COD_PROVINCIA,COD_PROVMUNI,MUNICIPIO,POBLACION_1999,2000_SALDOTOTAL,2000_SALDOTOTAL_HOMBRES,2000_SALDOTOTAL_MUJERES,2000_SALDOEXT_TOTAL,2000_SALDOEXT_HOMBRES,2000_SALDOEXT_MUJERES,2000_SALDOTOTAL_MENORES,2000_SALDOTOTAL_ESTUDIANTES,2000_SALDOTOTAL_TRABAJADORES,2000_SALDOTOTAL_MADUREZ1,2000_SALDOTOTAL_MADUREZ2,2000_SALDOTOTAL_JUBILADOS,2000_SALDOHOMBRES_MENORES,2000_SALDOHOMBRES_ESTUDIANTES,2000_SALDOHOMBRES_TRABAJADORES,2000_SALDOHOMBRES_MADUREZ1,2000_SALDOHOMBRES_MADUREZ2,2000_SALDOHOMBRES_JUBILADOS,2000_SALDOMUJERES_MENORES,2000_SALDOMUJERES_ESTUDIANTES,2000_SALDOMUJERES_TRABAJADORES,2000_SALDOMUJERES_MADUREZ1,2000_SALDOMUJERES_MADUREZ2,2000_SALDOMUJERES_JUBILADOS,2000_SALDOEXT_MENORES,2000_SALDOEXT_ESTUDIANTES,2000_SALDOEXT_TRABAJADORES,2000_SALDOEXT_MADUREZ1,2000_SALDOEXT_MADUREZ2,2000_SALDOEXT_JUBILADOS,2000_SALDOEXT_HOMBRES_MENORES,2000_SALDOEXT_HOMBRES_ESTUDIANTES,2000_SALDOEXT_HOMBRES_TRABAJADORES,2000_SALDOEXT_HOMBRES_MADUREZ1,2000_SALDOEXT_HOMBRES_MADUREZ2,2000_SALDOEXT_HOMBRES_JUBILADOS,2000_SALDOEXT_MUJERES_MENORES,2000_SALDOEXT_MUJERES_ESTUDIANTES,2000_SALDOEXT_MUJERES_TRABAJADORES,2000_SALDOEXT_MUJERES_MADUREZ1,2000_SALDOEXT_MUJERES_MADUREZ2,2000_SALDOEXT_MUJERES_JUBILADOS,2001_SALDOTOTAL,2001_SALDOTOTAL_HOMBRES,2001_SALDOTOTAL_MUJERES,2001_SALDOEXT_TOTAL,2001_SALDOEXT_HOMBRES,2001_SALDOEXT_MUJERES,2001_SALDOTOTAL_MENORES,2001_SALDOTOTAL_ESTUDIANTES,2001_SALDOTOTAL_TRABAJADORES,2001_SALDOTOTAL_MADUREZ1,2001_SALDOTOTAL_MADUREZ2,2001_SALDOTOTAL_JUBILADOS,2001_SALDOHOMBRES_MENORES,2001_SALDOHOMBRES_ESTUDIANTES,2001_SALDOHOMBRES_TRABAJADORES,2001_SALDOHOMBRES_MADUREZ1,2001_SALDOHOMBRES_MADUREZ2,2001_SALDOHOMBRES_JUBILADOS,2001_SALDOMUJERES_MENORES,2001_SALDOMUJERES_ESTUDIANTES,2001_SALDOMUJERES_TRABAJADORES,2001_SALDOMUJERES_MADUREZ1,2001_SALDOMUJERES_MADUREZ2,2001_SALDOMUJERES_JUBILADOS,2001_SALDOEXT_MENORES,2001_SALDOEXT_ESTUDIANTES,2001_SALDOEXT_TRABAJADORES,2001_SALDOEXT_MADUREZ1,2001_SALDOEXT_MADUREZ2,2001_SALDOEXT_JUBILADOS,2001_SALDOEXT_HOMBRES_MENORES,2001_SALDOEXT_HOMBRES_ESTUDIANTES,2001_SALDOEXT_HOMBRES_TRABAJADORES,2001_SALDOEXT_HOMBRES_MADUREZ1,2001_SALDOEXT_HOMBRES_MADUREZ2,2001_SALDOEXT_HOMBRES_JUBILADOS,2001_SALDOEXT_MUJERES_MENORES,2001_SALDOEXT_MUJERES_ESTUDIANTES,2001_SALDOEXT_MUJERES_TRABAJADORES,2001_SALDOEXT_MUJERES_MADUREZ1,2001_SALDOEXT_MUJERES_MADUREZ2,2001_SALDOEXT_MUJERES_JUBILADOS,2002_SALDOTOTAL,2002_SALDOTOTAL_HOMBRES,2002_SALDOTOTAL_MUJERES,2002_SALDOEXT_TOTAL,2002_SALDOEXT_HOMBRES,2002_SALDOEXT_MUJERES,2002_SALDOTOTAL_MENORES,2002_SALDOTOTAL_ESTUDIANTES,2002_SALDOTOTAL_TRABAJADORES,2002_SALDOTOTAL_MADUREZ1,2002_SALDOTOTAL_MADUREZ2,2002_SALDOTOTAL_JUBILADOS,2002_SALDOHOMBRES_MENORES,2002_SALDOHOMBRES_ESTUDIANTES,2002_SALDOHOMBRES_TRABAJADORES,2002_SALDOHOMBRES_MADUREZ1,2002_SALDOHOMBRES_MADUREZ2,2002_SALDOHOMBRES_JUBILADOS,2002_SALDOMUJERES_MENORES,2002_SALDOMUJERES_ESTUDIANTES,2002_SALDOMUJERES_TRABAJADORES,2002_SALDOMUJERES_MADUREZ1,2002_SALDOMUJERES_MADUREZ2,2002_SALDOMUJERES_JUBILADOS,2002_SALDOEXT_MENORES,2002_SALDOEXT_ESTUDIANTES,2002_SALDOEXT_TRABAJADORES,2002_SALDOEXT_MADUREZ1,2002_SALDOEXT_MADUREZ2,2002_SALDOEXT_JUBILADOS,2002_SALDOEXT_HOMBRES_MENORES,2002_SALDOEXT_HOMBRES_ESTUDIANTES,2002_SALDOEXT_HOMBRES_TRABAJADORES,2002_SALDOEXT_HOMBRES_MADUREZ1,2002_SALDOEXT_HOMBRES_MADUREZ2,2002_SALDOEXT_HOMBRES_JUBILADOS,2002_SALDOEXT_MUJERES_MENORES,2002_SALDOEXT_MUJERES_ESTUDIANTES,2002_SALDOEXT_MUJERES_TRABAJADORES,2002_SALDOEXT_MUJERES_MADUREZ1,2002_SALDOEXT_MUJERES_MADUREZ2,2002_SALDOEXT_MUJERES_JUBILADOS,2003_SALDOTOTAL,2003_SALDOTOTAL_HOMBRES,2003_SALDOTOTAL_MUJERES,2003_SALDOEXT_TOTAL,2003_SALDOEXT_HOMBRES,2003_SALDOEXT_MUJERES,2003_SALDOTOTAL_MENORES,2003_SALDOTOTAL_ESTUDIANTES,2003_SALDOTOTAL_TRABAJADORES,2003_SALDOTOTAL_MADUREZ1,2003_SALDOTOTAL_MADUREZ2,2003_SALDOTOTAL_JUBILADOS,2003_SALDOHOMBRES_MENORES,2003_SALDOHOMBRES_ESTUDIANTES,2003_SALDOHOMBRES_TRABAJADORES,2003_SALDOHOMBRES_MADUREZ1,2003_SALDOHOMBRES_MADUREZ2,2003_SALDOHOMBRES_JUBILADOS,2003_SALDOMUJERES_MENORES,2003_SALDOMUJERES_ESTUDIANTES,2003_SALDOMUJERES_TRABAJADORES,2003_SALDOMUJERES_MADUREZ1,2003_SALDOMUJERES_MADUREZ2,2003_SALDOMUJERES_JUBILADOS,2003_SALDOEXT_MENORES,2003_SALDOEXT_ESTUDIANTES,2003_SALDOEXT_TRABAJADORES,2003_SALDOEXT_MADUREZ1,2003_SALDOEXT_MADUREZ2,2003_SALDOEXT_JUBILADOS,2003_SALDOEXT_HOMBRES_MENORES,2003_SALDOEXT_HOMBRES_ESTUDIANTES,2003_SALDOEXT_HOMBRES_TRABAJADORES,2003_SALDOEXT_HOMBRES_MADUREZ1,2003_SALDOEXT_HOMBRES_MADUREZ2,2003_SALDOEXT_HOMBRES_JUBILADOS,2003_SALDOEXT_MUJERES_MENORES,2003_SALDOEXT_MUJERES_ESTUDIANTES,2003_SALDOEXT_MUJERES_TRABAJADORES,2003_SALDOEXT_MUJERES_MADUREZ1,2003_SALDOEXT_MUJERES_MADUREZ2,2003_SALDOEXT_MUJERES_JUBILADOS,2004_SALDOTOTAL,2004_SALDOTOTAL_HOMBRES,2004_SALDOTOTAL_MUJERES,2004_SALDOEXT_TOTAL,2004_SALDOEXT_HOMBRES,2004_SALDOEXT_MUJERES,2004_SALDOTOTAL_MENORES,2004_SALDOTOTAL_ESTUDIANTES,2004_SALDOTOTAL_TRABAJADORES,2004_SALDOTOTAL_MADUREZ1,2004_SALDOTOTAL_MADUREZ2,2004_SALDOTOTAL_JUBILADOS,2004_SALDOHOMBRES_MENORES,2004_SALDOHOMBRES_ESTUDIANTES,2004_SALDOHOMBRES_TRABAJADORES,2004_SALDOHOMBRES_MADUREZ1,2004_SALDOHOMBRES_MADUREZ2,2004_SALDOHOMBRES_JUBILADOS,2004_SALDOMUJERES_MENORES,2004_SALDOMUJERES_ESTUDIANTES,2004_SALDOMUJERES_TRABAJADORES,2004_SALDOMUJERES_MADUREZ1,2004_SALDOMUJERES_MADUREZ2,2004_SALDOMUJERES_JUBILADOS,2004_SALDOEXT_MENORES,2004_SALDOEXT_ESTUDIANTES,2004_SALDOEXT_TRABAJADORES,2004_SALDOEXT_MADUREZ1,2004_SALDOEXT_MADUREZ2,2004_SALDOEXT_JUBILADOS,2004_SALDOEXT_HOMBRES_MENORES,2004_SALDOEXT_HOMBRES_ESTUDIANTES,2004_SALDOEXT_HOMBRES_TRABAJADORES,2004_SALDOEXT_HOMBRES_MADUREZ1,2004_SALDOEXT_HOMBRES_MADUREZ2,2004_SALDOEXT_HOMBRES_JUBILADOS,2004_SALDOEXT_MUJERES_MENORES,2004_SALDOEXT_MUJERES_ESTUDIANTES,2004_SALDOEXT_MUJERES_TRABAJADORES,2004_SALDOEXT_MUJERES_MADUREZ1,2004_SALDOEXT_MUJERES_MADUREZ2,2004_SALDOEXT_MUJERES_JUBILADOS,2005_SALDOTOTAL,2005_SALDOTOTAL_HOMBRES,2005_SALDOTOTAL_MUJERES,2005_SALDOEXT_TOTAL,2005_SALDOEXT_HOMBRES,2005_SALDOEXT_MUJERES,2005_SALDOTOTAL_MENORES,2005_SALDOTOTAL_ESTUDIANTES,2005_SALDOTOTAL_TRABAJADORES,2005_SALDOTOTAL_MADUREZ1,2005_SALDOTOTAL_MADUREZ2,2005_SALDOTOTAL_JUBILADOS,2005_SALDOHOMBRES_MENORES,2005_SALDOHOMBRES_ESTUDIANTES,2005_SALDOHOMBRES_TRABAJADORES,2005_SALDOHOMBRES_MADUREZ1,2005_SALDOHOMBRES_MADUREZ2,2005_SALDOHOMBRES_JUBILADOS,2005_SALDOMUJERES_MENORES,2005_SALDOMUJERES_ESTUDIANTES,2005_SALDOMUJERES_TRABAJADORES,2005_SALDOMUJERES_MADUREZ1,2005_SALDOMUJERES_MADUREZ2,2005_SALDOMUJERES_JUBILADOS,2005_SALDOEXT_MENORES,2005_SALDOEXT_ESTUDIANTES,2005_SALDOEXT_TRABAJADORES,2005_SALDOEXT_MADUREZ1,2005_SALDOEXT_MADUREZ2,2005_SALDOEXT_JUBILADOS,2005_SALDOEXT_HOMBRES_MENORES,2005_SALDOEXT_HOMBRES_ESTUDIANTES,2005_SALDOEXT_HOMBRES_TRABAJADORES,2005_SALDOEXT_HOMBRES_MADUREZ1,2005_SALDOEXT_HOMBRES_MADUREZ2,2005_SALDOEXT_HOMBRES_JUBILADOS,2005_SALDOEXT_MUJERES_MENORES,2005_SALDOEXT_MUJERES_ESTUDIANTES,2005_SALDOEXT_MUJERES_TRABAJADORES,2005_SALDOEXT_MUJERES_MADUREZ1,2005_SALDOEXT_MUJERES_MADUREZ2,2005_SALDOEXT_MUJERES_JUBILADOS,2006_SALDOTOTAL,2006_SALDOTOTAL_HOMBRES,2006_SALDOTOTAL_MUJERES,2006_SALDOEXT_TOTAL,2006_SALDOEXT_HOMBRES,2006_SALDOEXT_MUJERES,2006_SALDOTOTAL_MENORES,2006_SALDOTOTAL_ESTUDIANTES,2006_SALDOTOTAL_TRABAJADORES,2006_SALDOTOTAL_MADUREZ1,2006_SALDOTOTAL_MADUREZ2,2006_SALDOTOTAL_JUBILADOS,2006_SALDOHOMBRES_MENORES,2006_SALDOHOMBRES_ESTUDIANTES,2006_SALDOHOMBRES_TRABAJADORES,2006_SALDOHOMBRES_MADUREZ1,2006_SALDOHOMBRES_MADUREZ2,2006_SALDOHOMBRES_JUBILADOS,2006_SALDOMUJERES_MENORES,2006_SALDOMUJERES_ESTUDIANTES,2006_SALDOMUJERES_TRABAJADORES,2006_SALDOMUJERES_MADUREZ1,2006_SALDOMUJERES_MADUREZ2,2006_SALDOMUJERES_JUBILADOS,2006_SALDOEXT_MENORES,2006_SALDOEXT_ESTUDIANTES,2006_SALDOEXT_TRABAJADORES,2006_SALDOEXT_MADUREZ1,2006_SALDOEXT_MADUREZ2,2006_SALDOEXT_JUBILADOS,2006_SALDOEXT_HOMBRES_MENORES,2006_SALDOEXT_HOMBRES_ESTUDIANTES,2006_SALDOEXT_HOMBRES_TRABAJADORES,2006_SALDOEXT_HOMBRES_MADUREZ1,2006_SALDOEXT_HOMBRES_MADUREZ2,2006_SALDOEXT_HOMBRES_JUBILADOS,2006_SALDOEXT_MUJERES_MENORES,2006_SALDOEXT_MUJERES_ESTUDIANTES,2006_SALDOEXT_MUJERES_TRABAJADORES,2006_SALDOEXT_MUJERES_MADUREZ1,2006_SALDOEXT_MUJERES_MADUREZ2,2006_SALDOEXT_MUJERES_JUBILADOS,2007_SALDOTOTAL,2007_SALDOTOTAL_HOMBRES,2007_SALDOTOTAL_MUJERES,2007_SALDOEXT_TOTAL,2007_SALDOEXT_HOMBRES,2007_SALDOEXT_MUJERES,2007_SALDOTOTAL_MENORES,2007_SALDOTOTAL_ESTUDIANTES,2007_SALDOTOTAL_TRABAJADORES,2007_SALDOTOTAL_MADUREZ1,2007_SALDOTOTAL_MADUREZ2,2007_SALDOTOTAL_JUBILADOS,2007_SALDOHOMBRES_MENORES,2007_SALDOHOMBRES_ESTUDIANTES,2007_SALDOHOMBRES_TRABAJADORES,2007_SALDOHOMBRES_MADUREZ1,2007_SALDOHOMBRES_MADUREZ2,2007_SALDOHOMBRES_JUBILADOS,2007_SALDOMUJERES_MENORES,2007_SALDOMUJERES_ESTUDIANTES,2007_SALDOMUJERES_TRABAJADORES,2007_SALDOMUJERES_MADUREZ1,2007_SALDOMUJERES_MADUREZ2,2007_SALDOMUJERES_JUBILADOS,2007_SALDOEXT_MENORES,2007_SALDOEXT_ESTUDIANTES,2007_SALDOEXT_TRABAJADORES,2007_SALDOEXT_MADUREZ1,2007_SALDOEXT_MADUREZ2,2007_SALDOEXT_JUBILADOS,2007_SALDOEXT_HOMBRES_MENORES,2007_SALDOEXT_HOMBRES_ESTUDIANTES,2007_SALDOEXT_HOMBRES_TRABAJADORES,2007_SALDOEXT_HOMBRES_MADUREZ1,2007_SALDOEXT_HOMBRES_MADUREZ2,2007_SALDOEXT_HOMBRES_JUBILADOS,2007_SALDOEXT_MUJERES_MENORES,2007_SALDOEXT_MUJERES_ESTUDIANTES,2007_SALDOEXT_MUJERES_TRABAJADORES,2007_SALDOEXT_MUJERES_MADUREZ1,2007_SALDOEXT_MUJERES_MADUREZ2,2007_SALDOEXT_MUJERES_JUBILADOS,2008_SALDOTOTAL,2008_SALDOTOTAL_HOMBRES,2008_SALDOTOTAL_MUJERES,2008_SALDOEXT_TOTAL,2008_SALDOEXT_HOMBRES,2008_SALDOEXT_MUJERES,2008_SALDOTOTAL_MENORES,2008_SALDOTOTAL_ESTUDIANTES,2008_SALDOTOTAL_TRABAJADORES,2008_SALDOTOTAL_MADUREZ1,2008_SALDOTOTAL_MADUREZ2,2008_SALDOTOTAL_JUBILADOS,2008_SALDOHOMBRES_MENORES,2008_SALDOHOMBRES_ESTUDIANTES,2008_SALDOHOMBRES_TRABAJADORES,2008_SALDOHOMBRES_MADUREZ1,2008_SALDOHOMBRES_MADUREZ2,2008_SALDOHOMBRES_JUBILADOS,2008_SALDOMUJERES_MENORES,2008_SALDOMUJERES_ESTUDIANTES,2008_SALDOMUJERES_TRABAJADORES,2008_SALDOMUJERES_MADUREZ1,2008_SALDOMUJERES_MADUREZ2,2008_SALDOMUJERES_JUBILADOS,2008_SALDOEXT_MENORES,2008_SALDOEXT_ESTUDIANTES,2008_SALDOEXT_TRABAJADORES,2008_SALDOEXT_MADUREZ1,2008_SALDOEXT_MADUREZ2,2008_SALDOEXT_JUBILADOS,2008_SALDOEXT_HOMBRES_MENORES,2008_SALDOEXT_HOMBRES_ESTUDIANTES,2008_SALDOEXT_HOMBRES_TRABAJADORES,2008_SALDOEXT_HOMBRES_MADUREZ1,2008_SALDOEXT_HOMBRES_MADUREZ2,2008_SALDOEXT_HOMBRES_JUBILADOS,2008_SALDOEXT_MUJERES_MENORES,2008_SALDOEXT_MUJERES_ESTUDIANTES,2008_SALDOEXT_MUJERES_TRABAJADORES,2008_SALDOEXT_MUJERES_MADUREZ1,2008_SALDOEXT_MUJERES_MADUREZ2,2008_SALDOEXT_MUJERES_JUBILADOS,2009_SALDOTOTAL,2009_SALDOTOTAL_HOMBRES,2009_SALDOTOTAL_MUJERES,2009_SALDOEXT_TOTAL,2009_SALDOEXT_HOMBRES,2009_SALDOEXT_MUJERES,2009_SALDOTOTAL_MENORES,2009_SALDOTOTAL_ESTUDIANTES,2009_SALDOTOTAL_TRABAJADORES,2009_SALDOTOTAL_MADUREZ1,2009_SALDOTOTAL_MADUREZ2,2009_SALDOTOTAL_JUBILADOS,2009_SALDOHOMBRES_MENORES,2009_SALDOHOMBRES_ESTUDIANTES,2009_SALDOHOMBRES_TRABAJADORES,2009_SALDOHOMBRES_MADUREZ1,2009_SALDOHOMBRES_MADUREZ2,2009_SALDOHOMBRES_JUBILADOS,2009_SALDOMUJERES_MENORES,2009_SALDOMUJERES_ESTUDIANTES,2009_SALDOMUJERES_TRABAJADORES,2009_SALDOMUJERES_MADUREZ1,2009_SALDOMUJERES_MADUREZ2,2009_SALDOMUJERES_JUBILADOS,2009_SALDOEXT_MENORES,2009_SALDOEXT_ESTUDIANTES,2009_SALDOEXT_TRABAJADORES,2009_SALDOEXT_MADUREZ1,2009_SALDOEXT_MADUREZ2,2009_SALDOEXT_JUBILADOS,2009_SALDOEXT_HOMBRES_MENORES,2009_SALDOEXT_HOMBRES_ESTUDIANTES,2009_SALDOEXT_HOMBRES_TRABAJADORES,2009_SALDOEXT_HOMBRES_MADUREZ1,2009_SALDOEXT_HOMBRES_MADUREZ2,2009_SALDOEXT_HOMBRES_JUBILADOS,2009_SALDOEXT_MUJERES_MENORES,2009_SALDOEXT_MUJERES_ESTUDIANTES,2009_SALDOEXT_MUJERES_TRABAJADORES,2009_SALDOEXT_MUJERES_MADUREZ1,2009_SALDOEXT_MUJERES_MADUREZ2,2009_SALDOEXT_MUJERES_JUBILADOS,2010_SALDOTOTAL,2010_SALDOTOTAL_HOMBRES,2010_SALDOTOTAL_MUJERES,2010_SALDOEXT_TOTAL,2010_SALDOEXT_HOMBRES,2010_SALDOEXT_MUJERES,2010_SALDOTOTAL_MENORES,2010_SALDOTOTAL_ESTUDIANTES,2010_SALDOTOTAL_TRABAJADORES,2010_SALDOTOTAL_MADUREZ1,2010_SALDOTOTAL_MADUREZ2,2010_SALDOTOTAL_JUBILADOS,2010_SALDOHOMBRES_MENORES,2010_SALDOHOMBRES_ESTUDIANTES,2010_SALDOHOMBRES_TRABAJADORES,2010_SALDOHOMBRES_MADUREZ1,2010_SALDOHOMBRES_MADUREZ2,2010_SALDOHOMBRES_JUBILADOS,2010_SALDOMUJERES_MENORES,2010_SALDOMUJERES_ESTUDIANTES,2010_SALDOMUJERES_TRABAJADORES,2010_SALDOMUJERES_MADUREZ1,2010_SALDOMUJERES_MADUREZ2,2010_SALDOMUJERES_JUBILADOS,2010_SALDOEXT_MENORES,2010_SALDOEXT_ESTUDIANTES,2010_SALDOEXT_TRABAJADORES,2010_SALDOEXT_MADUREZ1,2010_SALDOEXT_MADUREZ2,2010_SALDOEXT_JUBILADOS,2010_SALDOEXT_HOMBRES_MENORES,2010_SALDOEXT_HOMBRES_ESTUDIANTES,2010_SALDOEXT_HOMBRES_TRABAJADORES,2010_SALDOEXT_HOMBRES_MADUREZ1,2010_SALDOEXT_HOMBRES_MADUREZ2,2010_SALDOEXT_HOMBRES_JUBILADOS,2010_SALDOEXT_MUJERES_MENORES,2010_SALDOEXT_MUJERES_ESTUDIANTES,2010_SALDOEXT_MUJERES_TRABAJADORES,2010_SALDOEXT_MUJERES_MADUREZ1,2010_SALDOEXT_MUJERES_MADUREZ2,2010_SALDOEXT_MUJERES_JUBILADOS,2011_SALDOTOTAL,2011_SALDOTOTAL_HOMBRES,2011_SALDOTOTAL_MUJERES,2011_SALDOEXT_TOTAL,2011_SALDOEXT_HOMBRES,2011_SALDOEXT_MUJERES,2011_SALDOTOTAL_MENORES,2011_SALDOTOTAL_ESTUDIANTES,2011_SALDOTOTAL_TRABAJADORES,2011_SALDOTOTAL_MADUREZ1,2011_SALDOTOTAL_MADUREZ2,2011_SALDOTOTAL_JUBILADOS,2011_SALDOHOMBRES_MENORES,2011_SALDOHOMBRES_ESTUDIANTES,2011_SALDOHOMBRES_TRABAJADORES,2011_SALDOHOMBRES_MADUREZ1,2011_SALDOHOMBRES_MADUREZ2,2011_SALDOHOMBRES_JUBILADOS,2011_SALDOMUJERES_MENORES,2011_SALDOMUJERES_ESTUDIANTES,2011_SALDOMUJERES_TRABAJADORES,2011_SALDOMUJERES_MADUREZ1,2011_SALDOMUJERES_MADUREZ2,2011_SALDOMUJERES_JUBILADOS,2011_SALDOEXT_MENORES,2011_SALDOEXT_ESTUDIANTES,2011_SALDOEXT_TRABAJADORES,2011_SALDOEXT_MADUREZ1,2011_SALDOEXT_MADUREZ2,2011_SALDOEXT_JUBILADOS,2011_SALDOEXT_HOMBRES_MENORES,2011_SALDOEXT_HOMBRES_ESTUDIANTES,2011_SALDOEXT_HOMBRES_TRABAJADORES,2011_SALDOEXT_HOMBRES_MADUREZ1,2011_SALDOEXT_HOMBRES_MADUREZ2,2011_SALDOEXT_HOMBRES_JUBILADOS,2011_SALDOEXT_MUJERES_MENORES,2011_SALDOEXT_MUJERES_ESTUDIANTES,2011_SALDOEXT_MUJERES_TRABAJADORES,2011_SALDOEXT_MUJERES_MADUREZ1,2011_SALDOEXT_MUJERES_MADUREZ2,2011_SALDOEXT_MUJERES_JUBILADOS,2012_SALDOTOTAL,2012_SALDOTOTAL_HOMBRES,2012_SALDOTOTAL_MUJERES,2012_SALDOEXT_TOTAL,2012_SALDOEXT_HOMBRES,2012_SALDOEXT_MUJERES,2012_SALDOTOTAL_MENORES,2012_SALDOTOTAL_ESTUDIANTES,2012_SALDOTOTAL_TRABAJADORES,2012_SALDOTOTAL_MADUREZ1,2012_SALDOTOTAL_MADUREZ2,2012_SALDOTOTAL_JUBILADOS,2012_SALDOHOMBRES_MENORES,2012_SALDOHOMBRES_ESTUDIANTES,2012_SALDOHOMBRES_TRABAJADORES,2012_SALDOHOMBRES_MADUREZ1,2012_SALDOHOMBRES_MADUREZ2,2012_SALDOHOMBRES_JUBILADOS,2012_SALDOMUJERES_MENORES,2012_SALDOMUJERES_ESTUDIANTES,2012_SALDOMUJERES_TRABAJADORES,2012_SALDOMUJERES_MADUREZ1,2012_SALDOMUJERES_MADUREZ2,2012_SALDOMUJERES_JUBILADOS,2012_SALDOEXT_MENORES,2012_SALDOEXT_ESTUDIANTES,2012_SALDOEXT_TRABAJADORES,2012_SALDOEXT_MADUREZ1,2012_SALDOEXT_MADUREZ2,2012_SALDOEXT_JUBILADOS,2012_SALDOEXT_HOMBRES_MENORES,2012_SALDOEXT_HOMBRES_ESTUDIANTES,2012_SALDOEXT_HOMBRES_TRABAJADORES,2012_SALDOEXT_HOMBRES_MADUREZ1,2012_SALDOEXT_HOMBRES_MADUREZ2,2012_SALDOEXT_HOMBRES_JUBILADOS,2012_SALDOEXT_MUJERES_MENORES,2012_SALDOEXT_MUJERES_ESTUDIANTES,2012_SALDOEXT_MUJERES_TRABAJADORES,2012_SALDOEXT_MUJERES_MADUREZ1,2012_SALDOEXT_MUJERES_MADUREZ2,2012_SALDOEXT_MUJERES_JUBILADOS,2013_SALDOTOTAL,2013_SALDOTOTAL_HOMBRES,2013_SALDOTOTAL_MUJERES,2013_SALDOEXT_TOTAL,2013_SALDOEXT_HOMBRES,2013_SALDOEXT_MUJERES,2013_SALDOTOTAL_MENORES,2013_SALDOTOTAL_ESTUDIANTES,2013_SALDOTOTAL_TRABAJADORES,2013_SALDOTOTAL_MADUREZ1,2013_SALDOTOTAL_MADUREZ2,2013_SALDOTOTAL_JUBILADOS,2013_SALDOHOMBRES_MENORES,2013_SALDOHOMBRES_ESTUDIANTES,2013_SALDOHOMBRES_TRABAJADORES,2013_SALDOHOMBRES_MADUREZ1,2013_SALDOHOMBRES_MADUREZ2,2013_SALDOHOMBRES_JUBILADOS,2013_SALDOMUJERES_MENORES,2013_SALDOMUJERES_ESTUDIANTES,2013_SALDOMUJERES_TRABAJADORES,2013_SALDOMUJERES_MADUREZ1,2013_SALDOMUJERES_MADUREZ2,2013_SALDOMUJERES_JUBILADOS,2013_SALDOEXT_MENORES,2013_SALDOEXT_ESTUDIANTES,2013_SALDOEXT_TRABAJADORES,2013_SALDOEXT_MADUREZ1,2013_SALDOEXT_MADUREZ2,2013_SALDOEXT_JUBILADOS,2013_SALDOEXT_HOMBRES_MENORES,2013_SALDOEXT_HOMBRES_ESTUDIANTES,2013_SALDOEXT_HOMBRES_TRABAJADORES,2013_SALDOEXT_HOMBRES_MADUREZ1,2013_SALDOEXT_HOMBRES_MADUREZ2,2013_SALDOEXT_HOMBRES_JUBILADOS,2013_SALDOEXT_MUJERES_MENORES,2013_SALDOEXT_MUJERES_ESTUDIANTES,2013_SALDOEXT_MUJERES_TRABAJADORES,2013_SALDOEXT_MUJERES_MADUREZ1,2013_SALDOEXT_MUJERES_MADUREZ2,2013_SALDOEXT_MUJERES_JUBILADOS,2014_SALDOTOTAL,2014_SALDOTOTAL_HOMBRES,2014_SALDOTOTAL_MUJERES,2014_SALDOEXT_TOTAL,2014_SALDOEXT_HOMBRES,2014_SALDOEXT_MUJERES,2014_SALDOTOTAL_MENORES,2014_SALDOTOTAL_ESTUDIANTES,2014_SALDOTOTAL_TRABAJADORES,2014_SALDOTOTAL_MADUREZ1,2014_SALDOTOTAL_MADUREZ2,2014_SALDOTOTAL_JUBILADOS,2014_SALDOHOMBRES_MENORES,2014_SALDOHOMBRES_ESTUDIANTES,2014_SALDOHOMBRES_TRABAJADORES,2014_SALDOHOMBRES_MADUREZ1,2014_SALDOHOMBRES_MADUREZ2,2014_SALDOHOMBRES_JUBILADOS,2014_SALDOMUJERES_MENORES,2014_SALDOMUJERES_ESTUDIANTES,2014_SALDOMUJERES_TRABAJADORES,2014_SALDOMUJERES_MADUREZ1,2014_SALDOMUJERES_MADUREZ2,2014_SALDOMUJERES_JUBILADOS,2014_SALDOEXT_MENORES,2014_SALDOEXT_ESTUDIANTES,2014_SALDOEXT_TRABAJADORES,2014_SALDOEXT_MADUREZ1,2014_SALDOEXT_MADUREZ2,2014_SALDOEXT_JUBILADOS,2014_SALDOEXT_HOMBRES_MENORES,2014_SALDOEXT_HOMBRES_ESTUDIANTES,2014_SALDOEXT_HOMBRES_TRABAJADORES,2014_SALDOEXT_HOMBRES_MADUREZ1,2014_SALDOEXT_HOMBRES_MADUREZ2,2014_SALDOEXT_HOMBRES_JUBILADOS,2014_SALDOEXT_MUJERES_MENORES,2014_SALDOEXT_MUJERES_ESTUDIANTES,2014_SALDOEXT_MUJERES_TRABAJADORES,2014_SALDOEXT_MUJERES_MADUREZ1,2014_SALDOEXT_MUJERES_MADUREZ2,2014_SALDOEXT_MUJERES_JUBILADOS,2015_SALDOTOTAL,2015_SALDOTOTAL_HOMBRES,2015_SALDOTOTAL_MUJERES,2015_SALDOEXT_TOTAL,2015_SALDOEXT_HOMBRES,2015_SALDOEXT_MUJERES,2015_SALDOTOTAL_MENORES,2015_SALDOTOTAL_ESTUDIANTES,2015_SALDOTOTAL_TRABAJADORES,2015_SALDOTOTAL_MADUREZ1,2015_SALDOTOTAL_MADUREZ2,2015_SALDOTOTAL_JUBILADOS,2015_SALDOHOMBRES_MENORES,2015_SALDOHOMBRES_ESTUDIANTES,2015_SALDOHOMBRES_TRABAJADORES,2015_SALDOHOMBRES_MADUREZ1,2015_SALDOHOMBRES_MADUREZ2,2015_SALDOHOMBRES_JUBILADOS,2015_SALDOMUJERES_MENORES,2015_SALDOMUJERES_ESTUDIANTES,2015_SALDOMUJERES_TRABAJADORES,2015_SALDOMUJERES_MADUREZ1,2015_SALDOMUJERES_MADUREZ2,2015_SALDOMUJERES_JUBILADOS,2015_SALDOEXT_MENORES,2015_SALDOEXT_ESTUDIANTES,2015_SALDOEXT_TRABAJADORES,2015_SALDOEXT_MADUREZ1,2015_SALDOEXT_MADUREZ2,2015_SALDOEXT_JUBILADOS,2015_SALDOEXT_HOMBRES_MENORES,2015_SALDOEXT_HOMBRES_ESTUDIANTES,2015_SALDOEXT_HOMBRES_TRABAJADORES,2015_SALDOEXT_HOMBRES_MADUREZ1,2015_SALDOEXT_HOMBRES_MADUREZ2,2015_SALDOEXT_HOMBRES_JUBILADOS,2015_SALDOEXT_MUJERES_MENORES,2015_SALDOEXT_MUJERES_ESTUDIANTES,2015_SALDOEXT_MUJERES_TRABAJADORES,2015_SALDOEXT_MUJERES_MADUREZ1,2015_SALDOEXT_MUJERES_MADUREZ2,2015_SALDOEXT_MUJERES_JUBILADOS,2016_SALDOTOTAL,2016_SALDOTOTAL_HOMBRES,2016_SALDOTOTAL_MUJERES,2016_SALDOEXT_TOTAL,2016_SALDOEXT_HOMBRES,2016_SALDOEXT_MUJERES,2016_SALDOTOTAL_MENORES,2016_SALDOTOTAL_ESTUDIANTES,2016_SALDOTOTAL_TRABAJADORES,2016_SALDOTOTAL_MADUREZ1,2016_SALDOTOTAL_MADUREZ2,2016_SALDOTOTAL_JUBILADOS,2016_SALDOHOMBRES_MENORES,2016_SALDOHOMBRES_ESTUDIANTES,2016_SALDOHOMBRES_TRABAJADORES,2016_SALDOHOMBRES_MADUREZ1,2016_SALDOHOMBRES_MADUREZ2,2016_SALDOHOMBRES_JUBILADOS,2016_SALDOMUJERES_MENORES,2016_SALDOMUJERES_ESTUDIANTES,2016_SALDOMUJERES_TRABAJADORES,2016_SALDOMUJERES_MADUREZ1,2016_SALDOMUJERES_MADUREZ2,2016_SALDOMUJERES_JUBILADOS,2016_SALDOEXT_MENORES,2016_SALDOEXT_ESTUDIANTES,2016_SALDOEXT_TRABAJADORES,2016_SALDOEXT_MADUREZ1,2016_SALDOEXT_MADUREZ2,2016_SALDOEXT_JUBILADOS,2016_SALDOEXT_HOMBRES_MENORES,2016_SALDOEXT_HOMBRES_ESTUDIANTES,2016_SALDOEXT_HOMBRES_TRABAJADORES,2016_SALDOEXT_HOMBRES_MADUREZ1,2016_SALDOEXT_HOMBRES_MADUREZ2,2016_SALDOEXT_HOMBRES_JUBILADOS,2016_SALDOEXT_MUJERES_MENORES,2016_SALDOEXT_MUJERES_ESTUDIANTES,2016_SALDOEXT_MUJERES_TRABAJADORES,2016_SALDOEXT_MUJERES_MADUREZ1,2016_SALDOEXT_MUJERES_MADUREZ2,2016_SALDOEXT_MUJERES_JUBILADOS,2017_SALDOTOTAL,2017_SALDOTOTAL_HOMBRES,2017_SALDOTOTAL_MUJERES,2017_SALDOEXT_TOTAL,2017_SALDOEXT_HOMBRES,2017_SALDOEXT_MUJERES,2017_SALDOTOTAL_MENORES,2017_SALDOTOTAL_ESTUDIANTES,2017_SALDOTOTAL_TRABAJADORES,2017_SALDOTOTAL_MADUREZ1,2017_SALDOTOTAL_MADUREZ2,2017_SALDOTOTAL_JUBILADOS,2017_SALDOHOMBRES_MENORES,2017_SALDOHOMBRES_ESTUDIANTES,2017_SALDOHOMBRES_TRABAJADORES,2017_SALDOHOMBRES_MADUREZ1,2017_SALDOHOMBRES_MADUREZ2,2017_SALDOHOMBRES_JUBILADOS,2017_SALDOMUJERES_MENORES,2017_SALDOMUJERES_ESTUDIANTES,2017_SALDOMUJERES_TRABAJADORES,2017_SALDOMUJERES_MADUREZ1,2017_SALDOMUJERES_MADUREZ2,2017_SALDOMUJERES_JUBILADOS,2017_SALDOEXT_MENORES,2017_SALDOEXT_ESTUDIANTES,2017_SALDOEXT_TRABAJADORES,2017_SALDOEXT_MADUREZ1,2017_SALDOEXT_MADUREZ2,2017_SALDOEXT_JUBILADOS,2017_SALDOEXT_HOMBRES_MENORES,2017_SALDOEXT_HOMBRES_ESTUDIANTES,2017_SALDOEXT_HOMBRES_TRABAJADORES,2017_SALDOEXT_HOMBRES_MADUREZ1,2017_SALDOEXT_HOMBRES_MADUREZ2,2017_SALDOEXT_HOMBRES_JUBILADOS,2017_SALDOEXT_MUJERES_MENORES,2017_SALDOEXT_MUJERES_ESTUDIANTES,2017_SALDOEXT_MUJERES_TRABAJADORES,2017_SALDOEXT_MUJERES_MADUREZ1,2017_SALDOEXT_MUJERES_MADUREZ2,2017_SALDOEXT_MUJERES_JUBILADOS
1,01002,Amurrio,9753,-15,-9,-6,18,10,8,6,-20,-22,9,-5,17,5,-6,-9,2,-5,3,1,-14,-13,7,0,14,5,3,0,8,1,0,3,3,0,2,1,0,2,0,0,6,0,0,-83,-47,-36,8,4,4,-6,-22,-45,-8,-6,5,-3,-7,-24,-7,-5,0,-3,-15,-21,-1,-1,5,1,2,2,3,0,0,0,1,1,2,0,0,1,1,1,1,0,0,-10,-9,-1,11,8,3,19,-16,-14,-1,-4,3,5,-9,0,-2,-4,1,14,-7,-14,1,0,2,1,3,5,3,0,-1,1,1,4,2,0,0,0,2,1,1,0,-1,-50,-10,-40,6,5,1,5,-4,-47,-9,-1,5,9,1,-17,-6,-1,3,-4,-5,-30,-3,0,2,4,4,-5,2,1,0,4,2,-1,0,0,0,0,2,-4,2,1,0,92,71,21,65,43,22,43,-2,6,32,2,12,26,2,10,25,2,6,17,-4,-4,7,0,6,6,17,22,15,2,2,2,11,16,11,2,0,4,6,6,4,0,2,78,43,35,61,34,27,20,5,39,17,-1,-5,7,3,20,10,2,0,13,2,19,7,-3,-5,12,12,22,15,1,-1,5,5,12,12,0,0,7,7,10,3,1,-1,259,130,129,103,58,45,53,37,103,43,4,9,33,13,52,22,2,4,20,24,51,21,2,5,23,20,29,27,3,1,15,10,16,16,1,0,8,10,13,11,2,1,131,87,44,132,78,54,25,42,34,22,2,7,14,21,21,17,6,8,11,21,13,5,-4,-1,26,36,39,24,5,2,11,20,23,18,5,1,15,16,16,6,0,1,65,35,30,88,44,44,3,27,14,29,-4,-6,4,14,3,23,-6,-4,-1,13,11,6,2,-2,16,30,26,13,-1,2,7,18,11,10,-2,0,9,12,15,3,1,2,-29,-21,-8,38,10,28,-3,2,-38,-1,-6,14,-4,5,-28,0,-1,5,1,-3,-10,-1,-5,9,18,10,6,1,3,0,6,7,1,-3,-1,0,12,3,5,4,4,0,-36,-19,-17,-7,-12,5,10,-14,-36,2,-2,3,5,1,-17,-9,1,0,5,-15,-19,11,-3,3,8,3,-6,-7,-5,-1,6,1,-5,-12,-3,1,2,2,-1,5,-2,-2,88,42,46,28,8,20,12,11,29,22,6,8,-1,4,8,23,4,5,13,7,21,-1,2,3,5,9,7,3,3,1,1,4,-1,0,3,1,4,5,8,3,0,0,43,27,16,-7,-8,1,-4,11,35,2,-1,2,0,1,30,0,-7,2,-4,10,5,2,6,0,3,3,2,-9,-3,-4,2,2,1,-9,-5,0,1,1,1,0,2,-4,82,32,50,-13,-20,7,36,11,16,12,1,2,27,7,-3,4,-2,-3,9,4,19,8,3,5,-1,10,-11,-10,-1,1,2,4,-12,-10,-3,0,-3,6,1,0,2,1,24,-3,27,-20,-18,-2,18,-20,20,-3,0,1,13,-10,7,-9,-5,-2,5,-10,13,6,5,3,-3,-2,4,-11,-6,-3,0,-4,2,-10,-5,-1,-3,2,2,-1,-1,-2,-13,-17,4,2,-3,5,9,5,-12,-7,0,-10,0,5,-8,-10,0,-5,9,0,-4,3,0,-5,4,9,-5,-7,-2,3,1,6,-5,-4,-2,1,3,3,0,-3,0,2,34,13,21,2,8,-6,17,-5,7,13,-15,17,16,4,-7,11,-17,7,1,-9,14,2,2,10,-4,7,11,-9,-6,3,-1,11,7,-8,-4,3,-3,-4,4,-1,-2,0,10,-6,16,38,13,25,25,6,-19,14,-15,0,15,0,-11,12,-11,-7,10,6,-8,2,-4,7,16,10,3,5,-1,4,6,4,-2,4,0,1,10,6,5,1,-1,3
1,01011,Baños de Ebro/Mañueta,333,5,5,0,6,5,1,3,3,0,1,-1,-1,1,2,1,2,-1,0,2,1,-1,-1,0,-1,0,3,2,1,0,0,0,2,2,1,0,0,0,1,0,0,0,0,12,9,3,8,7,1,4,2,2,3,0,1,4,2,1,2,0,0,0,0,1,1,0,1,2,2,1,3,0,0,2,2,1,2,0,0,0,0,0,1,0,0,2,-1,3,3,2,1,2,-1,1,-2,3,-2,1,-1,0,-2,1,-1,1,0,1,0,2,-1,0,1,0,0,2,0,0,1,0,0,1,0,0,0,0,0,1,0,-2,-1,-1,2,1,1,-1,0,-2,0,0,0,0,0,-2,0,0,0,-1,0,0,0,0,0,1,0,1,0,0,0,1,0,0,0,0,0,0,0,1,0,0,0,0,3,-3,10,7,3,-4,3,-4,4,1,0,0,1,-2,3,1,0,-4,2,-2,1,0,0,1,4,0,4,1,0,1,2,0,3,1,0,0,2,0,1,0,0,25,22,3,21,19,2,-1,2,15,5,3,0,-2,1,14,4,3,0,1,1,1,1,0,0,0,2,10,5,2,0,0,1,9,5,2,0,0,1,1,0,0,0,-7,-10,3,-3,-7,4,1,-5,-6,2,-1,2,0,-4,-6,-1,0,1,1,-1,0,3,-1,1,2,-1,-3,-1,0,0,1,-2,-3,-3,0,0,1,1,0,2,0,0,8,6,2,11,8,3,-2,3,1,5,1,0,-1,2,1,5,-1,0,-1,1,0,0,2,0,0,3,2,6,0,0,0,2,2,4,0,0,0,1,0,2,0,0,-17,-14,-3,-15,-13,-2,1,-4,-10,-5,1,0,0,-2,-7,-5,0,0,1,-2,-3,0,1,0,-1,-4,-5,-4,-1,0,-1,-2,-5,-4,-1,0,0,-2,0,0,0,0,-4,0,-4,-2,-1,-1,-2,1,-4,1,1,0,1,1,-3,0,1,0,-3,0,-1,1,0,0,-2,1,-2,1,0,0,-1,0,-1,1,0,0,-1,1,-1,0,0,0,0,1,-1,3,2,1,1,-1,2,-2,-1,0,0,0,2,-2,0,0,1,-1,0,0,-1,0,0,1,1,0,0,0,0,1,1,-1,0,0,0,0,0,1,0,0,-4,-1,-3,2,1,1,0,0,-1,0,-3,0,0,0,0,0,-1,0,0,0,-1,0,-2,0,2,0,1,0,-1,0,1,0,0,0,0,0,1,0,1,0,-1,0,5,3,2,4,3,1,1,-1,0,2,1,2,2,-1,1,1,0,0,-1,0,-1,1,1,2,2,0,1,0,1,0,2,0,1,0,0,0,0,0,0,0,1,0,6,2,4,6,2,4,1,1,5,0,0,-1,0,0,3,0,-1,0,1,1,2,0,1,-1,1,1,2,2,0,0,0,0,1,1,0,0,1,1,1,1,0,0,-9,-7,-2,-13,-8,-5,-1,0,-3,-2,-2,-1,-1,-1,-4,0,-1,0,0,1,1,-2,-1,-1,-1,-1,-3,-4,-4,0,-1,-1,-2,-2,-2,0,0,0,-1,-2,-2,0,-3,-2,-1,2,1,1,-1,-1,0,1,-2,0,-1,1,-1,0,-1,0,0,-2,1,1,-1,0,2,0,0,0,0,0,1,0,0,0,0,0,1,0,0,0,0,0,1,1,0,3,2,1,-1,-1,3,5,-1,-4,-1,-1,0,5,0,-2,0,0,3,0,-1,-2,0,0,2,1,0,0,0,0,1,1,0,0,0,0,1,0,0,0,-9,-1,-8,2,1,1,0,-2,-1,-4,0,-3,0,1,0,-2,-1,0,0,-3,-1,-2,1,-3,2,1,1,-2,-1,0,1,1,0,-1,-1,0,1,0,1,-1,0,0
1,01022,Elciego,905,7,2,5,5,4,1,2,-3,8,0,4,-4,2,-1,4,-1,1,-3,0,-2,4,1,3,-1,2,0,3,0,0,0,2,0,2,0,0,0,0,0,1,0,0,0,24,15,9,18,11,7,3,6,13,2,0,-1,1,7,4,1,0,1,2,-1,9,1,0,-2,5,5,5,2,0,0,2,3,3,2,0,0,3,2,2,0,0,0,8,1,7,12,4,8,-3,9,-7,4,3,3,0,3,-8,2,2,2,-3,6,1,2,1,1,1,4,4,2,0,1,0,1,1,2,0,0,1,3,3,0,0,1,12,9,3,5,2,3,-1,5,3,-3,7,1,0,3,5,-3,3,1,-1,2,-2,0,4,0,2,1,2,0,0,0,1,0,1,0,0,0,1,1,1,0,0,0,19,12,7,5,1,4,9,2,5,1,0,2,6,2,1,1,-1,3,3,0,4,0,1,-1,1,1,2,1,0,0,1,0,0,0,0,0,0,1,2,1,0,0,11,5,6,10,5,5,2,0,3,-1,10,-4,-1,1,2,0,5,-2,3,-1,1,-1,5,-2,3,2,4,0,1,0,1,2,1,0,1,0,2,0,3,0,0,0,62,28,34,12,4,8,8,10,24,13,3,1,1,6,13,6,0,1,7,4,11,7,3,0,1,3,5,2,-1,1,0,2,3,0,-1,0,1,1,2,2,0,1,21,8,13,4,1,3,3,3,9,2,6,-1,1,0,7,1,2,-1,2,3,2,1,4,0,0,1,3,0,0,0,0,1,1,0,-1,0,0,0,2,0,1,0,25,15,10,11,7,4,6,8,2,4,2,3,4,6,1,2,1,1,2,2,1,2,1,2,4,5,0,3,-1,0,3,3,0,1,0,0,1,2,0,2,-1,0,-2,-1,-1,5,4,1,1,-3,-1,2,0,2,0,0,-1,3,-2,1,1,-3,0,-1,2,1,1,0,3,2,-1,0,1,0,2,1,0,0,0,0,1,1,-1,0,-7,1,-8,3,2,1,0,-2,2,6,-7,-6,3,-1,2,2,-2,-3,-3,-1,0,4,-5,-3,-1,1,0,3,0,0,0,0,1,1,0,0,-1,1,-1,2,0,0,-8,-3,-5,5,4,1,-1,-2,1,-3,-2,-1,1,0,2,-5,0,-1,-2,-2,-1,2,-2,0,0,3,2,0,0,0,0,2,2,0,0,0,0,1,0,0,0,0,11,2,9,-23,-12,-11,5,-1,9,-3,0,1,4,-3,-1,1,0,2,1,2,10,-4,0,-1,-1,-4,-10,-4,-3,-1,-1,-3,-5,-1,-2,0,0,-1,-5,-3,-1,-1,21,14,7,2,2,0,5,5,7,0,4,0,1,3,6,3,1,0,4,2,1,-3,3,0,0,1,4,-4,0,1,0,1,2,-1,0,0,0,0,2,-3,0,1,7,7,0,8,6,2,0,8,2,1,-4,-2,0,6,3,2,-1,-3,0,2,-1,-1,-3,1,1,1,2,2,0,2,0,1,2,2,0,1,1,0,0,0,0,1,-48,-29,-19,-19,-17,-2,-10,-2,-22,-8,-2,-3,1,-2,-18,-7,-2,0,-11,0,-4,-1,0,-3,-2,-2,-14,-2,0,1,-1,-1,-12,-4,0,1,-1,-1,-2,2,0,0,7,12,-5,2,3,-1,4,11,0,2,-1,-9,3,7,3,1,0,-2,1,4,-3,1,-1,-7,0,2,-3,3,0,0,0,2,-1,2,0,0,0,0,-2,1,0,0,-11,-4,-7,5,2,3,-5,0,-2,-4,2,-2,-1,0,-2,-2,2,-1,-4,0,0,-2,0,-1,-1,1,1,2,2,0,-1,0,1,1,1,0,0,1,0,1,1,0
1,01028,Labastida/Bastida,1195,31,18,13,3,1,2,1,3,18,12,4,-7,0,4,8,7,3,-4,1,-1,10,5,1,-3,0,0,2,1,0,0,0,0,1,0,0,0,0,0,1,1,0,0,18,16,2,7,4,3,-4,5,11,2,2,2,-1,2,13,-2,1,3,-3,3,-2,4,1,-1,2,2,2,1,0,0,1,1,2,0,0,0,1,1,0,1,0,0,25,9,16,6,5,1,7,-3,6,7,2,6,2,-2,1,5,0,3,5,-1,5,2,2,3,0,2,2,1,1,0,0,1,2,1,1,0,0,1,0,0,0,0,35,28,7,9,6,3,5,6,9,9,7,-1,4,4,7,10,3,-1,1,2,2,-1,4,0,0,3,1,4,0,0,0,0,1,4,0,0,0,3,0,0,0,0,59,41,18,17,15,2,20,11,19,14,0,-5,11,10,13,7,0,-1,9,1,6,7,0,-4,5,2,6,5,-1,0,4,3,5,4,-1,0,1,-1,1,1,0,0,42,12,30,2,-2,4,14,3,14,4,8,1,2,0,6,3,2,1,12,3,8,1,6,0,2,1,-1,0,0,0,0,0,-2,0,0,0,2,1,1,0,0,0,40,16,24,22,14,8,13,7,7,4,6,3,8,4,5,-6,4,1,5,3,2,10,2,2,9,0,8,3,2,0,6,0,5,1,2,0,3,0,3,2,0,0,12,6,6,12,6,6,-5,2,12,-4,5,1,-4,-2,8,1,2,1,-1,4,4,-5,3,0,3,5,1,3,0,0,1,1,2,2,0,0,2,4,-1,1,0,0,-10,-3,-7,13,7,6,-7,-4,4,2,0,-6,0,0,1,0,-1,-4,-7,-4,3,2,1,-2,2,1,5,5,0,0,1,0,4,2,0,0,1,1,1,3,0,0,-44,-18,-26,0,-1,1,-9,-5,-14,1,-7,-7,-2,-2,-9,3,-5,-2,-7,-3,-5,-2,-2,-5,0,0,1,-1,-1,1,0,0,1,-1,-1,0,0,0,0,0,0,1,-8,-17,9,-3,-3,0,-1,-3,8,-8,-3,-1,-3,-3,0,-9,-2,0,2,0,8,1,-1,-1,1,0,2,-5,0,-1,1,0,1,-5,0,0,0,0,1,0,0,-1,37,16,21,-1,-1,0,12,9,0,3,11,0,7,-1,0,-1,7,1,5,10,0,4,4,-1,2,3,-2,-2,-2,0,2,2,0,-3,-2,0,0,1,-2,1,0,0,-36,-23,-13,1,-1,2,-2,-4,-5,-12,-11,-1,-3,-3,-2,-7,-7,0,1,-1,-3,-5,-4,-1,1,0,3,-1,-2,0,1,0,0,-1,-1,0,0,0,3,0,-1,0,9,8,1,5,2,3,1,0,14,-2,-2,-2,4,-2,11,-2,-2,-1,-3,2,3,0,0,-1,-1,2,2,2,1,-1,-1,0,1,2,0,0,0,2,1,0,1,-1,-18,-13,-5,-19,-17,-2,-3,4,-5,-3,-12,-1,7,1,-6,-6,-9,1,-10,3,1,3,-3,-2,-3,0,-3,-10,-3,1,-1,0,-3,-10,-2,0,-2,0,0,0,-1,1,-6,-4,-2,2,1,1,0,-4,-1,5,-3,-2,-2,-1,-1,3,-3,-1,2,-3,0,2,0,-1,1,1,2,-1,-1,0,0,0,2,0,-1,0,1,1,0,-1,0,0,-1,14,-15,2,2,0,5,2,10,-6,-6,-4,10,1,8,-2,0,-1,-5,1,2,-4,-6,-3,1,2,-2,0,0,1,1,1,0,0,0,0,0,1,-2,0,0,1,-6,-1,-5,7,5,2,-8,-1,5,8,-4,-4,-6,-2,8,5,-4,0,-2,1,-3,3,0,-4,1,0,3,3,0,0,1,0,2,2,0,0,0,0,1,1,0,0
1,01031,Laguardia,1409,12,15,-3,6,2,4,5,0,2,3,3,-1,5,1,3,4,1,1,0,-1,-1,-1,2,-2,2,1,3,0,0,0,1,0,1,0,0,0,1,1,2,0,0,0,34,28,6,17,16,1,5,3,7,8,12,-1,3,6,6,7,6,0,2,-3,1,1,6,-1,1,6,4,4,2,0,1,6,4,3,2,0,0,0,0,1,0,0,38,22,16,8,3,5,4,10,17,0,5,0,1,5,8,0,5,1,3,5,9,0,0,-1,0,4,3,1,0,0,0,1,1,1,0,0,0,3,2,0,0,0,30,21,9,10,4,6,-2,1,15,7,7,2,2,2,4,5,6,2,-4,-1,11,2,1,0,0,2,4,3,1,0,0,1,1,2,0,0,0,1,3,1,1,0,19,19,0,24,12,12,-1,4,15,2,2,-4,0,1,11,4,0,2,-1,3,4,-2,2,-6,2,7,12,1,1,1,1,1,8,0,1,1,1,6,4,1,0,0,28,10,18,21,11,10,4,8,11,12,-8,-3,4,1,3,7,-4,-2,0,7,8,5,-4,-1,3,6,8,4,0,0,3,2,3,3,0,0,0,4,5,1,0,0,-18,-24,6,7,3,4,2,-5,-8,-5,-5,4,0,-7,-8,-3,-3,-2,2,2,0,-2,-2,6,2,3,2,0,0,0,0,1,2,0,0,0,2,2,0,0,0,0,32,22,10,3,4,-1,9,12,-1,12,3,-4,7,5,-1,12,0,-1,2,7,0,0,3,-3,2,8,-6,-2,1,0,0,6,-1,-1,0,0,2,2,-5,-1,1,0,2,2,0,17,5,12,-6,9,-3,7,2,-4,-2,3,-2,6,0,-1,-4,6,-1,1,2,-3,5,6,4,4,-2,0,2,1,0,3,-1,0,3,5,4,1,-1,0,16,9,7,6,3,3,16,-1,-1,3,-3,0,10,0,0,-1,0,-2,6,-1,-1,4,-3,2,1,1,3,-1,2,0,1,0,2,0,0,0,0,1,1,-1,2,0,47,30,17,9,6,3,8,4,11,8,7,7,6,2,10,5,2,4,2,2,1,3,5,3,3,2,1,2,1,0,2,1,1,2,0,0,1,1,0,0,1,0,13,3,10,1,1,0,5,6,6,3,-6,-3,0,0,4,3,-4,-1,5,6,2,0,-2,-2,1,-2,2,0,0,-1,0,-1,1,0,0,0,1,-1,1,0,0,-1,-1,0,-1,7,5,2,2,9,2,-4,-2,-6,1,7,-1,-4,2,-5,1,2,3,0,-4,-1,2,2,2,-1,1,0,1,1,1,0,1,0,1,1,1,-1,0,0,-7,-2,-5,2,1,1,-1,0,-3,-2,1,-2,-1,-2,3,-2,0,0,0,2,-6,0,1,-2,0,0,1,0,1,0,0,0,1,0,0,0,0,0,0,0,1,0,12,2,10,1,-1,2,5,4,-3,9,-2,0,3,0,1,0,-2,0,2,4,-4,9,0,0,0,4,-3,0,0,0,0,1,-1,-1,0,0,0,3,-2,1,0,0,-37,-13,-24,-2,-1,-1,-6,1,-13,-11,-6,-4,-3,3,-7,-4,-4,1,-3,-2,-6,-7,-2,-5,2,0,-4,-3,3,0,2,-1,-2,-2,2,0,0,1,-2,-1,1,0,-10,-13,3,-6,-8,2,-4,-5,2,2,-2,-4,-4,-5,5,-5,-2,-1,0,0,-3,7,0,-3,0,1,-3,-2,-2,0,0,0,-3,-3,-2,0,0,1,0,1,0,0,25,14,11,5,4,1,8,9,3,3,8,-5,5,2,3,3,2,-1,3,7,0,0,6,-4,0,1,2,1,1,0,0,1,1,1,1,0,0,0,1,0,0,0
1,01036,Laudio/Llodio,19632,-138,-79,-59,15,9,6,3,-19,-73,-25,-13,-9,2,-11,-39,-17,-6,-7,1,-8,-34,-8,-7,-2,4,4,4,1,0,2,3,2,3,0,0,1,1,2,1,1,0,1,-153,-80,-73,16,10,6,-9,-28,-77,-25,-14,-1,-7,-11,-46,-13,-1,-3,-2,-17,-31,-12,-13,2,5,3,6,2,0,0,4,2,3,1,0,0,1,1,3,1,0,0,-145,-80,-65,33,18,15,-9,-6,-82,-28,-22,4,-8,-2,-40,-9,-14,-6,-1,-4,-42,-19,-8,10,9,8,14,2,1,-1,4,6,7,0,1,0,5,2,7,2,0,-1,-151,-67,-84,47,19,28,-2,-24,-92,-16,-11,-6,8,-6,-42,-18,-6,-2,-10,-18,-50,2,-5,-4,16,3,14,9,4,1,10,1,4,2,2,0,6,2,10,7,2,1,-115,-66,-49,68,32,36,1,9,-71,-31,-18,-2,1,6,-33,-16,-15,-6,0,3,-38,-15,-3,4,10,16,22,11,5,1,4,7,11,6,2,1,6,9,11,5,3,0,-80,-52,-28,85,38,47,28,7,-82,-13,-22,-6,11,4,-36,-16,-15,-4,17,3,-46,3,-7,-2,23,22,25,9,2,1,9,10,14,2,1,1,14,12,11,7,1,0,-56,-62,6,113,58,55,22,9,-48,-9,-26,-8,8,-5,-33,-15,-16,-2,14,14,-15,6,-10,-6,26,27,28,20,7,3,15,14,17,9,1,2,11,13,11,11,6,1,-95,-51,-44,72,31,41,12,-22,-57,-6,-24,2,9,-13,-35,-3,-8,-1,3,-9,-22,-3,-16,3,31,16,14,9,1,1,17,7,3,3,1,0,14,9,11,6,0,1,68,50,18,84,45,39,36,28,5,12,-15,-2,10,13,29,18,-21,-1,26,15,-24,-6,6,-1,21,29,23,11,1,-1,10,13,14,11,-2,-1,11,16,9,0,3,0,121,81,40,57,30,27,51,27,13,15,11,0,38,9,10,8,11,0,13,18,3,7,0,0,16,18,13,6,5,-1,11,8,5,2,4,0,5,10,8,4,1,-1,64,7,57,29,1,28,26,5,16,5,-2,3,12,5,-17,7,-3,-1,14,0,33,-2,1,4,15,7,5,0,0,0,8,1,-5,0,-2,-1,7,6,10,0,2,1,36,18,18,-6,-7,1,20,20,-2,16,-10,-4,14,3,2,2,-2,-1,6,17,-4,14,-8,-3,-6,11,3,-8,-4,-3,-7,1,6,-4,-1,-2,1,10,-3,-4,-3,-1,3,-9,12,10,0,10,12,-6,-16,-4,5,12,4,3,-21,5,0,2,8,-9,5,-9,5,10,6,7,-9,-4,7,1,4,6,-10,-4,3,0,2,1,1,0,4,1,-60,-30,-30,0,-2,2,-16,5,-29,0,-18,-1,-6,-1,-15,0,-7,-1,-10,6,-14,0,-11,0,-7,0,3,-2,3,2,-5,1,0,1,0,0,-2,-1,3,-3,3,2,-77,-38,-39,-28,-12,-16,-9,-16,-21,-19,-6,-3,2,-13,-24,-4,3,-1,-11,-3,3,-15,-9,-2,-3,5,-8,-14,-6,-1,0,2,-4,-8,-1,0,-3,3,-4,-6,-5,-1,-33,-15,-18,-1,-11,10,5,0,-16,-33,-4,6,8,6,-10,-22,-2,2,-3,-6,-6,-11,-2,4,-3,7,-3,0,-3,0,-2,3,-4,-6,-3,1,-1,4,1,6,0,-1,-13,3,-16,36,8,28,-3,4,-9,-6,7,-5,-3,12,-5,-2,4,-3,0,-8,-4,-4,3,-2,10,17,0,5,2,2,2,10,-1,-3,0,0,8,7,1,8,2,2,44,14,30,46,23,23,13,23,21,-6,-6,-4,19,8,4,-11,-6,2,-6,15,17,5,0,-6,8,13,9,12,3,1,5,8,5,4,1,0,3,5,4,8,2,1
1,01058,Legutio,1333,30,12,18,3,1,2,4,5,10,7,3,1,-1,2,2,5,2,2,5,3,8,2,1,-1,0,2,1,0,0,0,0,0,1,0,0,0,0,2,0,0,0,0,23,12,11,10,5,5,4,3,4,0,3,9,6,2,1,-1,0,4,-2,1,3,1,3,5,3,3,3,0,0,0,2,1,2,0,0,0,1,2,1,0,0,0,38,33,5,12,9,3,0,2,25,7,6,-1,1,4,18,6,4,0,-1,-2,7,1,2,-1,0,2,3,5,0,2,0,2,3,3,0,1,0,0,0,2,0,1,25,15,10,3,1,2,4,5,14,4,2,-5,-1,3,15,-2,2,-1,5,2,-1,6,0,-4,1,0,2,0,0,0,0,0,1,0,0,0,1,0,1,0,0,0,40,15,25,12,5,7,5,3,19,11,4,-3,-1,4,10,1,3,-2,6,-1,9,10,1,-1,5,4,2,1,0,0,1,2,2,0,0,0,4,2,0,1,0,0,15,6,9,17,6,11,3,6,11,2,1,-7,5,6,3,-4,0,-3,-2,0,8,6,1,-4,2,5,7,2,1,0,0,2,3,1,0,0,2,3,4,1,1,0,52,27,25,16,8,8,14,15,24,-6,3,1,7,12,12,-5,1,-1,7,3,12,-1,2,2,6,5,3,0,1,1,3,4,1,0,0,0,3,1,2,0,1,1,19,9,10,15,3,12,0,0,-1,12,6,-1,-5,0,1,5,6,1,5,0,-2,7,0,-2,6,4,4,-1,0,1,2,0,1,-1,0,1,4,4,3,0,0,0,36,34,2,15,9,6,9,8,16,7,1,-6,8,5,13,7,2,-1,1,3,3,0,-1,-5,5,2,7,3,-1,-1,5,1,3,1,-1,0,0,1,4,2,0,-1,3,3,0,1,0,1,-3,0,4,7,0,-6,3,-3,0,4,2,-4,-6,3,4,3,-2,-2,-2,1,1,0,0,-1,0,0,0,-1,0,-1,-2,1,1,1,0,0,60,30,30,-5,-3,-2,-11,13,32,13,8,-2,-9,2,22,8,3,-1,-2,11,10,5,5,-1,-5,2,-4,1,-1,1,-2,-1,-2,2,-1,0,-3,3,-2,-1,0,1,39,29,10,13,6,7,-6,3,30,10,5,-4,-2,0,19,10,4,-1,-4,3,11,0,1,-3,-2,3,6,4,2,0,-1,1,1,3,2,0,-1,2,5,1,0,0,-7,-7,0,4,-4,8,-9,2,5,0,-4,-1,-8,0,7,-3,-1,-2,-1,2,-2,3,-3,1,1,1,1,2,-2,1,-1,-1,-3,1,-1,1,2,2,4,1,-1,0,-58,-30,-28,-8,-6,-2,-17,0,-20,-9,-6,-5,-11,5,-14,-6,-2,-2,-6,-5,-6,-3,-4,-3,0,4,-2,-5,-3,-2,-1,1,-1,-4,-1,0,1,3,-1,-1,-2,-2,-8,3,-11,-4,3,-7,-6,6,-2,-1,-3,-1,1,1,3,0,-1,0,-7,5,-5,-1,-2,-1,-4,-1,-1,1,1,0,0,-1,0,2,2,0,-4,0,-1,-1,-1,0,19,4,15,-13,-12,-1,12,5,-4,1,5,0,7,3,-5,-5,4,0,5,2,1,6,1,0,-3,-1,-4,-4,-1,0,-2,-1,-4,-4,-1,0,-1,0,0,0,0,0,49,31,18,8,6,2,10,-2,23,17,0,1,7,-1,14,10,0,1,3,-1,9,7,0,0,1,1,2,4,-1,1,2,0,2,3,-1,0,-1,1,0,1,0,1,65,32,33,17,11,6,17,10,16,21,1,1,9,2,8,12,1,1,8,8,8,9,0,0,2,5,2,8,0,0,0,2,1,7,1,0,2,3,1,1,-1,0
1,01043,Oyón-Oion,2286,80,35,45,5,3,2,5,13,42,0,9,10,2,5,22,-2,6,2,3,8,20,2,3,8,1,0,3,0,1,0,1,0,1,0,1,0,0,0,2,0,0,0,77,45,32,11,7,4,1,27,30,21,6,-5,3,15,22,8,2,-3,-2,12,8,13,4,-2,1,3,5,2,0,0,1,2,3,1,0,0,0,1,2,1,0,0,71,43,28,14,10,4,7,6,29,21,3,1,7,3,16,12,1,0,0,3,13,9,2,1,1,2,3,3,3,2,0,1,4,2,2,1,1,1,-1,1,1,1,100,50,50,21,7,14,34,18,36,18,-6,-3,16,8,21,8,-2,-2,18,10,15,10,-4,-1,10,3,5,2,0,0,4,1,0,1,0,0,6,2,5,1,0,0,144,74,70,23,14,9,29,28,48,28,7,7,9,9,34,15,2,6,20,19,14,13,5,1,3,5,10,2,2,1,1,2,8,1,1,1,2,3,2,1,1,0,42,28,14,14,11,3,12,10,5,11,-3,2,10,0,3,9,1,0,2,10,2,2,-4,2,1,1,4,5,1,1,0,0,5,3,1,1,1,1,-1,2,0,0,82,48,34,61,33,28,9,32,11,19,5,-5,9,12,10,10,5,-2,0,20,1,9,0,-3,19,13,8,10,5,1,14,7,3,4,2,1,5,6,5,6,3,0,43,20,23,9,7,2,18,1,9,17,-9,3,9,6,-1,7,-5,1,9,-5,10,10,-4,2,-5,3,4,6,0,-1,-2,4,2,3,0,-1,-3,-1,2,3,0,0,48,40,8,28,24,4,3,9,27,-4,4,4,3,11,21,-2,1,2,0,-2,6,-2,3,2,3,9,16,0,-1,-1,4,5,14,1,0,-1,-1,4,2,-1,-1,0,58,25,33,10,3,7,10,6,17,12,6,-2,8,-1,5,7,3,-3,2,7,12,5,3,1,2,5,1,2,1,-1,2,4,-1,-1,0,-1,0,1,2,3,1,0,16,10,6,4,-6,10,21,6,-3,-12,3,-2,14,7,-5,-7,2,-1,7,-1,2,-5,1,-1,8,2,-6,-1,1,0,4,2,-9,-4,1,0,4,0,3,3,0,0,3,-2,5,14,8,6,6,0,3,-10,-3,6,4,-4,4,-11,-1,4,2,4,-1,1,-2,2,4,2,6,-1,2,0,4,0,3,-2,2,0,0,2,3,1,0,0,-5,9,-14,-10,-9,-1,-11,4,9,-5,4,-11,-5,-1,15,-5,4,-3,-6,5,-6,0,0,-8,-1,4,-4,-3,-5,-2,0,2,-5,-3,-3,-1,-1,2,1,0,-2,-1,19,-1,20,-5,-6,1,21,-7,0,2,3,-1,18,-11,-4,1,-1,-4,3,4,4,1,4,3,-1,-3,-4,1,2,0,-1,-3,-4,0,2,0,0,0,0,1,0,0,21,12,9,-13,-11,-2,-1,10,21,2,-14,-5,-1,4,8,5,-6,-4,0,6,13,-3,-8,-1,-6,-2,2,-6,-1,-1,-3,-1,-2,-3,-2,-1,-3,-1,4,-3,1,0,-6,-9,3,-12,-14,2,1,5,5,-20,-2,1,-8,1,2,-10,0,2,9,4,3,-10,-2,-1,-1,0,-2,-5,-4,0,-3,0,-2,-6,-3,0,2,0,0,1,-1,0,-11,1,-12,-14,0,-14,-16,6,-7,0,-9,8,1,-1,1,2,-4,0,-17,7,-8,-2,-5,8,-7,-2,-3,0,-3,0,-1,-1,0,2,-1,0,-6,-1,-3,-2,-2,0,14,13,1,15,3,12,4,-3,3,3,2,2,-1,-4,3,8,4,2,5,1,0,-5,-2,0,2,8,4,-1,1,1,-1,2,1,-1,2,0,3,6,3,0,-1,1
1,01051,Salvatierra/Agurain,3933,-21,-17,-4,10,4,6,-9,-6,15,-12,-7,-4,-4,-8,5,-6,-2,-2,-5,2,10,-6,-5,-2,1,3,5,1,0,0,0,1,2,1,0,0,1,2,3,0,0,0,23,19,4,22,10,12,6,9,10,-1,1,-5,2,5,9,2,0,-1,4,4,1,-3,1,-4,6,2,8,4,0,0,2,1,2,3,0,0,4,1,6,1,0,0,-1,0,-1,11,4,7,10,-1,8,-6,-5,-4,3,3,-1,1,-4,-1,7,-4,9,-7,-1,-3,3,3,5,1,0,-1,1,2,0,1,0,0,2,1,5,0,0,-1,59,47,12,22,12,10,0,27,21,2,8,-1,2,15,17,1,8,1,-2,12,4,1,0,-2,6,5,5,3,2,0,3,1,4,2,1,0,3,4,1,1,1,0,39,21,18,19,7,12,-2,8,22,1,-1,2,-1,1,15,0,0,1,-1,7,7,1,-1,1,5,3,7,3,0,0,1,0,2,3,0,0,4,3,5,0,0,0,91,63,28,33,21,12,19,10,28,21,9,3,14,6,17,15,6,3,5,4,11,6,3,0,6,8,8,8,2,0,3,5,3,7,2,0,3,3,5,1,0,0,195,100,95,22,8,14,28,20,93,26,7,11,13,2,55,18,3,4,15,18,38,8,4,7,1,8,8,3,1,1,0,3,4,1,0,0,1,5,4,2,1,1,193,114,79,57,28,29,25,30,90,33,5,7,10,13,61,20,2,6,15,17,29,13,3,1,12,12,15,15,1,1,5,3,11,8,0,0,7,9,4,7,1,1,122,71,51,50,24,26,25,29,33,21,6,3,14,24,24,12,2,-7,11,5,9,9,4,10,17,16,8,8,3,-2,8,8,6,2,1,-1,9,8,2,6,2,-1,39,31,8,47,22,25,5,-3,3,14,5,17,4,-1,-8,20,5,12,1,-2,11,-6,0,5,19,5,12,4,3,2,10,2,3,1,3,1,9,3,9,3,0,1,14,16,-2,18,9,9,1,12,1,-11,-1,10,4,9,6,-7,0,2,-3,3,-5,-4,-1,8,7,8,1,4,-1,-1,4,3,-1,3,0,0,3,5,2,1,-1,-1,95,30,65,36,12,24,14,12,35,15,10,9,4,0,19,2,3,3,10,12,16,13,7,6,16,9,7,1,2,0,5,4,4,-1,0,0,11,5,3,2,2,0,7,23,-16,45,26,19,5,2,9,-14,-3,12,3,1,12,0,3,7,2,1,-3,-14,-6,5,11,12,15,6,-1,2,5,4,11,7,-2,1,6,8,4,-1,1,1,-50,-39,-11,20,12,8,-18,-5,-19,-13,-10,14,-8,-10,-12,-3,-10,2,-10,5,-7,-10,0,12,6,8,5,3,-1,-1,3,4,4,1,0,0,3,4,1,2,-1,-1,7,-4,11,20,5,15,-6,19,6,-9,-9,10,-5,11,5,-13,-6,7,-1,8,1,4,-3,3,2,1,8,5,1,3,-2,-1,8,-1,-1,2,4,2,0,6,2,1,-2,-18,16,18,3,15,12,6,3,-32,-3,4,10,0,-3,-26,-5,1,2,6,6,-6,2,3,0,9,3,2,4,0,2,3,-4,2,0,0,-2,6,7,0,4,0,7,9,-2,24,10,14,10,-4,-7,13,-11,4,8,-3,4,3,-6,3,2,-1,-11,10,-5,1,7,4,9,4,0,-1,4,2,5,0,0,-1,3,2,4,4,0,0,-38,-25,-13,-37,-24,-13,-25,4,3,-26,-8,12,-15,-3,-1,-10,-1,4,-10,7,4,-16,-7,8,-17,1,-1,-19,-5,3,-11,0,-1,-11,-2,0,-6,1,0,-8,-3,3
1,01059,Vitoria-Gasteiz,217154,1217,780,437,1453,780,673,76,516,427,106,-77,161,37,307,360,80,-44,47,39,209,67,26,-33,114,224,368,500,248,66,27,109,204,297,124,30,12,115,164,203,124,36,15,1741,896,845,2165,1137,1028,248,482,702,224,-29,101,124,251,380,133,-49,52,124,231,322,91,20,49,408,447,759,397,100,29,210,230,427,209,40,13,198,217,332,188,60,16,2040,1101,939,1855,1004,851,256,715,781,175,-56,180,147,360,538,77,-62,43,109,355,243,98,6,137,336,483,573,307,107,27,184,239,337,171,46,13,152,244,236,136,61,14,1352,777,575,1778,900,878,214,484,444,93,-45,161,96,274,357,53,-24,26,118,210,87,40,-21,135,377,451,538,277,87,27,191,229,282,136,42,9,186,222,256,141,45,18,1820,918,902,2069,1010,1059,238,720,585,170,-34,132,135,394,321,71,-36,35,103,326,264,99,2,97,400,557,558,343,137,46,208,280,258,180,67,9,192,277,300,163,70,37,1425,489,936,2143,1046,1097,351,667,111,181,-49,145,151,325,-29,79,-61,23,200,342,140,102,12,122,494,665,517,335,88,18,249,342,251,158,30,7,245,323,266,177,58,11,1963,1020,943,2736,1436,1300,394,717,469,285,-32,132,167,404,281,138,-39,63,227,313,188,147,7,69,516,745,825,459,137,38,230,393,483,248,52,19,286,352,342,211,85,19,2386,1304,1082,2679,1437,1242,494,904,637,272,-27,103,257,494,421,146,-57,37,237,410,216,126,30,66,542,900,813,347,51,2,285,473,478,183,8,1,257,427,335,164,43,1,2504,1279,1225,1924,931,993,465,848,733,319,11,120,274,401,422,144,-11,47,191,447,311,175,22,73,485,688,451,229,42,14,281,338,202,78,19,4,204,350,249,151,23,10,2006,1064,942,1405,709,696,390,660,590,214,-6,144,230,324,328,144,3,34,160,336,262,70,-9,110,381,479,363,156,0,13,219,225,173,82,-3,5,162,254,190,74,3,8,858,259,599,-472,-538,66,353,348,488,-104,-207,-31,191,167,243,-138,-160,-39,162,181,245,34,-47,8,169,144,-246,-383,-133,-43,90,67,-234,-338,-111,-20,79,77,-12,-45,-22,-23,2164,1135,1029,836,365,471,406,567,651,238,103,161,230,304,403,115,15,57,176,263,248,123,88,104,289,362,161,-29,9,17,167,181,79,-73,-17,10,122,181,82,44,26,7,-508,-680,172,-1602,-1196,-406,140,-10,-385,-370,-41,151,96,-75,-382,-355,-32,56,44,65,-3,-15,-9,95,22,-140,-786,-514,-172,-22,47,-123,-612,-409,-93,-12,-25,-17,-174,-105,-79,-10,778,135,643,-341,-333,-8,315,158,138,105,-37,62,179,-13,-57,52,-52,9,136,171,195,53,15,53,49,26,-219,-156,-50,-7,30,-25,-172,-123,-40,-9,19,51,-47,-33,-10,2,1865,826,1039,121,-23,144,589,318,445,281,93,115,315,111,184,111,65,28,274,207,261,170,28,87,149,104,-38,-111,-11,18,98,30,-51,-105,-7,7,51,74,13,-6,-4,11,1231,401,830,71,-94,165,377,304,86,235,61,127,219,119,-89,86,17,34,158,185,175,149,44,93,113,171,-100,-124,-18,12,74,76,-99,-114,-35,1,39,95,-1,-10,17,11,1879,841,1038,755,249,506,503,522,441,213,101,60,304,227,198,64,12,6,199,295,243,149,89,54,337,339,58,-26,-29,38,206,145,2,-87,-54,16,131,194,56,61,25,22,2589,1100,1489,1440,630,810,587,598,715,387,131,133,292,296,325,132,-4,29,295,302,390,255,135,104,372,427,378,119,68,46,195,218,185,21,-15,10,177,209,193,98,83,36
1,01063,Zuia,1637,100,58,42,30,19,11,20,10,38,27,-1,4,9,7,24,16,0,1,11,3,14,11,-1,3,6,9,12,3,0,0,2,6,9,2,0,0,4,3,3,1,0,0,127,69,58,16,13,3,25,9,43,34,10,4,14,7,24,17,5,1,11,2,19,17,5,3,1,0,6,8,1,0,1,0,6,5,1,0,0,0,0,3,0,0,136,78,58,20,10,10,30,-8,35,50,17,5,13,-2,27,28,9,0,17,-6,8,22,8,5,6,2,5,2,3,1,3,1,3,0,2,1,3,1,2,2,1,0,128,48,80,14,3,11,27,11,35,46,8,-3,11,5,9,19,3,-2,16,6,26,27,5,-1,0,4,4,5,0,0,0,1,1,1,0,0,0,3,3,4,0,0,54,31,23,19,11,8,20,1,15,7,2,4,13,1,4,7,0,3,7,0,11,0,2,1,4,1,12,2,0,0,2,1,6,2,0,0,2,0,6,0,0,0,36,28,8,35,23,12,0,8,4,5,8,12,0,9,6,5,6,3,0,-1,-2,0,2,9,7,6,10,9,2,0,2,4,8,7,1,0,5,2,2,2,1,0,32,17,15,19,16,3,4,-1,8,10,3,4,3,0,6,1,5,-1,1,-1,2,9,-2,5,-3,6,8,6,0,0,-1,4,7,5,0,0,-2,2,1,1,0,0,18,3,15,29,18,11,-6,-6,1,2,11,16,-5,-4,-1,4,6,4,-1,-2,2,-2,5,12,2,9,12,6,0,0,0,6,7,5,0,0,2,3,5,1,0,0,15,14,1,32,20,12,12,0,5,1,-3,1,5,7,6,0,-1,-2,7,-7,-1,1,-2,3,7,11,3,9,1,1,4,7,3,6,0,0,3,4,0,3,1,1,13,4,9,10,8,2,4,-4,3,5,2,1,4,-5,-2,6,2,-3,0,1,5,-1,0,4,-2,2,5,3,3,-1,1,-1,2,3,3,0,-3,3,3,0,0,-1,30,8,22,-8,-4,-4,8,-5,4,6,9,7,2,-2,-1,-3,6,5,6,-3,5,9,3,2,0,-1,-4,-4,0,1,0,0,-3,-2,0,1,0,-1,-1,-2,0,0,20,8,12,-8,-9,1,3,0,9,2,-7,9,0,-2,9,1,-8,5,3,2,0,1,1,4,1,1,-6,0,-5,0,0,-1,-3,0,-5,0,1,2,-3,0,0,0,8,8,0,-14,-8,-6,12,-5,1,8,-9,-3,8,0,-6,7,-1,-1,4,-5,7,1,-8,-2,-4,-3,2,-4,-5,0,-1,-1,1,-4,-3,0,-3,-2,1,0,-2,0,11,11,0,5,-2,7,1,-4,3,-5,1,15,-2,-1,3,0,2,8,3,-3,0,-5,-1,7,4,-1,1,-2,2,0,0,0,0,-3,0,0,4,-1,1,1,2,0,-38,-25,-13,-14,-12,-2,-4,-8,-12,-5,-9,1,-1,-1,-6,-5,-7,-4,-3,-7,-6,0,-2,5,-5,-1,-3,-7,2,0,-4,-1,-2,-7,2,0,-1,0,-1,0,0,0,-24,-10,-14,-8,-4,-4,-10,-5,0,-12,-4,6,-5,0,-1,-4,-1,2,-5,-5,1,-8,-3,4,-4,-1,1,-4,-1,0,0,0,-2,-2,0,0,-4,-1,3,-2,-1,0,-18,-19,1,-4,-10,6,1,-8,-9,7,-15,4,0,-3,-10,2,-9,-1,1,-5,1,5,-6,5,1,0,-2,-4,1,0,0,0,-6,-3,-1,0,1,0,4,-1,2,0,12,6,6,12,3,9,-1,1,-11,10,2,12,-4,3,-5,9,-2,5,3,-2,-6,1,4,7,6,4,2,0,0,0,2,2,0,-1,0,0,4,2,2,1,0,0
2,02003,Albacete,147527,1392,719,673,930,526,404,169,347,527,222,27,99,80,204,271,115,-4,53,89,143,256,107,31,46,98,256,359,161,41,10,46,161,214,80,15,7,52,95,145,81,26,3,1695,928,767,1605,901,704,225,430,592,346,59,46,108,216,354,202,11,43,117,214,238,144,48,3,210,415,584,315,55,10,106,225,347,187,24,3,104,190,237,128,31,7,993,540,453,1299,755,544,358,217,306,157,-32,-9,176,118,188,85,-19,3,182,99,118,72,-13,-12,227,358,406,221,56,21,119,200,276,122,28,7,108,158,130,99,28,14,930,392,538,1229,653,576,308,243,208,141,-9,53,146,143,88,51,-28,6,162,100,120,90,19,47,235,327,397,191,54,22,116,188,219,103,19,8,119,139,178,88,35,14,1910,915,995,1707,894,813,431,420,588,299,41,123,211,225,294,134,-6,48,220,195,294,165,47,75,322,451,586,257,61,17,158,238,334,132,20,6,164,213,252,125,41,11,2191,1276,915,1859,1024,835,381,605,776,340,11,71,217,330,489,220,-19,34,164,275,287,120,30,37,327,516,623,279,85,19,167,267,378,170,31,2,160,249,245,109,54,17,2291,1356,935,2071,1170,901,421,714,888,278,-52,31,184,437,601,156,-39,8,237,277,287,122,-13,23,389,631,639,297,76,27,206,365,391,158,31,12,183,266,248,139,45,15,1478,697,781,1784,1015,769,291,559,424,166,-35,82,148,302,195,51,-32,42,143,257,229,115,-3,40,297,650,501,243,71,12,152,375,303,139,37,7,145,275,198,104,34,5,1637,774,863,1253,696,557,336,412,457,313,40,79,159,225,207,124,26,35,177,187,250,189,14,44,188,370,434,169,75,8,99,216,261,82,33,0,89,154,173,87,42,8,356,58,298,-191,-201,10,150,69,39,22,-10,92,74,-13,-25,-1,-3,26,76,82,64,23,-7,66,67,14,-146,-100,-33,0,33,-6,-116,-93,-25,1,34,20,-30,-7,-8,-1,236,-112,348,-53,-150,97,182,45,106,-146,-70,114,102,-37,-39,-142,-47,58,80,82,145,-4,-23,56,72,65,-55,-87,-57,-4,28,16,-79,-96,-24,-1,44,49,24,9,-33,-3,447,141,306,248,60,188,101,77,61,107,-32,124,60,56,-25,24,-28,44,41,21,86,83,-4,80,64,124,15,23,6,7,34,48,-9,-6,-8,-3,30,76,24,29,14,10,0,-97,97,-294,-237,-57,167,-1,-188,-55,4,75,93,-29,-150,-44,-6,40,74,28,-38,-11,10,35,46,7,-238,-120,10,-8,41,-6,-183,-89,-4,-1,5,13,-55,-31,14,-7,-561,-508,-53,-402,-308,-94,10,-71,-307,-196,-7,22,-4,-52,-243,-158,-50,10,14,-19,-64,-38,43,12,-16,-43,-173,-142,-24,-7,-12,-28,-146,-103,-21,0,-4,-15,-27,-39,-3,-7,-289,-101,-188,404,261,143,50,-36,-202,-28,-82,27,22,27,-74,-21,-36,-5,28,-63,-128,-7,-46,32,62,121,113,69,19,11,24,77,91,48,11,4,38,44,22,21,8,7,256,133,123,161,109,52,57,-24,-135,109,82,161,35,-8,-72,71,34,70,22,-16,-63,38,48,91,26,82,-8,18,22,10,23,55,1,17,5,4,3,27,-9,1,17,6,347,49,298,315,143,172,178,26,-33,7,26,149,83,16,-46,-34,-19,63,95,10,13,41,45,86,101,120,53,18,9,7,48,72,23,0,0,-2,53,48,30,18,9,9,-418,-299,-119,2,1,1,87,-75,-229,-250,-41,56,40,-24,-149,-183,-40,36,47,-51,-80,-67,-1,20,38,68,12,-94,-29,-14,17,40,18,-61,-25,-3,21,28,-6,-33,-4,-11
2,02009,Almansa,23612,9,8,1,85,35,50,-2,-2,27,7,-18,-5,1,-1,13,3,-8,-3,-3,-1,14,4,-10,-2,4,29,28,19,2,3,1,9,16,7,1,1,3,20,12,12,1,2,316,165,151,236,119,117,48,68,113,57,12,13,22,34,66,32,9,-1,26,34,47,25,3,14,46,53,84,47,3,2,21,29,44,23,1,1,25,24,40,24,2,1,284,155,129,178,93,85,49,41,88,58,5,27,28,15,48,47,-2,10,21,26,40,11,7,17,37,50,44,38,4,1,19,26,25,22,-1,0,18,24,19,16,5,1,229,114,115,164,86,78,43,35,85,19,7,33,18,27,39,14,1,10,25,8,46,5,6,23,33,45,51,27,3,5,17,24,25,16,1,3,16,21,26,11,2,2,313,137,176,236,98,138,50,79,65,46,18,46,26,16,37,28,8,16,24,63,28,18,10,30,33,81,62,51,5,3,17,17,35,25,2,1,16,64,27,26,3,2,248,144,104,199,100,99,51,31,79,46,16,17,36,23,42,27,4,4,15,8,37,19,12,13,37,57,57,23,15,7,21,24,30,13,9,2,16,33,27,10,6,5,157,99,58,199,119,80,48,-22,76,33,11,5,18,-9,63,19,6,1,30,-13,13,14,5,4,33,38,74,42,7,3,19,23,50,23,3,1,14,15,24,19,4,2,254,158,96,241,120,121,88,29,79,28,13,12,51,19,50,16,12,6,37,10,29,12,1,6,66,55,72,31,16,0,34,20,41,16,7,2,32,35,31,15,9,-2,72,31,41,135,60,75,18,38,9,18,-2,-13,8,18,7,7,-2,-9,10,20,2,11,0,-4,32,35,43,23,-2,-1,18,15,16,7,-1,1,14,20,27,16,-1,-2,-102,-37,-65,-23,-21,-2,-17,-22,-18,-30,-16,3,-5,-4,-15,-14,-3,5,-12,-18,-3,-16,-13,-2,1,2,-9,-8,-7,-3,1,-1,-11,-6,-4,0,0,3,2,-2,-3,-3,-223,-122,-101,-62,-42,-20,-3,-75,-65,-64,-20,4,-7,-31,-29,-46,-6,-5,4,-44,-36,-18,-14,9,-1,-8,-21,-18,-10,-5,-4,-2,-16,-14,-5,-1,3,-6,-5,-4,-5,-4,-76,-21,-55,-15,3,-18,-9,-17,-28,-19,2,-7,-4,-7,-10,-1,0,0,-5,-10,-18,-18,2,-7,-11,0,-4,-1,3,-3,0,3,-3,3,2,-3,-11,-3,-1,-4,1,0,-116,-73,-43,-48,-39,-9,-15,-4,-31,-36,-30,-5,-7,-2,-22,-23,-17,-5,-8,-2,-9,-13,-13,0,-3,4,-18,-24,-6,-3,-2,0,-14,-18,-6,-1,-1,4,-4,-6,0,-2,-219,-93,-126,-93,-56,-37,-36,-51,-88,-49,-10,16,-16,-26,-40,-20,1,10,-20,-25,-48,-29,-11,6,-13,-10,-30,-27,-9,-4,-10,-7,-16,-17,-4,-2,-3,-3,-14,-10,-5,-2,-147,-67,-80,-61,-35,-26,-26,-35,-47,-16,-24,0,-17,-15,-23,-4,-15,7,-9,-20,-24,-12,-9,-7,-10,-8,-18,-10,-12,-4,1,-9,-14,-3,-9,-2,-11,1,-4,-7,-3,-2,-45,-56,11,-25,-16,-9,-7,-10,-45,-1,-12,28,-16,-7,-16,-11,-12,4,9,-3,-29,10,0,24,-2,1,-9,-17,-1,2,2,2,-5,-14,-2,0,-4,-1,-4,-3,1,2,-142,-74,-68,-25,-19,-6,-8,-44,-59,-30,-2,3,0,-19,-38,-24,4,5,-8,-25,-21,-6,-6,-2,-5,-9,-3,-8,-2,-1,0,-5,-3,-6,-4,-2,-5,-4,0,-2,2,1,5,-1,6,47,17,30,27,-36,-22,15,0,22,8,-9,-11,5,-4,9,19,-27,-11,10,4,13,8,16,23,-10,3,4,4,4,15,-10,1,2,4,12,8,0,2,2
2,02010,Alpera,2334,23,20,3,14,11,3,3,13,1,0,6,0,2,10,4,-1,6,-1,1,3,-3,1,0,1,1,9,4,0,0,0,1,7,3,0,0,0,0,2,1,0,0,0,6,1,5,12,4,8,6,3,-2,1,-3,2,1,0,0,-1,-2,3,5,3,-2,2,-1,-1,2,5,4,1,0,0,0,2,2,0,0,0,2,3,2,1,0,0,-19,-13,-6,5,4,1,-9,-3,-8,-5,5,1,-6,-3,-3,-1,0,0,-3,0,-5,-4,5,1,0,1,2,1,1,0,0,1,2,1,0,0,0,0,0,0,1,0,-1,6,-7,19,12,7,-4,2,-5,2,3,1,-1,2,0,1,5,0,-3,0,-5,1,-2,1,1,8,9,1,0,0,1,5,5,1,0,0,0,3,4,0,0,0,40,30,10,34,28,6,-3,4,6,13,13,5,0,2,7,11,6,2,-3,2,-1,2,7,3,3,10,11,7,1,0,2,8,9,6,1,0,1,2,2,1,0,0,5,-1,6,45,22,23,7,11,-3,-8,1,-1,5,5,-3,-7,0,0,2,6,0,-1,1,-1,11,20,11,3,0,0,3,10,8,1,0,0,8,10,3,2,0,0,-1,4,-5,35,23,12,-7,6,-18,3,13,3,-3,9,-11,-1,9,1,-4,-3,-7,4,4,2,1,14,11,6,3,0,0,11,6,3,3,0,1,3,5,3,0,0,5,-5,10,42,23,19,9,6,-17,3,6,-4,3,4,-10,-1,0,-3,6,2,-7,4,6,-1,4,17,14,4,1,0,1,9,9,2,0,0,3,8,5,2,1,0,23,3,20,18,6,12,7,10,4,3,2,-2,6,1,1,-2,-2,-1,1,9,3,5,4,-1,2,9,3,2,3,-1,2,2,2,0,0,0,0,7,1,2,3,-1,9,0,9,19,6,13,8,8,-9,4,-1,-2,2,0,-7,3,2,-1,6,8,-2,1,-3,-1,6,4,4,5,0,0,1,0,1,4,0,0,5,4,3,1,0,0,35,23,12,9,3,6,4,11,1,9,5,4,6,7,3,2,3,2,-2,4,-2,7,2,2,0,6,4,-1,-1,1,1,1,2,0,-1,0,-1,5,2,-1,0,1,-30,-23,-7,-8,-7,-1,-1,2,-21,-9,0,-1,-4,2,-15,-6,1,-1,3,0,-6,-3,-1,0,3,3,-9,-3,-2,0,1,2,-6,-3,-1,0,2,1,-3,0,-1,0,-3,4,-7,5,3,2,4,1,1,-4,0,-3,0,4,2,-1,1,-2,4,-3,-1,-3,-1,-1,1,3,0,0,0,0,0,2,0,0,0,0,1,1,0,0,0,0,-3,5,-8,3,1,2,2,0,-6,5,5,-7,2,4,-3,1,3,-1,0,-4,-3,4,2,-6,1,2,0,0,0,0,0,1,0,0,0,0,1,1,0,0,0,0,-6,-4,-2,14,8,6,1,-5,5,-3,-5,-1,5,-3,0,0,-5,-1,-4,-2,5,-3,0,0,3,2,3,2,1,1,4,1,2,1,0,0,-1,1,1,1,1,1,-7,-3,-4,11,7,4,-2,-2,-2,-1,1,0,-1,-2,-3,2,2,-1,-1,0,1,-3,-1,1,3,1,7,0,0,0,2,1,3,1,0,0,1,0,4,-1,0,0,13,13,0,17,11,6,3,-8,7,12,0,-4,2,-2,3,9,1,-1,1,-6,4,3,-1,-3,4,4,4,4,0,-1,2,2,3,3,0,0,2,2,1,1,0,-1,-5,2,-7,4,3,1,-5,-5,2,-5,3,4,-1,0,3,-4,2,1,-4,-5,-1,-1,1,3,0,0,1,1,2,0,0,0,1,1,1,0,0,0,0,0,1,0
2,02015,Barrax,1952,8,-4,12,11,2,9,6,2,-6,4,2,-1,1,-1,-6,1,1,-1,5,3,0,3,1,0,4,3,2,1,0,0,1,0,0,0,0,0,3,3,2,1,0,0,-11,-2,-9,9,4,5,-8,-1,-3,0,1,-1,-5,1,0,1,0,0,-3,-2,-3,-1,1,-1,1,2,4,2,0,0,0,0,4,0,0,0,1,2,0,2,0,0,30,9,21,20,5,15,2,8,12,4,1,0,2,2,5,-1,0,0,0,6,7,5,1,0,4,7,6,2,1,0,1,1,3,0,0,0,3,6,3,2,1,0,17,16,1,29,14,15,1,4,7,1,0,0,0,4,6,3,-1,1,1,0,1,-2,1,-1,1,9,10,4,2,0,1,4,4,2,1,0,0,5,6,2,1,0,-14,1,-15,27,15,12,-4,0,-13,3,-1,0,-4,6,-7,5,-1,1,0,-6,-6,-2,0,-1,4,10,7,6,0,0,1,6,3,5,0,0,3,4,4,1,0,0,-2,-4,2,19,12,7,3,2,1,-1,0,-8,4,1,-2,-2,-2,-3,-1,1,3,1,2,-5,0,9,6,3,1,0,0,7,3,2,0,0,0,2,3,1,1,0,41,29,12,35,17,18,8,14,17,-3,1,3,6,7,12,1,1,1,2,7,5,-4,0,2,10,11,10,3,0,0,6,2,6,2,0,0,4,9,4,1,0,0,-1,-3,2,19,13,6,-2,7,-3,-3,0,0,-6,5,0,0,-1,-1,4,2,-3,-3,1,1,0,12,5,1,1,0,0,8,3,1,1,0,0,4,2,0,0,0,-4,1,-5,17,7,10,0,-2,-3,4,1,-4,0,-2,-1,7,0,-3,0,0,-2,-3,1,-1,4,4,3,3,2,1,1,1,1,3,1,0,3,3,2,0,1,1,0,11,-11,6,5,1,-1,2,0,-2,3,-1,3,5,3,0,0,0,-4,-3,-3,-2,3,-1,0,3,2,1,0,0,0,3,2,0,0,0,0,0,0,1,0,0,9,4,5,16,8,8,5,-3,-4,10,-1,2,5,-2,-2,3,-1,1,0,-1,-2,7,0,1,2,4,4,5,1,0,1,3,2,2,0,0,1,1,2,3,1,0,-35,-15,-20,5,3,2,-7,1,-12,-11,2,-6,-2,2,-7,-5,1,-2,-5,-1,-5,-6,1,-4,0,3,1,1,0,0,0,2,0,1,0,0,0,1,1,0,0,0,-36,-16,-20,3,2,1,-9,-6,-12,-4,0,-4,-4,-5,-2,-4,1,-2,-5,-1,-10,0,-1,-2,1,0,1,1,0,0,1,0,1,0,0,0,0,0,0,1,0,0,3,-1,4,6,4,2,2,7,-6,-4,4,-2,6,5,-7,-6,2,-1,-4,2,1,2,2,-1,1,1,2,1,0,0,1,1,1,1,0,0,0,0,1,0,0,0,-12,-5,-7,17,10,7,-1,-5,-2,-1,-2,-1,-3,1,-4,3,-1,-2,2,-6,2,-4,-1,1,5,4,2,5,1,0,2,3,1,3,1,0,3,1,1,2,0,0,-13,-11,-2,1,-1,2,-2,-11,2,-1,-1,0,-4,-6,0,-1,0,0,2,-5,2,0,-1,0,0,-1,2,0,0,0,0,-1,0,0,0,0,0,0,2,0,0,0,-12,-13,1,4,0,4,3,4,-9,3,-4,-7,-4,1,-7,2,-2,-1,7,3,-2,1,-2,-6,2,1,0,1,0,0,0,0,0,0,0,0,2,1,0,1,0,0,12,3,9,12,4,8,12,2,0,-3,-2,2,5,0,2,-3,-2,1,7,2,-2,0,0,1,5,1,3,1,1,0,1,0,1,1,1,0,4,1,2,0,0,0
2,02018,Bonete,1222,14,6,8,11,6,5,2,4,7,5,-2,-2,2,2,3,2,-2,-1,0,2,4,3,0,-1,0,3,6,2,0,0,0,1,4,1,0,0,0,2,2,1,0,0,-5,1,-6,11,9,2,2,-4,-4,3,1,-3,4,-1,-3,3,1,-3,-2,-3,-1,0,0,0,5,2,1,3,0,0,5,1,1,2,0,0,0,1,0,1,0,0,25,20,5,8,7,1,-3,9,4,7,5,3,-3,7,4,7,4,2,0,2,0,0,1,1,1,1,3,3,0,0,1,0,3,3,0,0,0,1,0,0,0,0,23,16,7,35,22,13,8,6,5,-2,4,0,3,4,5,1,2,0,5,2,0,-3,2,0,8,7,11,5,3,0,1,7,7,5,1,0,7,0,4,0,2,0,32,15,17,36,21,15,2,13,3,12,0,2,3,7,1,6,-2,0,-1,6,2,6,2,2,9,10,11,6,0,0,7,5,4,5,0,0,2,5,7,1,0,0,20,19,1,22,17,5,5,2,4,9,4,-2,3,2,10,4,3,-1,2,0,-6,5,1,-1,3,9,8,2,0,0,3,5,8,1,0,0,0,4,0,1,0,0,-7,-7,0,32,17,15,9,-5,3,-8,0,-4,4,-4,3,-6,1,-3,5,-1,0,-2,-1,-1,9,6,12,3,0,2,5,5,5,2,-1,1,4,1,7,1,1,1,-18,-5,-13,17,9,8,-7,2,-8,-6,3,-1,-2,-1,-2,-2,2,0,-5,3,-6,-4,1,-1,4,3,4,0,4,2,2,2,3,0,1,1,2,1,1,0,3,1,8,8,0,20,10,10,-1,-2,2,6,0,3,1,-1,1,6,1,0,-2,-1,1,0,-1,3,3,6,8,3,-1,1,3,2,4,2,-1,0,0,4,4,1,0,1,2,-7,9,8,5,3,3,-1,0,-5,0,4,1,-1,-2,-5,-1,1,2,0,2,0,1,3,0,0,6,2,0,0,0,0,4,1,0,0,0,0,2,1,0,0,7,-2,9,17,5,12,2,10,-1,1,-1,-3,-1,1,-2,1,-1,0,3,9,1,0,0,-3,2,8,5,2,0,0,1,0,4,0,0,0,1,8,1,2,0,0,-6,3,-9,8,4,4,4,3,-9,-1,2,-4,6,3,-6,1,1,-1,-2,0,-3,-2,1,-3,2,2,4,0,0,0,2,1,2,-1,0,0,0,1,2,1,0,0,-11,-7,-4,-1,-1,0,-7,1,-8,1,2,-2,-7,0,1,-1,2,-3,0,1,-9,2,0,1,-3,0,1,-2,2,0,-1,0,0,-2,1,0,-2,0,1,0,1,0,-45,-19,-26,2,2,0,-8,-1,-15,-10,-4,-5,-2,0,-7,-5,-1,-3,-6,-1,-8,-5,-3,-2,0,0,2,0,0,0,0,0,2,0,0,0,0,0,0,0,0,0,-19,-12,-7,0,1,-1,3,-3,-14,-6,1,0,2,-1,-9,-4,0,0,1,-2,-5,-2,1,0,3,0,-1,-2,0,0,2,0,1,-2,0,0,1,0,-2,0,0,0,-24,-7,-17,-7,0,-7,0,-1,-6,-6,-5,-7,0,1,-1,-4,-2,-2,0,-2,-5,-2,-3,-5,1,-1,-3,-3,-1,-1,1,1,-1,-2,0,0,0,-2,-2,-1,-1,-1,-7,-10,3,0,-1,1,1,-1,-2,-2,3,-5,0,1,-3,-2,0,-5,1,-2,1,0,3,0,0,0,1,-1,1,-1,0,0,1,-1,0,-1,0,0,0,0,1,0,-41,-22,-19,-2,-1,-1,-7,-12,-16,-3,-2,0,-3,-8,-9,1,-1,-1,-4,-4,-7,-4,-1,1,-1,-1,1,0,-1,0,0,-1,0,0,0,0,-1,0,1,0,-1,0
2,02019,"Bonillo, El",3278,6,14,-8,17,10,7,0,-2,-3,3,2,5,5,2,-1,5,1,2,-5,-4,-2,-2,1,3,4,3,2,8,0,0,3,3,0,4,0,0,1,0,2,4,0,0,8,9,-1,34,25,9,1,0,4,7,-4,1,-1,-1,6,7,-1,0,2,1,-2,0,-3,1,5,6,11,12,0,0,2,4,9,10,0,0,3,2,2,2,0,0,-44,-20,-24,12,8,4,-8,-3,-17,-18,2,1,-3,-5,-6,-8,2,1,-5,2,-11,-10,0,0,3,3,4,0,0,2,3,2,2,0,0,1,0,1,2,0,0,1,-28,-14,-14,16,5,11,-6,-9,-11,-6,4,0,-3,-1,-10,-2,2,0,-3,-8,-1,-4,2,0,4,0,5,4,2,1,2,0,2,1,0,0,2,0,3,3,2,1,-10,-16,6,10,3,7,2,-4,0,-4,-2,-2,0,-7,-5,-2,-1,-1,2,3,5,-2,-1,-1,2,2,2,4,0,0,1,0,0,2,0,0,1,2,2,2,0,0,4,-4,8,15,3,12,10,0,-9,0,3,-2,-1,-3,-2,1,1,0,11,3,-7,-1,2,-2,8,5,2,0,0,0,1,1,1,0,0,0,7,4,1,0,0,0,-2,-4,2,14,7,7,0,0,-15,2,5,6,2,0,-8,-4,3,3,-2,0,-7,6,2,3,2,3,2,5,0,2,1,2,2,1,0,1,1,1,0,4,0,1,-42,-12,-30,6,3,3,-5,-8,-16,-9,1,-5,-1,-4,-7,0,3,-3,-4,-4,-9,-9,-2,-2,1,4,1,0,0,0,1,1,1,0,0,0,0,3,0,0,0,0,-11,0,-11,10,3,7,2,-8,-10,3,-1,1,-1,-3,0,1,0,3,3,-5,-10,2,-1,-2,3,0,1,5,0,0,1,0,0,2,0,0,2,0,1,3,0,0,-2,3,-5,8,2,6,5,-4,1,5,1,-9,2,-2,5,2,1,-4,3,-2,-4,3,0,-5,0,2,2,2,2,0,0,0,0,1,1,0,0,2,2,1,1,0,-7,-5,-2,-7,-2,-5,0,-1,-9,-4,3,3,0,3,-10,0,2,0,0,-4,1,-4,1,3,-1,-1,0,-4,0,-2,-1,0,0,0,0,-1,0,-1,0,-4,0,-1,-3,-1,-2,6,4,2,6,-4,8,-9,-1,-4,4,-3,2,-3,0,-2,2,-1,6,-6,-1,-2,1,0,3,0,0,1,0,0,2,0,0,1,1,0,1,0,0,0,-33,-16,-17,-6,-3,-3,-7,-7,-13,2,-2,-7,-2,-1,-8,0,-1,-5,-5,-6,-5,2,-1,-2,-3,-2,-2,1,-1,1,-2,0,-1,0,0,0,-1,-2,-1,1,-1,1,17,7,10,-4,-2,-2,1,0,-2,8,7,2,-2,2,0,0,5,2,3,-2,-2,8,2,0,-2,0,-1,-1,0,0,-1,0,0,-1,0,0,-1,0,-1,0,0,0,-8,-6,-2,1,-1,2,-2,5,-6,-9,1,2,-1,0,-4,-3,0,2,-1,5,-2,-6,1,0,0,2,1,-2,0,0,0,1,0,-2,0,0,0,1,1,0,0,0,-13,3,-16,5,5,0,1,-8,-2,-3,2,-2,3,-4,-1,3,2,0,-2,-4,-1,-6,0,-2,3,0,2,2,-2,0,2,0,1,3,-1,0,1,0,1,-1,-1,0,-11,5,-16,2,1,1,-12,-2,3,1,-4,4,-4,1,3,2,-1,3,-8,-3,0,-1,-3,1,0,1,0,0,1,0,0,1,0,-1,1,0,0,0,0,1,0,0,-2,-10,8,5,3,2,6,4,-10,-4,3,0,3,-1,-8,-3,-1,1,3,5,-2,-1,4,-1,0,5,2,-4,2,0,1,1,1,-1,1,0,-1,4,1,-3,1,0
2,02024,Casas-Ibáñez,4097,31,7,24,18,9,9,6,5,-3,8,4,9,4,-3,-5,7,2,1,2,8,2,1,2,8,6,5,3,2,1,0,3,1,2,2,1,0,3,4,1,0,0,0,60,29,31,42,26,16,0,16,15,-2,17,12,0,9,6,-1,9,5,0,7,9,-1,8,7,6,6,18,4,6,1,3,3,10,4,4,1,3,3,8,0,2,0,75,46,29,53,38,15,17,13,19,18,-6,13,9,9,17,11,-5,7,8,4,2,7,-1,6,10,10,21,9,1,1,8,8,16,5,1,0,2,2,5,4,0,1,44,25,19,44,24,20,3,-3,18,-2,10,17,-1,4,13,-2,6,4,4,-7,5,0,4,13,7,18,13,3,2,0,4,10,7,2,0,0,3,8,6,1,2,0,34,21,13,56,31,25,-1,0,13,18,5,1,-1,3,5,11,4,-1,0,-3,8,7,1,2,11,14,17,11,3,0,5,9,10,4,3,0,6,5,7,7,0,0,75,47,28,78,39,39,12,24,5,17,2,14,9,19,0,11,-1,8,3,5,5,6,3,6,11,30,21,12,3,0,9,16,6,9,-1,0,2,14,15,3,4,0,46,31,15,64,42,22,22,10,22,-6,0,0,11,4,15,-3,4,1,11,6,7,-3,-4,-1,12,29,16,6,1,1,7,17,13,4,1,0,5,12,3,2,0,1,138,83,55,134,85,49,19,54,30,13,6,13,12,34,24,6,-3,8,7,20,6,7,9,5,15,47,38,25,6,1,8,34,27,14,1,0,7,13,11,11,5,1,66,29,37,40,21,19,12,1,18,23,10,2,5,0,5,15,5,-1,7,1,13,8,5,3,9,9,10,8,2,2,5,4,5,6,0,1,4,5,5,2,2,1,36,22,14,16,7,9,2,8,19,11,-3,0,1,7,12,5,0,-2,1,1,7,6,-3,2,1,9,5,3,-1,-1,0,3,2,2,0,0,1,6,3,1,-1,-1,44,5,39,16,0,16,14,18,-11,11,10,0,8,8,-20,4,2,2,6,10,9,7,8,-2,4,4,-1,7,4,-2,1,-1,-5,4,1,0,3,5,4,3,3,-2,34,31,3,11,9,2,14,2,7,5,8,-4,7,0,21,2,5,-5,7,2,-14,3,3,1,1,1,11,-2,-1,1,0,2,8,-1,0,0,1,-1,3,-1,-1,1,-24,3,-27,-14,-8,-6,7,-6,-3,-12,0,-12,5,3,-2,-6,2,0,2,-9,-1,-6,-2,-12,1,-4,-4,-6,-3,0,3,-3,-5,-2,-2,0,-2,-1,1,-4,-1,0,-72,-45,-27,-36,-21,-15,-9,-20,-24,-9,1,-9,-4,-17,-15,-3,-2,-4,-5,-3,-9,-6,3,-5,-5,-5,-14,-9,-1,-1,-3,-3,-8,-7,1,-1,-2,-2,-6,-2,-2,0,-69,-46,-23,-52,-38,-14,-8,-7,-16,-29,-11,2,-8,-7,-14,-12,-8,3,0,0,-2,-17,-3,-1,2,0,-23,-22,-4,-5,0,-4,-17,-14,-2,-1,2,4,-6,-8,-2,-4,-75,-56,-19,-44,-34,-10,-10,-13,-33,-5,-10,0,-5,-9,-20,-8,-8,-2,-5,-4,-13,3,-2,2,0,-6,-23,-10,-4,-1,0,-4,-12,-12,-5,-1,0,-2,-11,2,1,0,20,1,19,3,-1,4,12,4,4,-2,0,-1,3,5,-7,0,0,-1,9,-1,11,-2,0,0,0,3,-2,6,-2,-2,-2,4,-2,2,-1,-2,2,-1,0,4,-1,0,-27,-27,0,-4,-7,3,-5,1,-10,-6,-6,-1,-5,-3,-7,-4,-9,0,0,4,-3,-2,3,-1,4,5,-6,-2,-5,0,1,3,-6,-1,-4,0,3,2,0,-1,-1,0
2,02025,Caudete,8909,83,65,18,95,58,37,27,27,32,8,-6,-5,15,24,25,7,0,-5,12,3,7,1,-6,0,18,25,35,12,2,2,9,20,20,8,1,0,9,5,15,4,1,2,206,114,92,158,103,55,32,61,58,28,12,15,17,30,44,18,3,3,15,31,14,10,9,12,30,47,53,25,3,0,16,30,40,16,1,0,14,17,13,9,2,0,59,32,27,103,59,44,10,36,-2,3,-7,19,10,17,3,0,-5,6,0,19,-5,3,-2,13,26,34,29,9,1,3,15,20,13,8,0,2,11,14,16,1,1,1,68,41,27,75,40,35,4,7,26,24,7,1,0,7,14,13,4,4,4,0,12,11,3,-3,11,20,24,14,4,2,4,13,11,7,3,2,7,7,13,7,1,0,102,68,34,114,62,52,15,13,45,14,10,3,6,10,28,14,5,4,9,3,17,0,5,-1,30,22,28,17,13,3,18,11,15,11,5,1,12,11,13,6,8,2,148,88,60,119,62,57,33,30,27,25,30,2,19,7,20,20,15,5,14,23,7,5,15,-3,29,25,29,21,14,1,15,11,16,14,6,0,14,14,13,7,8,1,196,136,60,182,106,76,40,35,54,37,32,0,15,34,50,21,11,5,25,1,4,16,21,-5,40,47,35,37,17,5,20,32,24,19,5,5,20,15,11,18,12,0,98,5,93,122,53,69,29,14,16,13,17,14,0,-10,3,9,6,-1,29,24,13,4,11,15,24,34,35,21,7,0,10,5,25,10,3,0,14,29,10,11,4,0,153,59,94,106,42,64,56,12,21,32,12,21,27,-4,7,6,11,11,29,16,14,26,1,10,33,17,24,18,14,0,19,0,13,4,7,-1,14,17,11,14,7,1,113,71,42,101,57,44,14,26,14,4,34,15,12,19,6,3,21,4,2,7,8,1,13,11,22,20,22,16,13,7,13,12,13,9,6,3,9,8,9,7,7,4,28,6,22,12,1,11,16,-16,-11,23,12,1,-1,-7,-9,13,8,0,17,-9,-2,10,4,1,6,-2,-3,3,7,0,6,-1,-6,-1,3,0,0,-1,3,4,4,0,58,26,32,23,4,19,8,20,0,17,3,8,6,8,3,12,-4,-3,2,12,-3,5,7,11,4,10,4,1,2,0,-2,3,0,0,2,-1,6,7,4,1,0,1,-62,-14,-48,6,0,6,-12,-6,-12,-22,-3,-6,-1,0,9,-13,-4,-2,-11,-6,-21,-9,1,-4,-2,3,6,-4,3,-1,1,0,0,-3,2,0,-3,3,6,-1,1,-1,-84,-30,-54,8,-2,10,-29,-23,-32,-4,1,0,-11,-5,-19,-1,2,1,-18,-18,-13,-3,-1,-1,2,-4,1,8,1,0,1,-6,0,4,-1,0,1,2,1,4,2,0,-265,-143,-122,-219,-125,-94,-44,-22,-48,-90,-56,-3,-22,-15,-26,-51,-23,-5,-22,-7,-22,-39,-33,2,-24,-21,-27,-67,-61,-20,-11,-17,-20,-38,-26,-13,-13,-4,-7,-29,-35,-7,-23,-2,-21,55,27,28,8,-15,-25,-7,5,10,12,-10,-8,-1,-2,7,-4,-5,-17,-6,7,3,12,3,10,6,16,8,7,0,4,4,9,3,5,3,6,2,7,5,-82,-49,-33,-23,-20,-3,1,-9,-31,-30,-7,-4,4,-6,-9,-25,-3,-7,-3,-3,-22,-5,-4,3,4,9,-11,-10,-12,-3,0,6,-8,-8,-6,-4,4,3,-3,-2,-6,1,-1,9,-10,70,37,33,-3,-17,-1,2,19,-1,2,-10,9,1,12,-1,-5,-7,-10,1,7,0,16,19,19,5,9,1,9,6,13,3,5,1,7,13,6,2,4,0
2,02029,Chinchilla de Monte-Aragón,3227,-3,7,-10,10,5,5,6,-6,-2,3,1,-6,3,0,4,3,-2,-2,3,-6,-6,0,3,-4,2,0,5,1,1,1,0,0,3,1,0,1,2,0,2,0,1,0,2,8,-6,7,3,4,-1,-3,-9,12,11,-8,-1,0,-4,10,7,-4,0,-3,-5,2,4,-4,0,4,2,1,0,0,0,3,0,0,0,0,0,1,2,1,0,0,10,11,-1,12,9,3,-3,3,2,3,6,-1,0,4,1,0,5,1,-3,-1,1,3,1,-2,2,4,4,2,0,0,2,3,2,2,0,0,0,1,2,0,0,0,96,56,40,15,7,8,19,18,33,33,-5,-3,11,6,20,24,-4,-1,8,12,13,9,-1,-2,4,3,5,3,0,0,2,0,4,1,0,0,2,3,1,2,0,0,106,65,41,55,33,22,15,30,42,12,3,2,8,15,29,11,0,2,7,15,13,1,3,0,13,16,21,3,0,2,7,8,14,3,0,1,6,8,7,0,0,1,145,76,69,25,12,13,21,28,62,27,8,-3,10,8,35,17,5,0,11,20,27,10,3,-3,3,7,9,5,0,0,2,2,5,3,0,0,1,5,4,2,0,0,90,41,49,23,13,10,13,19,54,3,6,-8,4,11,26,1,4,-4,9,8,28,2,2,-4,6,10,5,1,1,0,1,8,2,1,1,0,5,2,3,0,0,0,61,34,27,22,11,11,1,3,50,4,1,0,2,1,33,-1,-1,-2,-1,2,17,5,2,2,5,6,9,3,0,-1,2,3,7,0,0,-1,3,3,2,3,0,0,143,79,64,35,23,12,11,15,72,24,14,1,1,5,49,16,6,-2,10,10,23,8,8,3,7,7,11,8,1,0,2,5,9,6,0,0,5,2,2,2,1,0,75,34,41,11,5,6,5,3,50,4,9,-1,0,2,22,2,5,0,5,1,28,2,4,-1,2,5,2,0,0,2,2,2,1,-1,0,1,0,3,1,1,0,1,83,42,41,19,9,10,5,25,23,25,12,-11,1,10,16,13,6,-5,4,15,7,12,6,-6,8,4,7,-1,0,0,3,3,3,-1,0,0,5,1,4,0,0,0,93,38,55,18,9,9,4,31,31,17,10,-6,-1,9,15,3,10,-1,5,22,16,14,0,-5,5,1,5,4,1,0,3,-1,2,3,1,0,2,2,3,1,0,0,44,31,13,13,8,5,8,0,20,14,3,-5,8,0,14,7,0,0,0,0,6,7,3,-5,1,4,4,4,-1,1,0,4,3,1,-1,1,1,0,1,3,0,0,14,10,4,6,3,3,-7,11,22,-12,5,-6,-2,11,13,-11,3,-4,-5,0,9,-1,2,-2,-2,9,3,-3,0,0,-1,5,1,-1,0,0,-1,4,2,-2,0,0,6,4,2,-8,-6,-2,8,4,0,-7,1,-4,7,6,-1,-8,-2,-1,1,-2,1,1,3,-3,2,1,0,-8,-2,-2,3,2,-1,-8,0,-2,-1,-1,1,0,-2,0,-18,-2,-16,23,14,9,-11,-14,5,3,1,-6,-2,-10,2,9,-2,-3,-9,-4,3,-6,3,-3,7,7,0,2,4,0,3,4,1,1,2,0,4,3,-1,1,2,0,11,8,3,27,17,10,-12,11,1,9,8,-7,-12,10,0,7,6,-4,0,1,1,2,2,-3,2,8,9,6,1,1,2,4,7,4,0,0,0,4,2,2,1,1,-3,8,-11,13,5,8,-13,-1,1,6,5,2,-7,-4,7,8,5,1,-6,3,-6,-2,0,1,2,4,2,3,2,0,0,0,1,4,0,0,2,4,1,-1,2,0
2,02030,Elche de la Sierra,3936,10,3,7,10,4,6,5,0,-12,6,5,3,1,3,-11,1,2,4,4,-3,-1,5,3,-1,2,3,4,1,0,0,1,1,2,0,0,0,1,2,2,1,0,0,-38,-21,-17,13,2,11,0,-12,-14,-6,-2,-4,-4,-6,-5,-4,-2,0,4,-6,-9,-2,0,-4,6,2,4,1,0,0,1,0,1,0,0,0,5,2,3,1,0,0,22,18,4,23,12,11,8,8,-3,1,4,-3,5,2,-2,5,4,-1,3,6,-1,-4,0,-2,5,1,10,2,1,1,3,1,5,1,0,0,2,0,5,1,1,1,21,8,13,17,6,11,20,-5,-1,9,0,-3,7,-3,-4,6,3,0,13,-2,3,3,-3,-3,7,1,4,2,2,1,3,0,0,1,1,1,4,1,4,1,1,0,2,11,-9,15,8,7,11,-14,-3,9,6,-8,6,-8,2,7,3,-1,5,-6,-5,2,3,-7,8,3,1,3,0,0,3,2,1,2,0,0,5,1,0,1,0,0,37,24,13,18,9,9,11,5,-5,7,16,0,6,3,-3,3,9,4,5,2,-2,4,7,-4,9,2,1,5,1,0,6,1,0,1,1,0,3,1,1,4,0,0,26,19,7,22,13,9,6,7,-3,1,8,8,11,-1,1,-2,5,4,-5,8,-4,3,3,4,1,5,8,4,2,2,1,3,4,3,0,2,0,2,4,1,2,0,20,7,13,17,6,11,2,-5,2,14,4,5,-2,0,-2,8,-1,4,4,-5,4,6,5,1,1,2,4,3,4,3,1,0,1,2,0,2,0,2,3,1,4,1,31,6,25,6,4,2,11,3,4,7,-3,8,7,0,-1,-3,-1,4,4,3,5,10,-2,4,0,1,2,0,1,2,0,2,2,-2,1,1,0,-1,0,2,0,1,-7,3,-10,4,1,3,-16,17,-7,6,5,-11,-14,11,-2,7,4,-4,-2,6,-5,-1,1,-7,-1,3,-2,1,2,0,0,0,0,0,1,0,-1,3,-2,1,1,0,17,17,0,7,3,4,7,6,-1,6,3,-3,5,6,-2,12,0,-3,2,0,1,-6,3,0,0,5,2,2,0,-2,1,3,0,0,0,-1,-1,2,2,2,0,-1,16,9,7,8,6,2,3,-5,-3,13,5,1,0,-7,-2,10,6,1,3,2,-1,3,-1,0,2,2,1,0,2,1,1,1,1,0,2,1,1,1,0,0,0,0,-22,3,-25,-9,-4,-5,11,-5,-13,-4,6,-17,12,0,-5,-2,2,-4,-1,-5,-8,-2,4,-13,4,-2,-7,-1,-3,0,3,-1,-4,-1,-1,0,1,-1,-3,0,-2,0,-49,-24,-25,-7,-5,-2,-7,-10,-21,1,1,-12,-6,-3,-11,4,0,-7,-1,-7,-10,-3,1,-5,1,-2,-4,-1,-2,1,-1,-1,-1,0,-2,0,2,-1,-3,-1,0,1,-14,-12,-2,2,0,2,8,-2,-9,-18,5,-1,9,-2,-8,-18,4,2,-1,0,-1,0,1,-3,1,0,0,0,0,1,1,0,0,-2,0,1,0,0,0,2,0,0,-34,-28,-6,-6,-3,-3,-10,-6,-6,-4,-2,-4,-8,-4,-6,-3,-4,-2,-2,-2,0,-1,2,-2,-3,0,-1,-2,0,0,-2,0,0,-1,0,0,-1,0,-1,-1,0,0,-25,-5,-20,4,3,1,-5,-1,-7,-7,1,-5,-2,0,-4,-3,3,2,-3,-1,-3,-4,-2,-7,2,1,0,-1,0,2,1,1,0,0,0,1,1,0,0,-1,0,1,-16,-5,-11,7,5,2,9,-7,-17,-4,7,-5,6,-2,-4,-5,2,-3,3,-5,-13,1,5,-2,1,1,1,2,1,1,1,0,1,1,1,1,0,1,0,1,0,0
2,02033,Fuente-Álamo,2483,36,33,3,50,41,9,-1,10,17,9,4,-4,-1,9,17,8,2,-3,0,1,0,1,2,-1,5,12,18,11,4,0,3,10,15,10,3,0,2,2,3,1,1,0,108,57,51,84,48,36,33,21,29,17,4,4,12,10,18,11,2,3,21,11,11,6,2,1,22,20,33,9,0,0,10,11,20,7,0,0,12,9,13,2,0,0,40,28,12,50,30,20,2,17,1,17,2,-2,3,9,3,13,1,-2,-1,8,-2,4,1,0,2,15,16,15,1,0,2,8,9,11,0,0,0,7,7,4,1,0,49,42,7,76,47,29,13,11,5,16,4,0,9,8,4,15,4,2,4,3,1,1,0,-2,18,25,17,11,3,1,10,16,8,9,3,0,8,9,9,2,0,1,-11,-5,-6,33,19,14,-13,0,11,-8,-1,2,-11,6,8,-8,0,2,-2,-6,3,0,-1,0,5,9,12,6,0,0,2,7,6,4,0,0,3,2,6,2,0,0,43,34,9,76,49,27,16,19,0,3,1,2,10,19,4,-2,-2,3,6,0,-4,5,3,-1,15,33,10,15,1,0,5,24,7,11,0,0,10,9,3,4,1,0,-40,-17,-23,61,32,29,-21,-1,-10,-8,0,-2,-5,-2,-4,-3,-1,-3,-16,1,-6,-5,1,1,13,26,12,9,0,0,4,15,8,4,0,0,9,11,4,5,0,0,28,11,17,76,45,31,7,8,6,9,0,-1,4,2,2,7,-2,0,3,6,4,2,2,-1,13,24,24,12,2,1,6,14,14,8,2,1,7,10,10,4,0,0,5,3,2,4,5,-1,9,5,-8,-4,4,-1,7,6,-6,-7,3,0,2,-1,-2,3,1,-1,3,6,-2,-3,0,0,2,5,-1,-2,1,0,1,1,-1,-1,-1,0,-25,-11,-14,-2,-5,3,-5,-1,-18,1,6,-4,-5,-2,-10,1,5,0,0,1,-8,0,1,-4,-1,-3,-4,3,3,0,-3,-3,-5,4,2,0,2,0,1,-1,1,0,-33,-9,-24,-28,-21,-7,-7,-5,-15,-5,-1,1,-4,-5,3,-4,1,1,-3,0,-18,-1,-2,0,-1,-2,-12,-9,-4,0,-2,-1,-8,-8,-2,0,1,-1,-4,-1,-2,0,5,1,4,21,11,10,-5,10,2,6,0,-7,-4,-1,6,3,-1,-3,-1,11,-4,3,1,-4,2,12,5,3,-1,0,0,6,6,1,-2,0,2,6,-1,2,1,0,-1,-1,0,-9,-5,-4,14,-5,-7,-3,-2,1,5,-1,-8,1,2,0,9,-4,1,-4,-4,1,2,-1,-4,-6,-1,1,2,1,-3,-5,-1,1,0,-2,-1,-1,0,0,16,9,7,-5,-1,-4,5,-2,1,6,3,3,5,-1,0,2,1,2,0,-1,1,4,2,1,-1,0,-7,2,1,0,0,1,-5,3,0,0,-1,-1,-2,-1,1,0,-50,-32,-18,-25,-20,-5,-6,-4,-24,-10,-1,-5,-6,-1,-13,-7,-1,-4,0,-3,-11,-3,0,-1,-2,-2,-8,-11,-1,-1,-3,-3,-6,-7,0,-1,1,1,-2,-4,-1,0,-17,-12,-5,12,1,11,2,0,-10,-7,0,-2,-2,3,-4,-7,-1,-1,4,-3,-6,0,1,-1,9,6,-3,-2,2,0,4,3,-3,-4,1,0,5,3,0,2,1,0,-37,-24,-13,-8,-5,-3,-4,-12,-10,-3,-6,0,-2,-7,-6,-3,-4,-1,-2,-5,-4,0,-2,1,3,-3,-1,-2,-5,0,1,-2,0,-2,-2,0,2,-1,-1,0,-3,0,-33,-19,-14,3,0,3,-9,3,-8,-17,0,0,-3,-2,-3,-12,2,0,-6,5,-5,-5,-2,0,3,2,3,-3,-2,0,3,-1,2,-3,-1,0,0,3,1,0,-1,0
2,02034,Fuentealbilla,1803,21,7,14,20,10,10,8,4,4,7,2,-3,2,1,2,4,1,-2,6,3,2,3,1,-1,3,3,9,5,0,0,0,2,5,3,0,0,3,1,4,2,0,0,38,21,17,55,30,25,11,1,23,4,7,-8,3,-1,17,2,4,-4,8,2,6,2,3,-4,14,8,27,4,2,0,5,3,19,2,1,0,9,5,8,2,1,0,55,45,10,70,39,31,14,5,22,4,8,0,13,3,21,3,4,0,1,2,1,1,4,0,18,14,28,6,1,0,11,5,18,3,1,0,7,9,10,3,0,0,27,12,15,58,29,29,3,4,17,6,6,-9,1,7,7,-2,3,-4,2,-3,10,8,3,-5,13,12,21,9,3,0,9,7,11,1,1,0,4,5,10,8,2,0,23,7,16,75,35,40,-2,20,-6,5,4,3,3,11,-7,-2,2,1,-5,9,1,7,2,2,17,22,22,11,1,0,9,12,11,1,0,0,8,10,11,10,1,0,-4,1,-5,58,34,24,3,14,-11,-4,-3,-2,3,11,-8,0,-2,-2,0,3,-3,-4,-1,0,14,23,8,10,2,1,8,15,3,6,2,0,6,8,5,4,0,1,21,9,12,65,30,35,-5,16,-1,2,2,4,-5,12,1,2,0,-2,0,4,-2,0,2,6,8,27,12,16,0,1,1,18,6,6,-1,0,7,9,6,10,1,1,73,45,28,112,71,41,18,27,11,11,7,-5,11,14,9,9,3,-2,7,13,2,2,4,-3,19,42,34,11,3,-1,11,21,27,10,0,0,8,21,7,1,3,-1,43,21,22,28,15,13,7,10,20,-1,2,3,2,9,7,0,0,2,5,1,13,-1,2,1,6,7,8,6,1,0,2,6,4,3,0,0,4,1,4,3,1,0,-2,-6,4,14,6,8,2,-2,1,-1,2,-1,3,-5,0,-4,4,-3,-1,3,1,3,-2,2,3,4,3,1,1,2,3,0,1,0,1,1,0,4,2,1,0,1,-35,-15,-20,11,6,5,-13,-2,-3,-10,-2,-4,-6,1,-2,-4,-1,-4,-7,-3,-1,-6,-1,0,-1,4,3,4,0,1,1,2,2,1,0,0,-2,2,1,3,0,1,-6,-10,4,17,5,12,-2,7,-11,-4,1,3,-6,-1,-6,-1,1,3,4,8,-5,-3,0,0,4,9,2,1,0,1,1,3,0,1,0,0,3,6,2,0,0,1,-36,-18,-18,-12,-4,-8,-4,-7,-12,-9,0,-4,-2,-2,-10,-4,-1,1,-2,-5,-2,-5,1,-5,-2,-2,-2,-5,-1,0,-1,-1,-2,-1,0,1,-1,-1,0,-4,-1,-1,-15,-5,-10,-14,-8,-6,-4,5,2,-6,-7,-5,0,3,1,-5,-2,-2,-4,2,1,-1,-5,-3,-3,2,0,-8,-4,-1,0,1,0,-7,-1,-1,-3,1,0,-1,-3,0,-26,-19,-7,-31,-20,-11,-6,1,-19,0,-2,-1,-4,1,-14,-3,-1,1,-2,0,-5,3,-1,-2,-4,2,-23,0,-6,0,-3,2,-13,-1,-5,0,-1,0,-10,1,-1,0,-13,-5,-8,11,2,9,8,-5,-15,-1,1,-3,4,0,-11,1,-1,0,4,-5,-4,-2,2,-3,6,2,0,2,0,0,2,0,0,0,-1,0,4,2,0,2,1,0,-4,-6,2,5,0,5,2,2,-10,5,1,-4,0,-2,-2,2,-1,-2,2,4,-8,3,2,-2,1,1,2,0,1,0,1,0,1,-2,0,0,0,1,1,2,1,0,-52,-34,-18,-30,-21,-9,-1,2,-25,-14,-10,-3,-1,-1,-17,-8,-7,1,0,3,-8,-6,-3,-4,2,2,-18,-11,-4,-2,2,1,-12,-10,-2,0,0,1,-6,-1,-2,-2
2,02035,"Gineta, La",2064,6,9,-3,6,1,5,-3,6,3,4,-2,-2,-2,4,6,0,1,0,-1,2,-3,4,-3,-2,0,2,0,4,0,0,0,1,0,0,0,0,0,1,0,4,0,0,27,11,16,12,4,8,6,6,9,6,-1,0,2,3,4,2,-1,0,4,3,5,4,0,0,2,1,8,0,0,0,0,0,3,0,0,0,2,1,5,0,0,0,44,27,17,20,11,9,14,9,12,7,5,-6,6,8,8,3,3,-3,8,1,4,4,2,-3,4,6,6,3,0,0,2,3,4,1,0,0,2,3,2,2,0,0,27,21,6,11,6,5,2,6,2,14,1,2,3,7,2,9,-1,1,-1,-1,0,5,2,1,2,5,2,0,2,0,2,3,1,0,0,0,0,2,1,0,2,0,36,33,3,16,9,7,-2,16,8,8,6,0,3,8,9,8,6,-1,-5,8,-1,0,0,1,0,6,6,3,1,0,0,2,4,1,2,0,0,4,2,2,-1,0,66,40,26,44,28,16,24,3,13,17,6,2,14,0,6,13,5,0,10,3,7,4,1,2,10,6,11,12,2,1,6,2,6,10,2,0,4,4,5,2,0,1,83,54,29,18,11,7,8,11,27,12,17,9,7,10,19,6,8,5,1,1,8,6,9,4,6,5,2,1,3,1,3,5,1,0,2,0,3,0,1,1,1,1,47,26,21,20,13,7,2,16,19,17,0,-8,-1,10,11,10,1,-5,3,6,8,7,-1,-3,2,6,4,8,0,0,1,5,1,6,0,0,1,1,3,2,0,0,128,78,50,37,21,16,21,3,73,17,6,3,12,0,41,20,0,2,9,3,32,-3,6,1,10,10,10,5,2,0,6,6,5,2,2,0,4,4,5,3,0,0,59,42,17,15,9,6,14,9,18,18,2,-4,9,6,16,10,2,-2,5,3,2,8,0,-2,5,4,4,1,1,0,4,2,2,0,1,0,1,2,2,1,0,0,45,11,34,-2,-6,4,-4,13,0,30,5,2,-1,4,-7,13,2,0,-3,9,7,17,3,2,-6,4,-1,-1,0,2,-4,2,-3,-1,-1,1,-2,2,2,0,1,1,15,9,6,19,13,6,9,6,5,-2,-2,0,7,2,5,-4,1,-1,2,4,0,2,-3,1,6,7,2,2,0,2,3,4,2,2,1,1,3,3,0,0,-1,1,-16,-11,-5,-3,-2,-1,-3,0,-4,-13,3,0,1,-5,2,-9,3,-2,-4,5,-6,-4,0,2,1,1,1,-3,-1,-2,1,-1,1,-2,0,-1,0,2,0,-1,-1,-1,-59,-37,-22,-24,-18,-6,-14,-8,1,-24,-9,-3,-7,-6,1,-17,-6,-2,-7,-2,0,-7,-3,-1,3,-4,-8,-11,-4,0,2,-2,-5,-9,-4,0,1,-2,-3,-2,0,0,42,17,25,-4,-3,-1,10,1,7,15,4,5,4,1,1,9,2,2,6,0,6,6,2,3,-2,-1,-3,2,-1,1,0,0,-2,0,-2,1,-2,-1,-1,2,1,0,-33,-12,-21,-4,-3,-1,-17,2,-11,-9,4,-5,-12,5,-3,-6,4,-3,-5,-3,-8,-3,0,-2,-5,1,1,0,-1,0,-3,0,1,0,-1,0,-2,1,0,0,0,0,-50,-28,-22,1,-1,2,-5,-6,-24,-13,2,-1,-1,-3,-12,-13,3,-1,-4,-3,-12,0,-1,0,0,1,-3,0,3,0,1,1,-3,-1,1,0,-1,0,0,1,2,0,6,7,-1,5,3,2,6,7,-8,4,-3,-1,4,3,-4,5,-2,1,2,4,-4,-1,-1,-2,0,2,-2,3,1,1,0,1,-1,2,0,1,0,1,-1,1,1,0
2,02037,Hellín,26205,926,559,367,899,555,344,108,244,329,180,52,8,49,140,214,124,23,9,59,104,115,56,29,-1,89,254,373,159,17,3,39,157,236,110,10,1,50,97,137,49,7,2,338,191,147,435,263,172,64,85,105,46,34,1,32,58,64,17,15,2,32,27,41,29,19,-1,67,134,146,71,11,5,33,88,91,43,4,3,34,46,55,28,7,2,488,265,223,606,344,262,142,141,110,77,11,3,81,70,56,51,9,-4,61,71,54,26,2,7,134,176,174,91,17,10,69,102,102,61,5,3,65,74,72,30,12,7,420,259,161,577,314,263,106,69,133,65,34,11,56,34,87,45,23,11,50,35,46,20,11,0,123,137,192,88,18,11,63,65,114,52,9,7,60,72,78,36,9,4,426,212,214,547,296,251,60,138,145,37,32,4,24,58,105,5,18,-2,36,80,40,32,14,6,53,182,209,74,18,5,23,96,120,46,8,2,30,86,89,28,10,3,220,137,83,447,227,220,52,52,60,28,37,-3,32,32,40,18,12,3,20,20,20,10,25,-6,87,122,135,69,22,8,40,54,76,42,10,4,47,68,59,27,12,4,852,462,390,896,481,415,199,233,237,123,38,8,93,135,131,69,21,4,106,98,106,54,17,4,190,249,283,130,27,6,88,138,163,75,10,1,102,111,120,55,17,5,586,382,204,497,285,212,157,152,131,93,44,0,71,122,101,56,23,3,86,30,30,37,21,-3,100,164,143,68,12,4,43,103,87,43,4,2,57,61,56,25,8,2,-15,-63,48,-41,-55,14,-31,16,-27,-6,10,28,-24,-15,-26,-17,8,14,-7,31,-1,11,2,14,-30,7,-18,-9,5,3,-20,-5,-16,-16,1,1,-10,12,-2,7,4,2,73,68,5,-15,-18,3,54,-17,-29,35,20,6,38,-15,-8,32,13,3,16,-2,-21,3,7,3,19,-8,-16,-6,-13,6,22,-14,-23,-3,-8,5,-3,6,7,-3,-5,1,-54,-56,2,21,-24,45,-17,-4,-61,13,22,-12,-6,-26,-44,11,11,-5,-11,22,-17,2,11,-7,9,15,-31,18,1,3,-3,-3,-19,1,-3,1,12,18,-12,17,4,2,165,62,103,181,70,111,43,6,71,28,11,7,10,6,20,15,0,13,33,0,51,13,11,-6,39,24,63,41,10,3,14,10,24,17,3,1,25,14,39,24,7,2,-84,-78,-6,71,27,44,-2,-41,-31,-44,21,14,-11,-19,-30,-27,7,7,9,-22,-1,-17,14,7,6,16,17,16,12,3,8,6,4,6,1,2,-2,10,13,10,11,1,-126,-58,-68,30,6,24,-22,-9,-61,2,-23,-12,-21,-1,-13,-4,-11,-4,-1,-8,-48,6,-12,-8,8,12,1,9,0,-1,6,5,-4,-1,0,0,2,7,5,10,0,-1,-58,-29,-29,42,12,30,-18,-29,-5,-4,-3,6,-14,-16,-6,-6,4,10,-4,-13,1,2,-7,-4,6,11,17,6,-4,3,1,4,4,4,-4,1,5,7,13,2,0,2,-50,20,-70,90,47,43,-31,-5,-49,31,3,1,1,2,-16,24,11,-2,-32,-7,-33,7,-8,3,24,21,27,21,-1,-4,12,16,11,10,-1,-2,12,5,16,11,0,-2,-145,-70,-75,82,27,55,-20,-9,-64,-54,-3,6,0,-15,-18,-43,6,3,-20,6,-46,-11,-9,3,14,25,26,10,1,3,12,3,17,-10,3,1,2,22,9,20,-2,2,107,91,16,211,147,64,28,43,9,32,-1,-5,13,37,12,22,4,3,15,6,-3,10,-5,-8,26,68,75,21,13,7,18,55,51,12,7,4,8,13,24,9,6,3
2,02045,Madrigueras,4536,3,7,-4,15,9,6,4,6,-6,-2,4,-3,3,4,0,-1,2,-2,1,2,-6,-1,2,-1,2,4,5,0,3,0,1,3,3,0,1,0,1,1,2,0,2,0,24,7,17,26,14,12,-1,4,3,4,8,5,-2,2,1,1,2,3,1,2,2,3,6,2,4,9,6,2,5,0,1,5,5,1,2,0,3,4,1,1,3,0,40,28,12,42,26,16,8,10,9,7,5,2,5,7,6,5,4,2,3,3,3,2,1,0,5,13,14,7,3,0,3,8,8,5,2,0,2,5,6,2,1,0,36,28,8,30,20,10,-2,15,11,7,2,3,1,9,8,7,2,1,-3,6,3,0,0,2,1,11,8,6,3,1,1,8,5,3,2,1,0,3,3,3,1,0,53,49,4,58,40,18,0,18,18,14,-1,2,7,10,20,11,-1,2,-7,8,-2,3,0,0,3,19,26,10,0,0,3,10,20,8,-1,0,0,9,6,2,1,0,88,48,40,79,44,35,13,10,24,17,1,18,6,6,17,10,-1,8,7,4,7,7,2,10,10,24,19,19,2,1,4,13,12,11,1,1,6,11,7,8,1,0,7,17,-10,33,25,8,-3,6,-9,-1,6,7,2,4,3,-1,4,4,-5,2,-12,0,2,3,6,9,5,7,4,1,4,4,9,4,2,1,2,5,-4,3,2,0,134,74,60,88,63,25,12,35,43,20,3,19,5,22,25,12,1,8,7,13,18,8,2,11,6,38,26,15,2,1,3,26,22,11,0,1,3,12,4,4,2,0,83,40,43,46,25,21,21,25,21,14,2,-2,8,10,14,7,1,-2,13,15,7,7,1,0,11,8,19,9,0,-1,4,3,14,5,0,-1,7,5,5,4,0,0,-31,-24,-7,-14,-14,0,7,-5,-34,-7,1,6,8,-3,-28,-9,1,4,-1,-2,-6,2,0,2,6,-3,-14,-2,-2,0,1,-1,-12,-1,-2,0,5,-2,-2,-1,0,0,-76,-35,-41,-24,-21,-3,-5,-14,-32,-15,-6,-5,1,-6,-14,-11,-3,-2,-6,-8,-18,-4,-3,-3,-1,6,-14,-13,-1,-1,0,1,-9,-12,0,-1,-1,5,-5,-1,-1,0,4,5,-1,-21,-12,-9,7,-3,-10,-4,6,6,5,-1,-1,-3,4,0,2,-2,-9,-1,2,6,-1,-3,-13,-6,1,0,-1,-3,-6,-2,0,0,0,0,-7,-4,1,0,-36,-16,-20,-3,0,-3,-8,-12,-15,2,-4,2,0,-5,-11,2,-3,1,-8,-7,-4,0,-1,1,0,3,-4,-2,0,0,0,2,-2,-1,0,1,0,1,-2,-1,0,-1,2,-9,11,7,4,3,5,6,-15,12,-6,0,1,4,-12,5,-5,0,4,2,-3,7,-1,0,1,4,-1,4,-2,-1,2,4,-1,1,-1,-1,-1,0,0,3,-1,0,7,20,-13,7,7,0,1,-3,12,-3,2,-2,4,-3,13,2,4,0,-3,0,-1,-5,-2,-2,1,1,1,3,1,0,-1,-1,6,2,1,0,2,2,-5,1,0,0,-35,-20,-15,-1,-3,2,-2,-13,-11,-5,-5,0,-2,-5,-8,-4,0,-1,0,-8,-3,-1,-5,1,0,-2,0,0,1,0,0,-1,-2,-1,1,0,0,-1,2,1,0,0,10,-2,12,20,9,11,-2,-1,-1,6,4,3,-6,1,-1,0,2,0,4,-2,0,6,2,3,7,2,4,5,2,0,3,2,1,1,2,0,4,0,3,4,0,0,28,3,25,6,-1,7,10,2,1,5,3,8,4,0,-6,0,3,3,6,2,7,5,0,5,4,1,4,-4,2,0,0,0,2,-4,2,0,4,1,2,0,0,0
2,02051,Montealegre del Castillo,2144,74,49,25,38,27,11,11,24,16,19,0,4,4,12,13,15,1,4,7,12,3,4,-1,0,5,16,11,6,0,0,3,10,9,5,0,0,2,6,2,1,0,0,55,31,24,51,29,22,4,27,30,-2,-1,-4,5,18,15,-2,-1,-4,-1,9,15,0,0,0,13,16,20,2,0,0,7,9,11,2,0,0,6,7,9,0,0,0,15,7,8,47,28,19,1,4,-2,-2,7,9,2,1,1,-3,2,3,-1,3,-3,1,5,6,14,16,11,5,1,0,9,8,8,3,0,0,5,8,3,2,1,0,20,5,15,27,14,13,7,-7,3,0,8,11,0,-1,1,0,3,4,7,-6,2,0,5,7,7,9,4,5,2,0,4,4,1,5,0,0,3,5,3,0,2,0,9,12,-3,10,8,2,-8,5,-4,7,2,6,-2,8,-1,3,1,3,-6,-3,-3,4,1,3,0,4,6,0,0,0,0,2,6,0,0,0,0,2,0,0,0,0,44,19,25,29,16,13,14,12,6,7,1,3,13,2,-4,3,2,2,1,10,10,4,-1,1,6,7,13,3,0,0,5,1,7,3,0,0,1,6,6,0,0,0,23,14,9,37,26,11,-10,13,9,-2,4,6,-10,9,7,2,0,3,0,4,2,-4,4,3,1,18,13,3,0,0,1,11,10,2,0,0,0,7,3,1,0,0,55,43,12,44,31,13,15,26,1,11,2,1,7,22,5,3,3,2,8,4,-4,8,-1,-1,5,22,11,4,1,0,5,18,6,1,1,0,0,4,5,3,0,0,-18,-9,-9,6,5,1,-3,-3,-12,-8,1,10,-4,1,-8,-1,0,6,1,-4,-4,-7,1,4,-1,5,1,0,0,0,-1,5,0,1,0,0,0,0,1,-1,0,0,27,12,15,14,5,9,8,-4,15,3,2,2,5,-1,3,2,1,2,3,-3,12,1,1,0,3,3,7,1,0,0,1,1,3,0,0,0,2,2,4,1,0,0,-11,-14,3,1,-4,5,-1,-1,-10,2,0,1,0,-1,-8,-1,0,-2,-1,0,-2,3,0,3,0,0,2,-1,0,0,-1,-1,0,-2,0,0,1,1,2,1,0,0,-28,-17,-11,-11,-6,-5,-12,-5,-21,-2,-1,14,-7,-3,-9,-1,-1,3,-5,-2,-12,-1,0,11,-6,2,-8,1,0,0,-2,1,-5,0,0,0,-4,1,-3,1,0,0,-27,-17,-10,-17,-8,-9,-17,-9,-11,0,-2,10,-8,-3,-8,1,-4,5,-9,-6,-3,-1,2,5,-12,-1,-4,-1,0,0,-5,-1,-1,-1,0,0,-7,0,-3,0,0,0,2,-5,7,-5,0,-5,-7,-6,0,-4,5,13,-4,-3,3,-5,5,-1,-3,-3,-3,1,0,14,-3,-1,-3,2,0,0,0,0,-2,2,0,0,-3,-1,-1,0,0,0,-4,-8,4,5,2,3,3,-3,-8,1,-4,8,1,-3,-3,0,-3,0,2,0,-5,1,-1,8,3,1,-1,2,0,0,1,1,-1,1,0,0,2,0,0,1,0,0,-35,-25,-10,-33,-24,-9,-4,1,-16,-25,-4,11,1,-2,-9,-17,-5,4,-5,3,-7,-8,1,7,3,0,-13,-16,-7,0,1,0,-8,-11,-6,0,2,0,-5,-5,-1,0,-8,-4,-4,3,1,2,-2,-7,-6,-4,1,11,-1,-3,0,-3,2,2,-1,-4,-6,-1,-1,9,0,0,1,1,1,0,0,0,1,0,0,0,0,0,0,1,1,0,14,4,10,7,7,0,1,9,-3,6,0,2,0,5,-2,1,0,0,1,4,-1,5,0,2,-1,4,0,2,2,0,0,3,2,1,1,0,-1,1,-2,1,1,0
2,02056,Ontur,2431,47,21,26,39,16,23,18,5,4,17,2,0,6,2,-2,11,3,0,12,3,6,6,-1,0,7,10,8,13,0,1,1,4,3,8,0,0,6,6,5,5,0,1,-17,0,-17,31,16,15,-7,-10,-5,1,6,0,-1,0,-1,3,2,-1,-6,-10,-4,-2,4,1,4,6,5,9,6,1,1,5,0,6,3,1,3,1,5,3,3,0,-6,-5,-1,11,6,5,-8,4,-5,3,1,-3,-1,0,-4,0,1,-2,-7,4,-1,3,0,-1,1,3,3,4,0,0,1,1,2,2,0,0,0,2,1,2,0,0,35,17,18,44,22,22,15,7,13,-2,4,-2,6,2,8,0,0,1,9,5,5,-2,4,-3,13,9,9,6,6,1,7,4,5,3,2,1,6,5,4,3,4,0,7,7,0,31,18,13,1,7,3,4,-1,-6,0,4,3,3,0,-1,1,3,0,1,-1,-5,3,4,13,8,2,0,1,2,8,6,1,0,2,2,5,2,1,0,13,3,10,33,19,14,7,-7,5,8,2,-3,5,-3,-1,2,1,-2,2,-4,6,6,1,-1,5,10,10,8,0,0,4,6,4,5,0,0,1,4,6,3,0,0,-13,3,-16,7,5,2,-3,4,-13,0,3,-2,-3,7,-1,2,1,-2,0,-3,-12,-2,2,0,4,5,2,-1,-2,-1,1,4,2,0,-1,-1,3,1,0,-1,-1,0,-6,-2,-4,32,22,10,8,0,-8,-3,4,-5,-1,4,-2,-1,3,-4,9,-4,-6,-2,1,-1,4,12,7,4,5,0,1,8,6,3,4,0,3,4,1,1,1,0,5,-8,13,17,5,12,-1,-5,11,2,2,-2,0,-5,4,-3,-1,-2,-1,0,7,5,3,0,2,2,8,4,0,1,1,0,3,1,0,0,1,2,5,3,0,1,-12,6,-18,19,8,11,-1,0,-9,-9,6,0,3,2,-1,-1,2,0,-4,-2,-8,-8,4,0,5,7,4,0,3,0,4,2,1,0,1,0,1,5,3,0,2,0,-22,-10,-12,-25,-14,-11,4,-7,-6,-9,-2,-2,4,-7,1,-8,-1,0,0,0,-7,-1,-1,-2,-2,-9,-5,-5,-6,2,1,-5,-5,-3,-3,1,-3,-4,0,-2,-3,1,-24,-14,-10,6,0,6,-1,4,-8,-10,-2,-5,-2,0,-4,-5,0,-2,1,4,-4,-5,-2,-3,3,3,1,-1,0,0,2,1,-1,-1,-1,0,1,2,2,0,1,0,-14,-6,-8,2,0,2,5,-8,-9,3,-5,0,2,-6,-2,3,-3,0,3,-2,-7,0,-2,0,2,0,2,-1,-1,0,1,-1,1,0,-1,0,1,1,1,-1,0,0,-25,-19,-6,-7,-2,-5,2,-5,-10,-3,-3,-5,1,-5,-8,-2,-3,-2,1,0,-2,-1,0,-3,7,-2,-4,-7,-1,0,5,-1,-2,-3,-1,0,2,-1,-2,-4,0,0,-12,-3,-9,2,3,-1,6,-7,-5,-8,2,0,7,-7,1,-6,1,1,-1,0,-6,-2,1,-1,4,3,1,-5,-1,0,4,1,1,-3,0,0,0,2,0,-2,-1,0,-30,-18,-12,-24,-17,-7,-7,0,-2,-22,1,0,-6,-5,4,-10,0,-1,-1,5,-6,-12,1,1,-5,-3,-5,-11,0,0,-4,-4,-2,-7,0,0,-1,1,-3,-4,0,0,-10,3,-13,-5,-5,0,-2,-1,-8,1,2,-3,-4,0,-2,5,3,0,2,-1,-6,-4,-1,-3,1,0,-2,-3,-1,0,-2,-1,-1,-1,0,0,3,1,-1,-2,-1,0,-14,-5,-9,9,5,4,2,0,-13,-4,1,0,-1,2,-3,-5,3,-1,3,-2,-10,1,-2,1,5,5,-2,0,1,0,0,2,2,0,1,0,5,3,-4,0,0,0
2,02069,"Roda, La",13627,178,133,45,145,96,49,21,33,79,35,4,8,19,22,63,20,3,6,2,11,16,15,1,2,8,42,58,26,5,6,3,31,45,12,2,3,5,11,13,14,3,3,254,165,89,214,139,75,30,62,92,59,7,4,9,46,62,42,5,0,21,16,30,17,2,4,26,53,85,47,2,0,9,45,52,31,1,0,17,8,33,16,1,0,293,181,112,230,141,89,78,66,76,56,19,-5,42,41,46,37,13,-2,36,25,30,19,6,-3,60,68,66,30,2,1,31,47,46,13,1,1,29,21,20,17,1,0,254,155,99,219,123,96,66,93,46,27,10,4,48,54,31,15,1,3,18,39,15,12,9,1,51,70,53,29,10,1,34,39,29,15,4,0,17,31,24,14,6,1,241,105,136,216,91,125,48,96,47,34,10,3,23,49,16,10,5,1,25,47,31,24,5,2,36,83,55,30,10,2,17,42,23,4,4,1,19,41,32,26,6,1,192,110,82,193,108,85,39,52,26,37,28,9,23,40,6,21,16,2,16,12,20,16,12,7,31,59,53,38,11,1,14,35,30,24,5,0,17,24,23,14,6,1,231,130,101,256,130,126,49,88,67,15,14,-3,34,44,41,10,4,-2,15,44,26,5,10,-1,53,82,78,32,6,4,31,37,42,19,0,1,22,45,36,13,6,3,403,250,153,409,246,163,94,141,89,47,9,16,52,100,44,43,1,7,42,41,45,4,8,9,83,139,100,66,14,3,46,83,59,46,9,1,37,56,41,20,5,2,9,-19,28,40,-2,42,-9,13,-15,14,-9,15,-14,-4,-8,9,-11,9,5,17,-7,5,2,6,5,16,8,13,-2,-1,3,-6,-2,5,-4,1,2,22,10,8,2,-2,196,110,86,84,34,50,44,22,60,22,20,15,18,6,39,14,10,15,26,16,21,8,10,0,20,23,21,9,5,4,8,8,14,0,0,2,12,15,7,9,5,2,60,13,47,41,12,29,16,24,-14,28,0,2,8,10,-12,7,1,-3,8,14,-2,21,-1,5,10,26,-3,4,4,0,8,10,-2,-3,-1,0,2,16,-1,7,5,0,7,-3,10,76,36,40,3,29,-28,5,-2,4,0,10,-15,8,-6,1,3,19,-13,-3,4,3,16,36,11,10,4,1,14,13,2,8,-1,1,2,23,9,2,5,0,-12,-14,2,-20,-26,6,3,6,-29,6,-8,8,-2,5,-13,-2,-5,3,5,1,-16,8,-3,5,-4,7,-13,-1,-8,-4,-6,-1,-12,-3,-3,-3,2,8,-1,2,-5,-1,-438,-250,-188,-404,-254,-150,-56,-71,-171,-107,-38,4,-24,-39,-103,-65,-19,2,-32,-32,-68,-42,-19,2,-71,-41,-141,-104,-37,-10,-37,-27,-96,-70,-18,-5,-34,-14,-45,-34,-19,-5,-170,-93,-77,-46,-35,-11,-38,-24,-43,-38,-11,-14,-18,-2,-39,-17,-15,-2,-20,-22,-4,-21,4,-12,-1,-2,-15,-21,-6,0,-1,4,-14,-12,-11,0,0,-6,-1,-9,5,0,-36,-13,-23,22,0,22,-7,2,-16,-9,-7,7,1,-1,-10,-6,3,5,-8,3,-6,-3,-10,2,2,16,-4,7,3,-2,-4,4,-7,6,2,-1,6,12,3,1,1,-1,-129,-67,-62,-42,-23,-19,-20,-10,-59,-25,-9,-8,-11,-13,-31,-6,-6,-4,-9,3,-28,-19,-3,-4,-16,-2,-18,-5,-1,-3,-7,-6,-9,-2,-1,0,-9,4,-9,-3,0,-3,-15,-6,-9,50,31,19,9,-9,-25,-7,1,18,9,-1,-14,-6,-2,10,0,-8,-11,-1,3,8,10,14,10,10,5,1,5,9,6,7,2,2,5,5,4,3,3,-1
2,02074,Tobarra,7469,87,59,28,92,62,30,0,28,38,5,13,2,-3,24,27,3,5,1,3,4,11,2,8,1,4,32,38,14,2,2,3,24,25,8,1,1,1,8,13,6,1,1,95,70,25,109,68,41,5,32,18,30,14,-6,4,16,24,20,8,-2,1,16,-6,10,6,-4,16,30,38,19,3,0,8,13,30,14,2,0,8,17,8,5,1,0,99,91,8,119,78,41,18,41,25,12,6,-6,6,38,26,14,5,0,12,3,-1,-2,1,-6,25,43,38,9,1,2,10,32,29,6,1,0,15,11,9,3,0,2,76,32,44,93,45,48,16,19,14,16,6,0,1,10,11,8,0,0,15,9,3,8,6,0,28,24,24,16,1,0,9,13,15,8,0,0,19,11,9,8,1,0,57,59,-2,113,83,30,1,24,17,14,9,-7,-2,23,14,16,7,1,3,1,3,-2,2,-8,14,43,34,13,8,0,7,36,24,9,6,0,7,7,10,4,2,0,109,79,30,127,82,45,27,23,21,15,17,7,12,16,19,15,11,6,15,7,2,0,6,1,32,34,39,17,4,1,15,23,29,12,3,0,17,11,10,5,1,1,196,106,90,176,103,73,62,34,52,33,14,-4,31,20,26,19,8,-2,31,14,26,14,6,-2,51,41,59,19,3,1,23,23,42,12,1,0,28,18,17,7,2,1,138,68,70,141,68,73,32,30,42,31,7,-4,14,15,20,22,-3,-1,18,15,22,9,10,-3,39,21,51,19,9,1,19,9,27,10,2,0,20,12,24,9,7,1,-8,-3,-5,13,-4,17,19,8,-36,8,-7,-2,21,6,-27,3,-3,-4,-2,2,-9,5,-4,2,10,12,-10,-1,0,0,11,2,-10,-7,-1,0,-1,10,0,6,1,0,114,58,56,88,35,53,35,29,44,11,2,-6,18,5,32,3,2,-2,17,24,12,8,0,-4,32,25,21,10,-1,1,15,8,6,6,0,0,17,17,15,4,-1,1,-45,-17,-28,-44,-29,-15,-11,-17,-11,-10,0,5,-2,4,-8,-10,0,1,-9,-21,-3,0,0,4,-14,-5,-15,-8,-3,0,-7,-1,-12,-6,-3,0,-7,-4,-3,-2,0,0,-29,-10,-19,-23,-20,-3,1,14,-28,-9,-7,-1,1,15,-10,-6,-7,-3,0,-1,-18,-3,0,2,0,12,-21,-14,-2,0,3,7,-17,-11,-2,-1,-3,5,-4,-3,0,1,-75,-52,-23,-17,-14,-3,-15,-21,-14,-23,-2,-2,-8,-16,-8,-18,-4,0,-7,-5,-6,-5,2,-2,-4,-5,-4,-2,-5,2,-1,-5,-2,-3,-5,1,-3,0,-2,1,0,1,45,22,23,31,21,10,17,3,7,5,0,13,9,1,-4,11,1,3,8,2,11,-6,-1,10,7,7,8,6,0,2,6,2,6,5,0,1,1,5,2,1,0,1,-60,-14,-46,14,7,7,-16,-3,-30,-10,1,-4,-2,1,-12,-7,4,1,-14,-4,-18,-3,-3,-5,-3,8,3,4,-1,1,0,1,1,3,0,1,-3,7,2,1,-1,0,-52,-32,-20,18,10,8,-3,-18,-12,-12,-2,-12,-2,-10,-8,-3,-5,-7,-1,-8,-4,-9,3,-5,4,3,12,1,-3,-1,3,0,7,2,-2,-1,1,3,5,-1,-1,0,-44,-34,-10,13,6,7,-13,10,-8,-24,-5,-6,-10,4,-4,-16,-3,-3,-3,6,-4,-8,-2,-3,4,6,7,-5,-2,1,2,4,4,-2,-3,0,2,2,3,-3,1,1,37,34,3,63,43,20,14,3,-5,-9,15,11,15,3,0,-2,9,5,-1,0,-5,-7,6,6,12,6,20,10,5,5,9,4,12,10,3,2,3,2,8,0,2,3
2,02079,Villamalea,3476,64,43,21,55,33,22,9,13,28,14,2,-3,5,8,18,10,2,-1,4,5,10,4,0,-2,4,13,19,18,0,0,3,5,12,12,0,0,1,8,7,6,0,0,73,32,41,80,32,48,25,24,23,9,-1,-7,9,13,10,2,-1,-1,16,11,13,7,0,-6,24,21,22,10,2,0,7,9,10,5,0,0,17,12,12,5,2,0,71,41,30,57,32,25,1,21,31,10,5,2,-1,9,20,8,3,1,2,12,11,2,2,1,5,18,27,6,0,0,2,8,17,4,0,0,3,10,10,2,0,0,87,43,44,63,36,27,7,32,26,9,11,2,1,26,9,3,4,0,6,6,17,6,7,2,10,23,17,9,4,0,2,18,10,5,1,0,8,5,7,4,3,0,60,51,9,79,50,29,-4,15,32,9,4,2,-3,14,21,12,3,2,-1,1,11,-3,1,0,10,18,30,16,4,0,4,11,20,12,2,0,6,7,10,4,2,0,66,33,33,83,46,37,13,30,14,2,2,4,8,13,13,-1,-1,1,5,17,1,3,3,3,14,28,28,7,4,1,8,16,18,3,1,0,6,12,10,4,3,1,12,7,5,53,24,29,5,-5,-4,7,4,6,9,-4,1,-1,2,1,-4,-1,-5,8,2,5,13,14,15,10,0,1,9,5,7,3,0,0,4,9,8,7,0,1,103,41,62,87,34,53,23,36,33,15,-2,-2,5,15,18,2,1,-1,18,21,15,13,-3,-1,8,40,31,7,1,0,0,14,19,0,1,0,8,26,12,7,0,0,75,39,36,60,28,32,32,7,11,15,14,-7,13,8,4,8,8,-4,19,-1,7,7,6,-3,16,14,14,9,6,0,4,7,7,6,3,0,12,7,7,3,3,0,-3,0,-3,15,4,11,5,-5,-8,-10,6,7,6,-5,-6,0,2,2,-1,0,-2,-10,4,5,5,2,6,2,0,0,4,-1,1,0,0,0,1,3,5,2,0,0,16,7,9,40,16,24,-1,-1,11,7,-1,-3,-2,-3,11,0,2,-1,1,2,0,7,-3,-2,10,10,11,7,0,0,6,2,5,2,0,0,4,8,6,5,0,0,89,42,47,36,15,21,8,24,30,15,5,5,5,10,10,10,2,4,3,14,20,5,3,1,4,14,10,3,4,1,3,5,4,0,2,1,1,9,6,3,2,0,2,-10,12,19,9,10,1,2,-7,3,1,0,-5,4,-6,0,-2,0,6,-2,-1,3,3,0,6,5,3,4,1,0,4,3,1,1,0,0,2,2,2,3,1,0,-15,-7,-8,-36,-25,-11,-1,8,-2,-13,-12,-1,2,-1,0,-7,-2,-3,-3,9,-2,-6,-10,2,-1,0,-17,-9,-6,-3,0,-1,-13,-7,-2,-2,-1,1,-4,-2,-4,-1,-40,-18,-22,-48,-29,-19,-3,-6,-5,-31,6,-3,0,5,-3,-21,3,-4,-3,-11,-2,-10,3,1,-5,-7,-12,-22,-1,-1,-2,0,-8,-16,-1,-2,-3,-7,-4,-6,0,1,15,3,12,35,11,24,5,13,8,-1,-5,-6,-1,10,5,-2,-5,-5,6,3,3,1,0,-1,8,13,8,7,-4,3,0,5,7,1,-3,1,8,8,1,6,-1,2,62,27,35,31,7,24,21,6,23,7,3,-2,19,2,5,0,0,0,2,4,18,7,3,-2,11,4,9,4,2,0,7,1,3,-4,1,-1,4,3,6,8,1,1,4,12,-8,5,1,4,5,-2,-5,6,-4,0,8,7,-4,3,-7,0,-3,-9,-1,3,3,0,3,10,-2,-9,-1,2,2,7,-2,-6,-2,0,1,3,0,-3,1,2
2,02081,Villarrobledo,22197,524,378,146,545,383,162,18,146,219,137,15,-14,12,95,167,99,10,-5,6,51,52,38,5,-9,13,144,235,135,16,1,8,98,172,95,10,0,5,46,63,40,6,1,414,285,129,511,328,183,55,101,157,100,7,-1,22,81,105,76,6,-2,33,20,52,24,1,1,41,146,201,108,14,1,23,90,128,77,10,0,18,56,73,31,4,1,506,344,162,552,355,197,60,178,155,99,28,-18,30,118,118,70,15,-8,30,60,37,29,13,-10,49,183,185,112,19,0,29,113,125,78,9,0,20,70,60,34,10,0,434,250,184,533,317,216,63,137,144,61,23,-2,37,65,90,42,17,-3,26,72,54,19,6,1,74,172,174,94,10,2,42,98,106,62,5,1,32,74,68,32,5,1,322,190,132,553,308,245,37,106,130,33,9,3,20,59,83,24,2,2,17,47,47,9,7,1,75,167,187,95,21,1,37,84,113,61,10,0,38,83,74,34,11,1,520,322,198,680,389,291,58,212,175,48,24,2,36,121,115,37,11,0,22,91,60,11,13,2,92,239,238,90,15,1,50,129,141,58,7,0,42,110,97,32,8,1,310,151,159,543,274,269,108,132,50,35,3,-18,53,55,34,13,2,-8,55,77,16,22,1,-10,110,171,165,75,7,7,55,83,88,37,4,2,55,88,77,38,3,5,773,472,301,878,507,371,117,254,226,129,46,-11,45,139,166,92,28,-1,72,115,60,37,18,-10,118,285,277,152,38,1,56,156,177,95,20,0,62,129,100,57,18,1,196,53,143,201,64,137,58,79,-15,25,31,15,33,29,-26,-7,15,7,25,50,11,32,16,8,51,65,31,40,14,0,27,22,1,11,4,-1,24,43,30,29,10,1,-27,-51,24,60,5,55,12,19,-33,-37,15,2,0,6,-35,-30,7,2,12,13,2,-7,8,0,25,27,5,-11,11,2,16,8,-9,-14,2,1,9,19,14,3,9,1,-237,-169,-68,-202,-165,-37,5,-42,-71,-98,-32,0,-1,-37,-60,-53,-14,-3,6,-5,-11,-45,-18,3,-8,-18,-61,-80,-37,-1,-11,-23,-56,-55,-22,0,3,5,-5,-25,-15,-1,87,26,61,115,33,82,24,41,-12,14,28,-3,4,13,-12,8,15,-1,20,28,0,6,13,-2,41,47,23,-2,7,-2,19,10,9,-8,2,0,22,37,14,6,5,-2,-50,-7,-43,1,-6,7,1,24,-49,12,-28,-9,2,12,-18,7,-14,1,-1,12,-31,5,-14,-10,-1,18,-1,-3,-12,-2,1,3,-2,-1,-7,-1,-2,15,1,-2,-5,-1,-122,-61,-61,-49,-35,-14,-17,-4,-69,-27,-11,0,-3,-8,-37,-10,-7,-1,-14,4,-32,-17,-4,1,-5,14,-38,-13,-10,3,-4,7,-24,-11,-4,2,-1,7,-14,-2,-6,1,-56,-20,-36,37,27,10,-6,4,-40,-1,-10,-2,-7,7,-13,-8,2,1,1,-3,-27,7,-12,-3,14,17,6,11,-9,-3,6,11,4,9,-3,-1,8,6,2,2,-6,-2,31,27,4,94,51,43,7,11,-31,16,24,1,13,10,-15,10,10,-2,-6,1,-16,6,14,3,10,31,18,24,9,1,5,18,11,15,1,1,5,13,7,9,8,0,-100,-50,-50,79,37,42,-18,-34,-18,-27,-15,9,-8,-5,-7,-17,-19,5,-10,-29,-11,-10,4,4,17,23,17,14,0,6,12,12,7,10,-5,1,5,11,10,4,5,5,39,5,34,147,62,85,35,11,21,-22,0,-13,12,4,3,-14,-2,0,23,7,18,-8,2,-13,25,44,34,24,15,2,8,17,14,14,7,0,17,27,20,10,8,2
3,03001,Adsubia,558,21,14,7,27,17,10,-2,4,7,2,9,1,0,5,2,2,5,0,-2,-1,5,0,4,1,0,6,8,4,8,1,0,5,4,3,5,0,0,1,4,1,3,1,45,31,14,47,33,14,5,9,11,7,11,2,5,7,10,5,3,1,0,2,1,2,8,1,5,10,8,8,13,3,5,9,8,4,5,2,0,1,0,4,8,1,-8,-1,-7,6,3,3,-2,3,-4,3,6,-14,0,1,1,1,2,-6,-2,2,-5,2,4,-8,0,3,2,4,6,-9,0,1,2,2,1,-3,0,2,0,2,5,-6,57,25,32,48,26,22,2,1,3,10,35,6,1,0,-3,5,18,4,1,1,6,5,17,2,4,0,4,8,29,3,3,0,1,5,15,2,1,0,3,3,14,1,-16,-20,4,2,-8,10,9,3,-12,-2,-6,-8,5,3,-12,-3,-8,-5,4,0,0,1,2,-3,10,-1,-3,2,-1,-5,6,0,-5,0,-6,-3,4,-1,2,2,5,-2,19,10,9,19,11,8,-1,1,8,0,11,0,0,0,7,0,3,0,-1,1,1,0,8,0,0,0,5,5,9,0,0,0,4,4,3,0,0,0,1,1,6,0,37,20,17,24,11,13,3,2,2,10,21,0,1,2,-5,5,16,1,2,0,7,5,5,-1,3,3,2,6,15,-5,1,1,-2,2,10,-1,2,2,4,4,5,-4,19,12,7,25,15,10,3,5,-6,2,12,3,2,1,-4,3,5,5,1,4,-2,-1,7,-2,2,7,2,1,10,3,1,3,1,2,5,3,1,4,1,-1,5,0,10,4,6,19,8,11,7,-1,-1,8,2,-5,1,-1,0,5,0,-1,6,0,-1,3,2,-4,7,0,5,4,3,0,2,0,3,3,0,0,5,0,2,1,3,0,13,11,2,13,7,6,-1,-2,-1,6,11,0,0,1,-2,5,7,0,-1,-3,1,1,4,0,0,1,0,3,9,0,0,0,0,2,5,0,0,1,0,1,4,0,44,26,18,16,7,9,4,5,7,13,14,1,1,1,7,10,7,0,3,4,0,3,7,1,0,0,3,4,7,2,0,-1,2,2,3,1,0,1,1,2,4,1,24,16,8,15,9,6,7,3,0,4,10,0,6,4,-2,1,7,0,1,-1,2,3,3,0,1,-1,1,2,11,1,1,0,-1,1,8,0,0,-1,2,1,3,1,6,1,5,18,11,7,1,2,1,-4,5,1,0,1,-1,-2,2,1,1,1,2,-2,3,0,1,1,0,4,9,3,0,1,0,4,5,1,1,0,0,0,4,2,6,1,5,3,2,1,1,-4,3,-6,5,8,-1,-3,0,-1,1,5,2,-1,3,-5,4,3,-2,0,1,0,3,1,-1,0,0,2,0,1,-1,0,1,-2,3,0,37,16,21,37,17,20,0,-1,1,4,16,17,-1,0,0,2,6,9,1,-1,1,2,10,8,0,1,4,4,14,14,0,1,1,2,6,7,0,0,3,2,8,7,-3,0,-3,5,0,5,-1,0,-3,-6,6,1,0,2,0,-6,2,2,-1,-2,-3,0,4,-1,0,-1,-5,-3,10,4,0,-1,-1,-5,4,3,0,0,-4,2,6,1,4,4,0,8,5,3,-2,-1,-1,1,9,-2,0,1,1,0,5,-3,-2,-2,-2,1,4,1,0,0,1,0,6,1,0,0,1,0,4,0,0,0,0,0,2,1,25,13,12,20,11,9,1,1,1,6,10,6,1,1,2,4,4,1,0,0,-1,2,6,5,1,1,2,1,10,5,1,1,2,1,5,1,0,0,0,0,5,4
3,03002,Agost,4053,51,42,9,45,30,15,5,0,24,19,2,0,3,6,14,16,4,-2,2,-6,10,3,-2,2,3,14,19,5,3,1,2,9,12,5,1,1,1,5,7,0,2,0,112,68,44,110,67,43,28,26,35,22,6,-6,13,17,25,13,2,-3,15,9,10,9,4,-3,25,21,43,13,6,1,14,15,25,9,3,0,11,6,18,4,3,1,137,72,65,97,51,46,31,28,41,22,9,4,21,16,22,7,2,2,10,12,19,15,7,2,20,22,29,16,6,2,12,11,17,7,1,1,8,11,12,9,5,1,77,45,32,81,49,32,14,17,17,23,0,8,6,10,12,12,2,6,8,7,5,11,-2,2,14,27,19,18,1,0,8,16,12,9,3,1,6,11,7,9,-2,-1,78,37,41,48,28,20,21,5,25,17,11,-1,7,0,12,12,4,2,14,5,13,5,7,-3,10,13,11,12,0,2,4,7,7,9,0,1,6,6,4,3,0,1,109,64,45,58,34,24,16,29,28,23,8,3,4,18,20,15,6,1,12,11,8,8,2,2,4,21,14,14,4,1,2,13,10,6,2,1,2,8,4,8,2,0,69,40,29,61,32,29,13,23,10,7,10,4,11,17,7,0,3,1,2,6,3,7,7,3,14,14,14,12,5,1,9,9,5,5,2,1,5,5,9,7,3,0,36,20,16,64,36,28,8,9,14,-12,13,3,2,8,6,-3,5,1,6,1,8,-9,8,2,11,15,23,7,5,2,7,8,18,3,1,-1,4,7,5,4,4,3,21,10,11,39,16,23,6,3,6,11,-5,0,5,-1,2,7,-1,-1,1,4,4,4,-4,1,6,7,13,10,1,1,1,3,7,4,0,0,5,4,6,6,1,1,-2,8,-10,7,6,1,5,-8,-7,3,2,4,6,-2,-1,4,1,2,-1,-6,-6,-1,1,2,1,2,7,-3,0,0,3,2,3,-2,0,0,-2,0,4,-1,0,0,-3,7,-10,11,6,5,-5,-5,10,-11,4,3,-1,-3,14,-7,1,2,-4,-2,-4,-4,3,1,2,1,3,0,2,2,1,0,1,0,1,2,1,1,2,0,1,0,-46,-30,-16,-17,-14,-3,-15,2,-19,-17,9,-4,-7,2,-19,-13,7,1,-8,0,0,-4,2,-5,-6,1,-2,-11,1,0,-2,-1,-2,-10,0,1,-4,2,0,-1,1,-1,16,3,13,5,-3,8,11,-2,14,-8,2,-2,7,-1,5,-4,-3,-1,4,-1,9,-4,5,-1,4,-1,-2,1,3,0,2,-2,-2,1,-1,-1,2,1,0,0,4,1,11,12,-1,0,0,0,0,-3,1,0,7,5,7,-4,5,-3,3,4,-7,1,-4,3,4,1,-3,3,-4,0,2,2,-2,1,0,-1,1,1,-1,2,-4,1,1,1,-16,-1,-15,-16,-9,-7,-9,4,-22,4,9,-3,-5,0,-8,7,7,-2,-4,4,-14,-3,2,-1,-4,0,-10,-2,2,-2,-2,-1,-4,-3,1,0,-2,1,-6,1,1,-2,38,14,24,17,7,10,17,3,10,15,-2,-2,10,-2,2,9,1,-3,7,5,8,6,-3,1,4,0,7,4,1,1,3,0,1,2,1,0,1,0,6,2,0,1,-14,-21,7,12,2,10,6,-5,6,-17,-4,-1,-2,-5,-7,-10,-3,4,8,0,13,-7,-1,-5,10,-1,4,0,-3,2,3,-1,0,0,-2,2,7,0,4,0,-1,0,31,11,20,13,5,8,18,2,-12,15,13,-3,7,4,-7,6,7,-4,11,-2,-5,9,6,1,3,0,7,5,0,-2,1,-1,4,2,1,-2,2,1,3,3,-1,0
3,03005,Albatera,8661,285,163,122,185,121,64,53,72,83,53,17,2,24,43,52,32,8,2,29,29,31,21,9,0,18,58,59,41,7,0,9,33,47,28,4,0,9,25,12,13,3,0,212,135,77,229,150,79,30,57,67,22,29,5,15,38,42,16,19,4,15,19,25,6,10,1,29,71,75,32,15,4,16,46,55,23,8,1,13,25,20,9,7,3,245,144,101,242,130,112,49,50,71,35,28,8,34,25,37,19,16,10,15,25,34,16,12,-2,48,61,58,41,26,8,28,33,28,21,14,6,20,28,30,20,12,2,359,217,142,275,164,111,75,76,85,35,60,23,47,54,55,20,27,13,28,22,30,15,33,10,55,68,63,36,38,14,35,40,40,22,16,10,20,28,23,14,22,4,219,126,93,241,152,89,27,60,24,50,51,9,7,43,16,30,29,3,20,17,8,20,22,6,32,54,57,55,32,8,15,41,38,36,19,3,17,13,19,19,13,5,292,181,111,220,130,90,39,59,70,50,58,15,15,36,51,35,33,12,24,23,19,15,25,3,35,48,53,39,39,6,13,31,40,21,21,4,22,17,13,18,18,2,333,192,141,218,120,98,49,79,92,55,53,3,23,51,68,25,24,1,26,28,24,30,29,2,38,46,46,36,42,10,18,28,29,18,21,6,20,18,17,18,21,4,540,319,221,281,146,135,91,150,184,65,31,8,52,86,111,46,14,5,39,64,73,19,17,3,45,85,82,42,22,4,21,52,33,26,11,2,24,33,49,16,11,2,14,-5,19,95,37,58,-9,21,3,-17,10,5,-4,14,-5,-12,4,-2,-5,7,8,-5,6,7,36,18,14,5,15,6,23,8,-2,-1,6,3,13,10,16,6,9,3,32,-6,38,-3,-23,20,3,28,15,-20,13,-6,0,1,2,-14,8,-2,3,27,13,-6,5,-4,-2,10,-11,-7,6,-1,2,-3,-13,-11,3,-1,-4,13,2,4,3,0,-44,-27,-17,-57,-42,-15,1,-15,8,-11,1,-27,-2,-5,2,-14,4,-11,3,-10,6,3,-3,-16,-1,-2,-23,-8,-6,-17,-3,0,-19,-11,-1,-8,2,-2,-4,3,-5,-9,-27,-16,-11,30,3,27,-19,25,-21,-20,7,3,-13,11,-5,-15,5,3,-6,14,-16,-5,2,0,7,12,-4,3,9,3,1,-1,-3,0,3,3,6,13,-1,3,6,0,17,2,15,-6,-10,4,11,-16,20,4,8,-13,9,-11,12,-2,2,-9,2,-5,8,6,6,-4,-13,4,-1,1,9,-6,-4,4,-7,-1,3,-5,-9,0,6,2,6,-1,34,28,6,8,-3,11,-2,4,10,4,10,1,-2,-1,-1,16,9,5,0,5,11,-12,1,-4,3,2,-3,-5,6,4,0,0,-10,0,3,4,3,2,7,-5,3,0,66,25,41,38,23,15,26,21,7,2,11,0,11,7,8,-3,6,-2,15,14,-1,5,5,2,8,11,3,1,10,5,7,4,4,0,6,2,1,7,-1,1,4,3,9,13,-4,-9,-10,1,7,-1,-4,14,-4,3,9,-9,5,8,0,1,-2,8,-9,6,-4,2,8,-3,1,-6,-8,0,3,-7,8,-9,-4,0,5,4,-7,3,-4,0,-294,-127,-167,-319,-163,-156,12,14,-43,-71,-90,-116,18,20,-14,-41,-47,-63,-6,-6,-29,-30,-43,-53,-6,20,-47,-81,-92,-113,-1,18,-24,-47,-46,-63,-5,2,-23,-34,-46,-50,159,80,79,176,81,95,40,23,31,22,21,18,18,9,20,8,8,15,22,14,11,14,13,3,35,38,35,20,26,19,12,18,18,7,12,13,23,20,17,13,14,6
3,03006,Alcalalí,941,46,34,12,64,37,27,5,5,-1,13,26,-2,4,7,3,4,18,-2,1,-2,-4,9,8,0,8,5,4,15,30,2,6,5,3,5,17,1,2,0,1,10,13,1,52,33,19,63,32,31,4,2,0,10,39,-2,4,2,-1,2,22,4,0,0,1,8,17,-6,2,4,7,10,34,6,2,2,3,3,17,5,0,2,4,7,17,1,-26,-14,-12,-6,-4,-2,-3,-4,2,-3,-7,-10,-3,-3,0,0,1,-8,0,-1,2,-3,-8,-2,-2,-1,1,-2,0,-2,-2,-1,1,-1,0,-1,0,0,0,-1,0,-1,25,9,16,22,12,10,8,2,6,8,6,-7,4,0,-3,5,5,-4,4,2,9,3,1,-3,6,1,2,5,8,-1,4,0,0,3,3,1,2,1,2,2,5,-2,128,68,60,141,70,71,4,5,17,18,86,-1,-2,4,10,9,45,1,6,1,7,9,41,-2,8,5,20,22,82,4,2,3,9,11,42,3,6,2,11,11,40,1,101,53,48,91,46,45,17,4,8,17,39,15,13,0,7,4,20,9,4,4,1,13,19,6,10,7,11,13,36,13,7,2,8,3,19,7,3,5,3,10,17,6,-1,-6,5,0,-8,8,0,3,1,-12,13,-7,0,0,0,-6,4,-6,0,3,1,-6,9,-1,6,8,-3,-15,7,-3,4,3,-3,-7,-2,-3,2,5,0,-8,9,0,103,55,48,98,53,45,11,10,16,24,39,4,11,2,5,12,23,2,0,8,11,12,16,2,14,4,13,26,35,6,9,2,3,15,21,3,5,2,10,11,14,3,8,-5,13,-9,-9,0,8,-1,1,3,15,-18,-2,-3,3,2,5,-10,10,2,-2,1,10,-8,0,0,-2,1,6,-14,-1,-2,-1,2,1,-8,1,2,-1,-1,5,-6,14,10,4,27,17,10,-4,-2,8,-3,5,12,-4,0,6,-2,2,10,0,-2,2,-1,3,2,2,1,1,5,12,6,2,0,1,3,7,4,0,1,0,2,5,2,-69,-33,-36,-59,-29,-30,-9,-4,-19,-16,-1,-19,-8,0,-8,-8,1,-10,-1,-4,-11,-8,-2,-9,-3,-4,-10,-16,-6,-20,-5,-2,-3,-7,-2,-10,2,-2,-7,-9,-4,-10,5,5,0,-4,2,-6,-1,-3,8,-1,11,-8,-1,-1,7,1,4,-5,0,-2,1,-2,7,-3,-3,-4,0,0,10,-7,-2,-1,2,1,5,-3,-1,-3,-2,-1,5,-4,-30,-21,-9,-54,-27,-27,5,-7,5,-4,-3,-27,1,-6,1,-3,-1,-13,4,-1,4,-1,-2,-14,-7,-3,-1,-11,-9,-23,-2,-2,-1,-6,-4,-12,-5,-1,0,-5,-5,-11,-31,-5,-26,-45,-14,-31,-1,2,-7,-4,-4,-16,-1,0,-2,2,2,-5,0,2,-5,-6,-6,-11,-1,-3,-4,-8,-8,-20,0,-2,-2,-1,-1,-7,-1,-1,-2,-7,-7,-13,-20,-10,-10,-29,-12,-17,5,-8,-1,-2,7,-22,1,-3,-3,2,3,-10,4,-5,2,-4,4,-12,3,-8,2,-1,0,-25,3,-4,0,0,2,-13,0,-4,2,-1,-2,-12,-5,-5,0,-10,-8,-2,8,1,7,-1,-9,-11,5,-2,5,-5,-7,-1,3,3,2,4,-2,-10,0,3,4,-2,-6,-9,-1,-1,3,-2,-5,-2,1,4,1,0,-1,-7,9,-5,14,21,3,18,-1,3,-3,0,22,-13,2,0,-1,-1,6,-10,-3,3,-2,1,16,-3,-1,3,-2,4,17,-3,0,2,-2,2,6,-5,-1,1,0,2,11,2,41,22,19,47,22,25,-2,-1,-5,8,33,9,-4,1,-3,3,22,4,2,-2,-2,5,11,5,4,-1,1,6,32,5,-1,1,-2,3,19,2,5,-2,3,3,13,3
3,03009,Alcoy/Alcoi,60476,-19,5,-24,301,150,151,28,4,30,9,-37,-61,13,10,2,12,-23,-18,15,-6,28,-3,-14,-43,38,77,110,61,10,1,17,40,58,28,5,0,21,37,52,33,5,1,-58,-14,-44,317,168,149,3,11,-6,-6,-24,-40,-6,22,1,-4,-14,-17,9,-11,-7,-2,-10,-23,53,85,113,53,6,4,29,41,68,23,4,1,24,44,45,30,2,3,286,182,104,636,340,296,81,141,104,12,-9,-44,33,101,73,-9,-13,-5,48,40,31,21,4,-39,142,185,176,94,24,11,65,105,103,53,7,4,77,80,73,41,17,7,135,84,51,497,240,257,97,53,22,-2,1,-33,40,42,30,-7,4,-19,57,11,-8,5,-3,-14,120,124,131,79,26,7,56,63,68,36,14,1,64,61,63,43,12,6,231,105,126,361,185,176,111,73,34,12,12,-19,51,19,26,-5,12,-5,60,54,8,17,0,-14,57,104,115,49,24,9,26,51,71,19,12,5,31,53,44,30,12,4,-161,-70,-91,268,145,123,8,-43,-64,-40,-15,-23,-6,-8,-43,2,-9,-8,14,-35,-21,-42,-6,-15,51,71,74,45,17,0,22,38,42,28,11,0,29,33,32,17,6,0,47,3,44,470,243,227,43,84,-49,-2,3,-32,14,37,-21,-14,2,-11,29,47,-28,12,1,-21,90,140,136,67,22,8,44,74,71,35,11,5,46,66,65,32,11,3,545,303,242,602,323,279,154,190,103,90,4,-8,90,104,60,44,3,-4,64,86,43,46,1,-4,130,214,143,88,19,6,63,117,91,41,9,2,67,97,52,47,10,4,178,104,74,429,229,200,41,156,-12,7,8,-27,18,87,4,-3,12,-13,23,69,-16,10,-4,-14,73,180,97,47,22,4,32,98,61,20,14,0,41,82,36,27,8,4,-150,-56,-94,126,57,69,-2,16,-93,-18,-29,-24,6,19,-58,-13,-7,1,-8,-3,-35,-5,-22,-25,12,74,29,-3,13,-1,9,37,9,-7,8,1,3,37,20,4,5,-2,-155,5,-160,138,85,53,18,-21,-92,-42,8,-18,20,17,-21,-16,3,3,-2,-38,-71,-26,5,-21,30,50,39,1,11,6,16,31,29,0,4,5,14,19,10,1,7,1,-99,-52,-47,100,43,57,17,12,-57,-23,-23,-33,16,14,-38,-23,-17,-9,1,-2,-19,0,-6,-24,7,49,16,16,10,1,2,26,4,5,3,2,5,23,12,11,7,-1,-65,-57,-8,68,36,32,13,35,-51,-21,-40,2,-5,19,-50,-9,-18,3,18,16,-1,-12,-22,-1,1,57,5,5,-1,0,5,34,-1,-1,-3,1,-4,23,6,6,2,-1,-182,-91,-91,65,29,36,-40,-15,-79,-11,-12,-14,-11,-6,-32,-12,-18,-3,-29,-9,-47,1,6,-11,16,31,17,-5,6,-1,13,13,13,-8,-1,-1,3,18,4,3,7,0,31,29,2,86,42,44,12,22,13,-36,23,-10,11,6,14,-26,12,7,1,16,-1,-10,11,-17,19,29,20,5,7,4,7,10,11,6,5,1,12,19,9,-1,2,3,11,-9,20,168,83,85,14,6,22,3,-11,-19,-8,0,17,4,-8,-12,22,6,5,-1,-3,-7,36,47,57,29,2,-5,22,20,39,13,-5,-6,14,27,18,16,7,1,105,96,9,155,96,59,42,64,-4,1,3,-15,28,42,-8,5,5,14,14,22,4,-4,-2,-29,14,78,28,15,15,3,10,50,14,10,9,2,4,28,14,5,6,1,181,118,63,310,159,151,70,57,-2,8,45,-4,45,54,-16,-10,26,11,25,3,14,18,19,-15,36,105,98,31,21,11,15,61,44,14,14,4,21,44,54,17,7,7
3,03011,"Alfàs del Pi, l'",13226,898,448,450,716,376,340,176,103,189,199,151,73,93,42,90,96,81,43,83,61,99,103,70,30,144,55,142,157,143,71,71,25,74,82,73,49,73,30,68,75,70,22,1090,579,511,984,511,473,212,141,222,215,184,106,118,75,103,121,94,60,94,66,119,94,90,46,226,96,186,188,174,102,119,51,78,102,92,60,107,45,108,86,82,42,632,344,288,394,204,190,121,69,203,120,149,-42,59,39,88,76,92,-13,62,30,115,44,57,-29,117,36,85,95,96,-45,59,13,33,53,57,-14,58,23,52,42,39,-31,1352,692,660,1043,523,520,197,147,319,247,315,116,106,61,177,131,152,57,91,86,142,116,163,59,189,105,174,215,273,81,92,46,91,104,138,50,97,59,83,111,135,31,1722,874,848,1246,608,638,262,137,349,325,394,240,152,47,170,159,215,125,110,90,179,166,179,115,220,109,174,243,331,165,110,40,76,119,172,91,110,69,98,124,159,74,1493,767,726,1093,553,540,193,223,295,256,338,173,125,84,155,110,178,108,68,139,140,146,160,65,152,135,182,213,282,123,72,55,93,104,148,77,80,80,89,109,134,46,1294,676,618,990,531,459,204,114,287,237,297,151,109,62,140,133,145,86,95,52,147,104,152,65,176,120,215,172,224,77,99,59,116,96,115,42,77,61,99,76,109,35,838,409,429,733,362,371,102,146,134,149,197,108,27,73,64,91,93,56,75,73,70,58,104,52,100,111,131,143,184,60,38,46,68,83,91,33,62,65,63,60,93,27,42,-26,68,-26,-36,10,-46,10,-5,32,60,-18,-34,4,-11,-2,24,-10,-12,6,6,34,36,-8,-14,-3,-5,4,43,-56,-10,-5,-18,0,19,-23,-4,2,13,4,24,-33,361,205,156,240,124,116,72,26,76,65,102,22,29,20,44,50,56,9,43,6,32,15,46,13,47,21,57,54,78,-20,24,8,28,27,48,-12,23,13,29,27,30,-8,313,194,119,252,135,117,69,15,69,59,59,34,48,-2,43,51,26,28,21,17,26,8,33,6,42,13,47,69,67,9,21,-7,31,36,38,14,21,20,16,33,29,-5,258,144,114,184,102,82,30,29,39,61,63,24,22,14,22,19,33,28,8,15,17,42,30,-4,34,13,9,29,76,16,15,5,12,7,42,16,19,8,-3,22,34,0,73,20,53,-50,-25,-25,37,42,-6,5,22,-33,21,23,-17,-3,8,-15,16,19,11,8,14,-18,0,12,-29,-7,5,-35,5,7,-21,-9,3,-13,-5,5,-8,2,2,-22,-329,-174,-155,-460,-241,-219,-10,-68,-67,-33,-52,-99,-2,-40,-40,-11,-20,-59,-8,-28,-27,-22,-32,-40,-47,-71,-83,-88,-39,-133,-12,-42,-60,-38,-21,-68,-35,-29,-23,-50,-18,-65,294,137,157,236,110,126,53,6,33,43,132,29,30,2,22,10,72,5,23,4,11,33,60,24,46,7,29,35,116,-1,24,5,15,12,61,-9,22,2,14,23,55,8,272,165,107,163,95,68,65,19,99,29,57,8,38,4,33,32,49,11,27,15,66,-3,8,-3,54,1,51,46,32,-25,24,-2,21,25,27,-2,30,3,30,21,5,-23,233,105,128,83,30,53,100,12,39,22,54,2,61,5,4,4,21,9,39,7,35,18,33,-7,58,14,6,2,44,-48,26,-6,3,-2,18,-12,32,20,3,4,26,-36,-881,-452,-429,-913,-462,-451,-25,-104,-115,-126,-121,-397,-8,-61,-53,-62,-70,-201,-17,-43,-62,-64,-51,-196,-11,-94,-97,-139,-126,-452,0,-56,-51,-73,-62,-222,-11,-38,-46,-66,-64,-230
3,03012,Algorfa,1220,264,138,126,264,139,125,3,7,10,76,142,26,-1,5,7,36,71,20,4,2,3,40,71,6,8,3,12,73,142,26,2,1,9,36,71,20,6,2,3,37,71,6,93,48,45,108,56,52,11,2,2,7,60,11,4,1,0,3,34,6,7,1,2,4,26,5,12,5,5,12,64,10,5,2,3,5,36,5,7,3,2,7,28,5,188,99,89,194,103,91,22,8,16,37,85,20,17,1,8,13,50,10,5,7,8,24,35,10,24,5,11,33,99,22,15,2,6,11,56,13,9,3,5,22,43,9,92,45,47,100,49,51,3,5,6,18,50,5,1,3,1,10,24,2,2,2,5,8,26,3,5,3,6,21,52,12,4,2,2,9,25,7,1,1,4,12,27,5,317,152,165,319,161,158,45,5,23,57,154,31,21,1,8,26,80,14,24,4,15,31,74,17,38,7,23,55,158,37,22,3,9,24,85,17,16,4,14,31,73,20,610,300,310,609,297,312,62,14,42,105,325,59,32,-1,23,42,166,38,30,15,19,63,159,21,64,12,41,120,311,59,29,2,20,51,157,38,35,10,21,69,154,21,747,383,364,706,370,336,80,11,75,192,324,59,41,0,41,93,164,39,39,11,34,99,160,20,70,12,50,186,331,54,37,5,27,93,169,36,33,7,23,93,162,18,480,233,247,475,227,248,56,13,38,135,190,45,21,10,15,68,92,28,35,3,23,67,98,17,51,15,30,126,205,44,18,8,12,60,100,29,33,7,18,66,105,15,218,110,108,245,127,118,13,7,14,46,113,24,-7,8,9,32,50,17,20,-1,5,14,63,7,30,3,27,54,113,18,13,3,14,31,52,14,17,0,13,23,61,4,206,95,111,183,87,96,11,7,6,60,91,28,4,0,6,23,46,14,7,7,0,37,45,14,18,4,5,41,94,21,7,0,2,15,52,11,11,4,3,26,42,10,98,55,43,101,49,52,7,2,5,21,51,9,6,4,0,11,28,3,1,-2,5,10,23,6,13,4,8,23,41,11,4,4,2,9,24,5,9,0,6,14,17,6,159,77,82,164,83,81,28,6,16,35,71,-2,16,2,5,12,40,1,12,4,11,23,31,-3,24,3,15,34,75,10,13,0,8,17,38,7,11,3,7,17,37,3,178,91,87,139,70,69,20,2,36,30,71,17,12,-1,16,15,34,13,8,3,20,15,37,4,15,2,15,31,59,15,6,2,8,15,27,10,9,0,7,16,32,5,32,29,3,81,47,34,-24,-1,15,-7,45,1,-17,3,19,-4,27,-1,-7,-4,-4,-3,18,2,0,3,12,17,41,7,1,2,7,11,22,4,-1,1,5,6,19,3,64,36,28,60,36,24,3,-4,2,17,40,5,5,-1,-2,10,17,6,-2,-3,4,7,23,-1,3,-5,7,5,36,13,3,-1,6,3,15,9,0,-4,1,2,21,4,-73,-36,-37,-84,-44,-40,-1,-5,12,-21,-16,-43,0,-6,9,-7,-13,-19,-1,1,3,-14,-3,-24,0,-13,1,-17,-12,-43,-1,-9,2,-7,-8,-21,1,-4,-1,-10,-4,-22,-205,-99,-106,-231,-113,-118,-12,-31,8,-21,-54,-94,3,-16,-3,-7,-25,-50,-15,-15,11,-14,-29,-44,-14,-31,0,-34,-52,-100,2,-14,-5,-13,-30,-53,-16,-17,5,-21,-22,-47,-70,-36,-34,-88,-47,-41,1,-2,11,9,15,-106,1,-2,5,12,2,-55,0,0,6,-3,13,-51,4,-3,1,9,8,-107,4,-2,2,5,-1,-55,0,-1,-1,4,9,-52
3,03013,Algueña,1459,18,9,9,5,2,3,9,5,0,6,2,-4,6,-1,1,3,2,-2,3,6,-1,3,0,-2,2,1,1,1,0,0,1,0,0,1,0,0,1,1,1,0,0,0,20,-2,22,7,1,6,3,7,8,-1,1,2,-1,0,5,-6,-1,1,4,7,3,5,2,1,0,2,2,2,1,0,0,0,1,0,0,0,0,2,1,2,1,0,5,3,2,16,9,7,3,1,-2,9,-3,-2,1,-1,-3,10,-3,-1,2,2,1,-1,0,-1,2,6,3,5,0,0,2,3,1,3,0,0,0,3,2,2,0,0,11,2,9,2,1,1,4,-1,3,-2,7,-2,1,0,0,-1,3,-1,3,-1,3,-1,4,-1,0,1,0,0,1,0,0,1,0,0,0,0,0,0,0,0,1,0,38,20,18,13,5,8,15,8,4,8,4,0,7,3,1,6,2,1,8,5,3,2,2,-1,4,3,3,2,1,0,1,1,2,1,0,0,3,2,1,1,1,0,20,2,18,24,12,12,-3,4,8,5,5,2,-7,1,2,3,2,2,4,3,6,2,3,0,3,2,9,4,5,1,1,2,5,2,2,0,2,0,4,2,3,1,-13,-3,-10,5,1,4,-2,-1,-4,1,-5,-3,0,-1,1,-2,0,-1,-2,0,-5,3,-5,-2,0,0,3,1,1,0,0,0,0,0,1,0,0,0,3,1,0,0,46,32,14,27,20,7,1,11,12,12,12,-1,0,5,12,10,7,-2,1,6,0,2,5,1,3,5,7,9,3,0,2,4,6,6,2,0,1,1,1,3,1,0,-4,1,-5,9,6,3,1,-2,1,-1,2,-5,0,-2,2,1,2,-2,1,0,-1,-2,0,-3,0,1,5,3,0,0,0,1,3,2,0,0,0,0,2,1,0,0,-5,7,-12,3,2,1,-6,-1,0,1,2,-1,-2,2,4,1,2,0,-4,-3,-4,0,0,-1,0,2,0,1,0,0,0,1,0,1,0,0,0,1,0,0,0,0,-25,-2,-23,-1,0,-1,-8,-4,-14,2,1,-2,-2,0,-4,3,1,0,-6,-4,-10,-1,0,-2,0,0,-1,0,0,0,-1,0,0,1,0,0,1,0,-1,-1,0,0,21,2,19,4,1,3,7,3,7,7,-4,0,1,0,3,0,-2,0,6,3,4,7,-2,0,0,0,1,2,0,0,0,0,0,1,0,0,0,0,1,1,0,0,0,2,-2,1,1,0,-3,3,3,-9,4,1,-2,1,0,0,3,-1,-1,2,3,-9,1,2,0,1,-2,1,1,0,0,0,-1,1,1,0,0,1,-1,0,0,0,-17,-8,-9,5,2,3,-6,-2,-9,-2,1,0,-2,-1,-1,-3,1,-2,-4,-1,-8,1,0,2,2,0,3,0,0,0,1,0,1,0,0,0,1,0,2,0,0,0,-22,-6,-16,2,1,1,-1,-6,-5,0,-7,-3,0,0,-4,-1,-4,3,-1,-6,-1,1,-3,-6,0,0,0,1,1,0,0,0,0,0,1,0,0,0,0,1,0,0,-2,-1,-1,5,2,3,-1,-2,-5,7,0,-2,-1,-1,2,0,0,-1,0,-1,-7,7,0,-1,1,1,0,0,2,1,0,1,0,0,1,0,1,0,0,0,1,1,-74,-41,-33,-56,-35,-21,-12,-7,-13,-28,-13,-2,-6,-4,-5,-18,-8,-1,-6,-3,-8,-10,-5,-1,-6,-6,-6,-21,-14,-3,-3,-3,-4,-15,-9,-1,-3,-3,-2,-6,-5,-2,-29,-13,-16,0,2,-2,-8,-3,-6,-6,5,-9,-3,-2,-2,-4,3,-4,-5,-1,-4,-2,2,-5,-1,0,1,-1,1,0,0,0,1,0,1,0,-1,0,0,-1,0,0
3,03014,Alicante/Alacant,272432,1555,764,791,316,170,146,266,47,333,313,158,428,131,7,195,140,31,254,135,40,138,173,127,174,44,35,80,58,49,44,27,16,40,29,28,25,17,19,40,29,21,19,1670,863,807,284,142,142,355,201,507,368,120,120,173,128,253,166,70,73,182,73,254,202,50,47,62,23,61,42,53,40,26,8,31,25,32,19,36,15,30,17,21,21,1999,1022,977,184,109,75,223,387,658,433,222,82,101,203,343,202,95,75,122,184,315,231,127,7,62,17,-19,24,54,39,26,23,-3,13,28,18,36,-6,-16,11,26,21,1185,729,456,270,145,125,130,232,471,269,96,26,105,115,261,195,42,24,25,117,210,74,54,2,42,53,50,22,70,29,19,36,20,18,34,16,23,17,30,4,36,13,6223,3350,2873,5569,3012,2557,960,1516,1828,1284,370,246,474,791,1098,734,137,111,486,725,730,550,233,135,840,1353,1707,944,475,211,429,696,1032,519,223,93,411,657,675,425,252,118,5458,2936,2522,5676,3081,2595,801,1412,1798,987,399,101,381,743,1051,552,154,79,420,669,747,435,245,22,844,1425,1867,937,405,161,429,721,1119,541,170,79,415,704,748,396,235,82,4715,2330,2385,6191,3140,3051,776,1503,1403,759,337,-22,423,695,760,319,154,-5,353,808,643,440,183,-17,959,1596,1908,1056,482,146,500,738,1072,540,207,61,459,858,836,516,275,85,4627,2395,2232,6478,3427,3051,758,1659,1215,741,341,-70,400,838,677,409,118,-11,358,821,538,332,223,-59,1043,1890,1910,1014,442,144,544,987,1086,538,190,70,499,903,824,476,252,74,596,199,397,2878,1352,1526,121,637,-17,14,27,-156,92,298,-101,-59,-15,-4,29,339,84,73,42,-152,582,947,789,362,150,18,293,443,411,129,54,7,289,504,378,233,96,11,-1356,-925,-431,638,155,483,-82,68,-642,-434,-48,-198,-109,-40,-441,-247,-26,-45,27,108,-201,-187,-22,-153,201,320,97,-94,33,43,91,92,-41,-60,25,30,110,228,138,-34,8,13,-802,-631,-171,442,0,442,-45,173,-689,-108,25,-133,-68,81,-408,-178,-13,-26,23,92,-281,70,38,-107,101,303,-81,17,37,46,34,121,-109,-74,9,14,67,182,28,91,28,32,550,328,222,992,379,613,214,237,30,18,161,-114,162,75,-10,26,51,21,52,162,40,-8,110,-135,228,305,148,141,106,39,131,85,46,37,39,30,97,220,102,104,67,9,303,234,69,1018,465,553,136,222,-86,62,110,-177,74,108,-5,14,58,-35,62,114,-81,48,52,-142,293,315,56,141,134,36,135,140,24,47,80,21,158,175,32,94,54,15,1008,592,416,1002,476,526,447,232,-70,244,246,-122,242,124,-65,144,131,-5,205,108,-5,100,115,-117,347,243,44,109,156,49,201,86,-6,58,74,33,146,157,50,51,82,16,1389,628,761,1479,701,778,410,243,211,273,272,-58,213,34,53,126,141,28,197,209,158,147,131,-86,372,265,266,216,226,83,210,90,123,98,111,45,162,175,143,118,115,38,-4446,-2397,-2049,-4386,-2461,-1925,33,-74,-1452,-1597,-589,-795,63,-39,-784,-949,-363,-335,-30,-35,-668,-648,-226,-460,-59,-32,-1365,-1729,-670,-585,4,-54,-703,-1055,-417,-265,-63,22,-662,-674,-253,-320,2294,1075,1219,2290,1003,1287,523,406,385,529,454,-50,295,192,123,279,198,-25,228,214,262,250,256,-25,467,463,479,374,318,123,233,205,221,157,121,34,234,258,258,217,197,89,3285,1463,1822,3792,1792,2000,888,545,758,586,354,100,481,265,293,195,134,60,407,280,465,391,220,40,868,629,964,690,354,223,456,313,436,304,153,94,412,316,528,386,201,129
3,03015,Almoradí,13606,120,101,19,128,77,51,-3,51,35,11,18,6,6,39,32,12,10,2,-9,12,3,-1,8,4,18,34,41,22,6,5,10,20,28,12,3,2,8,14,13,10,3,3,291,186,105,256,149,107,53,62,102,54,11,4,17,45,72,43,6,2,36,17,30,11,5,2,56,69,85,39,4,0,26,43,56,22,2,0,30,26,29,17,2,0,525,329,196,305,199,106,123,85,159,87,54,12,73,60,107,44,34,7,50,25,52,43,20,5,65,67,88,47,30,4,44,48,63,22,19,1,21,19,25,25,11,3,582,305,277,279,154,125,89,99,177,100,80,40,45,59,94,59,30,18,44,40,83,41,50,22,48,59,93,38,31,9,26,32,60,21,11,3,22,27,33,17,20,6,799,444,355,463,263,200,144,153,210,131,84,71,67,80,140,73,43,31,77,73,70,58,41,40,94,86,115,83,55,24,45,57,73,43,27,13,49,29,42,40,28,11,732,376,356,411,202,209,68,164,183,103,156,46,28,69,113,47,85,26,40,95,70,56,71,20,59,77,67,61,113,31,29,38,32,26,57,18,30,39,35,35,56,13,396,148,248,244,70,174,72,59,69,72,72,45,21,2,44,23,30,25,51,57,25,49,42,20,57,27,26,38,66,24,28,-3,-6,10,26,11,29,30,32,28,40,13,472,186,286,350,139,211,118,80,68,80,81,36,56,25,1,30,45,23,62,55,67,50,36,13,105,53,38,70,61,17,58,14,-6,27,32,11,47,39,44,43,29,6,496,269,227,283,150,133,101,67,170,85,44,27,59,28,89,60,20,12,42,39,81,25,24,15,67,53,56,54,36,13,40,26,29,24,20,9,27,27,27,30,16,4,274,144,130,117,36,81,28,58,75,-3,62,53,29,25,34,-11,36,31,-1,33,41,8,26,22,36,31,22,-15,30,10,20,9,-5,-18,18,9,16,22,27,3,12,1,-380,-194,-186,-437,-228,-209,-86,-28,-38,-81,-133,-8,-45,-17,-3,-33,-82,-13,-41,-11,-35,-48,-51,5,-68,-43,-53,-104,-137,-35,-34,-28,-20,-50,-78,-19,-34,-15,-33,-54,-59,-16,54,22,32,85,22,63,16,10,10,-2,10,14,17,0,-1,0,3,3,-1,10,11,-2,7,11,29,16,12,4,17,5,21,2,-11,2,7,1,8,14,23,2,10,4,11,-21,32,-50,-39,-11,11,-11,-7,-33,34,19,-11,-7,1,-30,17,12,22,-4,-8,-3,17,7,-30,1,-29,-19,20,3,-14,0,-22,-16,11,0,-16,1,-7,-3,9,3,216,131,85,45,5,40,52,67,31,23,25,18,26,30,6,37,9,23,26,37,25,-14,16,-5,13,13,-31,6,25,17,8,4,-32,0,12,12,5,9,1,6,13,5,-59,-56,-3,-59,-39,-20,-6,-33,-41,-10,11,29,-18,-19,-15,-16,10,10,12,-14,-26,6,1,19,-15,-7,-20,-38,15,6,-4,-6,-7,-33,8,4,-11,-1,-13,-5,7,2,173,100,73,61,33,28,34,32,40,26,16,24,24,8,36,13,5,13,10,24,4,13,11,11,14,22,19,12,0,-12,7,5,19,10,-6,-4,7,17,0,2,6,-8,121,64,57,1,-27,28,19,21,1,18,32,8,17,12,0,6,16,1,2,9,1,12,16,7,13,26,-4,-21,-1,-28,3,12,-7,-23,-6,-12,10,14,3,2,5,-16,140,67,73,55,11,44,46,7,68,22,-2,-18,26,11,26,10,-9,-4,20,-4,42,12,7,-14,21,15,44,0,5,-44,12,8,18,-13,-2,-21,9,7,26,13,7,-23
3,03018,Altea,14711,159,85,74,16,7,9,0,30,54,23,12,38,-1,11,27,18,7,20,1,19,27,5,5,18,4,0,5,2,3,2,2,0,1,0,3,1,2,0,4,2,0,1,282,132,150,9,8,1,27,28,112,57,31,23,10,8,52,38,13,9,17,20,60,19,18,14,1,1,2,2,2,1,1,0,2,2,2,1,0,1,0,0,0,0,173,94,79,6,6,0,6,15,98,18,8,23,18,9,51,10,-1,3,-12,6,47,8,9,20,3,6,1,1,-2,-3,1,5,3,2,-3,-2,2,1,-2,-1,1,-1,389,223,166,133,87,46,45,51,101,74,33,82,26,26,71,55,5,38,19,25,30,19,28,44,19,39,31,21,19,0,11,22,18,16,12,5,8,17,13,5,7,-5,1188,653,535,1023,561,462,114,174,324,220,259,96,46,83,201,118,143,62,68,91,123,102,116,34,101,150,240,197,252,78,42,71,135,114,143,55,59,79,105,83,109,23,922,459,463,948,490,458,105,110,114,204,253,142,39,55,81,84,126,70,66,55,33,120,127,72,126,127,173,189,216,117,62,63,102,92,107,64,64,64,71,97,109,53,851,449,402,854,441,413,166,114,158,172,148,92,82,74,71,84,81,55,84,40,87,88,67,37,142,142,159,149,186,75,66,69,76,77,101,52,76,73,83,72,85,23,870,496,374,901,498,403,135,122,114,183,227,82,78,75,64,103,121,50,57,47,50,80,106,32,134,139,177,177,212,54,73,77,99,97,110,37,61,62,78,80,102,17,284,125,159,399,201,198,46,27,69,17,86,33,44,-2,16,9,37,17,2,29,53,8,49,16,47,68,82,74,95,28,38,25,37,38,49,13,9,43,45,36,46,15,298,92,206,241,98,143,61,41,8,57,84,36,34,6,-32,32,25,17,27,35,40,25,59,19,35,43,24,42,64,27,19,4,-1,22,31,20,16,39,25,20,33,7,163,51,112,220,85,135,73,43,-11,35,39,-21,26,20,-8,10,15,-15,47,23,-3,25,24,-6,82,47,23,49,29,-17,39,15,4,15,16,-8,43,32,19,34,13,-9,319,171,148,318,175,143,48,26,39,72,88,41,35,16,14,42,39,23,13,10,25,30,49,18,52,44,25,70,86,38,32,20,7,40,49,23,20,24,18,30,37,15,98,4,94,104,27,77,20,-9,-31,43,72,4,2,-25,-36,20,44,2,18,16,5,23,28,2,15,24,1,19,43,-1,1,-3,-11,9,28,2,14,27,12,10,15,-3,-34,12,-46,-23,-2,-21,-2,-26,69,21,-16,-85,21,-7,21,23,-23,-27,-23,-19,48,-2,7,-58,21,-19,33,21,-5,-77,16,-9,1,23,-4,-30,5,-10,32,-2,-1,-47,314,131,183,352,156,196,71,30,6,94,68,42,30,12,-11,41,31,25,41,18,17,53,37,17,61,44,49,75,89,30,26,19,10,33,42,23,35,25,39,42,47,7,516,283,233,387,203,184,68,50,117,136,109,18,45,28,49,66,69,17,23,22,68,70,40,1,45,55,78,81,85,31,27,25,34,39,48,22,18,30,44,42,37,9,409,202,207,412,206,206,78,5,88,104,80,40,27,18,53,52,30,14,51,-13,35,52,50,26,67,46,78,101,85,26,30,26,47,49,40,9,37,20,31,52,45,17,484,227,257,504,264,240,61,64,141,63,107,36,26,27,76,43,25,20,35,37,65,20,82,16,70,72,125,96,112,22,34,41,71,52,47,14,36,31,54,44,65,8
3,03019,Aspe,16492,65,33,32,43,24,19,39,6,-7,24,13,-13,22,-2,-4,12,5,-4,17,8,-3,12,8,-9,5,10,14,10,3,1,2,9,8,4,1,0,3,1,6,6,2,1,165,116,49,139,83,56,20,40,34,39,18,10,10,20,35,26,12,11,10,20,-1,13,6,-1,26,27,46,26,10,4,13,16,31,14,6,3,13,11,15,12,4,1,361,198,163,224,124,100,78,47,100,68,50,10,50,27,52,36,24,6,28,20,48,32,26,4,44,41,67,33,31,4,28,23,32,22,14,3,16,18,35,11,17,1,398,229,169,174,94,80,82,89,138,67,18,-2,42,47,75,44,10,5,40,42,63,23,8,-7,51,45,39,22,9,5,25,27,22,10,3,4,26,18,17,12,6,1,298,166,132,167,95,72,22,61,106,60,42,11,8,35,66,39,14,7,14,26,40,21,28,4,27,23,37,42,28,9,12,15,23,27,10,7,15,8,14,15,18,2,547,310,237,236,125,111,91,75,165,103,88,18,58,38,98,53,54,8,33,37,67,50,34,10,34,38,45,51,53,12,11,24,24,27,31,7,23,14,21,24,22,5,477,243,234,196,104,92,78,86,171,95,42,3,35,38,95,51,24,0,43,48,76,44,18,3,33,38,43,37,40,4,17,17,25,22,21,2,16,21,18,15,19,2,528,251,277,239,118,121,99,112,144,95,48,26,49,48,75,47,14,10,50,64,69,48,34,16,52,65,53,35,29,2,29,33,29,13,9,2,23,32,24,22,20,0,172,100,72,111,61,50,32,17,84,7,17,7,22,9,43,8,10,4,10,8,41,-1,7,3,30,23,20,26,4,4,18,14,6,16,4,2,12,9,14,10,0,2,59,34,25,-48,-28,-20,27,30,-8,6,-10,9,6,23,2,1,-5,4,21,7,-10,5,-5,5,-6,-3,-30,-8,0,-1,-2,0,-19,-7,0,0,-4,-3,-11,-1,0,-1,-116,-78,-38,-208,-126,-82,-36,-13,-14,-25,-24,-4,-19,-12,-26,-11,-8,-1,-17,-1,12,-14,-16,-3,-39,-22,-48,-57,-30,-13,-13,-11,-38,-39,-16,-8,-26,-11,-10,-18,-14,-5,-24,-20,-4,31,4,27,-1,2,-27,3,10,-14,-6,6,-14,-4,4,-5,5,-4,-13,7,6,-9,14,9,-4,9,1,0,5,2,-3,1,-1,0,9,7,-1,8,2,0,-10,-7,-3,-74,-34,-40,-3,5,-5,-2,6,-12,-8,-1,9,-7,13,-5,5,6,-14,5,-7,-7,-14,-5,-6,-26,-15,-8,-7,-5,-1,-13,-3,-5,-7,0,-5,-13,-12,-3,-155,-99,-56,-155,-95,-60,-22,-27,-35,-41,-29,-3,-8,-12,-37,-21,-16,-4,-14,-15,2,-20,-13,1,-23,-13,-33,-40,-29,-19,-12,-11,-20,-26,-13,-13,-11,-2,-13,-14,-16,-6,46,20,26,-15,-5,-10,34,-15,14,-22,13,18,21,-14,20,-26,9,9,13,-1,-6,4,4,9,-2,-6,-5,-19,16,0,-4,-5,4,-11,9,2,2,-1,-9,-8,7,-2,39,3,36,-10,-19,9,13,9,-12,6,19,6,2,12,-25,-1,11,7,11,-3,13,7,8,-1,-11,6,-1,-9,15,-11,-9,4,-7,-9,6,-5,-2,2,6,0,9,-6,-27,-33,6,-28,-22,-6,0,7,-41,-25,22,9,3,-2,-33,-18,9,10,-3,9,-8,-7,13,-1,2,-8,-27,-7,11,0,0,-7,-14,-11,7,3,2,-1,-13,4,4,-3,77,38,39,46,23,23,14,3,28,17,17,-3,9,12,7,11,5,-3,5,-9,21,6,12,0,12,12,12,9,0,0,5,11,1,7,-4,2,7,1,11,2,4,-2
3,03021,Banyeres de Mariola,6848,-6,-4,-2,17,9,8,0,2,-3,4,-2,-8,-1,-1,3,2,-2,-5,1,3,-6,2,0,-3,2,4,6,5,0,0,1,1,5,2,0,0,1,3,1,3,0,0,55,25,30,46,27,19,11,13,24,7,6,-3,2,8,13,3,2,-2,9,5,11,4,4,-1,12,12,12,9,1,0,5,9,7,5,1,0,7,3,5,4,0,0,82,64,18,91,58,33,23,23,27,8,3,-2,23,13,20,6,2,1,0,10,7,2,1,-3,24,24,27,11,4,0,15,12,18,10,2,0,9,12,9,1,2,0,-12,8,-20,55,28,27,6,-1,-12,-1,3,-11,6,-3,-1,0,4,-2,0,2,-11,-1,-1,-9,16,10,13,9,5,0,9,5,4,5,3,0,7,5,9,4,2,0,-41,-14,-27,20,14,6,-9,-9,-14,4,-6,-5,-4,-1,-3,1,-5,-1,-5,-8,-11,3,-1,-4,1,5,8,6,0,0,1,5,4,4,0,0,0,0,4,2,0,0,-36,-21,-15,35,25,10,-9,-13,-15,-1,1,1,-7,-10,-3,-1,0,0,-2,-3,-12,0,1,1,2,7,17,8,1,0,1,4,13,7,0,0,1,3,4,1,1,0,-6,4,-10,23,9,14,-2,-3,-6,2,-3,5,1,2,-4,2,1,1,-3,-5,-2,0,-4,4,9,8,6,-2,2,0,7,3,0,-2,1,0,2,5,6,0,1,0,-6,0,-6,25,8,17,6,-3,-9,9,-1,-5,4,-5,-2,3,0,0,2,2,-7,6,-1,-5,4,11,0,5,3,1,2,0,0,2,2,1,2,11,0,3,1,0,17,-2,19,23,11,12,6,8,-7,0,2,9,1,2,-3,-4,-1,4,5,6,-4,4,3,5,9,10,0,2,1,1,6,4,-1,1,0,1,3,6,1,1,1,0,-2,0,-2,12,7,5,8,0,3,-8,-1,-4,1,1,2,-4,-1,0,7,-1,1,-4,0,-4,2,1,5,1,3,0,1,0,4,1,1,0,1,1,1,0,2,0,-27,-9,-18,20,13,7,2,-12,-10,-4,1,-4,1,-5,-7,1,2,-1,1,-7,-3,-5,-1,-3,8,5,9,0,-1,-1,8,2,2,1,0,0,0,3,7,-1,-1,-1,28,7,21,-5,-6,1,4,20,-10,3,4,2,2,7,-8,1,2,0,2,13,-2,2,2,2,4,2,-9,-5,0,3,3,0,-7,-3,0,1,1,2,-2,-2,0,2,-47,-18,-29,-11,-7,-4,-8,-9,-4,-12,-7,-7,-3,0,1,-7,-6,-4,-5,-9,-5,-5,-1,-3,-1,-2,0,-3,-2,-3,-2,-1,3,-3,-2,-2,1,-1,-3,0,0,-1,10,3,7,-13,-8,-5,11,5,-14,1,2,4,3,6,-8,-2,2,2,8,-1,-6,3,0,2,3,4,-16,-3,-2,0,1,4,-8,-4,-1,0,2,0,-8,1,-1,0,-24,-12,-12,-9,-3,-6,9,-4,-14,-7,-6,-2,7,1,-15,2,-7,0,2,-5,1,-9,1,-2,-1,1,-6,-2,-1,0,1,1,-4,0,-1,0,-2,0,-2,-2,0,0,-29,-19,-10,9,1,8,-3,-2,-3,-10,-7,-2,0,-2,-3,-10,-3,0,-3,0,0,0,-4,-2,-1,5,1,1,1,1,0,2,-1,-2,1,1,-1,3,2,3,0,0,2,5,-3,-9,-8,-1,13,-1,-7,7,-8,-3,11,1,-4,0,-3,0,2,-2,-3,7,-5,-3,4,4,-8,1,-5,-5,2,-1,-4,-1,-1,-3,2,5,-4,2,-4,-2,28,7,21,31,17,14,12,-7,4,8,-4,13,4,-3,6,0,-2,0,8,-4,-2,8,-2,13,11,4,10,3,3,-1,6,1,7,2,1,0,5,3,3,1,2,-1
3,03023,Beneixama,1796,58,29,29,71,37,34,3,16,18,16,1,4,-1,5,13,9,1,2,4,11,5,7,0,2,2,19,29,16,2,3,0,6,17,10,2,2,2,13,12,6,0,1,-5,-2,-3,32,17,15,1,5,-7,-5,4,-3,0,4,-5,-2,1,0,1,1,-2,-3,3,-3,3,10,12,4,3,0,1,6,5,4,1,0,2,4,7,0,2,0,77,50,27,84,49,35,33,20,8,13,2,1,22,13,3,13,1,-1,11,7,5,0,1,2,31,20,17,14,0,1,19,13,9,8,0,0,12,7,8,6,0,1,28,13,15,82,40,42,11,8,3,6,5,-5,4,6,4,1,1,-3,7,2,-1,5,4,-2,26,16,22,13,4,0,12,10,12,5,1,0,14,6,10,8,3,0,-38,-23,-15,4,1,3,-9,-1,-20,-12,2,1,-5,-3,-6,-12,2,0,-4,2,-14,0,0,1,0,3,-1,2,-1,1,0,2,-1,0,0,0,0,1,0,2,-1,1,-55,-26,-29,-2,-1,-1,-16,-11,-20,-3,1,-4,-7,-7,-9,-2,1,-1,-9,-4,-11,-1,0,-3,-1,-1,-2,1,1,0,-1,-1,0,1,0,0,0,0,-2,0,1,0,-19,-16,-3,14,11,3,-3,-4,-6,0,-1,-3,-2,-2,-6,-2,-2,-1,-1,-2,0,2,1,-2,1,5,5,3,0,0,1,4,3,3,0,0,0,1,2,0,0,0,-2,2,-4,20,9,11,4,1,-6,3,2,-6,5,1,-4,3,1,-4,-1,0,-2,0,1,-2,5,4,8,1,1,0,3,2,2,1,0,0,2,2,6,0,1,0,-10,-11,1,1,0,1,0,-1,-10,-4,1,5,-2,-1,-10,-3,2,3,2,0,0,-1,-1,2,-1,0,1,1,0,0,-1,-1,1,1,0,0,0,1,0,0,0,0,9,8,1,11,6,5,2,3,-2,4,-1,4,4,2,3,0,-3,3,-2,1,-5,4,2,1,2,2,1,5,1,0,2,1,2,1,0,0,0,1,-1,4,1,0,-5,-3,-2,-12,-7,-5,-1,-10,-3,10,-2,3,-3,-4,1,4,0,1,2,-6,-4,6,-2,2,-2,-6,-1,0,-2,0,-3,-2,-1,1,-1,0,1,-4,0,-1,-1,0,-15,-11,-4,-10,-4,-6,-3,-1,-1,-12,0,1,-2,0,-2,-4,-1,-2,-1,-1,1,-8,1,3,-4,-1,0,-4,-1,0,-2,0,-1,-1,0,0,-2,-1,1,-3,-1,0,-4,-12,8,-1,-5,4,2,0,-3,-2,0,-1,-2,-3,-1,-3,-1,-1,4,3,-2,1,1,0,1,2,0,-4,0,0,-2,0,1,-4,0,0,3,2,-1,0,0,0,-8,-7,-1,-8,-6,-2,-6,1,0,-2,-1,-1,-3,-1,-1,0,-1,-1,-3,2,1,-2,0,0,-2,-1,-1,-4,0,0,-2,-2,0,-2,0,0,0,1,-1,-2,0,0,14,10,4,6,3,3,4,2,7,9,-8,-1,3,3,2,4,-3,0,1,-1,5,5,-5,-1,4,1,1,2,-2,0,4,-1,-1,2,-1,0,0,2,2,0,-1,0,-4,4,-8,2,1,1,1,3,-7,0,0,-1,0,-1,-3,6,2,0,1,4,-4,-6,-2,-1,1,2,0,0,-1,0,0,1,0,1,-1,0,1,1,0,-1,0,0,7,8,-1,3,5,-2,6,0,-5,7,0,1,5,2,-4,6,0,1,1,-2,-1,1,0,0,2,1,0,1,0,-1,2,1,0,2,0,0,0,0,0,-1,0,-1,-2,6,-8,-4,-1,-3,-2,-2,5,2,-1,-4,-2,4,4,0,0,0,0,-6,1,2,-1,-4,-2,-1,-2,3,-1,-1,-2,1,-2,2,0,0,0,-2,0,1,-1,-1
3,03024,Benejúzar,5067,73,25,48,25,17,8,16,18,13,5,3,18,7,0,5,4,2,6,9,18,8,1,1,12,2,8,9,2,2,2,2,5,6,2,1,1,0,3,3,0,1,1,50,38,12,78,43,35,9,12,13,11,-2,5,8,12,9,6,-1,3,1,0,4,5,-1,2,15,22,15,22,2,0,7,14,9,12,0,0,8,8,6,10,2,0,42,17,25,42,22,20,3,13,-4,4,2,24,4,5,-5,3,0,9,-1,8,1,1,2,15,7,12,17,6,0,0,4,7,10,2,-1,0,3,5,7,4,1,0,111,71,40,52,31,21,20,23,23,11,11,25,14,18,16,5,6,13,6,5,7,6,5,12,3,17,14,9,3,6,1,10,10,5,1,4,2,7,4,4,2,2,50,31,19,59,37,22,-9,8,13,5,11,25,-3,6,19,-2,2,12,-6,2,-6,7,9,13,5,16,23,7,6,2,4,9,16,4,2,2,1,7,7,3,4,0,83,61,22,49,26,23,21,16,9,3,10,23,10,12,15,2,9,11,11,4,-6,1,1,12,6,14,12,2,11,4,3,8,7,0,6,2,3,6,5,2,5,2,169,93,76,56,26,30,58,30,37,13,12,16,37,10,24,7,7,7,21,20,13,6,5,9,18,14,10,8,5,1,10,4,6,4,2,0,8,10,4,4,3,1,66,49,17,78,41,37,-3,5,10,12,18,24,-1,5,11,14,7,11,-2,0,-1,-2,11,13,19,10,18,15,10,6,10,5,10,8,5,3,9,5,8,7,5,3,11,-2,13,46,21,25,13,15,-12,-18,1,10,10,1,-9,-12,4,3,3,14,-3,-6,-3,7,17,11,5,6,5,1,12,5,-1,2,3,0,5,6,6,4,2,1,3,-18,21,1,-8,9,11,-8,-18,-9,7,21,2,-10,-9,-9,1,7,9,2,-9,0,6,14,2,4,-5,-7,4,3,3,-3,-5,-6,0,3,-1,7,0,-1,4,0,-5,-12,7,0,-3,3,9,-1,-16,-12,3,4,-1,6,-18,-7,3,1,10,-7,2,-5,0,3,5,3,-3,-4,-1,-1,1,2,-3,-2,0,-1,4,1,0,-2,-1,0,-37,-17,-20,-2,-4,2,-20,-10,-4,-3,-5,1,-10,-8,-1,3,-5,1,-10,-2,-3,-6,0,0,3,4,-5,-2,1,-4,1,0,-3,0,-1,-2,2,4,-2,-2,2,-2,11,6,5,-41,-20,-21,12,3,-5,-14,-1,3,11,-2,0,-9,0,0,1,5,-5,-5,-1,3,-4,0,-7,-16,-3,-12,0,-1,-4,-9,-2,-4,-4,1,-3,-7,-1,-8,-18,-14,-4,7,0,7,-25,-3,-19,-10,8,27,-14,1,-12,-4,3,10,-11,-4,-7,-6,5,17,-1,2,1,-2,4,3,-1,1,-2,-1,2,1,0,1,3,-1,2,2,53,31,22,13,7,6,15,4,13,5,-6,16,10,1,6,6,-2,7,5,3,7,-1,-4,9,3,2,3,-1,-1,4,1,0,1,-1,0,4,2,2,2,0,-1,0,-3,1,-4,19,6,13,-17,-4,-4,20,5,6,-6,-6,-5,12,4,5,-11,2,1,8,1,1,5,6,1,5,1,2,4,0,-1,2,1,1,1,6,2,3,0,1,7,-2,9,26,15,11,-9,10,9,-12,-5,13,-4,6,6,-13,-5,7,-5,4,3,1,0,6,0,7,4,8,4,3,0,2,6,5,1,1,0,5,-2,3,3,2,42,33,9,18,9,9,11,-6,-12,19,10,18,8,1,2,6,5,12,3,-7,-14,13,5,6,1,1,2,10,1,3,0,2,2,3,0,2,1,-1,0,7,1,1
3,03025,Benferri,1026,34,14,20,30,15,15,1,3,6,11,11,2,0,-2,-1,8,6,3,1,5,7,3,5,-1,1,5,3,6,12,3,0,2,0,4,6,3,1,3,3,2,6,0,37,16,21,37,15,22,0,2,9,2,21,3,1,-2,7,2,7,1,-1,4,2,0,14,2,3,5,7,0,21,1,2,1,4,0,8,0,1,4,3,0,13,1,56,34,22,28,17,11,18,3,3,12,18,2,10,5,-1,10,8,3,8,-2,4,2,10,-1,6,1,5,5,9,2,5,0,2,5,3,2,1,1,3,0,6,0,83,36,47,29,13,16,6,9,26,10,21,9,2,1,13,2,12,4,4,8,13,8,9,5,4,2,7,2,9,5,2,1,2,0,5,3,2,1,5,2,4,2,26,12,14,16,6,10,-1,2,2,10,18,-4,-2,1,3,5,9,-3,1,1,-1,5,9,-1,1,1,0,4,13,-3,1,0,-1,2,6,-2,0,1,1,2,7,-1,76,46,30,38,22,16,15,0,17,8,30,4,7,0,9,9,19,0,8,0,8,-1,11,4,2,1,-1,7,21,8,0,0,0,5,14,3,2,1,-1,2,7,5,89,49,40,35,20,15,15,10,14,16,24,12,9,4,8,7,9,12,6,6,6,9,15,0,5,2,5,1,15,7,4,0,4,-1,4,9,1,2,1,2,11,-2,122,63,59,24,10,14,17,25,39,15,19,8,9,11,26,10,9,0,8,14,13,5,10,8,-1,-2,5,4,14,4,0,-2,2,4,7,-1,-1,0,3,0,7,5,105,54,51,25,8,17,22,20,22,27,11,2,16,8,11,10,7,1,6,12,11,17,4,1,6,3,-1,8,6,3,3,1,-1,2,2,1,3,2,0,6,4,2,7,14,-7,2,0,2,-5,6,4,11,-6,-3,0,3,7,6,-1,-1,-5,3,-3,5,-5,-2,1,-1,-1,0,2,0,1,0,-1,-1,1,0,0,-1,0,1,1,0,16,16,0,-42,-20,-22,11,10,22,8,-9,-27,4,8,12,7,-4,-12,7,2,10,1,-5,-15,-3,0,-4,-1,-8,-26,-3,-1,-1,-1,-3,-11,0,1,-3,0,-5,-15,9,0,9,-10,-8,-2,1,11,14,-4,-4,-7,-1,3,10,-3,-2,-5,2,8,4,-1,-2,-2,-2,4,0,-2,-5,-5,-2,1,-1,0,-2,-4,0,3,1,-2,-3,-1,-15,1,-16,-24,-12,-12,-17,2,1,-6,1,4,-13,5,5,-2,6,0,-4,-3,-4,-4,-5,4,-8,3,-7,-8,-1,-3,-6,2,-3,-5,2,-2,-2,1,-4,-3,-3,-1,-12,-8,-4,-13,-7,-6,4,-8,-3,-5,-1,0,5,-8,-1,-5,0,0,-1,0,-2,0,-1,0,-2,-2,-6,-5,1,1,0,-1,-2,-5,0,1,-2,-1,-4,0,1,0,-13,-19,6,-4,-3,-1,1,5,-9,-6,2,-7,1,-3,-6,-7,0,-5,0,8,-3,1,2,-2,0,-1,3,-1,-1,-4,0,-1,3,-2,0,-3,0,0,0,1,-1,-1,16,13,3,-2,0,-2,1,-3,2,7,3,3,-3,0,3,4,5,2,4,-3,-1,3,-2,1,0,0,-1,1,-1,-1,0,0,0,1,0,-1,0,0,-1,0,-1,0,-15,-8,-7,-25,-17,-8,4,-8,5,-2,-5,-8,5,-4,1,0,-7,-2,-1,-4,4,-2,2,-6,-2,-5,-3,-3,-4,-8,-1,-2,0,-4,-7,-3,-1,-3,-3,1,3,-5,-7,-8,1,3,0,3,-6,3,3,3,6,-14,-6,1,-2,3,3,-7,0,2,5,0,3,-7,3,1,5,1,1,-9,1,0,2,0,1,-5,2,1,3,1,0,-4
3,03026,Beniarbeig,1205,82,56,26,73,48,25,4,20,21,14,14,8,4,14,16,8,9,4,0,6,5,6,5,4,5,20,25,14,5,3,3,12,20,7,3,2,2,8,5,7,2,1,79,36,43,83,42,41,8,17,29,16,6,3,1,8,18,6,0,3,7,9,11,10,6,0,8,21,25,21,5,2,1,10,15,14,0,2,7,11,10,7,5,0,57,36,21,42,24,18,15,9,8,4,17,3,11,6,4,5,9,2,4,3,4,-1,8,1,6,9,7,7,10,1,5,5,5,4,5,0,1,4,2,3,5,1,58,23,35,27,16,11,11,2,11,13,15,7,3,-1,4,5,9,3,8,3,7,8,6,4,3,4,5,5,6,4,2,1,4,4,3,2,1,3,1,1,3,2,70,34,36,32,18,14,10,3,18,12,16,11,4,1,9,4,7,9,6,2,9,8,9,2,4,3,5,6,10,4,2,2,4,2,5,3,2,1,1,4,5,1,67,33,34,50,26,24,18,4,20,5,13,4,10,0,13,0,6,3,8,4,7,5,7,1,8,3,10,9,15,4,3,2,7,4,7,2,5,1,3,5,8,2,136,76,60,59,35,24,39,17,18,28,19,13,21,9,5,19,10,8,18,8,13,9,9,5,10,9,4,12,16,8,6,6,2,8,9,4,4,3,2,4,7,4,159,81,78,36,13,23,29,27,46,32,21,0,8,14,23,18,11,4,21,13,23,14,10,-4,6,4,7,8,9,2,0,1,2,4,4,2,6,3,5,4,5,0,93,37,56,35,15,20,16,16,19,22,12,6,6,5,7,10,7,1,10,11,12,12,5,5,9,2,2,14,7,1,3,0,1,7,3,1,6,2,1,7,4,0,-111,-54,-57,-100,-55,-45,-18,-10,-11,-10,-35,-27,-9,-5,-5,0,-18,-16,-9,-5,-6,-10,-17,-11,-7,-6,-15,-10,-34,-29,-7,-4,-6,-5,-16,-17,0,-2,-9,-5,-18,-12,-3,-6,3,15,9,6,-7,-4,-5,8,3,1,-4,-3,-3,6,1,-3,-3,-1,-2,2,2,4,4,0,1,3,5,2,4,1,0,2,2,0,0,-1,1,1,3,2,18,14,4,13,5,8,-13,1,10,7,11,1,-8,2,6,6,3,2,-5,-1,4,1,8,-1,-5,1,6,5,6,0,-3,1,3,3,1,0,-2,0,3,2,5,0,15,-3,18,19,14,5,-3,-1,-2,-7,12,15,-10,1,-1,-9,6,9,7,-2,-1,2,6,6,3,4,-1,-2,11,4,2,3,0,0,4,5,1,1,-1,-2,7,-1,-52,-35,-17,-45,-26,-19,2,-7,-7,-19,-21,0,4,-5,-8,-11,-13,-2,-2,-2,1,-8,-8,2,-5,-2,-2,-10,-15,-12,0,-1,-4,-4,-8,-9,-5,-1,2,-6,-7,-3,69,44,25,9,4,5,24,1,12,7,5,22,17,0,9,2,3,14,7,1,3,5,2,8,-1,-3,1,1,5,6,0,-2,1,-1,1,5,-1,-1,0,2,4,1,2,1,1,3,4,-1,-14,4,2,-6,6,9,-4,0,4,-6,3,3,-10,4,-2,0,3,6,4,-1,0,0,2,-2,3,-1,1,-1,1,1,1,0,-1,1,1,-3,50,45,5,30,19,11,6,0,14,9,24,-5,6,3,9,9,15,1,0,-3,5,0,9,-6,4,-3,2,1,19,6,5,-1,0,-1,13,2,-1,-2,2,2,6,4,36,14,22,-15,-7,-8,-2,1,15,11,15,-4,-4,-4,10,9,10,-7,2,5,5,2,5,3,-7,-4,0,-5,5,-4,-3,-2,2,-2,2,-4,-4,-2,-2,-3,3,0
3,03030,Benidoleig,817,52,19,33,51,21,30,4,0,10,16,23,-1,1,0,5,4,11,-2,3,0,5,12,12,1,5,1,4,15,24,2,2,1,2,5,11,0,3,0,2,10,13,2,49,28,21,49,27,22,6,5,1,16,15,6,0,5,2,8,9,4,6,0,-1,8,6,2,7,3,4,13,14,8,3,3,2,6,9,4,4,0,2,7,5,4,45,26,19,58,28,30,2,3,7,9,22,1,2,2,3,7,11,1,0,1,4,2,11,0,5,6,7,11,25,3,1,3,4,6,13,1,4,3,3,5,12,2,62,29,33,66,33,33,15,4,8,6,20,9,4,1,7,2,11,4,11,3,1,4,9,5,12,3,8,5,27,11,6,0,5,2,13,7,6,3,3,3,14,4,59,33,26,45,26,19,7,3,12,8,30,-1,4,0,8,5,17,-1,3,3,4,3,13,0,1,3,6,4,28,3,1,0,4,4,14,3,0,3,2,0,14,0,63,27,36,53,24,29,9,1,18,7,25,3,3,1,10,2,11,0,6,0,8,5,14,3,6,3,10,5,23,6,2,1,5,2,11,3,4,2,5,3,12,3,44,25,19,36,20,16,11,-4,15,14,14,-7,8,-2,10,5,7,-4,3,-2,5,9,7,-3,5,0,3,12,10,6,4,0,3,6,3,4,1,0,0,6,7,2,79,31,48,52,22,30,15,6,9,18,23,8,5,4,4,7,7,4,10,2,5,11,16,4,7,2,8,8,16,11,3,2,3,3,6,5,4,0,5,5,10,6,56,32,24,16,9,7,14,3,16,12,5,6,10,1,5,9,4,3,4,2,11,3,1,3,3,2,0,7,2,2,2,1,-1,5,1,1,1,1,1,2,1,1,-3,2,-5,-34,-16,-18,13,0,-5,-2,2,-11,12,-3,-3,-1,3,-6,1,3,-2,-1,-1,-5,-6,-1,-8,-12,1,-8,-1,-3,-4,-5,2,-5,-5,2,-4,-7,-1,-3,51,29,22,29,17,12,9,4,3,13,12,8,5,1,3,8,4,6,4,3,0,5,8,2,0,4,4,6,8,7,0,2,4,4,4,3,0,2,0,2,4,4,14,13,1,16,11,5,-4,-4,-2,10,12,1,-2,0,0,4,8,2,-2,-4,-2,6,4,-1,-2,0,1,4,9,4,0,1,2,1,4,3,-2,-1,-1,3,5,1,24,12,12,16,6,10,10,-1,0,1,7,5,4,0,0,0,4,4,6,-1,0,1,3,1,2,0,1,2,9,2,0,0,1,-1,3,3,2,0,0,3,6,-1,-11,-6,-5,6,3,3,-7,-1,4,-3,3,-8,-4,-1,3,-1,1,-4,-3,0,1,-2,2,-4,0,1,1,1,6,-3,0,1,1,0,3,-2,0,0,0,1,3,-1,22,17,5,18,10,8,-1,1,4,-1,13,7,0,-1,0,2,9,7,-1,2,4,-3,4,0,1,0,2,-2,14,4,0,0,1,-1,8,2,1,0,1,-1,6,2,-169,-78,-91,-149,-78,-71,-30,-9,-18,-33,-12,-66,-16,-5,-4,-19,-4,-30,-14,-4,-14,-14,-8,-36,-17,-6,-11,-32,-20,-63,-10,-4,-4,-20,-10,-30,-7,-2,-7,-12,-10,-33,37,21,16,31,17,14,4,1,2,5,17,6,2,2,0,4,8,3,2,-1,2,1,9,3,3,0,3,3,16,5,3,0,1,1,8,3,0,0,2,2,8,2,47,23,24,27,17,10,5,3,6,13,10,7,3,0,2,6,6,4,2,3,4,7,4,3,0,3,2,5,10,7,0,1,1,4,6,5,0,2,1,1,4,2
3,03031,Benidorm,52845,2643,1361,1282,1861,943,918,309,518,745,418,352,269,160,240,409,241,173,125,149,278,336,177,179,144,225,348,554,368,218,129,108,160,300,198,109,60,117,188,254,170,109,69,3414,1858,1556,2937,1596,1341,348,788,903,633,438,292,163,423,519,367,220,163,185,365,384,266,218,129,389,641,822,565,339,167,206,333,452,321,184,94,183,308,370,244,155,73,3097,1712,1385,2960,1591,1369,380,722,811,520,397,261,186,339,528,302,204,152,194,383,283,218,193,109,436,623,765,569,363,186,218,292,434,332,196,112,218,331,331,237,167,74,2347,1305,1042,2556,1329,1227,261,546,462,463,391,196,127,273,293,267,200,130,134,273,169,196,191,66,352,516,649,472,384,164,172,233,357,255,215,87,180,283,292,217,169,77,2085,1231,854,2633,1385,1248,245,464,469,356,404,146,109,244,298,246,230,107,136,220,171,110,174,39,367,529,671,472,399,182,164,258,373,265,208,111,203,271,298,207,191,71,1636,863,773,2489,1329,1160,136,415,260,298,361,156,60,217,181,147,187,72,76,198,79,151,174,84,300,555,598,452,375,192,160,277,347,230,192,117,140,278,251,222,183,75,1287,796,491,2575,1337,1238,127,394,170,229,260,122,99,192,198,121,137,57,28,202,-28,108,123,65,366,586,609,457,377,169,201,275,333,242,189,93,165,311,276,215,188,76,1546,836,710,2638,1366,1272,199,408,123,286,318,186,96,203,101,166,142,106,103,205,22,120,176,80,397,605,621,465,392,146,195,277,349,258,192,86,202,328,272,207,200,60,1103,558,545,1738,915,823,161,275,108,141,297,105,81,128,79,54,164,48,80,147,29,87,133,57,247,376,384,324,286,112,142,181,202,165,158,62,105,195,182,159,128,50,713,399,314,1227,660,567,73,196,96,73,155,97,21,115,63,74,64,58,52,81,33,-1,91,39,178,272,226,220,198,119,97,139,128,119,108,65,81,133,98,101,90,54,1084,594,490,1289,694,595,251,221,88,201,197,130,100,118,73,97,115,93,151,103,15,104,82,37,236,274,304,211,159,96,121,140,162,118,88,61,115,134,142,93,71,35,1439,793,646,1356,715,641,220,265,333,213,226,165,120,139,192,122,123,95,100,126,141,91,103,70,217,299,288,224,198,112,118,158,161,105,106,59,99,141,127,119,92,53,-1228,-687,-541,-1210,-675,-535,-47,74,-509,-520,-138,-98,-21,66,-336,-309,-82,-9,-26,8,-173,-211,-56,-89,-46,46,-474,-516,-137,-87,-19,34,-293,-322,-62,-16,-27,12,-181,-194,-75,-71,1431,703,728,1092,586,506,193,203,368,171,251,208,102,68,164,82,130,127,91,135,204,89,121,81,163,167,241,177,196,133,84,80,130,96,110,76,79,87,111,81,86,57,-5429,-2975,-2454,-5699,-3097,-2602,-152,-180,-1054,-1156,-1124,-1780,-84,-109,-500,-694,-597,-991,-68,-71,-554,-462,-527,-789,-222,-219,-1060,-1261,-1180,-1767,-122,-119,-511,-738,-632,-977,-100,-100,-549,-523,-548,-790,907,483,424,801,430,371,101,169,99,166,253,90,60,92,33,91,145,48,41,77,66,75,108,42,102,150,175,92,165,96,65,87,96,29,84,60,37,63,79,63,81,36,1197,694,503,1305,673,632,148,196,217,267,208,162,94,89,101,164,114,129,54,107,116,103,94,33,189,235,286,238,207,139,106,104,125,126,117,88,83,131,161,112,90,51,-2190,-1183,-1007,-2324,-1277,-1047,-143,20,-468,-567,-402,-637,-48,36,-274,-352,-209,-342,-95,-16,-194,-215,-193,-295,-172,11,-478,-641,-435,-625,-90,21,-257,-415,-211,-333,-82,-10,-221,-226,-224,-292
3,03034,Benijófar,1655,273,141,132,282,143,139,27,16,29,67,119,14,9,14,16,29,60,13,18,2,13,38,59,1,31,22,30,64,116,17,10,14,20,26,60,13,21,8,10,38,56,4,274,128,146,251,129,122,49,16,34,45,106,23,27,8,15,18,53,7,22,8,19,27,53,16,35,13,26,46,106,24,22,10,11,21,54,11,13,3,15,25,52,13,278,142,136,272,138,134,31,-6,14,69,137,29,19,0,5,31,66,19,12,-6,9,38,71,10,35,3,22,63,125,24,19,1,12,29,60,17,16,2,10,34,65,7,406,190,216,390,190,200,63,14,30,82,171,43,22,7,17,35,84,23,41,7,13,47,87,20,46,11,32,85,171,43,17,5,18,38,86,24,29,6,14,47,85,19,234,138,96,273,148,125,21,4,19,59,100,30,14,3,12,39,45,24,7,1,7,20,55,6,39,8,23,67,116,17,23,2,11,39,55,16,16,6,12,28,61,1,184,103,81,183,102,81,24,21,26,42,69,-3,8,13,12,26,42,-1,16,8,14,16,27,-2,26,21,22,42,66,5,12,12,11,23,42,1,14,9,11,19,24,4,192,95,97,150,79,71,15,21,23,44,78,10,7,17,9,12,40,7,8,4,14,32,38,3,16,8,9,39,65,11,9,8,2,16,36,7,7,0,7,23,29,4,193,99,94,147,73,74,40,5,43,13,73,17,23,-3,26,7,35,11,17,8,17,6,38,6,19,14,18,25,56,13,11,5,7,11,30,7,8,9,11,14,26,6,89,46,43,96,53,43,2,15,24,21,23,2,-2,4,20,9,11,2,4,11,4,12,12,0,9,6,20,26,31,3,5,3,13,14,16,1,4,3,7,12,15,2,50,16,34,71,28,43,-12,6,2,11,35,7,-16,5,5,-3,18,7,4,1,-3,14,17,0,4,9,6,19,30,3,-2,4,2,6,16,2,6,5,4,13,14,1,112,60,52,89,47,42,14,8,23,13,36,13,9,3,9,10,15,10,5,5,14,3,21,3,18,1,9,21,30,9,10,1,3,12,15,5,8,0,6,9,15,4,64,19,45,80,40,40,9,6,-5,22,20,12,-3,3,1,5,6,8,12,3,-6,17,14,4,4,11,12,25,21,7,-1,5,8,11,13,4,5,6,4,14,8,3,129,60,69,83,43,40,25,6,15,26,43,11,12,3,-1,20,16,9,13,3,16,6,27,2,13,7,11,20,25,6,7,3,6,13,10,3,6,4,5,7,15,3,93,43,50,85,44,41,20,1,2,22,30,17,8,-2,4,6,13,13,12,3,-2,16,17,4,10,4,5,22,30,14,7,2,0,9,15,11,3,2,5,13,15,3,5,10,-5,34,24,10,-13,-1,-7,-4,33,-3,-1,2,-3,-6,19,-1,-12,-3,-4,2,14,-2,2,3,0,7,28,-6,1,3,0,3,19,-2,1,0,0,4,9,-4,-159,-90,-69,-114,-60,-54,-23,-26,-21,-21,-8,-60,-11,-7,-15,-15,-10,-32,-12,-19,-6,-6,2,-28,-20,-17,-4,-13,-5,-55,-7,-6,-4,-10,-5,-28,-13,-11,0,-3,0,-27,114,61,53,123,70,53,1,4,0,28,59,23,0,2,0,15,29,15,1,2,0,13,30,8,4,3,6,29,59,22,5,2,3,16,31,13,-1,1,3,13,28,9,136,64,72,104,49,55,17,-3,14,16,67,24,4,-2,0,8,40,14,13,-1,14,8,27,10,3,6,8,14,55,17,1,3,1,7,26,11,2,3,7,7,29,6
3,03041,Benissa,9687,470,263,207,428,229,199,61,44,97,89,119,52,30,30,56,47,73,25,31,14,41,42,46,27,46,39,76,76,129,56,22,19,42,41,73,30,24,20,34,35,56,26,487,265,222,480,266,214,66,36,114,107,121,40,35,21,61,60,65,23,31,15,53,47,56,17,60,45,102,104,128,38,30,28,61,55,68,24,30,17,41,49,60,14,567,303,264,583,310,273,65,52,111,91,198,46,38,29,65,49,93,30,27,23,46,42,105,16,65,57,116,95,190,57,35,33,64,57,87,33,30,24,52,38,103,24,525,297,228,527,289,238,73,57,106,75,182,33,45,31,63,42,98,19,28,26,43,33,84,14,59,58,93,89,185,43,33,31,58,47,96,24,26,27,35,42,89,19,371,246,125,432,250,182,14,49,71,66,145,24,13,24,53,52,83,20,1,25,18,14,62,4,32,52,86,81,143,36,21,25,50,52,76,25,11,27,36,29,67,11,374,211,163,379,204,175,52,60,44,74,127,17,22,44,22,43,69,13,30,16,22,31,58,4,52,56,54,69,120,26,25,33,31,34,65,16,27,23,23,35,55,10,387,178,209,437,211,226,74,53,27,67,150,14,32,36,-2,32,77,3,42,17,29,35,73,11,67,65,49,94,136,23,34,30,17,43,71,16,33,35,32,51,65,7,493,256,237,480,238,242,77,30,61,105,148,68,35,14,21,57,88,40,42,16,40,48,60,28,72,52,84,86,133,49,26,28,40,39,74,29,46,24,44,47,59,20,173,86,87,217,112,105,17,37,5,21,79,13,5,21,-6,9,45,11,12,16,11,12,34,2,30,34,29,40,65,17,14,15,18,21,30,13,16,19,11,19,35,4,187,81,106,190,95,95,34,-4,1,34,92,25,19,-11,-1,12,47,14,15,7,2,22,45,11,13,15,19,39,77,24,8,2,9,20,39,15,5,13,10,19,38,9,153,47,106,97,27,70,-2,-4,3,28,57,64,12,-10,-15,0,24,35,-14,6,18,28,33,29,3,2,-10,10,60,30,5,-3,-13,-4,23,18,-2,5,3,14,37,12,298,169,129,199,112,87,64,21,30,52,93,34,42,14,9,29,57,15,22,7,21,23,36,19,25,14,28,31,70,29,14,10,16,15,40,16,11,4,12,16,30,13,-29,-49,20,-111,-74,-37,4,-16,-40,-18,27,11,1,-12,-28,-27,16,0,3,-4,-12,9,11,11,-16,-21,-44,-39,11,-4,-5,-12,-28,-32,5,-2,-11,-9,-16,-7,6,-2,-191,-99,-92,-162,-82,-80,-9,0,-9,-41,-47,-81,-5,-3,-16,-22,-9,-43,-4,3,7,-19,-38,-38,5,-5,-3,-10,-43,-107,6,-4,-7,-12,-13,-53,-1,-1,4,2,-30,-54,88,22,66,82,33,49,20,8,11,11,14,28,7,2,5,-9,-8,25,13,6,6,20,22,3,11,16,-9,5,27,32,7,9,-3,-11,7,24,4,7,-6,16,20,8,244,118,126,214,110,104,23,-6,38,72,83,31,10,-6,18,34,47,14,13,0,20,38,36,17,23,16,21,47,72,33,9,4,11,23,43,19,14,12,10,24,29,14,140,56,84,144,61,83,30,0,-3,29,71,8,8,-1,-6,9,32,12,22,1,3,20,39,-4,15,3,2,11,82,26,4,-2,2,2,37,17,11,5,0,9,45,9,283,127,156,287,151,136,40,23,36,79,77,27,26,8,6,37,39,10,14,15,30,42,38,17,29,27,24,61,94,52,13,19,6,26,55,32,16,8,18,35,39,20
3,03042,"Benitachell/Poble Nou de Benitatxell, el",2131,253,154,99,275,153,122,5,23,33,42,131,20,5,19,28,23,66,14,0,4,5,19,65,6,17,25,38,43,130,22,7,19,25,20,66,16,10,6,13,23,64,6,359,184,175,315,167,148,65,19,73,83,108,11,22,10,44,38,59,11,43,9,29,45,49,0,55,21,61,66,95,17,18,13,37,35,51,13,37,8,24,31,44,4,401,194,207,427,219,208,65,23,45,50,173,41,38,10,18,24,86,17,27,13,27,26,87,24,64,21,58,58,186,39,36,10,31,29,94,19,28,11,27,29,92,20,463,253,210,485,260,225,51,25,61,82,208,34,32,14,34,40,105,25,19,11,27,42,103,9,61,24,61,80,216,41,36,13,34,39,109,27,25,11,27,41,107,14,361,185,176,421,222,199,25,8,32,52,198,45,16,0,21,22,98,27,9,8,11,30,100,18,44,11,31,69,213,52,23,6,16,34,109,33,21,5,15,35,104,19,302,161,141,343,179,164,7,9,32,50,157,49,3,6,16,24,81,31,4,3,16,26,76,18,32,19,40,52,155,44,20,10,20,26,76,27,12,9,20,26,79,17,496,264,232,470,247,223,53,46,54,84,200,57,30,24,28,41,102,36,23,22,26,43,98,21,49,39,59,73,195,54,25,19,34,39,97,32,24,20,25,34,98,22,439,201,238,372,185,187,62,21,76,91,154,35,20,8,34,43,76,20,42,13,42,48,78,15,51,22,47,75,136,39,18,12,22,42,67,23,33,10,25,33,69,16,206,100,106,168,72,96,31,21,38,30,67,20,15,10,18,9,30,18,16,11,20,21,37,2,20,18,13,28,67,22,3,6,6,8,32,17,17,12,7,20,35,5,110,50,60,151,71,80,5,-11,23,28,59,6,2,-6,12,12,29,0,3,-5,11,16,30,6,18,4,15,34,61,17,8,3,3,19,30,7,10,1,12,15,31,10,103,56,47,97,49,48,7,6,8,21,55,4,4,4,0,14,33,-1,3,2,8,7,22,5,10,7,12,18,44,5,7,3,5,9,25,-1,3,4,7,9,19,6,127,73,54,114,64,50,7,15,6,4,60,37,7,9,2,2,31,23,0,6,4,2,29,14,14,7,-1,3,55,37,13,3,0,0,27,21,1,4,-1,3,28,16,46,33,13,113,58,55,1,5,-9,4,42,2,0,2,-6,5,29,1,1,3,-3,-1,13,1,17,6,-3,23,54,16,8,3,-5,10,32,10,9,3,2,13,22,6,109,50,59,112,58,54,-2,0,8,21,55,21,-1,3,3,7,29,8,-1,-3,5,14,26,13,12,-4,8,18,55,21,8,-3,3,11,31,8,4,-1,5,7,24,13,166,69,97,179,79,100,22,-1,37,31,66,10,-1,0,10,19,33,6,23,-1,27,12,33,4,24,7,28,36,70,14,9,2,7,16,36,9,15,5,21,20,34,5,34,42,-8,36,26,10,-4,1,10,27,48,-49,6,0,6,18,26,-13,-10,1,4,9,22,-36,6,-1,8,20,35,-33,5,-1,2,11,16,-7,1,0,6,9,19,-26,-563,-301,-262,-559,-289,-270,0,-41,-1,-64,-119,-341,3,-15,-5,-30,-59,-195,-3,-26,4,-34,-60,-146,-12,-45,-16,-59,-92,-337,-5,-16,-6,-31,-46,-186,-7,-29,-10,-28,-46,-151,166,92,74,153,77,76,37,0,24,24,72,9,22,3,13,14,32,6,15,-3,11,10,40,3,31,-3,20,24,59,20,17,-3,8,14,28,11,14,0,12,10,31,9
3,03043,Biar,3537,-1,-1,0,7,4,3,-1,-4,-3,5,3,-2,-2,-3,0,2,1,0,1,-1,-3,3,2,-2,1,2,1,2,1,0,0,2,1,0,1,0,1,0,0,2,0,0,16,13,3,17,11,6,-10,1,27,1,-2,-1,-5,3,19,2,-3,-2,-5,-2,8,-1,1,1,2,3,8,3,1,0,2,1,7,0,1,0,0,2,1,3,0,0,1,0,1,12,4,8,8,1,3,0,0,-9,5,3,-1,2,-1,-7,3,-2,4,-2,1,-2,4,4,2,3,0,-1,3,1,0,2,-1,-1,1,3,2,1,1,0,22,24,-2,20,10,10,9,-6,0,15,2,3,5,2,2,8,2,5,4,-8,-2,7,0,-2,2,2,10,4,2,0,2,0,5,2,1,0,0,2,5,2,1,0,42,22,20,29,13,16,10,13,13,2,0,2,6,2,10,2,-2,2,4,11,3,0,2,0,6,12,7,2,2,0,3,4,5,0,1,0,3,8,2,2,1,0,32,21,11,13,6,7,13,-4,11,7,2,4,7,-2,10,3,2,2,6,-2,1,4,0,2,5,1,4,2,0,1,1,2,2,1,0,0,4,-1,2,1,0,1,34,14,20,17,7,10,17,5,-5,14,4,0,8,5,-12,12,1,1,9,0,7,2,3,-1,6,2,0,6,3,0,1,1,0,3,2,0,5,1,0,3,1,0,14,4,10,25,10,15,11,4,-4,-3,8,-1,2,5,-4,2,3,-2,9,-1,0,-5,5,1,10,4,0,4,7,0,4,2,-2,2,4,0,6,2,2,2,3,0,10,17,-7,17,10,7,0,-2,11,4,5,-11,5,2,9,3,2,-6,-5,-4,2,1,3,-5,5,3,4,2,3,0,2,2,3,2,1,0,3,1,1,0,2,0,-20,-18,-2,-30,-19,-11,-8,7,-5,-8,-6,-4,-6,0,-6,-3,0,-3,-2,7,1,-5,-6,-1,-5,3,-7,-7,-7,-7,-3,1,-7,-4,-3,-3,-2,2,0,-3,-4,-4,2,-9,11,-3,-1,-2,-6,-5,6,4,5,-4,-1,-3,3,-4,-2,-2,-5,-2,3,8,7,-2,-6,1,-1,1,1,1,-2,0,1,0,-1,1,-4,1,-2,1,2,0,-36,-13,-23,-1,3,-4,-12,-3,-11,-3,4,-10,-4,-2,-4,-2,4,-4,-8,-1,-7,-1,0,-6,-4,0,2,-3,5,-1,-1,0,2,-2,5,-1,-3,0,0,-1,0,0,-13,-12,-1,8,3,5,4,-3,-13,4,-3,-1,-3,0,-5,-1,-1,-1,7,-3,-8,5,-2,0,6,2,-2,2,0,0,2,1,-1,1,0,0,4,1,-1,1,0,0,-9,8,-17,-13,-7,-6,0,0,-1,5,-5,-8,2,0,3,8,-3,-2,-2,0,-4,-3,-2,-6,-1,-3,-1,-4,-1,-3,0,-1,-2,-2,-1,-1,-1,-2,1,-2,0,-2,-23,-10,-13,-3,-2,-1,3,-3,-11,-4,3,-11,6,-2,-5,-3,-1,-5,-3,-1,-6,-1,4,-6,0,1,-1,-3,1,-1,1,-1,0,-2,1,-1,-1,2,-1,-1,0,0,2,6,-4,-11,-2,-9,3,-2,3,2,-1,-4,0,0,1,3,0,1,3,-2,2,-1,-1,-5,-3,0,-4,-1,-2,-1,-1,0,1,0,-2,0,-2,0,-5,-1,0,-1,-9,-10,1,3,1,2,1,-2,-4,-3,2,-4,-5,-2,3,-7,6,-5,6,0,-7,4,-4,1,2,0,3,0,-1,-1,0,1,2,-1,0,-1,2,-1,1,1,-1,0,13,3,10,12,5,7,11,0,-7,8,-1,2,6,0,-8,5,-3,3,5,0,1,3,2,-1,6,2,-2,3,1,2,3,1,-2,1,0,2,3,1,0,2,1,0
3,03044,Bigastro,4829,121,61,60,25,15,10,13,25,48,14,18,1,6,16,23,6,9,-1,7,9,25,8,9,2,0,7,13,4,1,0,0,4,10,1,0,0,0,3,3,3,1,0,143,87,56,76,47,29,40,28,45,21,10,-1,24,18,25,15,5,-1,16,10,20,6,5,0,17,20,28,10,1,0,11,12,16,7,1,0,6,8,12,3,0,0,159,92,67,76,45,31,34,48,38,24,8,4,16,32,20,16,5,2,18,16,18,8,3,2,19,22,17,9,7,2,7,19,9,4,6,0,12,3,8,5,1,2,149,90,59,61,41,20,26,43,43,28,4,2,12,25,28,19,3,3,14,18,15,9,1,-1,8,17,14,15,5,2,5,13,10,9,2,2,3,4,4,6,3,0,278,157,121,177,103,74,11,62,75,29,84,10,1,38,43,22,44,7,10,24,32,7,40,3,11,35,25,25,70,10,6,25,16,13,35,8,5,10,9,12,35,2,349,188,161,156,85,71,48,77,95,63,46,10,31,40,60,29,17,4,17,37,35,34,29,6,15,35,25,23,45,13,7,21,18,9,22,8,8,14,7,14,23,5,263,159,104,114,47,67,52,45,94,38,29,2,20,23,68,26,22,-2,32,22,26,12,7,4,27,23,22,18,16,7,6,7,13,10,8,2,21,16,9,8,8,5,111,39,72,61,6,55,15,39,31,-5,20,1,11,13,4,-5,9,0,4,26,27,0,11,1,20,23,11,-2,6,1,9,7,-7,-9,2,2,11,16,18,7,4,-1,-11,-25,14,25,-9,34,-20,5,-11,-9,6,4,-14,-6,-14,-6,4,2,-6,11,3,-3,2,2,6,-2,1,1,14,3,5,-11,-8,-1,3,2,1,9,9,2,11,1,-43,-18,-25,-15,-17,2,-37,4,-3,-17,-3,-3,-16,8,-1,-14,-5,-1,-21,-4,-2,-3,2,-2,-6,6,-13,-8,1,2,-3,4,-15,-8,0,2,-3,2,2,0,1,0,-14,-2,-12,-20,-13,-7,-29,-4,18,-9,-9,0,-20,-2,19,-2,-2,-3,-9,-2,-1,-7,-7,3,-8,2,-6,-7,2,-5,-5,0,-4,-2,1,-3,-3,2,-2,-5,1,-2,-48,-17,-31,-34,-22,-12,-21,-2,-14,-4,-9,-11,-1,-3,-12,1,-5,-5,-20,1,-2,-5,-4,-6,-4,0,-16,-4,-5,-6,-2,-1,-12,-2,-2,-3,-2,1,-4,-2,-3,-3,-79,-53,-26,4,1,3,-13,-1,-45,-10,-2,-7,-12,3,-28,-7,-6,-2,-1,-4,-17,-3,4,-5,2,-1,-1,0,2,2,4,-2,1,-3,-1,2,-2,1,-2,3,3,0,-74,-35,-39,-42,-22,-20,-29,9,-5,-42,0,-11,-5,2,-4,-27,0,-1,-24,7,-1,-15,0,-10,-8,-2,-8,-17,-7,-1,-1,-1,-6,-11,-3,0,-7,-1,-2,-6,-4,-1,-88,-56,-32,-37,-34,-3,-15,-2,-37,-19,-8,-10,-9,-6,-25,-8,-2,-4,-6,4,-12,-11,-6,-6,-4,3,-10,-13,-6,-8,-6,1,-14,-9,-4,-2,2,2,4,-4,-2,-6,23,5,18,-27,-19,-8,18,11,15,2,-13,-12,13,1,5,-2,-9,-5,5,10,10,4,-4,-7,1,1,-7,-11,-1,-11,2,-1,-6,-9,0,-5,-1,2,-1,-2,-1,-6,0,-19,19,-26,-16,-10,7,-3,3,11,-3,-13,-11,-6,7,4,-7,-5,18,3,-4,7,4,-8,2,-6,-3,-5,-6,-8,-3,0,-1,-4,-5,-3,5,-6,-2,-1,-1,-5,-15,-5,-10,3,-7,10,-15,4,11,-8,-1,-9,-6,6,4,-6,0,-4,-9,-2,7,-2,-1,-5,-2,8,7,-11,7,-8,-1,6,1,-13,4,-4,-1,2,6,2,3,-4
3,03046,Busot,1615,65,25,40,14,8,6,1,13,16,17,15,1,-4,8,7,4,10,-1,5,5,9,13,5,2,0,0,2,3,8,1,0,0,2,0,5,1,0,0,0,3,3,0,84,48,36,54,28,26,9,11,14,25,24,-1,6,3,10,14,15,-1,3,8,4,11,9,0,4,1,6,14,23,6,3,1,2,9,10,3,1,0,4,5,13,3,96,43,53,95,44,51,24,-2,11,33,25,6,10,-3,4,17,12,4,14,1,7,16,13,2,22,3,9,25,28,8,8,0,3,12,15,6,14,3,6,13,13,2,215,101,114,175,88,87,34,-1,22,42,95,21,14,-5,11,22,44,15,20,4,11,20,51,6,19,6,9,24,89,27,7,3,5,11,42,20,12,3,4,13,47,7,293,151,142,256,135,121,30,10,48,59,129,17,15,2,26,33,67,7,15,8,22,26,62,10,26,7,23,63,116,22,10,3,11,40,58,13,16,4,12,23,58,9,220,121,99,152,78,74,10,16,26,66,83,20,12,6,19,32,40,12,-2,10,7,34,43,8,9,8,22,35,66,11,6,4,13,17,30,7,3,4,9,18,36,4,180,96,84,101,55,46,31,4,26,51,49,15,21,1,10,27,30,6,10,3,16,24,19,9,10,4,11,19,45,10,7,3,3,13,25,4,3,1,8,6,20,6,170,86,84,89,48,41,44,5,41,30,40,7,29,0,16,22,14,3,15,5,25,8,26,4,16,4,10,13,38,8,10,3,6,8,16,5,6,1,4,5,22,3,126,56,70,56,30,26,29,2,12,35,38,10,17,-6,7,19,18,2,12,8,5,16,20,8,15,-1,7,11,19,5,12,-2,2,7,9,2,3,1,5,4,10,3,112,56,56,32,17,15,23,11,17,39,24,-5,6,8,4,22,18,-3,17,3,13,17,6,-2,-1,0,2,10,18,1,-2,1,0,7,11,0,1,-1,2,3,7,1,69,46,23,52,29,23,-6,-2,12,12,41,11,0,1,9,11,17,7,-6,-3,3,1,24,4,1,2,0,2,36,11,1,1,2,0,17,8,0,1,-2,2,19,3,106,66,40,18,20,-2,22,12,27,23,15,7,11,7,19,13,14,1,11,5,8,10,1,6,-6,3,3,1,17,0,-3,3,4,2,13,1,-3,0,-1,-1,4,-1,34,21,13,22,13,9,3,2,1,13,11,6,3,3,0,5,4,7,0,-1,1,8,7,-1,1,-1,5,4,10,3,1,-1,2,2,5,4,0,0,3,2,5,-1,12,20,-8,21,15,6,-5,5,-4,6,12,0,-4,7,1,9,6,3,-1,-2,-5,-3,6,-3,1,-2,4,5,8,5,-1,-1,4,6,5,2,2,-1,0,-1,3,3,-6,-4,-2,16,10,6,-2,-3,-23,16,6,-3,-2,-4,-8,6,3,1,0,1,-15,10,3,-4,1,1,-3,-1,11,7,1,1,-1,-3,6,6,0,0,-2,2,5,1,-6,7,-13,3,-1,4,7,-4,7,-4,7,-20,0,-1,1,5,8,-8,7,-3,6,-9,-1,-12,1,3,3,0,7,-12,-1,0,0,-1,4,-4,2,3,3,1,3,-8,-2,-2,0,-6,-8,2,8,-12,-6,9,8,-11,4,-4,0,-1,-1,-1,4,-8,-6,10,9,-10,1,-4,-2,6,5,-12,-1,-3,0,1,-2,-3,2,-1,-2,5,7,-9,45,29,16,31,14,17,27,-8,16,15,9,-13,19,-7,12,6,2,-3,8,-1,4,9,7,-10,13,-1,7,6,11,-4,8,-2,3,1,5,0,5,1,4,5,6,-4
3,03049,Callosa de Segura,15291,81,81,0,146,101,45,12,1,38,15,0,10,20,15,29,8,2,4,-8,-14,9,7,-2,6,17,29,62,31,5,2,12,21,46,17,4,1,5,8,16,14,1,1,399,264,135,409,259,150,56,127,151,64,15,-18,26,86,114,36,8,-9,30,41,37,28,7,-9,46,122,158,64,14,3,19,79,110,40,9,0,27,43,48,24,5,3,210,108,102,229,119,110,56,68,62,30,-2,-7,31,37,35,12,-5,-5,25,31,27,18,3,-2,42,60,81,25,9,9,19,33,51,9,2,4,23,27,30,16,7,5,83,64,19,277,160,117,18,41,18,6,11,-16,7,37,7,6,7,-5,11,4,11,0,4,-11,81,72,78,23,17,3,44,45,47,13,8,1,37,27,31,10,9,2,304,185,119,239,142,97,68,108,73,57,6,-13,38,59,43,44,1,-1,30,49,30,13,5,-12,54,69,60,38,11,4,26,42,41,25,5,1,28,27,19,13,6,3,73,62,11,181,110,71,37,44,21,-10,-16,-5,23,29,20,-3,-9,0,14,15,1,-7,-7,-5,28,60,53,23,12,4,10,33,40,18,6,3,18,27,13,5,6,1,177,84,93,253,112,141,53,45,3,43,21,12,34,28,-13,25,3,6,19,17,16,18,18,6,65,45,58,51,29,5,34,19,20,26,9,4,31,26,38,25,20,1,-146,-87,-59,58,8,50,-11,7,-105,-17,-7,-12,6,-7,-70,-11,0,0,-17,14,-35,-6,-7,-12,28,26,-3,0,4,3,20,6,-14,-6,1,2,8,20,11,6,3,1,336,159,177,345,153,192,127,78,60,73,1,-2,71,11,36,46,0,-3,56,67,24,27,1,1,116,92,68,39,18,9,69,32,28,12,8,4,47,60,40,27,10,5,-31,-4,-27,21,11,10,-7,19,-32,-3,13,-12,7,15,-21,-6,12,-5,-14,4,-11,3,1,-7,14,25,-7,-15,2,2,17,12,-4,-16,1,1,-3,13,-3,1,1,1,-153,-82,-71,-111,-72,-39,-68,-16,2,-45,-16,-7,-27,-13,8,-35,-10,-3,-41,-3,-6,-10,-6,-4,-25,-11,-15,-51,-9,-1,-13,-13,-8,-34,-5,0,-12,2,-7,-17,-4,-1,-21,-43,22,-22,-46,24,37,4,-29,-10,-6,-20,11,-1,-20,-18,-10,-8,26,5,-9,8,4,-12,3,6,-16,-5,-5,-6,-6,-5,-12,-9,-8,-5,9,11,-4,4,3,-1,-132,-64,-68,-87,-54,-33,-14,-14,-7,-56,-17,-18,-19,1,2,-25,-12,-5,5,-15,-9,-31,-5,-13,-1,-5,-30,-35,-8,-6,1,-2,-22,-22,-5,-2,-2,-3,-8,-13,-3,-4,1,13,-12,-81,-31,-50,10,-1,20,2,-16,-18,18,-3,10,4,-7,-11,-8,2,10,-2,-9,-7,-24,-7,-26,-22,-4,2,-6,-2,-16,-6,-3,2,-18,-5,-10,-16,-1,0,104,30,74,100,40,60,34,12,35,34,12,-21,4,-10,25,15,5,-9,30,22,10,19,7,-12,21,20,19,25,10,3,8,4,7,11,6,2,13,16,12,14,4,1,240,148,92,128,67,61,69,17,62,74,15,-3,35,12,39,55,3,-1,34,5,23,19,12,-2,34,13,41,22,11,2,5,6,28,16,6,2,29,7,13,6,5,0,116,92,24,112,49,63,26,24,58,12,8,-6,22,7,48,18,8,-6,4,17,10,-6,0,0,35,37,33,-4,5,-1,24,16,16,-6,-2,-2,11,21,17,2,7,1,222,156,66,244,148,96,21,69,74,74,-10,-6,5,58,52,47,2,-11,16,11,22,27,-12,5,31,78,65,51,5,9,14,51,49,27,2,2,17,27,16,24,3,7
3,03048,Callosa d'En Sarrià,6365,937,649,288,1013,687,326,51,293,405,157,20,5,27,194,286,121,19,1,24,99,119,36,1,4,45,312,437,179,31,5,22,208,300,133,20,3,23,104,137,46,11,2,574,385,189,722,488,234,55,164,227,107,13,8,28,94,183,76,4,-1,27,70,44,31,9,9,62,203,301,132,17,6,33,123,226,96,8,2,29,80,75,36,9,4,181,82,99,473,261,212,100,43,-15,13,16,22,53,25,-23,8,7,11,47,18,8,5,9,11,126,116,135,66,22,6,66,65,75,38,13,4,60,51,60,28,9,2,284,149,135,415,236,179,88,98,19,27,40,6,44,53,9,16,26,0,44,45,10,11,14,6,97,122,100,58,30,8,53,69,60,33,18,3,44,53,40,25,12,5,239,139,100,286,176,110,47,51,32,78,17,12,18,38,16,51,9,3,29,13,16,27,8,9,44,81,80,57,20,4,14,51,57,40,12,2,30,30,23,17,8,2,127,96,31,322,207,115,8,45,49,6,25,-4,2,40,31,7,21,-3,6,5,18,-1,4,-1,41,87,99,66,26,1,24,51,69,46,16,-1,17,36,30,20,10,2,289,176,113,496,307,189,39,126,75,2,20,29,28,72,61,-4,11,8,11,54,14,6,9,21,78,165,163,63,19,4,39,98,112,44,10,1,39,67,51,19,9,3,122,67,55,344,201,143,16,41,52,0,5,9,3,21,31,7,1,7,13,20,21,-7,4,2,56,102,109,60,12,3,31,54,68,40,8,0,25,48,41,20,4,3,-88,-45,-43,113,65,48,-13,-22,-79,1,8,12,1,-8,-52,3,2,5,-14,-14,-27,-2,6,7,37,21,14,22,12,4,20,13,9,12,6,3,17,8,5,10,6,1,-33,-33,0,54,24,30,-1,6,-30,-19,-2,14,4,-4,-24,-13,-1,4,-5,10,-6,-6,-1,10,9,23,6,8,5,2,4,12,-1,3,4,1,5,11,7,5,1,1,-11,-17,6,41,19,22,-3,-14,-37,4,12,20,-2,-4,-31,4,1,12,-1,-10,-6,0,11,8,8,6,9,11,7,-2,6,3,2,4,5,-1,2,3,7,7,2,-1,0,-10,10,40,23,17,-27,1,-6,2,6,25,-8,-7,-2,3,-1,6,-19,8,-4,-1,7,19,3,7,5,14,8,2,2,3,2,10,4,1,1,4,3,4,4,1,34,-6,40,25,6,19,-11,26,-1,1,0,19,-12,4,-1,-3,3,4,1,22,0,4,-3,15,-7,16,4,3,4,4,-6,6,3,-1,2,2,-1,10,1,4,2,2,-31,-13,-18,5,0,5,-12,-25,-14,1,6,18,2,-12,-3,-1,2,3,-14,-13,-11,2,4,15,-2,-3,2,2,2,5,3,-1,-2,-1,1,1,-5,-2,4,3,1,4,70,22,48,39,18,21,9,7,12,1,15,24,5,5,-6,-3,6,13,4,2,18,4,9,11,4,14,6,3,7,3,2,6,3,1,2,3,2,8,3,2,5,0,-590,-412,-178,-585,-415,-170,-26,-27,-162,-255,-109,-10,-3,-13,-106,-193,-93,-4,-23,-14,-56,-62,-16,-6,-27,-26,-159,-250,-106,-18,-10,-8,-106,-195,-91,-6,-17,-18,-53,-55,-15,-12,87,62,25,56,27,29,20,12,13,12,12,11,15,10,20,-1,12,2,5,2,-7,13,0,9,10,8,7,10,15,5,8,4,6,0,6,3,2,4,1,10,9,2,109,68,41,83,44,39,25,1,12,43,12,10,12,0,17,24,3,11,13,1,-5,19,9,-1,14,9,16,19,16,3,10,6,8,10,8,1,4,3,8,9,8,2
3,03047,Calp,15605,1203,656,547,1028,559,469,78,135,234,136,297,308,35,77,146,73,154,162,43,58,88,63,143,146,87,78,180,135,270,271,41,45,110,76,137,145,46,33,70,59,133,126,1927,1093,834,1749,983,766,211,228,390,311,401,359,117,146,258,175,205,177,94,82,132,136,196,182,179,193,337,274,392,354,94,124,225,157,197,175,85,69,112,117,195,179,1674,852,822,1484,766,718,195,212,309,231,397,319,89,109,172,118,180,179,106,103,137,113,217,140,184,176,284,208,357,264,93,84,156,108,167,154,91,92,128,100,190,110,1525,813,712,1362,722,640,158,209,266,296,356,235,88,118,151,158,171,122,70,91,115,138,185,113,176,189,216,249,322,204,93,110,119,128,158,109,83,79,97,121,164,95,1477,814,663,1343,728,615,110,174,367,239,384,197,50,100,224,133,201,105,60,74,143,106,183,92,126,156,313,230,332,180,55,90,183,133,171,94,71,66,130,97,161,86,1599,843,756,1376,740,636,192,246,370,252,361,159,99,129,215,132,176,85,93,117,155,120,185,74,171,182,284,240,348,141,93,90,169,136,168,79,78,92,115,104,180,62,1458,772,686,1331,697,634,194,258,296,267,293,135,114,123,166,145,145,72,80,135,130,122,148,63,186,233,282,230,277,108,95,116,156,125,139,58,91,117,126,105,138,50,1480,783,697,1456,788,668,182,303,350,235,266,130,81,161,207,123,146,58,101,142,143,112,120,72,219,294,343,255,242,93,116,156,199,137,130,44,103,138,144,118,112,49,452,226,226,611,311,300,58,101,45,113,95,35,34,47,6,75,45,14,24,54,39,38,50,21,88,119,135,119,112,35,48,59,62,67,55,17,40,60,73,52,57,18,438,186,252,587,276,311,55,54,63,90,144,41,41,3,1,52,75,20,14,51,62,38,69,21,86,106,106,118,126,42,48,34,48,60,62,24,38,72,58,58,64,18,-151,-80,-71,-17,-24,7,-7,54,10,-3,12,-222,18,12,12,-23,5,-105,-25,42,-2,20,7,-117,55,53,65,39,8,-244,30,21,23,7,6,-114,25,32,42,32,2,-130,63,3,60,219,82,137,89,31,3,4,27,-94,41,9,-11,-13,24,-52,48,22,14,17,3,-42,89,54,57,49,70,-107,40,19,19,20,40,-59,49,35,38,29,30,-48,159,80,79,228,118,110,47,-1,19,8,70,18,27,5,9,-12,35,15,20,-6,10,20,35,3,49,25,16,34,77,24,27,20,7,3,47,12,22,5,9,31,30,12,-161,-112,-49,-247,-156,-91,45,-9,-13,-45,61,-213,22,-7,-11,-43,19,-100,23,-2,-2,-2,42,-113,42,-16,-30,-52,33,-230,19,-12,-24,-43,11,-111,23,-4,-6,-9,22,-119,530,263,267,603,308,295,48,49,70,78,174,99,29,36,19,40,94,41,19,13,51,38,80,58,76,61,72,115,175,95,42,39,26,62,86,50,34,22,46,53,89,45,548,256,292,600,294,306,45,76,96,68,139,113,10,34,35,30,73,66,35,42,61,38,66,47,75,73,122,109,134,80,39,34,44,54,73,46,36,39,78,55,61,34,518,274,244,515,278,237,26,65,92,61,122,144,25,34,48,32,53,79,1,31,44,29,69,65,56,57,86,61,128,120,37,28,46,33,60,70,19,29,40,28,68,50,-96,-48,-48,-54,-35,-19,32,50,26,-53,87,-254,6,39,39,-38,23,-122,26,11,-13,-15,64,-132,29,65,28,-41,129,-274,14,40,27,-35,48,-132,15,25,1,-6,81,-142
3,03050,"Campello, el",17564,858,402,456,469,217,252,140,123,189,184,167,53,73,51,98,78,89,18,67,72,91,106,78,35,81,70,100,96,76,42,36,39,42,42,35,23,45,31,58,54,41,19,943,463,480,582,304,278,125,130,266,143,189,84,71,56,128,75,84,49,54,74,138,68,105,35,98,92,158,81,101,47,56,47,87,39,47,26,42,45,71,42,54,21,1088,512,576,784,381,403,197,75,268,172,257,110,86,31,121,94,132,45,111,44,147,78,125,65,157,101,155,121,179,64,74,50,70,60,89,36,83,51,85,61,90,28,1021,482,539,705,358,347,182,120,183,205,201,105,90,41,76,94,106,62,92,79,107,111,95,43,128,98,150,113,142,70,67,39,79,61,70,40,61,59,71,52,72,30,963,495,468,679,357,322,69,88,200,185,250,161,28,52,116,87,126,87,41,36,84,98,124,74,73,80,126,120,187,89,38,37,74,59,97,50,35,43,52,61,90,39,1079,542,537,735,385,350,150,96,289,201,235,94,97,26,131,126,107,45,53,70,158,75,128,49,111,78,170,128,186,58,61,32,89,72,95,33,50,46,81,56,91,25,701,366,335,676,359,317,58,56,176,122,180,99,24,25,88,82,87,52,34,31,88,40,93,47,96,77,142,131,165,60,53,41,72,71,86,33,43,36,70,60,79,27,814,458,356,447,230,217,93,136,193,102,162,128,59,64,99,75,91,73,34,72,94,27,71,55,56,102,79,67,103,39,23,49,38,41,52,27,33,53,41,26,51,12,468,215,253,255,126,129,61,31,142,83,104,44,31,13,56,47,46,22,30,18,86,36,58,22,45,30,51,41,64,20,29,11,16,21,36,11,16,19,35,20,28,9,242,98,144,52,27,25,24,6,97,5,39,56,23,-10,41,-2,21,22,1,16,56,7,18,34,10,11,6,1,12,9,9,3,1,1,10,3,1,8,5,0,2,6,422,185,237,64,27,37,86,10,158,54,61,36,44,1,85,7,35,3,42,9,73,47,26,33,16,23,30,13,19,-40,1,15,20,5,3,-19,15,8,10,8,16,-21,430,162,268,61,-1,62,82,52,109,75,46,44,47,20,39,13,23,3,35,32,70,62,23,41,48,21,17,17,-7,-44,22,4,2,0,-9,-27,26,17,15,17,2,-17,546,242,304,268,122,146,55,53,113,76,113,136,27,10,51,53,60,46,28,43,62,23,53,90,55,33,21,55,65,36,27,9,1,33,37,15,28,24,20,22,28,21,-284,-201,-83,-437,-244,-193,-10,-40,-35,-63,-76,-77,-5,-30,-22,-29,-47,-85,-5,-10,-13,-34,-29,8,-10,-33,-60,-72,-96,-171,-2,-21,-34,-46,-44,-100,-8,-12,-26,-26,-52,-71,387,155,232,199,101,98,63,1,80,58,109,76,31,1,28,14,51,33,32,0,52,44,58,43,51,16,12,46,61,11,27,8,-2,18,33,16,24,8,14,28,28,-5,315,99,216,151,60,91,107,7,10,41,70,79,36,-2,-12,6,36,32,71,9,22,35,34,47,67,6,7,20,35,13,30,-1,-1,7,18,6,37,7,8,13,17,7,340,175,165,97,34,63,58,25,115,25,51,57,27,8,69,14,31,21,31,17,46,11,20,36,41,17,13,1,34,-20,15,4,3,-2,12,-3,26,13,10,3,22,-17,349,132,217,90,17,73,58,19,31,93,74,67,35,-3,0,61,16,21,23,22,31,32,58,46,39,6,17,5,35,-13,16,-8,2,6,8,-8,23,14,15,-1,27,-5
3,03053,Castalla,7631,106,68,38,60,40,20,9,35,34,24,1,4,9,20,23,14,2,1,0,15,11,10,-1,3,1,21,23,10,4,1,1,11,19,6,2,1,0,10,4,4,2,0,126,77,49,92,51,41,29,22,39,36,9,-10,14,16,28,19,5,-6,15,6,11,17,4,-4,13,32,27,16,4,0,6,18,15,10,2,0,7,14,12,6,2,0,161,89,72,111,63,48,28,26,42,40,22,2,9,23,22,21,13,2,19,3,20,19,9,0,26,28,26,20,7,4,10,21,15,13,3,1,16,7,11,7,4,3,226,125,101,64,37,27,30,37,63,51,27,15,18,16,42,30,10,7,12,21,21,21,17,8,3,9,14,15,16,6,2,3,11,9,8,3,1,6,3,6,8,3,436,238,198,372,198,174,36,21,46,58,216,55,22,19,31,27,108,32,14,2,15,31,108,23,20,17,27,56,208,42,10,10,18,26,105,29,10,7,9,30,103,13,329,181,148,244,128,116,30,20,46,58,145,28,20,12,24,30,77,18,10,8,22,28,68,10,14,16,29,44,114,26,8,11,19,17,57,16,6,5,10,27,57,10,390,173,217,254,117,137,59,20,88,69,116,32,16,11,45,29,59,13,43,9,43,40,57,19,32,14,33,35,113,24,15,3,15,15,56,13,17,11,18,20,57,11,316,172,144,227,112,115,36,22,73,60,98,23,21,16,47,22,52,12,15,6,26,38,46,11,28,29,28,33,89,16,14,16,12,12,47,9,14,13,16,21,42,7,320,177,143,152,84,68,49,47,90,56,59,18,28,29,47,35,26,12,21,18,43,21,33,6,31,18,28,25,38,12,17,8,17,16,20,6,14,10,11,9,18,6,150,95,55,82,50,32,21,12,24,38,47,7,18,9,10,27,23,7,3,3,14,11,24,0,5,10,2,15,40,9,5,6,1,10,20,7,0,4,1,5,20,2,-30,-12,-18,-6,1,-7,-24,-6,0,-24,24,0,-6,-2,-2,-14,14,-1,-18,-4,2,-10,10,1,-7,-2,-23,1,18,6,-3,0,-12,2,9,5,-4,-2,-11,-1,9,1,10,10,0,34,18,16,0,-17,0,12,19,-2,1,1,-12,11,10,0,-1,-18,12,1,9,-2,6,0,-1,8,20,1,4,2,-1,2,10,1,2,-2,0,6,10,0,6,17,-11,26,15,11,-4,2,-2,9,6,-8,8,1,-7,4,9,-1,-12,1,5,5,-3,-7,1,4,6,4,5,6,0,0,3,2,4,6,1,4,3,2,1,0,-6,15,-21,7,6,1,-6,-9,17,-2,17,-20,-5,-2,16,5,15,-13,-1,-7,1,-7,2,-7,0,-2,5,0,14,-10,-1,0,0,3,10,-6,1,-2,5,-3,4,-4,-33,-23,-10,-2,-16,14,2,1,-10,-18,2,-12,4,-2,-5,-6,1,-12,-2,3,-5,-12,1,0,0,6,-2,-6,1,-4,0,-1,-1,-10,1,-5,0,7,-1,4,0,1,-51,-29,-22,-61,-32,-29,-12,-6,3,-7,-1,-32,-4,-11,7,-8,5,-21,-8,5,-4,1,-6,-11,-2,-2,-6,-4,-13,-33,1,-1,-3,-3,-3,-23,-3,-1,-3,-1,-10,-10,-2,0,-2,-66,-36,-30,18,-5,-9,13,3,-18,9,1,-2,4,-3,-10,9,-6,-7,9,6,-8,-3,-14,-5,-7,-10,-28,-4,-4,-1,-6,-4,-18,1,-10,-4,-1,-6,-10,33,40,-7,-1,7,-8,31,6,19,0,16,-38,17,9,19,-9,16,-10,14,-3,0,9,0,-28,9,3,-2,9,7,-29,7,0,4,1,8,-13,2,3,-6,8,-1,-16
3,03055,Catral,4979,106,53,53,8,3,5,18,27,31,20,13,-2,5,19,16,7,8,-1,13,8,15,13,5,-1,0,3,2,0,3,0,0,1,1,0,1,0,0,2,1,0,2,0,191,105,86,86,53,33,46,22,72,47,6,-1,18,11,43,30,3,0,28,11,29,17,3,-1,21,14,24,27,0,0,9,10,16,18,0,0,12,4,8,9,0,0,230,133,97,88,48,40,53,42,69,30,23,10,21,33,44,14,12,8,32,9,25,16,11,2,22,12,23,19,11,0,8,11,14,10,5,0,14,1,9,9,6,0,255,151,104,98,64,34,44,54,78,37,40,4,29,30,46,25,21,1,15,24,32,12,19,3,17,17,28,13,23,0,11,11,20,8,14,0,6,6,8,5,9,0,707,366,341,310,166,144,131,72,132,141,177,45,64,44,64,75,90,27,67,28,68,66,87,18,48,28,40,62,109,22,24,18,23,29,56,16,24,10,17,33,53,6,987,516,471,542,289,253,126,134,134,178,336,74,60,78,76,95,168,40,66,56,58,83,168,34,70,55,66,104,201,45,38,29,44,53,98,26,32,26,22,51,103,19,648,352,296,372,188,184,80,75,144,111,192,36,44,45,73,60,100,23,36,30,71,51,92,13,40,34,61,69,140,26,17,17,31,30,72,19,23,17,30,39,68,7,425,183,242,179,72,107,86,68,94,66,75,27,36,18,42,30,38,17,50,50,52,36,37,10,34,22,25,21,57,17,14,8,6,6,27,11,20,14,19,15,30,6,148,78,70,113,52,61,16,22,17,42,36,12,8,9,15,19,21,2,8,13,2,23,15,10,17,20,24,22,19,7,7,9,11,10,9,1,10,11,13,12,10,6,167,93,74,70,25,45,32,36,29,31,22,7,33,21,4,18,7,3,-1,15,25,13,15,4,22,9,14,14,3,5,18,3,-5,8,-2,2,4,6,19,6,5,3,81,44,37,50,29,21,15,-1,21,2,23,9,12,1,2,5,16,6,3,-2,19,-3,7,3,13,8,11,0,10,5,8,6,1,2,8,3,5,2,10,-2,2,2,-4,-18,14,53,20,33,-16,7,-15,-8,18,5,-14,11,-21,-7,8,1,-2,-4,6,-1,10,4,14,3,6,9,16,2,4,4,2,4,5,1,10,-1,4,5,11,1,52,21,31,-1,-2,1,20,10,6,-10,33,-8,7,-3,7,-4,20,-5,13,13,-1,-6,13,-3,-5,5,-5,-12,23,-7,-2,-2,1,-6,11,-4,-3,7,-6,-6,12,-3,-741,-404,-337,-685,-365,-320,-88,-68,-71,-151,-190,-176,-62,-36,-40,-79,-91,-97,-26,-32,-31,-72,-99,-79,-77,-54,-62,-142,-186,-165,-45,-33,-34,-75,-88,-90,-32,-21,-28,-67,-98,-75,-7,-13,6,47,25,22,5,-20,-19,-1,32,-2,5,-11,-11,-5,14,-4,0,-9,-8,4,18,2,5,-2,-4,6,46,-4,7,-3,-3,1,25,-2,-2,1,-1,5,21,-2,68,32,36,98,44,54,-2,-18,7,7,65,1,1,-15,4,12,29,-4,-3,-3,3,-5,36,5,1,-6,17,6,63,13,0,-6,7,6,29,4,1,0,10,0,34,9,57,35,22,127,70,57,21,-9,6,-16,39,19,21,-1,6,-20,20,10,0,-8,0,4,19,9,24,7,19,23,40,14,17,6,13,7,20,7,7,1,6,16,20,7,86,17,69,119,58,61,8,8,15,19,25,8,-1,1,4,0,14,2,9,7,11,19,11,6,18,12,14,22,39,11,7,7,10,8,25,1,11,5,4,14,14,10
3,03056,Cocentaina,10572,30,26,4,47,26,21,-2,-13,10,23,7,3,-1,-1,12,11,6,-1,-1,-12,-2,12,1,4,6,7,17,10,4,3,3,4,10,5,2,2,3,3,7,5,2,1,136,74,62,90,42,48,36,16,48,32,0,2,20,7,22,23,0,1,16,9,26,9,0,1,22,15,31,17,5,0,6,8,15,11,2,0,16,7,16,6,3,0,110,63,47,62,35,27,22,21,21,30,13,1,14,14,13,17,3,2,8,7,8,13,10,-1,11,10,24,6,8,0,8,6,13,4,3,0,3,4,11,2,5,0,90,66,24,73,42,31,15,7,25,26,14,6,14,3,26,17,6,1,1,4,-1,9,8,5,18,10,24,7,13,1,12,6,13,4,6,1,6,4,11,3,7,0,22,7,15,62,27,35,-3,-23,2,30,18,0,-7,-4,-6,17,12,-3,4,-19,8,13,6,3,18,3,15,9,13,3,10,2,6,3,6,0,8,1,9,6,7,3,148,71,77,106,58,48,48,0,21,38,25,17,23,4,11,18,12,5,25,-4,10,20,13,12,23,11,18,21,19,14,13,6,12,11,8,8,10,5,6,10,11,6,134,59,75,103,45,58,68,-11,18,51,3,2,24,2,6,29,-5,2,44,-13,12,22,8,0,33,11,13,21,16,7,12,7,6,10,5,5,21,4,7,11,11,2,181,119,62,90,42,48,47,26,24,57,20,5,27,8,14,42,17,8,20,18,10,15,3,-3,20,18,14,22,13,3,13,6,5,8,9,1,7,12,9,14,4,2,100,70,30,41,30,11,34,20,0,22,9,15,23,16,6,11,5,9,11,4,-6,11,4,6,3,14,3,11,1,8,2,10,3,8,2,4,1,4,0,3,-1,4,56,38,18,35,20,15,7,-2,7,29,18,-8,6,8,15,10,5,-9,1,-10,-8,19,13,1,3,6,4,11,9,0,1,2,2,9,5,-1,2,4,2,2,4,1,72,41,31,42,22,20,32,-2,11,26,9,-6,17,-2,1,17,11,-4,15,0,10,9,-2,-2,6,11,15,4,6,0,3,7,8,2,3,-1,3,4,7,2,3,1,27,27,0,18,5,13,-3,5,21,4,0,3,-7,9,23,4,-5,7,4,-4,-2,0,5,-4,6,4,5,3,-2,2,1,3,-1,1,-2,3,5,1,6,2,0,-1,-10,-13,3,-29,-11,-18,5,-18,4,3,-8,2,4,-12,-6,4,-6,3,1,-6,10,-1,-2,-1,1,-1,-2,-6,-15,-7,2,-2,0,-2,-9,-1,-1,1,-2,-4,-6,-6,54,28,26,9,8,1,21,33,1,-5,-5,6,10,14,6,-5,2,0,11,19,-5,0,-7,6,1,13,-7,2,1,-3,3,7,-5,5,-1,-1,-2,6,-2,-3,2,-2,-54,-20,-34,-17,1,-18,5,-1,-42,5,-10,-14,1,13,-26,8,-6,-11,4,-14,-16,-3,-4,-3,0,3,1,-10,-3,-9,1,4,5,-9,3,-4,-1,-1,-4,-1,-6,-5,107,54,53,96,46,50,40,11,26,38,-15,5,18,10,20,14,-5,0,22,1,6,24,-10,5,28,18,29,18,-1,2,15,7,20,8,-4,0,13,11,9,10,3,2,24,19,5,60,41,19,-5,11,23,-3,-9,7,-1,11,12,-1,-10,5,-4,0,11,-2,1,2,10,25,25,-4,4,-2,11,17,14,-2,1,-1,-1,8,11,-2,3,-1,79,60,19,147,102,45,31,1,27,11,10,-1,15,9,18,11,8,-3,16,-8,9,0,2,2,27,19,72,20,8,0,12,18,53,16,3,0,15,1,19,4,5,0
3,03059,Crevillent,24408,343,239,104,316,200,116,67,73,113,60,31,1,55,44,81,44,23,-6,12,29,32,16,8,7,67,71,116,46,10,6,37,54,71,29,6,3,30,17,45,17,4,3,354,216,138,380,233,147,59,91,122,57,14,10,20,64,85,31,10,4,39,27,37,26,4,6,79,95,120,61,22,2,41,68,75,37,10,1,38,27,45,24,12,1,380,213,167,353,198,155,89,59,94,73,58,5,48,34,63,35,31,2,41,25,31,38,27,3,90,74,95,57,30,5,48,42,56,31,15,5,42,32,39,26,15,0,385,250,135,384,213,171,62,69,94,67,75,16,34,48,73,48,37,10,28,21,21,19,38,6,70,85,102,59,53,9,35,47,65,32,27,4,35,38,37,27,26,5,452,325,127,447,296,151,69,129,129,55,72,-7,40,87,125,35,40,-1,29,42,4,20,32,-6,65,110,134,66,54,11,36,78,101,44,28,7,29,32,33,22,26,4,317,253,64,375,243,132,42,61,113,54,33,14,38,50,92,50,14,7,4,11,21,4,19,7,49,93,122,58,37,14,28,73,83,33,17,8,21,20,39,25,20,6,387,190,197,286,137,149,95,82,73,91,32,8,43,34,40,50,21,3,52,48,33,41,11,5,68,71,58,52,27,6,41,29,18,26,19,3,27,42,40,26,8,3,46,8,38,253,91,162,47,14,-28,-30,36,9,40,1,-28,-24,23,1,7,13,0,-6,13,8,90,61,39,29,22,9,52,9,1,13,12,3,38,52,38,16,10,6,6,-30,36,92,13,79,35,24,-15,-27,-9,-8,25,-2,-9,-31,-12,-2,10,26,-6,4,3,-6,52,34,3,-11,6,2,31,8,-13,-19,2,1,21,26,16,8,4,1,-74,-33,-41,-12,-22,10,-17,-45,5,15,-23,-10,-18,-8,-7,16,-10,-8,1,-37,12,-1,-13,-2,6,6,6,-10,-14,-8,-2,-2,2,-7,-9,-5,8,8,4,-3,-5,-3,-463,-241,-222,-255,-159,-96,-99,-81,-129,-101,-32,-19,-40,-34,-69,-66,-18,-15,-59,-47,-60,-35,-14,-4,-47,-22,-59,-62,-46,-21,-18,-6,-53,-42,-28,-14,-29,-16,-6,-20,-18,-7,11,-33,44,-84,-75,-9,-23,22,72,-41,6,-22,-9,-4,27,-33,2,-16,-14,26,45,-8,4,-6,-16,-3,-32,-32,3,-6,-8,-11,-32,-27,2,-1,-8,8,0,-5,1,-5,-111,-80,-31,-64,-46,-18,-27,2,-49,-50,1,11,-5,-10,-34,-36,1,5,-22,12,-15,-14,0,6,-4,-5,-33,-28,1,6,2,-3,-25,-27,4,3,-6,-2,-8,-1,-3,3,-120,-72,-48,-97,-61,-36,-8,-9,-51,-25,-9,-10,2,-11,-27,-16,-16,-1,-10,2,-24,-9,7,-9,-18,-10,-32,-33,-1,-4,-10,-7,-18,-20,-5,-1,-8,-3,-14,-13,4,-3,51,21,30,-1,-13,12,10,-8,10,31,-1,8,-5,-2,10,15,2,2,15,-6,0,16,-3,6,4,-8,1,4,-8,4,2,-9,-2,-1,-7,2,2,1,3,5,-1,2,172,73,99,114,30,84,68,11,43,36,25,-15,27,7,12,20,18,-11,41,4,31,16,7,-4,35,15,8,16,29,9,12,-2,-3,4,12,6,23,17,11,12,17,3,81,23,58,99,45,54,7,12,12,16,20,13,-1,1,10,13,-9,9,8,11,2,3,29,4,23,19,14,9,19,12,9,10,12,8,0,6,14,9,2,1,19,6,125,96,29,241,134,107,5,41,40,16,29,0,10,24,37,3,22,0,-5,17,3,13,7,0,45,54,30,33,57,21,27,32,16,14,34,10,18,22,14,19,23,11
3,03063,Dénia,29585,1237,562,675,897,418,479,207,174,366,219,205,70,92,77,166,101,100,24,115,97,200,118,105,46,154,116,242,164,179,41,67,48,122,76,88,16,87,68,120,88,91,25,1891,997,894,1627,831,796,348,319,531,381,237,67,187,161,286,213,106,39,161,158,245,168,131,28,304,278,445,309,228,55,162,137,236,155,108,30,142,141,209,154,120,25,1798,950,848,1456,742,714,274,267,463,350,342,97,141,132,247,199,173,50,133,135,216,151,169,47,282,214,332,255,296,72,138,107,163,140,153,39,144,107,169,115,143,33,1601,839,762,1304,647,657,284,260,411,307,276,63,123,146,219,177,141,33,161,114,192,130,135,30,263,219,296,224,228,70,117,109,143,116,122,37,146,110,153,108,106,33,1497,842,655,1398,747,651,174,216,424,292,300,95,108,114,238,162,158,64,66,102,186,130,142,31,208,220,312,265,283,100,116,115,151,139,155,64,92,105,161,126,128,36,1314,747,567,1241,648,593,207,188,397,258,207,57,120,100,241,141,110,37,87,88,156,117,97,20,207,218,304,241,220,45,114,107,164,126,108,27,93,111,140,115,112,18,1199,624,575,1266,653,613,187,161,356,235,192,57,123,94,159,122,90,33,64,67,197,113,102,24,245,212,292,246,190,68,139,97,152,133,90,37,106,115,140,113,100,31,1258,609,649,1317,668,649,244,223,295,253,203,38,104,106,140,151,82,26,140,117,155,102,121,12,289,291,280,249,168,33,135,135,159,131,84,21,154,156,121,118,84,12,623,286,337,652,298,354,151,91,152,122,115,-15,83,26,74,60,42,-6,68,65,78,62,73,-9,145,127,127,129,90,28,83,46,59,56,38,11,62,81,68,73,52,17,337,163,174,358,169,189,53,12,138,24,82,18,45,-6,44,-8,64,14,8,18,94,32,18,4,102,62,56,62,63,10,58,21,13,34,38,4,44,41,43,28,25,6,-116,-161,45,-142,-130,-12,42,-18,-24,-31,-11,-88,-2,-34,-41,-25,-6,-58,44,16,17,-6,-5,-30,50,31,-19,-56,-37,-117,21,1,-17,-51,-20,-67,29,30,-2,-5,-17,-50,-111,-64,-47,142,33,109,6,-12,18,-68,20,-83,0,-17,26,-58,13,-30,6,5,-8,-10,7,-53,49,40,42,13,36,-43,18,5,15,-1,20,-27,31,35,27,14,16,-16,-174,-58,-116,-279,-142,-137,-26,-59,-104,-46,59,-2,0,-10,-49,-36,21,18,-26,-49,-55,-10,38,-20,-51,-52,-108,-77,3,2,-28,-24,-51,-46,-4,11,-23,-28,-57,-31,7,-9,-2734,-1443,-1291,-2743,-1446,-1297,-185,-181,-208,-436,-453,-1287,-108,-105,-123,-251,-209,-654,-77,-76,-85,-185,-244,-633,-177,-171,-243,-426,-450,-1278,-97,-103,-133,-243,-212,-659,-80,-68,-110,-183,-238,-619,-104,-80,-24,-98,-91,-7,10,-9,-24,-63,20,-36,27,-15,-19,-42,-17,-15,-17,6,-5,-21,37,-21,31,9,-41,-45,-10,-49,21,-3,-27,-41,-17,-26,10,12,-14,-4,7,-23,-156,-75,-81,-135,-117,-18,37,-41,-56,-21,-9,-68,24,-28,-41,-3,5,-32,13,-13,-15,-18,-14,-36,33,-17,-31,-51,-7,-69,17,-14,-39,-44,0,-39,16,-3,8,-7,-7,-30,451,136,315,353,116,237,82,81,87,86,92,21,40,23,51,-7,39,-10,42,58,36,93,53,31,82,55,74,55,75,11,43,24,30,-1,32,-13,39,31,44,56,43,24,406,188,218,494,224,270,68,20,84,114,132,-25,27,8,36,49,60,5,41,12,48,65,72,-30,86,55,107,112,90,33,39,30,54,47,30,18,47,25,53,65,60,15
3,03064,Dolores,6239,-18,-14,-4,55,33,22,-12,1,-18,2,7,2,-18,-2,-9,8,5,2,6,3,-9,-6,2,0,8,15,11,7,9,4,2,9,8,6,5,2,6,6,3,1,4,2,83,51,32,123,77,46,9,31,37,3,4,-4,6,22,20,0,1,-1,3,9,17,3,3,-3,16,39,46,10,6,3,9,26,29,6,2,2,7,13,17,4,4,1,175,97,78,154,73,81,60,32,43,21,9,7,34,21,19,19,0,1,26,11,24,2,9,6,43,33,39,23,9,5,23,15,17,12,3,2,20,18,22,11,6,3,148,100,48,169,87,82,30,24,12,43,38,-3,18,18,15,24,25,-3,12,6,-3,19,13,0,40,27,44,28,25,5,20,15,24,13,13,2,20,12,20,15,12,3,87,42,45,125,70,55,8,15,-25,25,62,-1,1,9,-7,6,28,5,7,6,-18,19,34,-6,18,25,18,20,36,7,11,16,14,8,17,4,7,9,4,12,19,3,-13,-2,-11,83,40,43,-8,-22,-21,-6,44,3,-5,-6,-9,-4,21,2,-3,-16,-12,-2,23,1,5,9,9,9,43,7,1,5,3,3,23,4,4,4,6,6,20,3,83,21,62,164,78,86,46,-18,-5,11,43,9,23,-12,-20,3,23,5,23,-6,15,8,20,4,42,17,36,26,36,7,24,8,12,14,16,4,18,9,24,12,20,3,278,130,148,182,81,101,38,63,53,69,52,2,14,26,20,31,36,2,24,37,33,38,16,0,38,34,39,31,39,1,21,12,14,13,20,1,17,22,25,18,19,0,81,28,53,53,24,29,37,8,13,5,11,2,24,-4,2,1,1,1,13,12,11,4,10,1,21,6,-2,9,15,3,14,1,-2,2,7,1,7,5,0,7,8,2,-55,-61,6,-69,-43,-26,9,0,5,-22,-33,-13,-4,-2,-10,-19,-22,-3,13,2,15,-3,-11,-10,1,-7,-3,-15,-30,-15,-2,-1,-4,-15,-18,-3,3,-6,1,0,-12,-12,-5,19,-24,16,10,6,20,-4,8,-13,-9,-9,11,-7,20,-1,-3,-1,9,3,-12,-12,-6,-8,2,7,12,-2,-6,1,1,1,11,-2,-3,1,1,6,1,0,-3,0,-33,-13,-20,-72,-40,-32,1,-6,-21,-4,2,-12,-3,-1,-10,-4,6,-6,4,-5,-11,0,-4,-6,-10,-9,-14,-16,-13,-12,-7,-4,-11,-9,-4,-6,-3,-5,-3,-7,-9,-6,-46,-1,-45,-74,-23,-51,-20,-4,13,2,-23,-21,1,-1,13,3,-9,-12,-21,-3,0,-1,-14,-9,-6,-9,-15,0,-22,-23,2,-6,-1,0,-7,-11,-8,-3,-14,0,-15,-12,-90,-51,-39,-61,-36,-25,-28,-15,-18,-13,-16,-4,-17,-4,-17,-2,-9,-3,-11,-11,-1,-11,-7,-1,-14,-3,-9,-11,-16,-8,-6,-1,-9,-6,-8,-6,-8,-2,0,-5,-8,-2,17,46,-29,58,44,14,-3,-5,-1,5,18,-3,8,-1,11,6,13,7,-11,-4,-12,-1,5,-10,8,7,10,7,17,7,7,5,10,5,10,6,1,2,0,2,7,1,-6,6,-12,-10,-2,-8,37,4,20,-15,-16,-44,21,2,8,-8,-3,-19,16,2,12,-7,-13,-25,22,0,8,-1,-12,-29,8,-1,7,1,-5,-14,14,1,1,-2,-7,-15,81,45,36,55,25,30,8,10,7,15,25,14,7,8,8,6,12,3,1,2,-1,9,13,11,-6,7,10,4,24,14,-4,5,6,1,11,5,-2,2,4,3,13,9,30,-2,32,12,-8,20,-2,6,10,9,24,-19,-6,7,3,-12,11,-7,4,-1,7,21,13,-12,1,3,3,7,8,-10,-2,1,3,-6,3,-7,3,2,0,13,5,-3
3,03065,Elche/Elx,193174,1791,1095,696,1877,1075,802,250,438,710,342,22,11,128,282,449,205,11,14,122,156,261,137,11,-3,253,472,713,331,77,19,126,271,433,188,35,14,127,201,280,143,42,5,2588,1401,1187,2641,1427,1214,453,704,866,497,60,-14,229,376,492,298,13,-23,224,328,374,199,47,9,458,659,870,497,107,27,226,356,494,276,49,12,232,303,376,221,58,15,3559,1918,1641,2891,1504,1387,798,791,1065,667,184,24,399,416,599,387,80,22,399,375,466,280,104,2,639,695,842,477,177,41,300,361,464,268,79,22,339,334,378,209,98,19,4197,2254,1943,3260,1746,1514,875,944,1344,664,195,115,414,514,809,377,59,49,461,430,535,287,136,66,693,874,902,478,224,62,349,466,532,257,100,31,344,408,370,221,124,31,3930,2349,1581,3097,1792,1305,696,915,1237,688,238,114,386,539,807,425,116,51,310,376,430,263,122,63,501,840,934,537,205,54,253,492,605,315,89,24,248,348,329,222,116,30,4260,2479,1781,3464,2024,1440,698,1106,1404,664,225,106,324,636,905,442,96,37,374,470,499,222,129,69,520,953,1069,572,256,60,257,539,722,332,123,31,263,414,347,240,133,29,3065,1636,1429,3247,1668,1579,554,940,862,427,197,68,294,503,496,227,76,31,260,437,366,200,121,37,594,998,885,464,212,64,301,503,504,227,91,30,293,495,381,237,121,34,3221,1766,1455,3857,2067,1790,576,1174,743,542,154,49,275,670,447,294,54,26,301,504,296,248,100,23,745,1207,1003,611,221,45,369,667,577,330,98,16,376,540,426,281,123,29,-318,-324,6,543,185,358,22,224,-346,-184,-57,35,-7,101,-236,-152,-31,12,29,123,-110,-32,-26,23,100,474,52,-59,-4,-37,37,244,-8,-75,-7,-10,63,230,60,16,3,-27,-488,-343,-145,407,118,289,103,-43,-259,-226,-95,53,75,-30,-182,-153,-56,12,28,-13,-77,-73,-39,41,165,200,35,-26,5,10,101,80,-17,-51,-9,1,64,120,52,25,14,9,-1446,-1068,-378,-1090,-807,-283,-38,-185,-740,-348,-166,25,-27,-157,-525,-257,-104,8,-11,-28,-215,-91,-62,17,-125,-81,-461,-334,-110,1,-43,-82,-349,-265,-80,5,-82,1,-112,-69,-30,-4,-525,-369,-156,-132,-213,81,48,-40,-355,-86,-57,-21,22,-45,-228,-41,-47,-23,26,5,-127,-45,-10,2,62,79,-206,-110,26,4,44,11,-160,-99,-13,-2,18,68,-46,-11,39,6,-1095,-674,-421,-1109,-778,-331,-67,-140,-575,-380,-4,67,-6,-85,-354,-258,-12,29,-61,-55,-221,-122,8,38,-110,-104,-510,-348,-53,-2,-48,-64,-358,-284,-39,6,-62,-40,-152,-64,-14,-8,-960,-586,-374,-1018,-660,-358,-89,-108,-516,-271,-126,140,-12,-67,-324,-212,-44,70,-77,-41,-192,-59,-82,70,-114,-66,-411,-336,-108,-3,-37,-50,-262,-257,-68,3,-77,-16,-149,-79,-40,-6,776,432,344,967,545,422,155,177,22,170,182,80,60,129,30,109,84,26,95,48,-8,61,98,54,169,228,165,200,147,43,83,110,104,140,82,19,86,118,61,60,65,24,669,239,430,490,193,297,257,113,79,109,42,64,105,50,20,46,-5,29,152,63,59,63,47,35,133,194,62,37,41,14,64,99,7,13,9,-1,69,95,55,24,32,15,618,276,342,349,109,240,141,128,127,57,44,107,56,56,63,23,25,46,85,72,64,34,19,61,86,151,65,-27,20,31,33,73,28,-55,-5,20,53,78,37,28,25,11,2452,1244,1208,2054,1122,932,493,399,556,537,248,193,239,260,256,262,133,90,254,139,300,275,115,103,349,421,519,405,230,104,181,262,286,219,117,44,168,159,233,186,113,60
3,03066,Elda,51228,-68,-30,-38,433,215,218,33,-27,-41,28,-25,-33,18,-4,-35,7,-13,-5,15,-23,-6,21,-12,-28,74,98,156,83,14,3,46,45,78,34,7,2,28,53,78,49,7,1,739,397,342,1073,551,522,202,203,162,198,-10,-23,110,73,93,124,-7,-1,92,130,69,74,-3,-22,207,270,325,216,36,7,105,121,185,114,16,4,102,149,140,102,20,3,138,63,75,500,230,270,120,49,39,1,-28,-44,50,21,30,0,-19,-20,70,28,9,1,-9,-24,117,131,133,75,33,5,53,57,71,33,10,2,64,74,62,42,23,3,47,83,-36,398,205,193,56,61,-21,-8,-29,-19,59,45,-9,3,-15,-3,-3,16,-12,-11,-14,-16,88,118,93,63,26,6,44,56,59,28,12,3,44,62,34,35,14,3,102,106,-4,362,198,164,60,19,-17,22,23,-20,37,40,-9,28,12,-9,23,-21,-8,-6,11,-11,60,98,131,37,19,15,32,54,77,21,7,7,28,44,54,16,12,8,-203,-53,-150,267,135,132,25,-80,-169,20,-14,25,25,0,-83,8,-3,5,0,-80,-86,12,-11,20,55,70,80,35,19,8,28,35,39,21,10,2,27,35,41,14,9,6,107,140,-33,410,230,180,101,31,-46,65,-40,-29,73,41,-13,37,-15,-3,28,-10,-33,28,-25,-26,89,103,106,84,26,-2,51,55,59,46,16,1,38,48,47,38,10,-3,53,134,-81,427,227,200,111,30,-91,37,-36,1,74,46,-29,28,5,0,37,-16,-62,9,-41,1,112,112,101,69,24,6,59,59,52,31,19,3,53,53,49,38,5,3,-47,-51,4,432,209,223,27,-21,-34,-22,-18,22,4,-12,-14,-10,-21,7,23,-9,-20,-12,3,15,91,89,137,70,27,10,46,44,71,29,12,6,45,45,66,41,15,4,-343,-193,-150,66,22,44,-17,-60,-184,-71,-38,29,-10,-42,-89,-42,-20,13,-7,-18,-95,-29,-18,16,35,28,5,1,-6,0,15,12,3,-5,-5,0,20,16,2,6,-1,0,-398,-198,-200,-187,-126,-61,-63,-107,-109,-105,-33,12,-9,-58,-60,-81,-7,10,-54,-49,-49,-24,-26,2,-19,-26,-56,-65,-17,-10,-1,-14,-45,-58,-8,-4,-18,-12,-11,-7,-9,-6,54,62,-8,88,64,24,41,-12,6,0,-2,25,22,18,10,-1,5,14,19,-30,-4,1,-7,11,5,37,27,12,1,5,3,32,16,8,1,3,2,5,11,4,0,2,-258,-175,-83,-7,-25,18,-37,-20,-89,-60,-18,-31,-42,-2,-79,-25,-13,-16,5,-18,-10,-35,-5,-15,4,5,-13,-2,-2,1,-1,2,-23,-4,-1,2,5,3,10,2,-1,-1,-616,-326,-290,-389,-235,-154,-45,-138,-224,-136,-87,10,-9,-74,-99,-98,-53,2,-36,-64,-125,-38,-34,8,-48,-77,-102,-110,-47,-9,-24,-55,-62,-68,-25,-4,-24,-22,-40,-42,-22,-5,-184,-81,-103,-121,-70,-51,-9,-40,-94,-5,-27,-6,10,-18,-64,6,-13,1,-19,-22,-30,-11,-14,-7,-10,-11,-54,-35,-7,-5,-1,-5,-37,-17,-6,-4,-9,-6,-17,-18,-1,-1,-359,-177,-182,-44,-27,-17,-46,-20,-191,-42,-37,-23,-30,8,-74,-35,-20,-23,-16,-28,-117,-7,-17,0,-4,1,-31,-13,-4,2,-1,1,-13,-11,-4,-3,-3,0,-18,-2,0,5,31,28,3,72,35,37,60,-8,-3,-1,-17,-14,12,1,16,7,-14,-6,48,-9,-19,-8,-3,-8,12,23,26,11,-8,3,4,7,20,9,-11,3,8,16,6,2,3,0,29,-13,42,158,80,78,58,5,-11,21,-23,-17,7,11,11,-1,-22,-18,51,-6,-22,22,-1,1,37,43,56,9,10,1,15,27,41,-2,-1,-1,22,16,15,11,11,2
3,03069,Finestrat,1954,175,95,80,99,50,49,31,20,40,43,35,8,11,11,22,24,23,4,20,9,18,19,12,4,22,6,22,14,27,8,8,1,15,8,15,3,14,5,7,6,12,5,177,90,87,142,69,73,29,31,32,34,30,19,23,14,10,18,13,10,6,17,22,16,17,9,26,17,28,27,28,16,11,7,15,11,16,9,15,10,13,16,12,7,344,184,160,216,116,100,55,41,98,70,54,24,24,20,49,44,31,14,31,21,49,26,23,10,29,22,48,39,49,27,9,14,28,23,26,15,20,8,20,16,23,12,369,192,177,68,35,33,47,59,102,74,64,27,21,29,67,27,38,15,26,30,35,47,26,12,14,3,15,13,22,1,6,0,12,6,11,0,8,3,3,7,11,1,412,218,194,196,90,106,45,65,97,103,84,15,26,31,57,53,42,5,19,34,40,50,42,10,25,23,36,43,52,16,11,10,19,17,26,7,14,13,17,26,26,9,327,176,151,228,124,104,39,67,90,48,49,28,11,35,59,29,21,21,28,32,31,19,28,7,31,37,41,42,46,28,17,19,22,22,26,17,14,18,19,20,20,11,797,428,369,370,192,178,131,121,183,168,130,61,70,57,96,91,76,38,61,64,87,77,54,23,57,48,57,79,84,42,34,19,31,41,41,24,23,29,26,38,43,18,814,424,390,377,191,186,112,157,241,164,113,25,58,74,137,85,59,13,54,83,104,79,54,12,58,66,76,74,73,27,32,27,45,34,34,16,26,39,31,40,39,11,279,107,172,243,110,133,62,18,80,55,49,16,8,6,38,23,22,9,54,12,42,32,27,7,61,23,41,64,42,11,26,8,19,34,17,6,35,15,22,30,25,5,226,111,115,167,85,82,37,52,28,32,61,12,21,21,14,12,34,6,16,31,14,20,27,6,29,18,26,42,32,16,20,5,11,23,18,7,9,13,15,19,14,9,387,218,169,183,104,79,44,63,110,85,48,37,31,31,61,46,27,21,13,32,49,39,21,16,26,27,28,45,37,20,16,17,15,24,18,14,10,10,13,21,19,6,176,103,73,192,100,92,21,16,41,32,52,9,15,10,21,22,22,10,6,6,20,10,30,-1,30,19,40,37,46,18,21,12,12,22,19,12,9,7,28,15,27,6,172,84,88,200,104,96,10,9,61,31,39,18,9,-5,27,16,24,13,1,14,34,15,15,5,39,14,41,42,47,13,21,5,16,29,25,6,18,9,25,13,22,7,163,76,87,129,61,68,31,19,45,21,43,2,5,16,10,27,19,0,26,3,35,-6,24,2,23,20,15,29,28,12,5,11,4,17,15,8,18,9,11,12,13,4,185,102,83,126,57,69,-3,22,63,70,25,7,-3,14,28,44,12,7,0,8,35,26,13,0,24,9,30,29,23,9,11,7,8,16,8,6,13,2,22,13,15,3,71,18,53,3,-14,17,11,-5,29,2,15,14,-2,-10,19,-6,8,7,13,5,10,8,7,7,21,-13,0,-17,4,3,3,-6,-8,-13,-2,9,18,-7,8,-4,6,-6,258,111,147,186,94,92,1,46,63,68,69,0,-6,7,41,31,31,-1,7,39,22,37,38,1,30,11,30,44,48,14,15,0,12,30,22,10,15,11,18,14,26,4,187,85,102,193,105,88,21,59,46,18,40,-1,22,22,28,-9,26,0,-1,37,18,27,14,-1,33,22,43,45,36,9,28,10,25,21,18,1,5,12,18,24,18,8
3,03077,"Fondó de les Neus, el/Hondón de las Nieves",1604,76,41,35,44,24,20,14,12,13,22,16,-1,10,5,7,11,7,1,4,7,6,11,9,-2,7,5,9,13,10,0,6,1,7,5,5,0,1,4,2,8,5,0,45,17,28,48,27,21,7,1,11,5,26,-5,0,2,3,0,12,0,7,-1,8,5,14,-5,4,4,7,6,24,3,4,4,4,1,12,2,0,0,3,5,12,1,66,41,25,58,29,29,14,-10,8,12,37,5,5,-3,4,9,23,3,9,-7,4,3,14,2,13,0,9,10,22,4,5,0,5,5,12,2,8,0,4,5,10,2,197,113,84,151,78,73,19,10,1,39,109,19,13,5,3,19,65,8,6,5,-2,20,44,11,15,9,12,24,79,12,6,4,5,12,45,6,9,5,7,12,34,6,231,123,108,191,103,88,38,9,24,60,77,20,22,4,15,27,45,9,16,5,9,33,32,11,31,6,17,50,71,14,20,1,8,24,43,6,11,5,9,26,28,8,164,91,73,148,78,70,17,1,13,26,89,18,8,3,5,19,43,14,9,-2,8,7,46,4,23,3,9,25,76,11,12,2,2,12,41,9,11,1,7,13,35,2,212,117,95,157,79,78,29,11,31,24,99,18,14,9,14,13,55,12,15,2,17,11,44,6,18,4,18,23,79,15,6,2,9,10,41,11,12,2,9,13,38,4,243,135,108,184,100,84,45,11,24,55,86,18,24,7,21,27,44,11,21,4,3,28,42,7,25,9,11,42,78,19,14,6,9,22,37,12,11,3,2,20,41,7,133,80,53,114,57,57,-7,1,10,34,83,10,1,0,10,16,44,6,-8,1,0,18,39,4,2,2,4,25,64,15,0,1,2,13,31,8,2,1,2,12,33,7,76,46,30,66,37,29,-1,8,10,16,37,5,2,7,5,4,22,5,-3,1,5,12,15,0,3,3,3,18,32,7,1,2,2,10,18,4,2,1,1,8,14,3,53,18,35,43,25,18,6,6,-4,3,42,-1,3,-1,-6,1,19,1,3,7,2,2,23,-2,2,-1,3,8,35,-4,2,-2,3,4,18,0,0,1,0,4,17,-4,55,35,20,38,19,19,1,1,8,10,28,9,-2,2,5,8,17,5,3,-1,3,2,11,4,-4,4,1,6,24,7,-6,2,1,4,13,5,2,2,0,2,11,2,31,18,13,29,14,15,-7,0,4,11,24,-1,-1,-2,0,4,18,-1,-6,2,4,7,6,0,-1,-1,0,15,20,-4,-1,-1,-1,8,13,-4,0,0,1,7,7,0,-34,-28,-6,-29,-14,-15,-2,-8,-8,-11,10,-15,0,-12,-4,-9,6,-10,-2,4,-4,-2,4,-5,-9,-5,-4,-9,6,-9,-3,-5,-2,-3,3,-5,-6,0,-2,-6,3,-4,5,17,-12,16,12,4,-1,-1,0,0,15,-8,-2,-2,3,2,18,-3,1,1,-3,-2,-3,-5,6,0,4,-1,15,-9,2,0,0,-1,16,-6,4,0,4,0,-1,-3,-36,-18,-18,-37,-20,-17,7,-5,6,-11,-6,-27,4,-5,6,-8,-2,-13,3,0,0,-3,-4,-14,1,-7,-4,-5,4,-26,2,-6,-2,-6,5,-13,-1,-1,-2,1,-1,-13,-17,-2,-15,18,13,5,-9,-3,-6,-2,11,-8,-5,-4,-1,-1,7,-1,-4,1,-5,-1,4,-7,1,-3,2,9,22,-13,2,-3,2,6,11,-5,-1,0,0,3,11,-8,33,26,7,13,8,5,3,11,-2,8,27,-13,4,8,-1,9,11,-6,-1,3,-1,-1,16,-7,2,1,0,6,15,-11,2,1,-1,4,7,-5,0,0,1,2,8,-6
3,03070,Formentera del Segura,2111,64,37,27,25,18,7,15,17,25,3,4,-1,7,10,14,3,1,1,8,7,11,0,3,-2,1,10,10,3,1,0,1,6,7,3,1,0,0,4,3,0,0,0,57,39,18,70,40,30,11,9,16,10,10,0,5,6,12,7,7,1,6,3,4,3,3,-1,15,11,17,15,10,1,7,4,11,9,7,1,8,7,6,6,3,0,139,79,60,120,74,46,28,16,41,31,17,4,14,7,32,15,7,2,14,9,9,16,10,2,21,24,31,19,19,4,16,13,24,8,9,2,5,11,7,11,10,2,182,103,79,167,97,70,21,37,28,20,65,11,3,26,19,13,38,4,18,11,9,7,27,7,23,30,33,27,49,5,8,25,22,12,27,3,15,5,11,15,22,2,273,147,126,222,115,107,16,31,52,53,97,25,13,17,32,23,48,14,3,14,20,30,49,11,16,28,39,44,75,18,9,15,25,18,36,11,7,13,14,26,39,7,353,200,153,272,143,129,71,35,68,73,85,18,40,26,38,34,49,10,31,9,30,39,36,8,51,28,41,53,81,15,23,18,25,23,44,7,28,10,16,30,37,8,388,228,160,324,183,141,68,34,83,92,96,9,39,23,47,53,49,13,29,11,36,39,47,-4,39,34,52,81,98,17,21,22,34,43,48,13,18,12,18,38,50,4,562,296,266,453,250,203,54,64,112,147,157,26,22,21,73,80,83,16,32,43,39,67,74,10,46,47,68,109,149,31,24,25,47,56,79,17,22,22,21,53,70,14,193,110,83,184,97,87,26,25,38,40,50,12,21,15,22,21,22,6,5,10,16,19,28,6,27,29,24,37,53,12,19,11,17,17,26,5,8,18,7,20,27,7,97,15,82,28,-12,40,11,10,-2,13,34,30,-5,-5,-3,0,15,12,16,15,1,13,19,18,0,3,-15,-7,29,15,-2,-5,-16,-7,10,7,2,8,1,0,19,8,59,18,41,49,25,24,12,6,9,1,27,2,9,-5,3,-2,13,-2,3,11,6,3,14,4,5,-3,12,7,24,2,1,-2,8,4,11,1,4,-1,4,3,13,1,165,86,79,117,58,59,28,33,13,25,50,12,13,21,11,14,26,0,15,12,2,11,24,12,16,19,19,16,38,6,10,10,10,3,22,1,6,9,9,13,16,5,79,55,24,73,37,36,15,12,23,1,23,2,10,6,15,6,16,0,5,6,8,-5,7,2,12,12,11,9,23,5,4,2,7,5,15,4,8,10,4,4,8,1,118,43,75,105,51,54,38,-8,15,18,12,47,20,-6,5,2,5,20,18,-2,10,16,7,27,27,7,13,26,19,13,15,4,5,11,11,5,12,3,8,15,8,8,74,32,42,109,59,50,7,13,-2,8,36,13,-3,4,-1,5,22,6,10,9,-1,3,14,7,15,7,20,21,37,9,8,2,10,12,20,7,7,5,10,9,17,2,60,22,38,78,41,37,4,-3,-2,8,33,18,-4,2,-2,2,18,7,8,-5,0,6,15,11,13,0,3,17,37,7,4,1,3,11,19,3,9,-1,0,6,18,4,183,87,96,167,83,84,29,12,26,29,59,24,18,4,14,14,29,5,11,8,12,15,30,19,27,14,19,21,64,19,16,6,8,11,30,10,11,8,11,10,34,9,120,34,86,138,57,81,12,-1,2,17,56,33,-6,-1,7,-4,24,14,18,0,-5,21,32,19,21,9,11,28,43,25,6,4,7,9,20,11,15,5,4,19,23,14
3,03071,Gata de Gorgos,5003,28,11,17,23,11,12,11,6,7,7,-3,-1,1,3,6,3,-2,-1,10,3,1,4,-1,0,6,2,8,5,0,2,2,0,4,4,0,1,4,2,4,1,0,1,116,76,40,109,74,35,23,21,33,31,6,0,8,11,29,19,4,3,15,10,4,12,2,-3,19,15,43,20,5,5,12,9,33,13,3,3,7,6,10,7,2,2,117,85,32,108,66,42,25,26,37,16,8,3,22,19,21,10,6,4,3,7,16,6,2,-1,22,26,31,17,6,3,17,17,15,8,4,2,5,9,16,9,2,1,114,77,37,112,66,46,39,23,19,17,12,5,24,20,14,13,6,2,15,3,5,4,6,3,32,23,32,12,11,1,16,14,20,8,8,0,16,9,12,4,3,1,126,71,55,125,67,58,13,25,23,28,28,3,5,18,11,16,13,4,8,7,12,12,15,-1,25,23,28,19,22,4,11,13,18,11,10,1,14,10,10,8,12,3,166,95,71,127,70,57,31,35,46,32,21,-1,13,20,31,16,14,-1,18,15,15,16,7,0,27,26,36,22,14,1,14,18,18,14,7,-1,13,8,18,8,7,2,412,226,186,305,159,146,48,49,46,60,130,75,31,32,34,26,59,42,17,17,12,34,71,33,48,43,37,42,95,40,25,27,19,18,46,24,23,16,18,24,49,16,214,96,118,156,78,78,51,33,27,52,45,5,21,18,11,29,15,3,30,15,16,23,30,2,28,36,28,23,34,6,13,21,11,12,15,6,15,15,17,11,19,0,101,42,59,84,48,36,21,17,27,4,26,7,3,11,11,1,11,6,18,6,16,3,15,1,18,22,28,-3,12,6,11,13,17,-4,7,4,7,9,11,1,5,2,-10,-16,6,22,12,10,3,2,-11,-3,7,-10,1,-3,-13,-5,7,-3,2,5,2,2,0,-7,2,3,7,3,8,-2,4,2,1,0,6,-1,-2,1,6,3,2,-1,20,18,2,53,33,20,-19,9,3,1,17,8,-4,4,7,0,5,4,-15,5,-4,1,12,4,4,7,7,8,18,8,6,4,3,4,9,6,-2,3,4,4,9,2,3,-4,7,19,6,13,14,-12,4,-7,1,1,10,-7,0,-7,-2,0,4,-5,4,0,3,1,9,3,-1,2,2,2,5,-1,-1,-1,0,2,4,4,0,3,2,0,-58,-37,-21,9,-3,12,-11,-10,-11,-19,0,-7,-13,-10,1,-14,1,0,2,0,-12,-5,-1,-7,4,-3,-1,-6,8,5,2,-5,-1,-6,3,3,2,2,0,0,5,2,6,-3,9,9,6,3,0,10,-7,3,5,-4,-1,8,-10,3,2,-5,1,2,3,0,3,1,2,-1,2,0,5,0,0,3,0,-1,3,0,2,-4,2,1,2,0,-5,-17,12,61,23,38,-5,-1,-11,-1,10,1,-7,-3,-11,-5,7,3,2,2,0,4,3,-2,9,1,6,23,16,5,5,-3,-1,10,10,2,4,4,7,13,6,3,44,6,38,18,2,16,19,-9,4,-8,30,8,8,-4,-9,-11,15,6,11,-5,13,3,15,2,6,-4,-8,0,19,4,5,-2,-8,-3,7,2,1,-2,0,3,12,2,53,28,25,50,27,23,6,1,15,10,14,2,3,0,8,8,3,1,3,1,7,2,11,1,5,8,11,8,11,5,0,4,6,8,4,3,5,4,5,0,7,2,150,83,67,125,68,57,38,3,39,25,36,5,16,3,20,11,19,10,22,0,19,14,17,-5,18,10,19,29,36,11,5,7,12,15,21,6,13,3,7,14,15,5
3,03076,Guardamar del Segura,8845,104,50,54,23,11,12,11,-9,28,0,65,7,4,-6,12,1,32,6,7,-3,16,-1,33,1,3,0,5,2,11,1,1,0,3,1,6,0,2,0,2,1,5,1,121,73,48,12,7,5,-10,2,37,1,71,17,-1,-2,14,-2,43,18,-9,4,23,3,28,-1,2,2,3,2,1,1,1,0,3,1,1,0,1,2,0,1,0,1,89,51,38,8,5,3,-21,17,34,-1,27,34,-18,6,34,1,15,15,-3,11,0,-2,12,19,6,0,2,1,2,-3,4,-2,1,0,2,0,2,2,1,1,0,-3,190,104,86,73,42,31,15,25,74,23,14,43,5,25,41,15,2,19,10,0,33,8,12,24,8,9,11,7,25,13,4,7,7,7,11,6,4,2,4,0,14,7,860,455,405,790,422,368,123,120,163,131,238,84,59,73,93,72,112,47,64,47,70,59,126,37,104,107,142,131,214,89,46,62,83,74,102,54,58,45,59,57,112,35,963,488,475,938,492,446,91,62,157,137,377,131,58,17,85,60,192,70,33,45,72,77,185,61,94,78,141,137,365,115,58,37,75,71,179,67,36,41,66,66,186,48,1140,591,549,1016,538,478,125,72,124,211,432,166,80,39,48,108,213,96,45,33,76,103,219,70,119,73,102,187,412,116,74,38,49,96,208,67,45,35,53,91,204,49,825,417,408,718,374,344,71,75,158,151,256,105,42,29,91,70,116,66,29,46,67,81,140,39,94,73,126,140,210,73,48,32,65,78,108,43,46,41,61,62,102,30,294,127,167,373,186,187,25,35,28,52,131,14,18,24,10,10,57,5,7,11,18,42,74,9,41,48,61,71,108,37,23,25,27,31,57,21,18,23,34,40,51,16,147,72,75,174,61,113,-7,29,-2,54,81,-16,-2,14,-1,19,35,5,-5,15,-1,35,46,-21,12,40,7,48,70,-6,1,13,0,21,32,-7,11,27,7,27,38,1,385,176,209,184,79,105,37,35,58,71,121,57,28,18,13,42,50,20,9,17,45,29,71,37,30,27,16,31,72,3,19,11,-6,16,31,5,11,16,22,15,41,-2,312,160,152,266,127,139,68,29,60,52,64,33,45,3,34,16,33,27,23,26,26,36,31,6,63,14,45,67,66,9,32,-1,21,34,32,7,31,15,24,33,34,2,-28,-23,-5,59,21,38,18,1,5,14,-3,-65,11,-2,5,-6,1,-34,7,3,0,20,-4,-31,32,14,4,28,32,-55,18,4,-2,11,11,-22,14,10,6,17,21,-33,32,-16,48,9,-7,16,35,-7,30,-6,-22,-5,1,-14,11,-2,-8,-8,34,7,19,-4,-14,3,33,-2,15,6,-20,-28,6,-8,13,3,-6,-18,27,6,2,3,-14,-10,327,161,166,261,115,146,72,35,53,61,68,39,17,22,22,40,37,22,55,13,31,21,31,17,67,24,45,44,59,20,27,12,15,19,29,11,40,12,30,25,30,9,53,3,50,62,12,50,44,8,11,3,36,-51,31,5,-18,12,14,-41,13,3,29,-9,22,-10,53,8,28,14,21,-65,28,4,4,7,11,-44,25,4,24,7,10,-21,-738,-444,-294,-896,-511,-385,-12,-59,-37,-78,-187,-373,-10,-46,-41,-58,-92,-200,-2,-13,4,-20,-95,-173,-34,-68,-69,-143,-170,-418,-24,-39,-50,-85,-90,-226,-10,-29,-19,-58,-80,-192,-67,-43,-24,-225,-113,-112,92,-12,51,-8,9,-203,60,-4,20,-2,-8,-111,32,-8,31,-6,17,-92,69,-12,17,-43,-22,-239,43,-1,9,-22,-21,-123,26,-11,8,-21,-1,-116
3,03078,Hondón de los Frailes,553,30,15,15,6,3,3,7,1,2,7,8,5,3,1,2,1,5,3,4,0,0,6,3,2,2,0,1,2,0,1,1,0,1,1,0,0,1,0,0,1,0,1,50,29,21,20,10,10,6,6,17,8,11,2,4,3,10,7,3,2,2,3,7,1,8,0,2,3,2,5,8,0,0,1,1,3,5,0,2,2,1,2,3,0,81,50,31,55,28,27,5,2,14,10,43,6,5,3,9,5,22,6,0,-1,5,5,21,0,7,1,7,7,31,2,3,0,4,4,15,2,4,1,3,3,16,0,161,78,83,121,56,65,10,3,2,19,98,30,0,2,4,5,47,20,10,1,-2,14,51,10,13,1,10,15,70,12,4,0,4,6,35,7,9,1,6,9,35,5,142,73,69,136,73,63,0,2,1,25,94,19,-2,2,-1,14,49,11,2,0,2,11,45,8,7,2,10,26,84,6,3,2,6,13,45,4,4,0,4,13,39,2,100,50,50,97,48,49,9,7,10,22,42,9,5,3,4,8,22,7,4,4,6,14,20,2,10,5,9,22,42,9,4,2,4,10,21,7,6,3,5,12,21,2,118,59,59,57,26,31,9,6,23,25,42,12,6,3,13,10,19,8,3,3,10,15,23,4,7,0,8,11,28,3,6,0,2,3,13,2,1,0,6,8,15,1,-15,-5,-10,-19,-6,-13,2,12,-1,5,-12,-20,0,7,-1,4,-2,-12,2,5,0,1,-10,-8,1,4,-5,2,-12,-9,2,4,-4,1,-3,-6,-1,0,-1,1,-9,-3,18,18,0,0,0,0,6,-4,-3,3,17,-2,0,1,-2,5,15,-2,6,-5,-1,-2,2,0,2,-3,0,-3,7,-4,-2,-1,-1,0,5,-2,4,-2,1,-3,2,-2,-13,-8,-5,-1,-1,0,-11,0,-7,-5,12,-4,-4,-1,-5,-2,5,-1,-7,1,-2,-3,7,-3,-5,0,-2,0,9,-3,-2,-1,-3,2,4,-1,-3,1,1,-2,5,-2,21,16,5,17,9,8,0,1,-3,8,12,2,2,0,1,4,8,0,-2,1,-4,4,4,2,2,0,1,3,11,0,1,0,1,1,6,0,1,0,0,2,5,0,33,13,20,20,8,12,6,3,-9,9,23,0,3,-1,-3,3,12,-1,3,4,-6,6,11,1,3,0,-4,-1,20,2,1,0,-2,-3,11,1,2,0,-2,2,9,1,-2,-1,-1,-1,3,-4,-1,0,4,-7,2,-1,0,1,-1,1,-1,-1,-1,-1,5,-8,3,0,-4,-1,3,-4,6,-1,-2,0,0,2,4,-1,-2,-1,3,-6,2,0,17,3,14,26,15,11,4,8,-1,4,11,-9,1,4,-4,1,4,-3,3,4,3,3,7,-6,3,1,2,6,17,-3,1,1,1,3,10,-1,2,0,1,3,7,-2,46,22,24,42,19,23,-5,-1,-5,5,41,11,-2,0,-1,-1,19,7,-3,-1,-4,6,22,4,-3,2,-1,5,28,11,-1,0,-1,3,11,7,-2,2,0,2,17,4,-62,-27,-35,-59,-26,-33,-4,-2,-8,-13,-10,-25,-1,0,-6,-3,2,-19,-3,-2,-2,-10,-12,-6,-4,-8,-2,-9,-14,-22,-1,-4,-1,-3,-2,-15,-3,-4,-1,-6,-12,-7,7,-3,10,5,-1,6,3,-8,1,15,7,-11,0,-6,-3,8,-1,-1,3,-2,4,7,8,-10,-2,-3,-2,7,10,-5,-2,-1,-3,3,2,0,0,-2,1,4,8,-5,41,24,17,30,11,19,-1,0,5,19,18,1,-1,2,6,5,9,3,0,-2,-1,14,9,-2,1,-1,4,9,19,-2,0,1,1,3,6,0,1,-2,3,6,13,-2
3,03079,Ibi,21180,271,158,113,269,156,113,32,76,101,56,-3,7,22,38,60,40,-5,2,10,38,41,16,2,5,40,62,106,52,5,1,26,32,63,33,1,0,14,30,43,19,4,1,459,253,206,367,211,156,104,149,123,67,8,4,58,78,85,27,4,-1,46,71,38,40,4,5,78,116,105,50,11,4,44,66,67,26,6,1,34,50,38,24,5,3,468,239,229,409,207,202,144,119,133,47,7,9,82,46,66,32,1,5,62,73,67,15,6,4,123,101,110,53,16,3,65,51,53,26,7,3,58,50,57,27,9,0,194,89,105,268,135,133,76,63,49,9,-4,-3,41,21,35,0,-6,-6,35,42,14,9,2,3,76,79,68,30,11,2,38,32,39,16,7,1,38,47,29,14,4,1,-17,-14,-3,19,-2,21,16,-5,-14,-8,-11,-1,0,1,-3,-7,-6,-5,16,-6,-11,-1,-5,4,11,18,-3,-7,1,-2,3,0,-1,-5,1,-1,8,18,-2,-2,0,-1,249,148,101,256,154,102,57,67,100,31,0,-2,20,42,65,27,0,-3,37,25,35,4,0,1,44,72,90,36,12,2,22,43,60,23,5,1,22,29,30,13,7,1,312,197,115,255,138,117,49,76,102,42,13,29,38,48,69,20,6,15,11,28,33,22,7,14,51,77,68,35,22,0,28,42,40,18,9,0,23,35,28,17,13,0,382,238,144,356,202,154,132,102,59,55,26,0,83,57,40,30,20,-1,49,45,19,25,6,1,97,117,66,51,17,4,62,64,32,31,10,1,35,53,34,20,7,3,-74,-30,-44,16,-8,24,4,10,-47,-13,-6,-23,-5,3,-7,0,-10,-14,9,7,-40,-13,4,-9,36,15,-18,-7,-3,-8,21,1,-14,-9,-3,-4,15,14,-4,2,0,-4,-307,-169,-138,-127,-75,-52,-57,-51,-122,-45,-10,-18,-35,-18,-74,-23,-5,-14,-22,-33,-48,-22,-5,-4,-22,-20,-58,-13,-15,1,-8,-5,-39,-13,-9,-1,-14,-15,-19,0,-6,2,-283,-159,-124,-127,-79,-48,-43,-51,-98,-50,-31,-9,-19,-24,-59,-33,-20,0,-24,-27,-39,-17,-11,-9,-16,-15,-55,-27,-12,-3,-9,-11,-28,-22,-8,-1,-7,-4,-27,-5,-4,-2,-82,-62,-20,-21,-21,0,-8,1,-32,-42,-6,0,-11,0,-12,-32,-9,-4,3,1,-20,-10,3,4,-7,4,-3,-11,-6,1,-3,-1,-7,-7,-5,1,-4,5,4,-4,-1,0,5,-18,23,-15,-25,10,1,1,-2,-3,-3,3,-5,-19,14,-13,-6,3,6,20,-16,10,3,0,-3,6,-13,-10,-2,2,-3,-5,-7,-15,-1,1,0,11,-6,5,-1,1,-96,-47,-49,-71,-39,-32,-5,-22,-47,-23,-2,5,-1,-11,-19,-17,1,1,-4,-11,-28,-6,-3,4,-19,-8,-29,-15,-7,6,-6,-7,-13,-11,-3,0,-13,-1,-16,-4,-4,6,-65,-35,-30,-6,-4,-2,-3,3,-47,-5,-15,3,-16,2,-10,-1,-12,3,13,1,-37,-4,-3,0,-3,13,-9,-3,-2,-2,-6,8,-3,0,-3,0,3,5,-6,-3,1,-2,70,48,22,46,27,19,32,4,3,31,-12,12,22,14,-8,17,-6,10,10,-10,11,14,-6,2,11,14,8,7,5,1,6,8,3,4,6,0,5,6,5,3,-1,1,98,49,49,61,36,25,31,35,-24,38,19,-8,18,19,-17,18,12,-5,13,16,-7,20,7,-3,12,21,-3,10,18,0,7,17,-8,7,10,0,5,4,5,3,8,0,63,26,37,63,39,24,28,28,30,2,-13,-19,9,13,24,-3,-10,-11,19,15,6,5,-3,-8,1,18,28,11,4,0,1,11,22,6,0,-2,0,7,6,5,4,2
3,03080,Jacarilla,1540,13,2,11,14,7,7,-5,6,10,2,3,-2,-3,3,7,0,0,-4,-2,3,3,2,3,2,2,3,4,4,1,0,1,1,2,3,0,0,1,2,2,1,1,0,24,10,14,22,12,10,4,3,5,14,-2,-1,0,3,2,7,-2,0,4,0,3,7,0,-1,4,3,6,7,1,1,1,3,4,3,1,0,3,0,2,4,0,1,17,8,9,25,16,9,4,-1,-1,4,12,-2,0,2,-2,2,8,-2,4,-3,1,2,4,0,5,5,7,6,2,0,4,4,4,2,2,0,1,1,3,4,0,0,62,25,37,30,10,20,8,3,12,18,14,6,3,1,4,10,4,3,5,2,8,8,10,3,2,4,4,8,10,2,0,1,1,3,4,1,2,3,3,5,6,1,58,27,31,42,23,19,14,2,15,12,11,2,7,-2,6,6,6,2,7,4,9,6,5,0,7,2,12,10,8,2,4,0,6,6,5,1,3,2,6,4,3,1,71,36,35,56,27,29,13,4,7,19,24,4,6,2,5,7,16,1,7,2,2,12,8,3,12,4,10,12,14,4,3,2,6,4,10,2,9,2,4,8,4,2,106,54,52,78,43,35,23,10,21,16,24,10,18,2,10,9,9,6,5,8,11,7,15,4,16,8,11,16,21,5,13,4,7,7,9,3,3,4,4,9,12,2,118,54,64,95,43,52,18,18,26,25,29,3,5,11,12,10,13,3,13,7,14,15,16,0,14,8,18,18,31,5,7,3,7,8,13,4,7,5,11,10,18,1,18,7,11,29,5,24,0,-2,-11,6,18,4,2,-3,-7,4,6,1,-2,1,-4,2,12,3,3,4,2,0,15,4,0,-1,0,-1,6,1,3,5,2,1,9,3,-24,-18,-6,0,-3,3,-10,1,-13,-7,1,4,-4,0,-8,-7,0,1,-6,1,-5,0,1,3,0,-1,-1,-2,3,1,0,-2,-3,-1,2,1,0,1,2,-1,1,0,-11,-10,-1,1,0,1,-13,-2,-9,2,12,3,-8,1,-6,-1,7,1,-5,-3,-3,3,5,2,-6,0,1,3,3,0,-4,-1,1,2,2,0,-2,1,0,1,1,0,-25,-2,-23,4,4,0,-1,1,-3,-9,-9,-3,4,1,4,-3,-5,-2,-5,0,-7,-6,-4,-1,2,0,-1,2,1,0,2,0,0,1,1,0,0,0,-1,1,0,0,7,6,1,10,4,6,5,3,-6,2,4,-1,5,1,-5,4,1,0,0,2,-1,-2,3,-1,0,0,0,1,5,4,0,0,-1,1,2,2,0,0,1,0,3,2,-8,0,-8,5,4,1,-2,-7,2,1,-1,-2,1,-2,1,-1,1,-1,-3,-5,1,2,-2,-1,1,1,-1,1,2,0,0,0,0,1,2,0,1,1,-1,0,0,0,-37,-15,-22,-50,-20,-30,-5,-14,0,-7,0,-11,-8,-6,1,-4,5,-3,3,-8,-1,-3,-5,-8,-4,-9,-4,-14,-11,-8,-2,-4,0,-8,-4,-2,-2,-5,-4,-6,-7,-6,-29,-8,-21,-44,-16,-28,3,8,-3,-3,-13,-21,-1,3,3,1,-3,-11,4,5,-6,-4,-10,-10,-2,0,-5,-1,-13,-23,-1,0,1,-2,-3,-11,-1,0,-6,1,-10,-12,10,11,-1,7,4,3,7,5,-6,8,2,-7,5,-1,-1,9,0,-2,2,6,-5,-1,2,-5,3,0,2,3,1,-2,2,-3,2,4,-1,0,1,3,0,-1,2,-2,28,9,19,17,1,16,1,-1,6,4,12,6,0,-1,3,-1,3,5,1,0,3,5,9,1,5,0,3,7,2,0,-2,0,4,1,-2,0,7,0,-1,6,4,0
3,03082,Jávea/Xàbia,21996,1560,863,697,1504,831,673,225,193,402,337,293,96,124,104,226,179,169,54,101,89,176,158,124,42,227,180,378,314,296,94,122,102,206,167,166,59,105,78,172,147,130,35,1706,951,755,1670,940,730,247,271,386,345,330,109,127,164,222,189,180,60,120,107,164,156,150,49,261,276,368,328,327,96,142,166,213,171,185,55,119,110,155,157,142,41,1799,999,800,1813,999,814,307,206,366,330,438,139,172,128,212,188,226,68,135,78,154,142,212,71,324,216,333,343,455,133,179,129,188,190,234,73,145,87,145,153,221,60,1733,909,824,1745,903,842,306,178,320,394,389,129,160,98,165,208,201,71,146,80,155,186,188,58,333,178,322,387,398,117,172,94,162,198,207,67,161,84,160,189,191,50,1544,838,706,1519,812,707,298,170,339,363,380,-12,161,96,211,180,193,-5,137,74,128,183,187,-7,314,175,292,338,403,-12,163,93,162,184,211,-5,151,82,130,154,192,-7,1229,640,589,1422,738,684,228,99,201,210,386,98,110,62,107,109,188,59,118,37,94,101,198,39,258,142,234,265,391,124,126,81,134,124,190,77,132,61,100,141,201,47,1335,671,664,1469,789,680,175,154,255,263,341,136,75,80,134,138,146,90,100,74,121,125,195,46,191,191,286,268,378,141,89,114,160,148,177,92,102,77,126,120,201,49,982,474,508,1176,579,597,207,139,168,145,251,60,106,61,82,60,120,34,101,78,86,85,131,26,253,166,198,208,252,87,135,78,95,94,123,47,118,88,103,114,129,40,503,195,308,706,318,388,66,88,-9,64,188,103,34,37,-27,9,96,47,32,51,18,55,92,56,118,102,103,121,187,70,60,41,34,45,94,41,58,61,69,76,93,29,476,254,222,456,237,219,119,2,52,70,134,88,76,-6,27,38,65,50,43,8,25,32,69,38,61,36,49,80,135,84,42,10,24,38,67,50,19,26,25,42,68,34,502,269,233,451,224,227,78,39,9,79,172,125,42,31,11,31,78,78,36,8,-2,48,94,47,45,35,20,68,173,103,23,19,-3,30,83,69,22,16,23,38,90,34,468,251,217,407,224,183,97,22,48,68,158,62,63,3,21,28,86,42,34,19,27,40,72,20,93,35,35,52,119,66,64,9,12,29,61,44,29,26,23,23,58,22,615,275,340,551,259,292,116,32,93,101,149,116,62,14,29,31,72,64,54,18,64,70,77,52,95,44,73,103,154,74,50,23,25,39,73,44,45,21,48,64,81,30,318,146,172,114,40,74,73,6,51,101,134,-46,18,1,14,52,70,-7,55,5,37,49,64,-39,13,-8,5,41,125,-67,-10,-2,-7,18,60,-20,23,-6,12,23,65,-47,-1301,-667,-634,-1369,-682,-687,-33,-149,-82,-109,-210,-726,-13,-76,-70,-62,-83,-372,-20,-73,-12,-47,-127,-354,-52,-152,-87,-164,-199,-723,-19,-81,-62,-77,-78,-372,-33,-71,-25,-87,-121,-351,-3532,-1829,-1703,-3558,-1875,-1683,-178,-360,-235,-449,-679,-1641,-107,-178,-115,-222,-360,-854,-71,-182,-120,-227,-319,-787,-170,-367,-241,-443,-683,-1658,-99,-183,-134,-230,-369,-863,-71,-184,-107,-213,-314,-795,26,34,-8,-1,22,-23,129,-27,55,29,51,-219,68,-24,36,21,41,-114,61,-3,19,8,10,-105,99,-14,44,35,38,-211,54,-10,37,14,30,-110,45,-4,7,21,8,-101,1008,535,473,1053,541,512,121,104,141,184,269,170,61,64,84,76,149,88,60,40,57,108,120,82,152,119,164,190,250,161,77,65,84,90,129,85,75,54,80,100,121,76
3,03083,Jijona/Xixona,7436,0,6,-6,21,8,13,-1,4,-11,-8,5,12,-6,10,-2,-2,4,3,5,-6,-9,-6,1,9,3,5,8,1,1,3,2,1,4,0,0,1,1,4,4,1,1,2,75,35,40,92,39,53,1,23,29,7,13,5,-6,10,24,2,7,1,7,13,5,5,6,4,17,14,30,17,9,4,5,5,14,6,6,2,12,9,16,11,3,2,65,33,32,54,29,25,31,6,11,8,14,-6,20,-5,5,7,9,-4,11,11,6,1,5,-2,19,4,12,8,8,3,11,1,5,6,4,2,8,3,7,2,4,1,66,40,26,74,37,37,27,5,-7,6,23,15,15,10,-5,1,16,6,12,-5,-2,5,7,9,17,13,9,12,20,3,8,7,5,3,11,3,9,6,4,9,9,0,102,64,38,96,54,42,25,27,7,24,24,-4,10,15,8,20,12,-1,15,12,-1,4,12,-3,19,16,16,17,25,3,11,8,11,10,13,1,8,8,5,7,12,2,111,59,52,100,58,42,39,20,19,25,8,0,16,15,6,13,3,5,23,5,13,12,5,-5,21,21,23,21,10,3,9,14,15,11,7,1,12,7,8,10,3,2,14,12,2,52,27,25,11,-8,-3,7,9,1,7,-6,1,3,7,0,4,-2,-4,4,2,1,10,8,10,8,14,2,6,1,8,3,8,1,4,7,2,5,6,1,42,29,13,57,33,24,10,10,9,1,7,6,5,4,13,-1,4,4,5,6,-4,2,3,2,4,16,14,9,10,4,4,8,8,5,5,3,0,8,6,4,5,1,-33,-10,-23,15,2,13,-18,-2,-6,0,-18,14,-17,5,8,2,-8,2,-1,-7,-14,-2,-10,12,4,0,4,5,2,0,1,-1,1,1,0,0,3,1,3,4,2,0,1,-2,3,13,4,9,-10,3,0,-12,13,5,-2,6,0,-10,4,-2,-8,-3,0,-2,9,7,0,0,1,4,7,1,0,1,-1,1,2,1,0,-1,2,3,5,0,-10,2,-12,9,7,2,0,-2,-2,-8,-3,5,1,2,5,-5,2,-2,-1,-4,-7,-3,-5,7,0,3,0,1,5,0,-1,2,2,1,3,0,1,1,-2,0,2,0,18,16,2,26,13,13,11,0,-11,3,12,2,8,1,-11,4,6,7,3,-1,0,-1,6,-5,7,3,6,0,8,2,5,1,3,-1,4,1,2,2,3,1,4,1,4,9,-5,11,5,6,5,-11,-7,6,3,8,5,-8,-7,4,3,11,0,-3,0,2,0,-3,0,-2,3,1,4,5,-1,-2,1,2,1,4,1,0,2,-1,3,1,-45,-1,-44,-30,-12,-18,-6,-10,-2,-20,5,-9,0,-3,7,-6,5,-2,-6,-7,-9,-14,0,-7,-9,-3,-6,-12,2,-2,-2,-3,-4,-4,1,0,-7,0,-2,-8,1,-2,33,24,9,5,1,4,11,7,-4,9,-3,12,11,6,3,2,-4,7,0,1,-7,7,1,5,1,1,1,2,-1,1,-1,-1,0,3,-1,1,2,2,1,-1,0,0,-58,-23,-35,-1,1,-2,-17,0,-17,-15,-2,-3,-9,4,-9,-7,-1,3,-8,-4,-8,-8,-1,-6,1,1,-3,-2,5,-3,1,1,-1,-1,3,-2,0,0,-2,-1,2,-1,-93,-51,-42,-1,1,-2,-28,-21,-4,-26,-7,-8,-14,-9,-6,-7,-5,-9,-14,-12,2,-19,-2,1,-1,1,-2,-1,3,0,0,0,-1,2,2,-1,-1,1,-1,-3,1,1,37,15,22,24,9,15,20,-1,-2,-1,20,1,11,-1,-5,2,10,-3,9,0,3,-3,10,4,4,4,1,6,5,4,3,2,-2,1,3,2,1,2,3,5,2,2
3,03089,Monóvar/Monòver,11909,25,21,4,37,24,13,-3,18,9,-1,5,-1,-3,7,12,2,1,3,0,11,-3,-3,4,-4,3,13,13,6,1,1,1,8,9,5,0,1,2,5,4,1,1,0,206,91,115,121,69,52,9,40,52,45,6,51,2,19,31,23,1,15,7,21,21,22,5,36,14,31,37,26,7,5,9,18,21,14,4,3,5,13,16,12,3,2,296,142,154,184,92,92,77,52,60,32,33,39,36,22,37,13,18,14,41,30,23,19,15,25,49,39,36,31,17,10,21,17,21,19,9,4,28,22,15,12,8,6,277,145,132,182,98,84,53,62,57,27,52,22,24,40,37,3,29,9,29,22,20,24,23,13,35,46,43,33,18,3,18,26,28,11,11,2,17,20,15,22,7,1,144,75,69,150,73,77,38,27,13,20,16,23,22,12,13,17,11,0,16,15,0,3,5,23,36,30,39,20,22,2,20,13,19,12,10,-1,16,17,20,8,12,3,151,97,54,148,78,70,21,32,24,30,12,28,11,22,23,21,10,8,10,10,1,9,2,20,33,36,35,24,18,1,17,20,16,13,10,1,16,16,19,11,8,0,155,50,105,197,97,100,36,17,-2,35,39,25,9,8,-3,10,19,4,27,9,1,25,20,21,34,43,33,49,32,5,15,22,14,28,15,3,19,21,19,21,17,2,139,66,73,131,65,66,47,21,16,20,12,22,27,17,10,6,1,4,20,4,6,14,11,18,32,26,22,26,20,5,15,16,12,9,11,2,17,10,10,17,9,3,6,15,-9,42,21,21,-6,4,6,-20,6,7,-8,6,11,-5,2,6,2,-2,-5,-15,4,1,5,14,13,7,3,0,-1,11,6,4,1,0,6,3,7,3,2,0,-60,-37,-23,23,15,8,3,-13,-53,-6,9,-5,6,-8,-35,-8,10,-6,-3,-5,-18,2,-1,1,9,2,-1,1,9,-1,5,-1,-1,0,9,0,4,3,0,1,0,-1,-54,-27,-27,-61,-30,-31,-20,5,-23,-15,-3,3,-8,10,-15,-11,2,-5,-12,-5,-8,-4,-5,8,-9,-3,-18,-17,-8,-6,1,-1,-13,-12,-1,-4,-10,-2,-5,-5,-7,-2,-4,2,-6,28,17,11,-19,-4,17,-3,5,0,-13,4,3,3,2,2,-6,-8,14,-6,3,-2,4,7,6,8,7,-4,1,4,7,4,3,-2,3,3,-1,4,4,-2,-37,-20,-17,-15,-10,-5,-16,2,-30,1,-6,13,-5,3,-11,-7,-3,4,-11,-1,-19,8,-3,9,-7,2,-11,-2,0,3,-2,-1,-5,-3,-1,2,-5,3,-6,1,1,1,-87,-53,-34,-103,-59,-44,8,-16,-46,-32,-7,3,14,-6,-35,-16,-2,-11,-6,-10,-11,-16,-5,14,-15,-14,-36,-32,-4,-2,-5,-6,-25,-21,-1,-1,-10,-8,-11,-11,-3,-1,-35,-18,-17,25,11,14,-10,-10,-9,-10,-1,3,-8,-5,-4,-1,-2,0,-2,-5,-5,-9,1,3,7,5,3,4,4,0,2,4,1,3,0,-1,5,1,2,1,4,1,-8,-6,-2,14,8,6,1,2,-36,-9,7,21,-2,5,-21,-4,5,8,3,-3,-15,-5,2,13,10,4,-9,4,4,0,4,3,-2,2,1,0,6,1,-7,2,3,0,-40,-22,-18,-14,-9,-5,-7,-17,-43,14,13,-1,-3,-5,-30,5,7,2,-4,-12,-13,9,6,-3,-1,-4,-13,1,9,-6,1,0,-10,-1,4,-3,-2,-4,-3,2,5,-3,57,20,37,35,10,25,17,4,-9,8,16,18,7,3,-1,0,12,-2,10,1,-8,8,4,20,10,7,0,7,11,1,7,4,-4,-2,7,-1,3,3,4,9,4,2
3,03092,Muro de Alcoy,7194,117,71,46,37,23,14,3,51,30,5,8,20,3,25,26,7,4,5,0,26,4,-2,4,15,8,4,17,4,2,1,6,3,10,3,0,1,2,1,7,1,2,0,138,67,71,49,28,21,29,35,45,0,15,10,14,19,24,1,5,3,15,16,21,-1,10,7,9,13,15,3,6,0,4,9,10,1,3,0,5,4,5,2,3,0,122,92,30,43,27,16,6,18,50,21,13,12,4,17,42,18,6,4,2,1,8,3,7,8,5,5,12,9,10,2,3,1,10,6,6,1,2,4,2,3,4,1,126,43,83,40,18,22,29,11,44,20,12,12,11,4,11,8,2,7,18,7,33,12,10,5,9,4,13,2,6,6,2,4,6,1,2,3,7,0,7,1,4,3,216,121,95,76,39,37,33,43,56,25,40,16,18,24,38,12,20,7,15,19,18,13,20,9,18,12,17,15,9,5,10,5,9,10,4,1,8,7,8,5,5,4,268,128,140,75,44,31,35,69,100,22,22,12,12,25,56,15,11,3,23,44,44,7,11,9,18,13,17,10,12,4,13,5,10,7,5,3,5,8,7,3,7,1,184,107,77,84,51,33,4,46,60,38,24,8,10,25,34,21,13,2,-6,21,26,17,11,6,14,15,19,23,11,2,9,6,11,15,8,2,5,9,8,8,3,0,102,45,57,71,31,40,-7,30,36,11,28,5,-8,12,15,4,18,4,1,18,21,7,10,1,3,26,18,11,10,3,-1,12,8,5,4,3,4,14,10,6,6,0,117,55,62,50,23,27,21,19,38,18,15,3,11,2,28,4,6,0,10,17,10,14,9,3,11,16,8,6,9,-2,8,5,2,3,4,0,3,11,6,3,5,-2,32,33,-1,-59,-32,-27,-5,19,10,8,5,-6,-1,18,12,3,6,-6,-4,1,-2,5,-1,0,-7,-5,-14,-11,-11,-11,-1,-3,-6,-8,-6,-8,-6,-2,-8,-3,-5,-3,21,11,10,3,-6,9,1,0,13,-1,1,7,-1,2,15,-11,2,4,2,-2,-2,10,-1,3,-2,-3,3,-2,6,1,-1,0,-2,-4,1,0,-1,-3,5,2,5,1,2,-7,9,-10,-4,-6,2,12,-3,-5,-15,13,-8,8,-1,-3,-5,2,10,4,-2,-2,-10,11,1,6,-3,-3,-9,-2,2,-1,-2,-2,-1,0,-1,7,-1,-1,-8,-2,38,22,16,-4,-3,-1,15,10,20,-7,-7,3,9,-3,19,-2,-4,1,6,13,1,-5,-3,2,1,0,4,-4,-6,1,2,-1,1,-2,-3,0,-1,1,3,-2,-3,1,21,15,6,2,-1,3,-9,14,-15,15,8,5,-1,9,-7,10,3,-1,-8,5,-8,5,5,6,0,8,-10,5,1,-2,5,4,-11,4,-2,-1,-5,4,1,1,3,-1,36,-1,37,24,4,20,40,-1,-4,-3,7,-4,20,-2,-11,1,-3,-7,20,1,7,-4,10,3,6,10,3,-1,8,-3,0,4,-1,1,3,-3,6,6,4,-2,5,0,101,54,47,43,27,16,39,25,29,-6,10,4,19,7,21,-2,4,6,20,18,8,-4,6,-2,7,13,15,2,6,-2,3,7,13,2,2,-1,4,6,2,0,4,-1,0,4,-4,22,10,12,-17,17,-4,-6,7,3,-11,12,-4,8,5,-5,-6,5,0,-14,2,8,5,19,9,-2,-5,-4,3,11,3,1,-5,-3,2,8,6,-3,0,-1,9,10,-1,74,47,27,-13,-2,4,14,-6,6,-13,-6,31,4,-9,-1,0,4,-27,10,3,7,13,6,20,19,9,3,2,0,22,16,5,-1,11,6,-2,3,4,4
3,03090,Mutxamel,14087,559,306,253,149,83,66,105,35,189,132,69,29,68,9,99,80,42,5,37,26,90,52,27,24,23,7,33,32,41,12,12,6,17,17,24,7,11,1,16,15,17,5,730,370,360,282,148,134,116,106,230,132,52,86,64,56,107,79,28,31,52,50,123,53,24,55,58,43,92,41,26,16,30,21,47,24,14,9,28,22,45,17,12,7,543,221,322,223,102,121,121,70,114,98,69,63,47,24,53,43,28,22,74,46,61,55,41,41,62,23,46,43,37,12,32,10,16,23,17,4,30,13,30,20,20,8,662,350,312,204,107,97,135,74,171,120,114,43,72,41,93,60,59,20,63,33,78,60,55,23,32,20,45,36,51,20,19,11,28,15,23,11,13,9,17,21,28,9,722,406,316,303,157,146,155,76,172,156,123,25,102,41,97,84,60,17,53,35,75,72,63,8,61,23,50,63,84,22,32,13,27,32,39,14,29,10,23,31,45,8,745,383,362,274,153,121,93,94,200,171,130,51,47,47,102,92,67,28,46,47,98,79,63,23,40,24,57,52,74,24,21,17,31,29,35,17,19,7,26,23,39,7,1098,526,572,312,163,149,236,69,384,198,115,81,109,19,199,94,64,36,127,50,185,104,51,45,53,23,56,75,82,19,30,6,28,38,45,13,23,17,28,37,37,6,958,471,487,149,68,81,176,106,319,185,98,61,89,53,163,77,43,36,87,53,156,108,55,25,12,32,36,17,43,8,7,20,9,4,21,7,5,12,27,13,22,1,858,464,394,175,86,89,217,80,183,217,111,38,103,49,87,135,69,17,114,31,96,82,42,21,32,30,19,33,48,9,17,11,7,19,24,5,15,19,12,14,24,4,477,262,215,145,76,69,120,13,127,93,54,67,78,6,81,48,25,21,42,7,46,45,29,46,37,15,24,25,32,12,23,5,7,13,20,8,14,10,17,12,12,4,403,207,196,87,51,36,126,33,100,84,48,7,71,9,34,57,22,11,55,24,66,27,26,-4,12,15,15,7,29,6,9,10,2,4,18,6,3,5,13,3,11,0,146,38,108,144,67,77,57,31,-15,44,17,16,15,11,-12,20,7,0,42,20,-3,24,10,16,49,16,17,22,26,10,21,7,4,10,13,10,28,9,13,12,13,0,288,144,144,100,35,65,59,30,65,58,35,36,38,15,18,34,23,12,21,15,47,24,12,24,39,6,3,22,17,12,17,1,-3,10,7,3,22,5,6,12,10,9,230,142,88,32,15,17,51,-6,63,74,24,21,33,-8,21,67,13,13,18,2,42,7,11,8,8,-2,7,-5,18,5,11,-7,-1,4,5,2,-3,5,8,-9,13,3,105,37,68,15,11,4,36,12,33,-24,47,6,11,11,15,-26,29,-3,25,1,18,2,18,9,26,16,-5,-7,7,-26,19,5,-7,-6,4,-8,7,11,2,-1,3,-18,140,108,32,69,30,39,11,-2,39,41,5,28,20,0,37,34,3,6,-9,-2,2,7,2,22,9,2,16,16,21,1,9,-1,6,3,13,0,0,3,10,13,8,1,262,137,125,40,2,38,87,2,61,67,21,27,58,4,39,26,5,7,29,-2,22,41,16,20,14,3,-1,11,21,-10,6,-3,2,-4,7,-8,8,6,-3,15,14,-2,18,-7,25,-135,-97,-38,68,-10,14,39,-54,-49,38,-2,18,4,-38,-32,30,-8,-4,35,-16,-17,39,-12,1,-35,-62,-71,13,1,7,-31,-42,-47,26,-13,-6,-4,-20,-24
3,03093,Novelda,23665,337,235,102,338,222,116,25,108,140,49,4,8,10,61,117,39,2,3,15,47,23,10,2,5,29,89,146,58,7,7,12,54,103,44,4,3,17,35,43,14,3,4,325,219,106,368,234,134,41,104,151,29,0,-5,29,69,111,14,-2,-6,12,35,40,15,2,1,47,109,143,57,7,1,26,68,101,32,4,0,21,41,42,25,3,1,396,214,182,407,235,172,113,109,110,55,-3,1,63,51,73,33,-6,-4,50,58,37,22,3,5,87,104,129,60,17,5,49,57,82,38,5,2,38,47,47,22,12,3,254,117,137,277,147,130,87,66,47,36,18,-3,37,38,23,16,3,1,50,28,24,20,15,-4,76,76,64,39,16,2,37,49,35,19,4,3,39,27,29,20,12,-1,443,248,195,273,157,116,90,79,126,48,31,61,48,39,76,32,24,25,42,40,50,16,7,36,30,67,90,47,28,7,14,35,56,32,14,3,16,32,34,15,14,4,185,91,94,239,145,94,62,66,35,14,15,-14,26,37,12,14,8,-7,36,29,23,0,7,-7,35,66,82,36,15,3,19,39,52,24,9,1,16,27,30,12,6,2,220,129,91,308,174,134,35,61,20,67,5,28,27,28,15,42,0,14,8,33,5,25,5,14,72,77,90,47,15,5,37,46,54,28,5,2,35,31,36,19,10,3,170,108,62,311,184,127,38,76,53,10,-1,-2,10,62,45,5,-5,0,28,14,8,5,4,-2,49,126,95,43,2,-6,23,84,61,20,-1,-3,26,42,34,23,3,-3,-143,-107,-36,-54,-57,3,-1,21,-106,-34,-20,-2,-11,23,-79,-28,-11,-1,10,-2,-27,-6,-9,-1,-10,42,-42,-38,-7,0,-5,17,-32,-32,-6,1,-5,25,-10,-6,-1,-1,-130,-70,-60,18,13,5,-3,-10,-65,-43,-17,6,10,-11,-38,-29,-11,5,-13,1,-27,-14,-6,1,1,25,-9,6,-4,-1,4,10,-6,5,0,0,-3,15,-3,1,-4,-1,-247,-159,-88,-133,-88,-45,-20,-25,-76,-79,-46,-3,-16,-7,-53,-52,-29,-5,-4,-18,-23,-27,-17,2,-16,1,-55,-41,-23,-1,-10,5,-41,-28,-12,-4,-6,-4,-14,-13,-11,3,-183,-96,-87,-56,-35,-21,-4,-27,-91,-52,-10,1,2,-12,-42,-26,-6,-9,-6,-15,-49,-26,-4,10,-12,2,-22,-24,0,1,-4,2,-14,-16,-2,0,-8,0,-8,-8,2,1,-135,-90,-45,-38,-34,-4,-17,-29,-72,-17,-3,1,-5,-19,-43,-15,-10,-1,-12,-10,-29,-2,7,2,-8,6,-26,-13,2,1,-5,-2,-17,-11,0,1,-3,8,-9,-2,2,0,-139,-86,-53,-83,-59,-24,-34,0,-33,-52,-23,-6,-14,-5,-22,-32,-17,-3,-20,5,-11,-20,-6,-3,-6,13,-46,-35,-14,2,-6,7,-30,-22,-11,0,0,6,-16,-13,-3,2,-123,-94,-29,-55,-52,-3,-7,0,-85,-30,-1,-1,-7,-5,-53,-23,-1,-7,0,5,-32,-7,0,6,-6,11,-36,-16,-3,-7,-3,4,-29,-22,2,-5,-3,7,-7,6,-5,-2,15,29,-14,111,62,49,-15,-22,30,13,-11,16,-10,-6,17,17,-5,12,-5,-16,13,-4,-6,4,13,22,31,28,8,6,2,12,17,20,4,5,11,10,14,8,4,1,-109,-76,-33,-43,-41,-2,-17,-21,-29,-29,-5,-15,1,-14,-21,-25,-9,-11,-18,-7,-8,-4,4,-4,15,-1,-16,-27,-5,-11,12,-2,-13,-25,-6,-7,3,1,-3,-2,1,-4,-81,-18,-63,59,34,25,-21,-6,-41,-19,-11,15,-4,8,-7,-16,-9,9,-17,-14,-34,-3,-2,6,21,14,13,4,-2,6,6,10,13,0,-1,4,15,4,0,4,-1,2
3,03094,"Nucia, la",7839,750,386,364,476,250,226,90,119,176,141,172,44,45,55,103,65,100,19,45,64,73,76,72,25,55,55,100,88,129,44,32,27,53,46,69,22,23,28,47,42,60,22,722,369,353,531,286,245,124,74,215,133,137,29,69,31,114,62,75,11,55,43,101,71,62,18,92,40,122,98,136,39,51,23,68,48,71,22,41,17,54,50,65,17,1338,669,669,609,321,288,209,177,309,269,266,99,106,66,154,137,148,55,103,111,155,132,118,44,82,71,102,92,198,61,42,28,56,48,109,37,40,43,46,44,89,24,1314,653,661,562,271,291,194,183,369,254,223,85,96,67,194,129,117,46,98,116,175,125,106,39,82,60,71,135,165,47,35,23,31,66,84,31,47,37,40,69,81,16,1393,739,654,608,333,275,221,201,348,288,200,122,130,95,197,151,108,52,91,106,151,137,92,70,114,46,98,137,157,50,67,21,56,73,88,23,47,25,42,64,69,27,1490,756,734,609,298,311,225,217,373,302,246,114,109,96,189,172,128,58,116,121,184,130,118,56,63,66,109,123,188,56,33,24,46,62,101,31,30,42,63,61,87,25,1510,751,759,543,266,277,259,246,380,327,208,88,134,116,190,166,97,45,125,130,190,161,111,43,93,63,89,117,135,44,53,29,45,51,69,18,40,34,44,66,66,26,1278,636,642,344,159,185,250,194,326,268,159,65,140,76,149,145,88,29,110,118,177,123,71,36,51,55,36,85,82,31,31,12,10,48,45,11,20,43,26,37,37,20,885,471,414,358,187,171,195,123,201,213,102,52,117,59,101,108,55,31,78,64,100,105,47,21,90,42,33,85,73,34,55,18,16,41,36,20,35,24,17,44,37,14,344,184,160,208,115,93,47,18,58,84,87,47,41,16,29,24,53,19,6,2,29,60,34,28,44,13,33,57,55,4,29,10,18,25,30,3,15,3,15,32,25,1,303,135,168,84,33,51,33,58,97,21,65,15,19,10,43,16,35,1,14,48,54,5,30,14,4,18,-1,11,42,3,6,8,-7,6,16,0,-2,10,6,5,26,3,461,216,245,132,73,59,116,45,46,122,77,50,47,23,24,58,43,15,69,22,22,64,34,35,33,14,-5,28,47,12,19,9,0,14,25,5,14,5,-5,14,22,7,295,153,142,104,57,47,17,38,10,84,67,79,12,21,17,34,37,30,5,17,-7,50,30,49,30,18,-27,47,31,4,15,14,-21,26,20,2,15,4,-6,21,11,2,617,312,305,295,141,154,74,83,142,124,110,82,36,33,86,68,46,41,38,50,56,56,64,41,57,28,33,62,65,47,30,10,15,31,26,28,27,18,18,31,39,19,277,140,137,283,150,133,87,13,65,19,53,35,56,13,11,11,25,21,31,0,54,8,28,14,53,27,33,52,73,44,30,17,18,22,38,25,23,10,15,30,35,19,247,133,114,266,132,134,14,20,84,52,18,50,13,4,48,29,16,19,1,16,36,23,2,31,42,35,30,51,70,32,27,19,11,22,34,17,15,16,19,29,36,15,12,20,-8,-217,-108,-109,83,-5,6,58,4,-147,71,-10,-12,36,-4,-70,12,5,18,22,8,-77,-5,-14,-25,-6,-11,-156,4,-14,-9,2,-12,-78,-9,0,-16,-8,1,-78,-1285,-679,-606,-1330,-681,-649,-105,-124,-104,-230,-258,-471,-72,-78,-49,-102,-137,-244,-33,-46,-55,-128,-121,-227,-85,-122,-127,-241,-268,-493,-52,-72,-44,-120,-141,-253,-33,-50,-83,-121,-127,-240
3,03096,Onil,6777,13,19,-6,16,12,4,1,12,3,-3,4,-2,4,9,11,-4,2,-1,-3,3,-8,1,2,-1,2,5,6,2,1,0,2,2,5,2,1,0,0,3,1,0,0,0,70,38,32,47,23,24,-1,18,14,14,1,20,2,9,9,6,2,9,-3,9,5,8,-1,11,8,12,13,11,3,0,4,4,9,5,1,0,4,8,4,6,2,0,132,65,67,129,74,55,36,17,25,17,22,13,22,13,12,5,8,3,14,4,13,12,14,10,28,27,32,21,17,3,20,18,18,9,6,2,8,9,14,12,11,1,179,98,81,142,80,62,34,27,61,26,21,7,15,17,34,13,16,3,19,10,27,13,5,4,32,32,37,20,17,2,15,19,24,11,11,0,17,13,13,9,6,2,149,80,69,108,65,43,23,31,28,30,22,16,12,17,21,17,10,2,11,14,7,13,12,14,16,31,27,21,12,0,11,20,17,11,6,0,5,11,10,10,6,0,99,41,58,89,53,36,28,10,11,22,10,15,7,7,5,4,6,10,21,3,6,18,4,5,15,28,19,11,12,3,7,17,15,4,7,2,8,11,4,7,5,1,115,77,38,97,50,47,19,31,31,15,10,9,7,19,30,11,4,5,12,12,1,4,6,4,15,34,33,10,6,-2,6,15,19,8,3,-1,9,19,14,2,3,-1,70,40,30,140,78,62,21,21,-4,18,-1,9,7,18,-5,14,0,2,14,3,1,4,-1,7,35,35,31,29,7,1,20,23,15,16,3,1,15,12,16,13,4,0,43,27,16,47,29,18,12,4,9,13,3,-1,12,2,4,9,1,-3,0,2,5,4,2,2,9,12,17,5,2,1,8,6,10,3,1,0,1,6,7,2,1,1,-26,-12,-14,-4,-1,-3,-26,-10,6,-9,4,11,-7,-7,4,-8,3,3,-19,-3,2,-1,1,8,-4,2,0,-3,-1,2,0,1,-2,-1,0,1,-4,1,2,-2,-1,1,-36,-18,-18,0,1,-1,-3,-1,-21,0,-12,-3,-3,0,-3,-6,-6,-1,0,-1,-18,6,-6,-2,-3,1,1,3,-2,0,0,1,2,0,-2,0,-3,0,-1,3,0,0,-55,-41,-14,4,2,2,-4,-20,-7,-25,-4,7,-3,-9,-8,-16,-1,-2,-1,-11,1,-9,-3,9,6,0,-1,1,0,-2,6,-2,-1,-1,2,-2,0,2,0,2,-2,0,9,-1,10,-8,-10,2,8,2,0,-5,-5,11,6,-3,-7,-1,0,4,2,5,7,-4,-5,7,-2,2,1,-5,-3,-1,-2,-1,1,-5,-2,-1,0,3,0,0,-1,0,-26,-21,-5,9,3,6,-9,-6,2,-16,-2,6,-10,-1,4,-14,-3,4,1,-5,-2,-2,1,2,2,5,-1,-6,4,4,1,1,-1,-3,2,3,1,4,0,-3,2,1,30,23,7,36,23,13,7,12,-8,12,0,6,4,10,-2,10,0,2,3,2,-6,2,0,4,11,7,1,9,6,1,6,6,1,4,4,1,5,1,0,5,2,0,-102,-67,-35,-68,-43,-25,-3,-11,-34,-43,-13,2,-2,-9,-16,-35,-7,3,-1,-2,-18,-8,-6,-1,-1,-3,-26,-23,-10,-5,-1,-3,-13,-18,-6,-2,0,0,-13,-5,-4,-3,28,14,14,32,21,11,5,13,4,0,-4,8,5,11,-1,2,-3,0,0,2,5,-2,-1,8,1,9,15,2,1,3,2,7,8,3,0,1,-1,2,7,-1,1,2,-8,-7,-1,-8,-8,0,3,-10,-12,4,0,5,-2,-10,-6,5,0,4,5,0,-6,-1,0,1,2,2,-8,2,-4,-1,-2,0,-5,4,-5,0,4,2,-3,-2,1,-1
3,03097,Orba,1586,64,33,31,66,34,32,2,1,12,11,45,-7,1,1,5,6,24,-4,1,0,7,5,21,-3,0,2,9,9,40,6,0,1,7,4,20,2,0,1,2,5,20,4,46,26,20,60,31,29,7,0,7,8,21,3,3,1,2,4,16,0,4,-1,5,4,5,3,6,1,9,11,24,9,2,1,2,5,16,5,4,0,7,6,8,4,78,42,36,102,58,44,5,2,11,18,31,10,1,3,3,10,17,7,4,-1,8,8,14,3,9,6,15,19,31,21,3,4,9,10,18,13,6,2,6,9,13,8,231,112,119,190,99,91,40,16,38,20,99,13,20,5,16,10,47,12,20,11,22,10,52,1,28,11,31,15,87,15,16,6,14,6,43,12,12,5,17,9,44,3,158,78,80,167,80,87,28,-5,4,33,79,20,14,-1,-2,16,37,14,14,-4,6,17,42,6,29,3,13,30,67,25,13,2,6,13,31,15,16,1,7,17,36,10,157,91,66,161,86,75,11,15,8,27,73,21,8,7,8,13,40,14,3,8,0,14,33,7,14,8,7,36,75,19,5,5,5,17,41,12,9,3,2,19,34,7,159,91,68,151,86,65,1,8,18,27,59,45,3,3,13,17,28,26,-2,5,5,10,31,19,10,1,17,24,64,34,6,-1,12,14,32,22,4,2,5,10,32,12,71,27,44,120,59,61,4,-2,20,4,40,6,-2,-2,6,-4,25,5,6,0,14,8,15,1,17,7,21,20,45,10,6,4,7,8,25,9,11,3,14,12,20,1,63,30,33,81,36,45,9,5,-2,19,29,2,7,3,-3,6,11,5,2,2,1,13,18,-3,10,9,8,21,25,7,2,5,3,10,10,5,8,4,5,11,15,2,27,22,5,47,23,24,-5,-4,-4,5,21,14,-2,-4,5,5,11,7,-3,0,-9,0,10,7,2,2,2,9,21,11,1,0,3,4,10,5,1,2,-1,5,11,6,20,11,9,38,17,21,-2,1,-9,15,19,-4,0,1,-5,6,10,-1,-2,0,-4,9,9,-3,3,0,1,9,23,2,3,0,-1,3,11,1,0,0,2,6,12,1,24,12,12,11,7,4,15,-5,-6,7,23,-10,12,-2,-7,0,17,-7,3,-3,1,7,6,-3,-2,-6,-1,2,17,1,0,-2,-1,0,12,-2,-2,-4,0,2,5,3,-34,-10,-24,-4,1,-5,-17,-3,-9,14,-1,-18,-4,-4,-7,10,3,-8,-13,1,-2,4,-4,-10,-4,-2,-5,10,5,-8,-3,-1,-2,5,4,-2,-1,-1,-3,5,1,-6,79,39,40,53,29,24,21,0,11,17,16,14,8,1,4,9,9,8,13,-1,7,8,7,6,4,1,-1,10,19,20,1,1,0,6,10,11,3,0,-1,4,9,9,76,43,33,82,39,43,1,-1,3,22,36,15,2,0,6,10,16,9,-1,-1,-3,12,20,6,1,4,2,13,41,21,1,1,1,7,18,11,0,3,1,6,23,10,53,30,23,23,9,14,19,7,6,6,15,-1,8,3,3,3,9,4,11,4,3,3,6,-5,3,4,-3,2,12,4,2,2,-3,0,3,5,1,2,0,2,9,-1,-39,-42,3,-59,-44,-15,8,-8,-4,-10,6,-31,-2,-4,-4,-13,3,-22,10,-4,0,3,3,-9,-7,-12,-5,-13,8,-30,-6,-6,-4,-10,1,-19,-1,-6,-1,-3,7,-11,-32,-11,-21,-18,-8,-10,6,-1,-2,0,-2,-30,7,-2,-1,-2,4,-15,-1,1,-1,2,-6,-15,8,-5,-1,3,3,-26,7,-3,-3,-1,5,-13,1,-2,2,4,-2,-13
3,03099,Orihuela,51649,2613,1364,1249,2613,1409,1204,301,178,310,479,1052,281,156,95,154,262,533,159,145,83,156,217,519,122,245,188,376,424,1074,300,110,108,229,219,553,186,135,80,147,205,521,114,5208,3101,2107,5058,3029,2029,614,730,1178,908,1393,373,335,486,803,534,698,239,279,244,375,374,695,134,572,679,1102,868,1414,410,315,470,769,511,700,256,257,209,333,357,714,154,5866,3102,2764,5803,3071,2732,788,521,780,1061,2134,567,403,275,395,558,1101,361,385,246,385,503,1033,206,769,452,771,999,2189,608,389,249,403,513,1131,379,380,203,368,486,1058,229,3058,1611,1447,3686,1938,1748,508,269,457,548,1035,232,272,132,256,272,538,132,236,137,201,276,497,100,582,323,589,669,1199,303,305,178,321,333,607,181,277,145,268,336,592,122,4206,2160,2046,4807,2471,2336,594,280,563,756,1529,463,296,156,287,358,769,283,298,124,276,398,760,180,620,392,667,859,1727,520,306,204,365,411,859,315,314,188,302,448,868,205,3480,1756,1724,4104,2106,1998,446,310,442,685,1201,374,201,178,231,314,586,233,245,132,211,371,615,141,534,339,599,773,1415,415,273,182,313,374,688,261,261,157,286,399,727,154,3836,1947,1889,4188,2169,2019,469,383,600,654,1367,353,208,224,295,337,704,188,261,159,305,317,663,165,552,419,653,770,1426,346,266,225,356,396,720,198,286,194,297,374,706,148,3972,1995,1977,4335,2254,2081,554,431,518,738,1280,433,293,185,262,364,646,241,261,246,256,374,634,192,592,514,629,781,1355,439,319,244,345,396,686,248,273,270,284,385,669,191,1366,649,717,1737,841,896,214,61,208,230,502,160,131,46,62,91,237,90,83,15,146,139,265,70,256,179,255,331,527,176,132,94,114,126,259,108,124,85,141,205,268,68,1225,634,591,1538,745,793,202,41,101,265,526,86,112,15,17,147,255,87,90,26,84,118,271,-1,221,137,171,313,532,151,114,50,61,152,257,101,107,87,110,161,275,50,1463,809,654,1246,668,578,230,148,191,369,412,98,157,48,111,185,245,52,73,100,80,184,167,46,154,161,163,269,409,75,87,63,96,130,238,47,67,98,67,139,171,28,1579,715,864,1502,709,793,263,181,178,381,440,114,102,73,55,183,225,59,161,108,123,198,215,55,208,195,204,331,418,131,92,82,87,145,210,84,116,113,117,186,208,47,1261,577,684,989,461,528,242,108,259,229,366,32,91,45,87,118,183,42,151,63,172,111,183,-10,143,103,132,191,373,33,66,37,44,93,184,29,77,66,88,98,189,4,477,270,207,520,248,272,134,31,-22,179,251,-122,78,9,-5,92,127,-43,56,22,-17,87,124,-79,162,16,67,138,222,-102,86,4,20,62,107,-41,76,12,47,76,115,-61,456,225,231,823,410,413,124,-40,60,110,200,-4,75,-28,19,57,86,10,49,-12,41,53,114,-14,172,32,124,182,260,43,93,1,47,106,123,38,79,31,77,76,137,5,-7243,-3785,-3458,-6973,-3668,-3305,-358,-724,-457,-1039,-1558,-3151,-210,-341,-202,-556,-780,-1712,-148,-383,-255,-483,-778,-1439,-314,-650,-434,-989,-1496,-3107,-176,-309,-227,-521,-754,-1688,-138,-341,-207,-468,-742,-1419,-2870,-1496,-1374,-2692,-1378,-1314,-130,-155,-300,-353,-394,-1569,-87,-59,-147,-244,-223,-751,-43,-96,-153,-109,-171,-818,-68,-130,-157,-408,-414,-1528,-32,-57,-80,-253,-233,-731,-36,-73,-77,-155,-181,-797,-2581,-1314,-1267,-2628,-1422,-1206,115,-209,-136,-424,-308,-1655,91,-128,-55,-213,-154,-875,24,-81,-81,-211,-154,-780,65,-183,-169,-433,-288,-1640,39,-110,-108,-240,-159,-854,26,-73,-61,-193,-129,-786
3,03101,Pedreguer,5941,161,90,71,119,65,54,22,19,31,39,35,15,5,12,24,25,16,8,17,7,7,14,19,7,8,12,37,25,31,5,1,7,22,17,16,2,7,5,15,8,15,3,112,57,55,106,65,41,12,21,30,27,15,4,3,11,21,15,7,0,9,10,9,12,8,4,13,13,32,25,20,2,9,5,22,16,11,2,4,8,10,9,9,0,221,124,97,201,104,97,39,14,56,36,57,17,25,8,33,19,27,11,14,6,23,17,30,6,37,9,47,36,50,21,24,6,22,17,23,11,13,3,25,19,27,10,255,138,117,204,121,83,31,27,61,52,67,16,6,11,50,27,39,4,25,16,11,25,28,12,17,26,38,46,58,18,11,13,31,24,32,9,6,13,7,22,26,9,254,120,134,218,109,109,27,33,46,34,80,28,19,14,26,14,35,11,8,19,20,20,45,17,30,26,30,36,77,17,15,12,16,19,37,10,15,14,14,17,40,7,200,104,96,209,108,101,20,28,18,38,76,20,11,15,14,15,39,10,9,13,4,23,37,10,33,14,30,37,78,17,20,5,18,14,41,10,13,9,12,23,37,7,218,121,97,164,82,82,36,12,52,41,69,5,23,12,27,19,37,2,13,0,25,22,32,3,22,14,22,31,62,12,11,8,10,13,33,7,11,6,12,18,29,5,285,145,140,111,43,68,59,45,58,47,51,19,29,22,38,28,20,5,30,23,20,19,31,14,26,26,1,9,39,9,12,11,-3,1,19,3,14,15,4,8,20,6,144,79,65,138,67,71,20,17,37,19,44,9,12,7,24,3,25,8,8,10,13,16,19,1,27,16,19,20,50,6,13,6,8,9,26,5,14,10,11,11,24,1,51,4,47,-41,-32,-9,8,12,15,19,2,-12,3,-6,8,5,-5,-6,5,18,7,14,7,-6,-1,-4,6,-8,-12,-23,2,-8,1,-5,-10,-12,-3,4,5,-3,-2,-11,59,11,48,24,7,17,30,3,19,10,13,-12,7,2,4,0,8,-7,23,1,15,10,5,-5,-1,1,-2,9,14,4,-4,0,-2,3,7,4,3,1,0,6,7,0,94,43,51,61,32,29,10,-4,-12,47,38,8,7,4,-7,14,16,4,3,-8,-5,33,22,4,5,0,2,16,35,2,3,2,1,6,18,2,2,-2,1,10,17,0,-58,-10,-48,-87,-39,-48,-15,-8,-15,-25,17,-17,2,-3,-8,-12,11,-4,-17,-5,-7,-13,6,-13,-11,-9,-14,-26,-3,-24,-1,-7,-8,-13,-1,-9,-10,-2,-6,-13,-2,-15,-88,-35,-53,-91,-34,-57,-22,-4,3,-31,1,-38,-10,6,-3,-18,1,-12,-12,-10,6,-13,0,-26,-18,-8,-4,-24,-8,-30,-3,-2,-3,-15,-2,-10,-15,-6,-1,-9,-6,-20,-235,-136,-99,-231,-126,-105,-12,-25,-35,-29,-44,-92,-4,-16,-20,-24,-11,-61,-8,-9,-15,-5,-33,-31,-17,-17,-27,-34,-49,-88,-8,-9,-16,-17,-23,-54,-9,-8,-11,-17,-26,-34,107,57,50,-2,0,-2,27,5,51,26,6,-9,17,4,25,9,5,-5,10,1,26,17,1,-4,-1,2,9,-2,8,-18,-2,0,8,-5,5,-6,1,2,1,3,3,-12,23,11,12,-70,-35,-35,0,4,28,22,9,-38,1,3,18,9,3,-23,-1,1,10,13,6,-15,-9,-4,2,-15,4,-50,-3,-2,4,-10,2,-28,-6,-2,-2,-5,2,-22,25,7,18,1,0,1,4,6,16,37,9,-52,0,2,2,32,-2,-30,4,4,14,5,11,-22,2,4,9,16,9,-40,2,0,3,14,3,-22,0,4,6,2,6,-18
3,03102,Pego,10186,78,39,39,89,53,36,19,15,12,26,6,-1,6,7,5,15,6,-2,13,8,7,11,0,1,9,18,18,24,13,6,5,10,11,13,9,4,4,8,7,11,4,2,176,102,74,158,92,66,19,27,28,32,54,16,6,18,19,17,32,10,13,9,9,15,22,6,24,22,29,31,43,9,13,14,17,17,24,7,11,8,12,14,19,2,189,114,75,204,111,93,30,5,9,51,77,13,16,4,11,28,41,12,14,1,-2,23,36,1,25,18,33,46,70,12,13,9,17,27,36,9,12,9,16,19,34,3,221,122,99,195,110,85,21,40,49,33,55,20,14,17,39,22,22,7,7,23,10,11,33,13,24,25,45,36,52,11,10,13,32,26,24,4,14,12,13,10,28,7,209,100,109,249,131,118,28,20,1,45,85,26,15,11,-4,27,38,13,13,9,5,18,47,13,27,27,49,48,77,16,17,17,27,26,36,7,10,10,22,22,41,9,97,60,37,122,66,56,14,7,13,20,34,5,9,6,16,7,12,9,5,1,-3,13,22,-4,17,23,21,29,28,2,12,12,8,19,11,3,5,11,13,10,17,-1,236,115,121,184,89,95,54,29,59,33,48,5,27,13,23,17,27,3,27,16,36,16,21,2,34,28,38,21,53,8,15,17,12,10,27,6,19,11,26,11,26,2,197,97,100,177,75,102,32,32,41,29,53,11,13,7,20,19,34,5,19,25,21,10,19,6,34,22,24,34,57,6,12,5,8,16,31,3,22,17,16,18,26,3,117,64,53,103,55,48,39,-4,30,34,18,2,27,-1,18,13,8,-1,12,-3,12,21,10,3,21,9,14,26,27,5,13,6,5,15,14,1,8,3,9,11,13,4,43,34,9,59,29,30,3,6,5,0,30,1,-5,4,15,7,11,4,8,2,-10,-7,19,-3,6,5,8,9,25,6,4,5,0,6,10,4,2,0,8,3,15,2,-46,-24,-22,36,15,21,-11,-19,-6,-16,22,-17,-9,-6,-2,-8,10,-10,-2,-13,-4,-8,12,-7,4,6,8,12,13,-7,2,3,5,6,5,-6,2,3,3,6,8,-1,-24,-29,5,28,13,15,-11,11,10,-11,-1,-24,-9,3,-2,-17,-2,-3,-2,8,12,6,1,-21,3,8,7,3,8,-3,2,3,3,2,2,0,1,5,4,1,6,-3,-53,-29,-24,22,8,14,-20,-3,-21,-14,14,-6,-17,-5,-5,-9,8,-1,-3,2,-16,-5,6,-5,6,4,-1,2,11,-1,2,1,-2,1,6,0,4,3,1,1,5,-1,-34,-2,-32,6,4,2,6,-12,-9,-12,0,-7,8,-5,-6,-3,4,-2,-2,-7,-3,-9,-4,-5,5,-5,1,2,3,0,2,-3,1,1,4,-1,3,-2,0,1,-1,1,140,61,79,62,30,32,21,7,28,15,37,25,16,-1,17,-3,18,11,5,8,11,18,19,14,2,7,6,14,22,10,2,3,1,5,12,6,0,4,5,9,10,4,-120,-65,-55,-75,-44,-31,-10,-15,-24,-21,-8,-39,1,-6,-13,-18,-8,-19,-11,-9,-11,-3,0,-20,-4,0,-11,-23,-9,-28,2,0,-4,-21,-7,-14,-6,0,-7,-2,-2,-14,-106,-57,-49,-111,-72,-39,10,-8,-18,-20,11,-82,2,-3,-15,-9,12,-44,8,-5,-3,-11,-1,-38,-1,-7,-7,-21,-5,-70,-1,-6,-5,-15,-3,-42,0,-1,-2,-6,-2,-28,23,14,9,33,17,16,2,6,-11,-4,34,-5,5,3,-12,-5,23,-2,-3,3,1,1,11,-3,2,1,-1,4,29,-2,3,1,-3,2,15,-1,-1,0,2,2,14,-1
3,03104,Petrer,28223,630,312,318,121,61,60,79,183,253,72,19,13,53,76,133,43,8,-3,26,107,120,29,11,16,18,25,47,24,2,4,12,10,24,12,0,2,6,15,23,12,2,2,718,359,359,312,147,165,97,183,219,134,49,34,43,91,125,53,26,18,54,92,94,81,23,16,72,77,90,58,10,4,35,30,45,29,5,2,37,47,45,29,5,2,444,204,240,145,67,78,70,135,141,70,18,9,21,65,81,37,6,-5,49,70,60,33,12,14,38,42,32,27,7,-2,20,21,14,11,2,-1,18,21,18,16,5,-1,430,225,205,105,45,60,77,95,139,71,30,15,36,25,102,35,16,5,41,70,37,36,14,10,27,26,35,8,7,0,10,9,18,3,2,1,17,17,17,5,5,-1,221,107,114,119,52,67,19,66,76,16,19,35,13,42,42,1,3,11,6,24,34,15,16,24,31,31,30,16,8,2,14,18,11,6,2,1,17,13,19,10,6,1,372,154,218,115,65,50,46,116,155,21,19,5,-1,31,93,5,20,3,47,85,62,16,-1,2,26,35,24,17,12,1,12,22,13,9,8,1,14,13,11,8,4,0,383,199,184,121,59,62,26,92,189,-1,54,22,22,43,113,1,19,5,4,49,76,-2,35,17,19,38,37,10,13,4,14,18,16,4,4,3,5,20,21,6,9,1,445,194,251,130,67,63,44,99,176,63,37,9,24,17,111,20,11,9,20,82,65,43,26,0,38,43,18,26,5,-1,19,21,11,12,3,1,19,22,7,14,2,-2,174,74,100,76,23,53,24,47,69,20,13,3,15,19,47,-5,-4,-1,9,28,22,25,17,4,23,19,18,13,1,1,12,5,7,0,-1,0,11,14,11,13,2,1,-29,-33,4,54,25,29,-12,-12,19,-31,1,9,-10,-11,-2,-11,-1,-1,-2,-1,21,-20,2,10,7,15,23,4,5,1,3,6,16,0,2,-1,4,9,7,4,3,2,-149,-107,-42,-9,-12,3,0,-40,-65,-39,-10,3,-13,-20,-38,-30,-5,1,13,-20,-27,-9,-5,2,4,8,-17,-8,3,1,1,3,-12,-10,4,2,3,5,-5,2,-1,-1,-168,-94,-74,-27,-18,-9,-57,-4,-30,-66,-2,-9,-31,-4,-7,-40,-5,-7,-26,0,-23,-26,3,-2,-8,-2,-3,-12,0,-4,-2,-2,-9,0,-5,-1,-6,0,6,-12,5,-3,-49,-38,-11,-61,-37,-24,-30,-30,-55,19,22,29,-32,-16,-25,19,13,5,2,-14,-30,0,9,24,-15,-8,-20,-16,-1,-1,-9,-7,-11,-10,1,-1,-6,-1,-9,-6,-2,0,54,-2,56,17,1,16,28,-7,35,-29,6,15,19,-16,-5,-35,25,10,9,9,40,6,-19,5,2,8,6,-5,0,6,3,1,2,-9,1,3,-1,7,4,4,-1,3,-338,-190,-148,-152,-80,-72,-50,-49,-121,-109,-24,10,-28,-30,-55,-68,-12,2,-22,-19,-66,-41,-12,8,-16,-16,-44,-45,-17,-15,-8,-8,-21,-34,-4,-6,-8,-8,-23,-11,-13,-9,-13,-40,27,11,-2,13,13,-38,-27,-16,10,42,4,-18,-30,-15,-4,21,9,-20,3,-1,14,21,5,1,-8,2,8,3,1,4,-8,-2,2,1,4,-3,0,4,6,2,-125,-96,-29,-42,-30,-12,5,-20,-43,-66,-2,8,10,-24,-43,-39,-1,7,-5,4,0,-27,-1,1,0,0,-9,-21,-12,-4,0,-1,-8,-12,-8,-2,0,1,-1,-9,-4,-2,-20,-11,-9,14,8,6,-12,10,-10,-30,-7,25,-11,-4,-1,-13,5,14,-1,14,-9,-17,-12,11,4,9,5,-3,-2,-1,1,4,4,0,-1,-1,3,5,1,-3,-1,0
3,03902,Pilar de la Horadada,10723,703,416,287,667,426,241,60,151,173,100,165,57,25,92,120,55,93,32,35,59,53,45,72,25,61,147,177,106,136,39,37,99,129,66,69,25,24,48,48,40,67,14,974,561,413,908,541,367,107,188,198,178,203,89,53,122,122,101,107,53,54,66,76,77,96,36,114,168,208,139,204,68,60,112,131,83,107,45,54,56,77,56,97,23,1327,699,628,1191,631,560,124,161,191,189,507,136,61,80,114,102,253,78,63,81,77,87,254,58,142,135,149,177,467,107,81,71,85,87,233,65,61,64,64,90,234,42,1577,840,737,1349,734,615,234,127,212,239,595,162,121,80,118,120,291,108,113,47,94,119,304,54,191,128,171,199,522,132,102,81,100,106,253,88,89,47,71,93,269,44,1561,792,769,1394,724,670,204,138,236,233,573,165,119,62,137,110,267,92,85,76,99,123,306,73,181,125,197,225,509,150,95,69,113,116,239,89,86,56,84,109,270,61,1340,687,653,1095,596,499,164,223,188,208,390,151,90,125,102,90,194,83,74,98,86,118,196,68,127,136,164,177,377,113,64,86,102,86,195,62,63,50,62,91,182,51,1223,633,590,937,485,452,197,179,253,216,272,80,90,95,142,95,144,50,107,84,111,121,128,30,133,140,174,138,262,80,64,73,93,60,135,54,69,67,81,78,127,26,1045,531,514,899,482,417,122,199,212,146,253,104,62,99,113,70,121,57,60,100,99,76,132,47,129,171,161,133,217,82,68,90,99,65,109,46,61,81,62,68,108,36,625,322,303,567,286,281,99,75,79,76,185,111,62,54,30,36,88,47,37,21,49,40,97,64,81,116,70,74,156,68,45,70,29,35,73,32,36,46,41,39,83,36,468,226,242,336,157,179,81,46,52,43,141,99,49,8,29,5,76,56,32,38,23,38,65,43,48,43,33,29,131,41,25,10,17,10,62,26,23,33,16,19,69,15,510,254,256,288,143,145,45,59,94,80,141,93,23,23,57,47,59,48,22,36,37,33,82,45,23,36,42,33,114,39,18,12,17,13,57,26,5,24,25,20,57,13,507,246,261,359,176,183,77,82,102,64,115,61,34,37,64,30,49,28,43,45,38,34,66,33,46,56,55,50,97,49,23,27,32,25,39,28,23,29,23,25,58,21,208,119,89,-30,-9,-21,35,66,48,14,39,-6,14,38,18,5,32,3,21,28,30,9,7,-9,-7,21,-7,-37,14,-15,-3,11,-3,-28,11,1,-4,10,-4,-9,3,-16,331,187,144,243,135,108,38,28,21,57,94,87,17,6,39,36,38,45,21,22,-18,21,56,42,31,30,17,37,74,47,16,15,18,24,31,27,15,15,-1,13,43,20,-7,22,-29,-66,-22,-44,-22,42,35,-36,44,-75,-9,41,23,-19,20,-36,-13,1,12,-17,24,-39,1,17,17,-18,18,-106,4,15,2,-1,12,-55,-3,2,15,-17,6,-51,161,60,101,34,3,31,38,27,-25,-51,84,82,11,10,-21,-28,32,53,27,17,-4,-23,52,29,9,24,-38,-71,81,25,-1,11,-28,-40,32,26,10,13,-10,-31,49,-1,339,160,179,382,215,167,19,64,26,19,124,87,0,29,-4,19,60,53,19,35,30,0,64,34,50,60,46,43,126,54,29,34,26,24,66,35,21,26,20,19,60,19,393,191,202,470,237,233,38,42,45,1,175,87,31,35,30,-43,91,46,7,7,15,44,84,41,69,73,43,27,181,72,41,48,28,-10,95,32,28,25,15,37,86,40
3,03105,"Pinós, el/Pinoso",6064,84,56,28,56,30,26,10,14,9,25,12,14,2,15,9,14,7,9,8,-1,0,11,5,5,6,13,17,17,3,0,4,9,8,7,2,0,2,4,9,10,1,0,143,89,54,91,53,38,24,57,37,24,9,-8,17,32,20,16,5,-1,7,25,17,8,4,-7,11,29,27,18,4,1,8,16,13,13,2,1,3,13,14,5,2,0,184,94,90,110,48,62,40,24,42,44,22,10,21,7,22,29,11,2,19,17,20,15,11,8,26,24,23,24,8,3,13,10,8,12,3,1,13,14,15,12,5,2,194,120,74,145,77,68,57,42,47,39,9,-4,35,23,25,30,2,-1,22,19,22,9,7,-3,47,26,28,27,13,4,31,9,14,15,6,2,16,17,14,12,7,2,155,67,88,109,55,54,35,19,12,25,33,16,12,9,7,11,16,6,23,10,5,14,17,10,28,7,11,30,23,8,13,4,4,17,13,3,15,3,7,13,10,5,176,100,76,103,51,52,39,24,25,25,50,8,24,19,17,8,23,4,15,5,8,17,27,4,21,18,19,17,23,3,10,11,7,7,13,2,11,7,12,10,10,1,166,98,68,95,47,48,13,25,32,34,46,15,8,10,29,15,28,6,5,15,3,19,18,9,8,22,15,26,17,7,4,9,10,12,8,4,4,13,5,14,9,3,202,112,90,158,80,78,30,29,28,42,58,11,15,17,11,19,37,9,15,12,17,23,21,2,29,27,29,30,37,6,15,13,11,14,22,5,14,14,18,16,15,1,142,72,70,115,57,58,31,5,10,36,53,5,14,-3,2,26,26,7,17,8,8,10,27,-2,21,10,9,26,44,4,15,2,1,14,20,5,6,8,8,12,24,-1,96,68,28,61,33,28,26,-3,-2,35,25,10,26,3,-2,15,17,6,0,-6,0,20,8,4,19,2,7,15,9,9,13,2,3,5,6,4,6,0,4,10,3,5,-23,-21,-2,-15,-20,5,-9,-3,-15,-4,-1,4,-11,2,-10,-7,-3,7,2,-5,-5,3,2,-3,4,0,-15,2,-5,-1,2,-2,-13,-3,-5,1,2,2,-2,5,0,-2,-17,-33,16,-23,-19,-4,5,-16,4,-2,-7,-6,-5,-8,-5,-4,-10,-3,10,-8,9,2,3,-3,-7,-6,-4,-8,5,-3,-6,-3,-5,-3,-1,-1,-1,-3,1,-5,6,-2,-14,-5,-9,3,-2,5,-2,0,-8,-16,18,-5,8,2,-13,-6,9,-4,-10,-2,5,-10,9,-1,5,3,-6,-4,10,-5,3,3,-5,-5,6,-4,2,0,-1,1,4,-1,-11,1,-12,4,-5,9,-14,5,-16,-3,19,-5,-6,4,-2,1,7,-5,-8,1,-14,-4,12,0,-5,2,-8,-6,18,1,-5,0,-5,-4,7,1,0,2,-3,-2,11,0,24,22,2,36,16,20,-9,-12,7,10,19,10,-8,-3,4,14,9,7,-1,-9,3,-4,10,3,5,-4,8,7,17,2,-1,-3,4,4,10,2,6,-1,4,3,7,0,-242,-152,-90,-235,-138,-97,-9,-27,-23,-84,-48,-55,-2,-31,-19,-53,-20,-29,-7,4,-4,-31,-28,-26,-18,-34,-18,-64,-55,-47,-7,-30,-12,-39,-24,-27,-11,-4,-6,-25,-31,-20,126,89,37,90,53,37,8,-14,20,62,44,5,9,-4,17,36,23,6,-1,-10,3,26,21,-1,9,-3,16,23,41,2,8,1,9,11,21,1,1,-4,7,12,20,1,163,84,79,113,66,47,25,3,14,50,54,5,11,-1,4,32,30,1,14,4,10,18,24,4,18,7,11,24,51,-2,11,5,5,13,30,0,7,2,6,11,21,-2
3,03901,"Poblets, els",1485,170,80,90,180,86,94,10,15,10,28,80,27,6,6,4,16,35,13,4,9,6,12,45,14,13,14,11,32,82,28,7,6,3,16,39,15,6,8,8,16,43,13,276,140,136,258,127,131,30,22,35,43,105,41,17,10,21,18,53,21,13,12,14,25,52,20,36,19,33,36,97,37,21,6,17,15,49,19,15,13,16,21,48,18,252,122,130,270,136,134,0,11,27,22,141,52,1,-4,12,10,71,32,-1,15,15,12,70,20,15,10,21,25,142,57,11,1,11,9,69,35,4,9,10,16,73,22,34,27,7,68,36,32,-8,2,-11,2,36,11,-1,4,-4,0,17,9,-7,-2,-7,2,19,2,6,2,1,7,37,14,3,2,0,3,19,8,3,0,1,4,18,6,157,79,78,87,53,34,26,-1,32,19,93,-15,10,2,11,11,44,2,16,-3,21,8,49,-17,2,1,10,11,87,-25,-1,5,7,3,43,-4,3,-4,3,8,44,-21,249,127,122,180,91,89,10,12,38,45,113,28,8,8,15,22,58,15,2,4,23,23,55,13,10,5,13,29,89,34,4,3,6,16,43,19,6,2,7,13,46,15,229,105,124,174,86,88,25,20,38,32,80,29,10,9,14,17,38,14,15,11,24,15,42,15,8,13,16,22,88,25,3,6,9,12,42,13,5,7,7,10,46,12,181,96,85,138,73,65,27,17,40,46,47,3,13,13,16,22,25,7,14,4,24,24,22,-4,24,9,26,33,46,-1,11,5,11,17,27,1,13,4,15,16,19,-2,52,20,32,60,30,30,2,17,4,7,25,-3,-4,5,2,4,12,1,6,12,2,3,13,-4,14,8,8,12,21,-4,7,1,4,7,10,0,7,7,4,5,11,-4,79,36,43,34,10,24,9,6,3,26,37,-3,7,2,0,15,19,-8,2,4,3,11,18,5,4,1,-1,8,24,-3,0,-1,-2,5,13,-5,4,2,1,3,11,2,43,36,7,18,8,10,-5,-1,4,3,35,9,1,-1,4,0,25,8,-6,0,0,3,10,1,-3,1,0,-1,19,2,-1,1,0,-3,10,1,-2,0,0,2,9,1,34,16,18,31,22,9,3,3,-21,15,41,-5,-1,-3,-11,12,18,1,4,6,-10,3,23,-6,8,-3,1,5,23,-4,7,-2,1,4,11,0,1,-1,0,1,12,-4,59,39,20,36,17,19,-2,0,4,9,38,11,-2,-1,11,-1,17,15,0,1,-7,10,21,-4,3,-3,4,4,21,7,1,-2,2,-1,9,8,2,-1,2,5,12,-1,12,4,8,27,5,22,3,-7,-2,-6,22,2,1,-3,0,-8,9,4,2,-4,-2,2,13,-2,2,2,-6,-2,23,7,-1,1,-4,-3,8,3,3,1,-2,1,15,4,-45,-13,-32,-39,-18,-21,-8,-5,-6,-10,1,-19,0,-2,-2,-4,9,-15,-8,-3,-4,-6,-8,-4,-6,-8,-7,-11,6,-13,-3,-3,-5,-5,6,-8,-3,-5,-2,-6,0,-5,-49,-26,-23,-101,-52,-49,5,3,2,7,-6,-59,8,-2,6,2,-5,-35,-3,5,-4,5,-1,-24,-1,1,-7,-14,-11,-70,0,-2,-3,-7,-5,-36,-1,3,-4,-7,-6,-34,-18,-17,-1,-15,-15,0,1,2,-6,-4,28,-36,-5,0,-7,3,8,-14,6,2,1,-7,20,-22,-1,-2,-1,2,25,-38,0,-2,-4,1,6,-16,-1,0,3,1,19,-22,-21,-10,-11,-8,-7,-1,6,0,-4,-8,10,-23,-4,0,1,-5,8,-10,10,0,-5,-3,2,-13,3,1,3,-4,8,-19,-2,1,2,-3,4,-9,5,0,1,-1,4,-10
3,03107,Polop,2024,131,75,56,60,34,26,16,18,33,24,9,31,7,9,21,21,3,14,9,9,12,3,6,17,5,17,23,8,4,3,3,7,14,7,1,2,2,10,9,1,3,1,140,94,46,64,45,19,17,20,50,24,13,13,10,16,34,18,10,6,7,4,16,6,3,7,7,10,23,16,7,1,4,7,18,11,5,0,3,3,5,5,2,1,112,63,49,111,67,44,19,24,6,21,31,12,11,12,8,5,20,8,8,12,-2,16,11,4,28,16,23,15,25,4,18,9,12,7,17,4,10,7,11,8,8,0,306,184,122,110,58,52,12,42,98,60,77,15,15,22,59,30,44,11,-3,20,39,30,33,4,8,13,13,23,44,9,5,8,7,8,24,6,3,5,6,15,20,3,381,186,195,178,100,78,48,70,96,52,84,23,20,43,43,19,46,9,28,27,53,33,38,14,16,24,28,30,63,13,9,20,15,13,31,10,7,4,13,17,32,3,321,157,164,102,56,46,28,58,107,78,40,11,18,22,52,35,24,8,10,36,55,43,16,3,11,10,18,23,32,8,5,6,11,9,20,5,6,4,7,14,12,3,197,120,77,92,60,32,5,25,65,54,30,13,4,11,41,36,21,6,1,14,24,18,9,7,18,15,19,30,9,1,14,8,13,18,7,0,4,7,6,12,2,1,250,104,146,134,57,77,44,48,52,45,27,34,20,21,25,20,10,9,24,27,27,25,17,25,24,28,16,29,35,2,9,12,6,12,16,2,15,16,10,17,19,0,97,41,56,88,41,47,29,14,24,6,27,2,8,9,12,3,15,-2,21,5,12,3,12,4,12,11,19,15,29,2,4,5,9,8,15,0,8,6,10,7,14,2,86,48,38,46,21,25,29,16,7,23,16,-5,20,11,1,9,8,-1,9,5,6,14,8,-4,19,5,0,7,12,4,11,4,-5,7,3,2,8,1,5,0,9,2,152,74,78,59,24,35,25,23,61,37,7,-3,16,13,28,12,8,-2,9,10,33,25,-1,-1,9,12,2,22,11,2,5,5,-2,9,6,1,4,7,4,13,5,1,82,33,49,65,35,30,-3,15,28,2,23,18,-16,11,21,3,4,10,13,4,7,-1,19,8,9,7,4,9,27,9,4,5,3,6,10,7,5,2,1,3,17,2,134,77,57,45,25,20,17,1,35,36,25,20,10,3,16,17,17,14,7,-2,19,19,8,6,5,3,-1,12,19,7,5,2,-3,5,11,5,0,1,2,7,8,2,42,-4,46,-12,-13,1,23,0,12,3,-4,7,12,-8,6,-5,-11,2,11,8,6,8,7,5,6,-4,-15,3,-3,0,5,-2,-12,-1,-5,1,1,-2,-3,4,2,-1,134,88,46,44,34,10,12,7,36,28,32,19,9,10,16,16,25,12,3,-3,20,12,7,7,5,2,-1,11,26,1,5,2,-4,7,20,4,0,0,3,4,6,-3,171,89,82,47,22,25,55,32,17,23,25,16,25,19,7,10,12,11,30,13,10,13,13,5,23,7,12,3,4,-6,10,5,2,3,0,-2,13,2,10,0,4,-4,19,10,9,-55,-28,-27,-13,-4,2,32,17,-14,-22,-5,6,22,19,-12,9,1,-4,10,-2,-2,3,-6,-20,-3,4,-34,-2,-2,-9,-6,8,-18,5,-4,-11,3,-4,-16,184,97,87,40,32,8,36,24,64,22,28,11,28,6,40,5,15,5,8,18,24,17,13,6,13,5,14,9,15,-17,10,3,9,7,8,-6,3,2,5,2,7,-11
3,03109,Rafal,3123,133,85,48,82,54,28,26,44,47,20,1,-4,21,23,29,12,1,0,5,21,18,8,0,-4,14,19,36,13,0,0,9,13,23,9,0,0,5,6,13,4,0,0,67,33,34,66,34,32,10,10,17,16,8,4,2,8,8,6,5,2,8,2,9,10,3,2,11,16,23,11,4,0,3,11,11,6,2,0,8,5,12,5,2,0,29,32,-3,57,31,26,-10,14,18,5,4,-2,0,14,18,0,2,-1,-10,0,0,5,2,-1,14,20,16,5,0,1,8,10,11,3,-1,0,6,10,5,2,1,1,99,66,33,48,31,17,11,32,22,19,6,5,7,17,21,15,2,2,4,15,1,4,4,3,5,15,13,12,2,0,2,8,11,8,1,0,3,7,2,4,1,0,140,82,58,57,29,28,42,43,43,0,3,1,20,15,37,2,3,1,22,28,6,-2,0,0,11,17,20,7,0,0,6,3,14,5,0,0,5,14,6,2,0,0,-8,-5,-3,22,10,12,-8,-7,-11,9,5,4,-5,2,-9,2,3,2,-3,-9,-2,7,2,2,5,5,6,4,1,1,2,3,3,0,1,1,3,2,3,4,0,0,85,35,50,45,18,27,25,12,41,-5,7,0,12,0,31,-12,2,0,13,12,10,7,5,0,25,5,9,0,4,1,15,-3,6,-2,1,0,10,8,3,2,3,1,82,48,34,68,27,41,1,33,30,2,5,3,-5,14,27,3,5,1,6,19,3,-1,0,2,15,18,13,10,10,1,6,5,6,5,5,0,9,13,7,5,5,1,73,39,34,31,9,22,17,20,-4,19,11,11,8,22,-9,9,6,5,9,-2,5,10,5,6,0,8,7,5,8,3,-2,4,0,1,4,2,2,4,7,4,4,1,17,-3,20,7,2,5,-6,11,3,2,4,4,-7,3,-4,4,0,1,1,8,7,-2,4,3,0,1,0,1,5,1,0,-1,-2,2,2,1,0,2,2,-1,3,0,-21,-18,-3,-20,-9,-11,-4,-7,-7,-2,3,-2,-4,-4,-12,0,1,0,0,-3,5,-2,2,-2,-4,-2,-8,-4,-2,0,2,-3,-6,-1,-1,0,-6,1,-2,-3,-1,0,-4,-2,-2,-3,-4,1,-16,1,1,-3,6,5,-10,0,2,-2,3,2,-6,1,-1,-1,3,3,2,-1,-5,-2,1,0,1,-1,-4,-4,3,0,1,0,-1,2,-2,0,-54,-31,-23,-23,-14,-9,-17,3,-14,-14,-12,-4,-9,-1,-6,-12,-2,-3,-8,4,-8,-2,-10,-1,-3,-4,-7,-5,-3,-3,1,-3,-6,-4,-1,-2,-4,-1,-1,-1,-2,-1,-72,-34,-38,-16,-11,-5,-28,-5,-14,-18,-5,-1,-9,-2,-6,-9,-6,-2,-19,-3,-8,-9,1,1,1,-1,-5,-7,-4,0,-1,-1,-3,-3,-3,0,2,0,-2,-4,-1,0,30,9,21,9,5,4,-4,8,18,7,-3,-2,-1,3,-1,3,-1,2,-3,5,19,4,-2,-4,-2,3,4,0,0,3,0,1,1,0,0,2,-2,2,3,0,0,1,22,5,17,2,-9,11,8,1,1,5,4,2,4,-4,2,1,-1,3,4,5,-1,4,5,-1,-1,-2,-1,3,3,0,-2,-4,-3,-1,1,0,1,2,2,4,2,0,85,40,45,10,3,7,18,3,27,8,13,7,8,1,8,5,8,5,10,2,19,3,5,2,-3,0,9,-3,5,0,-2,0,2,-1,3,0,-1,0,7,-2,2,0,60,33,27,25,8,17,9,18,3,11,20,2,7,5,12,0,9,1,2,13,-9,11,11,1,4,9,6,1,3,2,0,3,4,-1,2,0,4,6,2,2,1,2
3,03110,"Ràfol d'Almúnia, el",386,28,18,10,36,20,16,1,2,4,3,21,-3,2,1,3,1,13,-2,-1,1,1,2,8,-1,3,2,3,5,22,1,2,1,1,2,13,1,1,1,2,3,9,0,68,43,25,74,45,29,12,2,15,17,20,2,5,3,10,11,12,2,7,-1,5,6,8,0,12,5,14,19,21,3,5,5,9,12,12,2,7,0,5,7,9,1,20,5,15,26,9,17,0,1,-4,1,22,1,0,1,-4,-1,11,-1,0,0,0,2,11,2,3,2,-1,4,19,-1,2,1,-3,0,10,-1,1,1,2,4,9,0,29,16,13,45,25,20,2,0,2,4,17,4,2,0,1,4,6,3,0,0,1,0,11,1,5,0,1,9,24,6,2,0,2,6,10,5,3,0,-1,3,14,1,-4,1,-5,-3,1,-4,2,-1,6,1,-5,-6,3,-1,6,-1,-3,-2,-1,0,0,2,-2,-4,0,1,2,2,-4,-4,1,1,3,0,-3,-1,-1,0,-1,2,-1,-3,50,19,31,50,21,29,2,1,1,4,29,13,-1,2,-5,3,14,6,3,-1,6,1,15,7,2,1,2,5,29,11,-2,2,-3,4,14,6,4,-1,5,1,15,5,48,23,25,42,22,20,7,1,-3,7,27,8,4,0,-4,5,14,3,3,1,1,2,13,5,5,0,1,4,24,8,3,0,0,3,13,3,2,0,1,1,11,5,52,25,27,33,18,15,6,2,-3,14,29,4,5,3,-6,6,15,2,1,-1,3,8,14,2,0,-1,-1,5,27,3,1,0,-1,3,14,1,-1,-1,0,2,13,2,12,11,1,11,6,5,0,-1,0,1,10,2,-1,-1,4,2,5,2,1,0,-4,-1,5,0,0,0,0,0,7,4,0,0,1,0,3,2,0,0,-1,0,4,2,34,16,18,22,10,12,-2,3,8,5,19,1,-2,3,2,1,9,3,0,0,6,4,10,-2,0,1,5,2,12,2,0,0,2,0,5,3,0,1,3,2,7,-1,22,7,15,16,7,9,1,-1,5,2,11,3,1,-2,2,1,1,4,0,1,3,1,10,-1,0,0,2,1,9,4,0,0,2,0,1,4,0,0,0,1,8,0,6,10,-4,10,9,1,1,0,2,-1,8,-4,2,0,3,0,5,0,-1,0,-1,-1,3,-4,-1,0,1,1,9,0,0,0,1,1,5,2,-1,0,0,0,4,-2,-26,-15,-11,-6,-4,-2,-3,-2,-1,-7,-7,-6,-3,-1,-1,-3,-4,-3,0,-1,0,-4,-3,-3,0,0,-1,-1,-2,-2,0,0,-1,-1,-1,-1,0,0,0,0,-1,-1,1,4,-3,-2,0,-2,-3,0,-3,6,3,-2,-1,-1,-1,4,5,-2,-2,1,-2,2,-2,0,0,0,0,1,-1,-2,0,0,0,1,1,-2,0,0,0,0,-2,0,-15,-7,-8,-2,-1,-1,-4,0,-3,-3,-2,-3,-2,-1,-2,-1,0,-1,-2,1,-1,-2,-2,-2,-3,0,-2,-1,4,0,-2,0,-1,-1,2,1,-1,0,-1,0,2,-1,8,5,3,0,-1,1,6,0,2,3,5,-8,4,-1,2,2,4,-6,2,1,0,1,1,-2,0,0,0,1,5,-6,0,0,0,1,3,-5,0,0,0,0,2,-1,20,16,4,16,10,6,2,2,2,10,4,0,1,1,4,8,2,0,1,1,-2,2,2,0,1,0,1,5,7,2,0,0,1,4,3,2,1,0,0,1,4,0,-23,-15,-8,-42,-24,-18,-3,-2,3,-5,-2,-16,-2,-2,-1,-2,-1,-9,-1,0,4,-3,-1,-7,-3,-3,-2,-8,-7,-19,-2,-2,-2,-4,-4,-10,-1,-1,0,-4,-3,-9
3,03111,Redován,5398,131,81,50,82,60,22,14,39,37,12,7,23,3,31,28,9,3,8,11,8,9,3,4,15,15,28,23,10,3,2,7,22,18,10,1,1,8,6,5,0,2,1,175,86,89,78,50,28,-1,32,30,21,10,81,-1,22,23,11,7,21,0,10,7,10,3,60,17,21,23,15,0,0,8,16,18,6,0,0,9,5,5,9,0,0,188,94,94,90,52,38,20,21,13,13,22,94,16,5,12,9,13,35,4,16,1,4,9,59,31,14,22,19,1,1,21,4,13,10,1,1,10,10,9,9,0,0,142,69,73,81,36,45,20,29,24,21,11,34,10,13,9,10,3,20,10,16,15,11,8,14,15,19,21,17,6,2,5,8,13,8,0,1,10,11,8,9,6,1,301,159,142,152,87,65,67,89,83,43,5,13,24,50,55,24,4,1,43,39,28,19,1,12,31,43,55,19,3,1,21,20,33,12,0,1,10,23,22,7,3,0,191,102,89,118,66,52,43,62,44,22,15,6,28,32,19,12,10,0,15,30,25,10,5,6,30,31,26,19,9,2,20,18,14,8,5,1,10,13,12,11,4,1,225,105,120,100,52,48,35,65,63,39,12,5,21,24,30,22,3,1,14,41,33,17,9,4,16,23,28,17,9,3,10,12,16,10,2,1,6,11,12,7,7,2,232,116,116,119,63,56,4,77,70,16,9,57,3,39,42,12,0,21,1,38,28,4,9,36,17,49,33,11,3,3,11,27,15,6,1,1,6,22,18,5,2,2,66,65,1,71,46,25,-19,43,33,2,-6,13,-10,27,41,1,-1,8,-9,16,-8,1,-5,5,11,20,33,6,0,0,7,12,25,1,0,0,4,8,8,5,0,0,73,52,21,20,10,10,-8,36,15,4,6,19,-1,24,12,6,4,4,-7,12,3,-2,2,15,4,19,8,-9,-3,1,3,11,4,-7,-3,1,1,8,4,-2,0,0,81,40,41,19,0,19,43,3,13,12,5,3,24,4,1,2,3,3,19,-1,12,10,2,0,8,-4,-1,11,2,2,2,-4,-3,3,0,1,6,0,2,8,2,1,65,39,26,28,12,16,-14,2,11,17,2,48,-10,1,18,14,4,14,-4,1,-7,3,-2,34,3,10,8,7,1,-1,1,4,3,4,0,0,2,6,5,3,1,-1,50,21,29,-45,-25,-20,1,14,-11,21,12,8,3,3,-2,8,4,6,-2,11,-9,13,8,2,-5,-8,-18,-13,0,0,-2,-6,-9,-7,0,-1,-3,-2,-9,-6,0,1,-22,-22,0,-66,-53,-13,3,-13,-16,-27,8,21,7,-9,-14,-21,6,9,-4,-4,-2,-6,2,12,-4,-2,-30,-34,0,4,0,-4,-21,-29,-2,3,-4,2,-9,-5,2,1,53,55,-2,-34,-17,-17,16,18,-26,15,13,20,19,19,-16,18,11,7,-3,-1,-10,-3,2,13,1,2,-23,-12,2,-3,2,0,-15,-1,0,-2,-1,2,-8,-11,2,-1,-35,-23,-12,1,5,-4,4,-4,-12,-18,-9,8,-2,6,-16,-8,-4,3,6,-10,4,-10,-5,5,10,1,2,-2,-12,2,6,3,2,0,-8,1,4,-2,0,-2,-4,1,30,-7,37,-20,-20,0,8,3,-6,-5,4,23,6,-4,-3,-19,3,9,2,7,-3,14,1,14,1,4,-12,-18,0,5,4,2,-4,-24,0,2,-3,2,-8,6,0,3,-8,-9,1,8,0,8,-28,23,-1,-18,-6,21,-17,18,-3,-11,-5,9,-11,5,2,-7,-1,12,-6,14,-2,-3,2,4,-2,10,-2,-8,0,2,-4,4,0,5,2,2
3,03112,Relleu,806,0,5,-5,15,9,6,4,0,-1,7,-1,-9,4,0,0,5,0,-4,0,0,-1,2,-1,-5,6,1,5,2,1,0,5,1,2,1,0,0,1,0,3,1,1,0,33,12,21,21,10,11,8,3,1,12,9,0,3,2,-5,7,4,1,5,1,6,5,5,-1,4,2,3,5,7,0,2,1,0,4,3,0,2,1,3,1,4,0,54,35,19,29,19,10,11,-4,8,16,21,1,7,-1,3,11,13,1,4,-3,5,5,8,0,3,-1,4,8,15,0,3,0,0,8,8,0,0,-1,4,0,7,0,71,35,36,63,35,28,10,12,-1,31,18,1,0,10,-2,17,8,2,10,2,1,14,10,-1,8,9,5,22,16,3,1,7,4,12,8,3,7,2,1,10,8,0,101,58,43,57,34,23,13,15,21,25,26,0,10,11,14,9,12,2,3,4,7,16,14,-2,3,8,15,10,18,3,1,6,10,5,10,2,2,2,5,5,8,1,47,25,22,47,27,20,15,7,0,6,18,0,8,1,-3,3,17,-1,7,6,3,3,1,1,12,4,7,7,17,0,5,2,3,4,13,0,7,2,4,3,4,0,21,10,11,47,23,24,-8,-3,4,12,18,-2,-9,-3,6,8,10,-2,1,0,-2,4,8,0,9,2,7,11,16,1,5,1,3,4,8,1,4,1,4,7,8,0,103,59,44,75,35,40,15,19,18,23,25,3,10,9,8,12,16,4,5,10,10,11,9,-1,11,9,8,23,23,1,4,4,3,9,14,1,7,5,5,14,9,0,57,31,26,46,24,22,10,10,4,4,21,7,6,4,4,0,13,4,4,6,0,4,8,3,4,4,2,8,18,9,3,2,1,4,9,5,1,2,1,4,9,4,37,16,21,35,18,17,5,-2,1,9,19,5,1,-2,3,2,7,5,4,0,-2,7,12,0,4,4,1,6,17,3,1,2,1,3,8,3,3,2,0,3,9,0,75,34,41,36,17,19,9,10,1,30,19,2,4,4,-1,12,10,3,5,6,2,18,9,-1,7,6,-1,9,14,1,3,4,-1,4,6,1,4,2,0,5,8,0,22,11,11,16,8,8,7,-2,-1,2,12,2,4,-2,0,3,5,0,3,0,-1,-1,7,2,2,2,2,3,4,2,1,1,1,2,3,0,1,1,1,1,1,2,1,-6,7,17,9,8,4,-7,2,-2,1,3,-3,-4,-2,0,3,0,7,-3,4,-2,-2,3,3,2,2,2,3,5,2,1,1,1,1,3,1,1,1,1,2,2,19,22,-3,27,13,14,3,1,3,2,8,0,1,0,6,4,8,2,2,1,-3,-2,0,-2,4,2,5,5,11,0,1,0,3,2,7,0,3,2,2,3,4,0,31,7,24,29,9,20,7,2,4,1,12,6,-2,1,-2,1,5,4,9,1,6,0,7,2,8,1,2,7,10,1,2,1,-1,3,3,1,6,0,3,4,7,0,16,8,8,39,21,18,-5,2,-1,11,4,4,-4,2,-1,5,4,3,-1,0,0,6,0,1,4,0,1,13,13,8,1,0,1,7,7,5,3,0,0,6,6,3,23,19,4,35,22,13,3,-1,1,4,19,-4,3,-2,2,6,13,-3,0,1,-1,-2,6,-1,1,0,2,8,21,3,0,0,2,6,14,0,1,0,0,2,7,3,52,26,26,47,20,27,3,-2,2,7,31,10,4,-2,0,4,13,6,-1,0,2,3,18,4,4,1,3,7,25,7,2,0,0,3,10,5,2,1,3,4,15,2
3,03113,Rojales,7099,630,347,283,692,356,336,73,13,67,111,301,57,44,5,40,45,166,43,29,8,27,66,135,14,88,26,62,128,319,64,47,8,28,53,169,48,41,18,34,75,150,16,1210,657,553,1176,634,542,117,48,94,215,579,152,61,26,49,105,314,99,56,22,45,110,265,53,102,32,97,204,579,157,50,18,46,100,312,105,52,14,51,104,267,52,1482,752,730,1567,799,768,161,95,123,279,682,144,84,51,54,131,352,81,77,44,69,148,330,63,173,72,140,292,729,155,81,39,67,137,379,93,92,33,73,155,350,62,210,132,78,192,113,79,25,37,39,23,68,13,24,27,19,14,39,6,1,10,20,9,29,7,17,22,32,25,86,8,10,19,24,12,44,3,7,3,8,13,42,5,2132,1129,1003,2120,1108,1012,157,100,224,376,1029,229,80,55,133,183,525,144,77,45,91,193,504,85,154,78,162,389,1072,253,86,40,94,188,538,156,68,38,68,201,534,97,2071,1060,1011,2101,1103,998,166,77,207,377,981,260,67,33,117,167,510,162,99,44,90,210,471,98,175,82,206,366,1002,264,80,42,115,166,531,165,95,40,91,200,471,99,1684,837,847,1763,893,870,145,76,140,363,759,197,82,37,59,186,368,102,63,39,81,177,391,95,156,78,176,354,784,207,92,40,85,177,383,111,64,38,91,177,401,96,1805,939,866,1793,915,878,197,115,243,330,715,184,93,68,131,168,364,103,104,47,112,162,351,81,198,116,221,308,740,190,86,61,122,153,382,98,112,55,99,155,358,92,1238,641,597,1185,580,605,177,45,138,249,491,121,102,32,60,124,248,64,75,13,78,125,243,57,140,63,103,249,484,135,79,35,39,118,234,69,61,28,64,131,250,66,567,306,261,490,242,248,48,29,87,157,284,-42,22,20,58,90,139,-25,26,9,29,67,145,-17,27,35,53,112,294,-35,11,12,34,62,145,-23,16,23,19,50,149,-12,731,370,361,756,388,368,26,17,5,141,395,139,13,7,-19,62,213,89,13,10,24,79,182,50,54,12,20,118,395,152,31,0,-10,61,210,94,23,12,30,57,185,58,497,311,186,450,248,202,56,-31,44,65,269,77,27,-10,37,44,160,40,29,-21,7,21,109,37,50,-21,34,80,235,60,22,-8,21,46,129,28,28,-13,13,34,106,32,-188,-81,-107,-251,-137,-114,-25,-33,-57,-27,60,-121,-18,-18,-20,-7,16,-41,-7,-15,-37,-20,44,-80,-21,-48,-63,-39,49,-142,-18,-34,-33,-16,13,-53,-3,-14,-30,-23,36,-89,437,242,195,405,209,196,20,22,21,89,236,31,23,9,8,47,128,16,-3,13,13,42,108,15,32,13,26,81,211,32,30,4,7,38,105,18,2,9,19,43,106,14,-3792,-1979,-1813,-3847,-2031,-1816,17,-236,-175,-630,-998,-1778,11,-120,-95,-343,-467,-966,6,-116,-80,-287,-531,-812,25,-247,-199,-644,-988,-1803,15,-127,-108,-358,-465,-990,10,-120,-91,-286,-523,-813,-500,-240,-260,-495,-242,-253,53,-55,0,-43,-25,-439,36,-34,12,-19,-3,-236,17,-21,-12,-24,-22,-203,43,-52,-6,-58,-22,-408,25,-24,4,-29,-2,-221,18,-28,-10,-29,-20,-187,-501,-253,-248,-476,-250,-226,-195,-46,18,-32,102,-358,-122,-17,20,-22,62,-179,-73,-29,-2,-10,40,-179,-183,-60,-12,3,98,-332,-113,-21,-4,-11,62,-168,-70,-39,-8,14,36,-164,258,141,117,276,146,130,23,17,48,58,234,-129,4,1,27,53,95,-43,19,16,21,5,139,-86,36,7,45,49,227,-95,10,-3,29,42,95,-30,26,10,16,7,132,-65
3,03114,"Romana, la",1992,31,19,12,11,8,3,0,1,7,10,11,0,0,2,6,3,7,0,0,-1,1,7,4,0,0,0,3,3,5,0,0,0,3,2,3,0,0,0,0,1,2,0,44,24,20,21,13,8,6,5,6,12,12,3,3,4,5,6,5,1,3,1,1,6,7,2,2,4,8,5,2,0,1,2,6,3,1,0,1,2,2,2,1,0,60,32,28,38,21,17,1,14,12,8,23,1,0,7,5,6,13,1,1,7,7,2,10,0,0,9,7,9,10,3,0,3,6,5,6,1,0,6,1,4,4,2,119,67,52,68,45,23,25,14,18,35,19,7,12,7,12,18,13,4,13,7,6,17,6,3,14,8,11,19,13,2,9,7,7,10,9,2,5,1,4,9,4,0,128,73,55,128,65,63,12,4,23,34,48,8,10,3,12,20,25,4,2,1,11,14,23,4,17,5,19,31,44,12,9,3,8,16,22,7,8,2,11,15,22,5,42,15,27,71,39,32,4,-9,2,6,35,8,-3,-5,-2,3,15,8,7,-4,4,3,20,0,11,3,10,16,25,6,8,1,6,7,12,5,3,2,4,9,13,1,79,35,44,61,29,32,34,-2,13,15,20,-3,12,0,2,8,13,-1,22,-2,11,7,7,-2,14,5,12,11,17,2,5,3,5,6,9,1,9,2,7,5,8,1,69,59,10,55,34,21,19,1,5,12,26,7,17,7,4,9,16,6,2,-6,1,3,10,1,17,3,5,11,15,4,12,2,2,9,6,3,5,1,3,2,9,1,9,-3,12,34,14,20,-2,2,-2,1,16,-1,-1,2,-5,1,4,0,-1,0,3,0,12,-1,7,5,6,6,9,1,3,2,3,2,4,0,4,3,3,4,5,1,45,28,17,35,21,14,1,-2,6,9,20,10,-2,-1,10,3,11,7,3,-1,-4,6,9,3,2,0,1,10,18,3,1,0,1,4,11,4,1,0,0,6,7,-1,-53,-23,-30,-43,-21,-22,-24,8,-2,-16,-11,-8,-17,6,3,-6,-4,-6,-7,2,-5,-10,-7,-2,-17,1,-2,-13,-10,-3,-10,1,-3,-4,-4,-2,-7,0,1,-9,-6,-1,-35,-18,-17,-29,-18,-11,-15,-9,-3,-8,10,-10,-10,0,-5,-7,7,-4,-5,-9,2,-1,3,-6,-11,-6,-3,-5,1,-5,-8,0,-3,-5,0,-2,-3,-6,0,0,1,-3,-22,-12,-10,-33,-16,-17,-3,-2,4,-8,-1,-12,-3,0,4,-6,-1,-6,0,-2,0,-2,0,-6,-5,0,0,-19,3,-12,-4,0,1,-10,3,-6,-1,0,-1,-9,0,-6,3,-1,4,-8,-6,-2,2,5,-1,1,-1,-4,-2,0,-2,5,1,-4,4,5,1,-4,-2,0,-3,1,-7,-5,5,1,-3,1,-4,-1,4,-3,0,0,-3,-4,1,4,-21,-16,-5,-22,-16,-6,3,-7,-10,-1,10,-14,1,-4,-6,-5,7,-7,2,-3,-4,4,3,-7,-5,-4,-5,-4,0,-4,-2,-3,-2,-4,-1,-4,-3,-1,-3,0,1,0,-23,-11,-12,-3,0,-3,-1,-3,-8,-1,-5,-5,1,-2,-5,-1,-3,-1,-2,-1,-3,0,-2,-4,0,1,0,0,-2,-2,0,0,1,0,-2,1,0,1,-1,0,0,-3,-14,1,-15,2,7,-5,-2,-1,-11,1,12,-14,-4,2,-6,6,10,-8,2,-3,-5,-5,2,-6,4,-2,-3,4,12,-14,1,0,-3,3,12,-7,3,-2,0,1,0,-7,8,0,8,-9,-4,-5,0,-5,8,-5,7,1,-1,-4,3,0,0,1,1,-1,5,-5,7,0,-3,-1,3,-3,2,-7,0,-2,1,1,0,-4,-3,1,2,-4,2,-3
3,03115,Sagra,398,13,8,5,6,4,2,0,0,3,2,8,0,0,0,2,1,4,1,0,0,1,1,4,-1,0,0,1,1,4,0,0,0,1,1,2,0,0,0,0,0,2,0,6,4,2,4,3,1,0,0,-1,3,1,3,1,0,0,1,1,1,-1,0,-1,2,0,2,0,0,1,1,2,0,0,0,1,1,1,0,0,0,0,0,1,0,9,2,7,8,5,3,3,0,-4,7,5,-2,2,-1,-3,1,3,0,1,1,-1,6,2,-2,0,2,1,2,3,0,0,1,1,1,2,0,0,1,0,1,1,0,15,5,10,10,5,5,-2,1,3,-1,12,2,-3,0,1,-1,7,1,1,1,2,0,5,1,0,0,4,0,6,0,0,0,2,0,3,0,0,0,2,0,3,0,40,16,24,22,8,14,9,5,1,7,11,7,4,1,-1,3,5,4,5,4,2,4,6,3,7,2,1,5,5,2,3,0,0,3,1,1,4,2,1,2,4,1,14,13,1,30,17,13,-3,6,5,1,8,-3,-2,3,6,2,4,0,-1,3,-1,-1,4,-3,0,3,9,7,10,1,0,0,6,5,5,1,0,3,3,2,5,0,4,12,-8,24,18,6,-7,1,1,-4,13,1,1,1,1,0,8,2,-8,0,0,-4,5,-1,2,3,2,4,10,3,2,3,1,3,6,3,0,0,1,1,4,0,-18,-10,-8,7,4,3,-4,-3,-8,-9,6,0,0,-1,-5,-7,2,1,-4,-2,-3,-2,4,-1,0,-1,-1,2,5,2,0,-1,-1,1,3,2,0,0,0,1,2,0,10,5,5,3,1,2,4,0,-3,4,0,5,3,0,-1,1,-2,4,1,0,-2,3,2,1,1,0,-2,1,-1,4,1,0,-1,0,-1,2,0,0,-1,1,0,2,19,12,7,22,12,10,-3,-2,3,2,18,2,-1,0,2,2,9,1,-2,-2,1,0,9,1,1,0,2,2,16,1,0,0,2,1,9,0,1,0,0,1,7,1,-5,-3,-2,-14,-7,-7,2,-2,0,-4,1,-1,2,-1,0,-4,1,0,0,-1,0,0,0,-1,0,-3,0,-7,-3,-1,0,-1,1,-5,-2,0,0,-2,-1,-2,-1,-1,-3,0,-3,-6,-2,-4,-2,0,2,2,0,-4,-1,1,1,1,0,-1,-1,-1,1,1,0,-3,-1,0,-1,1,-4,-1,0,0,0,0,-2,0,-1,0,-1,1,-2,-1,-10,-5,-5,0,1,-1,-6,-2,-3,-1,1,1,-4,0,0,-3,2,0,-2,-2,-3,2,-1,1,1,-1,0,0,0,0,0,0,0,0,1,0,1,-1,0,0,-1,0,-20,-10,-10,-29,-17,-12,-1,-2,-5,2,-3,-11,-1,-2,-2,0,4,-9,0,0,-3,2,-7,-2,-4,-2,-5,-1,-5,-12,-2,-2,-2,-1,0,-10,-2,0,-3,0,-5,-2,8,5,3,3,2,1,1,0,0,3,4,0,0,0,0,2,3,0,1,0,0,1,1,0,-1,0,0,0,4,0,-1,0,1,0,2,0,0,0,-1,0,2,0,11,3,8,3,2,1,2,2,0,2,5,0,0,1,0,0,2,0,2,1,0,2,3,0,0,0,1,0,0,2,0,0,1,0,0,1,0,0,0,0,0,1,-17,-11,-6,-24,-12,-12,-2,0,-5,2,-1,-13,-2,1,-3,-2,0,-6,0,-1,-2,4,-1,-7,-2,-1,-2,-3,-2,-14,-2,0,-1,-2,-1,-6,0,-1,-1,-1,-1,-8,3,0,3,2,0,2,2,1,4,2,-6,0,1,-1,2,0,-2,0,1,2,2,2,-4,0,0,-1,2,0,-2,3,0,-1,1,0,-1,1,0,0,1,0,-1,2
3,03116,Salinas,1188,46,19,27,21,7,14,10,2,13,11,8,1,3,0,8,3,5,0,7,2,5,8,3,1,8,2,4,6,0,0,3,0,2,2,0,0,5,2,2,4,0,0,59,35,24,52,29,23,11,7,14,15,8,4,5,6,10,10,3,1,6,1,4,5,5,3,13,5,14,12,7,1,6,4,8,7,4,0,7,1,6,5,3,1,69,43,26,64,34,30,15,10,21,3,13,4,8,6,15,-3,11,3,7,4,6,6,2,1,17,9,12,12,10,1,7,5,8,3,7,1,10,4,4,9,3,0,7,6,1,24,13,11,-2,4,-6,-4,9,6,-2,0,-1,-2,4,7,0,4,-5,-2,5,-1,2,5,6,1,7,3,0,4,3,0,3,3,2,1,3,1,4,0,50,27,23,50,29,21,11,0,-4,22,18,2,9,2,-7,13,9,1,2,-2,3,9,9,1,10,2,4,17,13,4,8,1,1,10,7,2,2,1,3,7,6,2,38,23,15,36,16,20,8,1,2,13,11,3,5,-1,3,8,5,3,3,2,-1,5,6,0,9,2,1,12,10,2,3,1,-1,5,6,2,6,1,2,7,4,0,20,11,9,19,12,7,-1,4,2,4,9,2,0,1,-2,4,5,3,-1,3,4,0,4,-1,0,1,3,4,7,4,0,1,2,3,3,3,0,0,1,1,4,1,50,27,23,25,16,9,6,11,16,10,3,3,4,4,11,4,3,0,2,7,5,6,0,3,2,3,3,5,8,4,2,2,2,3,4,3,0,1,1,2,4,1,17,9,8,16,5,11,-1,-3,3,5,9,3,-2,0,1,2,5,3,1,-3,2,3,4,0,3,0,1,3,6,2,-1,0,0,0,4,2,4,0,1,3,2,0,-35,-23,-12,-39,-21,-18,-13,-8,4,-13,1,-5,-10,-5,-2,-6,5,-4,-3,-3,6,-7,-4,-1,-6,-7,-2,-14,-4,-6,-5,-3,-1,-9,0,-3,-1,-4,-1,-5,-4,-3,-3,-1,-2,-25,-14,-11,-8,0,7,-3,9,-8,-6,0,7,-4,6,-4,-2,0,0,1,3,-4,-7,-4,-1,-7,-1,-5,-4,-2,0,-5,0,-3,-3,-2,-1,-2,-1,-2,44,20,24,16,8,8,21,3,2,14,3,1,9,2,0,7,0,1,12,1,2,7,3,0,2,2,2,4,6,0,1,1,1,2,3,0,1,1,1,2,3,0,-17,-12,-5,7,3,4,-11,-1,2,-13,5,1,-6,2,-1,-8,0,1,-5,-3,3,-5,5,0,0,0,1,1,5,0,0,0,0,1,2,0,0,0,1,0,3,0,-18,-13,-5,-30,-15,-15,8,1,-1,-1,-14,-12,3,0,0,1,-4,-13,5,1,-1,-2,-10,1,1,-2,-1,-6,-12,-10,2,-1,-2,-1,-5,-8,-1,-1,1,-5,-7,-2,17,13,4,16,10,6,2,5,0,6,7,-2,5,3,0,3,5,-2,-3,2,0,3,2,0,1,3,1,3,6,2,1,1,1,2,4,1,0,2,0,1,2,1,-30,-17,-13,-15,-8,-7,-3,-3,-6,-2,-2,-13,-1,-1,-3,-3,-1,-7,-2,-2,-3,1,-1,-6,1,-3,3,-1,-4,-11,1,-1,2,-1,-3,-6,0,-2,1,0,-1,-5,13,10,3,33,17,16,10,-4,2,-2,14,-5,6,-1,2,-3,9,-1,4,-3,0,1,5,-4,9,0,5,6,13,-1,7,-1,2,2,7,-1,2,1,3,4,6,0,23,16,7,26,13,13,6,1,1,-2,16,1,5,1,0,-1,11,0,1,0,1,-1,5,1,3,1,0,2,17,3,1,0,0,1,10,1,2,1,0,1,7,2
3,03118,San Fulgencio,3384,401,202,199,375,195,180,48,30,35,60,180,52,21,13,20,31,90,30,27,17,15,29,90,22,30,21,37,61,171,55,13,10,21,34,85,32,17,11,16,27,86,23,679,362,317,659,350,309,41,42,60,96,321,118,22,24,37,47,158,73,19,18,23,49,163,45,43,41,63,91,315,105,23,25,34,46,156,65,20,16,29,45,159,40,982,502,480,1033,521,512,110,38,86,112,496,138,46,29,41,47,254,85,64,9,45,65,242,53,117,37,82,132,502,161,55,22,40,57,250,97,62,15,42,75,252,64,1266,643,623,1287,650,637,138,34,103,215,597,176,77,17,38,101,297,109,61,17,65,114,300,67,132,36,99,202,619,194,68,21,45,88,305,120,64,15,54,114,314,74,1469,735,734,1508,754,754,114,43,103,248,769,192,55,17,45,112,392,114,59,26,58,136,377,78,126,35,108,256,780,200,60,13,54,112,392,121,66,22,54,144,388,79,1404,731,673,1367,698,669,119,53,115,279,640,193,69,33,52,142,318,116,50,20,63,137,322,77,110,51,108,252,648,194,55,28,46,129,320,119,55,23,62,123,328,75,1072,554,518,1024,531,493,86,47,88,214,471,160,51,13,47,113,235,88,35,34,41,101,236,72,82,45,71,195,468,159,44,16,35,103,239,90,38,29,36,92,229,69,1044,556,488,847,439,408,104,66,134,162,453,120,66,39,70,75,236,66,38,27,64,87,217,54,77,43,71,151,400,102,38,24,35,74,208,57,39,19,36,77,192,45,426,211,215,396,193,203,44,20,15,54,230,61,17,9,3,30,119,33,27,11,12,24,111,28,44,16,25,48,199,62,17,3,14,20,102,35,27,13,11,28,97,27,161,70,91,165,74,91,25,10,13,23,68,23,14,-5,8,10,33,10,11,15,5,13,35,13,25,9,12,28,73,16,13,1,4,9,38,8,12,8,8,19,35,8,225,123,102,156,85,71,11,4,32,36,109,34,2,1,26,21,57,16,9,3,6,15,52,18,7,8,20,19,75,27,2,3,17,11,38,14,5,5,3,8,37,13,203,103,100,166,86,80,10,27,12,42,87,19,4,11,5,21,49,11,6,16,7,21,38,8,4,18,6,24,81,30,0,8,2,12,44,18,4,10,4,12,37,12,190,91,99,128,62,66,7,10,19,36,85,29,3,4,2,20,47,12,4,6,17,16,38,17,11,7,10,10,55,33,4,0,4,4,35,13,7,7,6,6,20,20,203,100,103,233,122,111,12,14,3,39,105,32,6,8,-9,20,53,24,6,6,12,19,52,8,19,13,14,43,100,42,13,5,5,22,53,24,6,8,9,21,47,18,220,135,85,188,118,70,19,6,18,32,106,35,17,9,7,18,58,24,2,-3,11,14,48,11,11,10,2,31,95,39,10,8,-1,17,55,29,1,2,3,14,40,10,222,120,102,259,130,129,19,3,10,38,136,11,8,0,1,18,79,10,11,3,9,20,57,1,29,3,27,46,117,35,11,0,10,22,65,20,18,3,17,24,52,15,388,186,202,401,207,194,-7,-1,32,32,240,92,-5,0,18,12,111,49,-2,-1,14,20,129,43,17,7,25,44,223,85,8,5,13,17,118,46,9,2,12,27,105,39,392,209,183,384,202,182,39,3,19,64,204,66,24,3,14,32,105,33,15,0,5,32,99,33,20,13,29,61,182,79,12,9,15,29,95,42,8,4,14,32,87,37
3,03120,San Miguel de Salinas,3691,332,183,149,292,155,137,36,27,47,44,131,48,24,19,22,21,68,28,12,8,25,23,63,20,33,14,32,37,128,47,19,8,19,17,63,28,14,6,13,20,65,19,517,278,239,534,283,251,70,31,74,91,207,47,33,18,43,50,106,29,37,13,31,41,101,18,73,36,64,90,221,50,34,23,36,45,116,29,39,13,28,45,105,21,691,357,334,660,352,308,84,25,76,93,363,43,45,15,35,33,193,34,39,10,41,60,170,9,79,18,76,102,345,35,46,10,41,41,185,26,33,8,35,61,160,9,592,287,305,603,307,296,79,36,63,111,252,50,34,16,22,56,127,33,45,20,41,55,125,17,69,37,58,114,267,56,34,17,27,57,138,34,35,20,31,57,129,22,763,410,353,777,399,378,74,24,63,157,356,86,48,18,22,86,187,50,26,6,41,71,169,36,73,25,76,138,363,98,38,14,36,70,187,53,35,11,40,68,176,45,569,282,287,540,278,262,58,43,73,106,246,40,30,17,37,51,125,21,28,26,36,55,121,19,48,38,53,106,250,44,22,17,28,55,130,26,26,21,25,51,120,18,528,252,276,488,242,246,65,27,50,139,187,59,22,2,38,62,89,39,43,25,12,77,98,20,46,27,61,100,189,62,17,9,29,51,91,43,29,18,32,49,98,19,441,220,221,386,186,200,70,30,47,79,152,57,35,22,21,30,78,28,35,8,26,49,74,29,48,22,37,77,144,54,21,8,15,34,76,28,27,14,22,43,68,26,114,62,52,134,64,70,34,16,-8,9,43,20,18,6,5,-1,28,7,16,10,-13,10,15,13,28,11,5,21,49,18,12,4,4,10,28,6,16,7,1,11,21,12,-76,-60,-16,-136,-75,-61,36,2,-10,-22,-12,-78,17,-4,-7,-18,-10,-42,19,6,-3,-4,-2,-36,10,-8,-22,-38,-16,-66,7,-6,-15,-17,-9,-37,3,-2,-7,-21,-7,-29,-161,-71,-90,-193,-82,-111,-25,-19,-26,-18,-13,-63,-7,-11,-17,-13,-3,-21,-18,-8,-9,-5,-10,-42,-33,-23,-21,-34,-19,-63,-13,-7,-13,-18,-8,-23,-20,-16,-8,-16,-11,-40,-231,-125,-106,-276,-146,-130,0,-43,-5,-34,-68,-85,-1,-17,3,-19,-44,-48,1,-26,-8,-15,-24,-37,-16,-38,-10,-39,-74,-102,-7,-17,-4,-20,-44,-55,-9,-21,-6,-19,-30,-47,-536,-275,-261,-615,-325,-290,-42,-48,-21,-115,-134,-184,-13,-18,-16,-63,-62,-107,-29,-30,-5,-52,-72,-77,-70,-61,-29,-112,-152,-196,-34,-27,-19,-60,-73,-114,-36,-34,-10,-52,-79,-82,-97,-60,-37,-118,-63,-55,-1,-4,2,-16,-22,-64,4,-8,-8,-12,-5,-35,-5,4,10,-4,-17,-29,-1,-4,-7,-12,-26,-71,2,-3,-7,-10,-6,-42,-3,-1,0,-2,-20,-29,91,58,33,62,43,19,13,7,20,19,43,-12,8,5,15,17,18,-6,5,2,5,2,25,-6,14,3,17,18,25,-17,7,2,10,14,14,-5,7,1,7,4,11,-12,-12,-15,3,-32,-21,-11,24,-24,16,17,40,-85,5,-9,3,13,16,-44,19,-15,13,4,24,-41,11,-14,11,2,31,-76,1,-7,7,5,13,-41,10,-7,4,-3,18,-35,13,29,-16,15,16,-1,5,-5,3,14,30,-35,3,-2,4,19,12,-10,2,-3,-1,-5,18,-25,2,-2,0,15,42,-44,-1,-2,0,11,20,-14,3,0,0,4,22,-30,-76,-1,-75,-146,-52,-94,21,-15,20,18,-10,-114,10,-5,18,23,0,-49,11,-10,2,-5,-10,-65,1,-9,4,-3,-18,-125,-3,-5,6,11,-3,-61,4,-4,-2,-14,-15,-64
3,03122,San Vicente del Raspeig/Sant Vicent del Raspeig,37484,1017,474,543,235,122,113,179,251,342,114,84,41,70,112,171,62,47,11,109,139,171,52,37,30,59,39,68,39,23,7,27,16,39,20,16,4,32,23,29,19,7,3,816,450,366,140,72,68,100,228,307,76,60,34,44,100,200,45,40,10,56,128,107,31,20,24,31,21,47,29,10,2,15,7,31,14,4,1,16,14,16,15,6,1,1372,689,683,400,188,212,266,281,400,220,129,64,141,130,211,121,67,16,125,151,189,99,62,48,113,77,97,66,39,6,60,25,47,36,16,3,53,52,50,30,23,3,1410,742,668,455,232,223,216,312,503,186,133,50,120,159,273,102,67,22,96,153,230,84,66,28,78,98,131,96,37,13,39,49,75,48,13,8,39,49,56,48,24,5,1265,621,644,409,215,194,198,250,443,184,123,49,78,121,246,91,56,23,120,129,197,93,67,26,71,85,110,75,47,17,35,40,65,49,18,8,36,45,45,26,29,9,1006,527,479,387,202,185,82,243,385,139,74,69,42,112,246,55,35,30,40,131,139,84,39,39,67,91,116,72,32,6,34,47,70,33,15,2,33,44,46,39,17,4,1766,877,889,505,219,286,227,377,591,280,164,89,111,152,336,147,68,41,116,225,255,133,96,48,94,110,138,109,39,11,48,43,60,44,15,6,46,67,78,65,24,5,1757,835,922,458,181,277,180,410,673,204,158,118,77,182,346,119,68,39,103,228,327,85,90,79,94,140,129,54,23,13,39,59,51,21,5,4,55,81,78,33,18,9,1256,593,663,253,99,154,180,312,450,139,68,101,89,118,257,62,35,27,91,194,193,77,33,74,43,100,74,27,0,6,24,27,30,15,-1,3,19,73,44,12,1,3,665,356,309,116,60,56,58,127,337,41,40,53,50,65,185,3,24,21,8,62,152,38,16,32,26,35,54,-5,-3,4,12,12,36,-1,-2,-1,14,23,18,-4,-1,5,153,98,55,-8,-9,1,-7,40,34,-6,15,77,16,19,32,-10,14,23,-23,21,2,4,1,54,-7,25,-12,-22,4,1,1,12,-14,-11,2,-2,-8,13,2,-11,2,3,327,138,189,149,55,94,32,140,81,16,0,49,26,70,35,-11,-7,25,6,70,46,27,7,24,24,61,33,0,22,6,13,29,14,-10,4,4,11,32,19,10,18,2,400,154,246,125,64,61,32,206,10,42,34,75,15,108,5,-9,8,30,17,98,5,51,26,45,22,118,-4,-10,1,-4,21,54,-2,-11,0,2,1,64,-2,1,1,-6,41,-72,113,-69,-65,-4,53,80,-78,-33,-15,36,7,27,-63,-30,-29,20,46,53,-15,-3,14,16,-24,36,-48,-24,-10,-2,-20,13,-29,-20,-11,1,-4,23,-19,-4,1,-3,80,41,39,-277,-164,-113,67,13,-2,-20,-12,17,58,1,-6,-24,-2,10,9,12,4,4,-10,7,-16,-32,-96,-85,-30,-26,-7,-29,-58,-48,-15,-10,-9,-3,-38,-37,-15,-16,134,-4,138,-98,-68,-30,91,51,-50,12,9,16,49,19,-63,-15,-6,8,42,32,13,27,15,8,11,4,-68,-18,-23,-7,13,0,-41,-17,-18,-6,-2,4,-27,-1,-5,-1,417,200,217,181,90,91,49,136,134,34,14,42,20,52,90,28,0,4,29,84,44,6,14,38,34,66,33,19,17,7,25,32,19,6,6,1,9,34,14,13,11,6,437,207,230,299,140,159,43,128,114,60,47,49,12,60,56,24,23,24,31,68,58,36,24,25,45,84,70,53,23,19,13,37,42,28,6,9,32,47,28,25,17,10
3,03117,Sanet y Negrals,537,24,12,12,24,11,13,6,1,-1,6,8,2,3,1,0,3,4,1,3,0,-1,3,4,1,5,2,2,5,8,0,2,1,1,2,5,0,3,1,1,3,3,0,37,24,13,29,16,13,2,4,6,10,10,5,1,1,8,5,6,3,1,3,-2,5,4,2,3,4,5,8,7,2,1,1,4,4,4,2,2,3,1,4,3,0,19,11,8,31,19,12,3,0,2,5,13,-4,2,0,3,3,4,-1,1,0,-1,2,9,-3,3,2,6,9,10,1,2,2,5,7,2,1,1,0,1,2,8,0,18,12,6,24,11,13,3,-3,6,5,6,1,4,-2,4,2,3,1,-1,-1,2,3,3,0,3,0,6,6,7,2,3,-2,4,2,3,1,0,2,2,4,4,1,35,13,22,35,17,18,7,1,-1,7,18,3,2,0,-1,1,10,1,5,1,0,6,8,2,7,3,2,8,12,3,3,2,1,2,8,1,4,1,1,6,4,2,33,20,13,30,21,9,5,2,8,6,10,3,3,3,3,4,5,3,2,-1,5,2,5,0,3,2,6,7,10,2,2,4,3,5,5,2,1,-2,3,2,5,0,32,7,25,33,11,22,14,3,3,-4,18,-2,2,-3,1,-4,10,0,12,6,2,0,8,-2,10,5,1,-2,17,1,4,0,0,-5,9,2,6,5,1,3,8,-1,16,9,7,25,13,12,-1,-1,0,10,9,-1,-1,0,1,3,7,-1,0,-1,-1,7,2,0,2,0,6,8,9,0,2,1,4,2,5,-1,0,-1,2,6,4,1,-4,-1,-3,13,8,5,-8,-1,-2,1,5,1,-3,-2,0,0,3,1,-5,1,-2,1,2,0,0,0,0,4,8,1,0,0,0,1,6,1,0,0,0,3,2,0,-6,5,-11,7,4,3,-1,-3,1,-6,3,0,1,0,3,-3,4,0,-2,-3,-2,-3,-1,0,0,0,0,1,4,2,0,0,0,0,3,1,0,0,0,1,1,1,-4,-2,-2,14,6,8,-6,3,-5,-1,4,1,-9,2,1,0,3,1,3,1,-6,-1,1,0,0,1,0,3,7,3,0,0,0,2,3,1,0,1,0,1,4,2,-7,-1,-6,5,3,2,-4,-2,-5,0,1,3,0,1,-2,-1,-1,2,-4,-3,-3,1,2,1,0,0,-2,1,2,4,0,0,-1,1,1,2,0,0,-1,0,1,2,7,-1,8,7,4,3,1,1,-5,0,3,7,-1,0,-4,-2,1,5,2,1,-1,2,2,2,0,0,-1,1,1,6,0,0,-1,0,1,4,0,0,0,1,0,2,-51,-29,-22,-46,-24,-22,-4,-3,-4,-10,-16,-13,-3,-1,-3,-4,-10,-8,-1,-2,-1,-6,-6,-5,-3,-4,-3,-8,-17,-11,-1,-1,-2,-3,-10,-7,-2,-3,-1,-5,-7,-4,5,5,0,12,6,6,-4,2,2,0,4,1,-2,1,2,1,2,1,-2,1,0,-1,2,0,1,1,1,2,7,0,1,1,1,0,3,0,0,0,0,2,4,0,10,9,1,14,7,7,-4,2,5,-4,5,5,0,1,4,-3,3,3,-4,1,1,-1,2,2,0,1,2,2,5,4,0,0,1,1,3,2,0,1,1,1,2,2,29,16,13,13,5,8,1,1,2,8,12,4,-1,1,2,6,5,2,2,0,0,2,7,2,0,0,0,1,8,4,0,0,0,0,3,2,0,0,0,1,5,2,19,11,8,11,6,5,3,2,1,9,5,-1,2,0,2,3,4,0,1,2,-1,6,1,-1,2,1,0,3,4,1,2,0,0,1,2,1,0,1,0,2,2,0
3,03119,Sant Joan d'Alacant,16910,21,26,-5,209,109,100,-12,-14,36,-24,15,26,7,-8,17,-14,14,14,-19,-6,19,-10,1,12,57,29,62,31,19,9,26,14,36,18,9,5,31,15,26,13,10,4,376,196,180,238,109,129,87,19,84,84,44,53,40,16,57,34,26,22,47,3,27,50,18,31,63,29,59,50,22,12,29,10,29,23,13,4,34,19,30,27,9,8,387,193,194,262,138,124,43,39,147,80,22,48,32,7,75,36,15,26,11,32,72,44,7,22,61,41,80,52,14,11,34,17,45,33,6,2,27,24,35,19,8,9,766,322,444,316,151,165,48,88,324,110,117,71,24,38,134,44,54,25,24,50,190,66,63,46,61,55,86,63,35,13,32,27,41,29,14,7,29,28,45,34,21,6,393,152,241,263,132,131,-49,26,285,58,36,40,-43,8,127,27,12,20,-6,18,158,31,24,20,43,50,81,54,22,15,20,22,40,32,8,10,23,28,41,22,14,5,763,409,354,300,141,159,148,92,265,112,69,70,79,53,163,53,31,21,69,39,102,59,38,49,55,64,74,48,40,13,26,33,36,22,16,5,29,31,38,26,24,8,492,214,278,320,154,166,35,116,172,96,41,25,22,46,66,57,13,6,13,70,106,39,28,19,62,74,74,65,35,10,32,32,38,32,15,5,30,42,36,33,20,5,574,315,259,284,149,135,103,71,215,65,49,91,63,46,117,35,18,45,40,25,98,30,31,46,59,70,53,51,31,18,33,30,37,25,13,10,26,40,16,26,18,8,94,10,84,154,61,93,-1,37,1,25,-8,38,-18,11,-6,11,-3,13,17,26,7,14,-5,25,38,46,25,34,9,0,8,15,11,19,3,4,30,31,14,15,6,-4,125,28,97,6,-1,7,3,13,26,13,22,45,-3,2,-11,-10,22,27,6,11,37,23,0,18,-3,5,-1,-14,12,5,-4,-4,-5,-5,14,2,1,9,4,-9,-2,3,271,106,165,6,-7,13,-1,34,172,1,9,58,-7,5,92,10,-5,13,6,29,80,-9,14,45,9,8,-11,-17,13,3,5,3,-6,-12,0,3,4,5,-5,-5,13,0,173,38,135,47,14,33,44,22,10,-3,34,65,17,3,5,-13,10,19,27,19,5,10,24,46,12,6,22,-1,8,0,8,-1,9,-5,4,-1,4,7,13,4,4,1,291,126,165,45,18,27,53,21,45,79,16,76,29,15,-2,47,10,28,24,6,47,32,6,48,8,12,2,2,8,12,6,2,-1,2,3,6,2,10,3,0,5,6,98,57,41,-54,-28,-26,29,-22,32,14,6,39,19,-9,10,11,15,10,10,-13,22,3,-9,29,-5,-10,-23,-4,-10,-4,-2,-6,-9,-5,-2,-5,-3,-4,-14,1,-8,1,133,72,61,39,12,27,13,5,28,44,-16,53,-1,6,18,17,-7,37,14,-1,10,27,-9,16,12,1,14,-5,7,7,3,2,5,-4,-1,6,9,-1,9,-1,8,1,33,-21,54,-96,-56,-40,43,-16,-15,-15,-34,59,29,-14,-14,-43,-14,26,14,-2,-1,28,-20,33,14,3,-27,-62,-18,-9,22,-4,-10,-45,-14,-7,-8,7,-17,-17,-4,-2,111,-19,130,-127,-94,-33,63,-22,49,-26,-15,51,25,-12,12,-39,-15,5,38,-10,37,13,0,46,10,-16,-27,-23,-49,-28,-2,-7,-22,-19,-31,-15,12,-9,-5,-4,-18,-13,263,106,157,88,32,56,69,25,67,-1,21,79,32,15,30,1,15,13,37,10,37,-2,6,66,47,45,26,-11,-17,-5,28,27,15,-14,-15,-10,19,18,11,3,-2,5
3,03121,Santa Pola,18253,803,419,384,429,208,221,93,133,222,150,157,39,60,64,113,70,86,23,33,69,109,80,71,16,74,71,99,87,78,19,40,30,46,42,40,10,34,41,53,45,38,9,1101,587,514,782,401,381,134,187,317,187,213,58,57,91,180,111,113,32,77,96,137,76,100,26,124,152,235,117,107,42,58,76,118,62,57,27,66,76,117,55,50,15,1068,559,509,719,361,358,93,140,232,185,290,122,47,64,130,99,141,75,46,76,102,86,149,47,80,91,151,122,197,71,40,41,76,69,91,40,40,50,75,53,106,31,1102,535,567,839,431,408,112,134,246,149,349,108,43,39,129,76,182,69,69,95,117,73,167,39,101,70,113,145,303,102,46,28,63,78,152,63,55,42,50,67,151,39,2194,1109,1085,1529,782,747,208,170,458,379,760,214,101,76,244,182,371,132,107,94,214,197,389,82,148,101,160,281,649,186,73,53,85,141,313,114,75,48,75,140,336,72,1847,937,910,1314,657,657,131,165,352,372,633,195,57,71,181,191,322,117,74,94,171,181,311,78,119,100,152,245,537,156,58,38,76,108,278,95,61,62,76,137,259,61,2122,1103,1019,1278,672,606,248,208,564,397,530,164,124,105,315,196,279,85,124,103,249,201,251,79,134,117,215,245,448,116,73,58,117,125,234,65,61,59,98,120,214,51,1841,1006,835,1032,545,487,238,209,487,363,401,94,118,111,281,208,211,46,120,98,206,155,190,48,122,126,174,205,303,95,58,74,97,112,152,48,64,52,77,93,151,47,959,520,439,527,287,240,89,139,338,143,176,32,43,74,194,78,85,18,46,65,144,65,91,14,63,71,115,93,140,40,34,39,63,56,67,25,29,32,52,37,73,15,770,412,358,357,190,167,105,90,199,113,146,104,63,40,114,58,72,55,42,50,85,55,74,49,43,39,69,51,108,46,26,20,34,24,55,31,17,19,35,27,53,15,704,386,318,262,147,115,68,77,270,94,141,53,41,46,138,57,76,31,27,31,132,37,65,22,23,16,40,27,103,49,8,5,23,18,62,29,15,11,17,9,41,20,485,329,156,267,149,118,14,66,161,31,153,46,13,51,122,32,75,31,1,15,39,-1,78,15,38,21,57,28,94,23,23,13,27,18,45,20,15,8,30,10,49,3,145,10,135,235,113,122,24,8,-8,28,65,30,1,-2,-14,-4,13,20,23,10,6,32,52,10,52,28,13,33,64,43,29,10,-2,13,35,28,23,18,15,20,29,15,524,257,267,280,160,120,67,65,133,64,138,43,25,26,52,42,78,22,42,39,81,22,60,21,44,21,44,46,70,49,21,8,22,25,45,33,23,13,22,21,25,16,464,282,182,337,184,153,32,11,122,56,149,75,29,9,59,43,76,56,3,2,63,13,73,19,43,18,45,62,109,54,22,6,23,39,51,41,21,12,22,23,58,13,474,218,256,345,182,163,65,50,115,86,94,57,29,26,51,36,35,39,36,24,64,50,59,18,72,25,61,82,69,31,33,15,23,41,40,27,39,10,38,41,29,4,159,82,77,94,56,38,78,49,160,54,-2,-189,57,21,73,25,-4,-99,21,28,87,29,2,-90,100,31,75,57,12,-189,62,9,36,31,10,-96,38,22,39,26,2,-93,-291,-192,-99,-471,-289,-182,74,90,141,-28,-103,-480,22,49,64,-2,-55,-280,52,41,77,-26,-48,-200,68,63,75,-64,-142,-477,23,39,30,-30,-76,-280,45,24,45,-34,-66,-197
3,03123,Sax,8602,-33,-8,-25,6,2,4,-8,-1,-15,-3,-1,-5,-3,3,-4,-2,0,-2,-5,-4,-11,-1,-1,-3,1,0,3,1,0,1,0,0,2,0,0,0,1,0,1,1,0,1,76,41,35,69,34,35,7,8,37,22,4,-3,6,1,21,8,3,2,1,7,16,14,1,-5,8,11,17,24,8,1,4,6,8,11,4,1,4,5,9,13,4,0,160,89,71,108,56,52,45,12,38,32,24,9,22,6,25,12,15,9,23,6,13,20,9,0,31,16,16,29,15,1,16,9,10,13,7,1,15,7,6,16,8,0,227,109,118,144,71,73,63,16,29,61,48,9,27,8,11,34,24,5,36,8,18,27,24,4,41,18,16,32,31,4,22,7,8,16,15,2,19,11,8,16,16,2,123,63,60,116,66,50,9,16,30,18,41,5,10,2,13,16,16,4,-1,14,17,2,25,1,18,10,11,32,39,4,12,5,4,21,20,3,6,5,7,11,19,1,144,61,83,108,49,59,33,8,21,32,44,7,15,5,4,12,21,5,18,3,17,20,23,2,23,9,18,21,35,2,11,5,5,8,18,2,12,4,13,13,17,0,150,101,49,133,66,67,20,17,22,39,41,8,16,10,21,24,25,3,4,7,1,15,16,5,30,12,29,25,31,4,18,4,13,10,18,1,12,8,16,15,13,3,134,82,52,95,45,50,24,10,26,45,35,-5,16,4,20,27,18,-2,8,6,6,18,17,-3,20,10,12,28,21,3,8,4,5,12,13,2,12,6,7,16,8,1,51,34,17,73,39,34,27,-10,2,16,15,0,16,3,-5,8,11,0,11,-13,7,8,4,0,16,5,16,14,18,3,10,5,5,8,10,1,6,0,11,6,8,2,19,4,15,17,8,9,-16,19,7,15,-4,-6,-8,9,1,9,-5,-3,-8,10,6,6,1,-3,2,4,10,-3,3,0,4,-1,6,-4,2,0,-2,5,4,1,1,0,-36,-25,-11,30,13,17,-9,-1,-19,-4,-1,1,-8,3,-18,-1,1,0,-1,-4,-1,-3,-2,1,-2,2,9,9,10,2,1,-1,2,4,6,1,-3,3,7,5,4,1,3,5,-2,12,8,4,3,-10,15,7,-8,-7,1,-12,15,1,0,-3,2,2,0,6,-8,-4,1,0,1,5,5,0,0,0,2,4,3,-1,1,0,-1,1,2,1,34,33,1,5,7,-2,8,-6,13,13,14,-8,11,3,4,7,12,-5,-3,-9,9,6,2,-3,0,2,-5,2,8,-2,-2,2,-2,2,7,0,2,0,-3,0,1,-2,-30,-15,-15,25,8,17,-15,-3,-8,3,-1,-5,0,0,-13,6,-1,-7,-15,-3,5,-3,0,2,5,2,5,6,6,0,2,1,0,2,3,0,3,1,5,4,3,0,-121,-61,-60,-105,-52,-53,-3,-7,-28,-32,-27,-25,-3,-9,-15,-14,-13,-9,0,2,-13,-18,-14,-16,-9,-14,-14,-27,-24,-17,-3,-10,-8,-13,-12,-6,-6,-4,-6,-14,-12,-11,-195,-86,-109,-199,-97,-102,-17,-29,-18,-42,-36,-54,-6,-16,1,-23,-20,-21,-11,-13,-19,-19,-16,-33,-21,-32,-27,-45,-36,-39,-11,-18,-12,-20,-18,-19,-10,-14,-15,-25,-18,-20,-27,-2,-25,-71,-36,-35,14,-18,8,3,-11,-25,8,-4,10,2,-6,-12,6,-14,-2,1,-5,-13,-5,-17,4,-12,-22,-19,-2,-9,7,-6,-14,-12,-3,-8,-3,-6,-8,-7,4,-1,5,24,16,8,-7,6,-13,6,15,-3,-7,0,-7,2,9,2,0,6,-6,4,6,-5,6,8,2,0,8,-2,3,5,1,0,4,2,3,3,1,0,4,-4
3,03125,Senija,472,17,7,10,13,6,7,5,2,2,0,3,4,1,0,0,1,2,2,4,2,2,-1,1,2,5,1,1,1,4,1,2,0,1,0,2,1,3,1,0,1,2,0,21,13,8,21,13,8,4,6,0,9,4,-2,1,3,3,6,1,-1,3,3,-3,3,3,-1,0,6,5,6,4,0,0,4,4,4,1,0,0,2,1,2,3,0,20,14,6,20,13,7,2,5,8,4,3,-2,4,2,6,1,2,-1,-2,3,2,3,1,-1,5,3,4,4,4,0,3,2,4,2,2,0,2,1,0,2,2,0,28,16,12,28,14,14,-4,3,14,2,10,3,-2,2,8,2,4,2,-2,1,6,0,6,1,0,4,6,6,8,4,0,2,3,4,3,2,0,2,3,2,5,2,46,38,8,39,26,13,11,0,15,13,7,0,9,2,13,9,4,1,2,-2,2,4,3,-1,8,5,10,8,7,1,7,3,8,3,4,1,1,2,2,5,3,0,30,22,8,30,24,6,4,12,10,8,1,-4,2,8,8,6,1,-3,2,4,2,2,0,-1,1,6,15,4,4,1,1,3,13,4,3,0,0,3,2,0,1,1,20,8,12,31,17,14,-2,6,-7,14,6,3,-3,5,-5,6,4,1,1,1,-2,8,2,2,5,8,6,8,3,1,2,5,2,5,2,1,3,3,4,3,1,0,-10,-9,-1,25,13,12,-1,0,-12,-2,5,0,-4,0,-6,-3,2,1,3,0,-6,1,3,-1,3,7,6,3,5,1,1,4,5,0,2,1,2,3,1,3,3,0,-9,-9,0,7,2,5,1,-3,-4,1,2,-5,2,-4,-6,1,3,-4,-1,1,2,0,-1,-1,1,2,0,1,3,0,1,0,-1,0,2,0,0,2,1,1,1,0,27,15,12,1,1,0,8,-1,9,4,5,3,3,1,2,4,2,2,5,-2,7,0,3,1,-1,0,1,1,0,0,-1,1,0,1,0,0,0,-1,1,0,0,0,10,7,3,10,5,5,0,5,1,-2,3,3,-1,3,1,0,0,4,1,2,0,-2,3,-1,2,1,0,3,2,2,1,1,0,1,1,1,1,0,0,2,1,1,-21,-14,-7,-5,-3,-2,-1,-5,-4,0,-7,-3,-2,-2,-1,-2,-4,-3,1,-3,-3,2,-3,0,0,-2,2,-1,-3,-1,0,-1,2,-1,-2,-1,0,-1,0,0,-1,0,26,21,5,5,1,4,8,3,4,5,4,0,9,4,0,4,3,-1,-1,-1,4,1,1,1,0,0,2,0,2,1,0,0,0,0,1,0,0,0,2,0,1,1,-35,-20,-15,-49,-21,-28,2,-5,-3,-1,-10,-18,0,-6,-5,0,-2,-7,2,1,2,-1,-8,-11,-2,-6,-3,-8,-15,-15,-1,-5,-4,-1,-5,-5,-1,-1,1,-7,-10,-10,-3,-4,1,1,2,-1,3,-2,2,-1,-3,-2,-1,1,1,-1,-4,0,4,-3,1,0,1,-2,2,0,1,-1,1,-2,1,1,1,-1,0,0,1,-1,0,0,1,-2,-8,-8,0,5,1,4,-6,-3,-4,-6,0,10,-6,-1,-1,-3,-1,4,0,-2,-3,-3,1,6,0,0,0,2,0,3,0,0,0,1,0,0,0,0,0,1,0,3,19,8,11,11,6,5,3,3,3,3,7,1,0,1,-1,3,4,1,3,2,4,0,3,0,0,0,1,2,7,1,0,0,0,1,4,1,0,0,1,1,3,0,9,13,-4,17,10,7,5,-5,3,10,-1,-3,5,0,0,5,1,2,0,-5,3,5,-2,-5,5,0,1,5,4,2,3,0,0,3,2,2,2,0,1,2,2,0
3,03127,Tàrbena,702,24,13,11,27,13,14,5,1,7,8,4,0,4,1,3,5,0,0,1,0,4,3,4,0,7,0,10,8,2,0,3,0,5,5,0,0,4,0,5,3,2,0,23,14,9,24,16,8,12,0,6,4,1,-1,9,1,3,1,1,-1,3,-1,3,3,0,0,10,3,5,5,0,1,7,2,3,3,0,1,3,1,2,2,0,0,17,14,3,22,13,9,2,4,6,1,5,-3,0,3,3,0,5,2,2,1,3,1,0,-5,1,3,5,2,8,2,0,1,4,0,5,2,1,2,1,2,3,0,9,3,6,23,11,12,-4,5,9,0,0,-3,-2,2,7,-2,0,-3,-2,3,2,2,0,0,1,1,6,5,6,3,1,1,3,1,3,1,0,0,3,4,3,2,23,16,7,38,22,16,2,-4,4,4,16,2,1,-3,5,3,10,1,1,-1,-1,1,6,1,3,7,10,4,13,1,1,3,8,3,7,0,2,4,2,1,6,1,8,4,4,22,13,9,-2,1,2,-4,10,0,0,-2,2,-1,5,0,-2,3,0,-3,5,0,0,4,4,3,8,3,0,0,4,2,5,2,0,4,0,1,3,1,18,15,3,33,20,13,0,4,9,4,4,-3,1,0,7,4,4,-1,-1,4,2,0,0,-2,4,5,15,2,7,0,2,1,12,1,4,0,2,4,3,1,3,0,23,13,10,24,15,9,-2,6,9,11,2,-3,-1,4,3,8,3,-4,-1,2,6,3,-1,1,-1,5,4,8,5,3,0,2,2,6,4,1,-1,3,2,2,1,2,25,12,13,19,8,11,1,1,4,4,10,5,2,-1,3,0,5,3,-1,2,1,4,5,2,0,2,6,3,4,3,0,1,3,0,3,1,0,1,3,3,1,2,12,8,4,18,9,9,-6,6,1,9,1,0,-4,4,1,5,0,1,-2,2,0,4,1,-1,1,7,1,7,2,0,0,5,1,3,0,0,1,2,0,4,2,0,16,7,9,9,5,4,4,1,3,4,3,0,3,0,2,1,3,-2,1,1,1,3,0,2,3,1,1,0,2,1,3,0,1,0,1,0,0,1,0,0,1,1,7,3,4,11,5,6,1,-2,2,2,2,2,0,0,2,-1,0,2,1,-2,0,3,2,0,0,0,4,3,2,2,0,0,2,1,1,1,0,0,2,2,1,1,0,6,-6,9,6,3,-2,-2,1,-2,6,0,-2,-1,5,0,2,2,0,-1,-4,-2,4,-2,-1,2,-1,2,4,3,-1,1,0,2,2,2,0,1,-1,0,2,1,-3,3,-6,5,1,4,2,3,0,-6,1,-2,3,3,-2,0,2,-2,-1,0,2,-6,-1,0,4,0,0,-1,1,0,2,0,-1,0,0,0,2,0,1,-1,1,0,-57,-31,-26,-45,-30,-15,-9,-9,-21,-7,-4,-7,-3,-4,-15,-4,-1,-4,-6,-5,-6,-3,-3,-3,-5,-9,-16,-5,-5,-5,-3,-4,-12,-4,-4,-3,-2,-5,-4,-1,-1,-2,-7,-6,-1,-10,-8,-2,2,-3,-4,-1,0,-1,0,-1,-2,-5,-2,4,2,-2,-2,4,2,-5,-2,0,-5,-3,1,-1,-2,0,-2,-4,0,0,0,0,-3,1,1,-1,9,0,9,10,4,6,1,3,6,-2,0,1,-2,0,3,-2,1,0,3,3,3,0,-1,1,1,2,4,-1,1,3,1,1,2,-3,1,2,0,1,2,2,0,1,-7,0,-7,-11,-6,-5,0,-3,-10,3,-1,3,1,0,-4,-1,0,3,-1,-3,-6,4,-1,0,-3,-2,-4,0,-3,1,-1,-1,-2,-1,-2,1,-2,-1,-2,1,-1,0
3,03128,Teulada,8901,574,304,270,578,310,268,65,38,135,121,180,33,31,15,75,65,97,19,34,23,60,56,83,14,53,40,126,109,193,55,27,16,74,58,104,30,26,24,52,51,89,25,687,389,298,695,374,321,68,76,126,113,213,82,41,38,70,61,124,49,27,38,56,52,89,33,76,68,117,119,219,89,42,38,57,57,123,53,34,30,60,62,96,36,805,419,386,819,430,389,54,74,145,118,339,69,26,37,80,55,177,41,28,37,65,63,162,28,83,64,109,120,344,94,40,38,60,56,178,55,43,26,49,64,166,39,658,326,332,769,390,379,79,48,77,129,278,47,37,27,22,60,153,28,42,21,55,69,125,19,91,51,122,146,285,71,46,25,56,72,149,40,45,26,66,74,136,31,849,459,390,898,481,417,65,98,215,147,251,77,18,54,118,90,137,45,47,44,97,57,114,32,89,97,180,174,269,87,33,52,106,99,141,49,56,45,74,75,128,38,873,471,402,839,450,389,95,130,165,166,256,54,54,62,89,96,128,36,41,68,76,70,128,18,87,112,140,148,277,70,48,55,77,80,142,45,39,57,63,68,135,25,773,426,347,826,435,391,81,80,153,146,248,63,51,49,82,74,139,32,30,31,71,72,109,31,99,90,143,165,246,79,61,54,69,77,131,41,38,36,74,88,115,38,849,435,414,864,436,428,126,121,156,146,222,77,57,61,91,75,102,48,69,60,65,71,120,29,123,127,139,154,230,88,56,61,80,78,108,51,67,66,59,76,122,37,258,140,118,330,163,167,54,-2,22,31,121,25,32,11,13,13,63,5,22,-13,9,18,58,20,61,19,31,63,123,28,33,13,15,24,66,10,28,6,16,39,57,18,228,96,132,217,91,126,38,27,36,43,56,21,15,10,5,25,29,7,23,17,31,18,27,14,38,18,36,38,60,24,15,5,9,17,30,14,23,13,27,21,30,10,-70,-42,-28,11,-1,12,-11,-14,-27,-31,24,-19,-5,-9,-12,-19,15,-16,-6,-5,-15,-12,9,-3,10,2,-2,-10,31,-25,10,-2,-2,-14,19,-14,0,4,0,4,12,-11,-26,-21,-5,17,-8,25,-4,-25,-29,7,67,-49,-5,-14,-6,-5,34,-26,1,-11,-23,12,33,-23,11,-9,-7,7,57,-48,5,-9,-4,3,26,-31,6,0,-3,4,31,-17,239,134,105,212,129,83,33,30,55,4,75,36,13,10,47,3,36,22,20,20,8,1,39,14,19,22,31,26,81,29,11,6,26,12,50,21,8,16,5,14,31,8,96,47,49,76,23,53,4,-5,21,13,46,13,5,1,5,5,23,3,-1,-6,16,8,23,10,11,-4,7,7,38,16,8,-6,0,-8,24,4,3,2,7,15,14,12,96,24,72,165,82,83,-10,25,0,-14,71,18,-2,7,-3,-23,32,13,-8,18,3,9,39,5,6,14,9,23,80,31,0,11,6,6,38,21,6,3,3,17,42,10,135,97,38,146,92,54,16,20,-1,39,57,1,9,13,20,18,28,8,7,7,-21,21,29,-7,23,19,13,29,67,-10,11,12,11,17,35,4,12,7,2,12,32,-14,-280,-148,-132,-260,-136,-124,14,19,9,-34,-8,-285,8,14,-3,-26,-7,-135,6,5,12,-8,-1,-150,28,18,10,-26,-12,-284,20,12,-3,-29,-4,-135,8,6,13,3,-8,-149,384,179,205,400,178,222,40,67,18,54,114,86,8,45,0,26,58,39,32,22,18,28,56,47,57,60,38,65,127,46,15,36,12,28,56,29,42,24,26,37,71,17
3,03129,Tibi,1176,28,17,11,14,9,5,3,3,8,2,10,1,3,0,4,3,5,1,0,3,4,-1,5,0,0,1,2,1,10,0,0,1,1,1,6,0,0,0,1,0,4,0,28,17,11,5,3,2,4,3,8,5,6,2,0,2,6,5,3,1,4,1,2,0,3,1,1,0,2,0,2,0,0,0,2,0,1,0,1,0,0,0,1,0,19,5,14,1,0,1,7,1,3,8,0,0,3,1,-2,4,0,-1,4,0,5,4,0,1,0,-1,0,1,1,0,0,-1,0,0,1,0,0,0,0,1,0,0,44,21,23,2,1,1,-7,6,18,7,15,5,-4,0,8,6,9,2,-3,6,10,1,6,3,0,0,0,0,1,1,0,0,0,0,0,1,0,0,0,0,1,0,53,24,29,35,20,15,-1,3,2,17,26,6,-4,0,4,8,14,2,3,3,-2,9,12,4,0,0,3,5,22,5,0,0,2,3,12,3,0,0,1,2,10,2,92,56,36,50,27,23,15,12,-1,28,38,0,10,9,1,14,20,2,5,3,-2,14,18,-2,5,5,1,11,24,4,2,3,1,5,12,4,3,2,0,6,12,0,62,33,29,34,14,20,9,3,16,10,21,3,3,-1,12,7,10,2,6,4,4,3,11,1,8,0,10,4,10,2,2,0,4,3,5,0,6,0,6,1,5,2,65,38,27,45,25,20,5,13,11,11,14,10,6,7,4,6,6,9,-1,6,7,5,8,1,9,3,6,8,12,7,6,2,3,3,6,5,3,1,3,5,6,2,34,18,16,15,9,6,2,0,15,12,4,0,4,-1,8,4,1,1,-2,1,7,8,3,-1,0,2,4,4,4,1,1,1,2,1,3,1,-1,1,2,3,1,0,22,14,8,11,6,5,2,7,9,1,5,-1,5,0,3,3,3,0,-3,7,6,-2,2,-1,0,1,1,0,6,3,0,1,0,0,3,2,0,0,1,0,3,1,21,10,11,17,8,9,-6,-4,0,8,16,6,-2,-7,6,2,7,3,-4,3,-6,6,9,3,0,2,2,1,10,2,-1,1,1,0,6,1,1,1,1,1,4,1,1,-3,4,4,1,3,0,-6,-4,2,11,-1,1,-2,-5,4,1,0,-1,-4,1,-2,10,-1,0,0,0,1,4,-1,0,0,0,1,0,0,0,0,0,0,4,-1,6,6,0,6,3,3,-2,-3,1,4,5,1,1,-1,2,0,2,2,-3,-2,-1,4,3,-1,0,0,0,1,6,-1,0,0,0,0,3,0,0,0,0,1,3,-1,15,11,4,4,1,3,0,-5,9,9,3,-3,1,-1,6,4,3,-3,-1,-4,3,5,0,0,0,-2,1,2,3,0,0,-1,0,1,1,0,0,-1,1,1,2,0,11,7,4,3,3,0,4,1,-7,12,2,0,0,2,-2,5,2,1,4,-1,-5,7,0,-1,0,1,-2,1,1,2,0,1,-1,1,1,1,0,0,-1,0,0,1,8,5,3,6,3,3,4,0,-4,2,6,1,0,2,-2,3,2,1,4,-2,-2,-1,4,0,-1,-1,0,-1,8,1,-1,0,0,-1,3,2,0,-1,0,0,5,-1,-44,-23,-21,-33,-16,-17,-2,3,-3,-18,-3,-21,-1,1,-2,-7,-5,-9,-1,2,-1,-11,2,-12,-3,-1,-5,-4,-1,-19,-2,0,-2,-3,0,-9,-1,-1,-3,-1,-1,-10,-70,-33,-37,-58,-31,-27,-3,-5,2,-4,-18,-42,0,-4,2,-3,-7,-21,-3,-1,0,-1,-11,-21,0,-5,-2,-4,-15,-32,0,-2,-3,-3,-8,-15,0,-3,1,-1,-7,-17
3,03133,Torrevieja,42278,8877,4635,4242,6454,3337,3117,894,1040,1577,1530,2649,1148,429,503,910,802,1353,626,465,537,667,728,1296,522,672,634,1099,1122,2091,821,331,336,616,564,1035,448,341,298,483,558,1056,373,10614,5729,4885,8745,4761,3984,1175,1524,2238,1908,2710,1016,608,779,1355,1066,1318,577,567,745,883,842,1392,439,1066,1191,1803,1652,2249,749,545,652,1078,927,1103,438,521,539,725,725,1146,311,8233,4446,3787,7406,3982,3424,878,1097,1628,1378,2400,820,441,585,986,774,1184,456,437,512,642,604,1216,364,961,953,1391,1275,2108,686,517,500,821,694,1026,405,444,453,570,581,1082,281,7668,4268,3400,6725,3678,3047,914,1291,1748,1317,1799,553,456,723,1123,746,876,331,458,568,625,571,923,222,899,1018,1395,1148,1691,537,468,561,862,629,815,328,431,457,533,519,876,209,6914,3899,3015,6088,3339,2749,809,1172,1607,1128,1658,522,469,656,1048,614,824,290,340,516,559,514,834,232,767,951,1327,1100,1477,447,420,512,822,582,738,259,347,439,505,518,739,188,6310,3638,2672,5842,3306,2536,777,1093,1437,1172,1382,414,471,625,906,658,719,242,306,468,531,514,663,172,736,954,1317,1086,1294,423,417,549,814,602,662,245,319,405,503,484,632,178,6330,3387,2943,6298,3355,2943,948,1199,1514,1131,1204,314,503,604,866,614,587,208,445,595,648,517,617,106,958,1158,1495,1125,1134,392,510,581,861,614,542,232,448,577,634,511,592,160,6129,3019,3110,5785,2852,2933,868,1099,1128,947,1478,570,427,546,590,415,716,317,441,553,538,532,762,253,868,1058,1107,918,1242,539,433,520,562,408,607,297,435,538,545,510,635,242,947,319,628,2019,925,1094,40,211,-87,106,473,229,30,90,-142,-40,238,154,10,121,55,146,235,75,392,365,357,346,358,173,211,178,146,126,158,93,181,187,211,220,200,80,-202,-218,16,855,308,547,6,-58,-392,-143,275,121,-15,-49,-245,-118,139,73,21,-9,-147,-25,136,48,183,138,71,114,253,75,93,45,-11,25,102,43,90,93,82,89,151,32,1286,467,819,1610,721,889,51,161,-138,118,737,364,-3,39,-122,35,312,218,54,122,-16,83,425,146,131,181,142,253,567,320,65,71,51,105,247,175,66,110,91,148,320,145,2045,1085,960,2178,1067,1111,143,297,166,459,726,241,87,177,92,204,378,142,56,120,74,255,348,99,268,300,278,427,556,325,152,155,143,185,269,150,116,145,135,242,287,175,1708,985,723,1498,753,745,232,239,238,412,507,62,105,137,146,248,265,59,127,102,92,164,242,3,201,236,216,302,396,115,99,115,96,148,199,75,102,121,120,154,197,40,1074,639,435,665,267,398,302,272,320,289,295,-433,137,180,237,176,143,-247,165,92,83,113,152,-186,353,219,136,231,155,-455,201,114,26,104,72,-261,152,105,110,127,83,-194,-4180,-1999,-2181,-4048,-2022,-2026,213,-125,-71,-129,-343,-3754,110,-77,-31,-59,-126,-1837,103,-48,-40,-70,-217,-1917,249,-87,17,-140,-480,-3653,121,-86,6,-73,-221,-1796,128,-1,11,-67,-259,-1857,-808,-427,-381,-239,-184,-55,-101,27,-162,-267,84,-444,-27,-6,-94,-160,10,-192,-74,33,-68,-107,74,-252,75,69,-18,-86,17,-359,48,14,-22,-67,-16,-181,27,55,4,-19,33,-178,-11766,-6191,-5575,-11002,-5826,-5176,-376,-511,-1394,-1979,-1998,-5545,-207,-265,-754,-1240,-995,-2738,-169,-246,-640,-739,-1003,-2807,-211,-416,-1073,-1787,-2076,-5485,-108,-239,-616,-1122,-1048,-2716,-103,-177,-457,-665,-1028,-2769,-208,-181,-27,611,342,269,-14,-7,-122,-268,185,-1,-12,10,-88,-198,50,45,-2,-17,-34,-70,135,-46,165,112,152,11,89,42,107,72,55,1,34,46,58,40,97,10,55,-4
3,03137,"Vall de Laguar, la",916,5,3,2,7,6,1,1,4,-3,-1,3,1,0,4,0,-3,3,-1,1,0,-3,2,0,2,0,3,3,0,1,0,0,3,2,0,1,0,0,0,1,0,0,0,12,13,-1,13,9,4,-1,3,-1,4,3,5,0,4,1,5,1,2,-1,-1,-2,-1,2,3,1,6,2,2,2,0,1,5,1,1,1,0,0,1,1,1,1,0,14,7,7,7,6,1,3,6,1,0,1,3,2,4,-1,0,0,2,1,2,2,0,1,1,0,2,1,1,2,1,0,2,1,1,1,1,0,0,0,0,1,0,23,10,13,11,4,7,-5,3,2,2,11,10,-3,0,1,-1,5,8,-2,3,1,3,6,2,0,1,1,3,7,-1,0,1,0,0,4,-1,0,0,1,3,3,0,61,32,29,28,15,13,8,5,8,17,20,2,4,0,4,9,13,1,4,5,4,8,7,1,3,4,2,6,10,2,2,1,1,4,4,2,1,3,1,2,6,0,34,20,14,21,12,9,3,2,6,7,15,0,2,1,6,3,9,-2,1,1,0,4,6,2,4,1,6,6,5,-1,2,0,5,2,4,-1,2,1,1,4,1,0,0,0,0,10,1,9,2,3,-11,2,5,0,0,1,-5,1,3,1,2,2,-6,1,2,-1,1,4,0,0,3,2,-1,1,0,0,0,1,2,3,0,0,3,1,83,39,44,28,16,12,9,6,1,20,10,37,5,1,1,13,6,13,4,5,0,7,4,24,8,3,3,8,4,2,5,0,2,5,2,2,3,3,1,3,2,0,27,8,19,13,4,9,1,1,0,5,0,20,0,0,-1,2,1,6,1,1,1,3,-1,14,5,0,2,4,2,0,1,-1,0,2,2,0,4,1,2,2,0,0,13,14,-1,6,6,0,-2,1,3,-6,-1,18,-2,1,4,-2,3,10,0,0,-1,-4,-4,8,-1,0,1,2,3,1,0,0,2,1,2,1,-1,0,-1,1,1,0,16,9,7,-7,-6,-1,-1,2,-8,-3,-1,28,-4,3,-3,-2,-2,17,3,-1,-5,-1,1,11,-2,-1,-1,-3,-1,1,-2,0,-1,-2,-1,0,0,-1,0,-1,0,1,29,15,14,4,2,2,1,1,1,1,7,18,0,0,2,1,4,8,1,1,-1,0,3,10,0,0,1,1,1,1,0,0,0,1,0,1,0,0,1,0,1,0,33,17,16,1,-1,2,1,-2,5,-1,5,24,1,-1,4,-1,2,11,0,-1,1,0,3,13,-1,0,0,-2,0,4,0,0,0,-2,0,1,-1,0,0,0,0,3,11,7,4,-4,-2,-2,-2,-3,1,-1,2,14,0,-1,2,1,3,2,-2,-2,-1,-2,-1,12,-2,0,-1,0,0,-1,-1,0,-1,0,1,-1,-1,0,0,0,-1,0,1,12,-11,4,2,2,-1,4,1,2,2,-6,1,3,4,3,1,1,-2,1,-3,-1,1,-7,0,0,0,0,3,1,0,0,0,0,1,1,0,0,0,0,2,0,11,5,6,6,1,5,3,-4,-3,0,0,15,4,0,-5,0,-1,7,-1,-4,2,0,1,8,2,0,1,3,-1,1,1,0,-1,1,0,0,1,0,2,2,-1,1,29,2,27,9,3,6,-1,7,-1,10,0,14,0,3,-4,4,-1,0,-1,4,3,6,1,14,0,1,1,2,2,3,0,0,0,1,2,0,0,1,1,1,0,3,19,12,7,8,5,3,4,-2,2,-3,8,11,1,-1,3,-2,6,6,3,-1,-1,-1,2,5,4,0,0,3,0,1,3,0,0,1,0,1,1,0,0,2,0,0
3,03138,"Verger, el",3610,84,53,31,96,54,42,12,1,40,23,11,-2,6,5,22,12,10,-1,6,-4,18,11,1,-1,12,14,29,27,11,3,7,11,17,11,7,1,5,3,12,16,4,2,140,104,36,134,86,48,14,24,51,30,14,6,5,21,43,26,6,3,9,3,8,4,8,3,17,25,46,31,11,4,8,18,33,22,4,1,9,7,13,9,7,3,178,128,50,112,66,46,30,31,65,27,20,5,16,27,49,19,12,3,14,4,16,8,8,2,13,30,31,13,17,4,5,20,20,5,10,2,8,10,11,8,7,2,224,129,95,152,89,63,40,40,55,33,39,13,17,20,38,19,19,12,23,20,17,14,20,1,28,24,37,21,30,11,16,13,25,11,14,9,12,11,12,10,16,2,200,128,72,189,109,80,35,35,58,30,23,19,22,24,37,17,14,13,13,11,21,13,9,6,21,42,57,25,29,15,13,22,33,17,17,7,8,20,24,8,12,8,145,66,79,159,97,62,28,34,17,27,29,5,7,18,6,15,13,3,21,16,11,12,16,2,22,26,55,26,27,1,10,17,38,17,14,1,12,9,17,9,13,0,207,118,89,133,66,67,18,37,43,51,49,9,12,20,32,28,24,3,6,17,11,23,25,6,13,29,25,28,34,4,6,13,12,14,18,3,7,16,13,14,16,1,149,97,52,142,86,56,7,43,33,8,34,22,7,27,27,8,21,4,0,16,6,0,13,18,19,52,25,21,19,5,13,30,17,13,10,2,6,22,8,8,9,3,89,57,32,80,40,40,16,30,4,10,22,7,18,18,-1,1,12,9,-2,12,5,9,10,-2,25,15,15,5,15,5,13,7,4,4,7,5,12,8,11,1,8,0,20,6,14,28,18,10,5,-3,1,-12,14,11,5,1,-3,-11,8,5,0,-4,4,-1,6,6,3,2,9,0,4,10,2,1,6,-1,4,6,1,1,3,1,0,4,52,14,38,22,6,16,0,-4,7,10,26,14,-3,-1,-1,-3,16,6,3,-3,8,13,10,8,-2,-3,2,2,19,1,-1,-3,0,0,9,0,-1,0,2,2,10,1,110,31,79,16,3,13,-8,1,14,2,15,86,-5,2,6,1,7,20,-3,-1,8,1,8,66,0,2,1,2,8,3,1,-2,-3,3,3,1,-1,4,4,-1,5,2,-13,-6,-7,-3,-6,3,-12,10,-14,-6,-4,13,-11,-2,-5,2,-1,12,-1,12,-9,-8,-3,1,-4,3,-3,-3,1,3,-3,-1,-2,-2,-1,3,-1,4,-1,-1,2,0,16,8,8,42,18,24,-5,-1,5,-5,-6,26,-1,-2,1,-5,-1,14,-4,1,4,0,-5,12,6,6,8,1,6,14,1,4,5,-3,4,6,5,2,3,4,2,8,11,-18,29,3,-3,6,2,1,-17,-8,12,22,4,5,-24,-15,2,11,-2,-4,7,7,10,11,3,5,0,-1,5,-8,2,4,-3,-6,1,-1,1,1,3,5,4,-7,24,14,10,37,22,15,-9,-7,21,-10,15,13,-18,-3,11,5,15,3,9,-4,10,-15,0,10,2,-2,15,8,11,4,0,1,8,4,8,1,2,-3,7,4,3,3,10,16,-6,32,24,8,0,9,-11,-7,1,18,0,10,-3,-4,2,11,0,-1,-8,-3,-1,7,-1,10,10,3,2,7,-1,8,8,1,3,4,0,2,2,2,-1,3,118,61,57,41,11,30,19,13,15,14,21,32,16,6,11,6,9,11,3,7,4,8,12,21,3,4,9,3,7,14,3,0,4,-1,-1,6,0,4,5,4,8,8
3,03139,"Villajoyosa/Vila Joiosa, la",23340,480,247,233,318,165,153,88,49,105,83,97,51,41,22,50,47,52,32,47,27,55,36,45,19,52,52,76,52,64,20,28,24,36,30,37,9,24,28,40,22,27,11,705,449,256,622,365,257,107,110,195,142,96,52,55,80,132,94,53,33,52,30,63,48,43,19,89,118,171,116,89,33,42,76,105,71,46,22,47,42,66,45,43,11,1216,654,562,969,521,448,102,214,243,198,239,206,46,98,155,117,118,111,56,116,88,81,121,95,124,141,191,168,191,147,58,68,113,90,101,85,66,73,78,78,90,62,891,464,427,744,402,342,93,171,277,140,148,67,43,76,160,74,79,34,50,95,117,66,69,33,105,137,185,121,138,52,55,74,101,66,72,30,50,63,84,55,66,22,1085,558,527,743,408,335,132,174,305,167,219,82,66,92,155,93,114,32,66,82,150,74,105,50,100,140,164,135,147,47,53,75,99,72,80,23,47,65,65,63,67,24,1419,742,677,750,400,350,162,247,523,266,158,59,81,120,277,157,71,35,81,127,246,109,87,24,116,149,192,143,110,31,63,72,105,85,52,20,53,77,87,58,58,11,1504,759,745,776,392,384,180,346,482,227,204,52,101,155,276,115,79,30,79,191,206,112,125,22,111,165,186,159,110,39,61,81,101,74,48,24,50,84,85,85,62,15,1448,779,669,952,501,451,120,338,481,255,200,47,47,175,277,144,108,23,73,163,204,111,92,24,132,231,235,166,145,39,64,112,135,90,78,20,68,119,100,76,67,19,175,49,126,-14,-66,52,36,99,73,-55,-4,9,32,29,37,-61,-2,6,4,70,36,6,-2,3,8,51,-44,-41,7,-7,3,15,-48,-43,4,-1,5,36,4,2,3,-6,130,59,71,273,156,117,-1,57,-50,12,54,59,5,20,-27,1,30,35,-6,37,-23,11,24,24,41,48,41,39,61,38,36,23,14,27,34,21,5,25,27,12,27,17,-1780,-968,-812,-1718,-962,-756,-224,-91,-358,-376,-299,-436,-98,-51,-209,-218,-151,-244,-126,-40,-149,-158,-148,-192,-169,-117,-295,-348,-339,-457,-82,-64,-167,-222,-175,-256,-87,-53,-128,-126,-164,-201,740,405,335,616,310,306,76,121,119,178,151,85,48,53,87,80,87,39,28,68,32,98,64,46,107,86,138,130,101,45,49,38,73,67,54,23,58,48,65,63,47,22,401,227,174,275,148,127,20,65,55,41,130,81,-9,43,38,30,77,42,29,22,17,11,53,39,28,50,9,50,94,41,12,23,9,26,51,26,16,27,0,24,43,15,-22,-28,6,-188,-115,-73,-1,35,-95,23,45,-40,-8,12,-53,7,22,-12,7,23,-42,16,23,-28,9,-17,-66,-35,-27,-62,6,-18,-39,-21,-21,-28,3,1,-27,-14,-6,-34,19,17,2,57,22,35,-7,25,-33,-22,38,15,-3,22,-3,-26,21,2,-4,3,-30,4,17,13,32,1,8,-4,25,-8,13,-1,7,-11,16,-5,19,2,1,7,9,-3,55,-6,61,-87,-73,-14,-11,42,-6,1,56,-30,-11,33,-14,-21,11,-8,0,9,8,22,45,-22,-3,22,-29,-43,25,-64,-14,13,-23,-32,9,-30,11,9,-6,-11,16,-34,-25,-14,-11,-249,-139,-110,55,43,-13,-64,-18,-41,18,5,23,-24,-24,-21,37,38,-36,-40,6,-20,4,16,-49,-74,-75,-80,-1,1,-14,-40,-51,-38,5,15,-35,-34,-24,-42,283,111,172,132,53,79,86,41,87,14,27,24,53,30,40,-37,18,6,33,11,47,51,9,18,71,30,51,-1,-18,-7,38,18,29,-20,-18,0,33,12,22,19,0,-7
3,03140,Villena,31700,353,153,200,259,142,117,34,41,65,57,8,148,8,26,36,28,5,50,26,15,29,29,3,98,28,84,95,44,1,5,12,45,55,27,0,2,16,39,40,17,1,3,628,359,269,461,244,217,121,132,166,93,38,73,72,83,97,41,27,37,49,49,69,52,11,36,101,124,137,71,24,3,61,68,72,29,11,2,40,56,65,42,13,1,570,261,309,416,198,218,114,101,135,103,40,72,49,56,78,46,16,12,65,45,57,57,24,60,104,102,110,74,18,4,50,49,58,34,4,1,54,53,52,40,14,3,377,161,216,279,149,130,76,83,91,59,19,44,41,39,42,35,5,-4,35,44,49,24,14,48,71,80,65,36,20,4,44,45,32,17,7,2,27,35,33,19,13,2,211,111,100,233,132,101,52,63,32,36,19,2,26,30,19,18,10,4,26,33,13,18,9,-2,65,54,55,38,19,-1,36,31,33,21,8,0,29,23,22,17,11,-1,207,151,56,201,107,94,53,16,67,27,22,17,32,31,52,16,9,8,21,-15,15,11,13,9,52,43,49,31,20,6,32,25,24,13,11,2,20,18,25,18,9,4,258,177,81,294,153,141,78,35,43,65,42,-1,35,24,49,45,25,0,43,11,-6,20,17,-1,64,66,61,55,42,4,33,29,44,24,23,0,31,37,17,31,19,4,395,244,151,313,175,138,88,62,85,60,47,42,57,40,60,31,27,21,31,22,25,29,20,21,74,77,83,45,31,2,39,46,45,24,18,3,35,31,38,21,13,-1,100,41,59,152,77,75,6,45,11,28,15,-8,-12,34,-7,15,8,1,18,11,18,13,7,-9,15,50,38,25,24,-2,8,26,12,14,15,1,7,24,26,11,9,-3,-138,-70,-68,37,16,21,-14,-33,-65,-16,-3,-9,-9,-20,-35,-7,2,1,-5,-13,-30,-9,-5,-10,13,21,-7,5,6,-3,6,6,-4,3,6,-1,7,15,-3,2,0,-2,-121,-50,-71,6,-5,11,-29,-29,-33,-28,14,-22,-12,-15,-15,-10,3,-3,-17,-14,-18,-18,11,-19,6,5,-9,-6,6,3,1,-1,-3,-4,0,2,5,6,-6,-2,6,1,-91,-58,-33,-39,-37,-2,14,-20,-15,-38,-34,-2,4,-20,-1,-23,-12,-9,10,0,-14,-15,-22,7,3,8,-17,-28,-8,2,3,-1,-14,-17,-7,-1,0,9,-3,-11,-1,3,-88,-50,-38,-2,-21,19,-15,-5,-48,-23,2,-3,-6,1,-22,-23,6,-8,-9,-6,-26,0,-4,5,-4,15,-3,-10,2,-4,-2,0,0,-16,-2,-2,-2,15,-3,6,4,-2,-192,-106,-86,-18,-8,-10,0,-80,-55,-36,-16,-10,-3,-39,-35,-17,-9,-8,3,-41,-20,-19,-7,-2,2,-4,-3,-4,-7,-5,5,-4,-3,2,-5,-6,-3,0,0,-6,-2,1,-274,-145,-129,-130,-74,-56,-24,-41,-83,-65,-33,-30,-16,-23,-45,-30,-17,-15,-8,-18,-38,-35,-16,-15,-4,-14,-23,-48,-31,-10,2,-11,-13,-30,-15,-7,-6,-3,-10,-18,-16,-3,-189,-99,-90,-94,-43,-51,9,-22,-90,-56,-26,-7,4,5,-45,-40,-19,-9,5,-27,-45,-16,-7,2,-5,-2,-19,-48,-11,-10,-3,9,-7,-31,-6,-6,-2,-11,-12,-17,-5,-4,-181,-79,-102,21,-1,22,-32,-38,-90,-43,10,11,-12,-14,-44,-30,9,13,-20,-24,-46,-13,1,-2,19,12,5,-5,-5,-8,13,2,0,-11,-2,-4,6,10,5,6,-3,-4,-55,-34,-21,11,9,2,9,-1,4,-28,-28,-18,1,5,3,-13,-20,-15,8,-6,1,-15,-8,-3,17,17,14,-15,-12,-14,10,6,15,-5,-10,-9,7,11,-1,-10,-2,-5
3,03081,Xaló,2001,154,79,75,101,48,53,30,20,27,24,36,14,15,13,9,14,18,8,15,7,18,10,18,6,20,10,17,24,25,3,9,7,5,13,12,1,11,3,12,11,13,2,90,36,54,107,54,53,23,5,13,25,21,0,12,1,2,9,9,0,11,4,11,16,12,0,29,9,13,27,23,3,19,4,5,9,12,2,10,5,8,18,11,1,118,62,56,141,74,67,26,-1,24,28,38,1,16,3,11,12,19,1,10,-4,13,16,19,0,21,8,27,28,46,11,9,5,12,14,25,9,12,3,15,14,21,2,174,89,85,156,81,75,28,19,21,34,62,9,11,7,15,21,32,4,17,12,6,13,30,5,29,11,17,30,57,10,17,5,9,16,28,6,12,6,8,14,29,4,236,119,117,222,114,108,42,18,39,64,66,2,20,14,20,28,35,2,22,4,19,36,31,0,41,16,30,52,75,6,20,7,19,22,42,4,21,9,11,30,33,2,147,69,78,158,84,74,19,0,30,34,52,11,7,1,12,18,20,9,12,-1,18,16,32,2,23,13,30,36,46,8,12,8,14,19,24,6,11,5,16,17,22,2,86,46,40,115,55,60,19,14,9,21,10,14,9,1,6,12,10,10,10,13,3,9,0,4,31,14,20,28,12,8,17,4,10,11,9,4,14,10,10,17,3,4,172,85,87,151,76,75,30,15,46,30,30,13,13,10,31,8,14,3,17,5,15,22,16,10,36,16,26,27,31,10,21,7,16,12,12,4,15,9,10,15,19,6,64,34,30,73,30,43,8,1,-5,26,17,16,5,4,-6,19,2,9,3,-3,1,7,15,7,16,6,9,18,16,7,5,2,4,9,5,4,11,4,5,9,11,3,46,33,13,53,26,27,7,2,-8,13,42,-9,7,-4,1,5,27,-2,0,6,-9,8,15,-7,6,4,5,8,30,0,4,1,3,2,15,1,2,3,2,6,15,-1,75,36,39,44,22,22,13,8,10,13,33,-1,5,3,6,10,14,-2,8,5,4,3,19,1,4,6,6,8,17,3,2,3,2,6,8,1,2,3,4,2,9,2,18,9,9,33,15,18,-7,5,4,-1,11,5,-5,1,1,2,8,2,-2,4,3,-3,3,3,0,1,3,6,17,6,-1,-2,2,3,9,4,1,3,1,3,8,2,23,11,12,32,9,23,0,1,9,9,4,1,1,2,2,10,-5,2,-1,-1,7,-1,9,-1,9,1,3,4,12,3,2,1,0,2,1,3,7,0,3,2,11,0,-16,-3,-13,10,2,8,4,-8,0,-11,6,-7,2,-3,-2,-7,6,1,2,-5,2,-4,0,-8,3,-3,-3,-1,11,3,0,-1,-5,-1,6,3,3,-2,2,0,5,0,-101,-52,-49,-101,-52,-49,-17,-17,-7,-22,-14,-24,-10,-8,-1,-14,-4,-15,-7,-9,-6,-8,-10,-9,-14,-18,-7,-33,-6,-23,-8,-11,-2,-18,2,-15,-6,-7,-5,-15,-8,-8,-112,-61,-51,-134,-75,-59,-22,-18,1,-29,-29,-14,-11,-6,-5,-13,-17,-8,-11,-12,6,-16,-12,-6,-15,-17,-6,-26,-33,-37,-9,-9,-8,-12,-17,-20,-6,-8,2,-14,-16,-17,39,28,11,25,8,17,-3,4,2,6,16,9,5,0,3,0,10,8,-8,4,-1,6,6,1,7,1,3,2,10,0,7,-1,1,-3,4,0,0,2,2,5,6,0,90,56,34,55,32,23,14,5,19,9,24,16,4,5,7,11,16,10,10,0,12,-2,8,6,10,4,8,13,10,7,4,2,4,10,5,5,6,2,4,3,5,2
4,04001,Abla,1519,-4,-6,2,4,3,1,-4,-1,-6,4,1,2,-4,-2,-4,2,1,1,0,1,-2,2,0,1,0,0,0,3,0,1,0,0,0,2,0,1,0,0,0,1,0,0,7,10,-3,9,7,2,2,-1,-1,6,6,-3,1,-2,2,8,3,0,1,1,-3,-2,3,-3,0,2,4,3,0,0,0,1,3,3,0,0,0,1,1,0,0,0,-10,0,-10,29,19,10,2,1,-3,0,-3,-5,2,3,0,0,-1,-2,0,-2,-3,0,-2,-3,9,4,12,4,0,0,6,4,6,4,-1,0,3,0,6,0,1,0,10,-2,12,9,2,7,9,-2,-4,1,6,-1,1,-6,-4,1,3,2,8,4,0,0,3,-3,3,0,4,1,0,1,1,0,1,0,0,0,2,0,3,1,0,1,38,20,18,29,14,15,6,12,-1,17,6,-2,2,5,2,10,2,0,4,7,-3,7,4,-2,4,7,9,7,1,1,2,1,5,5,0,1,2,6,4,2,1,0,-1,10,-11,16,12,4,-1,1,-3,5,2,-3,1,3,0,4,3,0,-2,-2,-3,1,-1,-3,0,4,8,4,0,0,0,2,8,2,0,0,0,2,0,2,0,0,4,7,-3,21,17,4,3,3,2,-5,-1,1,2,5,3,-3,0,-1,1,-2,-1,-2,-1,2,2,8,8,0,3,0,0,8,6,1,2,0,2,0,2,-1,1,0,-8,4,-12,36,24,12,0,4,-13,6,3,-6,-1,3,-7,4,5,-1,1,1,-6,2,-2,-5,5,17,4,8,1,0,3,11,1,7,1,0,2,6,3,1,0,0,5,15,-10,29,22,7,7,4,1,-3,0,-1,8,1,7,0,-1,1,-1,3,-6,-3,1,-2,5,6,13,4,1,0,4,5,11,2,0,0,1,1,2,2,1,0,-38,-19,-19,15,12,3,-12,3,-14,0,-6,-9,-7,6,-11,2,-5,-4,-5,-3,-3,-2,-1,-5,1,8,1,4,1,0,1,7,1,3,0,0,0,1,0,1,1,0,29,13,16,10,5,5,4,-4,14,2,12,1,3,-5,5,4,6,0,1,1,9,-2,6,1,4,1,2,3,0,0,2,0,1,2,0,0,2,1,1,1,0,0,3,8,-5,6,4,2,0,17,-11,2,0,-4,1,13,-9,3,1,0,-1,4,-2,-1,-1,-4,0,4,1,2,0,-1,0,2,1,2,0,-1,0,2,0,0,0,0,11,1,10,8,2,6,5,12,-1,-4,1,-3,2,4,-2,-6,5,-3,3,8,1,2,-4,0,2,5,0,2,-1,0,1,2,-1,1,-1,0,1,3,1,1,0,0,-12,-4,-8,1,1,0,0,2,-2,-6,0,-5,1,1,-1,-2,0,-2,-1,1,-1,-4,0,-3,1,0,0,0,0,0,1,0,0,0,0,0,0,0,0,0,0,0,-19,-11,-8,1,-1,2,-4,-3,-8,-4,2,-2,-2,2,-7,-1,0,-3,-2,-5,-1,-3,2,1,0,0,0,0,1,0,0,0,-1,0,0,0,0,0,1,0,1,0,-36,-17,-19,-5,-5,0,-10,-4,0,-12,-1,-8,-8,-3,0,-6,2,-2,-2,-1,0,-6,-3,-6,0,0,0,-2,-1,-2,-1,0,-1,-2,-1,0,1,0,1,0,0,-2,-8,-1,-7,3,2,1,3,2,-2,1,-8,-3,5,0,-2,1,-4,-1,-2,2,0,0,-4,-2,1,0,2,0,0,0,1,0,1,0,0,0,0,0,1,0,0,0,-116,-70,-46,-94,-61,-33,-11,-7,-35,-31,-17,-13,-6,-1,-23,-21,-14,-4,-5,-6,-12,-10,-3,-9,-9,-6,-25,-34,-17,-3,-5,-2,-17,-21,-14,-2,-4,-4,-8,-13,-3,-1
4,04003,Adra,21286,168,119,49,218,145,73,38,28,47,40,12,0,21,19,44,28,3,2,17,9,3,12,9,-2,34,45,81,47,7,1,19,30,61,29,4,1,15,15,20,18,3,0,106,33,73,189,108,81,25,36,-14,33,22,5,5,24,-18,14,9,0,20,12,4,19,13,5,20,52,66,38,10,2,9,32,38,23,4,1,11,20,28,15,6,1,-268,-143,-125,93,55,38,-63,-57,-84,-47,-4,-8,-31,-29,-45,-28,-7,-3,-32,-28,-39,-19,3,-5,16,26,26,19,7,-1,6,17,16,13,3,0,10,9,10,6,4,-1,-24,-45,21,183,96,87,5,-4,9,-18,-7,-8,-6,-12,-7,-8,-7,-4,11,8,16,-10,0,-4,46,37,60,31,7,0,20,14,34,21,6,0,26,23,26,10,1,0,544,377,167,575,384,191,85,130,184,95,31,18,45,106,140,58,13,12,40,24,44,37,18,6,70,138,222,110,22,9,36,96,168,64,12,6,34,42,54,46,10,3,433,246,187,520,318,202,35,116,151,79,21,17,3,54,98,51,16,15,32,62,53,28,5,2,65,134,183,101,25,8,36,74,113,70,17,5,29,60,70,31,8,3,187,102,85,295,156,139,33,73,38,18,25,-5,6,46,29,4,14,-1,27,27,9,14,11,-4,60,95,76,35,21,4,30,54,41,18,10,1,30,41,35,17,11,3,172,108,64,374,230,144,18,94,2,14,32,13,21,60,1,5,19,4,-3,34,1,9,13,9,47,137,119,47,19,4,32,89,75,21,10,2,15,48,44,26,9,2,316,172,144,393,211,182,73,100,94,24,16,10,47,55,53,2,12,6,26,45,41,22,4,4,67,114,129,61,20,1,34,60,76,31,10,0,33,54,53,30,10,1,50,44,6,165,83,82,-1,10,44,-5,-6,5,-4,14,38,-1,-3,-4,3,-4,6,-4,-3,9,25,41,66,23,3,5,8,20,36,13,3,2,17,21,30,10,0,3,-83,4,-87,-3,-4,1,-29,12,-31,-11,-17,-4,5,2,5,1,-9,4,-34,10,-36,-12,-8,-8,-16,17,-1,-4,0,0,0,3,1,-8,-2,2,-16,14,-2,4,2,-2,66,-7,73,157,66,91,23,28,-4,3,22,-5,6,4,-16,-3,11,-6,17,24,12,6,11,1,30,60,37,19,7,1,15,25,10,11,3,0,15,35,27,8,4,1,124,29,95,146,58,88,65,22,7,23,2,4,36,-10,1,9,-7,1,29,32,6,14,9,3,36,38,15,31,14,7,23,6,9,15,2,3,13,32,6,16,12,4,24,4,20,79,20,59,3,7,3,-5,-3,13,7,-4,4,-7,1,6,-4,11,-1,2,-4,7,15,32,4,11,7,9,6,9,-2,-2,4,5,9,23,6,13,3,4,-163,-87,-76,-59,-54,-5,-36,-10,-24,-47,-23,-22,-24,-9,-6,-27,-12,-9,-12,-1,-18,-20,-11,-13,-23,7,4,-18,-16,-13,-16,-1,-3,-16,-12,-6,-7,8,7,-2,-4,-7,155,92,63,154,88,66,36,24,37,36,17,-3,12,15,33,21,6,-3,24,9,4,15,11,0,31,28,49,30,13,2,18,16,29,19,4,1,13,12,20,11,9,1,-74,-23,-51,-56,-18,-38,-4,19,-37,-51,-4,-2,-1,27,-8,-31,-13,-5,-3,-8,-29,-20,9,3,-1,32,-15,-48,-19,-5,1,30,11,-34,-19,-7,-2,2,-26,-14,0,2,46,93,-47,93,92,1,13,51,8,-42,14,2,12,53,29,-23,14,4,1,-2,-21,-19,0,-2,17,74,36,-27,-3,-8,14,58,51,-30,1,-5,3,16,-15,3,-4,-3
4,04006,Albox,9671,94,69,25,191,128,63,-8,28,44,14,19,-1,-10,20,21,22,14,2,2,8,23,-8,5,-3,10,55,60,41,20,5,6,37,34,34,13,4,4,18,26,7,7,1,357,342,15,426,349,77,20,109,143,71,19,-6,21,98,136,72,15,0,-1,11,7,-1,4,-6,42,116,158,75,32,2,32,98,135,64,19,1,10,18,23,11,13,1,498,342,156,600,417,183,62,92,124,112,103,4,30,72,105,68,58,8,32,20,19,44,45,-4,80,105,164,133,104,11,39,80,139,89,61,7,41,25,25,44,43,4,472,322,150,549,360,189,71,101,93,119,78,10,49,77,66,85,46,1,22,24,27,34,32,9,77,113,139,123,83,13,45,77,100,83,45,9,32,36,39,40,38,4,653,423,230,639,424,215,88,188,180,113,56,17,44,118,145,76,25,9,44,70,35,37,31,8,86,168,194,107,66,10,47,110,150,72,36,4,39,58,44,35,30,6,144,60,84,364,216,148,55,37,14,14,34,-9,21,22,-3,6,20,-8,34,15,17,8,14,-1,52,56,98,83,57,14,26,32,61,55,31,7,26,24,37,28,26,7,282,109,173,523,297,226,48,86,31,7,93,13,23,32,7,-18,47,13,25,54,24,25,46,0,77,117,113,73,123,17,40,61,69,47,65,12,37,56,44,26,58,5,303,111,192,527,292,235,63,85,49,15,58,23,30,39,14,-6,29,5,33,46,35,21,29,18,88,106,122,86,90,27,40,58,81,47,48,14,48,48,41,39,42,13,74,13,61,309,160,149,10,24,7,0,40,-8,11,9,-14,-6,15,-6,-1,15,21,6,25,-2,54,61,81,52,52,7,28,29,44,28,26,3,26,32,37,24,26,4,9,-11,20,187,99,88,13,15,-38,9,19,-7,0,11,-14,0,-3,-2,13,4,-24,9,22,-5,37,42,35,37,32,5,14,22,23,21,15,4,23,20,12,16,17,1,110,53,57,215,118,97,18,36,-6,14,28,12,12,10,-2,11,13,6,6,26,-4,3,15,6,33,50,41,37,36,15,16,25,25,26,18,7,17,25,16,11,18,8,66,28,38,122,67,55,23,9,10,11,11,1,13,6,5,-3,5,3,10,3,5,14,6,-2,17,26,26,28,18,6,12,17,16,13,4,5,5,9,10,15,14,1,69,55,14,73,44,29,12,6,-10,15,46,1,15,6,-3,16,16,5,-3,0,-7,-1,30,-4,9,10,5,7,39,3,6,11,2,1,20,4,3,-1,3,6,19,-1,75,44,31,78,35,43,27,21,4,5,17,-6,10,12,5,1,9,1,17,9,-1,4,8,-7,20,19,6,11,19,2,9,6,1,7,9,2,11,13,5,4,10,0,-2,-6,4,97,54,43,21,-8,-5,-14,5,-2,14,-2,-1,-12,-5,0,7,-6,-4,-2,10,-2,13,11,16,13,31,13,10,7,10,5,14,8,3,4,6,8,17,5,117,44,73,44,3,41,1,53,6,9,29,8,7,27,-2,-7,12,2,-6,26,8,16,17,6,3,29,1,-17,23,1,2,9,0,-18,7,1,1,20,1,1,16,0,230,142,88,187,105,82,24,50,24,33,72,21,12,34,31,11,35,15,12,16,-7,22,37,6,30,33,33,24,54,13,20,20,21,7,29,8,10,13,12,17,25,5,230,150,80,231,128,103,39,38,45,57,51,0,24,21,32,41,28,2,15,17,13,16,23,-2,33,38,56,36,48,19,20,21,28,23,20,15,13,17,28,13,28,4
4,04011,Alhama de Almería,3124,14,2,12,5,1,4,-2,1,0,-5,9,8,-3,2,-2,-6,5,5,1,-1,2,1,4,3,1,0,1,1,1,1,0,0,0,0,1,0,1,0,1,1,0,1,41,28,13,22,14,8,16,4,0,9,5,6,10,5,-2,7,3,4,6,-1,2,2,2,2,4,3,10,5,0,0,3,1,5,5,0,0,1,2,5,0,0,0,36,17,19,30,19,11,5,0,2,9,10,9,-2,2,2,4,7,4,7,-2,0,5,3,5,9,4,4,7,6,0,5,3,2,5,4,0,4,1,2,2,2,0,76,37,39,32,14,18,6,21,15,7,13,14,3,12,5,3,6,8,3,9,10,4,7,6,6,12,6,5,1,2,2,7,2,2,0,1,4,5,4,3,1,1,93,59,34,63,42,21,26,14,10,18,16,7,13,9,7,9,13,5,13,5,3,9,3,2,14,15,8,15,10,1,9,8,8,8,8,1,5,7,0,7,2,0,81,43,38,75,37,38,7,27,16,17,13,4,4,8,9,9,12,3,3,19,7,8,1,1,9,24,21,11,6,3,5,10,10,5,4,2,4,14,11,6,2,1,55,13,42,27,13,14,15,16,15,1,6,1,0,5,10,-3,3,-2,15,11,5,4,3,3,7,8,8,2,0,1,4,3,4,0,0,1,3,5,4,2,0,0,130,79,51,74,42,32,25,19,26,20,16,21,19,8,20,12,7,11,6,11,6,8,9,10,12,23,21,7,9,2,9,9,13,5,5,1,3,14,8,2,4,1,55,29,26,46,27,19,8,19,15,1,12,-1,0,11,14,-1,5,0,8,8,1,2,7,-1,8,11,21,0,6,-1,3,8,13,1,3,-1,5,3,8,-1,3,0,34,21,13,19,12,7,-10,13,-2,8,8,13,-9,11,0,7,4,6,-1,2,-2,1,4,7,-4,7,8,3,3,2,-2,4,6,2,1,1,-2,3,2,1,2,1,15,19,-4,8,9,-1,-6,2,-12,5,13,12,-2,12,-4,-3,10,5,-4,-10,-8,8,3,7,-2,4,5,-1,0,1,-3,6,3,0,1,1,1,-2,2,-1,-1,0,10,11,-1,30,17,13,10,-2,5,1,-6,1,14,-5,-2,4,-3,1,-4,3,7,-3,-3,0,10,8,8,1,4,-1,7,4,3,2,2,-1,3,4,5,-1,2,0,-6,2,-8,13,5,8,-7,4,-15,0,9,5,-6,5,-2,0,2,5,-1,-1,-13,0,7,0,1,3,2,3,3,1,0,0,3,2,0,0,1,3,-1,1,3,1,-11,0,-11,7,7,0,-12,2,-6,7,-4,-2,-7,0,-1,9,-3,1,-5,2,-5,-2,-1,-3,1,4,-1,2,0,1,1,3,0,2,0,1,0,1,-1,0,0,0,28,5,23,-16,-17,1,19,-1,-7,-3,6,13,10,-8,-7,-3,5,7,9,7,0,0,1,6,0,-2,-6,-10,1,1,-1,-4,-6,-7,0,1,1,2,0,-3,1,0,-33,-19,-14,12,1,11,-5,1,-14,-3,-13,2,-2,-3,-13,1,-7,4,-3,4,-1,-4,-6,-2,2,2,8,1,-2,1,-1,0,2,0,-1,1,3,2,6,1,-1,0,2,-2,4,5,5,0,4,-3,-1,0,-2,3,1,-3,-4,1,2,1,3,0,3,-1,-4,2,2,0,-2,3,2,0,1,0,-1,2,3,0,1,0,-1,1,-1,0,-27,-19,-8,16,3,13,-16,-8,-2,-12,0,10,-9,-3,3,-13,-1,4,-7,-5,-5,1,1,6,4,3,5,1,0,2,1,3,2,-3,0,0,3,0,3,4,0,2
4,04013,Almería,169027,947,565,382,1682,1047,635,172,175,444,167,3,-12,111,140,228,75,1,9,61,35,216,92,2,-21,249,411,610,291,73,37,141,266,405,182,33,15,108,145,205,109,40,22,1394,666,728,2101,1043,1058,362,290,477,259,-31,40,202,137,239,94,-20,18,160,153,238,165,-11,22,470,453,638,393,96,37,235,226,327,188,44,18,235,227,311,205,52,19,852,155,697,2558,1278,1280,437,160,253,98,-72,-30,189,11,-9,47,-73,-16,248,149,262,51,1,-14,604,579,752,397,141,55,302,277,392,206,57,27,302,302,360,191,84,28,641,156,485,2447,1163,1284,378,123,97,105,-55,0,213,40,-46,0,-37,-5,165,83,143,105,-18,5,616,563,681,380,144,41,310,256,332,185,53,16,306,307,349,195,91,25,2782,1642,1140,3667,2387,1280,438,805,793,447,66,235,174,565,495,260,29,119,264,240,298,187,37,116,425,1119,1385,538,135,43,211,778,975,330,65,16,214,341,410,208,70,27,3789,2484,1305,4269,2816,1453,647,1094,1225,602,154,88,324,768,899,396,71,41,323,326,326,206,83,47,590,1324,1525,610,169,23,296,925,1096,387,89,6,294,399,429,223,80,17,1335,815,520,3200,1959,1241,326,648,304,99,-57,-3,222,424,140,61,-32,1,104,224,164,38,-25,-4,496,999,1062,442,131,45,262,649,706,258,57,19,234,350,356,184,74,26,-1289,-997,-292,530,210,320,-129,92,-849,-248,-146,1,-90,-2,-655,-207,-63,11,-39,94,-194,-41,-83,-10,52,536,-2,4,-41,-37,-10,292,-36,-28,-9,-7,62,244,34,32,-32,-30,-1633,-1407,-226,-308,-410,102,-121,-285,-843,-347,-65,18,-89,-255,-775,-291,-24,21,-32,-30,-68,-56,-41,-3,-61,131,-194,-126,-44,-27,-50,4,-230,-117,-22,-4,-11,127,36,-9,-22,-23,272,-188,460,897,299,598,261,150,-166,-15,15,34,171,4,-271,-73,-16,9,90,146,105,58,31,25,279,316,208,37,30,9,160,115,33,-20,6,-2,119,201,175,57,24,11,-290,-302,12,462,184,278,70,-33,-28,-29,-190,-94,26,-66,-62,-12,-144,-45,44,33,34,-17,-46,-49,103,168,102,83,-6,-5,65,56,19,46,-6,-5,38,112,83,37,0,0,430,9,421,474,126,348,202,-54,0,31,116,121,84,-67,-139,3,59,68,118,13,139,28,57,53,156,140,70,40,26,29,82,33,-19,-2,6,17,74,107,89,42,20,12,610,222,388,296,85,211,46,154,144,119,95,70,11,72,24,54,33,35,35,82,120,65,62,35,65,167,37,-5,8,13,25,52,3,-8,0,6,40,115,34,3,8,7,851,385,466,269,100,169,204,117,216,176,136,62,96,70,102,50,51,41,108,47,114,126,85,21,53,93,72,25,18,-4,29,34,31,-10,5,3,24,59,41,35,13,-7,-18,-41,23,-186,-119,-67,163,-43,40,-90,-80,-45,85,-50,25,-26,-60,-27,78,7,15,-64,-20,-18,21,114,-123,-118,-53,-44,28,38,-62,-69,-40,-25,-7,76,-61,-49,-13,-19,607,145,462,-106,-122,16,141,124,28,88,109,110,61,24,-28,-30,62,53,80,100,56,118,47,57,22,149,-68,-152,-55,-20,12,60,-39,-114,-42,-13,10,89,-29,-38,-13,-7,-367,-215,-152,-791,-417,-374,44,75,-87,-365,-123,49,-3,46,-50,-201,-65,44,47,29,-37,-164,-58,5,-12,148,-209,-473,-206,-56,-23,96,-73,-289,-109,-26,11,52,-136,-184,-97,-30,1234,749,485,845,574,271,247,297,179,224,141,116,118,210,140,116,80,51,129,87,39,108,61,65,125,336,285,44,20,16,87,228,207,23,15,2,38,108,78,21,5,14
4,04016,Antas,2677,110,87,23,144,102,42,4,34,46,18,4,2,5,28,35,14,3,2,-1,6,11,4,1,0,14,40,59,27,3,0,9,27,42,22,2,0,5,13,17,5,1,0,64,36,28,108,58,50,-2,44,-3,12,11,0,1,28,-3,4,6,0,-3,16,0,8,5,0,9,52,19,18,8,1,7,30,7,9,5,0,2,22,12,9,3,1,76,36,40,82,41,41,18,11,9,16,20,3,8,-1,5,9,15,0,10,12,4,7,5,3,20,18,21,10,12,1,12,8,10,3,7,1,8,10,11,7,5,0,100,53,47,143,81,62,36,19,12,17,15,4,19,6,7,11,9,3,17,13,5,6,6,1,38,34,36,19,11,5,21,17,23,10,7,3,17,17,13,9,4,2,94,62,32,114,75,39,-4,27,19,21,22,7,-2,20,13,15,11,4,-2,7,6,6,11,3,8,28,33,21,20,4,4,18,24,16,12,1,4,10,9,5,8,3,78,37,41,103,51,52,20,6,30,9,10,3,7,0,17,7,6,0,13,6,13,2,4,3,25,19,32,14,10,3,9,7,20,10,4,1,16,12,12,4,6,2,103,58,45,94,55,39,25,19,12,17,23,8,16,5,12,9,13,4,9,14,0,8,10,4,28,21,16,11,14,2,19,9,8,8,8,2,9,12,8,3,6,0,64,34,30,85,45,40,17,7,9,18,18,-4,10,4,6,6,11,-2,7,3,3,12,7,-2,22,17,18,12,16,0,10,7,13,7,9,-1,12,10,5,5,7,1,16,8,8,50,28,22,-12,4,-6,11,9,5,-3,3,-5,5,6,2,-9,1,-1,6,3,3,6,11,9,16,7,0,6,7,3,8,3,0,0,4,6,8,4,0,-42,-32,-10,-30,-24,-6,3,3,-13,-12,-11,-12,1,7,-13,-11,-10,-6,2,-4,0,-1,-1,-6,3,3,-8,-9,-12,-6,3,0,-8,-7,-7,-4,0,3,0,-2,-5,-2,-28,-15,-13,1,-2,3,4,-10,-10,-10,-4,0,-6,-2,-3,-3,-3,0,10,-8,-7,-7,-1,0,-2,3,-1,-3,0,4,-5,2,3,-3,1,0,3,1,-4,0,-1,4,-61,-29,-32,-3,-6,3,-20,2,-29,-17,3,1,-6,2,-13,-18,3,2,-14,0,-16,1,0,-1,-2,2,-7,-1,4,-1,-1,2,-8,-3,3,0,-1,0,1,2,1,-1,-13,1,-14,13,8,5,-5,5,1,-11,-2,-4,-4,1,6,-6,1,0,-1,4,-5,-5,-3,-4,3,3,8,0,-2,0,1,0,3,0,2,1,2,3,5,0,-4,-1,-146,-79,-67,-106,-59,-47,-14,-23,-24,-34,-31,-18,-5,-7,-14,-24,-19,-9,-9,-16,-10,-10,-12,-9,-13,-9,-13,-31,-24,-16,-5,-5,-6,-21,-14,-8,-8,-4,-7,-10,-10,-8,27,8,19,3,-2,5,21,-3,16,7,-7,-6,12,-4,-3,11,-4,-3,9,1,19,-4,-3,-3,11,3,3,-3,-5,-7,4,0,-1,1,-1,-5,7,3,4,-4,-4,-2,-28,-9,-19,13,9,4,-3,-4,-11,-14,2,3,-8,2,-4,-2,3,1,5,-6,-7,-12,-1,2,4,2,8,-3,4,-2,2,2,6,-2,2,-1,2,0,2,-1,2,-1,-25,-10,-15,14,13,1,-7,-5,-15,-7,7,4,-2,-2,-4,-7,4,2,-5,-3,-11,0,3,2,5,-3,-2,4,6,4,3,0,3,2,2,3,2,-3,-5,2,4,1,43,25,18,25,18,7,9,0,11,9,14,-1,6,0,8,1,9,1,3,0,3,8,5,-2,5,2,5,3,9,0,2,2,4,2,6,1,3,0,1,1,3,-1
4,04017,Arboleas,1540,73,38,35,58,28,30,3,7,7,14,38,3,2,5,0,8,19,4,1,2,7,6,19,-1,6,4,6,7,30,4,2,1,1,4,17,3,4,3,5,3,13,1,165,90,75,125,65,60,11,9,26,19,78,22,9,4,18,9,36,13,2,5,8,10,42,9,2,4,12,19,69,19,2,3,7,9,33,11,0,1,5,10,36,8,236,120,116,173,89,84,37,8,16,39,117,20,24,3,7,19,58,10,13,5,9,20,59,10,22,8,13,28,88,14,15,4,5,13,43,9,7,4,8,15,45,5,327,187,140,278,151,127,8,18,38,50,175,35,5,12,25,26,94,23,3,6,13,24,81,12,15,19,34,41,141,28,8,10,21,19,76,17,7,9,13,22,65,11,503,267,236,464,242,222,32,21,42,96,248,64,14,16,25,49,124,39,18,5,17,47,124,25,32,25,45,75,236,51,13,16,27,36,119,31,19,9,18,39,117,20,563,327,236,525,308,217,25,66,78,93,241,60,12,48,45,54,126,42,13,18,33,39,115,18,28,67,77,90,215,48,12,48,47,53,114,34,16,19,30,37,101,14,479,222,257,491,232,259,46,16,21,89,253,54,14,5,2,38,126,37,32,11,19,51,127,17,57,23,32,97,230,50,20,10,15,37,116,34,37,13,17,60,114,16,380,168,212,380,168,212,34,6,-21,65,259,36,16,-4,-21,19,133,22,18,10,0,46,126,14,36,7,3,69,223,40,16,-3,-8,20,113,28,20,10,11,49,110,12,222,92,130,231,103,128,25,-6,0,31,139,32,13,-6,-1,10,63,14,12,0,1,21,76,18,24,2,13,40,130,22,12,-1,5,15,59,13,12,3,8,25,71,9,226,102,124,203,97,106,23,12,21,30,113,26,8,7,9,10,50,17,15,5,12,20,63,9,17,6,13,34,105,28,6,2,7,17,46,19,11,4,6,17,59,9,172,96,76,168,95,73,10,1,6,32,98,23,7,-1,5,17,54,14,3,2,1,15,44,9,12,4,16,26,93,16,9,1,9,14,51,11,3,3,7,12,42,5,114,65,49,126,67,59,8,-3,10,29,62,8,8,0,7,15,32,3,0,-3,3,14,30,5,15,4,4,23,68,11,11,2,1,11,34,7,4,2,3,12,34,4,144,66,78,124,60,64,10,7,1,28,86,10,-1,2,-1,14,43,9,11,5,2,14,43,1,9,6,3,26,65,14,2,2,0,14,34,8,7,4,3,12,31,6,71,40,31,89,46,43,8,-7,-1,16,55,4,9,1,-5,6,27,5,-1,-8,4,10,28,-1,6,3,9,15,48,8,6,3,2,6,23,6,0,0,7,9,25,2,176,96,80,189,94,95,1,7,25,30,106,6,4,5,13,9,62,1,-3,2,12,21,44,5,5,6,16,29,108,24,3,3,6,11,57,14,2,3,10,18,51,10,64,38,26,110,59,51,-4,-6,-1,-4,89,-11,1,-4,-2,-5,44,4,-5,-2,1,1,45,-15,2,-3,-3,5,101,8,3,-2,-3,0,50,11,-1,-1,0,5,51,-3,-2,-12,10,19,-2,21,20,-32,-23,-4,126,-88,10,-13,-8,-9,53,-44,10,-19,-15,5,73,-44,14,-30,-17,-7,131,-72,7,-12,-6,-11,58,-38,7,-18,-11,4,73,-34,-181,-83,-98,-152,-74,-78,21,-21,-39,-16,49,-175,13,-9,-28,0,25,-83,8,-12,-11,-16,24,-92,9,-19,-28,-14,50,-150,3,-8,-19,-2,27,-75,6,-11,-9,-12,23,-75
4,04022,Bédar,566,27,21,6,21,13,8,6,2,0,6,12,1,6,2,1,2,9,1,0,0,-1,4,3,0,4,0,2,4,10,1,3,0,1,1,7,1,1,0,1,3,3,0,48,25,23,57,30,27,10,-3,2,15,22,2,4,-3,2,6,13,3,6,0,0,9,9,-1,10,0,4,15,22,6,5,0,2,6,11,6,5,0,2,9,11,0,52,23,29,36,18,18,0,1,5,12,28,6,-2,1,1,4,15,4,2,0,4,8,13,2,0,1,3,7,22,3,0,1,1,2,12,2,0,0,2,5,10,1,103,49,54,92,44,48,22,-3,7,28,47,1,7,-2,3,14,25,2,15,-1,4,14,22,-1,16,1,8,18,41,8,4,0,4,8,22,6,12,1,4,10,19,2,42,29,13,54,31,23,-3,0,6,11,19,9,2,0,5,9,7,6,-5,0,1,2,12,3,3,2,8,13,21,7,1,1,5,9,10,5,2,1,3,4,11,2,46,27,19,56,30,26,7,1,9,13,20,-5,3,-1,5,9,12,-1,4,2,4,4,8,-4,6,2,7,15,25,0,2,1,5,9,13,0,4,1,2,6,12,0,76,38,38,69,42,27,5,10,4,15,33,8,1,9,-3,6,23,2,4,1,7,9,10,6,4,7,3,10,34,11,1,7,0,7,21,6,3,0,3,3,13,5,73,36,37,75,35,40,6,4,8,20,24,10,1,3,5,8,10,9,5,1,3,12,14,1,12,5,4,19,24,10,4,5,1,8,10,7,8,0,3,11,14,3,46,18,28,42,20,22,6,4,8,8,18,1,0,1,3,3,8,2,6,3,5,5,10,-1,5,3,4,11,16,2,2,1,2,5,8,1,3,2,2,6,8,1,36,20,16,32,14,18,-4,-4,7,8,21,6,0,-1,3,6,11,0,-4,-3,4,2,10,6,1,0,1,9,13,6,0,0,0,3,8,2,1,0,1,6,5,4,27,11,16,23,7,16,2,-2,3,6,16,2,2,-1,1,2,6,1,0,-1,2,4,10,1,3,-2,0,5,13,4,2,-1,-1,-1,6,2,1,-1,1,6,7,2,25,15,10,28,14,14,1,4,3,4,23,-9,3,1,4,-1,11,-3,-2,3,-1,5,12,-6,1,0,0,3,21,3,1,0,1,0,10,2,0,0,-1,3,11,1,42,30,12,27,15,12,5,-2,3,18,6,12,2,-1,2,12,4,11,3,-1,1,6,2,1,2,0,1,10,6,8,0,1,0,5,4,5,2,-1,1,5,2,3,26,13,13,23,9,14,-3,-1,7,4,13,7,0,-2,5,5,5,0,-3,1,2,-1,8,7,0,1,5,1,9,7,0,0,3,0,4,2,0,1,2,1,5,5,48,22,26,39,21,18,11,3,-3,10,24,3,5,2,-4,2,15,2,6,1,1,8,9,1,5,0,2,7,20,5,2,0,1,3,12,3,3,0,1,4,8,2,9,3,6,30,14,16,-7,2,-4,-1,16,2,-6,-1,-2,1,8,3,-1,3,-2,-2,8,-1,1,4,4,5,12,3,1,0,2,1,7,3,0,4,2,4,5,0,-155,-81,-74,-141,-73,-68,-18,-11,-14,-26,-23,-61,-9,-2,-14,-17,-14,-25,-9,-9,0,-9,-9,-36,-13,-12,-10,-25,-26,-55,-7,-3,-11,-14,-14,-24,-6,-9,1,-11,-12,-31,64,36,28,66,36,30,3,2,3,8,37,12,4,1,3,2,21,6,-1,1,0,6,16,6,5,2,2,12,34,11,4,0,1,6,18,7,1,2,1,6,16,4
4,04024,Benahadux,2775,44,29,15,8,3,5,15,6,8,1,4,8,11,3,9,-1,0,4,4,3,-1,2,4,4,2,1,0,2,2,1,1,0,0,1,1,0,1,1,0,1,1,1,33,12,21,13,7,6,11,16,4,-5,3,2,4,5,0,-6,4,3,7,11,4,1,-1,-1,1,6,3,0,1,2,1,2,2,0,0,2,0,4,1,0,1,0,25,21,4,15,7,8,12,4,8,-2,2,-1,13,6,-1,2,2,-1,-1,-2,9,-4,0,0,4,3,5,2,1,0,2,2,2,1,0,0,2,1,3,1,1,0,82,41,41,12,6,6,22,11,26,8,5,10,9,5,13,4,4,4,13,6,13,4,1,6,1,3,3,4,1,0,0,1,1,3,1,0,1,2,2,1,0,0,133,88,45,30,16,14,19,25,43,22,16,8,17,15,25,18,7,5,2,10,18,4,9,3,3,9,9,6,3,0,2,7,4,2,1,0,1,2,5,4,2,0,183,89,94,26,12,14,31,26,85,21,13,4,13,10,44,14,6,-1,18,16,41,7,7,5,6,7,6,4,2,1,4,2,1,3,1,1,2,5,5,1,1,0,139,69,70,15,5,10,20,28,70,16,0,4,6,14,40,8,1,0,14,14,30,8,-1,4,3,4,2,3,1,2,1,2,0,1,0,1,2,2,2,2,1,1,190,93,97,21,11,10,31,46,91,18,-3,2,15,20,42,12,-1,0,16,26,49,6,-2,2,6,7,5,3,0,0,4,2,3,2,0,0,2,5,2,1,0,0,101,74,27,42,30,12,-1,26,50,9,7,9,-4,20,42,9,6,1,3,6,8,0,1,8,7,13,17,4,3,-2,3,10,14,2,2,-1,4,3,3,2,1,-1,89,54,35,28,20,8,5,15,53,4,2,11,6,9,31,4,2,3,-1,6,22,0,0,8,2,14,9,1,1,1,2,11,6,0,1,0,0,3,3,1,0,1,76,32,44,12,-5,17,9,27,19,-1,17,5,2,16,9,2,3,1,7,11,10,-3,14,4,4,2,2,1,3,-2,1,-3,-4,0,1,-1,3,5,6,1,2,-1,11,-7,18,12,7,5,-3,-1,23,4,-10,-5,-7,-8,7,4,-2,-1,4,7,16,0,-8,-4,3,2,0,2,3,2,3,0,0,2,1,1,0,2,0,0,2,1,7,3,4,9,7,2,5,2,9,-2,-9,2,2,-2,8,-5,-1,1,3,4,1,3,-8,1,3,1,4,1,0,0,3,1,2,1,0,0,0,0,2,0,0,0,-33,-22,-11,-3,0,-3,-5,3,-30,-4,5,-4,0,2,-20,-3,1,-3,-5,1,-10,-1,4,-1,0,-1,-2,3,-2,-1,0,0,-1,3,-2,0,0,-1,-1,0,0,-1,-19,-7,-12,17,4,13,-9,11,0,-12,-5,-4,-5,9,7,-11,-5,-4,-4,2,-7,-1,0,0,-1,7,2,8,2,-1,-1,1,1,2,2,-1,0,6,1,6,0,0,17,11,6,1,-5,6,11,4,-4,4,-7,8,12,2,-12,3,0,4,-1,2,8,1,-7,4,0,1,-4,2,-1,3,0,0,-6,0,0,1,0,1,2,2,-1,2,-108,-61,-47,-117,-63,-54,-18,-27,-14,-39,-5,-6,-13,-13,-2,-21,-6,-6,-5,-14,-12,-18,1,0,-16,-13,-25,-41,-12,-11,-6,-4,-12,-25,-10,-7,-10,-9,-13,-16,-2,-4,88,42,46,8,7,1,21,22,26,18,7,-7,8,10,20,4,3,-1,13,12,6,14,4,-6,1,1,3,-1,1,2,1,1,2,0,0,2,0,0,1,-1,1,0
4,04031,Cantoria,3206,6,13,-7,24,16,8,0,5,-14,10,5,1,1,4,-5,9,2,2,-1,1,-9,1,3,-1,1,7,4,4,4,4,1,5,3,2,2,3,0,2,1,2,2,1,88,38,50,77,37,40,10,9,20,12,35,3,5,1,7,5,19,2,5,8,13,7,16,1,8,9,14,21,21,4,5,1,4,12,13,2,3,8,10,9,8,2,60,37,23,90,48,42,21,-3,15,15,13,-1,12,0,3,9,11,2,9,-3,12,6,2,-3,22,9,27,16,12,4,12,5,11,11,6,3,10,4,16,5,6,1,162,90,72,136,74,62,26,19,35,36,42,2,17,11,18,16,22,5,9,8,17,20,20,-3,17,18,28,22,44,6,10,11,16,10,22,5,7,7,12,12,22,1,138,69,69,136,72,64,25,22,16,42,30,1,17,12,2,24,12,2,8,10,14,18,18,-1,25,15,20,35,37,4,15,13,7,17,18,2,10,2,13,18,19,2,136,64,72,132,69,63,26,10,20,17,57,3,8,3,9,9,30,4,18,7,11,8,27,-1,21,15,25,15,47,7,6,11,13,10,24,5,15,4,12,5,23,2,174,97,77,189,106,83,15,25,6,27,91,7,8,11,5,16,48,6,7,14,1,11,43,1,23,22,28,29,68,17,14,12,15,17,36,10,9,10,13,12,32,7,147,79,68,159,80,79,14,20,15,14,73,15,10,8,12,4,36,12,4,12,3,10,37,3,14,19,26,19,69,12,6,12,11,10,34,7,8,7,15,9,35,5,48,25,23,77,42,35,5,-10,9,12,40,-8,2,-6,8,7,17,-3,3,-4,1,5,23,-5,9,5,10,16,34,1,3,3,6,9,18,1,6,2,4,7,16,0,9,12,-3,49,23,26,0,2,-11,4,13,2,1,0,4,0,5,3,-1,2,-15,4,8,-1,4,4,10,7,20,4,3,1,5,3,10,1,1,3,5,4,10,3,56,24,32,23,10,13,8,8,-2,15,28,-1,1,3,-2,3,19,0,7,5,0,12,9,-1,5,2,2,5,9,0,1,1,1,1,7,-1,4,1,1,4,2,1,-156,-78,-78,-86,-57,-29,-18,-21,-56,-22,-25,-13,-4,-6,-35,-11,-19,-2,-14,-15,-21,-11,-6,-11,-13,-12,-37,-15,-8,-2,-6,-4,-29,-12,-6,0,-7,-8,-8,-3,-2,-2,6,-3,9,16,9,7,1,1,-14,0,16,2,-5,-2,-11,2,9,3,6,3,-3,-2,7,-1,-1,0,-3,1,15,4,-2,-2,-3,4,8,4,1,2,0,-3,7,0,4,3,1,12,14,-2,-5,0,-15,12,11,-2,-7,2,-13,7,2,8,2,-2,-2,5,9,-10,-2,1,-2,7,9,-2,0,2,-1,4,5,3,-2,-1,-1,3,4,-5,47,12,35,25,5,20,6,0,8,13,25,-3,-4,-2,-2,8,11,1,10,2,10,5,14,-4,4,2,-5,7,15,2,1,1,-3,0,6,0,3,1,-2,7,9,2,-17,-9,-8,28,16,12,-11,-3,-7,-8,15,-2,-5,-4,0,-8,9,-1,-6,1,-7,0,6,-1,0,-2,-1,6,19,6,0,-1,0,3,10,4,0,-1,-1,3,9,2,14,8,6,54,32,22,6,-7,-10,3,23,-2,4,1,-6,0,11,-1,2,-8,-4,3,12,-1,3,-2,3,9,26,14,3,1,0,6,14,8,0,-3,3,3,12,6,32,17,15,53,24,29,5,-3,-4,4,24,5,-2,-3,1,9,13,-2,7,0,-5,-5,11,7,5,4,2,8,31,2,0,1,1,5,18,-2,5,3,1,3,13,4
4,04032,Carboneras,6360,55,23,32,109,54,55,-9,27,35,0,0,0,-7,3,27,-4,1,0,-2,24,8,4,-1,0,15,29,38,16,10,1,7,11,23,7,5,1,8,18,15,9,5,0,72,41,31,126,68,58,14,20,15,8,9,5,7,7,15,4,6,2,7,13,0,4,3,3,25,22,32,33,11,3,11,11,20,19,6,1,14,11,12,14,5,2,114,75,39,141,78,63,18,32,20,20,23,5,20,16,11,17,11,3,-2,16,9,3,12,2,29,35,38,23,15,1,16,21,21,12,8,0,13,14,17,11,7,1,154,77,77,84,43,41,24,29,62,16,9,5,6,8,39,11,4,3,18,21,23,5,5,2,15,19,27,13,5,2,6,8,16,6,4,1,9,11,11,7,1,1,96,90,6,118,90,28,6,13,46,16,12,5,11,17,45,8,5,5,-5,-4,1,8,7,0,11,24,42,25,13,3,7,19,34,18,9,3,4,5,8,7,4,0,191,122,69,162,101,61,-4,47,54,44,36,10,3,27,36,34,14,5,-7,20,18,10,22,5,18,42,40,36,18,6,10,23,28,27,8,3,8,19,12,9,10,3,140,57,83,122,64,58,35,21,0,34,36,14,11,11,4,9,18,5,24,10,-4,25,18,9,18,33,22,27,17,4,9,19,15,13,5,2,9,14,7,14,12,2,119,59,60,126,77,49,17,36,45,-8,18,7,5,23,11,3,12,3,12,13,34,-11,6,4,22,32,36,18,16,1,9,23,22,15,8,0,13,9,14,3,8,1,118,62,56,92,43,49,8,11,44,38,19,-3,0,12,23,17,12,-2,8,-1,21,21,7,-1,6,15,35,21,9,4,-2,10,20,8,4,2,8,5,15,13,5,2,100,45,55,126,73,53,-4,26,31,29,8,11,2,5,19,17,-2,6,-6,21,12,12,10,5,4,27,41,34,11,9,3,12,26,20,5,7,1,15,15,14,6,2,75,40,35,70,36,34,7,15,5,29,14,6,8,12,-3,14,9,2,-1,3,8,15,5,4,8,26,21,7,3,4,8,15,8,4,-1,2,0,11,13,3,4,2,-66,-29,-37,29,18,11,-22,-2,-16,-27,-2,1,-12,5,-4,-12,-2,-5,-10,-7,-12,-15,0,6,1,7,9,1,7,4,1,6,6,-1,4,2,0,1,3,2,3,2,-79,-51,-28,3,-1,4,-11,-15,-37,-28,7,2,0,-11,-31,-16,4,1,-11,-4,-6,-12,3,1,-1,1,-2,2,0,1,0,1,-3,1,-2,1,-1,0,1,1,2,0,-163,-107,-56,-184,-98,-86,-9,-35,-33,-53,-24,-9,3,-24,-23,-38,-17,-10,-12,-11,-10,-15,-7,1,-26,-23,-36,-48,-29,-24,-10,-13,-16,-30,-17,-14,-16,-10,-20,-18,-12,-10,20,23,-3,43,26,17,0,7,-15,-15,37,8,9,-1,-3,-10,22,6,-9,8,-12,-5,15,2,6,10,4,0,18,4,4,4,5,0,10,3,2,6,-1,0,8,1,-66,-44,-22,-42,-36,-6,-4,0,-29,-16,-10,-6,-1,1,-20,-8,-14,-2,-3,-1,-9,-8,4,-4,2,2,-17,-16,-5,-10,2,0,-17,-13,-6,-4,0,2,0,-3,1,-6,37,23,14,16,4,12,21,-6,9,11,9,-8,17,0,-1,9,2,-4,4,-6,10,2,7,-4,11,-2,5,5,4,-8,10,-1,-3,3,1,-6,1,-1,8,2,3,-2,-121,-70,-51,-33,-18,-15,-11,-4,-29,-31,-25,-18,-11,0,-20,-15,-7,-15,0,-4,-9,-16,-18,-3,6,9,-9,-11,-12,-16,3,3,-3,-9,-2,-10,3,6,-6,-2,-10,-6
4,04037,Chirivel,1824,12,6,6,4,3,1,2,0,7,-2,4,0,0,-1,5,-1,2,1,2,1,2,-1,2,-1,1,0,2,0,1,0,1,0,1,0,1,0,0,0,1,0,0,0,5,1,4,21,13,8,-2,5,-3,-3,5,3,-3,3,0,-3,3,1,1,2,-3,0,2,2,2,8,3,1,6,1,1,5,3,1,3,0,1,3,0,0,3,1,14,6,8,19,10,9,-3,4,1,11,5,-4,-5,4,2,5,2,-1,2,0,-1,6,3,-3,1,2,4,6,6,0,0,2,3,2,3,0,1,0,1,4,3,0,33,16,17,36,16,20,5,5,-6,12,14,4,1,2,-6,6,9,5,4,3,0,6,5,-1,11,2,4,8,8,3,4,1,1,3,5,2,7,1,3,5,3,1,50,24,26,47,20,27,6,8,13,7,20,-4,1,6,4,6,9,-2,5,2,9,1,11,-2,7,2,11,10,17,0,1,3,4,4,8,0,6,-1,7,6,9,0,9,9,0,33,19,14,1,-6,-5,4,13,2,2,0,-5,3,6,3,-1,-6,0,1,7,-1,6,0,4,7,13,3,4,0,1,5,8,1,2,0,3,2,5,2,-33,-17,-16,27,16,11,-10,-9,-20,6,10,-9,-6,-4,-11,5,3,-3,-4,-5,-9,1,7,-6,0,1,2,7,16,1,0,1,2,3,9,1,0,0,0,4,7,0,57,22,35,44,21,23,17,2,10,-2,19,11,8,1,4,-4,7,6,9,1,6,2,12,5,10,1,6,8,17,2,5,1,3,2,8,2,5,0,3,6,9,0,34,31,3,31,28,3,14,8,1,-7,9,7,13,9,2,-5,6,5,1,-1,-1,-2,3,2,15,9,2,1,2,2,14,8,1,1,2,2,1,1,1,0,0,0,26,26,0,31,22,9,10,2,-4,-3,13,8,13,3,1,1,6,2,-3,-1,-5,-4,7,6,13,10,-1,0,9,0,12,8,-1,0,3,0,1,2,0,0,6,0,11,4,7,3,4,-1,8,-7,-2,8,2,1,6,-5,0,3,-1,1,2,-2,-2,5,3,0,1,7,-1,-3,-1,0,1,7,-1,-2,-1,0,0,0,0,-1,0,0,-5,-2,-3,0,4,-4,-7,8,-2,2,1,-7,-2,3,-3,2,3,-5,-5,5,1,0,-2,-2,2,2,-2,-1,1,-2,3,2,-1,0,1,-1,-1,0,-1,-1,0,-1,-9,1,-10,9,12,-3,9,-3,1,-11,0,-4,12,-5,2,-7,3,-3,-3,2,-1,-4,-3,-1,8,6,-1,-2,0,-2,8,6,0,-1,1,-2,0,0,-1,-1,-1,0,-25,-16,-9,0,3,-3,8,-15,-15,2,-3,-2,7,-17,-8,4,-1,-1,1,2,-7,-2,-2,-1,4,2,-2,-2,-2,0,4,3,-2,-1,-1,0,0,-1,0,-1,-1,0,-103,-64,-39,-48,-25,-23,-14,-21,-21,-21,-20,-6,-10,-18,-12,-4,-12,-8,-4,-3,-9,-17,-8,2,-5,-9,-3,-7,-14,-10,-1,-6,-2,-2,-7,-7,-4,-3,-1,-5,-7,-3,31,20,11,7,9,-2,2,-13,-4,3,6,37,3,-8,-3,3,6,18,-1,-5,-1,0,0,19,7,-1,0,-1,1,1,7,2,-1,0,1,0,0,-3,1,-1,0,1,26,16,10,9,8,1,2,4,1,4,0,14,3,1,-1,0,4,8,-1,3,2,4,-4,6,3,4,-2,-1,5,0,2,5,-2,0,3,0,1,-1,0,-1,2,0,-13,-10,-3,-8,0,-8,6,-7,-3,-1,-7,-1,2,-5,-3,2,-4,-2,4,-2,0,-3,-3,1,3,4,0,1,-7,-9,3,4,0,1,-2,-6,0,0,0,0,-5,-3
4,04035,Cuevas del Almanzora,9584,508,358,150,534,372,162,17,156,176,127,20,2,8,100,134,97,9,2,9,56,42,30,11,0,20,158,202,123,18,4,11,106,144,91,10,3,9,52,58,32,8,1,248,134,114,300,173,127,42,68,60,56,16,3,24,29,38,34,7,0,18,39,22,22,9,3,51,70,100,55,18,4,29,37,62,33,7,3,22,33,38,22,11,1,297,174,123,405,234,171,69,103,44,52,21,5,46,59,33,22,10,1,23,44,11,30,11,4,82,111,103,75,26,6,53,54,70,39,14,3,29,57,33,36,12,3,449,236,213,489,278,211,105,89,93,68,72,15,47,52,50,42,33,10,58,37,43,26,39,5,99,105,119,82,64,17,51,63,68,51,32,12,48,42,51,31,32,5,451,291,160,413,285,128,58,74,143,83,63,14,22,52,112,45,37,9,36,22,31,38,26,5,41,93,134,71,49,17,21,65,107,42,30,12,20,28,27,29,19,5,185,95,90,152,63,89,57,15,30,30,42,12,35,0,22,9,21,10,22,15,8,21,21,2,29,16,17,35,45,10,11,6,3,14,21,8,18,10,14,21,24,2,596,334,262,324,151,173,124,80,155,139,76,11,67,34,93,84,40,9,57,46,62,55,36,2,60,50,54,76,69,14,33,16,20,38,35,9,27,34,34,38,34,5,796,447,349,636,403,233,134,168,216,128,114,35,63,97,140,67,58,22,71,71,76,61,56,13,99,134,186,111,87,18,57,88,139,62,46,10,42,46,47,49,41,8,468,317,151,559,344,215,56,147,131,63,63,17,33,107,94,50,33,5,23,40,37,13,30,12,78,155,165,82,63,16,42,95,117,54,30,6,36,60,48,28,33,10,-5,-2,-3,162,86,76,-18,17,-27,-2,28,-1,-8,5,-14,0,13,4,-10,12,-13,-2,15,-5,27,44,20,21,40,9,15,24,14,9,19,5,12,20,6,12,21,4,107,65,42,199,110,89,6,37,24,21,7,10,5,24,18,6,4,6,1,13,6,15,3,4,29,49,58,10,30,20,16,24,40,4,12,11,13,25,18,6,18,9,-75,-81,6,45,3,42,14,16,-80,-36,11,-3,4,-5,-69,-19,6,-2,10,21,-11,-17,5,-1,11,30,-3,-1,8,-2,3,11,-14,-3,4,0,8,19,11,2,4,-2,-14,-19,5,54,11,43,11,2,-29,-27,3,25,7,-6,-24,-7,-2,15,4,8,-5,-20,5,10,19,14,-7,-5,19,13,9,-3,-10,-4,11,7,10,17,3,-1,8,6,-82,-42,-40,-28,-26,-2,-3,23,-61,-47,-2,9,2,17,-37,-41,6,10,-5,6,-24,-6,-8,-1,0,15,-37,-39,19,11,-1,9,-18,-34,11,7,1,6,-19,-5,8,4,72,58,14,122,60,62,20,24,9,21,11,-14,14,15,19,11,10,-8,6,9,-10,10,1,-6,21,25,31,22,17,4,6,12,24,7,9,3,15,13,7,15,8,1,-210,-96,-114,-200,-112,-88,-5,-13,-45,-85,-27,-39,16,-15,-21,-52,-11,-15,-21,2,-24,-33,-16,-24,-12,-6,-35,-82,-25,-41,4,-10,-29,-48,-11,-18,-16,4,-6,-34,-14,-23,229,149,80,186,104,82,43,44,64,27,38,16,18,30,39,24,31,10,25,14,25,3,7,6,35,46,34,29,21,20,18,31,23,10,9,12,17,15,11,19,12,8,128,73,55,197,102,95,28,18,19,20,36,6,17,11,15,13,9,7,11,7,4,7,27,-1,28,38,50,23,41,17,16,18,26,14,17,11,12,20,24,9,24,6
4,04038,Dalías,3663,17,2,15,49,32,17,6,14,4,1,-2,-5,-3,10,-4,3,-1,-3,9,4,8,-2,-1,-2,7,15,19,6,0,2,3,10,13,5,0,1,4,5,6,1,0,1,-17,-5,-12,18,9,9,-6,3,-8,-9,1,2,0,-2,0,-7,2,2,-6,5,-8,-2,-1,0,2,8,6,1,0,1,1,4,3,0,0,1,1,4,3,1,0,0,-25,-8,-17,13,9,4,5,-16,-13,-3,1,3,8,-7,-11,-3,5,2,-3,-9,-2,0,-4,1,3,2,5,2,0,1,2,1,4,1,0,1,1,1,1,1,0,0,15,-3,18,7,3,4,10,-5,3,-4,8,4,6,-6,-1,-4,4,-2,4,1,4,0,4,6,0,4,3,-1,1,0,0,1,3,-1,0,0,0,3,0,0,1,0,79,48,31,46,33,13,13,23,27,4,11,2,10,13,15,2,5,3,3,10,12,2,6,-1,6,14,19,7,0,0,5,12,11,5,0,0,1,2,8,2,0,0,23,7,16,32,20,12,10,3,7,6,1,-3,0,0,7,1,-1,2,10,3,0,5,2,-5,5,7,13,5,2,0,2,6,8,3,1,0,3,1,5,2,1,0,40,20,20,21,8,13,7,9,2,2,16,2,6,-2,7,-1,8,2,1,11,-5,3,8,0,5,7,8,0,1,0,1,2,5,0,0,0,4,5,3,0,1,0,71,39,32,18,8,10,14,22,14,11,7,3,5,14,10,6,4,0,9,8,4,5,3,3,2,8,6,2,0,0,1,5,1,1,0,0,1,3,5,1,0,0,19,12,7,11,6,5,10,2,2,1,0,3,7,-1,2,0,-1,3,3,3,0,1,1,0,3,4,4,0,0,0,2,2,2,0,0,0,1,2,2,0,0,0,46,35,11,7,3,4,20,14,5,15,-2,-5,13,8,1,12,0,1,7,6,4,3,-2,-6,4,4,-1,0,0,0,3,1,-2,1,0,0,1,3,1,-1,0,0,5,4,1,11,6,5,-11,-1,8,3,4,2,-7,2,7,-3,4,1,-4,-3,1,6,0,1,2,2,3,4,0,0,2,1,2,1,0,0,0,1,1,3,0,0,25,-2,27,-9,-8,-1,9,9,8,-4,-9,9,2,2,4,-7,-7,3,7,7,4,3,-2,6,-5,4,-6,0,-2,0,-4,1,-4,-1,0,0,-1,3,-2,1,-2,0,-32,-15,-17,3,2,1,4,-10,-22,4,-1,-7,0,-1,-9,0,0,-4,4,-9,-13,4,-1,-3,2,2,-5,3,-1,0,0,2,-3,2,0,0,2,0,-2,1,-1,0,-1,-4,3,-1,-1,0,13,0,1,5,-8,-9,5,2,-2,2,-6,-3,8,-2,3,3,-2,-6,2,1,-3,0,-1,0,3,-1,-2,-1,0,0,-1,2,-1,1,-1,0,-19,-2,-17,-2,-1,-1,-6,-3,-11,-1,9,-1,1,-3,-2,-4,8,2,-7,0,-9,3,1,-3,0,-1,-6,4,1,0,0,-2,-3,3,1,0,0,1,-3,1,0,0,11,3,8,22,11,11,8,4,0,0,0,0,4,-1,0,4,-3,-1,4,5,0,-4,3,1,3,5,7,4,0,1,2,1,3,4,0,0,1,4,4,0,0,1,28,23,5,11,8,3,2,10,2,1,9,5,2,8,5,-1,7,2,0,2,-3,2,2,3,2,3,2,4,1,-1,0,2,2,3,1,0,2,1,0,1,0,-1,29,13,16,3,4,-1,13,0,4,3,13,-4,8,-2,2,-3,10,-1,5,2,2,6,3,-3,4,1,4,-7,2,-1,2,2,5,-6,2,-1,2,-1,-1,-1,0,0
4,04902,"Ejido, El",51485,1856,1411,445,2216,1792,424,178,669,722,216,34,24,109,518,590,159,24,7,69,151,132,57,10,17,188,716,967,286,34,10,105,602,833,219,22,5,83,114,134,67,12,5,910,427,483,1241,765,476,230,246,274,84,27,43,131,115,114,21,18,26,99,131,160,63,9,17,275,301,427,189,32,7,154,177,280,129,18,2,121,124,147,60,14,5,1200,377,823,1875,1063,812,492,229,236,164,53,21,250,48,6,50,11,6,242,181,230,114,42,15,458,417,595,301,76,17,234,230,370,177,38,10,224,187,225,124,38,7,1078,192,886,1835,937,898,457,246,145,141,59,23,216,30,-95,2,28,2,241,216,240,139,31,21,508,432,536,268,69,13,250,207,292,139,36,8,258,225,244,129,33,5,3535,2378,1157,4712,3497,1215,323,1305,1348,436,78,31,179,905,957,274,41,16,144,400,391,162,37,15,441,1536,2000,602,99,20,235,1155,1584,440,62,12,206,381,416,162,37,8,6334,4561,1773,6026,4498,1528,658,1964,2447,864,231,166,396,1518,1834,609,125,72,262,446,613,255,106,94,614,1941,2402,818,183,52,331,1509,1918,601,105,24,283,432,484,217,78,28,2028,1282,746,3217,2250,967,479,866,496,108,10,63,275,691,248,43,-3,21,204,175,248,65,13,42,571,1126,1078,315,83,24,303,891,793,199,40,12,268,235,285,116,43,12,1920,1040,880,3078,2071,1007,257,1234,255,49,49,84,125,951,-31,-69,28,34,132,283,286,118,21,50,357,1455,925,258,59,15,194,1135,580,113,32,11,163,320,345,145,27,4,2328,1558,770,2829,1935,894,119,1658,643,-160,20,50,96,1340,342,-250,0,29,23,318,301,90,20,21,193,1745,890,-7,1,-9,114,1411,565,-157,-7,-3,79,334,325,150,8,-6,474,-40,514,1658,997,661,169,161,10,39,24,55,95,-19,-156,6,-2,28,74,180,166,33,26,27,192,589,629,175,50,8,104,383,384,100,12,7,88,206,245,75,38,1,-2396,-2354,-42,-738,-856,118,79,-618,-1417,-395,-43,-20,74,-684,-1389,-313,-42,-10,5,66,-28,-82,-1,-10,48,-43,-524,-193,-14,-25,39,-125,-569,-172,-30,-8,9,82,45,-21,16,-17,-1521,-1631,110,-944,-1166,222,99,-204,-1131,-310,-33,56,30,-305,-1056,-282,-46,27,69,101,-75,-28,13,29,88,-40,-756,-232,-22,4,28,-149,-760,-254,-38,0,60,109,4,22,16,4,-973,-838,-135,-1260,-1060,-200,-11,19,-535,-332,-81,-56,12,-40,-476,-262,-46,-39,-23,59,-59,-70,-35,-17,-45,-16,-633,-409,-103,-63,-18,-67,-565,-318,-60,-39,-27,51,-68,-91,-43,-24,290,204,86,-98,-103,5,47,151,117,-24,-22,8,2,49,133,19,-7,-4,45,102,-16,-43,-15,12,35,100,-62,-81,-59,-49,14,25,-48,-49,-30,-27,21,75,-14,-32,-29,-22,946,649,297,474,268,206,110,243,387,137,-6,62,71,140,283,145,-14,18,39,103,104,-8,8,44,133,173,198,-1,-23,-16,71,109,109,8,-25,-8,62,64,89,-9,2,-8,1868,1520,348,1592,1163,429,66,396,762,450,99,87,74,278,663,384,73,44,-8,118,99,66,26,43,144,406,591,347,75,19,99,261,492,256,46,4,45,145,99,91,29,15,-1367,-867,-500,-643,-444,-199,-241,17,-329,-560,-214,-38,-96,15,-207,-402,-147,-23,-145,2,-122,-158,-67,-15,-80,129,-171,-376,-127,-29,-27,86,-120,-276,-94,-16,-53,43,-51,-100,-33,-13,-3277,-2142,-1135,-2351,-1553,-798,-529,-142,-994,-1170,-372,-62,-302,-60,-641,-841,-248,-39,-227,-82,-353,-329,-124,-23,-356,13,-686,-980,-285,-67,-199,35,-452,-707,-197,-37,-157,-22,-234,-273,-88,-30
4,04044,Fines,1727,29,17,12,26,17,9,4,7,5,16,-2,-1,1,7,4,7,-2,0,3,0,1,9,0,-1,1,7,9,7,2,0,1,6,6,3,1,0,0,1,3,4,1,0,26,13,13,30,15,15,4,7,9,5,0,1,0,0,8,6,-1,0,4,7,1,-1,1,1,6,5,10,7,1,1,2,3,5,4,0,1,4,2,5,3,1,0,94,53,41,65,33,32,38,16,24,8,8,0,17,14,12,4,7,-1,21,2,12,4,1,1,18,11,18,14,2,2,8,8,9,6,2,0,10,3,9,8,0,2,28,28,0,47,34,13,-1,10,-1,20,-3,2,6,6,-1,16,-1,1,-7,4,0,4,-2,1,8,11,8,15,2,1,7,8,6,10,2,0,1,3,2,5,0,1,87,66,21,80,55,25,24,18,33,7,6,-4,16,17,28,3,3,-4,8,1,5,4,3,0,17,18,27,11,4,2,11,14,19,7,3,0,6,4,8,4,1,2,91,76,15,96,75,21,-8,32,41,18,3,5,-2,21,36,16,1,4,-6,11,5,2,2,1,3,27,45,17,3,1,3,20,37,14,1,0,0,7,8,3,2,1,108,52,56,54,32,22,14,28,37,23,2,3,3,9,22,13,1,3,11,19,15,10,1,0,7,14,20,12,1,0,1,6,14,10,1,0,6,8,6,2,0,0,79,54,25,100,68,32,10,23,25,19,5,-2,7,15,18,11,4,-1,3,8,7,8,1,-1,13,26,37,18,4,1,8,19,25,14,2,0,5,7,12,4,2,1,77,36,41,61,38,23,18,18,17,15,1,6,5,13,5,8,2,1,13,5,12,7,-1,5,6,17,24,13,0,1,3,12,15,8,0,0,3,5,9,5,0,1,-18,-16,-2,16,2,14,0,6,-18,-10,-1,2,-2,5,-7,-12,-2,1,2,1,-11,2,1,1,9,7,-2,-1,1,0,2,4,-2,-3,0,0,7,3,0,2,1,0,-46,-14,-32,-8,-3,-5,-16,-2,-13,-4,-4,-5,-2,0,-6,-2,-4,1,-14,-2,-7,-2,0,-6,-2,4,-5,-2,-3,0,3,4,-5,-2,-3,0,-5,0,0,0,0,0,-29,-18,-11,9,3,6,-6,-7,-5,-10,-2,-1,-1,-10,1,-6,-1,-2,-5,3,-6,-4,-1,1,2,2,3,1,0,1,2,0,2,-1,0,0,0,2,1,2,0,1,-18,-5,-13,8,4,4,-2,-2,-15,-2,2,0,0,-1,-2,-4,2,-1,-2,-1,-13,2,0,1,0,4,0,3,0,0,0,2,0,2,0,0,0,2,0,1,0,0,14,10,4,2,0,2,2,1,3,8,-4,4,-1,0,7,4,-3,3,3,1,-4,4,-1,1,1,1,-2,2,-1,0,-1,0,0,1,-1,0,2,1,-2,1,0,0,50,32,18,10,6,4,13,7,6,19,6,-2,5,7,6,13,3,-2,8,0,0,6,3,0,2,1,2,1,2,2,1,1,1,0,2,1,1,0,1,1,0,1,-33,-9,-24,3,3,0,-15,4,-9,-7,3,-6,-1,0,1,-4,1,-4,-14,4,-10,-3,2,-2,0,-1,-1,2,2,1,0,-1,1,1,1,1,0,0,-2,1,1,0,-16,-10,-6,-1,0,-1,-3,1,-14,0,-1,0,0,0,-12,0,0,1,-3,1,-2,0,-1,-1,0,0,-1,0,0,0,1,0,-2,1,0,0,-1,0,1,-1,0,0,-22,-4,-18,13,7,6,-7,-6,-1,-3,-6,-1,1,-1,0,-4,-1,-1,-8,-5,-1,1,-5,0,2,3,4,4,-1,1,2,1,3,2,-1,0,0,2,1,2,0,1
4,04047,Gádor,2574,68,38,30,5,2,3,9,15,13,9,8,10,5,5,11,5,3,7,4,10,2,4,5,3,0,0,0,0,5,0,0,0,0,0,2,0,0,0,0,0,3,0,23,16,7,6,4,2,9,11,2,-4,7,-1,7,5,3,-3,5,-1,2,6,-1,-1,2,0,3,0,3,0,0,0,3,0,1,0,0,0,0,0,2,0,0,0,92,53,39,28,15,13,9,11,18,23,7,25,6,8,14,10,3,13,3,3,4,13,4,12,4,4,7,12,1,0,3,2,2,7,1,0,1,2,5,5,0,0,149,89,60,53,35,18,15,38,29,23,27,16,16,18,18,11,12,13,-1,20,11,12,15,3,16,8,13,10,2,3,14,6,6,6,1,2,2,2,7,4,1,1,59,32,27,70,38,32,21,19,13,11,-1,-6,11,8,10,5,1,-4,10,11,3,6,-2,-2,12,22,18,12,4,1,8,8,14,6,2,0,4,14,4,6,2,1,54,43,11,57,37,20,6,18,11,15,9,-8,2,16,12,9,3,-1,4,2,-1,6,6,-7,10,16,13,9,7,1,6,10,8,7,5,0,4,6,5,2,2,1,147,71,76,64,30,34,17,26,44,27,16,16,3,11,25,13,8,9,14,15,19,14,8,7,8,20,21,6,6,3,3,10,11,2,3,1,5,10,10,4,3,2,33,27,6,47,28,19,10,4,3,10,7,0,4,5,0,10,6,1,6,-1,3,0,1,-1,9,9,15,9,5,0,4,5,9,6,4,0,5,4,6,3,1,0,20,12,8,38,26,12,7,7,-11,2,7,8,4,3,-9,5,3,6,3,4,-2,-3,4,2,14,7,7,5,4,1,9,4,5,6,2,0,5,3,2,-1,2,1,-15,-14,-1,17,8,9,1,7,-12,-12,-4,0,0,4,-8,-9,-4,0,1,3,-4,-3,0,0,1,4,6,4,0,2,0,1,3,2,0,2,1,3,3,2,0,0,39,18,21,31,17,14,-1,18,4,7,15,-4,0,12,2,1,6,-3,-1,6,2,6,9,-1,1,12,8,5,4,0,0,9,4,2,2,-1,1,3,4,3,2,1,-12,0,-12,14,9,5,-10,0,-4,8,1,-7,-5,1,7,0,0,-3,-5,-1,-11,8,1,-4,0,5,5,4,0,0,0,3,5,1,0,0,0,2,0,3,0,0,-5,3,-8,14,5,9,0,-5,2,5,-4,-6,-2,-4,1,7,-1,0,2,-1,1,-2,-3,-6,4,1,3,5,-1,2,1,1,0,3,-1,1,3,0,3,2,0,1,-15,-5,-10,5,1,4,-6,0,-3,-2,4,-6,-2,-2,-1,1,2,-2,-4,2,-2,-3,2,-4,1,2,0,-1,0,3,1,0,-1,-1,0,2,0,2,1,0,0,1,-29,-16,-13,-3,-5,2,2,-4,-5,-12,-5,-4,-1,4,-1,-8,-8,-1,3,-8,-4,-4,3,-3,-1,1,3,-4,-2,0,-1,0,1,-3,-2,0,0,1,2,-1,0,0,-19,-20,1,2,-1,3,-4,8,-17,-5,-2,0,-4,0,-11,-2,-2,-1,0,8,-6,-3,0,1,0,3,-3,-2,3,1,1,1,-2,-3,2,0,-1,2,-1,1,1,1,-21,-9,-12,1,1,0,-5,1,-14,3,-8,3,-4,0,-6,5,-4,1,-1,1,-8,-2,-4,2,1,1,-2,2,-1,0,0,0,-1,2,0,0,1,1,-1,0,-1,0,-22,-8,-14,6,5,1,-2,1,-12,0,1,-9,0,2,-8,0,0,-1,-2,-1,-4,0,1,-8,4,0,-2,2,1,1,3,2,0,0,-1,1,1,-2,-2,2,2,0
4,04049,Garrucha,5156,162,98,64,127,74,53,25,27,51,28,21,11,13,13,36,15,10,8,12,14,15,13,11,3,21,29,43,18,11,3,12,14,30,8,6,2,9,15,13,10,5,1,258,127,131,165,87,78,62,47,78,46,18,6,33,28,29,29,9,1,29,19,49,17,9,5,40,42,43,23,12,2,22,24,20,15,6,0,18,18,23,8,6,2,282,126,156,192,99,93,73,34,105,40,17,13,29,11,46,24,6,10,44,23,59,16,11,3,49,42,51,32,15,2,24,21,26,18,8,1,25,21,25,14,7,1,404,181,223,202,99,103,86,62,123,58,46,19,47,19,56,31,16,8,39,43,67,27,30,11,39,47,54,35,21,5,18,18,32,19,8,3,21,29,22,16,13,2,461,260,201,239,156,83,61,115,129,99,37,11,29,73,75,52,22,5,32,42,54,47,15,6,25,65,87,39,16,7,16,45,57,24,9,5,9,20,30,15,7,2,377,196,181,256,133,123,75,77,122,71,32,-1,40,21,78,39,20,-2,35,56,44,32,12,1,59,54,79,43,16,4,29,25,42,25,8,3,30,29,37,18,8,1,456,301,155,380,238,142,58,125,184,54,18,12,33,81,134,36,11,6,25,44,50,18,7,6,75,107,118,61,8,6,38,73,80,38,4,2,37,34,38,23,4,4,219,107,112,151,89,62,16,78,80,31,9,6,1,48,52,0,3,4,15,30,28,31,6,2,33,75,32,7,6,-3,14,49,24,-4,7,-1,19,26,8,11,-1,-2,155,94,61,179,110,69,27,48,66,12,2,2,12,20,48,16,-1,-2,15,28,18,-4,3,4,29,61,66,15,6,0,16,36,47,9,1,0,13,25,19,6,5,0,-62,-35,-27,65,43,22,-27,8,-25,-27,1,3,-10,-9,-10,-15,5,1,-17,17,-15,-12,-4,2,5,32,17,6,3,2,6,11,15,6,3,2,-1,21,2,0,0,0,186,117,69,101,65,36,5,44,93,20,15,7,13,25,62,13,3,3,-8,19,31,7,12,4,10,35,29,21,4,1,9,18,22,14,1,1,1,17,7,7,3,0,6,-13,19,20,2,18,-8,12,3,3,-10,-1,-13,6,-9,6,-9,4,5,6,12,-3,-1,-5,13,13,-7,1,-5,3,8,5,-8,-2,-6,4,5,8,1,3,1,-1,-9,-30,21,-14,-18,4,-17,9,8,-28,3,19,-3,5,-14,-22,-6,8,-14,4,22,-6,9,11,-9,21,-10,-10,-7,1,-2,12,-11,-11,-5,-1,-7,9,1,1,-2,2,44,22,22,-61,-44,-17,-1,18,31,-11,3,1,1,3,16,-7,3,3,-2,15,15,-4,0,-2,-13,2,-22,-23,-6,0,-9,1,-12,-17,-7,-1,-4,1,-10,-6,1,1,-25,6,-31,-6,10,-16,-18,22,-8,-21,7,-9,-1,21,3,-13,-1,-5,-17,1,-11,-8,8,-4,-13,22,-5,-14,4,-2,-3,16,3,-9,0,2,-10,6,-8,-5,4,-4,108,88,20,35,25,10,16,13,17,27,24,8,9,15,21,14,6,17,7,-2,-4,13,18,-9,7,9,25,-5,-2,0,5,7,17,-5,-3,3,2,2,8,0,1,-3,12,-11,23,13,-5,18,-17,27,1,-8,-15,25,-14,6,7,-8,-12,11,-3,21,-6,0,-3,14,4,14,4,-9,-4,5,-3,2,8,-8,-4,1,7,12,-4,-1,0,4,130,77,53,85,58,27,9,32,43,14,22,9,12,17,26,0,12,9,-3,15,17,14,10,0,3,26,33,7,5,10,6,16,24,2,1,9,-3,10,9,5,4,1
4,04052,Huércal de Almería,6395,433,237,196,33,19,14,88,93,125,82,29,11,49,38,90,45,13,4,39,55,35,37,16,7,5,10,8,6,4,0,5,5,5,3,1,0,0,5,3,3,3,0,534,260,274,29,12,17,88,117,218,83,10,9,35,52,107,50,7,4,53,65,111,33,3,5,6,5,9,7,0,0,2,2,4,3,0,0,4,3,5,4,0,0,845,464,381,36,13,23,116,191,329,125,52,16,57,101,200,64,28,5,59,90,129,61,24,11,6,10,11,5,2,0,4,0,6,1,1,0,2,10,5,4,1,0,827,446,381,55,24,31,110,193,350,114,29,13,51,87,209,62,16,9,59,106,141,52,13,4,16,13,4,13,6,2,8,7,0,5,3,0,8,6,4,8,3,2,709,321,388,49,24,25,76,140,341,87,28,24,27,57,181,38,10,4,49,83,160,49,18,20,13,14,14,3,3,2,8,6,6,2,1,1,5,8,8,1,2,1,511,267,244,32,23,9,66,118,235,47,7,7,46,45,124,30,5,2,20,73,111,17,2,5,5,7,14,2,3,1,4,5,10,2,2,0,1,2,4,0,1,1,751,384,367,57,23,34,100,121,353,87,47,16,41,51,199,50,23,1,59,70,154,37,24,15,13,15,11,9,8,1,4,5,6,6,2,0,9,10,5,3,6,1,656,337,319,70,46,24,97,103,291,105,23,8,45,53,168,51,11,-1,52,50,123,54,12,9,4,17,28,16,3,1,4,10,20,10,1,0,0,7,8,6,2,1,552,240,312,60,32,28,116,91,209,87,21,27,48,38,88,43,12,11,68,53,121,44,9,16,8,17,14,17,5,-1,5,10,4,9,4,0,3,7,10,8,1,-1,421,262,159,73,33,40,48,73,185,92,9,-6,33,30,122,50,8,-1,15,43,63,42,1,-5,6,12,42,11,0,2,1,-1,26,6,0,1,5,13,16,5,0,1,219,165,54,63,40,23,38,33,94,27,11,7,38,26,71,19,3,-3,0,7,23,8,8,10,11,12,25,5,2,4,8,9,17,2,-1,2,3,3,8,3,3,2,149,73,76,4,-1,5,38,48,22,26,-13,6,30,20,14,11,-10,0,8,28,8,15,-3,6,4,-2,3,-2,1,-2,2,-2,0,-1,0,-1,2,0,3,-1,1,-1,-62,-20,-42,8,-3,11,-27,-18,-9,-36,-9,-3,-12,-21,5,-22,1,3,-15,3,-14,-14,-10,-6,3,6,-5,2,0,1,1,2,-10,2,-1,2,2,4,5,0,1,-1,115,22,93,-8,-9,1,33,-1,37,-19,-10,-1,8,-1,2,-17,-1,-1,25,0,35,-2,-9,0,-2,-2,3,-10,-1,-1,-3,0,0,-6,0,-1,1,-2,3,-4,-1,0,-27,-31,4,7,4,3,-18,-7,26,-38,-21,13,-21,-3,8,-15,-8,5,3,-4,18,-23,-13,8,11,3,-3,-8,1,3,8,1,-4,-3,0,2,3,2,1,-5,1,1,86,49,37,8,8,0,17,-15,70,-6,-3,12,6,-5,29,5,1,7,11,-10,41,-11,-4,5,6,3,1,-2,-3,2,4,1,2,2,-2,1,2,2,-1,-4,-1,1,53,13,40,3,-1,4,19,3,20,11,-2,4,8,-8,23,-7,-5,-1,11,11,-3,18,3,5,7,2,-6,3,-1,-3,4,-2,-3,2,0,-3,3,4,-3,1,-1,0,-9,-20,11,33,16,17,-19,27,25,-26,-23,-8,-6,4,21,-18,-17,-7,-13,23,4,-8,-6,-1,4,4,10,11,4,0,2,2,4,5,3,0,2,2,6,6,1,0
4,04053,Huércal-Overa,13870,242,134,108,210,121,89,41,37,67,69,21,6,17,23,40,36,14,4,24,14,27,33,7,2,31,50,67,44,15,3,18,33,36,23,10,1,13,17,31,21,5,2,315,155,160,328,163,165,43,63,103,74,29,-3,20,28,48,39,16,2,23,35,55,35,13,-5,49,72,107,61,29,8,22,37,50,31,16,6,27,35,57,30,13,2,442,237,205,391,214,177,100,79,118,83,41,22,55,41,63,46,20,12,45,38,55,37,21,10,95,77,92,72,40,13,50,43,54,40,20,6,45,34,38,32,20,7,488,270,218,396,207,189,103,71,87,127,92,10,50,43,48,73,52,2,53,28,39,54,40,8,75,71,82,95,58,12,39,34,44,51,30,6,36,37,38,44,28,6,553,315,238,499,287,212,82,85,150,120,87,28,41,51,91,73,45,13,41,34,59,47,42,15,81,93,124,106,79,13,38,56,77,67,41,7,43,37,47,39,38,6,264,151,113,292,159,133,78,41,91,6,50,0,41,25,71,-5,20,1,37,16,20,11,30,-1,84,44,61,50,45,6,41,28,38,25,25,2,43,16,23,25,20,4,204,104,100,165,101,64,90,22,48,-10,22,33,51,8,26,-14,9,26,39,14,22,4,13,7,68,13,14,21,38,8,45,6,9,12,21,6,23,7,5,9,17,2,340,195,145,342,188,154,52,26,105,73,69,15,28,20,65,37,41,8,24,6,40,36,28,7,63,58,68,71,65,13,34,34,35,43,34,6,29,24,33,28,31,7,398,212,186,398,222,176,47,75,112,72,95,2,27,36,60,37,48,5,20,39,52,35,47,-3,64,72,105,65,74,16,38,34,63,39,36,11,26,38,42,26,38,5,165,87,78,208,127,81,30,21,33,21,36,27,22,0,30,4,13,21,8,21,3,17,23,6,16,36,62,29,40,24,12,19,44,15,20,17,4,17,18,14,20,7,-201,-144,-57,-123,-105,-18,-35,-24,-65,-81,0,8,-20,-24,-52,-45,2,-1,-15,0,-13,-36,-2,9,-21,-2,-60,-46,3,1,-13,-12,-49,-36,3,2,-8,10,-11,-10,0,-1,159,102,57,196,122,74,37,46,22,-11,48,24,45,30,10,-17,28,11,-8,16,12,6,20,13,33,60,30,26,39,9,25,41,19,13,21,4,8,19,11,13,18,5,74,13,61,33,16,17,37,3,-11,5,6,39,22,-11,-16,2,-4,18,15,14,5,3,10,21,34,12,-5,-24,4,12,26,6,-12,-12,-1,8,8,6,7,-12,5,4,-677,-403,-274,-719,-408,-311,-30,-91,-142,-172,-166,-84,-31,-57,-70,-100,-95,-52,1,-34,-72,-72,-71,-32,-62,-76,-151,-179,-171,-81,-31,-46,-77,-112,-94,-49,-31,-30,-74,-67,-77,-32,231,129,102,201,110,91,20,29,85,3,46,38,20,8,54,-8,28,20,0,21,31,11,18,18,24,40,37,31,44,21,12,20,26,11,25,14,12,20,11,20,19,7,232,128,104,221,118,103,38,35,38,40,43,36,28,24,13,20,22,21,10,11,25,20,21,15,33,47,32,40,48,19,17,26,18,19,26,12,16,21,14,21,22,7,-266,-149,-117,-302,-166,-136,11,-40,5,-48,-81,-118,14,-25,-6,-33,-43,-59,-3,-15,11,-15,-38,-59,-12,-7,-5,-82,-79,-120,-2,-7,-4,-56,-35,-63,-10,0,-1,-26,-44,-57,88,55,33,172,114,58,-9,12,31,-17,48,22,11,6,39,-32,29,1,-20,6,-8,15,19,21,33,42,34,26,49,-18,33,32,23,7,28,-13,0,10,11,19,21,-5
4,04059,Lubrín,1771,-3,-1,-2,14,9,5,2,-8,5,-3,3,-2,1,-4,0,-1,1,2,1,-4,5,-2,2,-4,0,1,3,0,10,0,0,1,2,0,6,0,0,0,1,0,4,0,-11,-6,-5,17,9,8,0,-2,-13,5,9,-9,-2,1,-7,1,6,-5,2,-3,-6,4,3,-4,4,2,3,5,3,0,2,2,2,1,2,0,2,0,1,4,1,0,19,7,12,33,15,18,2,6,-3,-3,8,8,0,0,-2,1,5,3,2,6,-1,-4,3,5,6,6,7,4,8,1,2,3,3,2,5,0,4,3,4,2,3,1,61,39,22,64,31,33,6,5,6,16,24,4,4,2,11,8,13,1,2,3,-5,8,11,3,6,7,11,17,20,3,5,3,5,8,8,2,1,4,6,9,12,1,16,2,14,50,23,27,5,-4,-4,9,18,-6,1,-1,-2,2,7,-4,4,-3,-2,7,11,-2,7,2,12,10,14,5,1,2,7,5,6,2,6,0,5,5,8,3,69,54,15,68,43,25,2,13,24,15,15,-2,3,11,14,10,12,2,-1,2,10,5,3,-4,3,11,21,14,17,2,2,9,12,9,9,2,1,2,9,5,8,0,59,30,29,57,28,29,13,9,8,10,23,-5,10,2,6,3,11,-3,3,7,2,7,12,-2,11,7,14,10,12,2,7,4,6,4,6,1,4,3,8,6,6,1,10,4,6,38,23,15,3,3,-14,3,22,-7,1,-5,-7,2,13,0,2,8,-7,1,9,-7,4,7,2,9,14,2,3,2,1,8,8,1,1,5,1,1,6,1,-14,-3,-11,23,15,8,-4,2,-11,0,7,-7,-4,5,-7,0,6,-3,0,-3,-4,0,1,-4,4,3,4,1,8,3,2,2,3,1,5,2,2,1,1,0,3,1,35,15,20,22,13,9,4,8,1,-4,18,8,2,3,1,-4,8,5,2,5,0,0,10,3,2,3,4,1,8,4,1,1,5,-2,6,2,1,2,-1,3,2,2,-2,-3,1,5,0,5,-4,2,-6,-1,9,-2,-1,3,-6,-5,6,0,-3,-1,0,4,3,-2,2,1,2,-2,3,-1,0,1,1,-2,2,-2,2,0,1,0,1,1,5,9,-4,13,9,4,2,10,1,1,2,-10,0,9,2,3,1,-6,2,1,-1,-2,1,-4,1,3,0,1,7,1,2,2,0,2,3,0,-1,1,0,-1,4,1,-2,2,-4,7,3,4,0,-2,-1,5,2,-6,-1,-1,1,3,3,-3,1,-1,-2,2,-1,-3,-2,3,-2,4,4,0,-1,0,0,2,2,0,-1,3,-2,2,2,0,3,4,-1,17,10,7,0,-1,1,4,4,-5,1,0,0,3,4,-4,-1,-1,1,1,0,-1,2,1,5,5,4,0,3,-1,2,3,4,-1,-1,2,3,2,0,1,-9,-2,-7,17,11,6,-1,1,-4,-2,6,-9,1,-1,0,-2,4,-4,-2,2,-4,0,2,-5,5,0,-1,6,9,-2,3,0,0,3,6,-1,2,0,-1,3,3,-1,-62,-33,-29,-22,-14,-8,-7,-10,-10,-10,-8,-17,-2,-4,-3,-10,-6,-8,-5,-6,-7,0,-2,-9,1,-7,-1,-4,-2,-9,2,-5,-1,-4,-1,-5,-1,-2,0,0,-1,-4,6,5,1,20,11,9,-3,4,4,-3,6,-2,-2,4,0,-2,5,0,-1,0,4,-1,1,-2,1,0,6,3,6,4,1,1,2,1,4,2,0,-1,4,2,2,2,18,12,6,24,11,13,-1,2,4,6,3,4,-2,-2,4,3,2,7,1,4,0,3,1,-3,1,0,3,4,8,8,0,0,3,1,2,5,1,0,0,3,6,3
4,04060,Lucainena de las Torres,595,23,30,-7,40,38,2,-6,10,14,2,1,2,-4,12,18,2,1,1,-2,-2,-4,0,0,1,0,14,22,3,1,0,0,13,21,3,1,0,0,1,1,0,0,0,-2,1,-3,15,13,2,-1,1,2,3,-5,-3,-1,1,3,3,-4,-1,0,0,-1,0,-1,-2,0,6,7,2,0,0,0,5,6,2,0,0,0,1,1,0,0,0,-13,-7,-6,14,10,4,-3,7,-14,-6,1,2,-2,6,-8,-5,1,1,-1,1,-6,-1,0,1,1,8,1,2,0,2,1,7,0,1,0,1,0,1,1,1,0,1,-1,2,-3,8,6,2,0,0,-1,0,1,0,1,2,-2,-1,2,0,-1,-2,1,1,-1,0,0,2,4,1,0,1,0,2,3,0,0,1,0,0,1,1,0,0,55,54,1,63,58,5,1,20,20,15,6,-7,1,20,20,12,5,-3,0,0,0,3,1,-4,2,23,22,14,2,0,2,23,20,11,2,0,0,0,2,3,0,0,31,21,10,40,27,13,4,11,7,3,6,-1,4,10,4,-1,4,-1,0,1,3,4,2,0,1,14,11,5,6,2,1,13,8,3,1,0,0,1,3,2,5,2,9,10,-1,15,9,6,-1,5,-5,-2,12,0,0,2,-3,3,7,1,-1,3,-2,-5,5,-1,0,3,1,4,7,0,0,2,0,3,4,0,0,1,1,1,3,0,32,6,26,13,0,13,2,0,-2,9,21,2,0,0,-9,4,10,1,2,0,7,5,11,1,6,-3,-3,6,6,1,3,-3,-7,3,3,1,3,0,4,3,3,0,7,2,5,18,7,11,7,-2,1,9,-5,-3,4,-1,-1,6,-5,-1,3,-1,2,3,0,-2,6,3,5,6,-1,-1,3,2,2,2,-1,-1,3,1,3,4,0,0,-10,-14,4,-1,-6,5,-3,-5,5,-6,1,-3,-4,-5,-1,-3,-1,-1,1,0,6,-3,2,-2,0,-3,4,-4,1,0,0,-4,0,-4,1,0,0,1,4,0,0,0,-8,-8,0,9,5,4,-1,1,-14,-1,6,2,0,0,-7,-4,4,0,-1,1,-7,3,2,2,0,0,2,1,4,2,0,0,1,0,3,1,0,0,1,1,1,1,3,0,3,4,3,1,4,-1,-6,4,3,-1,2,-2,-7,2,5,1,2,1,1,2,-2,-2,0,0,0,0,4,0,0,0,0,0,3,0,0,0,0,0,1,0,1,2,-1,4,2,2,0,4,-4,3,-2,-2,0,2,0,-1,0,0,0,2,-4,4,-2,-2,2,1,0,1,0,0,1,0,0,1,0,0,1,1,0,0,0,0,-32,-19,-13,-6,-5,-1,-5,3,-11,-6,-6,-6,1,1,-7,-7,-3,-4,-6,2,-4,1,-3,-2,0,-1,-4,-1,0,0,0,-1,-3,-1,0,0,0,0,-1,0,0,0,-13,-11,-2,-34,-23,-11,-4,5,-3,-10,3,-3,-3,1,-2,-5,0,-2,-1,4,-1,-5,3,-1,-6,-1,-8,-12,-5,-2,-4,-2,-5,-7,-4,-1,-2,1,-3,-5,-1,-1,-21,-8,-13,-5,-3,-2,1,1,1,-4,-11,-9,-1,1,3,0,-6,-5,2,0,-2,-4,-5,-4,0,1,1,-1,-5,-1,0,0,1,0,-3,-1,0,1,0,-1,-2,0,1,4,-3,3,1,2,6,1,4,6,-6,-10,2,1,1,5,0,-5,4,0,3,1,-6,-5,0,0,0,3,0,0,0,-1,0,2,0,0,0,1,0,1,0,0,-12,-4,-8,6,4,2,-3,-1,-1,-6,0,0,-4,-1,2,-3,1,2,1,0,-3,-3,-1,-2,0,0,1,0,3,2,0,0,0,0,2,2,0,0,1,0,1,0
4,04062,Macael,5861,4,7,-3,43,29,14,1,-3,-5,7,3,0,3,1,-3,4,2,-1,-2,-4,-2,3,1,1,9,10,13,8,2,1,7,7,9,4,1,1,2,3,4,4,1,0,48,33,15,63,44,19,13,3,9,18,4,-2,6,6,8,8,4,-1,7,-3,1,10,0,-1,11,17,17,12,4,0,6,11,14,8,3,0,5,6,3,4,1,0,11,18,-7,53,26,27,5,-3,9,-3,6,-6,6,0,5,6,1,-2,-1,-3,4,-9,5,-4,12,13,20,4,4,0,7,5,11,1,2,0,5,8,9,3,2,0,102,69,33,89,45,44,35,12,30,15,11,-2,18,11,25,8,8,-1,17,1,5,7,3,-1,21,22,28,10,6,2,8,11,18,6,2,0,13,11,10,4,4,2,83,52,31,63,45,18,13,19,43,17,-4,-4,2,13,24,15,-3,2,11,6,19,2,-1,-6,7,18,24,10,4,0,3,9,20,9,4,0,4,9,4,1,0,0,21,33,-12,43,32,11,-6,7,15,5,2,-3,-3,11,14,8,2,0,-3,-4,1,-3,0,-3,9,9,16,5,4,0,5,9,13,3,2,0,4,0,3,2,2,0,93,74,19,108,67,41,15,18,42,19,-2,-2,8,12,37,15,0,0,7,6,5,4,-2,-2,14,31,42,19,2,0,6,18,29,13,1,0,8,13,13,6,1,0,54,49,5,84,55,29,15,19,25,1,-5,-4,8,12,26,6,-2,-1,7,7,-1,-5,-3,-3,16,27,24,14,2,0,9,18,16,10,1,0,7,9,8,4,1,0,-17,-25,8,44,18,26,5,14,-20,-14,0,-6,2,2,-18,-14,2,-1,3,12,-2,0,-2,-5,11,21,4,5,3,-1,4,10,-1,3,2,-1,7,11,5,2,1,0,-7,7,-14,36,20,16,14,-7,-2,-1,-12,-1,4,1,4,5,-8,1,10,-8,-6,-6,-4,-2,7,13,6,5,3,2,4,9,4,3,0,0,3,4,2,2,3,2,-63,-20,-43,27,19,8,-10,-10,-16,-22,-7,0,2,1,5,-18,-7,0,-12,-11,-21,-4,0,0,2,10,9,2,1,1,1,7,8,1,1,1,1,3,1,1,0,0,-65,-44,-21,-3,-2,-1,-15,-16,-38,-16,-5,24,3,-7,-29,-15,-5,8,-18,-9,-9,-1,0,16,-1,1,-3,0,0,0,0,3,-3,-1,-1,0,-1,-2,0,1,1,0,-107,-66,-41,-7,-9,2,-9,-24,-37,-19,-13,-6,-10,-17,-20,-12,-7,-2,1,-7,-17,-7,-6,-4,3,0,-4,-4,-1,-1,1,-2,-4,-4,0,0,2,2,0,0,-1,-1,-34,-16,-18,-4,-5,1,4,0,-11,-17,-6,-6,4,0,-10,-8,-1,-1,0,0,-1,-9,-5,-5,0,1,1,-7,2,-1,-1,0,1,-7,2,0,1,1,0,0,0,-1,-23,-1,-22,9,5,4,-18,0,-14,12,-4,3,-13,-1,-1,15,0,-1,-5,1,-13,-3,-4,4,0,3,-2,5,2,1,-2,3,2,2,0,0,2,0,-4,3,2,1,-34,-12,-22,4,2,2,9,-14,-22,-5,1,-5,1,-6,-7,0,-1,0,8,-8,-15,-5,2,-5,1,1,2,1,-1,0,1,0,1,1,-1,0,0,1,1,0,0,0,-49,-11,-38,5,4,1,-17,-1,-2,-30,0,-1,-5,2,5,-20,-2,7,-12,-3,-7,-10,2,-8,1,5,1,-7,3,2,1,4,1,-5,1,2,0,1,0,-2,2,0,-23,-14,-9,10,9,1,6,-11,-13,-12,1,5,6,-5,-8,-11,2,1,0,-6,-5,-1,-1,4,3,3,2,3,1,-2,2,3,1,3,1,-1,1,0,1,0,0,-1
4,04064,Mojácar,4615,160,81,79,151,78,73,39,19,26,34,39,1,27,9,11,18,13,3,12,10,15,16,26,-2,18,21,33,29,39,8,12,10,20,12,17,6,6,11,13,17,22,2,159,69,90,187,96,91,16,22,27,48,25,19,3,8,12,20,12,13,13,14,15,28,13,6,27,15,34,48,41,22,14,5,18,20,24,15,13,10,16,28,17,7,517,277,240,460,241,219,72,49,113,111,125,42,49,25,59,52,70,20,23,24,54,59,55,22,58,42,80,84,139,55,36,18,45,40,70,31,22,24,35,44,69,24,562,288,274,629,321,308,94,41,111,125,153,31,46,20,56,54,86,19,48,21,55,71,67,12,110,44,107,137,178,44,58,18,56,62,93,28,52,26,51,75,85,16,643,354,289,619,337,282,76,90,158,149,140,29,40,44,93,92,73,14,36,46,65,57,67,15,79,71,118,153,159,35,47,32,61,91,84,21,32,39,57,62,75,14,468,267,201,532,288,244,49,80,120,79,111,22,21,47,84,47,46,16,28,33,36,32,65,6,63,92,109,93,138,32,30,50,63,56,63,22,33,42,46,37,75,10,221,113,108,399,217,182,40,25,16,54,66,20,12,16,3,29,35,16,28,9,13,25,31,4,57,61,71,81,89,36,28,33,41,41,47,24,29,28,30,40,42,12,281,140,141,444,232,212,32,51,35,27,110,27,14,21,13,16,55,20,18,30,22,11,55,7,61,63,74,71,133,41,34,30,34,39,68,26,27,33,40,32,65,15,266,110,156,344,176,168,10,19,38,54,92,47,6,2,22,18,45,20,4,17,16,36,47,27,37,48,59,61,93,44,23,20,37,28,51,17,14,28,22,33,42,27,141,52,89,240,121,119,16,8,3,26,60,28,7,8,-12,9,25,14,9,0,15,17,35,14,24,32,31,40,81,29,11,13,17,22,38,18,13,19,14,18,43,11,216,117,99,222,108,114,23,16,33,50,60,31,11,7,20,20,34,23,12,9,13,30,26,8,21,22,30,51,69,27,8,9,13,25,33,19,13,13,17,26,36,8,117,71,46,164,90,74,-1,16,-6,17,49,41,5,17,-6,6,24,25,-6,-1,0,11,25,16,14,26,28,28,39,28,11,14,17,11,18,18,3,12,11,17,21,10,146,75,71,147,74,73,9,0,9,36,53,33,0,2,3,17,31,19,9,-2,6,19,22,14,9,10,14,27,59,27,4,7,7,13,26,17,5,3,7,14,33,10,117,72,45,141,75,66,-7,10,-10,24,55,44,2,11,-15,18,32,25,-9,-1,5,6,23,19,5,9,10,26,44,47,4,3,3,12,25,28,1,6,7,14,19,19,318,148,170,238,123,115,16,27,20,76,109,66,1,9,10,43,52,33,15,18,10,33,57,33,12,19,29,36,82,57,4,12,15,15,43,32,8,7,14,21,39,25,-629,-321,-308,-635,-327,-308,-66,-83,-67,-116,-109,-192,-34,-42,-33,-47,-66,-102,-32,-41,-34,-69,-43,-90,-51,-84,-64,-113,-125,-201,-29,-42,-37,-44,-70,-108,-22,-42,-27,-69,-55,-93,231,97,134,245,124,121,22,4,8,28,95,76,7,-5,0,13,43,41,15,9,8,15,52,35,15,10,29,31,96,63,8,3,17,15,46,35,7,7,12,16,50,28,344,167,177,274,134,140,36,7,31,55,140,72,25,8,1,25,67,40,11,-1,30,30,73,32,18,13,25,46,114,55,9,9,9,22,56,28,9,4,16,24,58,27
4,04903,"Mojonera, La",6582,281,273,8,546,468,78,-3,124,130,23,-6,-1,-10,120,124,33,0,-3,7,4,6,-10,-6,2,50,171,231,76,2,2,30,153,206,65,2,1,20,18,25,11,0,1,218,144,74,421,293,128,109,44,47,13,-5,-8,69,34,21,19,-4,-5,40,10,26,-6,-1,-3,105,91,145,58,3,1,66,61,110,44,2,0,39,30,35,14,1,1,146,74,72,479,344,135,78,36,32,21,-12,-12,36,23,19,11,-9,-8,42,13,13,10,-3,-4,107,111,178,69,11,0,56,78,148,54,6,0,51,33,30,15,5,0,168,105,63,429,292,137,105,6,35,14,4,-3,71,5,18,3,2,2,34,1,17,11,2,-5,125,85,141,63,6,1,75,56,110,42,5,1,50,29,31,21,1,0,-117,-116,-1,400,266,134,49,-6,-106,-33,-15,-9,23,-4,-93,-34,-6,-5,26,-2,-13,1,-9,-4,116,100,119,52,3,2,59,73,91,35,3,0,57,27,28,17,0,2,-272,-188,-84,230,169,61,-19,-74,-101,-65,-5,-5,-1,-38,-93,-45,-8,-2,-18,-36,-8,-20,3,-3,55,62,73,35,4,1,35,49,57,24,3,1,20,13,16,11,1,0,-135,-122,-13,340,219,121,22,-14,-73,-43,-12,-15,14,-17,-72,-36,-5,-6,8,3,-1,-7,-7,-9,73,113,100,41,9,0,43,73,66,30,5,0,30,40,34,11,4,0,-415,-359,-56,30,-11,41,-40,-54,-190,-119,-14,2,-23,-42,-178,-109,-3,-1,-17,-12,-12,-10,-11,3,17,37,12,-36,-4,1,17,26,-15,-35,-5,0,0,11,27,-1,1,1,-175,-160,-15,58,3,55,-43,41,-129,-61,2,9,-28,33,-116,-55,-7,5,-15,8,-13,-6,9,4,-3,71,-9,-1,-4,0,-1,45,-26,-12,-7,0,-2,26,17,11,3,0,58,130,-72,83,64,19,-11,35,71,-9,-29,4,-1,53,86,-1,-11,5,-10,-18,-15,-8,-18,-1,23,23,41,2,-6,0,17,19,33,-2,-3,0,6,4,8,4,-3,0,69,41,28,82,51,31,16,-1,46,0,-13,8,8,0,34,4,-9,-1,8,-1,12,-4,-4,9,4,18,50,0,-1,0,6,6,35,0,0,0,-2,12,15,0,-1,0,-143,-101,-42,-31,-64,33,-11,18,-78,-73,-8,-1,0,20,-59,-54,-12,-3,-11,-2,-19,-19,4,2,9,26,-19,-46,-8,0,4,9,-25,-49,-8,0,5,17,6,3,0,0,73,57,16,136,83,53,5,37,0,30,-4,-7,-4,26,24,14,-5,-4,9,11,-24,16,1,-3,24,62,14,24,0,0,11,43,14,10,0,0,13,19,0,14,0,0,24,22,2,71,46,25,8,25,18,-22,-1,-5,-5,33,13,-16,1,-3,13,-8,5,-6,-2,-2,20,44,9,-6,1,0,15,38,-1,-8,0,0,5,6,10,2,1,0,-12,33,-45,97,64,33,-32,29,0,0,-10,0,-15,26,17,7,-5,0,-17,3,-17,-7,-5,0,11,43,25,11,5,0,8,26,26,2,1,0,3,17,-1,9,4,0,-83,-2,-81,161,128,33,-49,5,-18,-7,-18,6,-21,13,10,9,-12,-1,-28,-8,-28,-16,-6,7,13,52,62,29,1,3,8,40,56,23,-1,1,5,12,6,6,2,2,84,106,-22,185,148,37,-7,30,41,31,-8,2,-2,36,44,35,-6,1,-5,-6,-3,-4,-2,1,16,49,77,35,5,2,10,41,66,28,3,0,6,8,11,7,2,2,35,75,-40,178,143,35,-25,15,46,11,-18,0,-7,27,54,15,-13,-4,-18,-12,-8,-4,-5,4,13,66,64,32,1,0,10,53,62,18,0,-1,3,13,2,14,1,1
4,04066,Níjar,16083,2138,1694,444,2128,1768,360,189,758,864,266,47,5,105,625,738,193,29,1,84,133,126,73,18,4,152,770,915,242,34,6,92,658,795,197,21,3,60,112,120,45,13,3,814,486,328,974,656,318,161,227,176,160,58,25,94,145,103,92,26,19,67,82,73,68,32,6,159,274,313,168,37,18,90,199,228,102,15,17,69,75,85,66,22,1,753,355,398,960,587,373,238,158,180,120,41,12,125,70,66,57,26,8,113,88,114,63,15,4,213,234,325,133,35,13,117,146,212,80,19,8,96,88,113,53,16,5,797,357,440,916,538,378,225,192,152,132,71,19,117,86,47,55,47,8,108,106,105,77,24,11,198,237,297,131,32,15,109,147,181,73,19,8,89,90,116,58,13,7,2496,2024,472,2837,2320,517,199,1011,937,287,53,7,130,856,800,189,37,8,69,155,137,98,16,-1,230,1095,1141,303,55,7,138,948,980,215,33,3,92,147,161,88,22,4,1606,1146,460,1801,1288,513,212,526,580,197,59,25,113,416,435,124,32,17,99,110,145,73,27,8,254,575,674,223,50,14,143,440,511,150,28,7,111,135,163,73,22,7,660,385,275,1178,777,401,122,238,153,83,37,20,87,165,69,36,10,14,35,73,84,47,27,6,194,373,403,144,47,4,117,265,277,78,27,5,77,108,126,66,20,-1,-632,-967,335,-43,-437,394,46,-57,-622,-80,37,44,-1,-145,-731,-119,16,12,47,88,109,39,21,32,118,56,-299,4,48,22,63,-62,-428,-53,24,13,55,118,129,57,24,9,395,274,121,662,424,238,-44,286,147,-11,-3,24,-21,228,78,-20,-3,11,-23,58,69,9,0,13,38,272,253,67,12,11,16,207,142,39,7,5,22,65,111,28,5,6,1210,812,398,813,473,340,124,460,366,183,31,24,75,309,272,115,15,14,49,151,94,68,16,10,100,341,208,124,24,4,60,208,121,68,9,1,40,133,87,56,15,3,625,450,175,517,242,275,43,238,231,77,27,-11,36,167,181,44,21,-4,7,71,50,33,6,-7,105,171,111,70,39,1,57,81,45,24,22,1,48,90,66,46,17,0,235,-63,298,678,331,347,163,106,-107,-7,35,26,110,1,-183,-27,13,13,53,105,76,20,22,13,159,179,177,102,28,15,104,73,78,50,9,8,55,106,99,52,19,7,311,185,126,557,332,225,46,76,108,63,2,10,5,41,79,49,-1,6,41,35,29,14,3,4,98,132,204,79,23,15,47,75,138,46,11,9,51,57,66,33,12,6,-1139,-727,-412,-1248,-841,-407,-119,-14,-378,-367,-168,-99,-65,-20,-280,-224,-89,-55,-54,6,-98,-143,-79,-44,-117,-77,-442,-359,-161,-101,-68,-61,-352,-225,-87,-53,-49,-16,-90,-134,-74,-48,-482,-247,-235,-190,-159,-31,-91,51,-183,-196,-58,-1,-46,45,-99,-114,-42,6,-45,6,-84,-82,-16,-7,-6,83,-143,-112,-23,6,0,42,-111,-72,-23,0,-6,41,-32,-40,0,6,-63,-27,-36,-103,-104,1,30,111,-47,-119,-47,-9,27,68,-50,-50,-28,-5,3,43,3,-69,-19,-4,41,96,-89,-114,-45,-11,32,46,-84,-75,-26,-8,9,50,-5,-39,-19,-3,296,248,48,178,125,53,66,165,119,-48,-28,-8,52,135,67,-8,-14,-7,14,30,52,-40,-14,-1,79,131,35,-74,-19,3,54,115,-6,-45,-13,3,25,16,41,-29,-6,0,217,308,-91,171,212,-41,38,271,152,-126,-86,-47,39,233,182,-74,-57,-29,-1,38,-30,-52,-29,-18,49,266,116,-145,-83,-46,30,222,125,-101,-52,-26,19,44,-9,-44,-31,-20
4,04069,Olula del Río,6008,88,32,56,22,10,12,9,21,35,13,3,6,1,8,14,6,1,1,8,13,21,7,2,5,5,3,7,6,1,0,1,2,3,3,1,0,4,1,4,3,0,0,93,64,29,78,46,32,14,23,48,-1,2,2,10,11,36,0,1,3,4,12,12,-1,1,-1,16,25,24,8,1,1,8,15,15,5,1,0,8,10,9,3,0,1,123,79,44,89,54,35,16,19,57,19,7,3,6,11,38,15,5,4,10,8,19,4,2,-1,16,19,24,17,7,6,7,11,16,12,4,4,9,8,8,5,3,2,-51,-26,-25,62,34,28,-19,5,-15,-20,-4,-3,-14,0,2,-9,-3,-5,-5,5,-17,-11,-1,2,11,18,12,17,2,1,6,11,6,10,1,0,5,7,6,7,1,1,63,56,7,100,58,42,-3,35,35,11,-2,-15,3,17,38,6,0,-8,-6,18,-3,5,-2,-7,11,34,32,19,2,1,2,17,23,12,2,1,9,17,9,7,0,0,117,82,35,83,51,32,21,30,55,8,3,3,12,25,37,5,2,0,9,5,18,3,1,3,11,27,32,12,1,0,6,17,21,6,1,0,5,10,11,6,0,0,62,54,8,98,58,40,12,30,23,2,-2,-5,5,21,20,9,0,1,7,9,3,-7,-2,-6,22,29,30,14,3,-1,8,18,21,11,1,-1,14,11,9,3,2,0,124,78,46,99,56,43,36,19,45,24,1,-1,17,15,25,16,0,4,19,4,20,8,1,-5,31,23,24,17,2,1,18,13,14,10,0,0,13,10,10,7,2,1,20,21,-1,71,41,30,-2,21,13,3,-8,-3,2,15,13,-2,-1,-2,-4,6,0,5,-7,-1,14,18,30,7,1,1,6,11,22,0,1,1,8,7,8,7,0,0,29,5,24,48,22,26,14,23,-10,-10,2,7,7,10,-8,-2,-2,-2,7,13,-2,-8,4,9,6,20,14,3,1,1,3,11,7,1,-1,0,3,9,7,2,2,1,-138,-72,-66,26,12,14,-4,-24,-43,-46,-18,-6,-1,-19,-16,-30,-8,-2,-3,-5,-27,-16,-10,-4,4,11,14,-6,2,1,1,4,10,-4,0,1,3,7,4,-2,2,0,-24,-11,-13,23,13,10,-3,2,0,-15,5,-13,0,0,-2,-12,3,-2,-3,2,2,-3,2,-11,9,2,7,2,4,-1,6,1,2,2,2,0,3,1,5,0,2,-1,-74,-49,-25,-30,-21,-9,-4,-19,-28,-10,-10,-4,-6,-7,-18,-9,-7,-3,2,-12,-10,-1,-3,-1,2,-2,-12,-12,-6,0,1,-1,-9,-7,-5,0,1,-1,-3,-5,-1,0,-40,-16,-24,-58,-34,-24,19,-14,-44,0,-2,-3,17,-11,-32,7,2,-1,2,-3,-12,-7,-4,-2,-2,-10,-26,-17,-3,0,-1,-7,-19,-5,-2,0,-1,-3,-7,-12,-1,0,-95,-46,-49,9,-3,12,-19,-4,-18,-34,-13,-6,-4,1,-3,-29,-6,-2,-15,-5,-15,-5,-7,-4,6,2,1,-4,-1,2,3,-1,-1,-5,0,0,3,3,2,1,-1,2,-8,-1,-7,-15,-2,-13,5,-7,0,-5,6,-4,0,-3,3,-5,5,-1,5,-4,-3,0,1,-3,-3,2,-5,-7,1,-1,-1,2,0,-4,1,0,-2,0,-5,-3,0,-1,-6,2,-8,8,5,3,-4,-3,10,-11,-7,2,5,-1,-1,-1,-6,0,-9,-2,11,-10,-1,2,0,6,7,-4,-2,-2,0,3,5,-3,-2,-1,0,3,2,-1,0,-1,15,7,8,-4,-1,-3,1,2,15,-6,2,-1,-5,1,22,-6,-2,-2,6,1,-7,0,4,1,-4,5,9,-15,2,0,-3,3,11,-11,0,0,-1,2,-2,-4,2,0
4,04070,Oria,2138,17,14,3,33,17,16,6,5,-5,12,7,-8,6,3,-6,8,6,-3,0,2,1,4,1,-5,6,5,5,7,10,0,4,2,1,3,7,0,2,3,4,4,3,0,49,22,27,68,33,35,8,3,-7,20,26,0,1,2,-5,8,17,0,7,1,-2,12,9,0,6,7,11,21,23,0,1,4,5,9,14,0,5,3,6,12,9,0,158,81,77,97,52,45,11,23,26,47,44,8,8,13,14,23,23,2,3,10,12,24,21,6,14,9,8,21,38,6,8,7,3,11,21,2,6,2,5,10,17,4,86,46,40,104,48,56,25,-2,1,35,33,-6,6,1,7,16,20,-4,19,-3,-6,19,13,-2,18,5,13,25,39,4,5,2,9,10,20,2,13,3,4,15,19,2,165,89,76,179,97,82,30,23,35,35,37,4,18,10,17,16,23,5,12,13,18,19,14,-1,32,15,34,47,42,8,17,9,16,27,24,4,15,6,18,20,18,4,128,87,41,149,92,57,22,14,29,39,28,-4,15,5,22,29,17,-1,7,9,7,10,11,-3,27,18,33,34,34,3,16,10,24,21,19,2,11,8,9,13,15,1,192,101,91,157,89,68,25,28,46,39,46,6,10,19,22,20,21,7,15,9,24,19,25,-1,23,18,39,30,35,10,11,11,22,18,17,8,12,7,17,12,18,2,69,38,31,130,63,67,18,6,7,12,43,-16,13,9,1,2,19,-7,5,-3,6,10,24,-9,25,9,15,26,47,7,15,4,5,11,23,4,10,5,10,15,24,3,-13,0,-13,53,23,30,-6,2,-15,-3,12,-1,-4,0,0,0,4,1,-2,2,-15,-3,8,-2,4,7,6,11,14,11,2,4,5,4,3,5,2,3,1,7,11,6,1,-1,2,36,19,17,2,2,-9,-5,18,-8,2,2,-8,-3,10,-5,0,0,-1,-2,8,-3,9,3,8,4,12,-1,5,1,5,2,7,-2,4,2,3,2,5,1,19,9,10,40,22,18,-1,2,-6,-2,19,3,-2,-4,2,2,8,2,1,6,-8,-4,11,1,3,6,6,6,13,3,1,2,4,4,8,2,2,4,2,2,5,1,2,9,-7,15,8,7,0,8,-9,-5,6,0,-1,5,-1,-2,6,2,1,3,-8,-3,0,-2,1,7,2,0,2,2,0,4,2,0,1,1,1,3,0,0,1,1,-20,-9,-11,5,3,2,0,-1,-9,-7,-1,-2,-1,-4,-6,-4,2,4,1,3,-3,-3,-3,-6,-1,-1,1,0,3,3,0,-1,1,-1,2,2,-1,0,0,1,1,1,41,25,16,27,16,11,4,3,-1,16,18,2,2,4,0,9,13,-3,2,-1,-1,7,5,5,0,4,2,5,13,3,1,2,1,3,7,2,-1,2,1,2,6,1,21,9,12,15,7,8,3,9,-1,3,5,1,1,2,2,6,-6,4,2,7,-3,-3,11,-3,0,3,0,1,10,1,-1,3,0,0,4,1,1,0,0,1,6,0,-55,-30,-25,21,12,9,-10,-11,-12,3,-10,-14,-7,-2,-7,1,-7,-7,-3,-9,-5,2,-3,-7,-1,1,4,9,3,5,0,2,3,4,1,2,-1,-1,1,5,2,3,36,25,11,41,23,18,5,7,-3,8,13,6,6,8,0,3,5,3,-1,-1,-3,5,8,3,1,6,-1,12,17,6,1,4,0,8,7,3,0,2,-1,4,10,3,18,13,5,44,22,22,0,-3,-3,-3,23,2,1,0,-4,-5,13,6,-1,-3,1,2,10,-4,5,1,4,7,25,2,3,1,4,1,10,3,2,0,0,6,15,-1
4,04072,Partaloa,377,-1,0,-1,4,3,1,-2,-1,-2,1,4,-1,-2,0,-1,0,3,0,0,-1,-1,1,1,-1,0,0,0,1,3,0,0,0,0,1,2,0,0,0,0,0,1,0,18,12,6,14,8,6,0,0,4,3,8,2,0,0,5,0,5,1,0,0,-1,3,3,1,0,1,4,2,5,2,0,1,3,0,2,2,0,0,1,2,3,0,81,35,46,59,30,29,14,3,7,11,38,8,5,0,-1,8,17,6,9,3,8,3,21,2,9,1,7,8,31,3,4,1,1,5,16,3,5,0,6,3,15,0,67,32,35,51,24,27,9,2,10,15,25,6,4,0,7,7,10,4,5,2,3,8,15,2,7,1,8,16,14,5,4,0,3,8,6,3,3,1,5,8,8,2,89,48,41,72,39,33,7,2,7,24,47,2,3,1,6,14,23,1,4,1,1,10,24,1,6,1,3,21,37,4,4,1,2,12,18,2,2,0,1,9,19,2,78,40,38,73,41,32,-1,5,2,16,54,2,0,1,0,9,29,1,-1,4,2,7,25,1,2,4,4,18,41,4,1,1,2,14,22,1,1,3,2,4,19,3,75,45,30,86,48,38,8,0,2,14,43,9,7,-1,3,7,23,6,1,1,-1,7,20,3,8,3,6,17,42,10,7,1,3,10,21,6,1,2,3,7,21,4,71,29,42,72,37,35,7,0,4,10,46,4,2,-1,3,2,22,1,5,1,1,8,24,3,6,1,5,11,43,6,3,1,3,5,23,2,3,0,2,6,20,4,46,25,21,45,25,20,2,0,0,10,29,5,3,1,-1,2,16,4,-1,-1,1,8,13,1,5,0,0,12,25,3,4,0,0,4,16,1,1,0,0,8,9,2,40,18,22,28,12,16,1,3,3,12,21,0,-2,1,2,6,10,1,3,2,1,6,11,-1,-1,3,1,7,17,1,-2,1,2,3,7,1,1,2,-1,4,10,0,27,14,13,7,3,4,6,3,5,5,6,2,1,3,2,2,6,0,5,0,3,3,0,2,4,0,2,1,1,-1,0,0,1,1,2,-1,4,0,1,0,-1,0,62,31,31,49,21,28,7,6,-1,9,32,8,4,5,-2,5,14,5,3,1,1,4,18,3,3,1,3,3,30,8,1,1,1,1,12,5,2,0,2,2,18,3,22,6,16,29,14,15,-1,1,-3,6,16,2,0,2,-3,-3,8,2,-1,-1,0,9,8,0,0,1,0,8,16,4,0,1,0,2,8,3,0,0,0,6,8,1,5,2,3,15,7,8,-2,0,3,1,2,0,-1,0,2,0,0,1,-1,0,1,1,2,-1,1,0,2,2,6,4,1,0,0,1,2,3,0,0,2,1,4,1,20,11,9,25,13,12,-2,-1,2,-5,12,12,-2,0,1,-1,3,9,0,-1,1,-4,9,3,0,1,-1,0,12,11,0,0,0,0,5,7,0,1,-1,0,7,4,82,43,39,76,40,36,2,2,-2,23,48,9,1,1,1,9,27,4,1,1,-3,14,21,5,0,2,3,18,45,8,0,1,3,7,24,5,0,1,0,11,21,3,69,40,29,55,25,30,5,6,7,12,24,15,1,4,5,8,13,9,4,2,2,4,11,6,4,2,3,11,22,13,0,1,1,6,11,6,4,1,2,5,11,7,52,27,25,59,31,28,1,-3,-2,9,35,11,1,-1,-2,1,23,4,0,-2,0,8,12,7,0,1,2,9,36,10,0,0,1,3,21,5,0,1,1,6,15,5
4,04076,Purchena,1623,-1,5,-6,7,3,4,-3,9,-4,5,-3,-5,-2,6,-2,5,-1,-1,-1,3,-2,0,-2,-4,1,1,1,2,0,2,0,1,0,1,0,1,1,0,1,1,0,1,39,27,12,6,4,2,2,16,20,3,1,-3,1,10,15,0,1,0,1,6,5,3,0,-3,3,0,1,2,0,0,2,0,1,1,0,0,1,0,0,1,0,0,35,33,2,51,29,22,16,10,3,10,1,-4,11,8,9,8,0,-2,5,2,-6,2,1,-2,18,12,3,17,1,0,10,8,2,8,1,0,8,4,1,9,0,0,-29,-27,-2,28,16,12,-1,0,-17,-10,3,-5,-3,-3,-12,-10,0,-1,2,3,-5,0,3,-4,4,8,4,6,3,1,0,4,2,6,1,1,4,4,2,0,2,0,6,0,6,45,25,20,2,-10,-3,17,5,-6,1,-6,-4,11,0,-2,1,-4,1,6,5,-4,6,8,10,13,6,0,2,6,7,7,2,0,4,2,3,6,4,0,45,20,25,43,22,21,17,9,4,12,2,2,8,4,3,4,0,2,9,5,1,8,2,0,15,8,8,8,4,0,6,5,4,5,2,0,9,3,4,3,2,0,-37,-8,-29,23,18,5,-14,-1,-5,-5,-4,-7,-6,1,-1,0,2,-2,-8,-2,-4,-5,-6,-5,0,9,4,5,5,0,0,7,3,5,3,0,0,2,1,0,2,0,-23,-20,-3,7,3,4,-10,5,-1,-15,-1,-2,-6,0,-1,-11,-2,0,-4,5,0,-4,1,-2,0,1,2,1,2,1,0,1,1,0,0,1,0,0,1,1,2,0,32,29,3,7,0,7,24,14,-18,6,2,5,22,12,-5,0,-1,2,2,2,-13,6,3,3,3,4,2,-1,-1,0,2,3,0,-4,-1,0,1,1,2,3,0,0,38,25,13,13,11,2,18,-1,2,2,10,6,19,0,-2,4,1,3,-1,-1,4,-2,9,3,8,2,3,0,-1,0,6,3,1,0,0,0,2,-1,2,0,-1,0,8,13,-5,9,5,4,2,1,7,2,-3,2,2,3,7,3,-2,2,0,-2,0,-1,-1,0,1,3,1,3,1,0,0,3,1,1,0,0,1,0,0,2,1,0,-6,-7,1,-1,-1,0,15,-6,-10,-4,-1,-1,6,-2,-7,-6,-1,1,9,-4,-3,2,0,-2,2,-3,-2,1,1,0,2,-2,-2,0,1,0,0,-1,0,1,0,0,-28,2,-30,3,16,-13,0,-4,-12,-10,2,-4,10,-1,-4,-4,1,-1,-10,-3,-8,-6,1,-3,3,8,-6,1,-2,-1,11,9,-3,0,-1,0,-8,-1,-3,1,-1,-1,-49,-26,-23,-10,-5,-5,5,-25,-6,-12,-9,0,3,-16,-7,-3,-3,0,2,-9,1,-9,-6,0,-1,0,-1,-6,-1,-1,0,0,-1,-3,0,-1,-1,0,0,-3,-1,0,27,7,20,-6,0,-6,10,-10,15,-1,11,4,10,-8,2,-6,8,2,0,-2,13,5,3,2,-1,1,-2,-3,-1,0,0,3,-2,-2,1,0,-1,-2,0,-1,-2,0,-26,-7,-19,11,8,3,10,-5,-17,-6,-3,-5,12,-5,-6,-2,-1,-5,-2,0,-11,-4,-2,0,3,5,2,1,0,0,3,4,0,1,0,0,0,1,2,0,0,0,9,6,3,27,20,7,29,-21,0,3,-2,0,18,-15,1,3,-2,1,11,-6,-1,0,0,-1,12,6,1,1,4,3,12,5,0,1,0,2,0,1,1,0,4,1,11,17,-6,39,31,8,19,9,-1,-13,-4,2,19,15,-2,-10,-3,-2,0,-6,1,-3,-1,4,11,23,2,1,1,1,11,19,0,1,0,0,0,4,2,0,1,1
4,04079,Roquetas de Mar,42333,342,-36,378,192,115,77,124,42,44,26,79,44,60,-18,-88,-31,30,17,64,60,132,57,49,27,34,38,65,27,17,9,17,21,49,14,9,4,17,17,16,13,8,5,2729,1355,1374,1832,984,848,580,499,933,433,200,74,315,225,444,221,109,37,265,274,489,212,91,37,447,365,574,267,122,47,245,177,322,150,60,25,202,188,252,117,62,22,2271,702,1569,2224,1083,1141,654,399,598,289,186,140,328,72,71,68,94,71,326,327,527,221,92,69,557,426,688,326,143,72,299,164,343,170,69,34,258,262,345,156,74,38,3614,1733,1881,2768,1545,1223,753,767,1190,514,238,146,331,360,611,251,113,68,422,407,579,263,125,78,528,656,945,391,171,66,257,335,601,226,84,38,271,321,344,165,87,28,5927,3633,2294,5167,3540,1627,700,1459,2502,822,302,131,343,866,1708,490,147,71,357,593,794,332,155,60,503,1392,2256,776,181,53,251,884,1743,536,93,30,252,508,513,240,88,23,4402,2444,1958,4028,2584,1444,559,1114,1668,657,266,119,284,621,992,375,121,44,275,493,676,282,145,75,487,1133,1510,620,199,65,273,700,1059,416,95,34,214,433,451,204,104,31,2113,706,1407,2116,1033,1083,455,528,568,217,190,122,241,185,74,64,76,59,214,343,494,153,114,63,466,543,564,314,153,62,255,275,239,161,68,30,211,268,325,153,85,32,3856,1675,2181,3246,1616,1630,777,1166,958,481,291,159,387,592,307,159,143,70,390,574,651,322,148,89,654,1004,886,436,197,54,333,540,416,194,103,25,321,464,470,242,94,29,3814,2367,1447,3045,1995,1050,344,964,1568,597,163,142,193,622,1036,354,81,61,151,342,532,243,82,81,321,866,1205,469,132,37,188,562,849,305,63,20,133,304,356,164,69,17,2684,1824,860,816,438,378,177,751,1375,144,77,128,94,544,1004,66,49,56,83,207,371,78,28,72,25,414,308,0,28,25,14,256,182,-54,14,19,11,158,126,54,14,6,2963,2022,941,1299,626,673,148,878,1370,309,103,107,82,636,983,202,50,47,66,242,387,107,53,60,154,440,392,130,103,55,67,239,185,46,50,28,87,201,207,84,53,27,962,158,804,1236,632,604,261,189,35,170,162,111,129,14,-173,33,89,50,132,175,208,137,73,61,199,337,314,172,135,68,102,179,158,86,64,36,97,158,156,86,71,32,1253,385,868,153,-174,327,289,332,187,90,180,110,165,147,-55,-30,75,47,124,185,242,120,105,63,80,225,-201,-66,53,39,27,107,-247,-97,4,16,53,118,46,31,49,23,-247,-452,205,-1216,-1075,-141,-61,152,-255,-166,7,40,-30,36,-337,-152,11,1,-31,116,82,-14,-4,39,-87,8,-690,-400,-43,-20,-41,-47,-634,-331,-14,-15,-46,55,-56,-69,-29,-5,-2996,-1697,-1299,-3836,-2230,-1606,-343,66,-836,-994,-509,-400,-153,47,-504,-606,-314,-198,-190,19,-332,-388,-195,-202,-483,-78,-1146,-1170,-540,-447,-251,-7,-706,-725,-347,-216,-232,-71,-440,-445,-193,-231,1144,548,596,-71,-104,33,163,305,186,243,121,74,36,179,73,165,40,30,127,126,113,78,81,44,-38,197,-182,-61,8,-16,-39,121,-142,-37,-10,-8,1,76,-40,-24,18,-8,1813,1152,661,557,382,175,201,391,629,361,118,52,122,262,415,229,82,5,79,129,214,132,36,47,40,313,194,6,5,-24,41,201,145,-11,9,-15,-1,112,49,17,-4,-9,730,441,289,-60,-20,-40,48,391,293,-102,8,38,8,253,209,-71,-6,24,40,138,84,-31,14,14,-19,280,-40,-206,-76,-29,-20,180,12,-141,-57,-8,1,100,-52,-65,-19,-21
4,04083,Serón,2673,-18,0,-18,20,13,7,-1,6,-6,-2,0,-16,1,6,-1,-1,4,-10,-2,0,-5,-1,-4,-6,3,6,6,4,1,0,2,5,3,2,1,0,1,1,3,2,0,0,13,9,4,8,7,1,4,2,-3,2,5,3,4,0,-4,3,2,4,0,2,1,-1,3,-1,5,0,2,1,0,0,5,0,1,1,0,0,0,0,1,0,0,0,-25,-17,-8,7,1,6,0,-1,-10,-4,1,-9,-3,-4,-5,-4,1,-2,3,3,-5,0,0,-7,1,2,1,2,1,0,-1,0,1,0,1,0,2,2,0,2,0,0,34,19,15,5,3,2,12,5,10,9,4,-8,7,1,7,2,2,-1,5,4,3,7,2,-7,2,1,1,0,1,0,1,0,1,0,1,0,1,1,0,0,0,0,21,7,14,14,6,8,-10,-1,-3,4,11,20,-6,3,-3,6,5,2,-4,-4,0,-2,6,18,0,2,3,5,4,0,-1,2,1,3,1,0,1,0,2,2,3,0,8,10,-2,16,6,10,10,-2,-10,10,4,-2,5,5,-5,3,2,2,5,-7,-5,7,2,-4,7,2,2,4,1,0,2,1,1,1,1,0,5,1,1,3,0,0,52,28,24,41,25,16,16,5,-5,14,14,8,14,1,-6,5,9,5,2,4,1,9,5,3,14,4,4,10,7,2,9,4,2,5,4,1,5,0,2,5,3,1,-17,-7,-10,29,16,13,4,-4,-9,2,5,-13,0,0,-7,1,4,-4,4,-4,-2,1,1,-9,11,1,6,5,4,1,6,1,4,2,2,1,5,0,2,3,2,0,6,1,5,10,5,5,8,8,-13,-2,3,3,6,3,-7,2,-2,-1,2,5,-6,-4,5,4,4,1,1,2,2,0,2,1,0,1,1,0,2,0,1,1,1,0,13,11,2,1,1,0,7,10,3,-2,3,-10,1,4,4,2,-1,0,6,6,-1,-4,4,-10,4,2,-1,-2,-3,0,2,1,1,-1,-2,0,2,1,-2,-1,-1,0,21,12,9,10,7,3,6,-9,10,-3,9,9,3,-3,10,-6,6,2,3,-6,0,3,3,7,4,0,3,4,-1,0,3,0,1,3,0,0,1,0,2,1,-1,0,-19,0,-19,1,2,-1,-5,1,-11,4,6,-11,-2,-1,-1,3,6,-4,-3,2,-10,1,0,-7,-1,1,-1,0,2,0,0,1,0,0,1,0,-1,0,-1,0,1,0,-22,-5,-17,-2,-1,-1,4,-3,-16,-2,-2,-3,3,-2,-5,0,1,-2,1,-1,-11,-2,-3,-1,0,-2,0,-1,1,0,0,-1,1,-1,0,0,0,-1,-1,0,1,0,24,20,4,4,3,1,12,1,-2,4,8,1,8,3,-2,1,6,3,4,-2,0,3,2,-2,0,0,0,1,2,1,0,0,0,1,2,0,0,0,0,0,0,1,0,-5,5,7,3,4,-3,0,-2,1,1,3,-2,-2,-8,1,5,1,-1,2,6,0,-4,2,1,-1,0,2,4,1,0,-1,0,1,3,0,1,0,0,1,1,1,-6,-6,0,7,4,3,5,-5,-5,-6,1,5,1,-2,-3,0,0,-1,4,-3,-2,-6,1,6,4,0,2,1,0,0,2,0,2,1,-1,0,2,0,0,0,1,0,-31,-13,-18,3,4,-1,-11,2,-21,-6,7,-3,-5,1,-9,-6,6,-1,-6,1,-12,0,1,-2,0,1,-1,1,2,0,0,1,0,1,2,0,0,0,-1,0,0,0,-1,-3,2,4,2,2,2,0,-4,0,2,0,0,-2,-2,0,4,-2,2,2,-2,0,-2,2,2,0,1,1,2,-2,1,0,1,0,1,-1,1,0,0,1,1,-1
4,04086,Sorbas,2735,0,6,-6,41,27,14,-6,-2,6,3,6,-5,-1,5,1,2,4,-4,-5,-7,5,1,2,-1,1,12,16,11,1,0,1,8,10,7,1,0,0,4,6,4,0,0,90,75,15,120,79,41,10,24,33,25,10,-13,4,22,23,24,7,-5,6,2,10,1,3,-8,17,33,31,28,9,1,8,24,20,20,6,1,9,9,11,8,3,0,43,30,13,80,49,31,7,13,1,19,10,-6,3,10,2,11,9,-3,4,3,-1,8,1,-3,16,22,20,16,6,0,8,13,13,10,5,0,8,9,7,6,1,0,17,22,-5,96,51,45,10,-4,-5,8,21,-12,4,6,2,2,13,-3,6,-10,-7,6,8,-9,24,21,17,12,17,5,10,14,10,5,9,3,14,7,7,7,8,2,98,55,43,117,71,46,17,10,33,14,24,-4,4,7,20,8,18,-4,13,3,13,6,6,0,26,14,31,23,19,4,14,8,19,14,14,2,12,6,12,9,5,2,55,27,28,95,51,44,10,19,1,-4,32,-4,4,12,-3,0,15,-4,6,7,4,-4,17,0,10,19,15,23,25,2,3,12,8,16,10,1,7,7,7,7,15,1,-41,-30,-11,59,39,20,1,-18,-19,-5,4,-2,7,-16,-18,-1,1,-3,-6,-2,-1,-4,3,1,11,8,16,16,7,1,8,3,13,13,2,0,3,5,3,3,5,1,-10,8,-18,74,42,32,-16,-5,-49,24,12,26,-2,2,-20,10,12,6,-14,-7,-29,14,0,20,6,16,16,24,8,1,5,8,11,11,5,0,1,8,5,13,3,1,14,7,7,40,30,10,7,10,6,-2,2,-12,2,4,5,-1,-1,-4,5,6,1,-1,3,-8,7,6,12,9,6,0,5,4,10,8,3,0,2,2,2,1,3,0,-71,-34,-37,-11,-11,0,-21,-4,-28,-7,2,-14,-14,-2,-13,-2,2,-6,-7,-2,-15,-5,0,-8,-3,-2,-6,3,-1,-2,-2,-3,-5,0,0,-1,-1,1,-1,3,-1,-1,-98,-59,-39,-82,-50,-32,-12,-6,-9,-50,-13,-9,-16,-4,-5,-26,-6,-3,4,-2,-4,-24,-7,-6,-10,-6,-6,-37,-19,-6,-6,0,-7,-22,-14,-2,-4,-6,1,-15,-5,-4,-20,-24,4,10,3,7,1,-6,-21,1,11,-6,3,-8,-22,0,5,-2,-2,2,1,1,6,-4,-1,1,-2,1,9,2,1,-1,-4,2,4,1,-2,2,2,-1,5,1,-4,0,-4,21,9,12,2,3,-10,-10,9,-1,0,-1,0,-8,6,0,2,4,-10,-2,3,-1,3,2,4,3,6,2,1,0,3,2,2,1,2,2,1,1,4,1,-65,-42,-23,-46,-34,-12,2,-2,-21,-28,-17,-2,-1,-4,-14,-18,-9,4,3,2,-7,-10,-8,-6,5,-5,-14,-20,-16,4,0,-4,-11,-14,-10,5,5,-1,-3,-6,-6,-1,-59,-41,-18,-40,-24,-16,-2,-1,-9,-14,-16,-19,-3,2,-10,-14,-5,-12,1,-3,1,0,-11,-7,-3,-2,-14,-12,-2,-7,0,0,-9,-9,-1,-5,-3,-2,-5,-3,-1,-2,-34,-27,-7,7,1,6,1,-7,-14,-3,1,-11,-6,-6,-2,-4,-1,-7,7,-1,-12,1,2,-4,0,1,1,3,3,-2,-1,0,0,3,1,-2,1,1,1,0,2,0,-58,-24,-34,0,2,-2,-20,-4,-10,-14,-12,1,-3,0,-3,-14,-8,3,-17,-4,-7,0,-4,-2,-2,1,5,-1,-6,3,0,0,5,-3,-3,3,-2,1,0,2,-3,0,-13,-2,-11,19,13,6,-11,-2,-4,-9,13,1,-1,-5,2,-10,11,2,-10,3,-6,1,2,-1,1,2,3,4,7,2,2,1,2,0,6,2,-1,1,1,4,1,0
4,04088,Tabernas,3241,-1,3,-4,16,7,9,-6,-1,0,6,4,-5,-5,0,2,2,4,-1,-1,-1,-2,4,0,-4,2,4,3,5,2,0,1,2,1,1,2,0,1,2,2,4,0,0,43,22,21,66,36,30,9,3,14,13,10,-6,6,1,3,9,5,-2,3,2,11,4,5,-4,12,10,27,12,4,1,8,6,12,8,1,1,4,4,15,4,3,0,48,39,9,52,34,18,4,21,12,8,5,-3,8,8,11,10,3,-1,-4,13,1,-2,2,-2,11,10,18,10,3,0,7,6,12,7,2,0,4,4,6,3,1,0,67,36,31,42,20,22,15,24,10,17,12,-11,7,7,8,13,7,-6,8,17,2,4,5,-5,8,13,10,6,4,1,4,5,7,1,3,0,4,8,3,5,1,1,212,118,94,210,118,92,29,54,47,52,28,-4,16,28,21,37,14,0,13,26,26,15,14,-4,25,56,50,52,21,2,11,33,27,33,11,2,14,23,23,19,10,0,108,59,49,184,106,78,13,32,33,12,18,-1,-1,18,29,3,10,-1,14,14,4,9,8,0,19,61,54,31,15,3,10,35,35,17,7,1,9,26,19,14,8,2,103,56,47,109,61,48,21,20,33,18,10,0,11,12,14,13,4,0,10,8,19,5,6,0,24,27,34,13,10,0,12,16,19,9,5,-1,12,11,15,4,5,1,67,34,33,119,60,59,-2,12,-1,38,18,0,-1,2,0,19,10,3,-1,10,-1,19,8,-3,13,24,19,40,17,5,5,12,10,20,10,3,8,12,9,20,7,2,18,6,12,34,18,16,6,-11,-3,16,10,-4,0,-4,-7,9,5,-1,6,-7,4,7,5,-3,10,2,3,12,6,1,6,3,-1,7,2,1,4,-1,4,5,4,0,33,18,15,23,14,9,15,2,9,2,6,-3,2,3,5,3,5,-1,13,-1,4,-1,1,-2,4,8,-2,12,1,0,4,6,-3,5,2,0,0,2,1,7,-1,0,34,15,19,35,21,14,9,23,-12,17,6,-10,2,15,-10,6,5,-4,7,8,-2,11,1,-6,10,7,8,1,6,1,6,4,5,-3,6,1,4,3,3,4,0,0,23,24,-1,31,17,14,15,4,23,-6,-7,-4,14,5,9,-1,-2,1,1,-1,14,-5,-5,-5,9,4,13,-1,1,3,5,4,7,-1,-1,1,4,0,6,0,2,2,-30,-19,-11,-4,-4,0,-6,1,1,-20,0,-6,-1,-1,-3,-10,1,-5,-5,2,4,-10,-1,-1,0,6,2,-11,-1,-1,0,2,0,-6,0,-1,0,4,2,-5,-1,0,-30,-11,-19,7,1,6,-4,9,3,-25,-9,-7,0,5,7,-14,-8,-2,-4,4,-4,-11,-1,-5,4,10,2,-7,-3,0,2,5,1,-6,-3,1,2,5,1,-1,0,-1,1,9,-8,-9,-2,-7,3,7,-5,-12,7,1,3,10,1,-9,2,3,0,-3,-6,-3,5,-2,1,1,-3,-9,0,0,0,2,0,-4,-1,0,1,-1,-3,-5,1,0,-34,-21,-13,12,2,10,-4,-1,-16,-12,6,-11,-2,-6,-9,-4,3,-5,-2,5,-7,-8,3,-6,0,9,2,-3,2,0,-1,2,2,0,-1,0,1,7,0,-3,3,0,6,5,1,7,9,-2,-7,9,-5,-2,16,-5,-3,9,-3,-4,7,-1,-4,0,-2,2,9,-4,-1,6,-8,2,7,-2,3,7,-7,-1,6,-1,-4,-1,-1,3,1,-1,59,40,19,28,24,4,21,5,12,16,8,-4,12,6,6,8,6,2,9,-1,6,8,2,-6,1,7,11,4,4,0,-1,6,11,4,2,1,2,1,0,0,2,-1
4,04089,Taberno,1002,28,20,8,22,14,8,7,5,6,5,10,-4,5,4,3,3,6,-1,2,1,3,2,4,-3,6,3,2,6,5,0,4,2,1,4,3,0,2,1,1,2,2,0,20,18,2,25,10,15,-1,11,-1,3,9,-1,3,7,2,2,4,0,-4,4,-3,1,5,-1,7,3,1,9,5,0,5,0,0,4,1,0,2,3,1,5,4,0,21,14,7,31,16,15,-1,-5,-7,7,21,4,-2,-2,1,4,10,3,1,-3,-8,3,11,1,0,0,1,9,20,1,0,0,0,5,10,1,0,0,1,4,10,0,46,27,19,29,20,9,6,8,10,2,16,3,4,7,5,0,8,3,2,1,5,2,8,0,6,3,3,3,12,2,6,3,1,2,7,1,0,0,2,1,5,1,16,5,11,28,11,17,-3,2,-1,8,12,-2,-1,2,-4,2,6,-1,-2,0,3,6,6,-1,2,1,1,9,15,0,1,0,0,2,8,0,1,1,1,7,7,0,28,8,20,35,15,20,4,-1,-1,3,19,4,-2,-2,0,0,11,1,6,1,-1,3,8,3,5,1,5,8,15,1,2,0,2,4,7,0,3,1,3,4,8,1,32,14,18,30,16,14,5,5,3,5,14,0,3,4,1,1,7,-2,2,1,2,4,7,2,5,0,6,5,12,2,2,0,4,2,7,1,3,0,2,3,5,1,12,9,3,14,6,8,4,1,0,7,3,-4,2,0,1,2,1,2,2,1,-1,5,2,-6,2,4,0,4,3,1,1,1,-1,3,2,0,1,3,1,1,1,1,1,0,1,7,3,4,-1,-3,3,4,1,-3,0,-2,0,3,1,-1,-1,-1,3,1,0,-2,0,-1,1,0,5,1,0,0,1,-1,3,0,0,-1,0,1,2,1,27,13,14,15,8,7,4,3,-1,1,14,8,2,-1,2,0,9,3,2,4,-3,1,5,5,3,0,0,1,9,2,2,0,0,0,6,0,1,0,0,1,3,2,64,31,33,13,9,4,18,10,15,12,8,0,8,6,3,7,4,2,10,4,12,5,4,-2,5,1,2,3,3,-1,4,1,0,2,2,0,1,0,2,1,1,-1,0,-1,1,5,2,3,2,2,-4,1,4,-6,3,-2,-1,0,0,-1,-1,4,-3,1,4,-5,0,0,-1,0,6,0,0,0,-1,0,3,0,0,0,0,0,3,0,-30,-18,-12,5,3,2,-8,0,-7,-11,-4,0,-2,-1,-4,-8,-1,-2,-6,1,-3,-3,-3,2,2,0,0,2,0,1,1,0,0,1,0,1,1,0,0,1,0,0,-8,0,-8,9,5,4,-6,1,-4,2,4,-4,-4,2,-1,3,2,-2,-2,-1,-3,-1,2,-2,0,1,1,2,5,0,0,1,1,1,2,0,0,0,0,1,3,0,9,6,3,9,5,4,5,3,-4,4,3,-2,2,1,-1,3,0,2,3,2,-3,1,3,-4,2,2,2,1,1,1,1,1,2,1,-1,1,1,1,0,0,2,0,-3,-4,1,2,0,2,2,-3,3,-6,7,-6,0,-1,-3,-1,4,-3,2,-2,6,-5,3,-3,0,0,1,-2,2,1,0,0,-1,-1,1,1,0,0,2,-1,1,0,15,8,7,15,6,9,2,0,-1,5,8,1,3,-1,-1,1,5,1,-1,1,0,4,3,0,1,0,-2,6,8,2,1,0,-1,2,3,1,0,0,-1,4,5,1,-5,-4,-1,11,3,8,-2,3,-6,2,2,-4,-1,0,-2,0,0,-1,-1,3,-4,2,2,-3,0,1,2,1,9,-2,0,0,0,-1,4,0,0,1,2,2,5,-2
4,04092,Tíjola,3796,42,25,17,24,16,8,4,11,-3,9,0,20,1,9,-1,5,1,10,3,2,-2,4,-1,10,2,6,8,7,1,0,0,4,7,4,1,0,2,2,1,3,0,0,43,24,19,48,28,20,-2,11,9,9,4,11,-3,7,7,7,2,4,1,4,2,2,2,7,4,16,12,12,4,0,1,7,7,11,2,0,3,9,5,1,2,0,21,15,6,39,26,13,3,9,4,4,2,-2,-1,5,8,4,1,-1,4,4,-4,0,1,-1,6,11,16,5,0,0,4,5,14,4,-1,0,2,6,2,1,1,0,-27,-10,-17,38,24,14,-11,-2,-15,1,-3,3,-5,-1,-9,3,-2,4,-6,-1,-6,-2,-1,-1,2,11,16,9,0,-1,0,8,10,6,0,-1,2,3,6,3,0,0,38,15,23,52,27,25,8,7,2,4,13,1,3,5,-1,2,4,2,5,2,3,2,9,-1,6,8,11,11,15,1,2,4,6,8,7,0,4,4,5,3,8,1,100,58,42,59,33,26,21,22,18,18,13,6,10,10,12,9,9,5,11,12,6,9,4,1,16,17,11,9,4,1,6,11,8,4,3,0,10,6,3,5,1,1,67,24,43,49,21,28,32,12,10,2,5,4,9,2,9,2,0,3,23,10,1,0,5,1,12,13,11,3,8,1,5,5,6,2,1,2,7,8,5,1,7,-1,25,2,23,51,25,26,-7,30,-17,15,8,-4,-4,11,-10,6,5,-7,-3,19,-7,9,3,3,9,19,6,14,3,-1,4,9,1,7,3,0,5,10,5,7,0,-1,33,28,5,33,20,13,-3,4,14,-4,9,13,-3,8,11,4,3,5,0,-4,3,-8,6,8,6,11,11,4,1,0,3,5,8,3,1,0,3,6,3,1,0,0,-20,-15,-5,-31,-20,-11,7,5,-16,-14,0,-1,3,0,-10,-10,0,0,4,5,-6,-4,0,-1,0,2,-18,-13,-2,0,2,-1,-10,-11,-1,1,-2,3,-8,-2,-1,-1,-20,-11,-9,6,4,2,-17,-13,-4,3,7,3,-4,-9,1,-5,4,3,-13,-4,-5,8,3,0,-1,1,-1,2,3,2,-1,0,1,1,1,2,0,1,-2,1,2,0,-5,-22,17,13,5,8,4,8,-13,-1,1,-3,3,-2,-13,-5,-1,-2,1,10,0,4,2,-1,3,1,3,3,3,0,3,0,0,1,1,0,0,1,3,2,2,0,7,4,3,11,6,5,4,1,10,5,-2,-11,-1,2,4,1,2,-5,5,-1,6,4,-4,-6,3,-1,2,7,-1,0,1,0,2,4,-1,0,2,-1,0,3,0,0,-23,-16,-7,-4,-1,-3,-14,-1,-3,-3,2,-1,-12,1,2,-5,-2,1,-2,-2,-5,2,4,-2,-3,1,-2,-2,1,1,-2,1,-1,-1,1,1,-1,0,-1,-1,0,0,-57,-24,-33,-1,-1,0,-19,-11,-29,-16,1,15,-6,-4,-15,-5,-2,6,-13,-7,-14,-11,3,9,-2,1,-3,-1,3,1,-2,0,-1,1,1,0,0,1,-2,-2,2,1,2,2,0,7,6,1,-6,2,-7,-4,1,17,-7,1,-2,-3,4,8,1,1,-5,-1,-3,9,1,4,1,0,-1,1,0,3,1,0,0,1,1,1,0,0,-1,0,-11,-2,-9,14,6,8,2,-5,-13,-2,8,0,1,-3,-6,4,2,1,1,-2,-7,-6,6,-1,4,4,2,3,0,1,2,1,0,3,-1,1,2,3,2,0,1,0,-28,-9,-19,4,1,3,5,-14,-9,-7,-6,3,6,-6,-2,-4,-3,-1,-1,-8,-7,-3,-3,4,1,-1,1,1,2,0,2,-2,2,-1,1,-1,-1,1,-1,2,1,1
4,04093,Turre,2233,31,22,9,56,31,25,-7,5,9,1,17,8,-1,5,5,0,8,7,-6,0,4,1,9,1,4,13,10,4,20,5,3,7,6,2,10,3,1,6,4,2,10,2,93,58,35,100,58,42,0,23,12,31,20,7,2,12,15,14,10,5,-2,11,-3,17,10,2,3,19,18,29,20,10,3,9,13,17,10,5,0,10,5,12,10,5,84,55,29,82,44,38,16,8,5,8,34,13,13,5,5,4,18,10,3,3,0,4,16,3,7,5,15,11,31,12,6,3,5,5,15,10,1,2,10,6,16,2,164,87,77,139,74,65,18,25,35,19,49,18,7,10,19,12,28,11,11,15,16,7,21,7,12,19,32,15,46,15,6,8,18,8,25,9,6,11,14,7,21,6,209,127,82,200,111,89,30,18,41,37,66,18,19,11,22,28,34,12,11,7,19,9,32,6,28,21,40,33,62,16,12,13,24,21,31,10,16,8,16,12,31,6,256,147,109,199,109,90,27,31,69,65,53,10,11,14,49,40,24,8,16,17,20,25,29,2,20,27,49,46,51,6,10,11,31,26,26,5,10,16,18,20,25,1,245,119,126,206,108,98,22,45,44,45,78,11,4,24,26,18,37,10,18,21,18,27,41,1,12,31,35,42,68,17,6,17,24,19,31,10,6,14,11,23,37,7,151,76,75,189,108,81,13,13,19,33,43,34,9,7,10,11,21,20,4,6,9,22,22,14,18,22,36,38,45,29,13,10,22,22,23,18,5,12,14,16,22,11,184,108,76,155,93,62,29,18,26,26,67,18,22,9,12,18,33,13,7,9,14,8,34,5,21,22,24,22,53,12,19,10,16,12,28,7,2,12,8,10,25,5,168,88,80,133,60,73,19,29,7,32,55,28,13,13,6,15,28,14,6,16,1,17,27,14,14,19,11,19,45,25,4,7,4,10,21,14,10,12,7,9,24,11,69,29,40,99,49,50,3,3,7,0,35,23,-2,0,0,-4,19,16,5,3,7,4,16,7,11,12,9,12,38,16,6,4,3,5,20,10,5,8,6,7,18,6,36,31,5,64,41,23,-11,22,-9,8,23,3,-9,9,3,6,13,8,-2,13,-12,2,10,-5,5,12,7,16,13,11,3,5,5,13,8,7,2,7,2,3,5,4,54,26,28,52,30,22,3,9,-4,8,26,11,2,5,-1,4,12,5,1,4,-3,4,14,6,3,9,5,9,22,4,1,4,1,7,12,5,2,5,4,2,10,-1,35,4,31,67,26,41,-10,9,-14,10,27,13,-10,7,-7,-5,13,7,0,2,-7,15,14,6,5,6,5,11,25,15,0,2,0,-3,19,8,5,4,5,14,6,7,51,33,18,51,21,30,9,5,9,-9,36,0,4,1,4,1,24,-2,5,4,5,-10,12,2,2,5,7,5,28,3,0,0,1,2,17,1,2,5,6,3,11,2,91,45,46,94,53,41,4,-7,20,-1,53,22,5,-10,14,-4,28,14,-1,3,6,3,25,8,6,10,17,8,41,12,3,5,9,2,26,8,3,5,8,6,15,4,115,60,55,81,42,39,2,4,26,18,33,31,0,1,9,11,18,20,2,3,17,7,15,11,5,0,15,7,30,22,3,-1,8,2,14,15,2,1,7,5,16,7,101,58,43,68,31,37,4,1,26,17,32,19,1,0,14,15,18,10,3,1,12,2,14,9,6,3,13,10,26,9,2,0,6,7,11,5,4,3,7,3,15,4
4,04099,Vélez-Rubio,6502,14,14,0,84,57,27,7,3,-6,-1,-2,11,8,2,3,0,-2,3,-1,1,-9,-1,0,8,6,30,23,16,4,4,5,22,17,9,2,1,1,8,6,7,2,3,142,85,57,153,100,53,15,38,40,39,10,1,7,22,28,19,11,-1,8,16,12,20,-1,2,17,40,56,31,8,1,10,23,41,19,7,0,7,17,15,12,1,1,129,63,66,165,83,82,21,11,17,14,33,31,10,4,13,14,18,2,11,7,4,0,15,29,47,29,38,25,23,1,22,14,16,15,14,1,25,15,22,10,9,0,218,117,101,179,95,84,79,20,43,40,24,11,44,10,21,16,17,10,35,10,22,24,7,1,62,27,40,27,20,3,37,15,17,12,13,1,25,12,23,15,7,2,121,73,48,154,82,72,21,17,29,24,22,5,9,8,22,12,11,9,12,9,7,12,11,-4,33,17,34,37,27,5,14,12,22,17,12,4,19,5,12,20,15,1,114,64,50,124,74,50,16,32,-2,33,18,14,11,34,-13,22,11,-1,5,-2,11,11,7,15,26,22,21,26,22,6,14,17,10,16,13,3,12,5,11,10,9,3,44,25,19,88,35,53,3,15,-3,16,19,-5,-7,8,5,7,9,4,10,7,-8,9,10,-9,13,20,17,19,15,3,6,5,6,8,7,3,7,15,11,11,8,0,88,47,41,89,52,37,16,25,17,-7,32,2,11,2,15,7,10,-1,5,23,2,-14,22,3,12,15,22,12,26,1,5,6,17,11,11,1,7,9,5,1,15,0,15,-2,17,62,35,27,13,13,-21,4,8,-1,-2,12,-13,3,5,-4,15,1,-8,1,3,3,14,14,12,7,11,2,6,8,8,5,7,1,8,6,4,2,4,1,11,16,-5,-5,-10,5,9,9,-9,-4,2,2,13,2,3,-11,-2,11,-4,7,-12,7,4,-9,1,2,-5,-7,-2,6,-2,-2,-1,-7,-4,6,3,4,-4,0,2,0,34,26,8,40,19,21,2,17,-11,20,6,-3,5,11,-4,9,3,4,-3,6,-7,11,3,-7,9,10,8,7,2,1,10,4,2,1,1,1,-1,6,6,6,1,0,-1,23,-24,23,12,11,12,2,-25,13,13,-14,10,12,-10,7,9,-5,2,-10,-15,6,4,-9,6,6,-4,3,9,2,4,6,-2,-1,4,1,2,0,-2,4,5,1,-18,-7,-11,-1,-6,5,0,4,-27,2,4,-3,0,3,-15,-1,4,0,0,1,-12,3,0,-3,-2,-3,-7,-4,9,5,0,-5,-6,-2,4,2,-2,2,-1,-2,5,3,10,11,-1,31,19,12,-4,-8,8,4,6,5,-1,-10,7,5,6,6,-3,2,1,-1,0,-1,-4,10,4,11,7,4,0,4,3,6,4,3,-4,6,1,5,3,1,24,15,9,5,3,2,4,3,-2,3,15,2,4,3,-8,6,8,2,0,0,6,-3,7,0,2,1,-3,1,2,2,2,3,-2,-1,-1,2,0,-2,-1,2,3,0,-8,-13,5,14,1,13,1,-9,4,6,-4,-7,-1,-3,4,-5,-4,-4,2,-6,0,11,0,-3,0,4,4,5,2,-1,0,1,0,-2,2,0,0,3,4,7,0,-1,12,0,12,49,20,29,10,4,-18,4,4,10,-2,-1,0,3,-3,4,12,5,-18,1,7,6,12,8,8,11,6,4,5,0,4,5,4,2,7,8,4,6,2,2,56,55,1,32,18,14,11,3,-5,24,7,12,10,-2,5,21,6,12,1,5,-10,3,1,0,1,5,3,9,11,2,2,1,3,5,3,3,-1,4,0,4,8,-1
4,04100,Vera,6926,299,138,161,222,116,106,30,76,102,62,14,13,8,29,61,29,8,3,22,47,41,33,6,10,13,65,94,34,9,6,8,29,54,16,6,2,5,36,40,18,3,4,473,244,229,310,155,155,96,87,162,76,31,18,49,33,79,50,24,7,47,54,83,26,7,11,57,66,107,42,25,10,30,26,51,29,15,2,27,40,56,13,10,8,560,289,271,349,182,167,133,66,152,103,76,22,79,42,69,47,35,16,54,24,83,56,41,6,78,60,87,51,58,13,43,34,45,24,26,9,35,26,42,27,32,4,777,398,379,564,283,281,168,131,176,132,123,46,78,69,95,75,54,27,90,62,81,57,69,19,139,95,106,83,107,34,68,49,51,44,50,21,71,46,55,39,57,13,741,452,289,505,294,211,89,126,270,113,107,34,64,72,159,78,57,21,25,54,111,35,50,13,49,87,157,91,98,21,32,48,93,58,48,15,17,39,64,33,50,6,859,468,391,513,292,221,119,156,232,184,126,39,47,73,144,117,62,25,72,83,88,67,64,14,54,95,134,92,108,29,28,40,93,54,58,19,26,55,41,38,50,10,1086,579,507,621,335,286,192,168,332,188,147,43,88,83,193,102,69,34,104,85,139,86,78,9,102,123,122,105,125,43,55,62,67,57,61,32,47,61,55,48,64,11,996,512,484,569,288,281,208,161,290,162,111,44,132,70,141,83,57,22,76,91,149,79,54,22,107,111,138,87,92,28,59,46,75,42,47,18,48,65,63,45,45,10,403,226,177,380,206,174,56,75,103,50,95,25,41,57,64,15,40,12,15,18,39,35,55,13,75,62,80,56,88,18,46,37,43,26,42,12,29,25,37,30,46,6,407,200,207,308,159,149,52,43,121,64,72,32,21,13,57,37,41,15,31,30,64,27,31,17,35,51,75,55,67,20,19,24,43,27,31,12,16,27,32,28,36,8,378,201,177,265,137,128,55,39,107,68,76,22,39,9,58,34,42,11,16,30,49,34,34,11,39,36,51,56,54,25,25,13,26,29,27,14,14,23,25,27,27,11,225,104,121,72,50,22,15,12,70,44,53,21,16,5,24,17,23,18,-1,7,46,27,30,3,-14,21,-7,10,46,16,0,10,-5,10,22,13,-14,11,-2,0,24,3,294,169,125,130,59,71,37,61,44,66,47,36,20,28,35,41,27,17,17,33,9,25,20,19,8,29,4,17,42,30,1,13,3,5,20,17,7,16,1,12,22,13,165,92,73,55,26,29,39,7,62,-30,58,30,35,-5,44,-20,31,13,4,12,18,-10,27,17,16,-1,-2,-11,29,24,11,-6,1,-9,16,14,5,5,-3,-2,13,10,198,80,118,92,43,49,6,15,46,33,69,25,-17,-3,20,16,42,23,23,18,26,17,27,2,-11,12,9,11,59,11,-9,5,3,0,34,10,-2,7,6,11,25,1,240,173,67,114,68,46,43,22,73,43,47,14,28,24,53,25,36,7,15,-2,20,18,11,7,12,20,13,15,37,15,3,13,13,5,23,10,9,7,0,10,14,5,-649,-367,-282,-880,-491,-389,23,-15,-17,-172,-178,-305,-1,-20,-12,-88,-96,-158,24,5,-5,-84,-82,-147,-3,-28,-116,-220,-212,-306,-5,-23,-62,-128,-118,-157,2,-5,-54,-92,-94,-149,370,167,203,227,102,125,70,35,82,67,89,18,23,17,47,24,35,13,47,18,35,43,54,5,26,37,32,34,76,22,7,20,20,5,34,16,19,17,12,29,42,6
4,04101,Viator,3493,65,33,32,8,7,1,13,23,11,5,8,6,9,9,1,6,6,4,4,14,10,-1,2,2,0,4,1,2,1,0,0,3,1,2,1,0,0,1,0,0,0,0,-86,-40,-46,8,5,3,-21,-12,-41,-9,0,-3,-7,-2,-21,-8,-1,-1,-14,-10,-20,-1,1,-2,0,2,2,2,2,0,0,2,1,1,1,0,0,0,1,1,1,0,134,89,45,35,20,15,43,32,31,12,12,2,26,26,24,4,9,-1,17,6,7,8,3,3,7,8,9,7,2,0,5,5,7,3,1,-1,2,3,2,4,1,1,97,61,36,19,11,8,26,17,23,18,6,5,13,13,16,8,4,5,13,4,7,10,2,0,5,5,5,1,2,1,3,3,3,0,1,1,2,2,2,1,1,0,49,22,27,19,12,7,17,16,18,-10,1,1,9,7,13,-9,-2,0,8,9,5,-1,3,1,3,5,7,3,0,0,2,2,5,2,0,0,1,3,2,1,0,0,111,60,51,41,20,21,1,54,39,7,8,-1,-4,31,22,1,6,3,5,23,17,6,2,-4,6,14,11,4,6,0,5,5,6,2,2,0,1,9,5,2,4,0,142,63,79,29,12,17,38,26,62,9,6,3,20,11,31,2,-1,2,18,15,31,7,7,1,12,5,10,2,0,0,7,3,1,1,0,0,5,2,9,1,0,0,222,107,115,24,12,12,46,49,71,42,10,-2,26,21,33,26,4,0,20,28,38,16,6,-2,5,6,5,7,2,-1,4,3,1,4,1,-1,1,3,4,3,1,0,192,102,90,49,30,19,11,35,102,19,12,2,6,12,57,15,6,0,5,23,45,4,6,2,9,15,20,4,1,0,6,9,13,3,0,-1,3,6,7,1,1,1,155,85,70,42,26,16,-10,75,54,13,4,13,1,40,25,14,-1,4,-11,35,29,-1,5,9,9,13,12,6,2,0,4,8,9,4,1,0,5,5,3,2,1,0,201,103,98,53,28,25,41,43,72,21,10,1,15,23,34,19,7,1,26,20,38,2,3,0,12,13,16,7,4,0,6,6,9,6,1,0,6,7,7,1,3,0,148,101,47,46,30,16,-1,52,44,25,14,8,-1,36,39,13,8,2,0,16,5,12,6,6,9,14,8,5,4,2,4,10,4,5,2,2,5,4,4,0,2,0,145,73,72,20,8,12,22,36,37,31,-4,10,6,11,38,15,-6,3,16,25,-1,16,2,7,4,4,3,5,2,2,1,2,0,4,0,1,3,2,3,1,2,1,-7,7,-14,14,3,11,-18,24,31,-25,-6,-9,-3,10,27,-18,-3,-4,-15,14,4,-7,-3,-5,3,5,1,4,1,0,1,0,0,2,0,0,2,5,1,2,1,0,64,53,11,2,2,0,12,13,-3,32,3,1,0,12,6,29,3,1,12,1,-9,3,0,0,-2,2,1,-1,1,0,-2,1,2,0,1,0,0,1,-1,-1,0,0,-13,-9,-4,11,3,8,-28,18,11,-13,-2,-5,-16,13,8,-13,-2,-2,-12,5,3,0,0,-3,1,2,5,1,2,0,1,0,2,0,0,0,0,2,3,1,2,0,-62,-48,-14,12,0,12,-5,18,-45,-19,-13,0,-8,9,-33,-12,-7,1,3,9,-12,-7,-6,-1,3,5,0,3,1,0,-1,1,-2,1,1,0,4,4,2,2,0,0,36,10,26,28,20,8,1,14,-5,14,13,-2,-3,9,-8,8,3,-1,4,5,3,6,10,-1,4,7,7,9,1,0,3,5,5,6,1,0,1,2,2,3,0,0
4,04102,Vícar,15356,479,366,113,741,592,149,57,150,211,54,3,5,24,121,164,56,3,0,33,29,47,-2,0,5,94,201,320,105,16,4,54,167,268,90,11,1,40,34,52,15,5,3,-120,-134,14,312,184,128,34,9,-114,-63,0,6,23,0,-98,-60,0,-2,11,9,-16,-3,0,8,82,58,106,41,14,3,42,37,71,22,7,2,40,21,35,19,7,1,-33,-159,126,409,208,201,84,-4,-135,-12,18,8,32,-23,-147,-38,9,3,52,19,12,26,9,5,120,73,127,54,27,6,64,32,74,22,12,2,56,41,53,32,15,4,482,228,254,590,360,230,135,142,136,20,26,15,74,58,70,3,14,3,61,84,66,17,12,12,160,130,204,70,19,4,92,68,143,42,10,2,68,62,61,28,9,2,2105,1716,389,2116,1742,374,177,771,866,235,37,12,103,660,740,177,26,6,74,111,126,58,11,6,162,731,907,267,38,9,84,627,786,217,21,5,78,104,121,50,17,4,825,464,361,834,546,288,122,176,355,106,38,8,73,83,209,67,11,8,49,93,146,39,27,0,110,232,331,125,29,5,59,153,230,90,12,2,51,79,101,35,17,3,244,-116,360,398,140,258,132,84,-95,60,18,38,75,-6,-218,9,9,9,57,90,123,51,9,29,136,125,58,52,15,10,67,63,-20,19,9,2,69,62,78,33,6,8,277,-92,369,485,189,296,113,237,-107,0,28,7,71,115,-242,-51,12,-1,42,122,135,51,16,8,108,226,76,53,16,3,60,128,-10,-2,10,0,48,98,86,55,6,3,915,576,339,744,520,224,71,312,381,119,21,1,11,204,268,78,10,-1,60,108,113,41,11,2,58,247,304,111,26,-6,27,169,230,82,15,-4,31,78,74,29,11,-2,341,280,61,359,233,126,27,143,91,43,19,7,15,98,107,44,11,2,12,45,-16,-1,8,5,57,125,129,37,5,-2,30,83,98,17,3,-2,27,42,31,20,2,0,243,100,143,161,81,80,28,43,70,54,4,39,-5,33,23,22,10,14,33,10,47,32,-6,25,30,48,57,24,-5,3,14,29,28,7,0,1,16,19,29,17,-5,2,204,13,191,160,41,119,71,64,-14,29,15,31,22,8,-45,10,0,11,49,56,31,19,15,20,29,77,13,24,10,2,21,36,-23,0,4,-1,8,41,36,24,6,3,41,2,39,-50,-60,10,31,25,45,-44,-15,5,26,18,0,-28,-9,1,5,7,45,-16,-6,4,1,27,-28,-58,5,2,0,17,-29,-47,-3,1,1,10,1,-11,8,1,9,42,-33,-94,-46,-48,37,46,-38,-56,-8,30,31,44,-15,-40,-1,18,6,2,-23,-16,-7,12,-7,26,-52,-57,-12,5,1,26,-39,-33,-4,2,-8,0,-13,-24,-8,3,83,81,2,8,23,-15,-41,90,27,8,-3,1,-20,68,52,-11,0,-5,-21,22,-25,19,-3,6,-13,70,-11,-19,-19,-2,-9,48,9,-13,-9,-3,-4,22,-20,-6,-10,1,152,144,8,181,138,43,-25,74,119,-21,-10,15,9,41,81,9,-4,9,-34,33,38,-30,-6,6,9,93,72,16,-4,-5,4,65,41,28,2,-2,5,28,31,-12,-6,-3,27,32,-5,83,68,15,-20,87,-27,-81,4,66,-5,60,-4,-50,6,26,-15,27,-23,-31,-2,40,14,94,34,-48,-13,-1,13,62,31,-28,-12,0,1,32,3,-20,-1,-1,99,94,5,151,129,22,-3,87,109,-69,-14,-1,7,67,79,-43,-7,-1,-10,20,30,-26,-7,0,-6,94,123,-56,-5,-3,-1,77,100,-45,-4,-1,-5,17,23,-11,-1,-2
4,04103,Zurgena,2079,17,16,1,14,11,3,0,-2,1,10,5,1,1,-3,3,9,5,0,-1,1,-2,1,0,1,0,2,4,6,2,0,0,0,4,5,2,0,0,2,0,1,0,0,52,39,13,68,43,25,11,5,9,13,11,3,11,7,6,7,6,2,0,-2,3,6,5,1,13,15,16,13,9,2,11,10,9,6,6,1,2,5,7,7,3,1,33,12,21,48,24,24,-4,4,9,8,11,2,-2,4,4,4,3,-2,-2,0,5,4,8,4,7,6,15,10,9,1,3,4,7,6,4,0,4,2,8,4,5,1,74,34,40,68,34,34,-7,11,10,12,39,10,-4,3,7,5,15,8,-3,8,3,7,24,2,8,9,11,9,28,3,6,5,8,1,11,3,2,4,3,8,17,0,56,31,25,88,46,42,1,-2,-14,29,33,9,1,-1,-3,15,16,3,0,-1,-11,14,17,6,10,3,8,28,30,9,6,2,6,13,15,4,4,1,2,15,15,5,201,89,112,174,82,92,23,10,22,34,85,24,10,-2,12,13,41,15,13,12,10,21,44,9,19,9,15,42,76,13,8,0,8,22,35,9,11,9,7,20,41,4,277,137,140,249,119,130,26,24,15,58,130,25,15,6,9,34,59,15,11,18,6,24,71,10,25,19,26,47,118,14,10,4,12,25,59,9,15,15,14,22,59,5,281,141,140,292,139,153,5,15,20,42,170,31,1,9,10,16,84,22,4,6,10,26,86,9,10,22,28,46,157,29,2,9,11,21,77,19,8,13,17,25,80,10,109,59,50,148,74,74,0,3,-17,21,87,18,0,4,-12,13,37,19,0,-1,-5,8,50,-1,8,10,12,29,79,10,3,6,8,13,34,10,5,4,4,16,45,0,40,23,17,51,24,27,-5,5,-24,9,52,3,-4,1,-3,3,23,2,-1,4,-21,6,29,1,-1,2,-10,8,46,6,1,0,-3,3,19,4,-2,2,-7,5,27,2,109,54,55,85,40,45,9,5,8,16,57,13,9,3,6,4,23,9,0,2,2,12,34,4,10,7,9,11,42,6,5,2,7,2,20,4,5,5,2,9,22,2,90,53,37,74,40,34,6,-5,15,27,33,16,3,-2,8,15,18,12,3,-3,7,12,15,4,9,3,11,21,24,6,4,2,3,13,13,5,5,1,8,8,11,1,41,20,21,67,35,32,0,-2,8,-2,36,1,-3,-2,9,0,15,2,3,0,-1,-2,21,-1,4,2,9,12,32,7,1,1,6,8,14,5,3,1,3,4,18,2,6,13,-7,3,5,-2,4,-2,4,-13,11,0,5,3,7,-13,3,8,-1,-5,-3,0,8,-8,3,-3,-7,-7,14,1,2,0,-2,-6,8,3,1,-3,-5,-1,6,-2,-52,-29,-23,-69,-34,-35,-9,-9,-28,-27,34,-15,-3,-7,-15,-20,18,-3,-6,-2,-13,-7,16,-12,-10,-13,-14,-30,21,-23,-5,-7,-4,-19,12,-11,-5,-6,-10,-11,9,-12,23,15,8,14,15,-1,5,14,17,-8,10,-13,6,1,8,-3,9,-5,-1,13,9,-5,1,-8,3,9,8,-7,13,-12,4,3,4,-3,10,-3,-1,6,4,-4,3,-9,-43,-13,-30,-5,5,-10,-8,-3,-17,-5,18,-28,-5,-5,-6,-3,16,-11,-3,2,-11,-2,2,-17,7,1,6,6,8,-34,5,0,2,2,9,-14,2,1,4,4,-1,-20,82,31,51,85,38,47,7,-5,2,5,56,18,2,2,-2,-1,21,9,5,-7,4,6,35,9,2,3,-1,9,57,15,1,4,-2,4,22,9,1,-1,1,5,35,6
5,05014,Arenas de San Pedro,6494,53,27,26,24,11,13,4,-6,12,14,16,12,0,-3,9,6,7,9,4,-3,3,8,9,3,6,0,8,6,3,1,4,0,3,2,1,1,2,0,5,4,2,0,94,45,49,20,11,9,10,3,36,12,24,8,4,0,18,10,11,1,6,3,18,2,13,7,2,2,8,2,3,2,2,2,4,1,1,0,0,0,4,1,2,2,60,22,38,44,21,23,12,11,6,9,15,3,5,8,-5,6,3,3,7,3,11,3,12,0,4,8,17,9,7,-1,2,5,6,6,3,-1,2,3,11,3,4,0,17,5,12,23,13,10,0,2,0,0,-3,18,4,3,-7,-2,-1,8,-4,-1,7,2,-2,10,0,4,7,6,4,2,0,2,2,6,1,2,0,2,5,0,3,0,129,53,76,44,23,21,37,6,15,44,14,14,14,8,2,17,7,5,23,-2,13,27,7,9,10,9,12,9,3,1,6,5,4,7,0,1,4,4,8,2,3,0,68,28,40,44,21,23,7,2,21,10,20,4,3,-7,15,6,5,3,4,9,6,4,15,1,5,9,16,7,4,3,2,4,8,3,2,2,3,5,8,4,2,1,131,73,58,73,43,30,33,15,17,43,22,-3,15,-2,23,26,12,-2,18,17,-6,17,10,-1,14,15,26,15,0,3,7,6,17,10,1,2,7,9,9,5,-1,1,143,97,46,107,58,49,13,27,51,33,23,-5,6,21,31,30,13,-5,7,6,20,3,10,0,22,31,30,19,5,0,10,18,20,8,3,-1,12,13,10,11,2,1,-12,-11,-1,37,16,21,17,-1,-16,2,2,-19,6,7,-14,-5,0,-7,11,-8,-2,7,2,-12,11,10,7,2,1,4,3,5,3,2,1,1,8,5,4,0,0,3,21,4,17,14,4,10,3,-15,1,-3,23,14,6,-8,-6,-5,12,7,-3,-7,7,2,11,7,5,0,3,2,3,1,2,1,0,1,0,0,3,-1,3,1,3,1,-38,-3,-35,-8,-5,-3,-10,-19,-12,-3,9,-4,0,-8,-12,7,7,0,-10,-11,0,-10,2,-4,-4,1,-2,-4,2,-1,-4,2,1,-4,1,-1,0,-1,-3,0,1,0,-25,-9,-16,-13,-11,-2,-2,-12,-17,13,3,-8,-10,-8,-3,6,8,1,8,-4,-14,7,-5,-9,-1,-2,-3,-7,0,0,0,-5,-1,-5,-2,2,-1,3,-2,-2,2,-2,-53,-26,-27,-11,-7,-4,-5,-22,-7,-9,-4,-6,-3,-11,-12,1,0,-3,-2,-11,5,-10,-4,-3,3,-3,-3,-2,-4,-2,0,-4,-3,2,-1,-1,3,1,0,-4,-3,-1,-5,4,-9,-4,-5,1,6,2,-10,1,6,-15,4,4,-1,0,4,-6,2,-2,-9,1,2,-9,2,0,-2,-6,1,0,0,1,-2,-5,1,0,2,-1,0,-1,0,0,-27,-35,8,4,0,4,-1,2,-10,-4,-6,-7,-8,-1,-8,0,-13,-5,7,3,-2,-4,7,-2,-1,3,-3,1,2,2,0,2,-4,2,0,0,-1,1,1,-1,2,2,4,-2,6,21,7,14,12,-17,5,-8,3,6,8,-8,-4,-14,7,6,4,-9,9,6,-4,0,5,3,7,1,0,5,2,0,1,0,0,4,3,3,6,1,0,1,-3,-21,18,21,1,20,-18,-2,-4,3,-1,15,-17,-1,-6,5,-7,4,-1,-1,2,-2,6,11,-3,2,13,0,2,5,-4,-1,4,0,0,2,1,3,9,0,2,3,-21,-3,-18,11,8,3,2,-8,-25,-4,11,-1,0,-5,-12,2,6,4,2,-3,-13,-6,5,-5,-1,5,2,4,1,0,0,2,4,1,0,1,-1,3,-2,3,1,-1
5,05016,Arévalo,7451,4,-6,10,14,5,9,-6,2,-4,4,-3,14,-1,1,-6,1,-1,3,-5,1,2,3,-2,11,0,2,4,5,1,2,0,1,2,1,0,1,0,1,2,4,1,1,56,24,32,32,16,16,10,12,26,9,-4,3,8,2,10,1,1,2,2,10,16,8,-5,1,6,7,13,5,1,0,4,2,7,3,0,0,2,5,6,2,1,0,67,27,40,33,16,17,4,7,40,9,-4,7,2,-1,21,7,-7,2,2,8,19,2,3,5,5,10,10,3,2,2,3,5,5,2,0,1,2,5,5,1,2,1,47,16,31,17,7,10,29,-6,15,-3,8,5,17,-3,2,-7,3,3,12,-3,13,4,5,2,4,6,2,4,0,1,2,2,0,2,0,1,2,4,2,2,0,0,77,54,23,24,9,15,11,15,23,21,-1,10,3,6,22,15,4,4,8,9,1,6,-5,6,6,10,6,1,0,1,3,2,3,1,0,0,3,8,3,0,0,1,26,4,22,32,15,17,16,-5,1,5,2,9,9,-7,-1,0,0,5,7,2,2,5,2,4,6,6,14,5,1,0,5,3,4,2,1,0,1,3,10,3,0,0,91,47,44,70,37,33,43,7,15,20,9,0,25,10,-7,23,2,-4,18,-3,22,-3,7,4,21,16,20,10,2,1,13,9,9,7,-1,0,8,7,11,3,3,1,137,100,37,121,68,53,24,37,14,43,14,5,19,23,20,29,6,4,5,14,-6,14,8,1,32,31,29,25,2,2,18,16,17,14,2,1,14,15,12,11,0,1,24,19,5,45,24,21,-15,16,20,-2,9,-6,-2,6,14,-4,1,2,-13,10,6,2,8,-8,13,12,14,4,2,0,8,7,7,0,1,1,5,5,7,4,1,-1,37,14,23,32,12,20,5,4,20,1,3,7,0,1,11,-1,1,4,5,3,9,2,2,3,10,8,7,2,4,0,4,3,3,0,2,0,6,5,4,2,2,0,8,5,3,11,3,8,-2,-3,-16,3,8,18,-5,-2,-7,2,7,10,3,-1,-9,1,1,8,6,4,-1,3,-1,0,2,2,0,0,-1,0,4,2,-1,3,0,0,10,9,1,-35,-19,-16,16,-7,-10,2,14,-3,8,2,-8,0,4,4,8,-9,-2,2,10,-7,-3,-6,-12,-10,-2,-2,-2,-2,-7,-6,-1,-1,-1,-4,-5,-4,-1,-1,75,22,53,6,0,6,29,5,18,17,4,1,18,3,-2,4,1,0,11,2,20,13,3,1,1,8,-4,-4,3,1,2,4,-3,-4,1,0,-1,4,-1,0,2,1,-35,-22,-13,-44,-27,-17,6,-12,-17,-4,-6,-3,6,-11,-13,-4,1,-2,0,-1,-4,0,-7,-1,-2,-6,-18,-11,-7,0,0,-5,-11,-6,-5,0,-2,-1,-7,-5,-2,0,19,1,18,-15,-13,-2,9,-2,-10,9,0,12,4,-2,-12,8,-3,7,5,0,2,1,3,5,-1,-1,-8,-1,-4,0,0,-2,-5,-3,-3,0,-1,1,-3,2,-1,0,-34,-22,-12,0,-2,2,-7,-29,-18,10,-6,19,-1,-9,-12,3,-7,7,-6,-20,-6,7,1,12,-5,-1,-2,1,0,7,-3,1,-1,-1,0,2,-2,-2,-1,2,0,5,-10,-4,-6,1,1,0,9,-8,-18,8,4,-5,6,-2,-4,-6,4,-2,3,-6,-14,14,0,-3,2,3,-4,-1,1,0,2,3,-1,-2,-1,0,0,0,-3,1,2,0,-31,-14,-17,-3,-4,1,3,-10,-10,0,-3,-9,-1,-3,-8,1,-1,-3,4,-7,-2,-1,-2,-6,-2,3,-1,1,-3,-1,-1,1,-1,-1,-2,0,-1,2,0,2,-1,-1
5,05019,Ávila,47682,154,49,105,193,84,109,25,-25,84,51,-14,27,17,-30,36,17,-14,17,8,5,48,34,0,10,26,35,80,40,9,2,10,12,43,17,2,0,16,23,37,23,7,2,547,237,310,378,187,191,41,66,235,88,61,50,21,15,118,43,11,27,20,51,117,45,50,23,37,85,151,78,24,1,19,38,84,39,6,1,18,47,67,39,18,0,484,183,301,337,160,177,141,51,183,53,24,23,62,4,87,16,-4,13,79,47,96,37,28,10,69,71,114,55,23,4,33,30,67,24,5,1,36,41,47,31,18,3,439,205,234,313,139,174,137,27,153,54,1,58,61,5,70,39,-2,29,76,22,83,15,3,29,67,66,103,50,19,6,29,20,54,22,10,3,38,46,49,28,9,3,561,288,273,461,244,217,75,87,193,103,24,76,38,44,110,47,8,34,37,43,83,56,16,42,70,108,169,78,27,9,38,48,105,41,9,3,32,60,64,37,18,6,1261,598,663,775,357,418,261,231,406,238,48,51,145,103,178,127,11,20,116,128,228,111,37,31,150,200,228,147,31,15,80,89,110,68,7,3,70,111,118,79,24,12,1398,741,657,1044,534,510,339,217,380,329,57,53,161,114,201,205,29,16,178,103,179,124,28,37,232,250,301,213,32,12,106,122,163,124,15,3,126,128,138,89,17,9,2000,1058,942,1565,850,715,442,415,536,375,119,72,208,227,288,213,55,45,234,188,248,162,64,27,331,428,461,261,58,10,151,236,276,152,24,1,180,192,185,109,34,9,746,379,367,770,391,379,185,168,163,121,31,64,80,68,112,64,16,29,105,100,51,57,15,35,158,219,219,127,33,7,83,86,133,66,15,2,75,133,86,61,18,5,553,175,378,424,173,251,146,50,87,94,54,85,83,7,7,14,2,45,63,43,80,80,52,40,155,131,70,53,9,1,78,54,26,14,0,0,77,77,44,39,9,1,204,49,155,391,171,220,112,29,32,6,9,15,48,6,21,-24,-8,10,64,23,11,30,17,5,112,118,90,44,20,1,52,47,44,19,7,0,60,71,46,25,13,1,153,51,102,324,159,165,37,19,9,3,-1,67,24,1,-15,-9,-4,38,13,18,24,12,3,29,54,106,79,49,25,3,35,45,38,24,13,1,19,61,41,25,12,2,-94,-109,15,220,102,118,-26,50,-150,-46,15,49,1,19,-106,-39,2,10,-27,31,-44,-7,13,39,33,120,19,27,11,4,21,51,12,13,1,0,12,69,7,14,10,4,-105,-93,-12,11,-3,14,58,-1,-133,-26,-62,49,35,-18,-78,-23,-30,20,23,17,-55,-3,-32,29,34,50,-47,-25,-13,10,22,22,-26,-16,-11,4,12,28,-21,-9,-2,6,-148,-112,-36,-11,-21,10,0,-12,-90,-86,-23,44,-1,-4,-63,-55,-11,10,1,-8,-27,-31,-12,34,-2,38,-31,-18,-8,7,1,12,-22,-11,-3,1,-3,26,-9,-7,-5,6,-183,-146,-37,-45,-26,-19,-1,-72,-119,-61,17,44,-4,-44,-77,-67,9,28,3,-28,-42,6,8,16,-6,24,-32,-35,-5,7,-5,16,-11,-27,-3,3,-1,8,-21,-8,-2,4,257,79,178,250,89,161,48,44,26,25,35,40,31,12,-5,0,12,13,17,32,31,25,23,27,44,87,53,25,10,6,29,27,17,5,-1,-1,15,60,36,20,11,7,59,-69,128,262,94,168,121,-26,-43,-43,-54,48,60,-25,-51,-44,-37,15,61,-1,8,1,-17,33,67,114,52,-16,-10,7,32,52,24,-27,-6,3,35,62,28,11,-4,4
5,05102,"Hoyo de Pinares, El",2381,-31,-13,-18,4,1,3,-11,-2,-16,0,0,-2,-4,-1,-6,-1,-1,0,-7,-1,-10,1,1,-2,0,2,1,0,1,0,0,0,1,0,0,0,0,2,0,0,1,0,-19,-13,-6,3,1,2,0,-20,-1,-2,0,3,-1,-11,-2,-3,2,2,1,-9,1,1,-2,1,0,1,0,0,0,2,0,0,0,0,0,1,0,1,0,0,0,1,1,9,-8,4,4,0,6,-2,3,-4,1,-3,5,4,1,-1,2,-2,1,-6,2,-3,-1,-1,2,0,3,-1,0,0,2,0,2,0,0,0,0,0,1,-1,0,0,-19,-14,-5,10,4,6,1,-8,-13,-1,4,-2,-3,-5,-9,1,1,0,4,-3,-4,-2,3,-2,5,1,2,2,0,0,0,1,1,2,0,0,5,0,1,0,0,0,18,15,3,32,22,10,6,2,7,6,-3,-1,1,6,6,4,-3,1,5,-4,1,2,0,-2,7,8,14,3,0,0,4,5,10,3,0,0,3,3,4,0,0,0,30,22,8,60,36,24,3,8,7,9,4,0,7,6,3,6,1,-1,-4,2,4,3,3,1,16,18,11,9,4,2,11,8,10,5,2,0,5,10,1,4,2,2,31,15,16,48,21,27,15,-2,-4,15,3,3,3,0,-1,10,2,1,12,-2,-3,5,1,2,24,7,8,7,0,1,12,0,6,2,0,0,12,7,2,5,0,1,53,32,21,55,31,24,9,14,11,10,2,5,5,7,10,7,-1,3,4,7,1,3,3,2,12,13,17,6,4,2,5,7,13,3,3,0,7,6,4,3,1,2,-37,-21,-16,16,9,7,-7,-8,-9,-12,-1,2,-7,-3,-3,-11,1,2,0,-5,-6,-1,-2,0,2,5,6,0,2,1,0,2,5,0,1,1,2,3,1,0,1,0,-46,-24,-22,-31,-23,-8,-6,-11,-20,-5,-1,-4,1,-2,-19,-4,0,-1,-7,-9,-1,-1,-1,-3,-4,-3,-17,-8,0,-1,-2,-1,-14,-7,0,0,-2,-2,-3,-1,0,-1,-20,-5,-15,-2,0,-2,8,-4,-19,3,-5,-1,3,-1,-9,6,-3,1,5,-3,-10,-3,-2,-2,0,0,-2,-1,1,0,0,0,0,0,0,0,0,0,-2,-1,1,0,-11,-4,-7,4,-1,5,3,-3,-9,5,-2,-4,2,-2,-5,-1,2,-1,1,-1,-4,6,-4,-3,4,4,-2,2,-2,-1,2,2,-2,-1,-1,0,2,2,0,3,-1,-1,-30,-22,-8,8,4,4,-5,-11,-1,-9,0,-2,-2,-7,-4,-9,3,-1,-3,-4,3,0,-3,-1,8,-2,1,2,0,-1,5,-2,0,1,0,0,3,0,1,1,0,-1,-53,-28,-25,0,1,-1,-21,-9,-15,0,0,-8,-14,-4,-7,2,-2,-3,-7,-5,-8,-2,2,-5,0,0,1,0,-1,0,1,1,0,0,-1,0,-1,-1,1,0,0,0,-34,-8,-26,-1,0,-1,-13,-5,-6,-9,6,-5,-5,-1,0,-3,6,-4,-8,-4,-6,-6,0,-1,0,0,1,0,-1,-1,0,0,1,0,0,-1,0,0,0,0,-1,0,-32,-22,-10,-3,-4,1,-4,-7,-8,-8,-2,-3,-1,-6,-5,-9,0,-1,-3,-1,-3,1,-2,-2,-1,0,0,-1,-1,0,0,0,0,-3,-1,0,-1,0,0,2,0,0,-46,-28,-18,11,7,4,-8,-6,-4,-17,-9,-3,-6,0,-3,-13,-5,-2,-2,-6,-1,-4,-4,-1,2,2,4,1,1,0,0,2,3,0,1,0,2,0,1,1,0,0,-39,-16,-23,8,3,5,-6,-9,-7,-13,-2,-3,-7,-4,0,-8,0,2,1,-5,-7,-5,-2,-5,1,2,2,3,-1,0,0,0,1,1,0,0,1,2,1,2,-1,0
6,06002,Aceuchal,5240,-28,-25,-3,7,2,5,-2,-19,-2,-5,-4,7,-3,-13,-4,-5,-1,3,1,-6,2,0,-3,4,1,1,3,2,0,0,0,1,1,0,0,0,1,0,2,2,0,0,33,26,7,2,1,1,4,6,8,-1,6,8,4,5,5,1,4,6,0,1,3,-2,2,2,1,0,1,0,0,0,1,0,0,0,0,0,0,0,1,0,0,0,4,-2,6,2,0,2,4,7,-5,-4,3,0,3,3,-5,-5,2,0,1,4,0,1,1,0,0,2,0,0,0,0,0,1,-1,0,0,0,0,1,1,0,0,0,46,27,19,40,21,19,1,7,8,10,13,7,1,1,5,11,7,2,0,6,3,-1,6,5,0,17,12,8,3,0,0,6,6,7,2,0,0,11,6,1,1,0,59,41,18,82,49,33,-2,34,30,0,1,-3,-3,23,19,1,2,-1,1,11,11,-1,-1,-2,4,34,31,12,0,0,1,22,17,8,0,0,3,12,14,4,0,0,111,75,36,127,88,39,13,48,24,24,3,0,10,33,17,14,3,-1,3,15,7,10,0,1,8,56,43,20,0,0,5,39,28,16,0,0,3,17,15,4,0,0,42,20,22,49,27,22,15,12,7,4,4,1,7,7,1,3,4,-1,8,5,6,1,0,2,11,18,7,8,5,0,6,9,4,5,3,0,5,9,3,3,2,0,79,45,34,113,67,46,18,33,7,12,9,1,9,26,2,5,3,1,9,7,5,7,6,0,21,46,24,16,5,0,12,29,11,11,3,0,9,17,13,5,2,0,22,-8,30,37,11,26,-2,10,10,-3,6,0,-5,-1,1,-5,3,-2,3,11,9,2,3,2,5,5,16,6,3,0,0,-2,8,2,2,0,5,7,8,4,1,0,40,35,5,11,5,6,11,3,13,8,3,2,4,6,14,7,3,1,7,-3,-1,1,0,1,1,3,2,5,0,0,2,1,-1,3,0,0,-1,2,3,2,0,0,2,2,0,-8,-5,-3,4,4,-4,-3,3,-2,4,3,2,-5,1,-2,0,1,-6,2,2,0,2,2,-5,-8,0,1,2,0,-2,-5,0,0,0,2,-3,-3,0,1,-30,-20,-10,-5,-8,3,16,-1,-24,-15,-4,-4,8,-3,-17,-8,-2,0,8,2,-7,-7,-2,-4,10,1,-11,-3,-2,0,8,-2,-10,-4,0,0,2,3,-1,1,-2,0,-26,-18,-8,-14,-14,0,-5,-3,-11,-4,-1,-1,-2,-1,-5,-5,-3,-1,-3,-2,-6,1,2,0,-4,0,-9,0,-1,0,-2,-1,-6,-3,-2,0,-2,1,-3,3,1,0,2,-2,4,0,0,0,-1,0,5,-2,-1,1,-3,-1,-2,2,0,2,2,1,7,-4,-1,-1,6,-2,5,-5,-3,0,2,-1,5,-4,-1,0,4,-1,0,-1,-2,0,-65,-41,-24,-53,-33,-20,-14,9,-37,-20,-5,-2,-8,2,-18,-10,-4,-3,-6,7,-19,-10,-1,1,-13,-1,-21,-14,-6,0,-8,0,-14,-7,-4,0,-5,-1,-7,-7,-2,0,0,-1,1,16,6,10,5,-3,-11,11,-1,-3,0,0,-1,6,-4,-2,5,-3,-10,5,3,-1,4,9,1,1,-2,0,0,4,1,2,-2,0,4,5,0,-1,0,0,-48,-25,-23,-24,-8,-16,-17,0,-15,-17,1,-3,-4,-2,-6,-13,1,-4,-13,2,-9,-4,0,1,-8,0,-8,-11,0,0,-2,1,-2,-8,0,0,-6,-1,-6,-3,0,0,12,0,12,0,-13,13,14,-8,12,0,-6,2,8,-3,4,0,-6,-1,6,-5,8,0,0,3,7,1,4,-6,-7,1,3,-4,-1,-2,-8,0,4,5,5,-4,1,1
6,06011,Almendralejo,27554,113,71,42,119,74,45,-6,46,35,14,13,13,-3,32,19,15,7,1,-3,14,16,-1,6,12,13,41,42,15,5,1,9,26,29,8,0,0,4,15,13,7,5,1,124,69,55,121,68,53,39,30,4,31,10,5,15,7,20,12,8,6,24,23,-16,19,2,-1,30,26,41,17,3,1,17,14,28,8,0,0,13,12,13,9,3,1,371,214,157,248,151,97,80,83,95,87,5,22,31,43,62,67,3,7,49,40,33,20,2,15,44,65,77,54,7,0,22,38,53,32,5,0,22,27,24,22,2,0,301,187,114,148,84,64,58,45,111,80,20,-13,37,25,57,48,21,-1,21,20,54,32,-1,-12,27,35,46,31,7,1,13,22,26,17,5,0,14,13,20,14,2,1,585,335,250,589,365,224,129,167,146,112,22,1,85,105,76,56,8,1,44,62,70,56,14,0,113,168,187,96,17,6,71,102,121,61,7,2,42,66,66,35,10,4,694,414,280,525,295,230,144,205,210,101,27,2,76,121,146,41,18,4,68,84,64,60,9,-2,89,195,138,81,14,2,44,111,89,36,10,1,45,84,49,45,4,1,568,285,283,516,256,260,99,152,164,81,52,17,43,74,79,37,36,16,56,78,85,44,16,1,92,161,138,96,20,4,43,77,71,48,11,3,49,84,67,48,9,1,1874,1161,713,1636,1008,628,199,564,630,355,74,41,96,369,391,230,51,20,103,195,239,125,23,21,162,514,584,311,49,8,73,340,350,207,29,5,89,174,234,104,20,3,307,128,179,260,97,163,122,64,56,33,27,-1,61,18,13,14,18,0,61,46,43,19,9,-1,95,71,64,17,9,-1,39,25,18,10,4,-1,56,46,46,7,5,0,275,165,110,211,115,96,65,69,88,49,-12,15,30,46,46,46,-13,7,35,23,42,3,1,8,51,82,31,36,3,3,19,45,20,27,-2,3,32,37,11,9,5,0,233,102,131,218,93,125,38,61,87,34,18,-7,13,18,52,16,7,-5,25,43,35,18,11,-2,43,74,60,31,9,-2,25,21,28,17,3,-1,18,53,32,14,6,-1,338,137,201,283,144,139,97,81,100,28,24,3,47,33,31,9,13,4,50,48,69,19,11,-1,74,89,59,34,24,0,38,48,28,19,10,0,36,41,31,15,14,0,242,163,79,218,117,101,37,57,71,50,33,0,32,24,56,26,23,3,5,33,15,24,10,-3,53,64,50,36,12,-2,28,32,29,14,11,0,25,32,21,22,1,-2,145,53,92,136,53,83,85,34,-4,21,-8,6,22,17,-2,16,-5,-1,63,17,-2,5,-3,7,65,42,-4,24,-2,0,31,22,-11,9,-3,-3,34,20,7,15,1,3,-674,-399,-275,-502,-302,-200,-25,-61,-286,-247,-49,-5,14,-24,-179,-168,-29,-13,-39,-37,-107,-79,-20,8,6,-4,-253,-201,-53,-3,21,-1,-155,-132,-37,-1,-15,-3,-98,-69,-16,-2,179,87,92,260,132,128,63,43,27,12,-3,20,25,25,25,-2,-3,4,38,18,2,14,0,16,76,68,42,49,5,0,39,38,19,23,4,-2,37,30,23,26,1,2,-1362,-833,-529,-1184,-751,-433,-144,-136,-487,-441,-150,-7,-76,-72,-282,-290,-112,-2,-68,-64,-205,-151,-38,-5,-105,-86,-436,-404,-150,-10,-57,-47,-260,-271,-112,-8,-48,-39,-176,-133,-38,-2,-161,-84,-77,-62,-33,-29,2,-21,-72,-46,-32,5,-11,7,-45,-29,-21,13,13,-28,-27,-17,-11,-8,3,12,-40,-31,-13,-4,1,19,-28,-20,-10,1,2,-7,-12,-11,-3,-5
6,06012,Arroyo de San Serván,3994,-12,-8,-4,5,2,3,1,-5,-7,-2,2,0,-1,-6,-1,-2,0,2,2,1,-6,0,2,-2,0,1,0,1,3,0,0,1,0,0,1,0,0,0,0,1,2,0,-14,-3,-11,14,4,10,-3,-6,-11,0,11,-5,0,-4,-7,3,6,-2,-3,-2,-4,-3,5,-3,4,5,2,3,0,0,2,1,0,1,0,0,2,4,2,2,0,0,5,4,1,6,4,2,2,-6,-3,-5,10,5,0,0,-2,-1,5,2,2,-6,-1,-4,5,3,2,-1,2,0,0,2,2,0,1,0,0,1,0,-1,1,0,0,1,34,24,10,11,5,6,10,1,13,7,-1,4,7,4,7,6,-2,2,3,-3,6,1,1,2,2,2,4,3,-1,1,0,2,2,1,-1,1,2,0,2,2,0,0,81,47,34,27,15,12,15,18,24,18,2,1,5,12,16,9,2,1,10,6,8,9,0,0,2,3,18,2,1,1,0,2,11,1,1,0,2,1,7,1,0,1,43,30,13,34,24,10,5,13,26,3,1,-1,3,6,18,5,-2,2,2,7,8,-2,3,-3,4,12,11,9,-2,0,3,7,9,6,-1,0,1,5,2,3,-1,0,30,12,18,15,9,6,12,-2,10,-2,9,6,8,1,-3,0,6,0,4,-3,13,-2,3,6,2,5,8,-2,1,1,3,3,3,-1,1,0,-1,2,5,-1,0,1,90,63,27,102,72,30,2,34,27,14,5,7,4,19,19,12,6,3,-2,15,8,2,-1,4,6,35,28,24,5,3,4,24,20,17,5,1,2,11,8,7,0,2,-30,-18,-12,17,6,11,-4,-11,-9,5,-8,1,-6,-2,-2,-2,-5,2,2,-9,-7,7,-3,-1,2,8,2,4,-1,2,0,5,2,1,-3,1,2,3,0,3,2,1,-3,-5,2,-15,-12,-3,4,1,3,-18,3,3,3,2,2,-12,-1,0,1,-1,1,-6,4,3,0,-1,-1,-10,-3,0,1,-2,-2,-7,-2,0,-1,1,1,-3,-1,0,-21,-24,3,6,4,2,-11,2,-9,1,-2,0,-4,-5,-7,-3,1,-5,-7,7,-2,4,-3,5,1,2,0,3,0,0,0,2,0,2,0,0,1,0,0,1,0,0,4,10,-6,7,4,3,4,-3,2,8,-4,-4,2,3,1,8,-2,-1,2,-6,1,0,-2,-3,0,2,1,1,2,0,-1,1,1,2,1,0,1,1,0,-1,1,0,-20,-11,-9,2,1,1,2,-4,-4,-10,-3,2,0,-3,0,-7,-1,2,2,-1,-4,-3,-2,0,-1,2,0,0,2,0,-1,1,-1,0,2,0,0,1,1,0,0,0,-71,-41,-30,-57,-41,-16,-8,-14,-32,-10,-6,1,-6,-3,-19,-9,-4,1,-2,-11,-13,-1,-2,0,-4,-5,-24,-13,-10,0,-1,-4,-17,-11,-7,0,-3,-1,-7,-2,-3,0,-42,-33,-9,-17,-15,-2,-6,-6,-12,-10,-7,0,-4,-4,-10,-8,-5,-2,-2,-2,-2,-2,-2,2,-2,3,-7,-8,-2,-1,-3,1,-5,-7,-1,0,1,2,-2,-1,-1,-1,-4,7,-11,17,6,11,1,4,0,-5,-5,1,-3,4,6,0,-3,3,4,0,-6,-5,-2,-2,7,0,5,4,1,0,0,0,3,2,1,0,7,0,2,2,0,0,5,-7,12,6,3,3,10,7,-4,-13,3,0,0,2,-5,-10,3,1,10,5,1,-3,0,-1,6,0,-1,1,0,-1,2,0,-1,0,1,0,4,0,0,1,-1,-1,-29,-13,-16,-6,2,-8,-16,-1,-6,-5,1,-5,-7,-1,0,-3,1,-4,-9,0,-6,-2,0,-1,-1,2,-1,-5,-1,0,2,1,2,-3,0,0,-3,1,-3,-2,-1,0
6,06014,Azuaga,8924,-22,-12,-10,14,4,10,4,-8,-15,0,0,-2,8,-6,-11,-4,0,3,-4,-2,-4,4,0,-5,3,2,4,4,0,0,1,1,1,1,0,0,2,1,3,3,0,0,-48,-29,-19,13,5,8,-2,-14,-22,-3,0,-11,-1,-12,-11,-1,-2,-2,-1,-2,-11,-2,2,-9,3,0,2,4,1,0,2,0,1,2,0,0,1,0,1,2,1,0,-27,-10,-17,0,-2,2,-10,-6,-7,2,2,-8,-3,-1,-7,2,0,-1,-7,-5,0,0,2,-7,1,1,-1,0,-1,0,1,0,-2,0,-1,0,0,1,1,0,0,0,-6,-8,2,0,-1,1,8,-8,-15,-2,0,9,2,-8,-12,0,1,8,6,0,-3,-2,-1,1,-1,1,0,0,0,0,-1,0,0,0,0,0,0,1,0,0,0,0,59,43,16,17,11,6,10,-1,1,12,22,13,7,1,10,5,13,5,3,-2,-9,7,9,8,4,1,6,5,0,1,3,0,4,3,0,1,1,1,2,2,0,0,28,9,19,13,5,8,11,3,-15,11,5,10,5,0,-10,7,3,3,6,3,-5,4,2,7,2,5,2,1,2,0,0,3,1,1,0,0,2,2,1,0,2,0,13,8,5,8,6,2,2,-8,-14,15,12,2,-1,-2,-5,10,5,0,3,-6,-9,5,7,2,4,3,1,0,0,0,3,3,0,0,0,0,1,0,1,0,0,0,-33,-9,-24,16,7,9,4,-10,-21,2,9,-18,2,0,-4,-1,0,-6,2,-10,-17,3,9,-12,3,4,3,3,2,1,1,3,2,0,1,0,2,1,1,3,1,1,-30,-22,-8,7,4,3,-9,-9,-18,-7,-5,21,-1,-8,-12,-3,-3,9,-8,-1,-6,-4,-2,12,-1,3,3,0,0,2,0,0,3,0,0,1,-1,3,0,0,0,1,-60,-39,-21,12,0,12,-18,-7,-19,-21,3,2,-11,-8,-14,-10,0,4,-7,1,-5,-11,3,-2,0,3,7,-1,1,1,0,-1,1,-1,0,0,0,4,6,0,1,1,14,10,4,8,1,7,4,-12,-7,-1,16,17,1,-9,-1,4,9,6,3,-3,-6,-5,7,11,1,3,1,3,1,-1,0,-2,2,1,1,-1,1,5,-1,2,0,0,-21,-16,-5,8,5,3,-10,-3,-14,-9,12,4,-3,-3,-7,-11,8,0,-7,0,-7,2,4,4,1,3,2,1,1,0,2,1,1,0,1,0,-1,2,1,1,0,0,-8,17,-25,12,5,7,-1,-3,-5,-2,0,1,4,-4,7,7,1,-1,-5,1,-12,-9,-1,2,3,5,3,0,0,0,3,1,0,0,0,0,0,4,3,0,0,0,-4,-14,10,5,1,4,5,0,-2,10,-5,-12,-3,4,-5,2,-5,-8,8,-4,3,8,0,-4,1,0,3,0,0,0,1,0,0,0,0,-1,0,0,3,0,0,1,-10,-8,-2,11,4,7,-11,-9,4,-8,2,12,-7,-9,4,2,-4,6,-4,0,0,-10,6,6,1,6,3,0,1,0,0,1,2,1,0,0,1,5,1,-1,1,0,-41,-17,-24,6,2,4,-11,-12,2,-8,-1,-11,-8,-7,10,-5,0,-7,-3,-5,-8,-3,-1,-4,0,1,2,2,0,1,0,0,2,0,0,0,0,1,0,2,0,1,-7,0,-7,16,4,12,7,7,-25,6,1,-2,3,4,-9,1,0,4,4,3,-16,5,1,-6,6,4,1,1,3,1,2,1,-1,0,1,1,4,3,2,1,2,0,-29,-18,-11,20,8,12,-4,6,-5,-20,-2,-5,-4,6,-9,-9,-2,-1,0,0,4,-11,0,-4,4,4,6,4,0,1,3,1,2,0,0,1,1,3,4,4,0,0
6,06015,Badajoz,136613,916,436,480,527,286,241,218,63,281,227,79,40,89,43,156,84,40,20,129,20,125,143,39,20,65,135,186,96,32,12,38,71,115,41,15,6,27,64,71,55,17,6,374,170,204,532,281,251,106,-7,181,90,-11,8,81,-5,39,38,2,12,25,-2,142,52,-13,-4,93,117,181,89,36,15,53,59,94,46,19,10,40,58,87,43,17,5,87,-21,108,502,243,259,62,-113,137,29,-8,-8,-1,-71,44,19,-5,-5,63,-42,93,10,-3,-3,131,83,159,91,18,8,60,34,82,50,8,2,71,49,77,41,10,6,1090,637,453,785,439,346,292,150,303,224,86,23,159,81,170,136,56,20,133,69,133,88,30,3,175,144,238,141,55,26,83,70,142,90,36,13,92,74,96,51,19,13,1528,817,711,1032,612,420,244,175,570,365,123,40,121,72,323,206,85,15,123,103,247,159,38,25,149,171,317,253,115,17,78,82,214,150,78,9,71,89,103,103,37,8,1149,489,660,1115,598,517,238,170,393,187,72,71,108,73,140,83,36,40,130,97,253,104,36,31,196,230,369,192,90,31,103,102,199,116,58,16,93,128,170,76,32,15,1141,498,643,1298,661,637,241,177,435,203,41,39,111,57,202,90,6,23,130,120,233,113,35,16,221,284,419,254,85,29,95,144,224,135,46,12,126,140,195,119,39,17,838,310,528,1223,673,550,86,190,187,217,75,74,5,121,10,105,28,33,81,69,177,112,47,41,157,307,348,265,109,27,72,174,191,146,64,19,85,133,157,119,45,8,805,327,478,775,359,416,197,115,278,171,2,21,97,9,134,71,-9,21,100,106,144,100,11,0,120,162,245,164,55,21,57,60,115,92,23,11,63,102,130,72,32,10,1132,549,583,716,394,322,209,207,422,198,43,44,101,71,220,107,15,27,108,136,202,91,28,17,135,142,210,146,58,19,67,64,116,104,30,8,68,78,94,42,28,11,-30,-119,89,-274,-170,-104,66,106,-11,-112,-63,-31,43,11,-55,-78,-45,-1,23,95,44,-34,-18,-30,29,64,-131,-163,-62,-21,20,27,-64,-113,-36,-9,9,37,-67,-50,-26,-12,521,272,249,469,233,236,96,68,169,174,9,-3,60,31,56,113,14,-10,36,37,113,61,-5,7,77,125,101,99,45,15,37,58,41,63,25,6,40,67,60,36,20,9,538,321,217,281,137,144,110,86,191,114,20,12,63,52,99,58,16,26,47,34,92,56,4,-14,43,73,51,55,37,16,23,36,21,22,21,11,20,37,30,33,16,5,340,120,220,91,40,51,87,5,126,113,12,7,57,11,9,53,2,-4,30,-6,117,60,10,11,40,35,-13,4,22,-2,18,29,-19,3,10,-4,22,6,6,1,12,2,-260,-185,-75,-138,-109,-29,4,-5,-93,-75,-66,-20,-26,-13,-79,-23,-42,4,30,8,-14,-52,-24,-24,5,27,-50,-87,-34,0,3,-6,-34,-55,-17,0,2,33,-16,-32,-17,0,-165,-164,-1,106,1,105,19,36,-126,-18,-69,-20,4,-16,-70,-25,-47,-10,15,52,-56,7,-22,-10,46,76,-4,-4,-7,-4,17,30,-21,-15,-11,1,29,46,17,11,4,-5,-205,-202,-3,-186,-134,-52,-41,44,37,-138,-44,-74,-32,7,-22,-68,-56,-33,-9,37,59,-70,12,-41,-4,49,-3,-120,-79,-35,-5,12,-3,-66,-52,-21,1,37,0,-54,-27,-14,-204,-159,-45,76,-9,85,-20,2,-91,-67,-33,1,-19,-18,-20,-64,-23,-15,-1,20,-71,-3,-10,16,15,95,15,-42,-8,-2,1,33,26,-51,-14,-4,14,62,-11,9,6,2
6,06036,Castuera,7354,-13,-3,-10,10,3,7,-3,-9,4,-2,-2,1,-2,0,5,-4,-1,1,-1,-9,-1,2,-1,0,2,1,2,3,1,1,2,0,0,0,0,1,0,1,2,3,1,0,-22,-25,3,38,8,30,0,7,-11,-4,1,-15,-1,-4,-6,-6,1,-9,1,11,-5,2,0,-6,2,14,14,7,1,0,2,0,4,2,0,0,0,14,10,5,1,0,-48,-21,-27,17,9,8,-7,-5,-35,-18,11,9,-7,-4,-17,-4,6,4,0,-1,-18,-14,5,5,2,4,2,4,3,2,2,1,0,2,3,1,0,3,2,2,0,1,-15,-7,-8,18,9,9,-1,-9,-11,-2,2,7,2,-4,-6,-2,-1,3,-3,-5,-5,0,3,4,4,4,3,2,4,1,3,2,1,1,1,1,1,2,2,1,3,0,16,-7,23,7,1,6,14,0,-18,0,5,19,1,-3,-14,-5,3,10,13,3,-4,5,2,9,5,-1,2,2,-1,0,1,1,0,0,-1,0,4,-2,2,2,0,0,45,19,26,16,7,9,9,10,-12,7,6,24,1,8,-4,7,3,5,8,2,-8,0,3,19,3,10,0,2,1,0,0,5,0,2,0,0,3,5,0,0,1,0,112,42,70,38,20,18,25,20,22,4,4,37,8,11,9,-5,1,17,17,9,13,9,3,20,13,12,13,0,0,0,7,6,6,1,0,0,6,6,7,-1,0,0,75,48,27,52,30,22,29,7,25,15,-1,-1,22,3,16,7,0,-1,7,4,9,8,-1,0,18,10,16,6,2,0,13,6,8,2,1,0,5,4,8,4,1,0,65,31,34,32,18,14,12,14,-6,13,15,14,7,8,-2,6,7,3,5,6,-4,7,8,11,6,13,1,6,2,4,2,8,1,4,1,2,4,5,0,2,1,2,18,4,14,40,16,24,11,-1,7,-4,0,6,6,-3,1,-6,1,5,5,2,6,2,-1,1,8,11,14,4,1,2,2,6,5,1,1,1,6,5,9,3,0,1,16,12,4,6,1,5,16,1,3,-4,-9,10,11,2,-2,1,-3,4,5,-1,5,-5,-6,6,5,1,3,2,-3,-2,2,-1,1,2,-1,-2,3,2,2,0,-2,0,21,15,6,8,8,0,-8,1,3,-8,8,21,-2,4,2,-1,2,7,-6,-3,1,-7,6,14,4,0,2,1,0,0,5,0,2,1,-1,0,-1,0,0,0,1,0,-36,-26,-10,-22,-13,-9,-16,-4,-17,-14,2,15,-9,-7,-10,-5,4,2,-7,3,-7,-9,-2,13,-8,1,-6,-6,-3,0,-5,-1,-3,-3,-1,0,-3,2,-3,-3,-2,0,-19,-3,-16,-1,-3,2,0,3,-19,-5,5,-4,4,1,-6,-6,4,-2,-4,2,-13,1,1,-2,4,1,-4,1,-2,-1,2,-1,-3,1,-2,0,2,2,-1,0,0,-1,-38,-8,-30,-17,-7,-10,4,-12,-24,-11,-4,10,7,-2,-8,-6,0,2,-3,-10,-16,-5,-4,8,-5,1,-5,-5,-2,-1,1,0,-4,-4,0,0,-6,1,-1,-1,-2,-1,18,3,15,3,2,1,-6,10,-5,7,-4,15,-8,8,-3,5,-4,5,2,2,-2,2,0,10,2,1,1,-1,0,0,0,2,1,-1,0,0,2,-1,0,0,0,0,-29,-27,-2,2,-3,5,-3,-11,-16,-5,-7,14,-1,-8,-10,-5,-8,5,-2,-3,-6,0,1,9,-1,-1,4,1,0,-1,-2,-2,2,0,0,-1,1,1,2,1,0,0,-61,-36,-25,-21,-14,-7,-7,-18,-31,-14,-1,12,-11,-11,-15,-3,0,5,4,-7,-16,-11,-1,7,-2,-6,-8,-5,0,0,-3,-5,-3,-3,0,0,1,-1,-5,-2,0,0
6,06044,Don Benito,31367,154,41,113,121,37,84,45,16,65,-1,3,12,21,-4,16,-6,-2,10,24,20,49,5,5,2,20,39,51,9,1,1,9,12,11,4,1,0,11,27,40,5,0,1,174,31,143,165,47,118,26,43,47,35,18,-4,11,3,-15,21,9,-3,15,40,62,14,9,-1,20,58,53,24,5,3,9,11,11,12,3,0,11,47,42,12,2,3,295,156,139,115,43,72,114,40,65,49,2,22,74,9,34,25,2,13,40,31,31,24,0,9,22,33,38,17,5,0,14,5,17,5,2,0,8,28,21,12,3,0,588,280,308,181,65,116,85,81,169,125,39,80,38,37,80,73,17,29,47,44,89,52,22,51,29,65,42,31,9,4,11,22,15,11,3,2,18,43,27,20,6,2,512,254,258,184,75,109,99,72,211,75,35,14,48,24,116,46,16,4,51,48,95,29,19,10,45,44,51,24,16,3,18,19,21,10,6,1,27,25,30,14,10,2,637,332,305,186,79,107,169,71,186,136,34,29,91,26,95,79,21,14,78,45,91,57,13,15,47,46,57,20,10,4,25,19,20,9,4,1,22,27,37,11,6,3,561,277,284,210,90,120,115,116,165,79,44,34,52,65,73,42,22,18,63,51,92,37,22,16,49,59,47,33,14,8,19,26,19,17,5,4,30,33,28,16,9,4,585,287,298,250,116,134,85,83,196,125,63,30,48,28,102,64,29,13,37,55,94,61,34,17,50,70,69,41,11,7,31,27,31,20,3,3,19,43,38,21,8,4,349,129,220,147,47,100,86,45,115,79,29,4,43,23,45,15,14,-6,43,22,70,64,15,10,38,28,36,33,4,8,19,9,10,8,0,1,19,19,26,25,4,7,349,163,186,106,40,66,98,35,126,46,36,10,37,3,78,18,24,6,61,32,48,28,12,4,47,19,21,13,0,4,21,5,3,8,0,3,26,14,18,5,0,1,305,149,156,60,13,47,55,22,123,34,18,51,39,3,51,16,17,21,16,19,72,18,1,30,24,23,3,12,-1,-5,21,2,-12,6,-3,-3,3,21,15,6,2,-2,272,150,122,74,34,40,62,-9,117,34,33,33,27,5,66,19,14,12,35,-14,51,15,19,21,24,18,22,3,4,1,13,6,11,1,1,0,11,12,11,2,3,1,5,-22,27,-22,-18,-4,0,5,-16,13,9,-4,-1,3,-19,-6,5,0,1,2,3,19,4,-4,-13,8,-19,-1,2,0,-5,1,-12,-2,0,0,-8,7,-7,1,2,0,-210,-159,-51,-56,-35,-21,-38,-44,-70,-42,-15,0,-34,-23,-44,-45,-10,1,-4,-21,-26,3,-5,-1,0,-10,-37,-14,-1,4,1,-5,-19,-12,-2,1,-1,-5,-18,-2,1,3,-166,-59,-107,-93,-59,-34,-41,-26,-52,-38,0,-2,-23,-23,-15,-2,0,4,-18,-3,-37,-36,0,-6,-23,2,-28,-29,-10,-6,-16,-10,-16,-10,-6,-1,-7,12,-12,-19,-4,-5,-70,-52,-18,-17,3,-20,-3,-38,-20,-12,10,-7,6,-45,-24,4,10,-2,-9,7,4,-16,0,-5,-1,10,-14,-9,-2,-2,5,2,-7,1,0,1,-6,8,-7,-10,-2,-3,-141,-59,-82,-63,-33,-30,-5,-43,-42,-37,-15,1,-8,-19,-13,-14,-11,6,3,-24,-29,-23,-4,-5,-1,11,-28,-27,-13,-7,-2,7,-9,-20,-8,-2,1,4,-19,-7,-5,-5,17,-24,41,18,-12,30,13,-16,14,0,12,-3,-4,-11,7,-25,16,-4,17,-5,7,25,-4,1,8,9,8,-9,3,0,2,4,0,-16,-2,2,6,5,8,7,5,-2
6,06050,Fregenal de la Sierra,5360,-24,-9,-15,3,1,2,-2,4,-6,-9,-5,-7,-1,3,-3,-5,-2,-2,-1,1,-3,-4,-3,-5,0,0,1,0,2,0,0,0,0,0,1,0,0,0,1,0,1,0,-20,-8,-12,3,2,1,-7,1,-15,-5,4,1,-5,0,-4,-5,3,2,-2,1,-11,0,1,-1,0,1,0,1,1,0,0,1,0,1,0,0,0,0,0,0,1,0,-23,-9,-14,8,3,5,-10,-14,-3,3,5,-2,-4,-4,-6,2,3,1,-6,-10,3,1,2,-3,0,3,1,4,0,0,0,0,0,2,1,0,0,3,1,2,-1,0,12,9,3,7,4,3,5,0,11,1,2,-5,4,-2,9,0,-1,-1,1,2,2,1,3,-4,2,0,1,3,0,1,2,0,1,1,0,0,0,0,0,2,0,1,9,17,-8,11,6,5,0,-1,7,-3,9,-6,3,0,6,0,5,1,-3,-1,1,-3,4,-7,0,1,4,4,2,0,0,0,3,2,1,0,0,1,1,2,1,0,30,24,6,18,17,1,6,7,6,6,5,-2,2,4,13,1,2,1,4,3,-7,5,3,-3,3,2,8,5,0,0,3,2,7,5,0,0,0,0,1,0,0,0,28,22,6,14,8,6,4,5,5,18,0,-2,3,3,1,11,3,2,1,2,4,7,-3,-4,1,4,6,2,1,0,1,2,3,1,1,0,0,2,3,1,0,0,18,20,-2,-1,-2,1,7,4,10,-2,1,-1,4,4,9,-2,2,3,3,0,1,0,-1,-4,0,1,-1,0,-1,0,0,0,-1,-1,0,0,0,1,0,1,-1,0,-23,-4,-19,7,5,2,-5,8,-23,4,10,-18,-4,4,-11,5,6,-4,-1,4,-12,-1,4,-14,1,4,1,0,1,0,0,2,2,0,1,0,1,2,-1,0,0,0,-8,-14,6,5,-2,7,6,2,-10,2,3,-13,2,0,-8,-4,2,-7,4,2,-2,6,1,-6,1,4,4,-2,0,-2,0,0,1,-2,0,-1,1,4,3,0,0,-1,-5,6,-11,6,3,3,10,-7,-9,6,0,-6,5,2,-7,6,-1,-1,5,-9,-2,0,1,-5,3,2,-1,0,2,0,2,0,-1,1,1,0,1,2,0,-1,1,0,-3,-11,8,6,1,5,-5,9,-3,7,-3,-10,-3,5,-9,2,-2,-5,-2,4,6,5,-1,-5,0,3,1,1,0,0,0,1,0,-1,0,0,0,2,1,2,0,0,-52,-25,-27,2,1,1,-9,-4,-12,-12,-3,-9,-5,-5,-7,-1,-2,-3,-4,1,-5,-11,-1,-6,-1,2,-1,0,2,0,-1,0,1,1,0,0,0,2,-2,-1,2,0,-40,-16,-24,-8,-5,-3,-5,-9,-10,2,-2,-12,-3,-2,-2,0,-1,-5,-2,-7,-8,2,-1,-7,-1,0,-3,-1,-1,-2,-1,0,-1,0,-2,-1,0,0,-2,-1,1,-1,-6,7,-13,4,3,1,4,-8,-7,6,2,-3,3,-5,4,3,4,-3,1,-3,-11,3,-2,0,1,2,-1,1,1,0,1,1,0,0,1,0,0,1,-1,1,0,0,-27,-17,-10,-1,-3,2,1,-8,-12,-11,6,0,3,-4,-6,-9,2,-1,-2,-4,-6,-2,4,1,0,-3,-1,-2,2,3,0,-2,-2,-2,1,2,0,-1,1,0,1,1,11,18,-7,6,5,1,9,-13,8,2,3,1,3,-4,7,5,2,4,6,-9,1,-3,1,-3,0,4,1,1,-1,1,0,3,1,1,-1,1,0,1,0,0,0,0,35,22,13,20,8,12,15,3,-1,9,6,3,7,3,0,3,5,3,8,0,-1,6,1,0,3,4,5,5,1,2,1,2,2,1,1,1,2,2,3,4,0,1
6,06052,Fuente de Cantos,5039,-33,-13,-20,4,2,2,-4,-5,-12,-3,2,-11,-2,-1,-4,-1,0,-4,-2,-4,-8,-2,2,-7,1,0,1,2,0,0,1,0,1,0,0,0,0,0,0,2,0,0,12,15,-3,10,6,4,8,3,-1,2,2,-4,9,2,-3,2,3,0,-1,1,2,0,-1,-4,2,3,3,0,1,1,2,1,1,0,1,1,0,2,2,0,0,0,-9,-16,7,8,2,6,-4,1,-9,-1,-2,5,-3,-2,-8,-5,1,0,-1,3,-1,4,-3,5,0,0,1,2,0,5,0,-1,0,1,0,2,0,1,1,1,0,3,15,5,10,7,2,5,4,-3,17,-7,4,2,2,0,5,-3,1,0,2,-3,12,-4,3,2,0,2,4,0,1,0,0,1,1,0,0,0,0,1,3,0,1,0,17,3,14,13,7,6,6,4,0,7,1,-2,-1,4,-2,5,-2,-2,7,0,2,2,3,0,3,2,5,1,0,2,1,2,2,1,0,1,2,0,3,0,0,1,29,23,6,20,11,9,15,3,2,3,9,0,6,9,2,-1,7,-1,9,-6,0,4,2,1,2,7,10,0,1,0,1,4,5,1,0,0,1,3,5,-1,1,0,31,10,21,44,22,22,5,1,17,0,4,5,-4,2,11,0,-1,3,9,-1,6,0,5,2,6,7,24,6,0,0,3,2,13,4,0,0,3,5,11,2,0,0,10,2,8,10,6,4,8,3,-8,0,6,1,2,5,-5,-2,3,0,6,-2,-3,2,3,1,2,5,1,1,1,0,1,4,0,1,0,0,1,1,1,0,1,0,-17,-7,-10,13,6,7,-6,-3,-13,4,-4,4,-7,-1,-3,5,-3,1,1,-2,-10,-1,-1,3,1,6,3,1,0,1,1,1,3,0,0,0,0,5,0,1,0,1,2,-15,17,11,0,11,6,-2,-1,-5,15,-13,4,-9,-12,-1,7,-4,2,7,11,-4,8,-9,1,4,1,2,3,0,0,0,-1,0,1,0,1,4,2,2,2,0,-34,-14,-20,11,4,7,-4,-9,-8,1,-3,-10,1,-4,-2,0,-2,-7,-5,-5,-6,1,-1,-3,3,0,5,4,1,-2,1,0,2,1,0,0,2,0,3,3,1,-2,-20,-14,-6,15,5,10,-2,-4,-5,-10,1,0,-1,-9,1,-3,0,-2,-1,5,-6,-7,1,2,2,7,5,0,0,1,1,1,3,0,0,0,1,6,2,0,0,1,65,31,34,-7,-7,0,11,9,3,19,16,7,6,9,1,7,7,1,5,0,2,12,9,6,2,-2,-7,0,0,0,1,-1,-6,0,-1,0,1,-1,-1,0,1,0,1,-2,3,-9,-1,-8,0,-9,-4,11,4,-1,0,-1,-3,3,1,-2,0,-8,-1,8,3,1,-1,2,-7,-3,0,0,0,3,-2,-2,0,0,-1,-1,-5,-1,0,0,-41,-26,-15,-4,-1,-3,-9,-11,-8,-8,-1,-4,-9,-8,-3,-3,-1,-2,0,-3,-5,-5,0,-2,0,-1,-3,-2,0,2,0,0,0,-1,0,0,0,-1,-3,-1,0,2,0,-1,1,2,-2,4,6,-7,-2,2,-3,2,5,-4,-3,1,-4,3,1,-3,1,1,1,-1,0,0,-2,3,1,0,0,-1,-3,2,0,0,0,1,1,1,1,0,-26,-8,-18,4,2,2,-2,-7,-3,-11,-10,7,1,-3,3,-6,-4,1,-3,-4,-6,-5,-6,6,2,-1,2,2,-2,0,1,-1,1,1,-1,0,1,0,1,1,-1,0,-41,-32,-9,2,0,2,-2,-9,-23,-6,-1,1,0,-10,-15,-2,-3,-1,-2,1,-8,-4,2,2,-1,2,0,1,0,0,-1,1,0,0,0,0,0,1,0,1,0,0
6,06060,Guareña,7375,-28,-10,-18,6,1,5,-8,-13,-5,-1,4,-5,-4,-5,-3,3,0,-1,-4,-8,-2,-4,4,-4,0,2,2,1,1,0,0,0,0,0,1,0,0,2,2,1,0,0,-30,-20,-10,7,3,4,-3,-17,7,-5,-4,-7,2,-13,-4,-2,0,-2,-5,-4,11,-3,-4,-5,2,1,2,1,1,0,0,0,1,1,1,0,2,1,1,0,0,0,2,2,0,10,6,4,10,0,-13,5,-1,1,4,-6,-5,6,0,3,6,6,-8,-1,-1,-2,7,0,1,2,0,0,5,0,0,1,0,0,2,0,1,1,0,0,11,0,11,10,5,5,7,1,-8,-3,4,7,0,-3,0,-2,2,1,7,4,-8,-1,2,6,2,1,2,2,3,0,1,1,1,1,1,0,1,0,1,1,2,0,-17,-10,-7,12,6,6,8,-9,-16,-1,1,-1,2,-3,-11,0,2,0,6,-6,-5,-1,-1,-1,6,4,2,0,0,0,3,1,2,0,0,0,3,3,0,0,0,0,56,42,14,15,8,7,15,12,4,24,8,-8,15,4,5,14,5,-2,0,8,-1,10,3,-6,7,3,0,5,0,0,5,0,0,3,0,0,2,3,0,2,0,0,-16,-17,1,3,-3,6,7,-15,-16,0,8,-2,-1,-2,-10,-7,4,-3,8,-13,-6,7,4,1,4,-1,-4,2,1,1,0,0,-3,0,0,0,4,-1,-1,2,1,1,43,31,12,35,14,21,19,12,1,5,6,-1,12,15,2,3,1,-3,7,-3,-1,2,5,2,11,7,11,4,2,0,4,2,7,1,0,0,7,5,4,3,2,0,-48,-22,-26,21,11,10,-9,-20,-12,-7,0,-1,-3,-12,-5,-3,1,0,-6,-8,-7,-4,-1,-1,5,3,7,5,0,0,3,2,3,3,0,0,2,1,4,2,0,0,-9,-8,-1,7,1,6,0,0,-13,-1,4,1,3,-2,-8,0,0,0,-3,2,-5,-1,4,1,1,3,1,2,0,0,-1,0,1,1,0,0,2,3,0,1,0,0,20,3,17,16,9,7,7,2,-10,13,7,1,-1,-2,-8,10,1,2,8,4,-2,3,6,-1,5,4,2,3,0,2,2,5,0,1,0,1,3,-1,2,2,0,1,-7,-7,0,6,2,4,8,-8,-3,3,-3,-5,1,1,-4,-2,0,-3,7,-9,1,5,-3,-2,1,-1,3,3,0,0,1,0,1,0,0,0,0,-1,2,3,0,0,-1,0,-1,6,3,3,2,10,1,-7,3,-10,2,6,-2,-5,2,-3,0,4,3,-2,1,-7,1,2,1,0,1,1,0,1,1,0,1,0,1,1,0,0,0,1,-25,-1,-24,-2,2,-4,-10,-8,4,-11,8,-8,-5,2,7,-8,4,-2,-5,-10,-3,-3,4,-6,1,0,1,-2,0,-2,2,0,0,0,0,0,-1,0,1,-2,0,-2,-59,-27,-32,1,2,-1,-8,-22,-13,-16,-6,7,-4,-9,-10,-8,0,5,-4,-13,-3,-8,-6,2,2,0,0,0,-1,0,2,1,0,0,-1,0,0,-1,0,0,0,0,-27,-14,-13,4,8,-4,6,-13,-19,-12,5,6,4,-8,-15,-5,4,5,2,-5,-4,-7,1,1,3,3,-1,2,-3,-1,3,2,1,2,-1,0,0,1,-2,0,-2,-1,-24,-15,-9,-2,-4,2,-2,6,-16,-3,1,-10,0,3,-7,-9,1,-3,-2,3,-9,6,0,-7,2,-2,3,-4,-1,0,0,-2,2,-3,-1,0,2,0,1,-1,0,0,-15,-10,-5,-2,-3,1,10,-10,-7,-5,1,-3,6,-11,-6,1,3,-1,4,1,-1,-6,-2,-2,3,-1,1,-6,0,1,3,-2,-1,-3,0,0,0,1,2,-3,0,1
6,06070,Jerez de los Caballeros,9609,-5,-1,-4,35,21,14,-4,-5,7,-6,7,-5,-5,-3,1,3,3,-2,1,-2,6,-9,4,-3,7,3,12,9,2,0,2,1,8,8,0,0,5,2,4,1,2,0,3,3,0,22,15,7,1,-1,-2,6,1,-2,0,-2,1,5,2,-2,1,1,-3,1,-1,0,7,1,7,5,2,0,2,1,5,5,2,0,5,0,2,0,0,0,7,14,-7,15,9,6,12,-1,-6,2,6,-9,7,1,-2,1,3,0,5,-2,-4,1,3,-9,8,2,-2,6,1,0,3,1,1,3,1,0,5,1,-3,3,0,0,80,32,48,11,7,4,24,14,15,8,11,8,14,7,2,1,6,3,10,7,13,7,5,5,4,3,3,1,0,0,4,1,1,1,0,0,0,2,2,0,0,0,50,34,16,23,10,13,27,0,5,10,12,-2,12,-2,4,9,7,3,15,2,1,1,5,-5,4,3,9,3,2,1,2,0,3,2,2,1,2,3,6,1,0,0,-30,-22,-8,24,14,10,-5,-7,-8,-8,-8,8,-4,-4,-4,-5,-7,3,-1,-3,-4,-3,-1,5,3,2,6,8,3,2,2,2,3,4,2,1,1,0,3,4,1,1,33,36,-3,50,37,13,12,1,10,3,11,-7,9,2,13,7,3,1,3,-1,-3,-4,8,-8,8,4,23,10,4,0,4,3,16,9,4,0,4,1,7,1,0,0,346,331,15,358,329,29,20,32,116,142,42,-7,8,32,118,134,37,0,12,0,-2,8,5,-7,15,39,133,136,35,0,10,36,129,121,33,0,5,3,4,15,2,0,74,44,30,35,22,13,22,14,17,14,9,-4,7,6,13,9,10,-3,15,8,4,5,-1,-1,4,6,9,10,5,-1,2,2,5,7,6,-1,2,4,4,3,-1,0,26,10,16,13,10,3,10,-16,13,2,21,0,0,-13,12,0,13,0,10,-3,1,2,8,0,5,1,3,0,4,0,2,1,4,1,2,0,3,0,-1,-1,2,0,-33,-15,-18,24,14,10,7,1,-29,-4,0,-6,5,5,-22,2,0,-3,2,-4,-7,-6,0,-3,4,7,7,7,-1,0,2,3,5,5,-1,0,2,4,2,2,0,0,-28,-20,-8,17,3,14,-2,-4,1,-7,-10,-5,-1,-1,5,-15,-4,-3,-1,-3,-4,8,-6,-2,5,4,1,5,1,0,1,1,-1,1,1,0,4,3,2,4,0,0,-95,-45,-50,8,1,7,-17,-17,-24,-17,-9,-7,-8,-8,-13,-4,-8,-3,-9,-9,-11,-13,-1,-4,2,0,1,3,1,1,1,-1,1,0,0,0,1,1,0,3,1,1,-49,-36,-13,-9,-11,2,7,6,-21,-17,-12,-9,-8,3,-13,-4,-8,-4,15,3,-8,-13,-4,-5,2,1,1,-7,-4,-2,-1,0,-1,-4,-4,-1,3,1,2,-3,0,-1,-27,-15,-12,12,6,6,-10,-10,-8,3,-3,3,-2,-6,-6,-3,-3,6,-8,-4,-2,6,0,-3,0,3,3,3,3,0,1,2,1,1,1,0,-1,1,2,2,2,0,-67,-42,-25,-64,-57,-7,-6,-3,-14,-21,-16,-6,1,-1,-2,-21,-19,0,-7,-2,-12,0,3,-6,-7,3,-8,-28,-21,-3,-4,0,-8,-21,-21,-3,-3,3,0,-7,0,0,-67,-51,-16,3,-1,4,-7,-13,-28,-18,5,-3,-1,-8,-18,-18,0,-4,-6,-5,-10,0,5,1,-1,-1,2,0,3,0,0,-1,-1,0,1,0,-1,0,3,0,2,0,-68,-52,-16,-6,-16,10,-5,-13,-17,-14,-7,-11,-5,-10,-11,-16,-7,-2,0,-3,-6,2,0,-9,3,-3,9,-6,-7,-2,-1,-2,3,-7,-7,-2,4,-1,6,1,0,0
6,06074,Llerena,5670,-27,-17,-10,11,4,7,-17,-2,-12,0,6,0,-7,0,-11,-1,2,1,-10,-2,-1,1,4,-1,0,3,4,2,2,0,0,2,1,0,1,0,0,1,3,2,1,0,-33,-12,-21,11,7,4,-12,-7,-3,-11,2,-1,-7,0,0,-7,2,0,-5,-7,-3,-4,0,-1,2,3,2,2,2,0,2,3,0,1,1,0,0,0,2,1,1,0,15,6,9,13,3,10,0,7,-5,3,5,7,3,1,-3,3,1,2,-3,6,-2,0,4,5,3,6,2,0,2,0,1,1,0,0,1,0,2,5,2,0,1,0,60,30,30,27,11,16,9,-1,13,15,10,15,7,-3,7,9,5,6,2,2,6,6,5,9,7,6,5,7,1,1,4,2,2,3,0,0,3,4,3,4,1,1,99,62,37,5,2,3,17,4,34,30,4,10,10,2,27,15,4,4,7,2,7,15,0,6,2,1,0,2,0,0,1,0,0,1,0,0,1,1,0,1,0,0,90,57,33,51,20,31,19,18,24,8,9,7,14,11,19,4,2,5,5,7,5,4,7,2,12,4,17,10,4,3,5,2,5,4,1,2,7,2,12,6,3,1,169,73,96,52,24,28,21,18,70,21,25,8,10,5,27,18,9,0,11,13,43,3,16,8,9,14,13,11,4,0,8,5,6,3,1,0,1,9,7,8,3,0,-33,-14,-19,6,4,2,0,4,-21,-13,5,-7,0,-1,-10,-7,6,-2,0,5,-11,-6,-1,-5,1,7,2,-2,1,-3,1,4,0,-1,1,-1,0,3,2,-1,0,-2,26,19,7,2,0,2,12,2,6,2,5,-1,13,0,5,0,5,-5,-1,2,1,2,0,4,2,0,1,1,-3,1,1,0,1,-2,0,0,1,0,0,3,-3,1,-32,-15,-17,1,-1,2,-2,-5,-22,-6,8,-2,2,0,-16,-7,8,0,-4,-5,-6,1,0,-2,0,0,-2,1,1,0,0,-1,-1,0,0,0,0,1,-1,1,1,0,18,12,6,4,1,3,4,18,-15,8,-5,11,-1,5,0,6,-3,5,5,13,-15,2,-2,6,-1,5,0,-1,1,0,-2,3,-1,0,1,0,1,2,1,-1,0,0,11,5,6,15,5,10,1,4,13,-13,9,-4,-4,0,8,-7,6,1,5,4,5,-6,3,-5,4,6,5,-4,4,0,1,2,3,-3,2,0,3,4,2,-1,2,0,-7,-2,-5,0,-4,4,-2,-4,1,2,-1,-4,-2,-1,0,3,-2,1,0,-3,1,-1,1,-5,0,-2,0,2,-1,1,-1,-1,-3,0,0,1,1,-1,3,2,-1,0,4,-1,5,-7,-1,-6,9,-6,1,0,2,-4,4,-5,-1,-1,5,-4,5,-1,2,1,-3,0,1,-2,-3,-3,0,0,2,-1,0,-2,0,0,-1,-1,-3,-1,0,0,-16,-7,-9,-11,-6,-5,-17,6,-12,-13,17,4,-10,-2,-1,-9,12,4,-7,8,-11,-4,5,0,-2,1,-6,-2,-1,-1,-1,1,-3,-1,-1,-1,-1,0,-3,-1,0,0,-30,-14,-16,1,-3,4,-3,-1,-14,-10,1,-1,1,2,-5,-11,0,1,-4,-3,-9,1,1,-2,0,0,0,-1,1,0,0,-2,1,-2,0,0,0,2,-1,1,1,0,-41,-34,-7,2,0,2,-11,-3,-25,-7,-7,8,-8,-1,-18,-4,-8,4,-3,-2,-7,-3,1,4,3,0,0,0,0,0,1,0,0,0,0,0,2,0,0,0,0,0,-36,-22,-14,3,1,2,-4,-13,-27,0,3,4,5,-7,-15,-4,3,-5,-9,-6,-12,4,0,9,1,4,0,0,-1,-1,2,1,-1,0,0,-1,-1,3,1,0,-1,0
6,06085,Monesterio,5057,47,24,23,9,4,5,-2,8,31,-2,7,2,-1,4,16,1,4,-1,-1,4,15,-3,3,3,0,4,4,1,0,0,0,1,2,1,0,0,0,3,2,0,0,0,-15,-5,-10,12,7,5,-4,6,-12,-6,0,1,-2,2,-5,-1,1,0,-2,4,-7,-5,-1,1,5,1,4,2,0,0,4,1,2,0,0,0,1,0,2,2,0,0,-15,1,-16,8,4,4,4,2,-20,0,1,-3,3,1,-4,1,2,-2,1,1,-16,-1,-1,-1,2,1,2,2,1,0,1,1,0,2,0,0,1,0,2,0,1,0,-24,-7,-17,6,1,5,-3,-5,-19,3,2,-4,6,-5,-8,-1,0,-1,-9,0,-11,4,2,-3,0,1,2,1,2,0,0,0,0,1,0,0,0,1,2,0,2,0,-3,9,-12,9,7,2,0,0,-9,2,0,0,0,-1,0,3,4,1,0,1,-9,-1,-4,-1,0,0,2,3,3,1,0,0,2,3,2,0,0,0,0,0,1,1,2,-5,7,3,2,1,-4,-4,-10,13,8,-1,1,-2,-10,5,2,-1,-5,-2,0,8,6,0,0,1,-1,3,0,0,0,1,0,1,0,0,0,0,-1,2,0,0,-5,-8,3,6,4,2,-6,-7,-10,1,8,10,-8,-5,-8,3,2,8,2,-2,-2,-2,6,2,1,1,3,1,0,0,0,1,2,1,0,0,1,0,1,0,0,0,22,10,12,21,11,10,5,9,20,-10,0,-7,0,-2,15,-6,0,1,5,11,5,-4,0,-8,4,6,6,3,1,0,2,2,4,2,1,0,2,4,2,1,0,0,-37,-13,-24,5,4,1,-2,-7,-17,-4,-1,-6,-2,1,-5,-2,0,-4,0,-8,-12,-2,-1,-2,1,1,0,1,2,0,1,1,1,0,1,0,0,0,-1,1,1,0,40,27,13,25,18,7,17,-12,18,11,9,-3,9,-6,10,9,8,-3,8,-6,8,2,1,0,3,1,8,5,8,0,1,1,5,5,6,0,2,0,3,0,2,0,-46,-23,-23,5,3,2,-6,-6,-4,-13,-9,-9,-4,-3,-1,-8,-4,-4,-2,-3,-3,-5,-5,-5,0,0,3,2,0,0,0,0,2,1,0,0,0,0,1,1,0,0,26,-1,27,7,-3,10,12,14,-3,5,1,-1,2,1,-6,0,0,3,10,13,3,5,1,-4,4,2,1,1,-1,0,1,0,-1,-2,-1,0,3,2,2,3,0,0,9,4,5,8,5,3,2,1,6,-3,3,0,3,1,0,-4,1,2,-1,0,6,1,2,-2,2,0,3,2,1,0,2,0,2,1,0,0,0,0,1,1,1,0,-13,7,-20,9,4,5,-7,-5,-8,3,7,-2,2,1,0,3,3,-2,-9,-6,-8,0,4,0,2,1,0,6,0,0,0,1,1,3,-1,0,2,0,-1,3,1,0,-30,-14,-16,1,1,0,-3,-3,-8,-5,-5,-6,0,1,-4,-2,-3,-6,-3,-4,-4,-3,-2,0,0,1,0,0,-1,1,0,0,1,-1,0,1,0,1,-1,1,-1,0,20,3,17,4,2,2,7,1,2,7,4,-3,5,0,-7,2,2,1,2,1,9,5,2,-4,1,4,-1,0,0,0,1,1,0,0,0,0,0,3,-1,0,0,0,-29,-12,-17,0,-1,1,-5,-8,-14,1,1,-3,-2,-4,-6,-2,3,1,-3,-4,-8,3,-2,-4,-1,0,-4,3,2,0,-1,1,-3,1,1,0,0,-1,-1,2,1,0,-1,4,-5,3,1,2,-4,9,-6,-9,7,2,-2,6,-1,-3,1,2,-2,3,-5,-6,6,0,0,1,1,-1,2,0,0,0,0,0,1,0,0,1,1,-1,1,0
6,06088,Montijo,15332,74,41,33,18,5,13,28,9,11,13,12,-1,17,-2,9,5,8,3,11,11,2,8,4,-4,3,4,8,1,2,0,1,0,1,1,2,0,2,4,7,0,0,0,-36,-7,-29,5,2,3,-1,-21,-22,-3,5,4,-7,-5,-6,2,5,2,6,-16,-16,-5,0,2,4,1,0,0,0,0,1,1,0,0,0,0,3,0,0,0,0,0,12,0,12,18,11,7,14,-14,8,0,-5,3,8,-9,3,-1,-4,1,6,-5,5,1,-1,2,4,3,6,3,1,0,1,3,3,3,0,0,3,0,3,0,1,0,54,28,26,32,12,20,8,2,8,1,21,8,-2,2,12,-1,10,6,10,0,-4,2,11,2,3,7,8,6,2,2,1,2,4,4,0,1,2,5,4,2,2,1,87,40,47,37,16,21,27,6,32,4,9,3,10,-9,23,7,5,-1,17,15,9,-3,4,4,5,10,11,6,4,0,2,3,6,3,1,0,3,7,5,3,3,0,35,24,11,55,27,28,-2,12,17,-9,12,4,4,14,2,-8,7,3,-6,-2,15,-1,5,1,12,13,19,7,1,1,6,7,5,6,1,1,6,6,14,1,0,0,62,24,38,43,21,22,29,-4,13,28,1,-7,2,5,5,12,1,-3,27,-9,8,16,0,-4,8,11,6,11,5,2,3,5,4,6,2,1,5,6,2,5,3,1,221,131,90,61,34,27,61,27,63,40,18,5,33,18,33,18,14,8,28,9,30,22,4,-3,16,18,20,2,3,2,6,14,11,-1,2,1,10,4,9,3,1,1,176,108,68,73,47,26,38,42,51,28,8,-1,25,21,31,23,5,-2,13,21,20,5,3,1,11,24,22,11,2,1,12,11,12,8,2,1,-1,13,10,3,0,0,48,18,30,40,21,19,7,4,3,6,4,17,8,8,-5,5,2,0,-1,-4,8,1,2,17,17,6,9,1,1,1,9,3,5,2,1,0,8,3,4,-1,0,1,-18,0,-18,-5,-8,3,-2,-24,-1,-3,17,-6,1,-16,2,2,10,-1,-3,-8,-3,-5,7,-5,-3,6,-5,0,-4,0,0,4,-8,-2,-4,1,-3,2,3,2,0,-1,-39,-20,-19,3,-2,5,-5,-15,-13,-5,-4,-2,-9,-8,-8,11,-2,-5,4,-7,-5,-16,-2,3,1,6,3,-5,-4,0,1,2,1,-2,-4,0,0,4,2,-3,0,0,-61,-46,-15,-16,-17,1,0,-20,-27,-12,3,-4,-1,-10,-23,-12,5,-4,1,-10,-4,0,-2,0,-5,2,-5,-4,-1,-3,-3,0,-6,-6,0,-2,-2,2,1,2,-1,-1,-126,-54,-72,3,-2,5,-37,-12,-59,-17,-4,-1,-14,-4,-35,0,-4,1,-23,-8,-24,-17,0,-2,9,-1,3,-6,0,-2,3,-3,2,-3,-1,0,6,2,1,-3,1,-2,-131,-53,-78,-44,-29,-15,-28,-25,-39,-25,-13,4,-5,-7,-16,-14,-12,4,-23,-18,-23,-11,-1,0,-10,-12,-13,-4,-6,1,-7,-7,-11,1,-5,0,-3,-5,-2,-5,-1,1,-121,-63,-58,-13,-10,-3,-11,-12,-39,-47,-14,3,-8,-7,-11,-27,-12,1,-3,-5,-28,-20,-2,2,-3,6,-8,-8,-3,2,-1,2,-5,-3,-3,0,-2,4,-3,-5,0,2,-5,-17,12,-3,-1,-2,26,-27,-22,-1,10,8,19,-11,-20,-14,7,3,7,-16,-2,13,3,5,-4,3,-2,-3,1,1,0,3,1,-5,0,0,-4,0,-3,2,1,1,-22,6,-28,12,6,6,18,-4,-24,-9,1,-10,20,-7,-3,-10,1,-2,-2,3,-21,1,0,-8,3,6,1,1,1,-2,2,2,1,1,1,-1,1,4,0,0,0,-1
6,06091,Navalvillar de Pela,4957,8,5,3,11,4,7,7,-9,-6,6,4,5,3,-2,-4,1,4,2,4,-7,-2,5,0,3,0,5,5,1,0,0,0,1,3,0,0,0,0,4,2,1,0,0,-21,-13,-8,6,2,4,-6,-8,-8,-8,2,6,-1,-5,-3,-5,-1,2,-5,-3,-5,-3,3,4,3,1,1,1,0,0,2,0,0,0,0,0,1,1,1,1,0,0,32,26,6,13,5,8,2,1,12,15,4,-3,3,3,4,12,3,1,-1,-2,8,3,1,-4,2,5,2,2,0,2,0,1,1,1,0,2,2,4,1,1,0,0,-35,-28,-7,8,2,6,5,-20,-7,-2,1,-11,0,-16,-5,-2,-1,-4,5,-4,-2,0,2,-7,0,3,5,0,0,0,0,1,1,0,0,0,0,2,4,0,0,0,-12,5,-17,13,6,7,-2,-1,-17,-1,7,-4,1,3,-5,2,5,-2,-3,-4,-12,-3,2,-2,1,3,5,1,3,0,0,0,3,1,2,0,1,3,2,0,1,0,-6,0,-6,34,9,25,8,-11,-2,4,0,-7,6,-3,-4,1,1,-2,2,-8,2,3,-1,-5,11,8,9,5,0,0,3,3,2,1,0,0,8,5,7,4,0,0,33,3,30,47,18,29,11,8,5,6,4,-3,3,-1,2,-1,0,-1,8,9,3,7,4,-2,9,9,17,7,1,2,3,5,6,1,1,1,6,4,11,6,0,1,8,4,4,43,19,24,24,-12,8,-8,1,-10,9,-3,-1,-3,0,-2,15,-9,9,-5,1,-8,13,11,13,6,1,-2,4,3,5,5,1,0,9,8,8,1,0,-2,-35,-14,-21,5,3,2,-12,1,-18,5,-3,-7,-4,1,-9,4,-7,1,-8,0,-9,1,4,-8,2,1,2,1,-1,0,2,0,0,1,0,0,0,1,2,0,-1,0,85,52,33,26,14,12,26,10,6,26,9,6,17,9,2,17,7,0,9,1,4,9,2,6,9,4,4,5,2,0,6,3,1,3,1,0,3,1,3,2,1,0,1,1,0,10,4,6,5,-4,-4,8,-6,-7,2,-2,-7,7,-5,-2,3,-2,3,1,-1,-5,2,5,0,0,-2,0,0,2,-2,-1,0,0,2,3,2,1,-2,0,25,18,7,11,10,1,0,10,18,4,1,-8,3,2,13,1,0,-1,-3,8,5,3,1,-7,0,2,6,1,1,0,0,1,6,0,2,0,0,1,0,1,-1,0,-9,-9,0,3,1,2,3,4,-13,-6,1,3,1,4,-8,-4,-3,1,2,0,-5,-2,4,2,2,1,-2,2,0,0,1,0,0,1,-1,0,1,1,-2,1,1,0,-33,-13,-20,4,2,2,-5,-6,-16,-7,-1,1,-4,-5,0,-10,1,3,-1,-1,-16,3,-2,-2,1,0,-1,-1,3,2,1,0,0,-1,1,1,0,0,-1,0,2,1,-12,-7,-5,-5,-2,-3,7,-1,-11,-8,2,-4,3,0,-5,-2,-2,-1,4,-1,-6,-6,4,-3,-2,0,1,-6,2,0,-1,0,1,-4,2,0,-1,0,0,-2,0,0,-23,-10,-13,-9,-4,-5,-4,-12,-3,-4,-9,7,-2,-1,-7,2,-6,2,-2,-11,4,-6,-3,5,3,-6,1,-3,-5,0,1,-2,-1,0,-3,0,2,-4,2,-3,-2,0,-56,-27,-29,-9,-7,-2,-19,-1,-26,-17,4,1,-13,-1,-14,-4,4,-1,-6,0,-12,-13,0,2,-2,-2,-6,-1,2,0,-2,0,-5,-1,1,0,0,-2,-1,0,1,0,-65,-27,-38,-6,-2,-4,-7,-9,-22,-7,-13,-7,-1,-6,-6,-4,-8,-2,-6,-3,-16,-3,-5,-5,0,-3,-2,-2,0,0,1,-2,-1,-1,0,0,-1,-1,-1,-1,0,0
6,06095,Olivenza,10585,46,23,23,17,10,7,23,-4,-5,6,2,23,13,-2,-8,5,4,10,10,-2,3,1,-2,13,4,4,5,1,1,1,2,3,3,1,0,0,2,1,2,0,1,1,9,13,-4,15,10,5,-6,-2,5,0,12,-1,-3,-1,4,6,8,-1,-3,-1,1,-6,4,0,0,2,4,5,3,1,0,2,3,3,1,1,0,0,1,2,2,0,132,81,51,69,38,31,43,0,32,24,22,9,27,-2,23,13,15,5,16,2,9,11,7,4,23,8,26,8,3,0,13,5,13,4,3,0,10,3,13,4,0,0,110,64,46,75,49,26,34,1,43,20,10,0,20,-6,29,13,7,0,14,7,14,7,3,0,24,5,28,11,5,1,16,2,17,8,5,0,8,3,11,3,0,1,130,60,70,-66,-51,-15,25,18,29,29,21,6,17,3,5,15,12,7,8,15,24,14,9,-1,-1,2,-45,-21,-2,2,-1,-2,-32,-18,0,2,0,4,-13,-3,-2,0,42,29,13,-14,-10,-4,19,11,-2,-7,16,6,12,6,12,-17,10,4,7,5,-14,10,6,2,3,-1,-17,0,0,1,-3,-2,-8,1,0,1,6,1,-9,-1,0,0,34,16,18,-16,-11,-5,24,-5,7,-11,3,7,11,-1,6,-6,-4,3,13,-4,1,-5,7,4,9,3,-19,-4,-7,1,7,3,-15,-3,-5,0,2,0,-4,-1,-2,1,75,29,46,25,11,14,20,3,49,6,-8,9,15,-4,17,-1,-2,5,5,7,32,7,-6,4,0,12,2,8,4,-1,3,7,1,1,1,-2,-3,5,1,7,3,1,33,6,27,27,12,15,9,1,9,9,6,-3,5,-10,-1,14,1,-3,4,11,10,-5,5,0,11,-4,2,16,2,0,6,-6,0,9,3,0,5,2,2,7,-1,0,32,10,22,1,1,0,21,2,-10,-4,3,15,12,2,-7,-1,-4,7,9,0,-3,-3,7,8,0,2,0,-5,1,3,0,4,0,-3,-1,1,0,-2,0,-2,2,2,88,35,53,21,11,10,9,14,16,18,18,4,0,7,1,10,9,3,9,7,15,8,9,1,2,3,4,2,8,0,0,1,2,0,7,0,2,2,2,2,1,0,-26,-24,-2,-34,-20,-14,0,-12,-9,-17,0,10,3,-9,-19,-6,0,5,-3,-3,10,-11,0,5,-4,-8,-3,-20,-2,2,-1,-4,-4,-12,0,1,-3,-4,1,-8,-2,1,43,28,15,-6,-2,-4,16,0,-9,16,0,16,6,4,-4,3,4,11,10,-4,-5,13,-4,5,0,-1,-5,-2,1,1,1,0,-5,-2,3,1,-1,-1,0,0,-2,0,49,41,8,4,4,0,3,27,6,6,1,2,4,19,14,4,-1,1,-1,8,-8,2,2,1,8,2,-3,1,-4,0,4,1,1,1,-3,0,4,1,-4,0,-1,0,-18,-21,3,-5,-5,0,4,-16,-28,11,10,-3,-5,-8,-16,3,6,-4,9,-8,-12,8,4,1,1,-2,-3,-3,0,1,0,-2,-1,-2,0,-1,1,0,-2,-1,0,2,-33,-12,-21,7,5,2,-9,-30,-8,-7,8,16,2,-17,0,-6,3,10,-11,-13,-8,-1,5,6,4,-1,4,0,-1,0,2,0,4,-1,0,0,2,-1,0,1,-1,0,-35,-1,-34,2,4,-2,-11,-2,-28,1,11,-7,-3,-1,-6,5,6,-3,-8,-1,-22,-4,5,-4,6,-1,0,0,-2,-2,4,1,0,1,-1,-1,2,-2,0,-1,-1,-1,2,-4,6,19,13,6,5,-12,-18,1,6,19,8,-15,-11,0,1,14,-3,3,-7,1,5,5,3,2,1,3,5,4,1,0,2,2,3,4,2,2,-1,1,2,0
6,06097,Orellana la Vieja,3522,-15,-8,-7,8,3,5,-5,1,-17,3,1,1,-2,-2,-11,3,0,3,-3,3,-6,0,1,-2,0,2,4,1,0,0,0,1,1,0,0,0,0,1,3,1,0,0,-35,-8,-27,6,3,3,-3,-2,-28,-3,3,-1,0,4,-10,-4,3,0,-3,-6,-18,1,0,-1,0,3,2,1,0,0,0,2,0,1,0,0,0,1,2,0,0,0,-9,1,-10,1,1,0,1,-4,-9,-3,4,1,6,-1,-8,-2,2,4,-5,-3,-1,-1,2,-3,1,0,2,-2,0,0,1,0,1,-1,0,0,0,0,1,-1,0,0,9,5,4,11,7,4,-2,-5,2,-4,14,4,-2,-2,-1,-1,7,4,0,-3,3,-3,7,0,2,2,3,1,3,0,2,2,2,0,1,0,0,0,1,1,2,0,-5,-19,14,19,7,12,-2,-8,-10,4,2,7,1,-11,-8,-2,0,0,-3,3,-2,6,2,7,2,5,4,6,1,0,1,2,1,2,0,0,1,3,3,4,1,0,-4,0,-4,17,6,11,-1,-6,-6,7,8,-7,0,-6,0,4,5,-3,-1,0,-6,3,3,-4,3,2,1,7,3,1,1,0,0,3,2,0,2,2,1,4,1,1,5,9,-4,16,8,8,6,-1,-2,-5,17,-9,5,-2,4,0,8,-5,1,1,-6,-5,9,-4,3,3,5,0,4,1,2,1,3,0,2,0,1,2,2,0,2,1,35,32,3,24,11,13,16,1,10,10,7,-7,13,6,6,6,4,-3,3,-5,4,4,3,-4,5,5,8,5,0,1,4,3,2,1,0,1,1,2,6,4,0,0,-16,-9,-7,10,5,5,6,0,-16,1,2,-8,6,0,-11,1,2,-7,0,0,-5,0,0,-1,2,2,4,1,1,0,1,1,1,1,1,0,1,1,3,0,0,0,25,20,5,13,9,4,8,5,6,0,9,-4,2,8,11,-2,2,-1,6,-3,-5,2,7,-3,6,2,3,1,0,0,4,1,2,2,0,0,2,1,1,-1,0,0,-20,-5,-15,2,2,0,5,-2,-16,3,1,-10,7,2,-9,1,-1,-5,-2,-4,-7,2,2,-5,1,2,-1,1,-1,0,0,1,0,1,0,0,1,1,-1,0,-1,0,24,12,12,21,14,7,-3,12,16,3,0,-8,0,3,5,7,-2,-2,-3,9,11,-4,2,-6,1,7,8,2,3,0,1,5,5,0,3,0,0,2,3,2,0,0,4,-3,7,5,1,4,8,2,-13,11,-6,-1,3,-2,-8,5,-3,0,5,4,-5,6,-3,-1,2,2,0,0,0,1,0,0,1,0,0,0,2,2,-1,0,0,1,-8,-12,4,0,-2,2,-9,5,-8,-8,9,1,-8,3,-5,-4,1,0,-1,2,-3,-4,8,1,-1,2,-1,-1,1,0,-2,2,-1,-1,0,0,1,0,0,0,1,0,33,33,0,9,7,2,17,7,-1,6,5,0,14,5,6,2,4,2,3,2,-7,4,1,-2,1,6,1,-1,2,0,0,5,2,-1,1,0,1,1,-1,0,1,0,-20,0,-20,3,2,1,-8,6,-7,-11,6,-6,0,3,5,-8,3,-4,-8,3,-12,-3,3,-2,0,2,0,1,0,0,-1,1,0,2,0,0,1,1,0,-1,0,0,-18,-17,-1,-19,-9,-10,-1,-5,-15,3,-3,0,-5,0,-10,-2,-4,1,4,-5,-5,5,1,-1,-1,-2,-8,-6,-1,-1,0,-1,-5,-2,-1,0,-1,-1,-3,-4,0,-1,1,-4,5,17,8,9,-1,-1,6,-1,-3,-1,-5,1,1,0,-2,-1,4,-2,5,-1,-1,0,1,-2,9,6,2,1,0,-1,7,1,1,0,1,-1,2,5,1,1
6,06121,Santa Marta,4100,22,5,17,2,1,1,5,10,1,3,6,-2,-1,2,3,0,3,-1,6,8,-2,3,3,-1,0,0,0,1,1,0,0,0,0,0,1,0,0,0,0,1,0,0,25,23,2,2,1,1,7,1,10,2,5,0,6,3,6,5,3,0,1,-2,4,-3,2,0,0,1,0,1,0,0,0,1,0,0,0,0,0,0,0,1,0,0,-29,-10,-19,-2,-1,-1,0,1,-17,-2,-3,-8,-2,0,-5,2,-1,-4,2,1,-12,-4,-2,-4,0,0,0,0,0,-2,0,0,0,0,0,-1,0,0,0,0,0,-1,12,13,-1,4,2,2,4,4,-10,11,5,-2,1,1,1,6,3,2,3,3,-11,5,2,-4,1,0,1,2,0,0,0,0,1,1,0,0,1,0,0,1,0,0,28,13,15,12,6,6,4,9,-2,0,11,5,6,1,-4,3,4,3,-2,8,2,-3,7,2,1,4,4,1,2,0,1,1,3,0,1,0,0,3,1,1,1,0,26,23,3,20,13,7,6,7,8,6,3,-5,4,9,8,1,3,-3,2,-2,0,5,0,-2,0,7,9,3,2,-1,0,4,8,1,1,-1,0,3,1,2,1,0,66,36,30,54,31,23,23,5,12,21,5,-3,15,1,-1,12,7,1,8,4,13,9,-2,-4,13,14,16,9,1,1,10,6,6,6,2,1,3,8,10,3,-1,0,-40,-6,-34,27,18,9,-8,-11,-12,0,-8,-1,-5,2,2,1,-5,0,-3,-13,-14,-1,-3,-1,11,5,9,0,-1,2,3,5,8,0,0,2,8,0,1,0,-1,0,26,14,12,16,8,8,3,9,1,-3,11,3,0,2,-1,-1,10,3,3,7,2,-2,1,0,6,7,1,2,-1,0,3,1,2,1,0,0,3,6,-1,1,-1,0,0,-4,4,21,13,8,-3,3,-1,9,0,-10,-2,3,-5,6,-2,-4,-1,0,4,3,2,-6,3,6,3,7,2,0,2,5,1,4,1,0,1,1,2,3,1,0,21,18,3,13,2,11,8,11,8,-1,4,-7,3,7,3,2,3,0,5,4,5,-3,1,-7,6,9,1,-3,0,0,2,2,-1,-1,0,0,4,7,2,-2,0,0,-3,-10,7,5,1,4,5,6,-16,-2,-4,7,4,-1,-9,-2,-2,0,1,7,-7,0,-2,7,2,7,1,-3,-3,0,1,3,0,-1,-2,0,1,4,1,-2,-1,0,-2,-3,1,-11,-6,-5,-2,-3,-8,6,3,-1,0,-4,-5,5,-1,1,-2,1,-3,1,4,-2,-2,-2,-7,0,-1,0,-1,0,-6,1,-1,0,-1,-2,-1,-1,0,0,41,14,27,29,15,14,5,18,0,11,-1,6,-2,7,-1,9,-1,2,7,11,1,2,0,4,5,8,6,8,0,1,1,4,3,6,0,0,4,4,3,2,0,1,-11,2,-13,-7,-2,-5,2,-9,14,-11,2,-10,-1,-1,9,-5,2,-3,3,-8,5,-6,0,-7,-2,1,-5,0,0,-1,1,1,-2,-1,0,-1,-3,0,-3,1,0,0,19,3,16,23,7,16,19,-4,3,-1,0,0,8,-5,0,-2,-1,1,11,1,3,1,1,-1,10,5,6,1,1,0,4,0,1,1,1,0,6,5,5,0,0,0,-45,-31,-14,-6,-6,0,2,0,-25,-18,3,-9,-1,1,-16,-12,0,-5,3,-1,-9,-6,3,-4,2,8,-5,-8,-3,0,-1,6,-3,-6,-2,0,3,2,-2,-2,-1,0,-1,13,-14,5,6,-1,19,-4,-1,-5,2,-10,14,-4,3,1,3,-5,5,0,-4,-6,-1,-5,2,0,4,-2,4,-2,2,-1,2,0,4,-1,0,1,2,-2,0,-1
6,06122,"Santos de Maimona, Los",7938,-21,-16,-5,8,3,5,-7,-8,-2,-1,-7,3,1,-11,-4,-3,-2,2,-8,3,2,2,-5,1,5,1,1,1,0,0,3,0,0,0,0,0,2,1,1,1,0,0,16,11,5,8,1,7,2,-2,0,0,10,6,1,1,-1,1,4,5,1,-3,1,-1,6,1,2,2,0,2,2,0,0,0,0,1,0,0,2,2,0,1,2,0,-34,-18,-16,5,0,5,-4,-3,-11,-6,-1,-8,1,-2,-8,-4,-2,-1,-5,-1,-3,-2,1,-7,0,2,2,0,0,1,0,0,0,-1,0,1,0,2,2,1,0,0,6,3,3,10,4,6,9,2,-15,13,3,-6,9,-8,-7,9,3,-3,0,10,-8,4,0,-3,5,0,1,4,0,0,2,0,0,2,0,0,3,0,1,2,0,0,27,21,6,28,13,15,15,9,9,3,1,-8,13,9,5,-2,1,-4,2,0,4,5,0,-4,9,4,4,5,4,2,6,1,2,1,3,0,3,3,2,4,1,2,46,25,21,15,6,9,11,-5,14,5,9,9,6,-2,10,1,7,1,5,-3,4,4,2,8,2,2,4,3,2,2,1,1,2,0,2,0,1,1,2,3,0,2,54,26,28,7,1,6,5,5,7,6,20,9,-1,3,5,0,10,8,6,2,2,6,10,1,0,1,2,4,0,0,0,0,1,0,0,0,0,1,1,4,0,0,47,34,13,21,13,8,16,-3,8,21,7,-2,16,2,2,13,1,1,0,-5,6,8,6,-3,0,7,7,4,3,0,0,6,4,2,1,0,0,1,3,2,2,0,58,36,22,26,19,7,10,16,20,9,5,-5,8,9,8,8,3,-1,2,7,12,1,2,-4,6,6,7,5,1,0,3,6,5,3,1,0,3,0,2,2,0,0,47,32,15,17,7,10,16,-3,11,13,6,-2,9,3,5,9,3,0,7,-6,6,4,3,-2,6,8,3,1,0,-1,2,4,-1,2,0,0,4,4,4,-1,0,-1,23,16,7,15,10,5,9,2,2,6,10,-3,6,2,3,5,4,-3,3,0,-1,1,6,0,1,7,4,3,0,0,0,5,3,2,0,0,1,2,1,1,0,0,-3,20,-23,8,6,2,-7,5,7,2,-4,-2,-2,8,8,5,0,2,-5,-3,-1,-3,-4,-4,-3,3,4,3,1,0,-1,2,2,3,0,0,-2,1,2,0,1,0,-11,6,-17,4,1,3,-1,-5,-15,5,7,-2,-2,0,-5,10,6,-2,1,-5,-10,-5,1,0,2,1,-2,4,-1,0,0,0,-2,2,1,0,2,1,0,2,-2,0,14,7,7,9,3,6,4,7,-3,-2,5,0,-2,6,-4,3,1,2,6,1,1,-5,4,-2,4,3,-1,2,0,0,2,0,0,1,0,0,2,3,-1,1,0,0,15,2,13,6,-4,10,-2,-2,18,-5,0,5,2,-8,11,-5,-3,4,-4,6,7,0,3,1,0,2,10,-2,-4,0,0,-2,3,-2,-3,0,0,4,7,0,-1,0,-29,-33,4,-4,-4,0,-1,-2,-14,-18,2,2,-1,0,-18,-14,2,-2,0,-2,4,-4,0,4,-1,2,-5,0,1,-2,-1,0,-4,1,1,-1,0,2,-1,-1,0,-1,-45,-12,-33,2,0,2,-5,-3,-29,-5,4,-7,0,5,-15,0,1,-4,-5,-8,-14,-5,3,-3,0,1,-2,1,1,0,1,0,-2,0,0,0,-1,1,0,1,1,0,2,-7,9,9,3,6,20,-10,-22,8,1,5,11,-10,-16,5,-2,4,9,0,-6,3,3,1,1,-1,4,2,2,1,1,-1,2,0,0,1,0,0,2,2,2,0
6,06133,Torremejía,2030,19,15,4,11,9,2,9,4,2,4,0,-1,6,4,1,3,0,0,3,0,1,1,0,-1,3,4,1,3,0,0,2,4,1,2,0,0,1,0,0,1,0,0,7,4,3,7,5,2,3,-2,-2,2,1,5,2,0,-2,1,0,3,1,-2,0,1,1,2,1,2,2,2,0,0,1,2,2,0,0,0,0,0,0,2,0,0,4,3,1,5,3,2,0,-3,3,5,-1,0,1,-4,3,3,0,0,-1,1,0,2,-1,0,1,0,2,1,0,1,1,0,1,0,0,1,0,0,1,1,0,0,7,6,1,7,4,3,-4,3,-1,3,3,2,-1,3,-1,0,2,1,-3,0,0,3,1,1,0,3,1,2,0,1,0,2,1,1,0,0,0,1,0,1,0,1,14,9,5,13,8,5,-1,5,9,-1,3,-2,3,1,4,0,1,-1,-4,4,5,-1,2,-1,2,4,7,0,0,0,1,3,4,0,0,0,1,1,3,0,0,0,7,8,-1,7,3,4,1,0,-4,4,4,2,1,1,1,2,2,1,0,-1,-5,2,2,1,2,3,2,0,0,0,2,1,0,0,0,0,0,2,2,0,0,0,10,6,4,6,5,1,-1,7,0,5,1,-3,0,4,-2,4,1,-1,-1,3,2,1,0,-2,2,1,2,-1,1,1,2,1,0,1,1,0,0,0,2,-2,0,1,38,23,15,22,10,12,8,3,16,7,1,3,5,0,11,5,0,2,3,3,5,2,1,1,3,6,9,2,1,0,0,3,5,1,1,0,3,3,4,1,0,0,1,1,0,0,-2,2,5,-4,0,2,1,-2,4,-5,2,0,2,-2,1,1,-2,2,-1,0,0,-1,1,0,0,0,0,-2,0,0,0,0,0,1,1,0,0,0,-5,-5,0,-1,-2,1,-4,-5,5,-4,4,-2,0,-2,2,-4,0,-1,-4,-3,3,0,4,-1,0,0,-1,-1,1,0,0,0,-1,-1,0,0,0,0,0,0,1,0,9,3,6,9,6,3,11,1,-4,-4,1,4,5,-1,-3,-1,1,2,6,2,-1,-3,0,2,5,1,3,0,0,0,2,0,3,1,0,0,3,1,0,-1,0,0,0,-1,1,3,3,0,-6,4,1,2,-5,3,-8,5,0,2,-2,2,2,-1,1,0,-3,1,0,2,1,1,-1,0,0,2,1,0,0,0,0,0,0,1,-1,0,-12,-7,-5,-6,-3,-3,-3,-6,0,-2,-4,-1,-2,-1,-3,-2,-3,1,-1,-5,3,0,-1,-2,-4,0,2,-2,-1,-1,-2,1,0,-1,-1,0,-2,-1,2,-1,0,-1,8,11,-3,4,3,1,-2,-6,6,3,6,0,0,-4,5,5,3,1,-2,-2,1,-2,3,-1,2,-1,1,0,2,0,1,-1,1,0,2,0,1,0,0,0,0,0,-19,-11,-8,-17,-12,-5,-3,-8,-5,-1,-2,1,-1,-2,-3,-1,-2,-1,-2,-6,-2,0,0,2,-3,-6,-5,-3,-1,1,-1,-2,-5,-3,-1,0,-2,-4,0,0,0,1,-2,-7,5,1,2,-1,7,-3,-2,-1,-1,-2,2,-4,-4,1,-1,-1,5,1,2,-2,0,-1,1,0,-1,0,1,0,1,0,0,0,1,0,0,0,-1,0,0,0,7,2,5,3,0,3,1,-4,-1,8,2,1,0,0,-3,7,-1,-1,1,-4,2,1,3,2,0,1,2,0,0,0,0,0,1,0,-1,0,0,1,1,0,1,0,-3,5,-8,-1,0,-1,0,2,-6,3,0,-2,4,0,-3,3,2,-1,-4,2,-3,0,-2,-1,-1,-1,1,-1,0,1,0,0,0,0,0,0,-1,-1,1,-1,0,1
6,06149,Villafranca de los Barros,12482,-31,-27,-4,11,3,8,0,-3,-13,-14,5,-7,-5,-7,-7,-8,3,-4,5,4,-6,-6,2,-3,3,4,3,1,0,0,2,0,1,0,0,0,1,4,2,1,0,0,4,-4,8,9,5,4,18,-27,4,21,-5,-5,9,-15,-3,12,-3,-4,9,-12,7,9,-2,-1,1,2,3,3,0,0,0,0,3,2,0,0,1,2,0,1,0,0,41,16,25,28,18,10,29,-1,-3,7,6,6,14,-5,2,2,4,1,15,4,-5,5,2,5,8,2,9,7,1,1,4,1,7,5,0,1,4,1,2,2,1,0,15,11,4,39,28,11,-9,14,8,-5,8,-2,0,10,0,-4,1,2,-9,4,8,-1,7,-4,3,13,15,6,1,0,3,10,8,5,1,0,0,3,7,1,0,0,237,157,80,181,125,56,37,65,73,48,17,-2,22,45,48,29,13,0,15,20,25,19,4,-2,14,61,65,34,6,0,8,43,46,23,4,0,6,18,19,11,2,0,154,80,74,121,69,52,23,35,43,31,17,1,11,16,19,13,10,6,12,19,24,18,7,-5,10,48,32,23,5,3,4,30,18,13,3,1,6,18,14,10,2,2,36,6,30,-22,-23,1,21,-8,-3,-16,19,23,14,-3,-12,-8,4,11,7,-5,9,-8,15,12,3,3,-15,-11,-3,1,-1,3,-12,-9,-4,0,4,0,-3,-2,1,1,69,50,19,149,84,65,9,29,7,19,10,-6,-1,16,20,13,6,-5,10,13,-13,6,4,-1,24,50,37,28,7,1,12,26,22,19,5,0,12,24,15,9,2,1,159,71,88,103,68,35,24,26,10,24,6,67,11,18,-1,20,3,19,13,8,11,4,3,48,18,38,20,20,6,-1,12,25,13,12,5,0,6,13,7,8,1,-1,-83,-51,-32,-68,-41,-27,7,-26,-45,-29,8,-5,2,-24,-17,-21,6,-1,5,-2,-28,-8,2,-4,4,-17,-25,-25,-6,-1,3,-10,-16,-14,-5,0,1,-7,-9,-11,-1,-1,11,-3,14,16,0,16,1,6,-10,3,2,7,4,7,-15,1,-2,1,-3,-1,5,2,4,6,5,4,2,2,3,0,2,1,-2,-2,1,0,3,3,4,4,2,0,53,22,31,44,15,29,17,20,-13,7,9,14,-2,14,-7,6,2,8,19,6,-6,1,7,6,5,26,7,3,2,1,-2,15,1,-1,1,1,7,11,6,4,1,0,50,-1,51,-30,-19,-11,12,-2,-24,8,-13,67,1,-2,-16,-1,-5,20,11,0,-8,9,-8,47,1,3,-18,-5,-12,1,0,4,-15,-3,-5,0,1,-1,-3,-2,-7,1,-62,-22,-40,-56,-34,-22,7,-17,-28,-26,-1,6,9,-7,-19,-9,-2,8,-2,-10,-9,-17,1,-2,8,-12,-25,-23,-3,-3,4,-8,-16,-11,-3,-1,4,-4,-9,-12,0,-2,-12,-16,4,13,6,7,15,-10,-10,-9,-2,6,10,-12,-8,-5,1,0,5,2,-2,-4,-3,6,11,9,1,-5,-7,3,8,3,1,-5,-4,2,3,6,0,0,-3,1,-41,-19,-22,32,13,19,6,-1,-31,-6,2,-11,9,-8,-19,-1,1,-3,-3,7,-12,-5,1,-8,8,13,-7,12,5,0,4,6,-8,8,2,0,4,7,1,4,3,0,-106,-45,-61,-74,-37,-37,-15,-24,-59,-25,3,13,-7,-1,-30,-10,0,0,-8,-23,-29,-15,3,13,-7,-5,-36,-19,-4,-3,-1,1,-21,-12,-2,-3,-6,-6,-15,-7,-2,0,-120,-72,-48,-97,-47,-50,-8,-37,-32,-40,-6,2,-5,-24,-12,-29,-5,3,-3,-13,-20,-11,-1,-1,-18,-31,-23,-24,-2,0,-10,-14,-7,-16,0,0,-8,-17,-16,-8,-2,0
6,06153,Villanueva de la Serena,23717,8,2,6,54,21,33,27,-25,15,-8,0,-4,21,-18,5,-10,0,1,6,-7,10,2,0,-5,17,11,11,5,6,3,8,3,4,1,3,1,9,8,7,4,3,2,74,23,51,51,19,32,4,10,21,7,8,23,-12,9,20,1,0,6,16,1,1,6,8,17,9,12,16,8,2,2,5,4,5,3,0,1,4,8,11,5,2,1,79,31,48,68,26,42,12,18,28,-3,18,9,8,4,14,-6,8,4,4,14,14,3,10,5,11,22,17,9,7,2,5,7,8,1,3,2,6,15,9,8,4,0,21,1,20,60,18,42,25,-6,-23,13,28,-16,18,-12,-17,-1,15,0,7,6,-6,14,13,-16,13,11,14,13,8,0,4,2,4,4,4,0,9,9,10,9,4,0,167,93,74,114,45,69,33,40,40,35,16,7,17,8,36,27,5,4,16,32,4,8,11,3,18,28,38,18,9,1,6,6,19,7,6,0,12,22,19,11,3,1,261,131,130,133,74,59,58,31,63,46,33,25,30,18,35,17,22,9,28,13,28,29,11,16,27,31,37,24,10,3,18,9,23,16,5,2,9,22,14,8,5,1,354,178,176,108,56,52,73,34,90,82,35,37,39,21,51,29,17,18,34,13,39,53,18,19,12,28,34,24,6,3,7,15,18,11,2,3,5,13,16,13,4,0,247,123,124,148,71,77,84,32,42,30,33,21,40,6,30,9,26,12,44,26,12,21,7,9,31,43,41,28,2,2,11,21,22,13,2,2,20,22,19,15,0,0,219,118,101,95,46,49,79,29,42,47,7,11,38,14,31,29,-3,5,41,15,11,18,10,6,30,25,24,9,2,1,16,13,14,-1,2,-1,14,12,10,10,0,2,225,104,121,71,21,50,56,57,32,43,19,0,14,21,13,28,16,1,42,36,19,15,3,-1,18,12,28,13,-4,0,3,4,8,8,-2,-1,15,8,20,5,-2,1,-24,6,-30,71,39,32,4,10,4,0,4,-42,-3,19,9,-2,6,-19,7,-9,-5,2,-2,-23,20,29,9,9,1,2,10,22,3,1,1,1,10,7,6,8,0,1,26,-6,32,14,-7,21,13,-3,-44,39,20,0,12,-11,-28,8,11,1,1,8,-16,31,9,-1,6,10,-14,-1,3,3,3,-7,-5,-4,-1,2,3,17,-9,3,4,1,78,31,47,33,14,19,11,9,-11,36,25,5,8,-15,-1,12,21,4,3,24,-10,24,4,1,15,17,4,-5,1,0,9,2,3,-4,5,-1,6,15,1,-1,-4,1,-39,5,-44,5,5,0,-9,3,-18,-22,9,-2,-4,5,8,-7,3,-1,-5,-2,-26,-15,6,-1,11,2,-11,4,0,-3,3,2,-3,2,1,-1,8,0,-8,2,-1,-2,-42,-48,6,-8,-15,7,35,-15,-38,-20,6,-12,8,-12,-23,-23,3,-4,27,-3,-15,3,3,-8,14,6,-21,-15,5,-1,7,2,-19,-13,5,-1,7,4,-2,-2,0,0,11,19,-8,36,12,24,16,-10,1,2,-3,4,12,4,-4,1,1,5,4,-14,5,1,-4,-1,12,11,8,-1,4,0,7,2,4,-3,0,0,5,9,4,2,4,0,-20,-43,23,44,10,34,28,-2,-49,-36,19,22,19,-7,-36,-40,14,9,9,5,-13,4,5,13,17,11,6,4,3,1,10,-1,-1,-2,2,1,7,12,7,6,1,0,-98,-69,-29,-3,-8,5,3,-27,-51,-8,-23,0,-5,-17,-29,-1,-16,-3,8,-10,-22,-7,-7,3,14,-1,-15,-3,-5,3,6,-4,-12,4,-6,1,8,3,-3,-7,1,2
6,06160,Zalamea de la Serena,4636,-16,-16,0,20,3,17,-18,-7,3,-5,10,1,-11,-8,-1,-3,3,3,-7,1,4,-2,7,-2,1,6,11,2,0,0,1,0,1,1,0,0,0,6,10,1,0,0,-26,-15,-11,22,5,17,-1,-20,-4,-9,0,7,2,-15,-1,-8,2,4,-3,-5,-3,-1,-2,3,0,12,5,3,1,0,0,1,1,1,1,0,0,11,4,2,0,0,-51,-18,-33,1,-1,2,-1,-28,-14,1,-8,1,3,-19,-1,2,-4,1,-4,-9,-13,-1,-4,0,2,2,2,0,-5,0,1,0,0,0,-2,0,1,2,2,0,-3,0,-21,-1,-20,10,3,7,-4,3,-12,-1,9,-14,0,-2,-3,3,5,-2,-4,5,-9,-4,4,-12,2,2,2,3,0,1,1,1,0,0,0,1,1,1,2,3,0,0,6,18,-12,17,8,9,5,-6,-4,-7,12,6,3,3,0,-1,6,8,2,-9,-4,-6,6,-2,3,6,3,1,2,1,2,2,2,0,1,1,1,4,1,1,1,0,-19,-5,-14,13,4,9,9,-17,1,2,-2,-13,11,-7,0,-6,0,-3,-2,-10,1,8,-2,-10,1,5,6,0,0,1,1,1,2,0,0,0,0,4,4,0,0,1,-37,-20,-17,8,3,5,-2,-12,-12,-8,-4,0,2,-5,-7,-4,-7,1,-4,-7,-5,-4,3,-1,3,-2,3,2,1,1,2,0,1,0,0,0,1,-2,2,2,1,1,-39,-26,-13,12,4,8,-9,-11,-9,-5,2,-8,-5,-9,-10,-1,2,-4,-4,-2,1,-4,0,-4,0,5,3,1,1,1,0,0,1,1,1,0,0,5,2,0,0,1,36,16,20,3,6,-3,12,0,9,0,14,-4,1,-3,8,0,8,-1,11,3,1,0,6,-3,-1,2,3,-2,1,0,0,1,4,0,1,0,-1,1,-1,-2,0,0,-13,-18,5,-7,-3,-4,5,-9,-5,9,4,-13,-8,-6,-2,4,1,-5,13,-3,-3,5,3,-8,-3,-2,-3,1,0,0,-2,0,-2,1,0,0,-1,-2,-1,0,0,0,16,10,6,13,3,10,-4,-3,5,7,6,5,1,-2,2,0,5,4,-5,-1,3,7,1,1,2,6,2,-1,3,1,1,1,1,-2,2,0,1,5,1,1,1,1,1,12,-11,5,4,1,4,-1,5,5,3,-14,2,-1,9,6,2,-4,2,0,-4,-1,1,-10,1,-2,1,2,1,2,1,-1,-1,2,1,2,0,-1,2,0,0,0,0,1,-1,5,1,4,6,-7,-1,-1,8,-2,2,-1,0,-4,4,1,4,-6,-1,3,4,-3,2,0,0,0,0,2,0,0,0,0,0,1,2,0,0,0,0,1,-20,3,-23,-10,-6,-4,-4,1,-3,-9,8,-15,0,-3,1,-1,9,-5,-4,4,-4,-8,-1,-10,-1,0,-3,-4,0,-2,-1,0,-1,-2,0,-2,0,0,-2,-2,0,0,7,12,-5,9,5,4,-1,-2,-6,1,8,8,3,-3,0,0,5,7,-4,1,-6,1,3,1,1,1,1,1,2,3,1,0,0,1,1,2,0,1,1,0,1,1,-7,0,-7,4,-1,5,-8,-2,-9,8,4,0,-4,0,1,7,-2,-3,-4,-2,-10,1,6,3,-1,1,0,1,3,0,-1,0,0,0,0,0,0,1,0,1,3,0,-55,-22,-33,4,4,0,-4,-6,-27,-6,-4,-6,0,-6,-10,-3,0,-1,-4,0,-17,-3,-4,-5,-1,2,-1,-1,1,4,0,0,-1,1,1,3,-1,2,0,-2,0,1,-32,-18,-14,13,3,10,6,-17,-15,1,2,-6,4,-10,-7,-4,1,-1,2,-7,-8,5,1,-5,3,0,5,0,5,0,2,-1,1,-2,3,0,1,1,4,2,2,0
7,07002,Alaior,7229,233,118,115,7,4,3,35,100,51,30,16,-1,10,55,28,15,6,1,25,45,23,15,10,-2,1,1,2,1,2,0,0,1,1,0,2,0,1,0,1,1,0,0,179,102,77,17,7,10,10,78,49,23,23,-5,2,45,34,11,10,-3,8,33,15,12,13,-2,1,2,3,3,6,1,0,1,2,1,2,1,1,1,1,2,4,0,252,136,116,164,86,78,35,46,65,44,52,11,17,20,40,24,29,6,18,26,25,20,23,5,36,20,46,32,27,3,19,9,27,16,13,2,17,11,19,16,14,1,226,125,101,183,93,90,-10,75,57,44,61,4,-9,40,31,28,33,2,-1,35,26,16,28,2,23,22,43,43,46,5,10,13,18,23,27,2,13,9,25,20,19,3,159,100,59,188,100,88,11,22,30,29,45,21,2,6,35,18,25,11,9,16,-5,11,20,10,25,27,38,33,46,17,13,13,22,19,22,9,12,14,16,14,24,8,170,95,75,153,87,66,22,65,42,20,14,4,19,44,9,10,8,2,3,21,33,10,6,2,35,22,36,32,21,6,22,14,20,16,11,3,13,8,16,16,10,3,120,81,39,161,77,84,14,30,35,21,14,5,9,30,29,4,11,-3,5,0,6,17,3,8,30,35,35,23,26,11,16,17,20,9,10,4,14,18,15,14,16,7,164,56,108,102,43,59,26,63,24,5,19,24,19,21,-3,4,2,14,7,42,27,1,17,10,14,28,22,12,15,10,7,15,3,5,7,6,7,13,19,7,8,4,175,94,81,158,81,77,29,30,28,40,34,14,8,20,18,33,8,7,21,10,10,7,26,7,29,17,39,24,36,12,12,9,23,15,16,6,17,8,16,9,20,6,99,43,56,103,46,57,11,44,20,-2,12,13,3,15,11,0,6,7,8,29,9,-2,6,6,21,22,11,17,24,8,9,7,5,8,11,6,12,15,6,9,13,2,105,67,38,71,33,38,0,37,24,23,24,0,6,19,11,25,6,1,-6,18,13,-2,18,-1,9,19,4,13,23,4,5,7,0,8,11,2,4,12,4,5,12,2,4,-3,7,53,29,24,-2,6,-16,-1,6,8,-3,-1,-1,-9,8,2,1,7,-15,8,-2,6,5,5,14,11,13,4,0,4,7,7,8,3,5,1,7,4,5,1,146,64,82,46,16,30,21,12,30,40,22,15,12,-2,9,24,9,7,9,14,21,16,13,8,-4,6,15,3,11,12,-3,1,7,3,2,5,-1,5,8,0,9,7,27,-12,39,29,12,17,19,11,-14,1,10,3,4,5,-14,-6,-4,4,15,6,0,7,14,-1,0,10,1,5,7,6,0,4,2,0,1,5,0,6,-1,5,6,1,-92,-36,-56,21,7,14,-14,-7,-25,-30,-12,0,-2,4,-7,-21,-9,-2,-12,-11,-18,-9,-3,2,-4,5,2,4,12,1,-4,4,2,0,6,-1,0,1,0,4,6,2,-20,4,-24,26,8,18,7,5,-11,-4,-23,2,1,12,3,-7,-9,2,6,-7,-14,3,-14,0,2,11,14,-5,0,0,-1,5,6,-4,1,0,3,6,8,-1,-1,0,160,98,62,101,56,45,33,19,29,49,25,6,31,6,12,32,17,2,2,13,17,17,8,4,20,8,19,31,22,0,14,1,10,18,13,0,6,7,9,13,9,0,110,56,54,78,42,36,-1,17,36,23,33,1,-3,2,23,13,19,1,2,15,13,10,14,0,8,17,16,19,13,3,3,7,12,12,4,3,5,10,4,7,9,0
7,07001,Alaró,3834,80,45,35,93,49,44,-3,16,32,25,10,0,-6,7,22,17,5,0,3,9,10,8,5,0,11,13,31,20,15,1,5,6,18,10,10,0,6,7,13,10,5,1,161,88,73,117,60,57,18,22,76,25,16,1,8,14,34,21,8,1,10,8,42,4,8,0,24,14,38,24,13,1,11,9,16,16,6,1,13,5,22,8,7,0,139,67,72,83,43,40,23,22,46,18,21,8,12,16,20,6,10,2,11,6,26,12,11,6,20,14,24,16,6,2,13,9,11,7,1,1,7,5,13,9,5,1,104,58,46,85,45,40,-7,25,52,20,15,-3,-1,12,29,9,9,-2,-6,13,23,11,6,-1,9,13,22,20,15,5,7,5,11,10,9,2,2,8,11,10,6,3,81,50,31,58,32,26,20,4,35,6,13,4,12,7,24,2,5,2,8,-3,11,4,8,2,7,10,15,14,9,2,4,5,9,8,4,2,3,5,6,6,5,0,121,66,55,64,36,28,29,13,38,23,18,-4,22,2,18,14,11,-1,7,11,20,9,7,-3,10,8,16,17,7,3,6,5,7,9,5,3,4,3,9,8,2,0,177,85,92,81,36,45,28,32,77,27,16,-3,21,10,40,9,7,-3,7,22,37,18,9,0,16,10,23,18,10,4,8,7,7,7,6,1,8,3,16,11,4,3,166,90,76,122,69,53,14,23,79,29,18,2,7,16,33,18,14,3,7,7,46,11,4,-1,21,12,36,31,21,1,14,8,13,20,12,2,7,4,23,11,9,-1,136,64,72,74,29,45,29,22,62,22,-13,4,19,8,23,11,-7,3,10,14,39,11,-6,1,19,13,21,17,1,1,9,6,4,8,0,0,10,7,17,9,1,1,65,12,53,40,16,24,20,9,38,1,0,-8,7,-2,12,-3,-3,0,13,11,26,4,3,-8,13,6,9,9,2,-1,6,2,4,3,0,0,7,4,5,6,2,-1,12,22,-10,27,26,1,-14,13,6,-3,0,7,-8,9,6,6,1,6,-6,4,0,-9,-1,1,6,5,11,1,-1,4,7,3,9,2,1,3,-1,2,2,-1,-2,1,62,69,-7,20,10,10,24,0,14,19,10,-6,20,5,21,15,7,0,4,-5,-7,4,3,-6,4,4,-1,5,7,1,4,2,-1,1,3,1,0,2,0,4,4,0,56,38,18,12,1,11,0,6,25,0,5,14,-3,4,21,2,3,9,3,2,4,-2,2,5,2,2,3,0,3,2,0,0,-1,0,0,2,2,2,4,0,3,0,6,-2,8,27,9,18,-19,5,6,3,12,0,-19,10,-1,1,7,1,0,-5,7,2,5,-1,12,1,2,4,6,2,4,0,0,0,5,0,8,1,2,4,1,2,73,36,37,36,19,17,9,7,28,14,12,1,3,6,8,13,6,-2,6,1,20,1,6,3,6,2,3,9,14,1,3,1,4,4,6,-1,3,1,-1,5,8,2,29,10,19,32,12,20,16,-8,-4,18,9,4,3,-9,5,5,4,4,13,1,-9,13,5,0,13,0,4,10,4,1,6,-1,1,4,1,1,7,1,3,6,3,0,127,41,86,87,35,52,24,19,36,40,1,5,1,8,15,17,0,1,23,11,21,23,1,4,21,9,14,30,11,2,8,5,6,9,7,0,13,4,8,21,4,2,131,67,64,111,52,59,22,1,45,43,14,3,18,-3,18,27,7,0,4,4,27,16,7,3,17,9,24,34,19,8,10,4,7,17,12,2,7,5,17,17,7,6
7,07003,Alcúdia,11435,631,357,274,347,181,166,34,187,216,103,57,23,16,96,140,49,30,16,18,91,76,54,27,7,41,55,100,90,43,17,16,31,56,46,21,10,25,24,44,44,22,7,852,459,393,638,342,296,106,249,282,128,65,20,55,133,150,68,39,14,51,116,132,60,26,6,105,151,210,108,52,10,53,80,119,55,28,6,52,71,91,53,24,4,765,388,377,666,348,318,106,217,215,137,57,27,57,101,110,80,25,13,49,116,105,57,32,14,115,154,201,121,55,15,53,79,106,69,30,8,62,75,95,52,25,7,609,333,276,584,305,279,58,178,139,113,85,31,39,85,90,72,36,9,19,93,49,41,49,22,88,129,160,104,71,24,42,66,83,64,35,11,46,63,77,40,36,13,676,400,276,638,332,306,78,162,148,115,89,70,65,88,105,54,46,34,13,74,43,61,43,36,87,128,167,112,83,53,54,55,90,63,38,27,33,73,77,49,45,26,334,164,170,527,264,263,1,159,40,36,54,39,5,66,26,13,28,21,-4,93,14,23,26,18,62,152,137,76,69,27,41,64,71,39,33,13,21,88,66,37,36,14,932,504,428,781,394,387,82,225,306,152,124,48,43,110,172,84,68,26,39,115,134,68,56,22,108,177,243,123,92,37,59,82,117,68,43,24,49,95,126,55,49,13,865,485,380,853,432,421,92,269,250,108,89,45,44,125,179,59,43,27,48,144,71,49,46,18,102,237,261,128,90,30,52,99,146,76,43,14,50,138,115,52,47,16,700,333,367,736,360,376,71,237,189,120,26,49,34,100,90,67,14,22,37,137,99,53,12,27,104,204,223,111,61,24,54,85,116,57,33,10,50,119,107,54,28,14,414,207,207,409,202,207,41,149,95,51,48,18,18,73,51,29,20,11,23,76,44,22,28,7,52,121,118,58,32,24,36,45,60,32,16,13,16,76,58,26,16,11,235,143,92,292,150,142,36,78,62,24,20,8,33,41,34,16,9,9,3,37,28,8,11,-1,51,76,70,43,29,21,30,39,28,23,14,14,21,37,42,20,15,7,340,195,145,282,142,140,62,121,97,14,19,13,24,55,82,12,3,11,38,66,15,2,16,2,37,93,81,33,26,7,19,42,49,15,11,3,18,51,32,18,15,4,352,200,152,248,129,119,58,102,120,30,14,13,38,62,67,9,8,8,20,40,53,21,6,5,34,66,62,37,33,10,21,32,27,17,17,10,13,34,35,20,16,0,418,233,185,182,100,82,92,111,101,94,12,1,49,49,74,61,4,-5,43,62,27,33,8,6,27,51,38,29,26,6,15,25,28,11,14,5,12,26,10,18,12,1,180,113,67,237,123,114,31,96,31,23,5,-9,5,58,38,14,-7,2,26,38,-7,9,12,-11,37,70,59,38,30,0,15,35,34,23,10,4,22,35,25,15,20,-4,236,113,123,249,141,108,9,120,41,22,11,34,10,60,8,26,6,3,-1,60,33,-4,5,31,21,87,76,37,15,7,14,46,40,28,8,0,7,41,36,9,7,7,287,121,166,283,122,161,56,114,85,39,-6,-5,30,41,61,7,-13,-7,26,73,24,32,7,2,42,93,84,30,19,8,24,33,48,2,10,0,18,60,36,28,9,8,385,175,210,387,173,214,22,147,155,32,36,-6,4,77,69,21,10,-4,18,70,86,11,26,-2,57,101,132,46,42,8,20,52,59,21,12,8,37,49,73,25,30,0
7,07004,Algaida,3661,117,78,39,64,39,25,-8,22,39,33,18,13,-1,10,28,25,10,6,-7,12,11,8,8,7,9,11,28,10,6,0,5,5,19,7,3,0,4,6,9,3,3,0,72,46,26,46,24,22,10,11,24,17,6,2,7,6,16,11,3,3,3,5,8,6,3,-1,8,8,14,4,8,4,3,6,7,1,4,3,5,2,7,3,4,1,159,106,53,63,34,29,37,14,53,38,9,6,22,13,29,28,7,5,15,1,24,10,2,1,12,7,23,18,3,0,9,4,11,9,1,0,3,3,12,9,2,0,147,73,74,41,21,20,17,20,48,25,26,6,7,4,25,18,13,5,10,16,23,7,13,1,6,8,10,10,7,0,2,3,5,8,3,0,4,5,5,2,4,0,107,69,38,76,41,35,9,22,40,19,13,3,11,14,27,7,8,4,-2,8,13,12,5,-1,16,11,19,14,11,5,9,6,8,9,6,3,7,5,11,5,5,2,122,61,61,77,39,38,5,23,30,27,26,12,-2,12,21,13,14,4,7,11,9,14,12,8,5,17,14,19,16,6,1,8,8,11,8,3,4,9,6,8,8,3,178,94,84,66,33,33,34,4,64,37,25,7,27,1,35,12,15,0,7,3,29,25,10,7,7,11,20,18,5,4,6,4,9,9,2,2,1,7,11,9,3,2,256,144,112,90,56,34,43,41,98,54,21,-1,14,27,53,35,15,-1,29,14,45,19,6,0,12,24,25,22,7,0,8,18,12,14,4,0,4,6,13,8,3,0,203,107,96,57,31,26,22,36,73,26,22,19,14,17,39,18,9,9,8,19,34,8,13,10,12,11,13,13,6,2,6,3,8,10,2,2,6,8,5,3,4,0,72,53,19,16,15,1,0,15,42,5,14,2,3,10,26,4,8,4,-3,5,16,1,6,-2,0,6,3,3,2,1,2,1,4,4,1,2,-2,5,-1,-1,1,-1,156,72,84,49,21,28,29,27,33,35,19,10,17,12,18,13,8,4,12,15,15,22,11,6,4,13,9,12,7,4,2,8,4,2,3,2,2,5,5,10,4,2,106,55,51,20,15,5,28,2,31,37,13,-2,15,-1,14,24,8,-3,13,3,17,13,5,1,1,5,9,4,1,0,2,3,5,2,1,2,-1,2,4,2,0,-2,4,-12,16,-66,-29,-37,10,3,7,-11,0,-9,3,-5,8,-8,-5,-5,7,8,-1,-3,5,-4,3,-12,-12,-28,-11,-8,3,-7,-1,-15,-3,-6,0,-5,-11,-13,-8,-2,64,36,28,27,14,13,-1,0,10,15,25,12,1,4,-3,6,19,8,-2,-4,13,9,6,4,4,3,6,9,0,4,1,2,1,5,1,4,3,1,5,4,-1,0,90,35,55,1,-6,7,-2,10,15,42,27,0,-4,0,2,27,5,5,2,10,13,15,22,-5,4,2,-6,-3,7,-3,1,-1,-5,-4,5,-2,3,3,-1,1,2,-1,56,33,23,5,11,-6,16,10,32,11,-6,-3,5,4,18,13,-4,0,11,6,14,-2,-2,-3,5,4,8,-13,0,1,7,0,5,-4,2,1,-2,4,3,-9,-2,0,59,37,22,21,9,12,-5,-8,30,18,16,9,-5,-3,10,22,11,4,0,-5,20,-4,5,5,9,-3,7,0,1,5,5,1,1,-2,2,1,4,-4,6,2,-1,4,151,82,69,48,23,25,33,8,55,37,11,4,12,5,26,19,14,2,21,3,29,18,-3,2,12,7,9,8,10,2,4,1,7,5,5,1,8,6,2,3,5,1
7,07005,Andratx,8477,436,232,204,331,169,162,62,62,140,74,82,17,29,27,77,43,47,9,33,35,63,31,35,8,41,35,91,72,77,14,19,11,49,40,44,6,22,24,42,32,33,8,308,161,147,295,157,138,21,52,102,78,52,2,3,31,59,39,26,1,18,21,43,39,26,1,30,38,105,60,54,7,13,22,55,32,28,6,17,16,50,28,26,1,400,190,210,242,115,127,68,66,136,71,43,-3,24,33,66,38,20,2,44,33,70,33,23,-5,41,35,66,51,36,4,21,12,37,17,21,3,20,23,29,34,15,1,471,225,246,346,167,179,77,78,129,69,72,30,31,29,70,33,38,15,46,49,59,36,34,15,52,43,83,62,78,22,30,19,38,27,37,14,22,24,45,35,41,8,373,193,180,352,201,151,53,59,102,83,61,16,31,38,43,42,37,5,22,21,59,41,24,11,47,49,79,77,77,20,31,29,40,42,47,10,16,20,39,35,30,10,526,290,236,411,216,195,60,57,159,124,93,31,40,20,83,78,45,21,20,37,76,46,48,10,41,44,116,95,90,25,20,20,65,52,44,15,21,24,51,43,46,10,569,294,275,436,230,206,58,105,144,139,105,17,16,54,79,72,61,11,42,51,65,67,44,6,51,69,98,109,95,14,22,32,58,59,50,9,29,37,40,50,45,5,418,229,189,414,200,214,26,61,118,78,113,20,10,33,75,37,57,15,16,28,43,41,56,5,48,51,88,95,101,27,17,18,54,44,49,17,31,33,34,51,52,10,402,196,206,271,128,143,44,79,146,60,62,3,28,31,72,28,33,0,16,48,74,32,29,3,38,50,81,48,41,11,21,16,43,18,22,6,17,34,38,30,19,5,131,83,48,180,92,88,25,16,32,28,12,17,32,7,26,4,5,12,-7,9,6,24,7,5,30,25,30,55,24,16,16,12,12,30,12,11,14,13,18,25,12,5,166,79,87,117,54,63,15,28,55,25,41,-2,15,2,34,0,26,-1,0,26,21,25,15,-1,9,16,23,28,35,5,4,2,11,14,21,2,5,14,12,14,14,3,202,100,102,151,70,81,32,36,55,73,16,-13,16,16,30,38,5,-10,16,20,25,35,11,-3,23,16,33,42,33,0,10,5,15,23,17,-2,13,11,18,19,16,2,119,61,58,52,26,26,37,11,26,16,30,-6,17,-7,12,14,22,1,20,18,14,2,8,-7,13,15,0,0,21,-3,13,1,1,-2,13,-2,0,14,-1,2,8,-1,36,-2,38,-11,-14,3,-4,33,47,15,-28,-29,4,15,10,9,-24,-16,-8,18,37,6,-4,-13,2,18,17,5,-16,-37,5,7,0,6,-13,-19,-3,11,17,-1,-3,-18,-1288,-666,-622,-1281,-674,-607,-61,-49,-143,-257,-324,-456,-27,-17,-50,-156,-175,-242,-34,-32,-93,-101,-149,-214,-58,-44,-158,-238,-338,-448,-27,-22,-68,-137,-177,-244,-31,-22,-90,-101,-161,-204,203,110,93,127,64,63,16,42,69,55,17,6,1,12,44,43,8,6,15,30,25,12,9,0,18,20,35,29,13,9,6,6,21,19,8,3,12,14,14,10,5,6,209,87,122,128,54,74,29,65,95,1,18,1,15,28,41,-6,12,-6,14,37,54,7,6,7,23,31,30,15,17,9,8,11,16,4,10,2,15,20,14,11,7,7,176,100,76,185,92,93,13,56,33,37,21,20,15,30,23,11,13,9,-2,26,10,26,8,11,26,40,44,29,24,21,14,21,20,12,12,13,12,19,24,17,12,8
7,07008,Binissalem,5097,188,104,84,54,28,26,32,25,75,38,14,2,21,15,41,17,8,3,11,10,34,21,6,-1,8,8,24,10,3,1,6,3,9,7,2,1,2,5,15,3,1,0,133,81,52,9,5,4,21,5,71,19,9,3,15,3,39,12,10,-1,6,2,32,7,-1,4,2,0,1,6,0,0,1,0,0,4,0,0,1,0,1,2,0,0,148,78,70,29,13,16,27,26,57,21,11,9,9,10,36,15,7,2,18,16,21,6,4,7,6,8,4,6,5,0,4,4,1,2,2,0,2,4,3,4,3,0,204,136,68,87,50,37,31,50,61,38,15,9,24,22,46,25,12,7,7,28,15,13,3,2,14,19,21,18,11,4,7,9,12,12,8,2,7,10,9,6,3,2,221,158,63,72,42,30,33,32,90,29,21,12,27,24,62,19,16,7,6,8,28,10,5,5,11,17,15,22,3,2,5,9,10,13,4,0,6,8,5,9,-1,2,155,84,71,57,35,22,50,5,50,18,14,9,22,8,29,5,7,8,28,-3,21,13,7,1,16,8,17,11,3,0,8,6,10,6,3,1,8,2,7,5,0,-1,263,140,123,63,30,33,47,17,119,34,24,14,27,8,59,21,15,8,20,9,60,13,9,6,7,19,12,10,8,5,2,10,5,6,3,3,5,9,7,4,5,2,202,98,104,51,24,27,47,40,69,19,12,12,22,24,30,9,4,7,25,16,39,10,8,5,10,13,11,11,5,0,3,9,6,5,1,0,7,4,5,6,4,0,126,68,58,5,0,5,23,4,79,6,1,10,11,-1,49,2,-3,6,12,5,30,4,4,4,0,-4,4,4,0,0,2,-6,0,4,-1,1,-2,2,4,0,1,-1,132,76,56,19,10,9,32,18,41,26,6,6,22,11,16,20,6,0,10,7,25,6,0,6,2,0,5,8,2,1,1,2,0,5,2,0,1,-2,5,3,0,1,162,118,44,11,12,-1,29,18,75,26,14,0,21,12,45,20,16,3,8,6,30,6,-2,-3,-3,2,7,6,2,-2,-2,2,6,5,1,0,-1,0,1,1,1,-2,147,87,60,26,10,16,18,8,50,25,19,17,10,6,26,14,11,15,8,2,24,11,8,2,7,1,5,-1,10,4,0,-1,2,0,6,3,7,2,3,-1,4,1,111,84,27,20,12,8,13,9,27,5,35,13,13,13,23,4,23,7,0,-4,4,1,12,6,8,5,1,3,0,4,4,4,-1,3,1,2,4,1,2,0,-1,2,38,34,4,17,6,11,7,7,5,5,2,3,11,1,8,-2,4,3,-4,6,-3,7,-2,0,7,5,1,7,-5,0,4,1,-4,4,-1,0,3,4,5,3,-4,0,-5,7,-12,17,8,9,-15,3,6,15,-7,-8,-9,0,5,16,-2,-2,-6,3,1,-1,-5,-6,3,4,8,1,4,-3,1,2,5,1,2,-3,2,2,3,0,2,0,72,52,20,28,20,8,1,0,24,29,15,3,13,6,14,10,8,0,-12,-6,10,19,7,3,7,2,7,3,6,2,6,1,3,3,4,2,1,1,4,0,2,0,169,102,67,42,27,15,35,31,61,37,2,0,25,9,40,23,1,4,10,22,21,14,1,-4,6,9,10,11,5,1,5,3,7,7,3,2,1,6,3,4,2,-1,181,89,92,80,35,45,33,6,52,57,28,6,6,6,22,31,17,4,27,0,30,26,11,2,10,13,23,20,6,6,4,7,11,7,2,2,6,6,12,13,4,4
7,07009,Búger,938,31,21,10,11,7,4,4,12,6,4,2,3,4,8,3,2,3,1,0,4,3,2,-1,2,0,4,3,0,3,1,0,3,1,0,3,0,0,1,2,0,0,1,45,22,23,41,22,19,8,7,11,10,9,0,4,3,6,5,5,-1,4,4,5,5,4,1,7,5,12,9,7,1,4,3,7,4,3,1,3,2,5,5,4,0,4,13,-9,14,10,4,-4,1,0,4,7,0,5,0,4,0,5,0,-9,1,-4,4,2,0,1,3,2,5,3,0,1,2,3,2,2,0,0,1,-1,3,1,0,38,18,20,17,8,9,2,1,5,20,9,0,6,-3,2,9,4,0,-4,4,3,11,5,0,2,2,1,9,3,0,2,0,0,4,2,0,0,2,1,5,1,0,15,2,13,15,6,9,8,4,0,3,1,1,3,3,-2,0,0,0,5,1,2,3,1,1,6,0,9,1,-1,0,3,0,3,1,-1,0,3,0,6,0,0,0,45,22,23,11,4,7,10,8,14,3,3,4,8,2,3,2,2,3,2,6,11,1,1,1,1,5,1,1,2,1,0,1,0,0,3,0,1,4,1,1,-1,1,-4,-4,0,-1,-3,2,-5,-5,9,-11,8,-1,-6,-1,2,-1,3,-1,1,-4,7,-10,5,0,-1,-2,1,-4,4,1,-3,-1,0,-1,2,0,2,-1,1,-3,2,1,0,1,-1,15,10,5,-10,-3,-8,7,12,0,-1,-4,-4,2,5,1,-9,1,-4,5,7,-1,0,2,0,5,6,2,3,0,-1,3,3,2,-3,2,1,2,3,0,11,9,2,2,0,2,3,-2,0,6,0,3,0,1,3,3,-1,2,3,-3,-3,3,1,1,-3,1,-1,1,2,2,-3,0,0,0,1,2,0,1,-1,1,1,0,-4,-4,0,-9,-6,-3,8,-1,-3,-1,-2,-5,3,1,-4,2,-2,-4,5,-2,1,-3,0,-1,0,0,-3,-1,-3,-2,0,0,-3,1,-1,-3,0,0,0,-2,-2,1,6,0,6,-2,-1,-1,2,4,-7,5,1,0,2,1,-5,0,3,-1,0,3,-2,5,-2,1,0,1,-2,0,-1,0,0,0,-2,0,1,0,0,1,0,0,-2,0,-20,-17,-3,-5,0,-5,-1,-1,-10,3,-13,3,-5,-2,-6,3,-8,2,4,1,-4,0,-5,1,1,-3,-3,4,-6,2,1,-1,-1,2,-3,2,0,-2,-2,2,-3,0,22,14,8,4,3,1,0,7,4,3,7,-1,0,3,4,2,3,1,0,4,0,1,4,-2,0,0,1,1,1,0,0,0,1,1,1,0,0,0,0,0,0,0,-5,-9,4,-2,-3,1,-2,-1,2,-4,-1,-1,-3,-4,-2,1,-2,0,1,3,4,-5,1,-1,-2,-1,3,1,-2,-1,-1,-1,1,2,-3,-1,-1,0,2,-1,1,0,-3,8,-11,-15,-6,-9,-2,3,9,2,-4,-11,-1,6,8,2,-1,-6,-1,-3,1,0,-3,-5,1,0,-4,-1,-4,-7,2,0,-2,-1,0,-5,-1,0,-2,0,-4,-2,34,18,16,10,4,6,7,7,9,10,1,1,6,4,5,2,0,1,1,3,4,8,1,0,2,1,1,2,0,4,1,0,1,0,0,2,1,1,0,2,0,2,-4,-7,3,-14,-8,-6,2,3,4,1,-5,-8,2,2,-3,0,-3,-4,0,1,7,1,-2,-4,-2,2,0,-2,-3,-9,-1,1,-1,-1,-1,-5,-1,1,1,-1,-2,-4,8,11,-3,15,4,11,1,-4,1,17,0,-7,3,-4,4,14,-3,-3,-2,0,-3,3,3,-4,7,4,3,6,1,-6,5,2,0,2,-2,-3,2,2,3,4,3,-3
7,07010,Bunyola,4530,153,94,59,66,32,34,29,6,62,28,16,10,22,11,31,11,9,9,7,-5,31,17,7,1,13,6,22,14,6,4,8,2,11,7,1,3,5,4,11,7,5,1,179,108,71,53,27,26,37,9,59,38,18,17,23,10,30,26,11,7,14,-1,29,12,7,10,12,6,18,10,4,3,8,2,9,5,1,2,4,4,9,5,3,1,111,60,51,34,12,22,31,15,21,31,11,4,18,9,10,15,10,-1,13,6,11,16,1,5,6,7,12,6,3,0,0,1,8,2,1,0,6,6,4,4,2,0,87,52,35,52,34,18,27,7,14,19,12,8,24,1,9,10,5,2,3,6,5,9,7,6,10,6,12,10,10,3,9,2,8,7,5,2,1,4,4,3,5,1,127,62,65,78,40,38,38,2,25,32,22,8,19,1,10,20,8,3,19,1,15,12,14,5,13,12,17,21,8,6,10,2,10,11,3,3,3,10,7,10,5,3,58,41,17,67,35,32,14,-6,8,25,8,11,5,5,3,19,6,4,9,-11,5,6,2,7,15,1,16,23,7,4,7,0,8,14,4,2,8,1,8,9,3,2,210,103,107,88,41,47,68,23,62,44,10,2,32,14,36,16,4,1,36,9,26,28,6,1,18,13,26,16,13,0,6,5,13,9,7,0,12,8,13,7,6,0,52,34,18,67,31,36,33,-11,11,15,-1,6,15,-10,13,14,-5,6,18,-1,-2,1,4,0,23,7,22,15,-1,1,7,2,17,6,-2,1,16,5,5,9,1,0,136,74,62,62,33,29,17,23,37,30,18,8,12,12,23,12,8,4,5,11,14,18,10,4,17,17,5,15,7,1,9,11,3,6,3,1,8,6,2,9,4,0,85,52,33,16,10,6,23,16,26,6,2,9,20,8,20,3,2,-2,3,8,6,3,0,11,6,2,6,0,-1,3,2,4,6,-2,-1,1,4,-2,0,2,0,2,3,4,-1,-15,-14,-1,16,-6,16,-4,-16,2,11,-3,-2,7,-9,3,5,-3,18,-11,-7,-1,5,2,-1,-8,-10,-3,4,1,-7,-4,-6,-2,1,1,6,-4,-4,-1,41,20,21,22,14,8,16,19,-18,3,14,5,12,13,-11,-1,10,-1,4,6,-7,4,4,6,5,4,-3,6,4,6,4,2,-1,3,3,3,1,2,-2,3,1,3,68,36,32,14,2,12,12,2,35,20,-8,6,8,-3,17,10,0,2,4,5,18,10,-8,4,4,1,1,-3,1,9,1,-1,0,-3,1,3,3,2,1,0,0,6,63,15,48,19,1,18,6,-4,59,13,-2,-10,3,-3,11,13,1,-8,3,-1,48,0,-3,-2,-2,3,9,2,4,2,-3,1,1,1,1,0,1,2,8,1,3,2,64,31,33,16,4,12,19,7,15,25,-3,2,3,8,8,16,0,-4,16,-1,7,9,-3,6,3,5,0,1,2,4,2,1,-2,0,1,1,1,4,2,1,1,3,13,6,7,1,-6,7,15,5,10,14,-22,-8,7,-6,2,14,-12,2,8,11,8,0,-10,-10,5,7,2,-1,-9,-3,2,-2,-1,0,-4,-1,3,9,3,-1,-5,-2,32,7,25,32,14,18,13,2,21,3,7,-12,6,-1,11,2,-1,-9,7,3,10,1,8,-3,5,7,8,8,4,-1,3,2,4,3,2,-1,2,5,4,5,2,0,111,60,51,48,19,29,38,12,23,57,3,-22,14,5,16,32,0,-7,24,7,7,25,3,-15,12,9,10,14,4,-1,3,2,5,7,2,0,9,7,5,7,2,-1
7,07011,Calvià,35376,1235,714,521,682,356,326,116,370,399,168,86,80,74,209,239,110,40,26,42,161,160,58,46,54,133,103,187,133,98,25,74,57,91,66,53,13,59,46,96,67,45,12,1048,585,463,615,287,328,121,397,276,110,90,47,78,217,173,48,35,27,43,180,103,62,55,20,125,99,167,110,88,22,51,41,78,59,47,8,74,58,89,51,41,14,1308,703,605,1084,550,534,201,343,326,222,130,69,100,194,202,109,81,15,101,149,124,113,49,54,238,170,293,228,112,32,118,76,146,125,61,17,120,94,147,103,51,15,871,372,499,1443,689,754,132,186,126,132,193,100,64,75,59,33,97,46,68,111,67,99,96,54,268,200,347,292,239,82,129,83,163,136,131,40,139,117,184,156,108,42,488,226,262,1259,617,642,85,60,29,92,153,65,26,34,27,29,64,45,59,26,2,63,89,20,228,150,272,294,228,79,118,67,118,146,108,55,110,83,154,148,120,24,1444,667,777,1623,754,869,249,270,276,320,145,152,129,95,135,170,53,71,120,175,141,150,92,81,242,255,383,383,213,121,102,93,196,196,96,62,140,162,187,187,117,59,2156,1108,1048,1796,895,901,246,389,550,455,328,157,132,182,295,254,151,76,114,207,255,201,177,81,201,301,424,397,322,132,93,129,213,212,166,67,108,172,211,185,156,65,2431,1229,1202,2132,1066,1066,309,412,697,504,306,195,167,187,367,265,173,66,142,225,330,239,133,129,278,346,572,486,303,131,141,155,282,261,158,59,137,191,290,225,145,72,709,458,251,687,365,322,126,171,149,104,113,27,60,115,118,90,44,14,66,56,31,14,69,13,107,151,203,103,107,-3,41,82,113,61,44,12,66,69,90,42,63,-15,-191,-56,-135,-314,-175,-139,53,87,103,-145,-194,-120,51,54,122,-96,-131,-67,2,33,-19,-49,-63,-53,7,65,21,-148,-152,-124,26,20,22,-91,-96,-63,-19,45,-1,-57,-56,-61,816,373,443,651,298,353,240,207,142,186,43,-5,124,106,40,87,14,-2,116,101,102,99,29,-3,132,150,217,128,69,-60,64,64,87,66,34,-26,68,86,130,62,35,-34,-1380,-736,-644,-1169,-643,-526,-93,-55,-262,-374,-322,-307,-44,-21,-147,-219,-177,-152,-49,-34,-115,-155,-145,-155,-28,-44,-234,-290,-299,-296,-20,-34,-133,-166,-156,-144,-8,-10,-101,-124,-143,-152,1025,518,507,1070,532,538,150,238,262,209,80,59,88,98,142,104,33,34,62,140,120,105,47,25,166,188,271,230,142,56,94,74,133,116,69,36,72,114,138,114,73,20,-1799,-933,-866,-1762,-899,-863,-84,-77,-205,-467,-491,-498,-33,-49,-123,-212,-253,-272,-51,-28,-82,-255,-238,-226,-110,-82,-223,-465,-419,-482,-40,-52,-127,-230,-207,-253,-70,-30,-96,-235,-212,-229,549,240,309,766,378,388,98,158,201,139,-48,-28,40,83,99,76,-31,-39,58,75,102,63,-17,11,132,135,204,176,84,13,62,59,109,93,45,1,70,76,95,83,39,12,851,401,450,898,444,454,197,153,237,189,66,-3,93,39,99,105,61,-5,104,114,138,84,5,2,175,156,214,217,103,27,82,58,122,110,56,13,93,98,92,107,47,14,1229,680,549,1200,603,597,202,245,343,344,104,-25,103,110,188,226,48,-5,99,135,155,118,56,-20,236,190,282,285,156,38,124,85,127,148,81,29,112,105,155,137,75,9,-245,-138,-107,-287,-207,-80,118,110,129,-108,-233,-285,52,54,83,-53,-119,-162,66,56,46,-55,-114,-123,96,59,62,-152,-151,-221,46,25,23,-97,-83,-129,50,34,39,-55,-68,-92
7,07064,"Castell, Es",6260,234,118,116,122,55,67,-5,72,86,32,30,19,5,30,40,20,15,10,-10,42,46,12,15,9,19,16,35,22,21,8,8,7,13,11,11,5,11,9,22,11,10,3,141,68,73,42,23,19,-21,54,78,16,21,-6,-11,26,42,12,7,-4,-10,28,36,4,14,-2,3,6,17,10,5,0,2,2,11,6,2,0,1,4,6,4,3,0,115,63,52,135,54,81,-7,50,45,7,2,14,-18,29,41,7,-1,5,11,21,4,0,3,9,34,29,29,22,12,7,10,8,16,10,6,3,24,21,13,12,6,4,141,91,50,166,94,72,24,57,-27,49,37,10,25,31,-10,28,14,4,-1,26,-17,21,23,6,37,22,31,27,35,13,22,12,17,17,20,6,15,10,14,10,15,7,244,156,88,160,80,80,36,50,77,35,26,20,9,34,56,30,14,10,27,16,21,5,12,10,22,36,38,21,24,17,10,17,21,12,9,10,12,19,17,9,15,7,88,39,49,122,57,65,9,31,-15,30,28,7,21,14,-23,14,11,2,-12,17,8,16,17,5,23,24,28,25,16,6,12,7,15,14,6,3,11,17,13,11,10,3,130,66,64,197,108,89,5,49,33,-4,30,14,-8,34,24,-5,12,9,13,15,9,1,18,5,21,33,62,33,35,11,13,17,33,20,19,5,8,16,29,13,16,6,125,81,44,164,83,81,3,61,48,7,18,-9,4,34,36,4,4,-2,-1,27,12,3,14,-7,20,36,51,16,33,8,7,17,29,10,16,5,13,19,22,6,17,3,169,105,64,124,64,60,32,14,48,50,22,8,18,9,33,30,12,9,14,5,15,20,10,-1,19,21,36,18,19,9,9,11,17,13,9,5,10,10,19,5,10,4,21,25,-4,48,28,20,2,-1,-6,5,17,5,5,3,1,1,11,1,-3,-4,-7,4,6,4,6,12,5,6,13,5,5,8,4,3,7,0,1,4,1,3,6,5,35,-17,52,67,30,37,6,21,4,-15,18,-1,-6,11,-17,-4,-1,-2,12,10,21,-11,19,1,15,6,14,9,19,2,6,6,2,6,9,0,9,0,12,3,10,2,-44,-14,-30,44,25,19,-17,8,-16,-26,13,-4,-13,-5,7,-18,16,0,-4,13,-23,-8,-3,-4,3,5,6,6,19,5,2,0,7,3,10,3,1,5,-1,3,9,2,-73,-44,-29,13,11,2,-17,17,-40,-21,3,-9,-17,11,-26,-7,2,-4,0,6,-14,-14,1,-5,-2,6,-7,1,9,6,-4,2,-2,4,8,3,2,4,-5,-3,1,3,-77,-30,-47,-27,-19,-8,-10,-17,-16,-15,6,-24,1,7,-11,-15,2,-12,-11,-24,-5,0,4,-12,-3,-6,1,-11,6,-15,-1,-1,-2,-12,3,-7,-2,-5,3,1,3,-8,-51,-17,-34,-18,-12,-6,3,-2,-34,-18,16,-18,11,3,-7,-24,10,-8,-8,-5,-27,6,6,-10,-2,-1,-6,-13,0,4,-1,1,-4,-10,2,0,-1,-2,-2,-3,-2,4,-453,-276,-177,-407,-245,-162,-42,-29,-91,-82,-84,-127,-21,-26,-58,-50,-56,-67,-21,-3,-33,-32,-28,-60,-28,-16,-75,-92,-75,-122,-17,-15,-43,-56,-48,-66,-11,-1,-32,-36,-27,-56,12,-7,19,41,23,18,23,3,-13,16,-10,-10,8,-3,-2,-12,1,-3,15,6,-11,28,-11,-7,19,9,-4,11,5,-1,12,3,-3,2,6,1,7,6,-1,9,-1,-2,125,68,57,64,30,34,7,29,42,29,20,-2,-4,10,35,24,7,-3,11,19,7,5,13,1,5,8,21,8,16,5,3,3,10,5,7,2,2,5,11,3,9,3
7,07015,Ciutadella de Menorca,22341,431,250,181,22,11,11,53,115,149,65,28,14,22,68,97,35,17,8,31,47,52,30,11,6,3,5,6,1,2,2,1,1,4,1,2,1,2,4,2,0,0,1,835,433,402,372,203,169,76,273,291,124,61,8,33,146,152,66,28,7,43,127,139,58,33,1,64,86,137,55,19,10,37,48,77,26,9,5,27,38,60,29,10,5,859,412,447,405,190,215,112,232,296,112,67,33,44,98,174,53,24,19,68,134,122,59,43,14,88,76,120,59,39,20,39,31,65,28,15,12,49,45,55,31,24,8,708,321,387,405,189,216,101,238,172,92,79,19,38,113,94,29,30,10,63,125,78,63,49,9,86,90,83,65,61,16,39,44,37,28,28,10,47,46,46,37,33,6,514,289,225,326,149,177,42,170,177,70,52,-7,28,72,129,42,22,-7,14,98,48,28,30,0,53,85,95,51,26,12,29,34,46,22,9,7,24,51,49,29,17,5,541,229,312,368,180,188,69,154,161,99,45,11,36,53,67,51,17,4,33,101,94,48,28,7,78,84,81,65,43,12,44,39,36,34,17,6,34,45,45,31,26,6,498,251,247,350,161,189,58,160,126,73,61,11,29,78,68,44,27,4,29,82,58,29,34,7,41,90,96,64,46,8,21,41,44,28,20,4,20,49,52,36,26,4,566,305,261,421,211,210,36,176,188,68,60,24,18,80,118,37,40,8,18,96,70,31,20,16,73,102,150,54,34,0,32,46,84,27,15,1,41,56,66,27,19,-1,421,191,230,364,187,177,46,132,194,12,24,15,39,41,93,-2,15,5,7,91,101,14,9,10,60,91,125,50,27,10,32,47,68,19,16,5,28,44,57,31,11,5,146,63,83,189,86,103,37,80,-17,5,19,17,5,46,4,-6,-6,11,32,34,-21,11,25,6,45,51,48,24,20,0,19,27,19,10,9,1,26,24,29,14,11,-1,-247,-140,-107,-128,-84,-44,-7,34,-153,-98,-11,-17,2,2,-85,-56,-2,-6,-9,32,-68,-42,-9,-11,2,30,-84,-52,-17,-13,4,8,-44,-39,-9,-7,-2,22,-40,-13,-8,-6,274,112,162,221,105,116,40,102,80,50,1,-10,19,49,25,21,3,-12,21,53,55,29,-2,2,29,60,56,35,37,-1,17,22,27,15,22,0,12,38,29,20,15,-1,-171,-99,-72,-133,-56,-77,8,6,-106,-42,-28,-10,6,-13,-48,-16,-17,-12,2,19,-58,-26,-11,2,-9,-1,-65,-52,-4,-5,-4,-3,-27,-20,-4,-1,-5,2,-38,-32,0,-4,69,37,32,105,48,57,-8,69,34,-42,10,-1,-1,35,34,-42,6,2,-7,34,0,0,4,-3,8,40,15,8,24,2,6,19,4,3,12,1,2,21,11,5,12,1,-148,-94,-54,45,7,38,-22,7,-90,-47,-20,13,9,-16,-48,-31,-26,14,-31,23,-42,-16,6,-1,7,23,-6,-2,14,8,9,3,-9,-4,3,5,-2,20,3,2,11,3,-18,-27,9,124,62,62,-22,42,-37,-7,4,-2,-29,26,-25,-3,2,-4,7,16,-12,-4,2,2,7,40,18,23,26,6,1,19,9,11,13,5,6,21,9,12,13,1,218,84,134,148,53,95,7,87,61,19,29,10,2,45,32,-8,7,0,5,42,29,27,22,10,18,51,35,12,20,8,8,20,16,1,6,0,10,31,19,11,14,8,533,266,267,342,160,182,52,126,153,89,77,23,34,42,70,46,51,17,18,84,83,43,26,6,34,70,72,67,63,27,21,31,27,31,32,14,13,39,45,36,31,13
7,07017,Costitx,876,40,23,17,22,15,7,6,4,12,14,7,-3,2,3,8,5,6,-1,4,1,4,9,1,-2,3,4,7,4,4,0,2,3,4,3,3,0,1,1,3,1,1,0,32,11,21,18,5,13,8,0,10,7,9,-2,2,-3,6,3,4,-1,6,3,4,4,5,-1,8,2,2,4,2,0,2,0,1,1,1,0,6,2,1,3,1,0,9,6,3,-6,-5,-1,4,-5,1,4,6,-2,5,-3,-1,4,2,-1,-1,-2,2,0,4,-1,1,0,0,-4,0,-3,1,-1,0,-2,-1,-2,0,1,0,-2,1,-1,29,11,18,8,3,5,-5,7,14,14,-2,1,-2,0,9,7,-3,0,-3,7,5,7,1,1,1,1,2,2,1,1,1,0,1,0,1,0,0,1,1,2,0,1,6,11,-5,9,3,6,-1,-5,7,8,-4,2,1,-2,8,6,-3,2,-2,-3,-1,2,-1,0,0,1,2,3,3,0,0,0,1,1,1,0,0,1,1,2,2,0,-19,-13,-6,-14,-7,-7,-4,-1,-5,-4,-5,-1,-7,0,-4,1,-2,-2,3,-1,-1,-5,-3,1,-1,0,-3,-3,-4,-3,-1,1,-2,0,-3,-2,0,-1,-1,-3,-1,-1,-11,5,-16,-10,-1,-9,3,-9,-2,1,2,-4,6,-4,0,1,2,0,-3,-5,-2,0,0,-4,-2,-3,-2,-1,-2,0,1,-1,0,0,-1,0,-3,-2,-2,-1,-1,0,50,25,25,14,9,5,9,9,0,23,12,-4,5,5,0,11,4,0,4,4,0,12,8,-4,1,-1,1,7,5,1,0,1,0,5,2,1,1,-2,1,2,3,0,61,37,24,24,12,12,13,10,15,16,3,2,8,8,8,7,3,3,5,2,7,9,0,-1,6,6,1,7,2,2,3,3,1,3,2,0,3,3,0,4,0,2,46,27,19,0,0,0,11,1,15,10,8,-1,5,3,5,5,7,0,6,-2,10,5,1,-1,0,3,2,1,-4,-2,1,1,1,2,-4,-1,-1,2,1,-1,0,-1,21,4,17,8,3,5,1,1,13,2,1,0,-2,2,9,-1,-1,-1,3,-1,4,3,2,1,1,0,2,1,2,0,1,0,1,0,1,0,0,0,1,1,1,0,22,12,10,6,0,6,-4,9,-4,10,13,1,1,8,-3,1,6,2,-5,1,-1,9,7,-1,0,1,-1,1,3,2,-1,1,-1,0,0,1,1,0,0,1,3,1,43,12,31,15,4,11,8,-1,5,15,9,3,1,-2,-1,9,2,1,7,1,6,6,7,2,1,0,2,2,7,2,1,0,0,1,2,0,0,0,2,1,5,2,24,4,20,7,2,5,15,-1,12,-4,6,-3,2,0,5,-5,3,-1,13,-1,7,1,3,-2,2,2,1,1,1,0,0,0,1,0,1,0,2,2,0,1,0,0,31,14,17,15,6,9,9,8,5,-1,4,6,4,3,3,0,2,3,5,5,2,-1,2,3,5,1,3,3,1,2,2,1,0,2,0,1,3,0,3,1,1,1,29,20,9,-25,-16,-9,22,2,15,8,-18,-3,11,1,8,10,-9,-3,11,1,7,-2,-9,0,4,-1,1,-13,-12,-4,2,-1,-1,-9,-5,-2,2,0,2,-4,-7,-2,-3,2,-5,-14,-7,-7,6,-7,0,0,-1,-2,7,0,-1,-2,0,-4,-1,-7,1,2,-1,2,7,-4,-1,-3,-6,-6,5,-2,0,-3,-1,-6,2,-2,-1,0,-5,0,38,8,30,15,8,7,5,-2,12,9,8,2,-1,-4,3,2,4,1,6,2,9,7,4,1,3,2,0,4,6,0,2,1,0,1,4,0,1,1,0,3,2,0
7,07018,Deyá,644,41,22,19,28,12,16,3,5,7,17,5,3,2,4,5,7,3,1,1,1,2,10,2,2,3,2,6,7,8,2,1,1,3,2,4,1,2,1,3,5,4,1,31,20,11,26,13,13,1,7,7,4,9,2,1,5,4,3,5,2,0,2,3,1,4,0,4,2,6,4,7,2,1,1,4,2,4,1,3,1,2,2,3,1,26,14,12,30,15,15,-6,12,6,10,0,1,-3,9,4,2,2,0,-3,3,2,8,-2,1,2,4,8,10,5,1,2,1,5,4,3,0,0,3,3,6,2,1,19,6,13,25,15,10,-3,11,6,3,5,-1,-4,3,2,5,2,0,1,8,4,-2,3,-1,2,6,5,4,6,2,2,3,2,3,3,2,0,3,3,1,3,0,17,17,0,28,15,13,0,8,-3,3,6,3,4,3,-1,5,2,4,-4,5,-2,-2,4,-1,3,2,7,7,6,3,1,0,2,5,4,3,2,2,5,2,2,0,14,15,-1,22,14,8,2,5,2,5,5,-4,2,5,5,1,5,-3,0,0,-3,4,0,-1,4,6,4,2,4,2,1,3,4,1,4,1,3,3,0,1,0,1,14,12,2,25,13,12,-7,7,0,5,8,3,-2,6,2,-1,6,1,-5,1,-2,6,2,2,2,5,5,3,6,3,1,2,1,1,5,2,1,3,4,2,1,1,23,5,18,37,17,20,5,9,5,0,4,-1,3,4,-1,-1,0,0,2,5,6,1,4,-1,8,8,5,7,8,1,5,3,3,2,3,1,3,5,2,5,5,0,15,6,9,11,6,5,0,5,6,0,1,3,0,0,4,0,1,1,0,5,2,0,0,2,-1,5,5,3,1,-2,-1,0,3,2,2,0,0,5,2,1,-1,-2,9,9,0,26,15,11,4,1,-2,0,6,0,1,0,4,3,0,1,3,1,-6,-3,6,-1,5,2,2,10,6,1,2,1,3,6,2,1,3,1,-1,4,4,0,20,9,11,23,11,12,0,6,1,7,7,-3,-2,3,0,3,5,-2,2,3,1,4,2,-1,4,4,2,4,8,1,2,2,1,1,4,1,2,2,1,3,4,0,-18,-7,-11,-3,-1,-2,-4,-2,-1,-8,2,-4,-6,-1,3,-6,3,0,2,-1,-4,-2,-1,-4,-3,4,-3,-3,2,0,-3,2,-1,-1,2,0,0,2,-2,-2,0,0,7,-1,8,10,5,5,-5,9,10,-1,-4,-2,-3,6,2,0,-6,0,-2,3,8,-1,2,-2,-4,4,6,0,2,2,-1,2,2,1,0,1,-3,2,4,-1,2,1,26,13,13,11,4,7,5,7,10,2,0,1,1,5,5,0,1,0,4,2,5,2,-1,1,3,1,6,2,-1,0,1,1,2,1,-1,0,2,0,4,1,0,0,7,2,5,15,8,7,3,2,-4,12,-3,-3,0,1,-2,7,-1,-3,3,1,-2,5,-2,0,3,3,1,8,0,0,1,2,1,4,0,0,2,1,0,4,0,0,4,-2,6,27,15,12,-3,3,1,-5,7,0,1,0,2,-7,2,0,-4,3,-1,2,5,0,5,1,5,7,7,1,5,1,3,3,2,1,0,0,2,4,5,0,0,0,0,17,5,12,-5,2,4,-2,0,0,-1,0,2,-1,1,-2,-4,2,2,-1,-1,2,2,2,7,0,4,1,0,0,2,1,1,0,2,2,5,-1,3,1,24,7,17,31,10,21,8,4,2,6,5,-2,3,2,0,2,2,-2,5,2,2,4,3,0,2,4,6,8,10,0,0,2,1,3,4,0,2,2,5,5,6,0
7,07026,Eivissa,32700,442,277,165,5,2,3,12,193,232,17,-12,-5,8,99,159,8,-2,-2,4,94,73,9,-10,-3,0,0,4,0,1,0,0,0,1,0,1,0,0,0,3,0,0,0,559,305,254,3,1,2,28,230,277,25,-12,8,10,111,166,34,-18,0,18,119,111,-9,6,8,0,0,2,1,0,0,0,0,1,0,0,0,0,0,1,1,0,0,1363,705,658,460,247,213,37,396,670,174,58,45,31,196,360,87,30,9,6,200,310,87,28,36,67,111,159,72,42,6,40,50,100,37,18,1,27,61,59,35,24,5,721,395,326,857,455,402,7,367,237,98,33,9,8,176,145,56,21,0,-1,191,92,42,12,9,154,226,279,133,48,10,81,107,151,80,28,4,73,119,128,53,20,6,1292,747,545,1285,734,551,-47,542,552,146,102,21,-16,292,333,98,45,9,-31,250,219,48,57,12,109,347,471,215,118,20,58,190,275,141,57,8,51,157,196,74,61,12,654,370,284,1153,586,567,-11,326,169,125,54,27,-4,144,132,91,23,2,-7,182,37,34,31,25,140,297,390,205,86,29,70,131,213,117,41,11,70,166,177,88,45,18,1402,897,505,1532,874,658,-7,633,490,238,48,19,-27,358,385,144,28,16,20,275,105,94,20,3,144,474,507,291,93,16,67,254,300,193,49,7,77,220,207,98,44,9,1074,693,381,1430,828,602,-31,692,319,118,-9,-5,-17,370,258,88,-8,0,-14,322,61,30,-1,-5,116,555,463,222,60,4,57,320,287,130,28,2,59,235,176,92,32,2,-6,-70,64,191,26,165,-99,461,-80,-158,-55,-49,-40,208,-13,-140,-41,-24,-59,253,-67,-18,-14,-25,56,253,33,-86,-36,-37,34,94,5,-72,-24,-14,22,159,28,-14,-12,-23,-34,-105,71,81,-31,112,-120,304,-32,-133,-42,-2,-78,143,-33,-95,-28,-6,-42,161,1,-38,-14,4,5,148,-28,-30,-17,-4,-3,60,-40,-35,-16,-3,8,88,12,5,-1,-1,-184,-151,-33,-100,-114,14,-93,200,-44,-141,-85,-7,-21,70,-32,-81,-74,-11,-72,130,-12,-60,-11,4,-18,53,-73,-51,-20,1,1,4,-53,-43,-29,2,-19,49,-20,-8,9,-1,303,162,141,69,-56,125,15,285,164,-97,-53,-2,10,147,101,-63,-32,4,5,138,63,-34,-21,-6,32,131,-27,-59,-13,-6,20,40,-41,-61,-19,0,12,91,14,2,6,-6,591,140,451,196,2,194,42,351,294,-31,-49,4,10,158,111,-70,-46,-11,32,193,183,39,-3,15,10,109,87,-6,-10,-5,-11,50,7,-29,-17,-3,21,59,80,23,7,-2,107,38,69,-261,-177,-84,-42,178,111,-32,-110,6,-49,91,65,-13,-59,11,7,87,46,-19,-51,-5,-16,11,-140,-73,-45,-3,-16,6,-95,-58,-17,2,0,5,-45,-15,-28,-5,-475,-380,-95,-752,-506,-246,-90,186,141,-301,-257,-154,-30,52,34,-208,-145,-87,-60,134,107,-93,-112,-67,-34,45,-166,-315,-191,-103,-24,11,-125,-201,-119,-53,-10,34,-41,-114,-72,-50,-638,-376,-262,-435,-295,-140,-97,172,-63,-336,-181,-119,-29,62,1,-194,-137,-67,-68,110,-64,-142,-44,-52,26,68,-98,-252,-129,-56,28,26,-50,-170,-98,-33,-2,42,-48,-82,-31,-23,14,-23,37,183,35,148,-5,176,229,-198,-113,-77,-22,93,143,-130,-68,-41,17,83,86,-68,-45,-36,48,141,104,-66,-30,-31,20,73,49,-62,-33,-20,28,68,55,-4,3,-11,28,-24,52,487,222,265,-31,272,79,-147,-111,-27,-27,126,78,-88,-91,-23,-4,146,1,-59,-20,-4,96,187,165,-1,1,21,58,86,82,-5,-17,9,38,101,83,4,18,12
7,07022,Felanitx,14900,409,272,137,230,138,92,73,97,104,80,36,9,46,69,71,59,20,2,27,28,33,21,16,7,40,35,61,54,28,7,21,19,41,33,17,3,19,16,20,21,11,4,466,246,220,298,175,123,88,102,130,79,47,19,35,55,75,44,23,12,53,47,55,35,24,7,45,57,79,58,43,13,23,33,49,33,25,10,22,24,30,25,18,3,367,224,143,331,190,141,44,111,128,41,32,12,22,72,80,26,15,9,22,39,48,15,17,3,44,83,108,47,34,15,28,43,70,25,14,10,16,40,38,22,20,5,246,162,84,341,209,132,40,56,57,50,24,17,28,30,44,33,12,12,12,26,13,17,12,5,77,71,76,60,43,12,47,37,46,42,26,10,30,34,30,18,17,2,308,194,114,376,212,164,48,70,64,65,39,22,32,33,44,43,25,14,16,37,20,22,14,8,65,71,107,68,47,16,38,33,65,39,27,9,27,38,42,29,20,7,487,298,189,451,257,194,89,103,144,69,60,10,62,69,90,31,31,8,27,34,54,38,29,2,98,95,125,70,46,12,57,57,74,37,24,6,41,38,51,33,22,6,520,290,230,453,237,216,106,117,116,94,61,26,56,64,74,47,39,11,50,53,42,47,22,15,87,109,101,76,52,24,50,56,48,36,31,13,37,53,53,40,21,11,565,341,224,465,250,215,61,137,156,81,51,77,40,86,104,53,36,17,21,51,52,28,15,60,64,131,120,83,47,16,33,67,61,46,28,12,31,64,59,37,19,4,381,212,169,363,192,171,87,76,83,81,36,22,49,50,58,40,11,8,38,26,25,41,25,14,89,85,88,70,23,5,50,42,47,42,7,2,39,43,41,28,16,3,156,51,105,220,102,118,30,35,47,-9,8,49,21,6,11,6,-8,17,9,29,36,-15,16,32,35,55,55,39,26,6,16,16,29,24,11,4,19,39,26,15,15,2,-5,-39,34,53,21,32,-9,11,-38,-7,-9,40,0,-5,-27,-21,-3,12,-9,16,-11,14,-6,28,-4,18,3,10,9,16,-1,3,3,2,5,8,-3,15,0,8,4,8,-375,-278,-97,-251,-194,-57,-15,-19,-192,-110,-35,-2,-17,-15,-126,-92,-20,-5,2,-4,-66,-18,-15,3,5,-6,-136,-80,-21,-12,-8,-16,-91,-63,-10,-5,13,10,-45,-17,-11,-7,23,12,11,123,73,50,8,19,11,-13,4,1,4,5,8,0,1,-1,4,14,3,-13,3,2,36,28,33,18,8,0,22,11,24,9,7,1,14,17,9,9,1,-1,41,-6,47,34,-13,47,-9,16,1,11,10,4,-18,11,-5,-8,8,0,9,5,6,19,2,4,0,26,3,0,9,-7,-6,9,-4,-15,5,-4,6,17,7,15,4,-3,61,18,43,77,37,40,53,-2,31,0,-5,-17,25,-7,10,-1,-8,-6,28,5,21,1,3,-11,35,16,20,19,-1,-12,21,8,1,10,-2,-3,14,8,19,9,1,-9,-126,-60,-66,-1,-19,18,-6,-11,-32,-40,-18,-14,9,-3,-20,-35,-8,1,-15,-8,-12,-5,-10,-15,10,8,1,2,-10,-12,1,1,-5,-5,-9,-3,9,7,6,7,-1,-9,-97,-31,-66,-10,-7,-3,-3,22,2,-21,-41,-54,1,11,12,-7,-20,-29,-4,11,-10,-14,-21,-25,23,34,33,-24,-24,-54,11,11,26,-10,-16,-30,12,23,7,-14,-8,-24,79,35,44,-4,-9,5,17,24,59,-4,8,-28,21,7,29,0,-4,-19,-4,17,30,-4,12,-9,11,6,18,-2,-14,-26,9,-3,17,-3,-11,-18,2,9,1,1,-3,-8
7,07023,Ferreries,3981,73,42,31,12,4,8,17,25,14,12,0,1,12,11,8,9,0,1,5,14,6,3,0,0,1,3,4,4,0,0,1,0,0,3,0,0,0,3,4,1,0,0,99,60,39,29,18,11,12,28,39,17,2,0,11,14,20,13,1,1,1,14,19,4,1,-1,7,4,9,9,0,0,6,1,4,7,0,0,1,3,5,2,0,0,30,-1,31,16,5,11,1,20,11,-3,-4,3,-2,7,-2,-5,-1,0,3,13,13,2,-3,3,3,5,3,4,2,-1,0,1,1,2,1,0,3,4,2,2,1,-1,27,12,15,29,17,12,3,23,-8,-1,4,6,3,11,-9,-1,3,4,0,12,1,0,1,2,5,5,10,3,4,2,4,4,3,2,3,1,1,1,7,1,1,1,37,16,21,38,20,18,2,24,-3,-3,7,7,1,13,-4,0,4,2,1,11,1,-3,3,5,4,16,10,1,4,1,1,10,6,0,3,0,3,6,4,1,1,1,70,39,31,49,21,28,9,29,14,12,9,-2,5,17,9,6,5,-2,4,12,5,6,4,0,12,14,11,7,4,0,4,6,3,5,3,0,8,8,8,2,1,0,55,43,12,62,34,28,9,18,5,10,10,4,3,6,12,12,8,2,6,12,-7,-2,2,2,7,16,25,7,5,1,4,5,13,6,4,1,3,11,12,1,1,0,45,14,31,39,21,18,27,13,-2,11,-4,1,12,7,-2,1,-2,0,15,6,0,10,-2,1,20,4,9,7,-2,1,12,1,7,2,-2,1,8,3,2,5,0,0,43,3,40,24,10,14,8,19,11,4,0,1,-1,7,4,-1,-3,-1,9,12,7,5,3,2,7,6,8,1,2,0,5,2,3,0,0,0,2,4,5,1,2,0,2,-14,16,-6,-8,2,9,2,-5,-6,3,-3,5,-3,-9,-9,4,-2,4,5,4,3,-1,-1,1,1,-2,-8,1,1,1,-2,-3,-3,-1,0,0,3,1,-5,2,1,-25,-15,-10,-22,-14,-8,-14,2,-3,-5,-8,-3,-5,4,-3,-4,-7,-2,-9,-2,0,-1,-1,-1,-9,0,-7,1,-4,-2,-3,0,-6,-1,-4,0,-6,0,-1,2,0,-2,-54,-30,-24,-1,-4,3,-11,2,-17,-30,-4,3,-5,-4,-10,-20,4,3,-6,6,-7,-10,-8,0,-3,6,-1,-1,-2,0,0,0,-2,0,-2,0,-3,6,1,-1,0,0,-84,-52,-32,-37,-17,-20,-6,2,-29,-20,-26,-6,1,1,-16,-14,-20,-4,-7,1,-13,-6,-6,-2,-8,-2,-18,-5,-3,-1,-2,-2,-8,-4,0,-1,-6,0,-10,-1,-3,0,48,13,35,14,3,11,7,9,11,13,4,5,0,-4,4,5,3,4,7,13,7,8,1,1,3,2,2,3,3,1,1,0,-1,2,0,1,2,2,3,1,3,0,-42,-27,-15,2,0,2,-6,2,-15,-12,-7,-3,-2,0,-10,-10,-3,-3,-4,2,-5,-2,-4,0,0,2,1,-1,-1,1,0,-1,2,-1,-1,1,0,3,-1,0,0,0,44,20,24,15,4,11,6,1,10,17,9,2,0,-2,4,11,7,1,6,3,6,6,2,1,4,-1,7,0,4,1,1,-2,3,0,1,1,3,1,4,0,3,0,19,-2,21,20,6,14,7,20,1,-15,7,-5,-1,7,-1,-8,1,-2,8,13,2,-7,6,-3,6,2,3,3,6,0,3,1,1,0,1,0,3,1,2,3,5,0,50,22,28,27,11,16,-2,24,14,7,0,5,1,14,5,2,-2,0,-3,10,9,5,2,5,6,1,9,2,2,6,1,0,4,1,1,3,5,1,5,1,1,3
7,07024,Formentera,5999,497,253,244,259,127,132,21,115,172,85,80,19,8,55,93,40,42,11,13,60,79,45,38,8,17,37,71,51,71,12,4,16,35,27,37,8,13,21,36,24,34,4,536,283,253,346,186,160,37,119,176,101,77,17,19,61,92,53,43,8,18,58,84,48,34,9,34,63,107,68,60,11,16,35,61,36,30,5,18,28,46,32,30,6,252,147,105,202,108,94,22,83,67,33,42,0,14,43,40,31,18,-2,8,40,27,2,24,2,27,41,42,37,43,5,13,18,25,24,22,2,14,23,17,13,21,3,219,133,86,138,89,49,20,71,88,46,-2,0,20,39,57,19,1,-1,0,32,31,27,-3,1,22,34,45,26,5,6,15,21,34,15,2,2,7,13,11,11,3,4,314,203,111,185,109,76,40,76,99,71,17,8,20,49,62,51,17,4,20,27,37,20,0,4,37,36,53,41,12,4,21,18,27,30,9,2,16,18,26,11,3,2,354,207,147,228,115,113,44,87,106,71,32,7,26,49,71,35,16,6,18,38,35,36,16,1,37,52,55,49,23,11,19,25,30,24,10,7,18,27,25,25,13,4,522,295,227,309,164,145,24,138,156,104,61,38,21,72,87,62,33,21,3,66,69,42,28,17,22,64,77,66,47,32,16,29,41,37,23,18,6,35,36,29,24,14,598,344,254,463,270,193,37,177,189,77,77,36,13,90,120,51,44,20,24,87,69,26,33,16,41,125,135,65,56,35,21,68,84,42,31,20,20,57,51,23,25,15,464,273,191,214,121,93,53,107,155,76,54,15,25,58,92,57,31,10,28,49,63,19,23,5,30,51,60,34,26,12,19,30,32,21,12,6,11,21,28,13,14,6,327,197,130,100,45,55,8,125,104,51,29,7,7,58,86,26,13,7,1,67,18,25,16,0,13,36,21,13,2,12,6,14,14,0,1,7,7,22,7,13,1,5,473,285,188,140,76,64,37,82,197,92,52,9,26,49,106,62,36,4,11,33,91,30,16,5,20,15,28,33,25,17,16,1,16,18,16,8,4,14,12,15,9,9,367,185,182,119,44,75,37,102,135,67,4,10,19,44,73,33,-2,9,18,58,62,34,6,1,16,26,40,12,9,9,9,11,8,4,1,7,7,15,32,8,8,2,809,450,359,496,270,226,58,123,212,229,123,49,28,47,128,155,57,28,30,76,84,74,66,21,28,57,118,133,111,41,14,21,73,84,54,21,14,36,45,49,57,20,392,271,121,114,55,59,11,104,153,100,6,9,19,57,105,70,13,0,-8,47,48,30,-7,9,7,30,34,13,19,9,12,9,18,0,15,1,-5,21,16,13,4,8,291,183,108,2,-4,6,8,89,149,53,15,-28,6,34,98,51,8,-12,2,55,51,2,7,-16,-4,20,8,-3,-13,-11,0,4,2,-1,-6,-4,-4,16,6,-2,-7,-7,277,194,83,259,168,91,-3,91,119,28,30,8,10,58,74,20,28,2,-13,33,45,8,2,6,14,42,86,56,36,21,9,28,55,39,23,12,5,14,31,17,13,9,307,160,147,219,97,122,10,99,124,48,10,13,-5,56,73,23,4,8,15,43,51,25,6,5,20,50,63,56,17,9,7,23,27,26,5,6,13,27,36,30,12,3,307,189,118,273,154,119,-6,119,134,68,3,-13,7,54,93,38,1,-7,-13,65,41,30,2,-6,25,53,98,61,25,6,20,30,47,37,13,3,5,23,51,24,12,3
7,07027,Inca,21974,699,424,275,4,2,2,195,131,216,112,35,-3,108,71,141,70,22,1,87,60,75,42,13,-4,0,0,3,0,1,0,0,0,2,0,0,0,0,0,1,0,1,0,287,160,127,8,5,3,44,51,116,41,23,4,38,19,65,31,2,1,6,32,51,10,21,3,3,1,0,3,1,0,1,1,0,2,1,0,2,0,0,1,0,0,260,122,138,12,2,10,68,56,64,49,3,0,18,28,42,22,-4,5,50,28,22,27,7,-5,8,-1,-2,3,3,1,3,-1,-2,1,0,1,5,0,0,2,3,0,269,148,121,58,29,29,-1,81,131,34,5,18,18,51,64,10,-2,8,-19,30,67,24,7,10,12,18,25,6,-1,-2,6,12,10,4,-2,-1,6,6,15,2,1,-1,457,263,194,413,240,173,98,76,197,35,37,3,57,28,138,16,22,-5,41,48,59,19,15,8,88,96,131,63,27,6,53,52,82,38,13,0,35,44,49,25,14,6,748,345,403,498,272,226,118,202,295,49,56,17,74,84,147,13,19,5,44,118,148,36,37,12,100,122,156,63,33,14,61,62,88,37,15,4,39,60,68,26,18,10,955,505,450,529,276,253,176,222,353,105,54,30,103,102,212,51,13,13,73,120,141,54,41,17,106,135,158,70,47,11,56,68,93,34,21,3,50,67,65,36,26,8,1147,706,441,692,397,295,183,302,454,141,36,29,108,163,313,96,21,10,75,139,141,45,15,19,125,197,228,100,27,8,63,114,133,63,17,5,62,83,95,37,10,3,630,313,317,607,334,273,104,194,228,59,12,13,58,99,140,19,-3,-6,46,95,88,40,15,19,133,165,186,84,19,12,69,82,126,43,5,6,64,83,60,41,14,6,253,32,221,359,184,175,39,78,73,-2,13,35,-4,-5,7,3,5,14,43,83,66,-5,8,21,64,104,107,50,19,5,32,42,68,27,5,4,32,62,39,23,14,1,95,28,67,124,50,74,-34,44,27,-10,32,33,-10,23,5,-19,16,8,-24,21,22,9,16,25,9,35,48,15,7,4,4,16,22,7,-2,0,5,19,26,8,9,4,25,-5,30,180,65,115,-10,18,47,-60,12,14,0,2,39,-45,-5,7,-10,16,8,-15,17,7,35,54,47,29,8,7,11,19,25,7,2,1,24,35,22,22,6,6,189,78,111,48,10,38,50,20,40,18,27,37,31,-7,36,3,-1,14,19,27,4,15,28,23,7,17,7,4,5,3,8,0,0,-6,2,3,-1,17,7,10,3,0,-1348,-753,-595,-1241,-708,-533,-239,-149,-411,-329,-177,-45,-129,-84,-217,-215,-89,-15,-110,-65,-194,-114,-88,-30,-216,-123,-367,-300,-165,-74,-119,-76,-214,-185,-86,-29,-97,-47,-153,-115,-79,-45,-93,-94,1,-144,-74,-70,2,-11,-43,-60,15,-5,-5,1,-44,-40,-7,-1,7,-12,1,-20,22,-4,-40,7,-44,-52,-9,-8,-17,10,-26,-33,-9,0,-23,-3,-18,-19,0,-8,90,18,72,-73,-51,-22,-21,-5,88,-18,12,26,-4,-8,38,-20,1,3,-17,3,50,2,11,23,-46,17,5,-36,-12,-10,-13,1,-2,-28,-8,-7,-33,16,7,-8,-4,-3,298,180,118,-72,-68,-4,-26,116,93,95,10,16,-1,59,60,46,14,5,-25,57,33,49,-4,11,-44,42,11,-40,-27,-13,-27,19,8,-35,-23,-9,-17,23,3,-5,-4,-4,770,388,382,313,184,129,94,141,216,160,86,64,30,76,122,92,36,25,64,65,94,68,50,39,35,71,104,54,31,16,10,44,69,34,14,11,25,27,35,20,17,5
7,07031,Llucmajor,22811,1081,573,508,508,258,250,140,178,330,218,159,49,42,84,212,123,83,27,98,94,118,95,76,22,84,63,125,109,101,25,39,26,66,54,56,17,45,37,59,55,45,8,1404,761,643,606,346,260,202,326,487,228,117,28,103,169,293,106,67,11,99,157,194,122,50,17,74,129,174,117,93,17,34,73,113,56,57,11,40,56,61,61,36,6,1191,605,586,681,358,323,175,204,386,212,146,41,87,95,214,112,68,24,88,109,172,100,78,17,112,111,206,112,113,21,54,50,118,58,61,13,58,61,88,54,52,8,1261,729,532,683,371,312,185,136,437,204,195,76,136,75,243,115,110,41,49,61,194,89,85,35,117,79,188,120,141,33,75,39,94,64,74,22,42,40,94,56,67,11,1024,517,507,538,260,278,62,171,387,208,135,47,45,80,190,108,74,11,17,91,197,100,61,36,87,97,138,103,76,31,42,36,68,61,37,13,45,61,70,42,39,18,1432,724,708,632,321,311,159,249,540,230,145,70,77,92,284,148,70,28,82,157,256,82,75,42,73,131,180,126,88,26,38,51,90,78,45,15,35,80,90,48,43,11,1711,854,857,680,362,318,169,299,607,305,224,80,96,125,306,175,103,41,73,174,301,130,121,39,89,132,150,148,118,38,46,66,84,81,61,21,43,66,66,67,57,17,1664,902,762,831,425,406,161,250,633,350,172,71,77,120,370,226,84,15,84,130,263,124,88,56,88,162,237,157,126,54,37,70,130,97,66,22,51,92,107,60,60,32,881,436,445,531,285,246,25,235,371,123,71,34,5,93,205,80,34,4,20,142,166,43,37,30,83,135,172,87,41,5,48,73,96,47,20,-2,35,62,76,40,21,7,258,141,117,94,47,47,-25,126,86,41,15,1,-7,73,63,-7,17,-2,-18,53,23,48,-2,3,23,62,32,-3,-15,-12,12,28,21,-7,-5,-4,11,34,11,4,-10,-8,145,12,133,138,54,84,20,44,122,-33,-8,-18,1,10,51,-21,-22,-17,19,34,71,-12,14,-1,39,34,42,15,6,-3,20,9,17,7,3,-5,19,25,25,8,3,2,-127,-64,-63,3,4,-1,-17,4,-43,-29,-45,-17,-19,10,-19,-8,-30,-6,2,-6,-24,-21,-15,-11,2,31,-22,17,-10,-19,0,17,-23,14,-1,-5,2,14,1,3,-9,-14,252,127,125,247,119,128,4,104,138,42,-13,-21,5,44,73,24,-11,-10,-1,60,65,18,-2,-11,51,50,77,41,17,7,27,19,39,26,5,0,24,31,38,15,12,7,-287,-165,-122,46,0,46,-91,-10,-95,-70,-24,0,-64,3,-43,-52,-14,2,-27,-13,-52,-18,-10,-2,-8,26,6,9,4,3,-17,8,0,3,2,0,9,18,6,6,2,3,0,20,-20,-16,-20,4,-54,67,38,-46,17,-28,-12,38,4,-12,7,-15,-42,29,34,-34,10,-13,-7,44,6,-35,-15,-12,3,22,-1,-25,-14,-8,-10,22,7,-10,-1,-4,444,272,172,185,123,62,60,97,128,63,62,22,23,66,80,70,20,3,37,31,48,-7,42,19,46,52,43,20,13,3,32,44,21,18,0,3,14,8,22,2,13,0,640,387,253,365,191,174,50,142,263,143,30,-10,55,65,151,106,5,-3,-5,77,112,37,25,-7,48,82,103,84,33,9,26,53,45,49,7,8,22,29,58,35,26,1,769,421,348,376,218,158,92,168,312,139,50,10,48,90,187,71,8,9,44,78,125,68,42,1,59,71,142,70,21,9,35,33,86,46,10,4,24,38,56,24,11,5
7,07033,Manacor,30154,1190,706,484,534,330,204,258,313,334,204,64,10,139,195,195,126,41,5,119,118,139,78,23,5,96,117,146,97,62,14,53,79,95,60,36,7,43,38,51,37,26,7,1229,684,545,724,402,322,204,325,395,175,94,16,113,173,228,91,57,11,91,152,167,84,37,5,126,154,216,117,78,22,67,83,124,64,41,16,59,71,92,53,37,6,750,376,374,772,417,355,130,207,222,106,62,34,58,98,135,38,31,19,72,109,87,68,31,15,157,166,213,112,82,34,85,81,130,48,47,21,72,85,83,64,35,13,434,253,181,732,405,327,74,125,74,42,86,47,61,75,38,14,46,28,13,50,36,28,40,19,135,150,201,95,105,40,82,77,118,50,55,20,53,73,83,45,50,20,445,212,233,601,315,286,81,114,42,52,103,44,46,55,18,12,56,18,35,59,24,40,47,26,120,115,127,86,112,36,72,53,68,39,62,17,48,62,59,47,50,19,1026,554,472,797,414,383,184,238,264,182,107,38,111,132,159,79,50,20,73,106,105,103,57,18,147,173,174,138,116,43,74,97,99,56,59,27,73,76,75,82,57,16,1078,552,526,862,425,437,165,261,241,192,154,50,80,140,128,111,71,23,85,121,113,81,83,27,147,188,198,141,130,46,79,84,99,66,66,25,68,104,99,75,64,21,1542,869,673,985,538,447,252,396,396,257,161,69,150,213,210,162,91,38,102,183,186,95,70,31,175,233,246,141,123,54,97,129,135,74,65,30,78,104,111,67,58,24,1060,601,459,949,498,451,179,278,306,193,59,32,96,140,188,112,36,20,83,138,118,81,23,12,187,229,253,149,76,37,103,99,145,76,46,19,84,130,108,73,30,18,603,297,306,603,279,324,122,188,123,63,81,27,75,61,81,22,40,14,47,127,42,41,41,13,112,168,153,81,58,21,65,64,75,37,25,11,47,104,78,44,33,10,-269,-202,-67,-47,-55,8,-68,-40,-60,-60,-22,-15,-39,-20,-63,-63,-14,1,-29,-20,3,3,-8,-16,-11,37,-6,-49,-13,-11,-8,10,-7,-46,-6,-1,-3,27,1,-3,-7,-10,-162,-146,-16,293,129,164,-44,-2,-55,-60,-5,2,-42,0,-47,-51,-10,2,-2,-2,-8,-9,5,0,42,59,75,60,34,15,24,22,30,28,16,7,18,37,45,32,18,8,65,-39,104,191,85,106,-39,13,52,-18,37,15,-19,-8,5,-37,11,8,-20,21,47,19,26,7,34,48,37,35,21,10,29,13,16,14,6,6,5,35,21,21,15,4,178,86,92,152,65,87,20,35,47,62,15,3,16,9,28,32,3,0,4,26,19,30,12,3,21,36,42,28,20,5,6,15,19,12,10,3,15,21,23,16,10,2,129,35,94,235,116,119,-27,60,24,34,12,27,-5,26,-5,-4,-1,20,-22,34,29,38,13,7,46,49,61,45,14,14,22,24,34,21,3,9,24,25,27,24,11,5,494,294,200,304,157,147,44,124,164,106,43,8,28,75,95,66,29,4,16,49,69,40,14,4,27,78,94,59,24,15,18,39,54,28,9,6,9,39,40,31,15,9,780,407,373,443,215,228,119,186,262,138,55,14,60,103,134,70,40,2,59,83,128,68,15,12,56,120,162,54,34,11,38,65,82,14,15,1,18,55,80,40,19,10,1500,747,753,811,404,407,240,288,421,334,149,61,115,130,228,180,60,25,125,158,193,154,89,36,113,142,233,184,105,27,56,75,128,90,39,12,57,67,105,94,66,15
7,07032,Maó,22725,834,504,330,455,239,216,104,212,336,137,42,6,56,112,214,93,22,8,48,100,122,44,20,-2,61,101,162,84,36,9,29,48,96,42,18,5,32,53,66,42,18,4,1041,558,483,661,365,296,209,285,330,142,35,30,93,172,176,77,19,14,116,113,154,65,16,16,137,172,198,116,31,4,63,101,117,68,13,2,74,71,81,48,18,2,934,473,461,585,296,289,142,280,353,109,41,10,74,136,177,54,26,5,68,144,176,55,15,5,137,146,157,81,41,16,72,72,79,43,22,6,65,74,78,38,19,10,738,354,384,599,301,298,115,250,214,90,43,22,47,119,105,50,17,17,68,131,109,40,26,5,154,143,132,93,54,15,73,67,74,54,22,7,81,76,58,39,32,8,635,348,287,446,245,201,68,173,218,124,52,0,36,79,145,69,24,0,32,94,73,55,28,0,80,102,135,79,35,11,37,53,90,44,17,3,43,49,45,35,18,8,567,327,240,484,234,250,60,247,146,63,29,9,39,138,94,43,15,-2,21,109,52,20,14,11,99,130,132,65,42,8,60,55,67,26,19,3,39,75,65,39,23,5,525,254,271,495,229,266,52,225,155,46,33,7,18,103,96,18,12,6,34,122,59,28,21,1,75,143,152,66,40,13,37,65,71,33,18,4,38,78,81,33,22,9,413,239,174,495,245,250,49,220,74,19,38,10,40,115,27,36,12,14,9,105,47,-17,26,-4,90,154,120,87,37,4,45,69,62,54,13,2,45,85,58,33,24,2,141,62,79,128,68,60,66,104,-12,-44,5,7,50,58,-10,-56,16,-1,16,46,-2,12,-11,8,54,86,-4,-8,-5,-3,30,54,-3,-18,1,0,24,32,-1,10,-6,-3,-136,-114,-22,120,14,106,-7,24,-28,-97,-31,-1,9,-6,-12,-73,-32,-1,-16,30,-16,-24,1,0,57,26,19,5,8,4,34,0,-7,-15,-4,5,23,26,26,20,12,-1,-339,-191,-148,-124,-93,-31,-72,17,-134,-101,-41,-3,-35,2,-67,-58,-23,-7,-37,15,-67,-43,-18,4,-10,5,-69,-35,-18,-2,-1,-9,-47,-27,-12,0,-9,14,-22,-8,-6,-2,43,47,-4,87,40,47,-21,63,42,-3,-7,-36,-6,39,1,20,4,-17,-15,24,41,-23,-11,-19,29,26,9,9,7,1,25,10,0,-4,4,1,4,16,9,13,3,0,-180,-186,6,-128,-83,-45,-16,14,-110,-39,-26,-3,-14,-9,-110,-37,-19,3,-2,23,0,-2,-7,-6,3,9,-78,-44,-14,-8,6,0,-48,-34,-4,-5,-3,9,-30,-10,-10,-3,-247,-126,-121,-155,-99,-56,-38,-2,-80,-87,-54,-3,-4,-7,-32,-58,-32,1,-34,5,-48,-29,-22,-4,-23,0,-64,-52,-20,-1,-9,0,-45,-35,-12,-1,-14,0,-19,-17,-8,0,-647,-347,-300,-537,-286,-251,-78,-29,-136,-207,-102,-93,-44,-29,-64,-111,-56,-40,-34,0,-72,-96,-46,-53,-40,-24,-147,-132,-97,-99,-17,-13,-86,-76,-51,-44,-23,-11,-61,-56,-46,-55,214,125,89,85,37,48,11,60,49,93,19,-23,1,41,29,61,3,-14,10,19,20,32,16,-9,18,12,18,40,1,-7,6,2,8,24,-2,-4,12,10,10,16,3,-3,281,144,137,223,100,123,45,121,62,35,5,8,8,51,54,34,-4,0,37,70,8,1,9,8,54,73,28,29,21,17,22,36,21,7,8,8,32,37,7,22,13,9,525,244,281,435,197,238,58,152,139,109,65,-6,14,67,65,59,31,1,44,85,74,50,34,-7,72,122,100,82,40,15,34,49,48,40,17,7,38,73,52,42,23,8
7,07035,Maria de la Salut,1800,53,40,13,56,34,22,0,17,15,21,2,-1,0,12,11,15,2,0,0,5,4,6,0,-1,5,18,19,11,2,1,0,9,15,8,2,0,5,9,4,3,0,1,96,60,36,72,44,28,19,29,23,7,10,5,10,12,20,5,9,2,9,17,3,2,1,3,16,21,17,9,5,1,9,11,12,6,4,0,7,10,5,3,1,1,34,16,18,58,30,28,2,7,15,0,3,8,7,-4,10,-3,3,3,-5,11,5,3,0,5,16,18,18,4,1,0,11,4,12,2,1,0,5,14,6,2,0,0,66,43,23,61,43,18,10,24,6,11,8,7,7,15,2,9,7,3,3,9,4,2,1,4,15,16,14,7,8,1,10,11,9,5,7,1,5,5,5,2,1,0,13,11,2,24,12,12,-5,3,11,3,2,0,-3,1,11,2,-1,1,-2,2,0,1,3,-1,6,3,8,4,2,1,3,2,5,2,0,0,3,1,3,2,2,1,13,9,4,17,9,8,1,5,1,4,7,-1,5,2,-1,2,3,0,-4,3,2,2,4,-1,1,4,4,5,2,1,1,2,3,2,1,0,0,2,1,3,1,1,29,14,15,21,10,11,3,10,-1,10,5,1,1,3,1,8,1,-1,2,7,-2,2,4,2,4,5,4,5,3,0,2,3,2,2,1,0,2,2,2,3,2,0,64,28,36,44,24,20,6,23,6,23,6,1,1,13,1,8,3,3,5,10,5,15,3,-2,12,13,7,9,2,1,6,8,4,5,0,1,6,5,3,4,2,0,-8,3,-11,25,14,11,-6,-8,-1,-2,7,1,-3,0,4,-2,4,0,-3,-8,-5,0,3,1,1,7,6,6,2,1,1,5,5,2,1,0,0,2,1,4,1,1,36,14,22,21,11,10,2,4,10,3,11,3,2,0,4,0,5,0,0,4,6,3,6,3,9,1,6,4,1,0,5,0,4,1,1,0,4,1,2,3,0,0,0,2,-2,5,0,5,-3,8,3,-12,3,3,-3,8,5,-10,1,3,0,0,-2,-2,2,0,1,6,4,-3,-4,0,0,4,1,-2,-3,0,1,2,3,-1,-1,0,-39,-21,-18,-28,-16,-12,-7,1,-14,-16,-2,-1,-6,2,-5,-7,-3,-2,-1,-1,-9,-9,1,1,-10,0,-7,-8,-4,0,-6,1,-1,-7,-4,0,-4,-1,-6,-1,0,0,0,4,-4,-8,-5,-3,-2,-1,7,-3,0,-2,1,1,1,-1,3,-2,-3,-2,6,-2,-3,0,-8,1,0,-3,2,0,-3,0,0,-3,1,0,-5,1,0,0,1,0,4,0,4,-4,-3,-1,6,-6,-2,11,3,-8,0,-3,-3,5,4,-3,6,-3,1,6,-1,-5,-1,-1,-1,-3,2,0,0,-2,-1,-3,3,0,-1,1,0,0,-1,0,11,-5,16,-1,-2,1,-8,11,5,1,6,-3,-6,1,1,-2,2,0,-2,10,4,3,4,-3,-6,2,2,-2,3,0,-4,1,0,-2,3,0,-2,1,2,0,0,0,-26,4,-30,5,6,-1,-14,-10,-3,-5,-2,9,-5,-3,3,4,0,6,-9,-7,-6,-9,-2,3,1,-2,2,1,2,1,1,0,3,0,1,1,0,-2,-1,1,1,0,46,23,23,-24,-16,-8,15,18,10,9,1,-9,9,7,7,2,1,-5,6,11,3,7,0,-4,3,5,-4,-9,-13,-6,2,2,-2,-6,-7,-5,1,3,-2,-3,-6,-1,3,8,-5,-15,-5,-10,3,8,-5,14,-7,-7,6,6,1,4,-3,-2,-3,2,-6,10,-4,-5,-1,5,-2,-5,-5,-7,1,4,1,-4,-3,-4,-2,1,-3,-1,-2,-3
7,07036,Marratxí,19451,1325,710,615,96,51,45,241,125,491,260,149,38,144,54,264,147,86,6,97,71,227,113,63,32,18,20,30,19,5,1,12,11,13,8,4,1,6,9,17,11,1,0,1405,773,632,151,78,73,321,194,363,340,131,37,197,108,192,174,70,20,124,86,171,166,61,17,41,31,34,26,13,4,26,13,17,15,4,3,15,18,17,11,9,1,1606,828,778,175,86,89,370,196,450,366,115,82,197,108,209,194,66,39,173,88,241,172,49,43,54,20,48,27,17,4,30,7,28,8,10,1,24,13,20,19,7,3,1247,617,630,176,77,99,292,160,394,215,113,50,149,66,201,122,51,20,143,94,193,93,62,30,49,34,50,15,22,4,23,12,20,8,10,3,26,22,30,7,12,1,691,329,362,118,48,70,110,60,204,179,76,58,49,6,122,84,40,26,61,54,82,95,36,32,26,15,32,22,18,3,7,3,16,11,7,2,19,12,16,11,11,1,975,519,456,157,80,77,268,126,313,157,68,38,161,63,163,70,41,16,107,63,150,87,27,22,36,32,41,28,13,6,20,12,21,19,6,2,16,20,20,9,7,4,1210,608,602,144,72,72,282,148,423,240,46,53,149,65,214,140,19,13,133,83,209,100,27,40,25,32,40,29,10,8,14,17,18,17,3,3,11,15,22,12,7,5,991,439,552,189,108,81,157,146,279,153,92,141,55,83,116,83,47,43,102,63,163,70,45,98,23,53,61,31,14,4,12,32,36,21,5,0,11,21,25,10,9,4,688,297,391,136,58,78,100,102,246,99,76,52,80,34,87,41,32,14,20,68,159,58,44,38,19,34,51,12,13,5,9,15,25,3,4,1,10,19,26,9,9,4,341,143,198,-39,-31,-8,90,11,150,35,14,27,44,-8,80,20,0,2,46,19,70,15,14,25,22,-7,-32,-12,-9,-1,11,-5,-17,-14,-7,1,11,-2,-15,2,-2,-2,302,134,168,58,8,50,71,-12,71,77,47,38,24,-15,35,51,18,16,47,3,36,26,29,22,16,18,6,7,4,4,6,2,-1,-4,0,4,10,16,7,11,4,0,57,-15,72,-3,-18,15,45,-8,18,-26,-4,24,22,-11,-18,-25,-1,14,23,3,36,-1,-3,10,8,0,2,-10,-3,-2,4,-5,-6,-7,-2,-2,4,5,8,-3,-1,0,476,262,214,50,24,26,61,97,107,132,45,18,32,55,37,94,25,4,29,42,70,38,20,14,-3,15,8,16,5,6,2,10,4,4,3,0,-5,5,4,12,2,6,237,113,124,-14,-20,6,84,7,85,16,9,36,25,10,53,-4,6,23,59,-3,32,20,3,13,7,16,-4,-24,-7,-6,1,2,-5,-16,-3,-1,6,14,1,-8,-4,-5,35,-16,51,-6,-7,1,41,-28,30,9,-51,21,7,-17,10,2,-25,6,34,-11,20,7,-26,15,5,2,-9,-8,-5,4,3,1,-5,-10,-3,3,2,1,-4,2,-2,1,-31,11,-42,-100,-56,-44,24,-17,47,-45,-37,-9,30,1,31,-22,-25,-12,-6,-18,16,-23,-12,3,-14,-3,-4,-47,-17,-15,-10,-3,1,-17,-16,-11,-4,0,-5,-30,-1,-4,341,154,187,38,15,23,131,15,95,81,-27,21,60,11,33,41,-9,4,71,4,62,40,-18,17,19,18,-9,16,-15,5,12,12,-4,3,-11,0,7,6,-5,13,-4,5,253,161,92,39,21,18,112,-6,69,72,1,5,58,8,18,69,2,3,54,-14,51,3,-1,2,20,3,9,0,5,1,9,2,7,1,-2,3,11,1,2,-1,7,-2
7,07037,"Mercadal, Es",2896,224,115,109,121,60,61,27,46,80,36,25,10,6,25,51,21,8,7,21,21,29,15,17,3,15,19,27,23,22,13,8,10,13,10,10,9,7,9,14,13,12,4,245,129,116,123,64,59,21,46,63,64,45,3,10,16,46,28,24,5,11,30,17,36,21,-2,18,15,30,29,27,2,6,7,22,13,14,2,12,8,8,16,13,0,216,122,94,108,62,46,16,60,65,41,25,9,7,38,41,21,14,3,9,22,24,20,11,6,14,18,18,23,26,8,7,13,13,11,14,4,7,5,5,12,12,4,285,165,120,164,82,82,34,57,47,69,58,21,20,36,30,40,30,10,14,21,17,29,28,11,17,15,30,34,49,18,7,8,16,20,23,8,10,7,14,14,26,10,250,126,124,120,69,51,39,37,89,29,39,17,16,20,51,7,22,7,23,17,38,22,17,10,17,19,24,14,31,14,11,10,14,7,18,8,6,9,10,7,13,6,236,131,105,154,75,79,20,29,62,50,62,11,14,12,27,32,35,9,6,17,35,18,27,2,25,22,21,31,40,14,12,14,5,16,19,8,13,8,16,15,21,6,347,201,146,174,94,80,34,57,108,80,54,10,17,35,67,47,27,6,17,22,41,33,27,4,28,18,51,28,41,6,13,9,27,14,25,5,15,9,24,14,16,1,276,129,147,181,95,86,31,67,47,75,46,11,17,31,17,34,25,5,14,36,30,41,21,6,20,40,36,46,32,6,11,21,21,20,18,3,9,19,15,26,14,3,159,92,67,101,47,54,35,33,21,24,39,5,20,24,13,17,14,5,15,9,8,7,25,0,13,21,26,18,15,6,9,9,9,11,6,3,4,12,17,7,9,3,79,6,73,42,13,29,13,34,-8,7,17,14,1,13,-20,-7,2,15,12,21,12,14,15,-1,12,12,1,-4,14,7,2,8,-3,-3,3,6,10,4,4,-1,11,1,-1,14,-15,0,2,-2,0,9,-18,5,-2,2,11,9,-21,5,0,6,-11,0,3,0,-2,-4,-1,6,-11,-2,3,4,0,3,-4,0,-1,3,-1,3,-7,-2,4,1,-7,-27,20,45,19,26,22,25,-22,-18,6,-25,0,12,-11,-16,-2,-14,22,13,-11,-2,8,-11,6,6,11,2,15,5,2,3,4,0,6,4,4,3,7,2,9,1,14,4,10,38,18,20,17,4,-5,2,-8,-9,6,1,-5,2,0,-8,11,3,0,0,-8,-1,5,6,5,8,11,1,3,2,1,5,7,-1,2,4,4,3,4,2,-284,-154,-130,-248,-137,-111,-53,-3,-80,-53,-43,-60,-28,3,-48,-23,-22,-38,-25,-6,-32,-30,-21,-22,-22,-15,-62,-51,-39,-60,-9,-6,-35,-26,-25,-36,-13,-9,-27,-25,-14,-24,-71,-33,-38,-39,-18,-21,1,14,-18,-24,-30,-17,-3,-1,-10,-8,-6,-6,4,15,-8,-16,-24,-11,4,-4,-13,-7,-12,-9,-1,-4,-2,-5,-4,-3,5,0,-11,-2,-8,-6,37,6,31,58,24,34,12,21,-15,9,19,-13,3,15,-10,-3,8,-10,9,6,-5,12,11,-3,9,11,16,13,8,0,4,5,9,6,4,-4,5,6,7,7,4,4,-14,-8,-6,39,22,17,-15,3,-16,16,4,-6,-10,4,-5,3,7,-4,-5,-1,-11,13,-3,-2,0,6,2,16,8,6,1,2,-2,11,4,5,-1,4,4,5,4,1,81,51,30,40,16,24,4,9,23,13,19,8,2,1,13,15,14,3,2,8,10,-2,5,5,4,10,3,1,14,7,4,4,0,-2,5,4,0,6,3,3,9,3
7,07039,Muro,6174,79,58,21,116,81,35,-14,29,59,-1,7,2,-11,24,47,-3,3,1,-3,5,12,2,4,1,17,28,47,13,8,3,10,20,36,8,4,3,7,8,11,5,4,0,160,109,51,135,80,55,24,43,55,36,8,-5,12,27,41,28,5,-3,12,16,14,8,3,-2,20,32,37,32,10,3,8,20,23,20,6,2,12,12,14,12,4,1,109,58,51,110,62,48,15,42,29,-3,15,13,14,17,22,-9,8,6,1,25,7,6,7,7,23,27,32,10,13,4,18,11,18,4,8,2,5,16,14,6,5,2,54,54,0,103,66,37,10,31,4,-15,12,6,14,20,9,-6,11,3,-4,11,-5,-9,1,3,27,25,23,17,5,1,20,13,15,11,4,0,7,12,8,6,1,1,112,96,16,108,63,45,4,46,47,12,2,3,0,41,48,5,2,0,4,5,-1,7,0,3,23,31,31,13,6,4,13,18,20,8,2,2,10,13,11,5,4,2,117,64,53,132,81,51,35,25,13,19,24,2,24,17,8,4,8,1,11,8,5,15,16,1,36,30,32,18,14,2,25,16,21,10,7,2,11,14,11,8,7,0,105,60,45,130,73,57,38,46,-7,24,-2,2,10,27,3,10,0,8,28,19,-10,14,-2,-6,37,29,35,16,5,3,20,12,24,8,5,2,17,17,11,8,0,1,205,119,86,136,71,65,40,58,61,38,9,1,27,40,23,26,4,2,13,18,38,12,5,-1,27,45,39,15,7,6,17,24,19,7,2,6,10,21,20,8,5,0,96,45,51,137,69,68,19,43,0,12,26,-1,18,22,-12,7,15,-2,1,21,12,5,11,1,36,37,42,9,9,1,23,18,17,5,6,0,13,19,25,4,3,1,-26,-2,-24,68,35,33,-34,25,3,-14,1,-7,-9,2,15,-10,3,-2,-25,23,-12,-4,-2,-5,6,26,21,6,6,2,7,12,10,2,3,1,-1,14,11,4,3,1,-38,-56,18,3,-9,12,-23,15,-9,-13,-11,0,-26,0,-11,-11,-6,-1,3,15,2,-2,-5,1,-16,16,3,-1,-1,1,-10,5,0,-2,-2,-1,-6,11,3,1,1,2,-62,-52,-10,8,-1,9,-14,-1,-35,-9,-7,8,-10,1,-20,-17,-3,-1,-4,-2,-15,8,-4,9,1,8,0,-2,-3,4,-2,5,-2,-4,-1,3,3,3,2,2,-2,1,-63,-31,-32,-56,-38,-18,6,-13,4,-27,-19,-12,5,-5,-1,-10,-9,-11,1,-8,5,-17,-10,-1,-16,-9,-7,-8,-7,-8,-11,-8,-6,-4,-3,-6,-5,-1,-1,-4,-4,-2,-93,-59,-34,-33,-21,-12,-15,-4,-32,-25,-16,4,-4,-1,-22,-23,-11,4,-11,-3,-10,-2,-5,0,-7,0,-12,-12,-3,1,-1,-3,-5,-10,-2,0,-6,3,-7,-2,-1,1,-20,-19,-1,-33,-31,-2,-5,-9,-22,6,4,3,-4,-3,-9,-2,-1,0,-1,-6,-13,8,5,3,-10,-1,-19,1,-2,-3,-7,-2,-17,-3,0,-2,-3,1,-2,4,-2,-1,-12,-2,-10,-24,-17,-7,15,12,-29,0,8,-17,13,5,-21,0,6,-5,2,7,-8,0,2,-12,6,-2,-12,-12,1,-5,5,-2,-11,-5,-2,-2,1,0,-1,-7,3,-3,80,53,27,38,21,17,22,11,51,1,-5,-6,10,8,30,4,-5,1,12,3,21,-3,0,-7,10,14,14,-1,4,-5,7,9,9,-4,1,-2,3,5,5,3,3,-3,108,81,27,59,29,30,9,27,40,36,3,-9,1,16,25,34,1,-1,8,11,15,2,2,-8,13,16,15,12,-1,1,2,7,11,9,-4,2,11,9,4,3,3,-1
7,07040,Palma,326993,2913,1549,1364,286,156,130,48,1716,1125,200,-155,-11,28,849,617,145,-86,9,20,867,508,55,-69,-20,42,59,83,47,29,23,21,30,47,27,16,15,21,29,36,20,13,8,-33,77,-110,226,139,87,-561,832,359,-286,-220,-117,-350,410,302,-93,-113,-42,-211,422,57,-193,-107,-75,53,38,55,31,31,12,31,20,42,19,19,6,22,18,13,12,12,6,-1300,-543,-757,68,55,13,-924,687,181,-592,-375,-174,-496,310,262,-278,-204,-100,-428,377,-81,-314,-171,-74,44,41,-63,-9,45,3,19,24,-28,13,24,-1,25,17,-35,-22,21,4,-3289,-2010,-1279,222,129,93,-940,220,-951,-905,-500,-104,-544,82,-621,-519,-292,-59,-396,138,-330,-386,-208,-45,48,34,44,41,30,18,25,15,23,31,18,11,23,19,21,10,12,7,4899,2028,2871,7913,4006,3907,331,2352,1347,557,204,114,117,1027,607,256,4,21,214,1325,740,301,200,93,1080,2057,2593,1326,612,192,570,973,1427,687,248,73,510,1084,1166,639,364,119,6310,3002,3308,8606,4322,4284,382,2690,2010,903,261,47,83,1198,1187,495,56,-4,299,1492,823,408,205,51,1181,2294,2793,1455,603,173,589,1032,1528,808,263,50,592,1262,1265,647,340,123,6540,3398,3142,10082,5235,4847,457,3140,1811,931,207,32,197,1596,1135,480,44,-17,260,1544,676,451,163,49,1402,2865,3163,1714,687,189,742,1372,1778,934,314,65,660,1493,1385,780,373,124,4423,2502,1921,6604,3545,3059,263,3285,1080,187,-141,-269,104,1651,898,55,-158,-58,159,1634,182,132,17,-211,895,2774,1918,848,216,-120,435,1403,1144,449,94,-18,460,1371,774,399,122,-102,5512,2855,2657,6843,3613,3230,804,2504,1688,626,5,-90,390,1264,959,310,-26,-28,414,1240,729,316,31,-62,1282,2021,2074,1107,297,-4,694,1055,1123,565,143,4,588,966,951,542,154,-8,1715,644,1071,3534,1633,1901,251,1504,244,-102,-152,-44,123,752,63,-153,-137,-2,128,752,181,51,-15,-42,689,1202,960,406,185,43,375,528,444,169,74,18,314,674,516,237,111,25,-849,-945,96,1903,736,1167,-37,770,-713,-423,-240,-187,-5,186,-498,-354,-188,-63,-32,584,-215,-69,-52,-124,391,715,409,245,93,23,223,236,147,90,11,17,168,479,262,155,82,6,-1129,-1084,-45,-987,-938,-49,-9,930,-798,-771,-262,-241,-27,282,-481,-595,-171,-106,18,648,-317,-176,-91,-135,111,469,-846,-654,-78,-28,55,126,-575,-481,-79,-2,56,343,-271,-173,1,-26,609,-108,717,510,16,494,173,763,-73,-317,-7,54,52,275,-136,-315,-11,34,121,488,63,-2,4,20,145,562,-110,-161,4,40,69,205,-148,-156,14,22,76,357,38,-5,-10,18,3311,1364,1947,1029,356,673,504,1524,866,308,55,-38,318,634,345,61,-34,-5,186,890,521,247,89,-33,126,692,144,-86,67,41,94,269,26,-78,8,13,32,423,118,-8,59,28,2627,924,1703,741,64,677,439,1454,623,-33,82,2,247,572,249,-161,-6,-7,192,882,374,128,88,9,178,745,-108,-199,27,52,144,272,-151,-230,-12,14,34,473,43,31,39,38,3610,1619,1991,2496,1123,1373,474,1644,1218,118,96,-62,229,704,624,23,41,-51,245,940,594,95,55,-11,402,975,691,129,164,64,193,407,348,57,58,19,209,568,343,72,106,45,5800,2740,3060,4170,1914,2256,567,2086,1935,735,303,90,312,951,1001,306,109,21,255,1135,934,429,194,69,557,1263,1205,618,312,142,312,526,570,287,137,44,245,737,635,331,175,98,6366,3322,3044,5634,2714,2920,620,2145,2425,902,297,-71,359,1028,1328,528,91,-28,261,1117,1097,374,206,-43,850,1404,1696,981,429,200,424,677,840,480,167,88,426,727,856,501,262,112
7,07041,Petra,2566,52,44,8,24,21,3,8,12,17,12,4,-3,8,13,12,9,3,-2,0,-1,5,3,1,-1,1,7,8,8,0,0,1,6,7,7,0,0,0,1,1,1,0,0,32,13,19,21,12,9,11,3,9,2,2,4,5,0,3,0,2,3,6,3,6,2,0,1,5,6,6,4,0,0,2,5,3,2,0,0,3,1,3,2,0,0,61,36,25,38,21,17,1,11,17,7,16,8,-3,8,16,5,6,4,4,3,1,2,10,4,3,13,10,2,9,1,0,8,6,2,5,0,3,5,4,0,4,1,6,18,-12,30,22,8,-2,8,-10,7,2,-4,-2,5,2,4,4,0,0,3,-12,3,-2,-4,9,6,5,7,1,0,5,6,5,4,0,0,4,0,0,3,1,0,66,41,25,54,32,22,30,10,9,4,8,5,16,9,4,4,6,3,14,1,5,0,2,2,18,10,12,10,4,0,8,7,8,6,3,0,10,3,4,4,1,0,47,25,22,40,21,19,8,3,12,17,9,-2,1,3,3,11,7,-1,7,0,9,6,2,-1,8,7,7,13,4,1,5,5,2,7,2,0,3,2,5,6,2,1,55,28,27,43,29,14,7,13,17,5,11,1,8,7,7,1,4,0,-1,6,10,4,7,1,17,7,6,8,5,0,14,5,3,4,3,0,3,2,3,4,2,0,69,24,45,47,23,24,12,15,19,18,4,-1,0,7,9,7,0,0,12,8,10,11,4,-1,7,11,14,8,5,2,3,5,7,5,3,0,4,6,7,3,2,2,62,40,22,44,25,19,15,12,13,12,8,1,14,7,8,2,5,2,1,5,5,10,3,-1,5,15,7,8,7,1,3,9,5,4,2,1,2,6,2,4,5,0,26,16,10,29,13,16,21,-2,5,7,-2,-2,9,2,5,2,-2,0,12,-4,0,5,0,-2,6,9,6,5,2,1,2,4,4,3,0,0,4,5,2,2,2,1,8,-2,10,29,15,14,3,2,-5,0,10,-3,1,-1,-3,0,5,-3,2,3,-2,0,5,0,8,3,8,2,2,3,4,2,5,1,1,2,4,1,3,1,1,1,9,-4,13,28,13,15,1,-4,5,2,0,3,-4,-2,-3,1,4,-1,5,-2,8,1,-4,4,8,2,5,8,3,1,4,0,0,5,2,1,4,2,5,3,1,0,-27,-19,-8,16,8,8,-5,3,6,-19,-7,-4,-1,-3,5,-15,-3,-1,-4,6,1,-4,-4,-3,2,4,2,4,2,1,1,0,1,3,2,1,1,4,1,1,0,0,-13,1,-14,13,8,5,-8,1,-5,1,3,-6,-4,6,-3,4,0,-3,-4,-5,-2,-3,3,-3,-1,4,4,4,3,-1,-1,1,4,3,2,-1,0,3,0,1,1,0,18,11,7,11,7,4,9,9,5,-1,6,-10,7,2,1,-1,7,-5,2,7,4,0,-1,-5,3,1,1,5,1,0,3,0,-1,4,1,0,0,1,2,1,0,0,-71,-33,-38,-43,-20,-23,-9,-4,-23,-19,-4,-11,-3,0,-13,-13,0,-4,-6,-4,-10,-6,-4,-7,-4,-3,-9,-14,-6,-7,-1,-1,-7,-7,0,-4,-3,-2,-2,-7,-6,-3,43,26,17,28,16,12,5,1,9,7,15,7,2,3,10,4,3,5,3,-2,-1,3,12,2,7,3,10,4,4,0,3,2,8,1,2,0,4,1,2,3,2,0,39,21,18,19,7,12,20,1,12,1,3,0,11,3,2,-3,5,3,9,-2,10,4,-2,-3,2,6,7,3,-1,1,1,3,2,1,0,0,1,3,5,2,-1,1
7,07042,Pollença,13976,34,22,12,30,16,14,-4,42,-22,5,1,12,3,30,-16,4,-3,5,-7,12,-6,1,4,7,5,3,5,6,8,3,3,2,2,4,3,2,2,1,3,2,5,1,16,30,-14,22,13,9,-10,25,18,-10,3,-7,-12,18,21,0,5,-3,2,7,-3,-10,-2,-4,4,5,6,4,3,0,2,3,4,2,2,0,2,2,2,2,1,0,-78,-26,-52,0,0,0,-25,17,-12,-43,-8,-2,-4,12,3,-27,-2,-5,-21,5,-15,-16,-6,3,2,0,1,-1,-2,0,0,-1,2,0,-1,0,2,1,-1,-1,-1,0,-220,-116,-104,4,2,2,-62,-14,-74,-40,-28,2,-33,-4,-49,-19,-13,7,-29,-10,-25,-21,-15,-5,2,-3,0,0,-2,7,0,-1,-1,1,-1,4,2,-2,1,-1,-1,3,249,135,114,450,245,205,-3,83,39,49,65,24,4,45,30,29,25,11,-7,38,9,20,40,13,71,91,106,77,86,17,41,44,67,44,39,11,30,47,39,33,47,6,382,203,179,570,300,270,55,91,50,77,93,14,29,46,36,41,41,8,26,45,14,36,52,6,95,116,118,103,108,25,50,57,67,56,54,13,45,59,51,47,54,12,421,222,199,522,257,265,55,97,82,96,69,21,28,61,48,41,34,9,27,36,34,55,35,12,77,106,119,108,83,26,38,59,57,50,37,14,39,47,62,58,46,12,395,213,182,444,235,209,21,109,114,71,62,12,20,60,60,29,32,8,1,49,54,42,30,4,55,108,107,81,63,26,40,52,57,40,32,12,15,56,50,41,31,14,156,75,81,262,136,126,33,63,45,-11,33,-6,13,38,16,-11,21,-4,20,25,29,0,12,-2,42,63,63,41,38,11,19,29,38,20,25,3,23,34,25,21,13,8,-319,-176,-143,-284,-159,-125,-5,4,-32,-65,-110,-99,-17,6,-17,-42,-47,-51,12,-2,-15,-23,-63,-48,-4,2,-28,-66,-87,-102,-10,3,-23,-39,-43,-47,6,-1,-5,-27,-44,-55,-879,-478,-401,-785,-426,-359,-91,-38,-143,-162,-219,-226,-49,-19,-95,-94,-108,-114,-42,-19,-48,-68,-111,-112,-69,-38,-106,-134,-221,-221,-34,-32,-66,-78,-107,-111,-35,-6,-40,-56,-114,-110,90,18,72,92,26,66,-14,27,-17,5,14,77,-5,3,-13,-2,9,24,-9,24,-4,7,5,53,-7,33,14,15,20,15,-5,9,5,1,7,7,-2,24,9,14,13,8,63,39,24,39,26,13,5,21,52,9,-23,0,8,15,29,7,-19,0,-3,6,23,2,-4,0,2,11,30,13,-9,-8,4,13,15,11,-13,-4,-2,-2,15,2,4,-4,-1,-6,5,-33,-39,6,6,0,-27,10,-12,13,-15,0,-7,19,-16,9,21,0,-20,-9,4,4,7,2,-37,0,-5,-5,-2,-8,-23,5,-11,-2,9,10,-14,-5,6,-3,18,12,6,-37,-13,-24,-31,9,-1,-6,19,27,-7,-10,8,-14,19,15,-24,19,-9,8,0,12,-30,8,-18,-15,16,0,-13,-3,-1,-13,14,3,-17,11,-17,-2,2,-3,157,103,54,37,16,21,35,33,54,18,-3,16,30,12,36,8,-2,15,5,21,18,10,-1,1,-5,10,30,3,6,-8,5,1,14,-10,5,1,-10,9,16,13,1,-9,-11,-9,-2,32,15,17,-21,0,-3,-14,3,25,-14,10,2,-15,3,1,-7,-10,-5,1,0,24,-2,17,20,-4,0,-2,0,12,9,1,-6,-4,-2,5,11,-5,6,2,91,32,59,71,34,37,19,31,3,-1,19,16,2,22,8,-10,15,-9,17,9,-5,9,4,25,19,21,15,16,15,-20,7,11,11,5,11,-15,12,10,4,11,4,-5
7,07043,Porreres,4261,141,122,19,112,88,24,6,50,44,21,14,5,6,40,44,18,9,3,0,10,0,3,5,2,11,34,35,21,7,4,7,30,30,17,3,1,4,4,5,4,4,3,105,76,29,107,81,26,21,45,21,6,10,1,16,33,15,9,3,0,5,12,6,-3,7,1,15,42,30,11,8,0,10,37,22,9,3,0,5,5,8,2,5,0,121,68,53,90,56,34,18,21,47,16,13,5,8,12,27,10,7,3,10,9,20,6,6,2,10,27,30,10,8,4,5,18,18,7,5,2,5,9,12,3,3,2,102,56,46,120,77,43,20,22,29,20,16,-4,13,11,16,6,10,0,7,11,13,14,6,-4,20,25,32,27,15,0,12,18,20,16,11,0,8,7,12,11,4,0,109,63,46,116,79,37,25,34,20,23,8,-1,14,21,9,18,0,1,11,13,11,5,8,-2,15,24,40,30,7,0,9,18,27,22,3,0,6,6,13,8,4,0,218,123,95,181,98,83,36,57,76,28,12,4,13,36,44,20,8,2,23,21,32,8,4,2,41,49,41,34,9,1,17,32,21,21,4,1,24,17,20,13,5,0,275,182,93,195,127,68,40,60,67,68,35,4,23,46,48,43,19,2,17,14,19,25,16,2,33,45,57,42,14,2,17,31,39,29,8,1,16,14,18,13,6,1,210,131,79,173,119,54,33,38,80,30,24,2,20,32,39,18,17,3,13,6,41,12,7,-1,13,54,46,40,16,1,8,38,33,27,10,0,5,16,13,13,6,1,172,87,85,136,75,61,48,42,53,25,7,-5,24,19,29,11,2,-3,24,23,24,14,5,-2,37,31,37,30,0,-1,20,12,25,17,1,-1,17,19,12,13,-1,0,104,69,35,79,38,41,16,32,9,18,8,13,13,18,4,13,0,14,3,14,5,5,8,-1,16,29,8,15,4,4,9,12,2,10,-1,4,7,17,6,5,5,0,69,25,44,76,44,32,27,13,14,10,3,3,12,-2,6,5,4,0,15,15,8,5,-1,3,13,13,21,16,9,3,7,8,11,12,4,1,6,5,10,4,5,2,-85,-72,-13,-4,-20,16,-12,-9,-28,-25,0,-6,-14,-1,-22,-26,0,-5,2,-8,-6,1,0,-1,4,4,-11,-6,2,3,1,-2,-6,-15,1,1,3,6,-5,9,1,2,-33,-36,3,-27,-29,2,13,-11,-23,-11,-6,6,15,-16,-22,-11,-4,2,-2,5,-1,0,-2,4,10,-6,-22,-10,0,1,10,-10,-19,-10,0,0,0,4,-3,0,0,1,-19,-16,-3,-18,-23,5,11,-7,-12,-30,0,17,6,5,-7,-24,-1,3,5,-12,-5,-6,1,14,8,5,-14,-13,-2,-2,3,8,-15,-14,-3,-2,5,-3,1,1,1,0,-20,-14,-6,38,4,34,-8,-9,-6,-9,9,5,-4,0,-3,-8,2,1,-4,-9,-3,-1,7,4,9,15,2,-2,12,1,3,7,-2,-8,3,0,6,8,4,6,9,1,48,2,46,32,12,20,20,7,-1,-6,5,20,7,2,-4,-12,4,5,13,5,3,6,1,15,8,4,12,3,2,2,5,3,6,0,-1,-1,3,1,6,3,3,3,63,44,19,49,35,14,15,16,19,22,6,-16,14,8,9,14,3,-5,1,8,10,8,3,-11,5,10,8,16,7,2,4,6,8,8,6,2,1,4,0,8,1,0,64,19,45,39,21,18,15,16,11,0,16,7,11,5,5,-6,4,0,4,11,6,6,12,7,7,9,10,3,4,6,7,5,8,0,-1,2,0,4,2,3,5,4
7,07045,Puigpunyent,1223,42,20,22,18,10,8,6,3,17,7,4,5,1,4,10,1,2,2,5,-1,7,6,2,3,0,3,9,4,2,0,0,3,4,2,1,0,0,0,5,2,1,0,71,46,25,28,13,15,10,13,16,16,6,9,9,5,14,10,2,5,1,8,2,6,4,4,5,4,10,4,3,2,1,1,6,2,1,2,4,3,4,2,2,0,79,44,35,21,9,12,22,10,21,14,8,3,13,4,11,6,8,1,9,6,10,8,0,2,2,3,6,4,3,3,1,1,1,2,3,1,1,2,5,2,0,2,44,25,19,23,11,12,8,-1,20,7,7,2,-1,-1,18,1,5,1,9,0,2,6,2,1,7,0,10,5,1,0,4,0,5,1,1,0,3,0,5,4,0,0,53,31,22,28,10,18,20,5,17,-4,10,2,13,1,10,-2,6,2,7,4,7,-2,4,0,4,9,4,2,6,2,1,2,2,0,3,2,3,7,2,2,3,0,84,44,40,55,26,29,13,15,18,26,9,3,7,7,6,16,4,4,6,8,12,10,5,-1,1,16,12,15,8,3,1,4,6,9,3,3,0,12,6,6,5,0,76,36,40,43,10,33,13,12,26,9,12,3,4,1,19,6,4,1,9,11,7,3,8,2,4,14,12,5,7,0,1,1,4,1,2,0,3,13,8,4,5,0,75,51,24,52,35,17,10,14,26,9,11,5,7,6,19,4,9,6,3,8,7,5,2,-1,10,11,11,9,7,4,9,7,8,3,4,4,1,4,3,6,3,0,88,37,51,20,10,10,16,1,30,34,7,3,9,-1,10,19,2,1,7,2,20,15,5,2,2,2,8,1,6,1,1,1,5,1,2,0,1,1,3,0,4,1,59,34,25,37,25,12,19,5,12,13,10,-3,13,-2,7,11,7,-3,6,7,5,2,3,0,11,4,3,13,5,0,8,2,1,9,5,0,3,2,2,4,0,0,28,3,25,14,3,11,9,0,21,5,-2,-7,-2,-2,10,1,-2,-3,11,2,11,4,0,-4,1,2,8,4,-2,0,-2,0,3,2,-1,0,3,2,5,2,-1,0,-81,-33,-48,-66,-23,-43,-6,-25,-15,-17,-11,-8,-1,-7,-5,-7,-10,-5,-5,-18,-10,-10,-1,-3,-6,-18,-16,-12,-10,-5,-3,-4,-4,-6,-6,-1,-3,-14,-12,-6,-4,-4,81,49,32,22,10,12,27,17,17,14,6,-1,22,9,13,3,4,-3,5,8,4,11,2,2,3,10,4,3,1,1,3,3,1,2,1,0,0,7,3,1,0,1,8,23,-15,6,5,1,0,-4,7,-2,6,0,8,2,1,4,8,0,-8,-6,6,-6,-2,0,-1,-1,4,1,1,1,1,-1,4,-1,1,1,-2,0,0,2,0,0,56,39,17,34,14,20,11,4,15,15,7,1,12,4,7,11,4,0,-1,0,8,4,3,1,9,5,6,9,4,1,3,2,3,2,4,0,6,3,3,7,0,1,0,-8,8,-17,-14,-3,11,-5,9,-2,-2,-12,6,-3,0,-4,-2,-5,5,-2,9,2,0,-7,-1,-1,2,-11,0,-6,-3,-1,0,-6,0,-4,2,0,2,-5,0,-2,18,10,8,25,15,10,7,-1,5,4,-1,5,5,-3,1,8,1,-1,2,2,4,-4,-2,6,5,1,1,9,5,4,5,0,-1,6,4,1,0,1,2,3,1,3,-4,-10,6,17,8,9,-4,0,5,0,-1,-6,-3,-1,1,-4,-2,-2,-1,1,4,4,1,-4,3,2,4,3,5,-1,2,0,1,3,3,-1,1,2,3,0,2,0
7,07059,"Salines, Ses",3370,-26,-13,-13,42,27,15,-6,-7,2,-5,0,-7,-5,2,1,-4,-2,-3,-1,-9,1,-1,2,-4,4,6,15,5,12,0,4,5,9,3,6,0,0,1,6,2,6,0,227,127,100,133,62,71,42,35,80,33,17,18,25,17,49,20,5,10,17,18,31,13,12,8,32,18,38,18,15,12,13,8,19,10,6,6,19,10,19,8,9,6,198,101,97,143,70,73,13,49,46,51,32,6,1,26,26,30,15,4,12,23,20,21,17,2,21,32,41,22,19,6,7,15,23,13,7,4,14,17,18,9,12,2,118,57,61,132,65,67,-15,34,34,16,37,12,-9,17,25,2,22,2,-6,17,9,14,15,10,15,37,23,24,29,4,6,18,14,10,16,1,9,19,9,14,13,3,139,96,43,159,89,70,2,16,25,40,39,17,3,15,20,27,18,12,-1,1,5,13,21,5,22,23,33,27,35,15,15,11,16,18,17,9,7,12,17,9,18,6,256,141,115,166,82,84,37,47,63,57,30,18,26,21,31,33,17,10,11,26,32,24,13,8,23,32,37,33,25,14,11,15,16,18,14,7,12,17,21,15,11,7,242,141,101,180,94,86,30,38,70,62,40,4,24,20,41,31,20,5,6,18,29,31,20,-1,15,30,45,47,38,5,11,13,26,23,18,3,4,17,19,24,20,2,261,142,119,214,100,114,26,46,69,59,51,10,4,36,38,26,31,7,22,10,31,33,20,3,24,44,41,48,39,14,10,22,16,21,20,9,14,22,25,27,19,5,189,118,71,148,84,64,25,42,36,57,26,3,20,15,32,36,10,6,5,27,4,21,16,-3,23,38,39,32,12,4,16,17,28,17,3,3,7,21,11,15,9,1,-48,-17,-31,25,12,13,-21,13,-20,-19,0,-2,-5,6,-7,-15,-1,3,-16,7,-13,-4,1,-5,1,27,4,-8,1,-1,0,10,6,-6,-1,1,1,17,-2,-2,2,-2,20,-8,28,27,15,12,3,-8,-16,5,35,6,-1,-1,-19,-4,18,1,4,-7,3,9,17,5,5,0,9,3,11,-1,2,1,5,2,6,-1,3,-1,4,1,5,0,-31,-13,-18,5,2,3,-17,10,-8,-4,-5,-7,-9,8,0,-2,-6,-4,-8,2,-8,-2,1,-3,6,3,-3,-6,1,3,5,1,-2,-2,-2,2,1,2,-1,-4,3,1,18,-9,27,5,-2,7,14,11,-4,8,-7,5,7,2,-18,9,-4,2,7,9,14,-1,-3,3,-3,-2,2,6,-1,3,-2,-1,-4,4,0,1,-1,-1,6,2,-1,2,-51,-14,-37,5,13,-8,-25,9,-3,-22,-9,-3,-16,7,-2,3,-2,-3,-9,2,-1,-25,-7,0,0,9,-3,-2,1,0,0,6,2,1,2,2,0,3,-5,-3,-1,-2,-12,-15,3,59,30,29,-22,2,9,0,7,-7,-11,1,7,-13,3,-2,-11,1,2,13,4,-5,2,9,23,11,13,2,1,3,11,6,9,1,1,6,12,5,4,1,22,16,6,34,13,21,3,3,-14,12,21,-1,1,5,-6,7,9,1,2,-2,-8,5,12,-2,4,7,-2,11,9,5,-1,6,-2,1,6,3,5,1,0,10,3,2,149,83,66,117,67,50,28,27,33,33,15,12,17,11,15,23,11,3,11,16,18,10,4,9,8,19,17,22,36,14,4,11,10,12,22,7,4,8,7,10,14,7,117,67,50,111,61,50,21,19,31,31,24,-6,5,10,22,15,18,-2,16,9,9,16,6,-4,21,16,29,24,22,-3,11,12,11,12,15,-1,10,4,18,12,7,-2
7,07049,Sant Joan,1683,20,16,4,31,25,6,2,2,9,3,5,1,-2,6,11,1,2,0,4,-4,-2,2,3,1,2,8,11,7,3,0,2,8,10,3,2,0,0,0,1,4,1,0,27,11,16,12,10,2,7,2,7,7,2,1,3,0,5,4,0,-2,4,2,2,3,2,3,1,2,7,1,0,0,1,2,6,0,0,0,0,0,1,1,0,0,70,42,28,49,29,20,2,19,29,10,5,4,1,8,19,7,3,3,1,11,10,3,2,1,10,7,25,7,0,0,4,3,16,6,0,0,6,4,9,1,0,0,43,23,20,44,25,19,3,12,7,4,12,4,0,10,3,1,6,2,3,2,4,3,6,2,9,13,9,3,8,2,5,9,5,1,4,1,4,4,4,2,4,1,22,5,17,47,20,27,13,7,5,-4,5,-4,4,2,0,-1,1,0,9,5,5,-3,4,-4,19,10,11,5,2,1,8,3,6,3,0,1,11,7,5,2,2,0,12,2,10,32,20,12,5,9,0,-1,2,0,1,5,3,-6,2,-1,4,4,-3,5,0,1,5,9,5,8,5,0,2,6,5,2,5,0,3,3,0,6,0,0,38,18,20,36,20,16,6,12,8,9,3,0,1,9,-4,7,2,3,5,3,12,2,1,-3,3,10,12,5,6,0,1,8,6,4,1,0,2,2,6,1,5,0,94,50,44,47,23,24,13,20,34,15,7,2,10,12,12,9,4,3,3,8,22,6,3,-1,9,13,19,2,1,2,6,8,8,0,0,1,3,5,11,2,1,1,30,11,19,22,13,9,9,13,4,1,5,-3,-1,4,6,-1,2,0,10,9,-2,2,3,-3,7,1,9,6,-2,0,0,0,7,5,0,0,7,1,2,1,-2,0,-2,-15,13,-1,-7,6,0,-5,-2,-3,6,-2,-1,-6,-6,-3,1,-1,1,1,4,0,5,-1,-3,3,-3,-1,2,1,-3,1,-5,0,0,0,0,2,2,-1,2,1,39,18,21,4,1,3,3,9,13,5,9,2,3,4,1,1,6,2,0,5,12,4,3,0,-4,6,0,-1,3,1,-3,2,0,-1,2,1,-1,4,0,0,1,0,51,17,34,9,3,6,-6,1,-4,0,6,54,-4,-1,0,2,3,17,-2,2,-4,-2,3,37,0,5,0,2,2,0,0,1,1,0,1,0,0,4,-1,2,1,0,6,7,-1,14,9,5,-1,1,-4,-12,-2,23,-1,1,0,-5,1,11,0,0,-4,-7,-3,12,8,5,1,1,1,-2,5,2,1,0,1,0,3,3,0,1,0,-2,75,23,52,23,10,13,14,10,4,8,5,31,4,2,-3,4,3,10,10,8,7,4,2,21,5,3,6,7,2,0,2,2,2,3,1,0,3,1,4,4,1,0,24,8,16,12,4,8,-8,2,-15,0,6,35,-4,2,-8,1,5,12,-4,0,-7,-1,1,23,4,3,2,-1,1,2,3,2,-1,-1,0,1,1,1,3,0,1,1,13,1,12,-10,-8,-2,1,1,-9,1,4,17,1,0,-7,2,-2,7,0,1,-2,-1,6,10,4,3,-8,0,-6,-3,3,1,-4,-3,-5,0,1,2,-4,3,-1,-3,38,25,13,14,9,5,12,2,7,1,0,16,7,4,1,2,2,8,5,-2,6,-1,-2,8,5,6,0,3,1,-1,5,2,0,2,1,-1,0,4,0,1,0,0,53,23,30,19,9,10,11,7,12,14,3,6,4,3,9,7,2,-2,7,4,3,7,1,8,5,1,3,5,3,2,1,-1,4,2,2,1,4,2,-1,3,1,1
7,07050,Sant Joan de Labritja,4063,271,133,138,152,79,73,45,39,93,53,30,8,24,11,55,21,14,6,21,28,38,32,16,2,27,23,44,33,18,7,14,8,29,15,9,4,13,15,15,18,9,3,227,129,98,165,86,79,28,39,85,42,30,0,15,20,56,17,19,0,13,19,29,25,11,0,25,22,50,40,21,5,11,13,29,18,12,2,14,9,21,22,9,3,233,136,97,157,90,67,21,30,77,53,40,4,9,23,40,30,26,5,12,7,37,23,14,-1,19,26,43,35,29,2,10,15,23,21,18,2,9,11,20,14,11,0,147,89,58,164,99,65,1,36,64,16,18,8,0,19,35,17,10,4,1,17,29,-1,8,4,33,24,45,24,26,9,20,11,28,18,15,4,13,13,17,6,11,5,172,109,63,181,104,77,6,42,77,34,11,-1,7,22,47,29,2,0,-1,20,30,5,9,-1,19,33,61,42,23,3,13,20,36,24,10,1,6,13,25,18,13,2,154,93,61,113,63,50,13,37,50,40,12,1,14,22,41,11,6,-1,-1,15,9,29,6,2,10,23,34,31,9,3,6,16,22,12,6,1,4,7,12,19,3,2,224,126,98,151,77,74,15,45,73,44,47,0,14,22,36,27,26,1,1,23,37,17,21,-1,9,27,52,20,37,5,6,12,23,15,21,0,3,15,29,5,16,5,229,118,111,165,85,80,17,54,88,44,20,3,1,29,43,26,15,0,16,25,45,18,5,3,21,25,71,39,6,1,4,8,39,30,2,0,17,17,32,9,4,1,74,33,41,76,34,42,0,15,55,3,5,-5,-2,10,27,1,0,-5,2,5,28,2,5,0,11,12,29,11,14,-1,3,10,12,3,7,-1,8,2,17,8,7,0,-62,-30,-32,-55,-30,-25,-5,-9,-22,-5,-13,-10,5,-4,-5,-11,-10,-6,-10,-5,-17,6,-3,-4,-13,0,-18,-17,-6,-2,-2,-3,-10,-13,-4,1,-11,3,-8,-4,-2,-3,-79,-40,-39,-35,-19,-16,-1,-6,-17,-32,-12,-13,0,-2,-7,-22,-5,-6,-1,-4,-10,-10,-7,-7,5,8,-10,-23,-8,-9,5,2,-10,-10,-4,-4,0,6,0,-13,-4,-5,162,83,79,94,48,46,36,24,68,54,-13,-13,14,10,31,33,-2,-7,22,14,37,21,-11,-6,27,16,25,29,1,-6,13,8,6,15,5,-1,14,8,19,14,-4,-5,185,93,92,113,50,63,21,25,66,46,27,-3,16,11,27,18,14,3,5,14,39,28,13,-6,14,22,33,32,10,0,8,6,15,16,3,1,6,16,18,16,7,-1,71,7,64,-29,-37,8,23,30,34,-7,-5,-9,7,7,19,-16,-1,-10,16,23,15,9,-4,1,0,8,-11,-18,-9,-2,-2,-1,-8,-15,-8,-4,2,9,-3,-3,-1,2,156,79,77,53,22,31,23,14,66,40,7,-5,18,12,16,26,9,-7,5,2,50,14,-2,2,23,4,22,13,-7,-6,15,1,3,10,-3,-5,8,3,19,3,-4,-1,182,92,90,41,10,31,29,19,65,74,8,-18,9,7,37,43,3,-9,20,12,28,31,5,-9,7,-1,30,17,-3,-10,-1,1,11,9,-6,-5,8,-2,19,8,3,-5,193,74,119,98,41,57,26,21,86,64,3,-11,14,7,28,25,5,-7,12,14,58,39,-2,-4,20,8,30,36,6,-3,10,5,13,5,7,0,10,3,17,31,-1,-3,171,89,82,102,50,52,24,10,95,39,2,-5,11,0,55,8,11,-1,13,10,40,31,-9,-4,13,5,46,28,14,-6,6,0,22,11,10,-1,7,5,24,17,4,-5
7,07048,Sant Josep de sa Talaia,13729,-86,-40,-46,12,9,3,-20,-26,-15,-15,-3,-2,2,-10,-18,-4,-5,-3,-22,-16,3,-11,2,1,0,3,3,5,1,0,0,2,2,4,1,0,0,1,1,1,0,0,320,215,105,5,3,2,22,119,120,54,1,1,14,65,98,41,0,-4,8,54,22,13,1,5,0,0,5,0,0,0,0,0,3,0,0,0,0,0,2,0,0,0,982,587,395,541,305,236,75,241,377,178,90,17,48,143,235,102,48,10,27,98,142,76,42,7,77,103,181,93,67,16,44,55,107,52,36,9,33,48,74,41,31,7,834,436,398,473,231,242,112,187,296,127,86,23,46,90,169,82,38,10,66,97,127,45,48,13,66,84,134,94,78,13,28,40,65,46,40,8,38,44,69,48,38,5,921,501,420,454,238,216,114,194,283,167,96,32,49,88,177,105,53,12,65,106,106,62,43,20,59,86,128,87,66,20,34,39,67,47,39,8,25,47,61,40,27,12,1146,607,539,525,294,231,132,230,453,172,85,26,64,121,239,102,55,10,68,109,214,70,30,16,67,89,177,90,69,23,38,43,99,63,40,10,29,46,78,27,29,13,1019,594,425,534,296,238,114,238,284,193,125,49,79,133,179,113,57,29,35,105,105,80,68,20,57,87,164,109,79,31,39,37,95,65,37,20,18,50,69,44,42,11,1321,677,644,709,368,341,162,300,433,212,130,51,61,144,252,118,69,17,101,156,181,94,61,34,86,147,212,120,109,27,44,77,110,62,55,14,42,70,102,58,54,13,887,469,418,385,216,169,90,272,328,135,36,2,35,130,192,80,18,0,55,142,136,55,18,2,36,95,141,79,25,5,24,47,78,49,14,2,12,48,63,30,11,3,641,376,265,278,129,149,106,151,252,61,58,14,61,94,131,46,30,11,45,57,121,15,28,3,29,59,94,46,30,16,13,24,40,31,11,8,16,35,54,15,19,8,835,447,388,322,150,172,128,179,229,161,70,47,65,94,124,97,40,20,63,85,105,64,30,27,52,54,89,68,37,20,24,21,48,30,18,9,28,33,41,38,19,11,916,479,437,403,189,214,82,201,399,148,26,17,57,61,242,69,12,10,25,140,157,79,14,7,67,58,129,87,38,12,34,15,70,40,18,7,33,43,59,47,20,5,1227,701,526,423,218,205,124,223,544,237,65,21,76,119,308,150,26,17,48,104,236,87,39,4,58,66,148,84,43,16,34,26,68,56,23,7,24,40,80,28,20,9,1140,593,547,381,195,186,103,206,465,240,81,25,79,88,238,131,42,4,24,118,227,109,39,21,43,53,125,97,38,20,27,21,60,57,19,8,16,32,65,40,19,12,719,339,380,413,196,217,90,109,323,134,38,7,39,52,152,63,20,4,51,57,171,71,18,3,45,59,164,78,49,13,22,29,73,37,27,7,23,30,91,41,22,6,588,263,325,416,209,207,103,106,185,160,24,-14,47,55,41,113,0,-3,56,51,144,47,24,-11,55,54,146,110,26,10,36,22,58,70,10,6,19,32,88,40,16,4,608,293,315,409,184,225,62,175,174,169,23,-6,10,86,71,112,13,-5,52,89,103,57,10,-1,79,59,120,103,28,14,39,25,50,48,15,4,40,34,70,55,13,10,779,409,370,545,270,275,14,169,347,153,80,6,12,74,184,78,38,11,2,95,163,75,42,-5,69,73,199,121,56,21,34,35,92,64,27,14,35,38,107,57,29,7
7,07052,Sant Lluís,4257,295,130,165,74,33,41,34,62,63,58,56,14,9,29,31,24,28,6,25,33,32,34,28,8,13,7,11,13,23,7,2,3,7,8,9,4,11,4,4,5,14,3,266,145,121,73,38,35,42,44,85,66,20,5,28,22,46,30,12,5,14,22,39,36,8,0,12,11,23,9,9,6,7,3,14,3,5,4,5,8,9,6,4,2,351,167,184,132,58,74,56,54,92,46,69,17,30,24,38,25,35,6,26,30,54,21,34,11,19,12,32,21,36,9,6,6,12,13,17,2,13,6,20,8,19,7,381,204,177,198,104,94,53,73,79,66,79,10,32,41,49,31,43,-1,21,32,30,35,36,11,36,26,31,31,57,14,20,13,15,16,31,6,16,13,16,15,26,8,286,187,99,143,72,71,45,20,74,59,56,21,22,23,53,39,32,11,23,-3,21,20,24,10,27,7,36,29,32,10,14,3,17,14,16,7,13,4,19,15,16,3,267,133,134,155,71,84,64,11,75,38,44,26,28,4,43,17,22,13,36,7,32,21,22,13,37,12,35,18,34,17,16,7,17,8,16,7,21,5,18,10,18,10,255,142,113,167,84,83,21,62,60,38,46,18,17,29,34,16,26,15,4,33,26,22,20,3,26,33,36,26,29,14,12,16,17,12,14,11,14,17,19,14,15,3,282,115,167,130,56,74,34,41,71,69,47,18,7,7,31,38,24,9,27,34,40,31,23,9,8,32,27,24,29,10,4,14,11,8,12,7,4,18,16,16,17,3,247,141,106,123,58,65,9,43,88,41,44,10,9,14,60,22,21,10,0,29,28,19,23,0,18,27,22,23,23,8,11,6,14,9,12,5,7,21,8,14,11,3,75,18,57,95,48,47,5,-1,1,11,42,9,-5,-2,-2,-6,24,5,10,1,3,17,18,4,3,13,12,14,36,13,0,6,8,5,18,9,3,7,4,9,18,4,140,65,75,98,46,52,19,43,2,29,30,10,11,17,8,7,13,4,8,26,-6,22,17,6,5,28,13,17,20,14,3,10,7,10,9,7,2,18,6,7,11,7,64,34,30,73,32,41,38,10,10,14,-6,-6,23,3,16,3,-6,-7,15,7,-6,11,0,1,10,18,15,8,12,6,7,6,9,4,5,0,3,12,6,4,7,6,43,12,31,46,18,28,11,14,11,15,-3,-6,1,10,-3,7,-4,-2,10,4,14,8,1,-4,-4,2,19,6,11,11,-5,0,7,5,7,4,1,2,12,1,4,7,70,57,13,28,13,15,5,14,29,-8,23,6,9,7,19,5,15,2,-4,7,10,-13,8,4,1,6,7,-1,11,3,0,1,7,-3,4,4,1,5,0,2,7,-1,60,0,60,28,10,18,14,16,23,12,14,-23,-10,9,1,-2,10,-8,24,7,22,14,4,-15,-1,5,10,14,4,-5,-3,0,3,4,4,2,2,5,7,10,0,-7,-309,-146,-163,-243,-117,-126,-8,-16,-58,-81,-36,-113,-3,-8,-28,-35,-16,-57,-5,-8,-30,-46,-20,-56,-2,-11,-57,-49,-31,-95,-2,-5,-28,-25,-13,-46,0,-6,-29,-24,-18,-49,-268,-126,-142,-258,-134,-124,-40,-3,-42,-12,-35,-144,-16,12,-29,-8,-12,-76,-24,-15,-13,-4,-23,-68,-23,-12,-26,-29,-39,-130,-12,-3,-18,-15,-18,-68,-11,-9,-8,-14,-21,-62,53,33,20,108,53,55,0,13,19,25,-18,13,3,8,1,17,-8,9,-3,5,18,8,-10,4,8,14,18,23,20,23,3,11,5,13,9,10,5,3,13,10,11,13
7,07053,Santa Eugènia,1143,45,20,25,38,19,19,8,-1,14,22,8,-3,-2,0,9,11,4,1,10,-1,5,11,4,-4,6,2,9,11,7,3,3,0,5,6,3,2,3,2,4,5,4,1,49,31,18,31,20,11,0,7,22,5,7,4,4,1,11,7,4,0,-4,6,11,-2,3,4,2,3,16,5,2,0,2,1,9,4,1,0,0,2,7,1,1,0,39,28,11,17,9,8,1,1,14,8,6,3,1,4,9,5,1,5,0,-3,5,3,5,-2,1,3,10,0,1,1,1,0,6,0,1,1,0,3,4,0,0,0,63,50,13,17,9,8,11,5,25,14,2,2,9,7,20,5,3,3,2,-2,5,9,-1,-1,3,2,7,2,1,2,2,1,3,1,1,1,1,1,4,1,0,1,35,31,4,18,10,8,3,-1,16,8,9,1,4,1,13,5,6,1,-1,-2,3,3,3,0,0,2,7,2,4,3,0,0,4,2,2,2,0,2,3,0,2,1,20,11,9,16,9,7,-1,4,2,0,9,5,-5,5,3,3,2,4,4,-1,-1,-3,7,1,3,2,6,0,1,3,2,1,4,0,0,2,1,1,2,0,1,1,74,41,33,23,8,15,20,1,35,8,9,2,9,0,18,5,6,3,11,1,17,3,3,-1,6,1,7,5,4,0,1,0,1,3,3,0,5,1,6,2,1,0,69,46,23,37,21,16,12,1,18,23,8,7,13,2,4,12,7,8,-1,-1,14,11,1,-1,3,5,12,13,1,2,3,2,6,8,1,1,0,3,6,5,0,1,88,58,30,36,24,12,16,3,22,34,8,5,10,1,15,24,6,1,6,2,7,10,2,4,2,6,9,11,3,3,1,4,6,10,2,1,1,2,3,1,1,2,-44,-31,-13,-68,-42,-26,2,2,-17,-14,-13,-4,0,3,-8,-15,-8,-2,2,-1,-9,1,-5,-2,-3,-1,-20,-19,-18,-6,-3,-1,-11,-12,-10,-4,0,0,-9,-7,-8,-2,43,22,21,21,11,10,5,7,25,5,0,1,2,-2,16,3,0,3,3,9,9,2,0,-2,3,4,8,0,3,3,1,1,5,0,1,3,2,3,3,0,2,0,61,38,23,13,8,5,13,4,15,27,1,0,10,2,6,20,-1,0,3,2,9,7,2,0,2,0,4,6,2,-1,2,0,2,4,1,-1,0,0,2,2,1,0,28,11,17,6,4,2,14,0,0,19,0,-6,9,-2,-2,5,2,-2,5,2,2,14,-2,-4,0,1,1,5,-1,0,1,0,0,3,0,0,-1,1,1,2,-1,0,-47,-26,-21,-49,-25,-24,-5,-2,3,-34,4,-13,-2,0,-1,-18,0,-6,-3,-2,4,-16,4,-7,-2,-9,-3,-22,-5,-8,0,-6,-1,-11,-3,-4,-2,-3,-2,-11,-2,-4,1,10,-9,23,15,8,-4,-6,13,4,-5,-2,0,-3,11,7,-5,0,-4,-3,2,-3,0,-2,1,3,4,11,1,3,3,2,3,6,0,1,-2,1,1,5,1,2,26,8,18,13,5,8,-2,4,15,3,-3,7,0,-5,9,4,-6,5,-2,9,6,-1,3,2,0,2,1,5,-1,4,0,0,0,5,-2,1,0,2,1,0,1,3,27,15,12,16,8,8,9,-3,7,6,14,-4,1,3,6,0,5,0,8,-6,1,6,9,-4,3,1,6,1,5,0,1,0,3,0,4,0,2,1,3,1,1,0,41,16,25,15,5,10,5,8,6,9,5,4,0,1,4,4,3,0,5,7,2,5,2,4,2,1,3,5,0,3,1,0,1,2,0,1,1,1,2,3,0,2
7,07054,Santa Eulalia del Río,21122,525,275,250,342,187,155,24,155,197,76,50,22,14,60,128,39,23,11,10,95,69,37,27,11,33,56,121,80,36,15,15,29,75,41,19,8,18,27,46,39,17,7,1226,677,549,762,425,337,124,270,439,258,99,28,58,124,275,149,57,8,66,146,164,109,42,20,109,134,253,173,69,19,49,72,144,108,42,8,60,62,109,65,27,11,1053,521,532,784,417,367,126,252,386,156,111,21,47,134,195,78,56,8,79,118,191,78,55,13,135,142,241,154,89,16,67,76,123,90,48,8,68,66,118,64,41,8,1319,718,601,901,487,414,127,320,401,235,161,35,57,141,243,138,93,25,70,179,158,97,68,10,117,171,247,211,121,23,57,85,140,128,61,12,60,86,107,83,60,11,855,460,395,773,414,359,75,182,253,218,91,34,56,103,133,119,38,14,19,79,120,99,53,20,92,127,244,177,91,36,53,72,127,98,41,21,39,55,117,79,50,15,1229,613,616,962,479,483,135,311,398,171,139,60,74,147,208,87,61,30,61,164,190,84,78,30,121,192,295,191,113,41,57,85,147,112,53,22,64,107,148,79,60,19,1379,776,603,993,553,440,168,312,461,233,165,33,76,150,289,149,90,17,92,162,172,84,75,16,124,193,294,224,121,33,68,97,171,133,62,19,56,96,123,91,59,14,1709,920,789,1327,684,643,174,399,574,330,146,60,97,180,338,184,84,28,77,219,236,146,62,32,129,342,407,259,134,46,58,152,226,144,78,21,71,190,181,115,56,25,1258,625,633,867,435,432,128,321,365,225,124,81,45,167,180,129,53,44,83,154,185,96,71,37,118,189,234,178,98,43,55,84,117,100,51,24,63,105,117,78,47,19,1166,581,585,588,281,307,167,239,429,176,89,44,80,104,231,95,43,12,87,135,198,81,46,32,92,108,174,118,67,24,49,45,81,63,34,7,43,63,93,55,33,17,845,410,435,472,228,244,88,192,297,186,36,31,51,90,138,82,32,11,37,102,159,104,4,20,61,82,140,102,53,28,33,30,76,47,28,11,28,52,64,55,25,17,1059,558,501,568,300,268,149,162,386,208,99,34,76,79,209,122,38,24,73,83,177,86,61,10,72,80,183,114,76,31,40,37,100,66,34,16,32,43,83,48,42,15,1188,611,577,346,139,207,145,218,427,265,98,5,61,103,227,166,35,5,84,115,200,99,63,0,54,55,83,90,40,13,14,20,35,38,15,13,40,35,48,52,25,0,1174,630,544,519,243,276,122,192,470,250,85,19,69,95,247,155,43,8,53,97,223,95,42,11,84,48,155,141,57,18,32,10,70,82,36,9,52,38,85,59,21,9,1218,558,660,734,348,386,175,193,446,265,68,43,73,90,232,123,10,15,102,103,214,142,58,28,117,86,238,178,61,34,65,29,106,95,23,18,52,57,132,83,38,16,1050,502,548,737,369,368,96,200,389,267,56,17,51,98,185,110,49,-9,45,102,204,157,7,26,92,115,260,166,75,17,50,56,125,87,41,4,42,59,135,79,34,13,1002,544,458,797,405,392,118,232,339,226,66,3,73,107,198,135,25,-1,45,125,141,91,41,4,123,123,250,183,77,26,66,54,121,105,39,12,57,69,129,78,38,14,862,454,408,757,358,399,82,196,340,184,26,35,36,109,153,122,33,3,46,87,187,62,-7,32,105,88,232,194,79,49,55,38,98,98,48,18,50,50,134,96,31,31
7,07055,Santa Margalida,7493,422,237,185,249,119,130,45,107,140,72,45,14,26,53,79,49,25,5,19,54,61,23,20,9,33,39,74,51,41,10,15,16,32,28,21,6,18,23,42,23,20,4,373,191,182,286,150,136,60,93,111,61,39,9,30,42,64,25,23,8,30,51,47,36,16,1,59,53,89,38,38,8,33,25,45,18,24,5,26,28,44,20,14,3,383,229,154,302,149,153,8,114,109,58,56,30,11,65,67,33,28,17,-3,49,42,25,28,13,40,55,85,50,56,13,17,22,46,28,26,8,23,33,39,22,30,5,459,262,197,286,142,144,89,105,100,77,53,29,54,57,53,54,23,13,35,48,47,23,30,16,57,57,69,52,38,11,32,23,31,30,17,7,25,34,38,22,21,4,353,203,150,302,157,145,26,101,69,77,56,22,12,46,46,53,26,18,14,55,23,24,30,4,45,63,69,59,46,18,19,29,40,36,19,12,26,34,29,23,27,6,414,247,167,342,179,163,40,116,110,75,58,9,18,65,73,47,31,8,22,51,37,28,27,1,50,78,71,68,63,9,27,39,40,37,31,4,23,39,31,31,32,5,571,263,308,372,185,187,53,128,165,119,62,38,19,60,86,55,26,13,34,68,79,64,36,25,37,100,93,69,53,19,17,52,46,38,22,9,20,48,47,31,31,10,686,377,309,415,200,215,110,152,204,121,62,31,49,72,128,70,35,20,61,80,76,51,27,11,59,100,118,68,46,21,24,43,64,32,23,13,35,57,54,36,23,8,514,312,202,428,238,190,31,171,172,70,39,26,30,94,116,39,17,16,1,77,56,31,22,10,52,122,143,75,25,8,30,60,87,42,13,5,22,62,56,33,12,3,166,91,75,237,117,120,-16,58,24,44,24,23,-8,17,34,21,13,8,-8,41,-10,23,11,15,23,71,73,43,13,10,13,27,41,24,6,3,10,44,32,19,7,7,128,62,66,162,80,82,19,37,15,-31,12,70,9,31,-8,-16,10,32,10,6,23,-15,2,38,25,37,49,26,14,9,17,18,23,10,8,2,8,19,26,16,6,7,139,86,53,126,68,58,7,45,7,26,11,35,13,14,6,27,-1,18,-6,31,1,-1,12,17,4,46,35,25,8,3,3,19,22,11,7,3,1,27,13,14,1,0,118,59,59,79,45,34,8,46,15,14,-12,36,-3,35,6,10,-6,10,11,11,9,4,-6,26,21,29,8,6,6,3,17,16,2,0,5,2,4,13,6,6,1,1,51,49,2,45,26,19,-35,23,8,5,28,24,-11,19,10,-1,21,9,-24,4,-2,6,7,15,-17,23,17,7,16,-2,-7,7,14,5,8,-2,-10,16,3,2,8,0,148,70,78,5,-21,26,33,16,44,7,24,21,24,11,19,-6,13,7,9,5,25,13,11,14,1,8,6,-13,0,2,-4,0,-3,-10,-6,2,5,8,9,-3,6,0,-2,-29,27,-45,-46,1,-6,59,-11,-37,1,-9,-4,35,-9,-41,-5,-4,-2,24,-2,4,6,-5,-7,31,0,-40,-8,-21,-3,12,-8,-32,-7,-8,-4,19,8,-8,-1,-13,218,124,94,150,69,81,-10,74,47,40,28,31,2,39,29,35,5,11,-12,35,18,5,23,20,20,24,45,33,18,7,11,15,20,9,8,4,9,9,25,24,10,3,339,182,157,223,92,131,3,103,92,78,25,30,-9,62,51,44,16,12,12,41,41,34,9,18,30,49,75,45,16,7,8,25,33,20,4,2,22,24,42,25,12,5
7,07057,Santanyí,8467,-166,-77,-89,36,19,17,-44,-39,-47,-20,-6,-10,-19,-12,-22,-18,-4,-3,-25,-27,-25,-2,-2,-7,3,3,8,13,6,2,2,2,4,5,4,1,1,1,4,8,2,1,541,297,244,346,184,162,60,145,176,80,66,12,24,76,109,45,34,9,36,69,67,35,32,3,50,67,95,66,52,15,22,39,51,35,27,10,28,28,44,31,25,5,314,149,165,385,188,197,51,64,43,66,80,16,29,32,10,34,37,7,22,32,33,32,43,9,71,58,97,66,73,16,36,23,47,36,36,9,35,35,50,30,37,7,321,140,181,479,229,250,32,42,35,73,112,27,15,11,27,16,53,18,17,31,8,57,59,9,58,64,110,97,128,20,23,24,58,47,62,15,35,40,52,50,66,5,285,119,166,393,200,193,26,44,42,67,72,29,3,24,12,37,32,12,23,20,30,30,40,17,67,58,88,89,74,14,30,31,40,55,36,8,37,27,48,34,38,6,584,288,296,581,287,294,49,103,153,132,112,37,15,52,66,73,65,18,34,51,87,59,47,19,58,104,145,128,112,32,25,48,63,70,60,20,33,56,82,58,52,12,569,304,265,583,303,280,57,137,96,134,111,35,33,55,71,62,65,20,24,82,25,72,46,15,73,108,122,128,112,37,45,40,72,60,66,20,28,68,50,68,46,17,626,330,296,624,354,270,64,76,132,137,158,57,49,36,51,67,91,38,15,40,81,70,67,19,65,89,139,133,148,47,50,44,67,76,85,30,15,45,72,57,63,17,404,241,163,321,156,165,69,100,98,71,45,12,37,64,68,40,20,6,32,36,30,31,25,6,46,74,89,54,42,10,25,30,45,26,21,5,21,44,44,28,21,5,219,138,81,308,149,159,3,38,64,51,44,21,-4,24,48,36,23,12,7,14,16,15,21,9,31,53,69,80,50,20,15,22,29,43,24,13,16,31,40,37,26,7,299,129,170,249,136,113,7,53,68,41,40,88,10,15,25,28,17,32,-3,38,43,13,23,56,27,47,61,56,41,17,20,17,34,31,21,13,7,30,27,25,20,4,213,110,103,240,129,111,-1,38,30,47,61,39,2,25,5,26,34,19,-3,13,25,21,27,20,27,28,59,55,53,18,20,17,22,31,30,9,7,11,37,24,23,9,254,109,145,217,108,109,31,63,45,52,27,31,14,19,20,27,11,14,17,44,25,25,16,17,28,38,50,45,34,17,13,15,23,27,16,10,15,23,27,18,18,7,171,73,98,165,78,87,43,19,18,41,17,28,32,9,13,17,3,0,11,10,5,24,14,28,33,22,29,37,33,5,21,9,14,17,16,1,12,13,15,20,17,4,15,-29,44,130,48,82,16,11,-3,-13,-6,8,-1,-2,-17,-15,0,5,17,13,14,2,-6,3,22,18,26,28,22,10,12,3,6,8,10,6,10,15,20,20,12,4,167,48,119,188,83,105,-6,28,47,40,20,36,-19,12,6,25,13,9,13,16,41,15,7,27,14,26,58,40,34,12,5,12,25,19,17,2,9,14,33,21,17,10,179,118,61,161,93,68,-5,62,32,35,30,31,3,28,36,23,18,16,-8,34,-4,12,12,15,6,43,39,21,42,6,6,15,28,14,22,7,0,28,11,7,20,-1,277,199,78,210,145,65,31,44,67,68,26,38,17,43,46,44,25,22,14,1,21,24,1,16,21,32,54,65,27,7,15,23,36,39,23,7,6,9,18,26,4,0
7,07058,Selva,2909,3,6,-3,29,15,14,-10,11,0,-7,12,-1,-4,5,-2,-3,7,4,-6,6,2,-4,5,-5,4,6,5,6,5,3,3,4,1,2,3,2,1,2,4,4,2,1,47,18,29,21,5,16,16,7,15,-1,9,1,10,3,7,-3,3,-2,6,4,8,2,6,3,5,1,6,6,3,0,1,0,2,1,1,0,4,1,4,5,2,0,76,42,34,42,15,27,2,23,21,11,13,3,4,13,8,4,7,5,-2,10,13,7,6,-2,8,11,11,4,6,1,5,2,4,2,1,1,3,9,7,2,5,0,83,32,51,36,17,19,22,7,25,12,15,3,11,0,7,5,9,1,11,7,18,7,6,2,11,2,14,4,4,1,5,1,7,2,1,1,6,1,7,2,3,0,104,65,39,37,19,18,16,6,48,27,12,-6,16,2,27,14,8,-3,0,4,21,13,4,-3,5,3,14,6,7,0,2,0,8,4,4,0,3,3,6,2,3,0,26,31,-5,24,16,8,1,5,-3,11,12,0,3,4,4,8,9,3,-2,1,-7,3,3,-3,1,4,4,8,5,2,0,3,2,6,4,1,1,1,2,2,1,1,118,72,46,36,17,19,24,15,26,30,17,8,8,11,15,22,12,4,16,4,11,8,5,4,1,4,6,8,10,7,1,1,4,3,5,3,0,3,2,5,5,4,60,35,25,29,16,13,8,10,17,14,11,1,9,4,6,6,8,4,-1,6,11,8,3,-3,5,6,7,0,8,5,6,3,3,1,3,2,-1,3,4,-1,5,3,90,48,42,40,17,23,18,11,37,9,17,-4,4,7,19,8,11,-2,14,4,18,1,6,-2,7,6,12,6,6,0,1,3,5,2,4,0,6,3,7,4,2,0,99,70,29,33,18,15,17,20,15,34,7,5,18,20,9,19,1,1,-1,0,6,15,6,4,3,8,7,6,6,3,2,6,3,3,3,1,1,2,4,3,3,2,89,43,46,16,5,11,19,10,26,20,12,4,11,9,9,8,6,2,8,1,17,12,6,2,2,1,0,5,7,1,1,-2,-1,3,4,0,1,3,1,2,3,1,1,-9,10,-16,-15,-1,0,-7,-13,5,11,5,-2,-5,-6,-3,5,4,2,-2,-7,8,6,1,2,-3,-12,1,-2,-2,1,-1,-10,-2,-3,0,1,-2,-2,3,1,-2,19,25,-6,-22,-8,-14,3,7,2,1,3,2,8,10,6,-1,-2,5,-5,-3,-4,2,5,-3,-3,3,-2,-12,-1,-7,0,3,-1,-7,-1,-2,-3,0,-1,-5,0,-5,-10,-17,7,-48,-29,-19,-3,4,11,7,-16,-12,1,1,0,-2,-10,-7,-4,3,11,9,-6,-5,-7,0,3,-9,-19,-16,-3,0,6,-9,-13,-10,-4,0,-3,0,-6,-6,22,13,9,16,12,4,14,-12,0,2,7,7,7,-5,0,1,4,5,7,-7,0,1,3,2,1,0,1,7,6,1,1,2,-1,5,3,2,0,-2,2,2,3,-1,-8,-18,10,-8,-9,1,14,-12,-9,-4,5,-3,7,-13,-7,-5,2,-2,7,1,-2,1,3,-1,4,-1,-2,-3,-4,-3,0,-3,-2,-2,-2,-1,4,2,0,-1,-2,-2,17,10,7,15,5,10,4,5,7,3,1,-7,2,5,1,6,0,-7,2,0,6,-3,1,0,2,8,5,-1,8,-8,0,8,1,-3,4,-6,2,0,4,2,4,-2,116,57,59,51,22,29,28,-1,44,42,-1,-2,11,0,14,31,-5,4,17,-1,30,11,4,-6,17,3,18,11,-1,-1,9,0,7,4,0,0,8,3,11,7,-1,-1
7,07047,Sencelles,2057,110,58,52,25,9,16,24,7,28,29,15,9,19,5,13,14,7,1,5,2,15,15,8,8,1,1,7,6,8,2,1,0,3,4,1,0,0,1,4,2,7,2,128,51,77,24,9,15,22,19,55,29,2,1,4,7,26,11,2,1,18,12,29,18,0,0,3,6,8,6,1,0,1,1,3,3,1,0,2,5,5,3,0,0,131,68,63,51,22,29,19,8,48,11,35,8,8,-1,28,12,11,6,11,9,20,-1,24,2,10,2,11,10,14,4,4,1,6,5,4,2,6,1,5,5,10,2,135,76,59,24,13,11,16,12,41,32,19,15,9,6,20,23,15,6,7,6,21,9,4,9,3,4,5,4,4,3,2,2,3,1,3,2,1,2,2,3,1,1,91,61,30,28,14,14,27,8,27,18,3,9,24,11,8,7,5,7,3,-3,19,11,-2,2,7,2,6,5,2,5,5,2,1,2,1,2,2,0,5,3,1,3,92,50,42,33,19,14,13,17,22,17,18,5,11,5,10,10,10,3,2,12,12,7,8,2,7,6,4,8,7,1,3,1,5,7,3,0,4,5,-1,1,4,1,150,82,68,53,32,21,27,13,32,43,24,6,13,5,17,27,15,2,14,8,15,16,9,4,8,9,11,12,8,3,5,6,5,8,7,1,3,3,6,4,1,2,90,43,47,37,15,22,12,14,42,21,14,-13,-1,3,24,13,9,-3,13,11,18,8,5,-10,5,7,8,9,7,1,1,2,3,6,3,0,4,5,5,3,4,1,56,25,31,31,18,13,11,9,28,12,-1,-4,6,4,15,5,1,-6,5,5,13,7,-2,2,4,3,14,8,2,0,1,2,9,5,1,0,3,1,5,3,1,0,56,31,25,22,9,13,1,8,14,22,6,6,0,5,14,12,-3,3,1,3,0,10,9,3,5,1,3,3,8,2,0,0,3,2,2,2,5,1,0,1,6,0,-13,-5,-8,11,9,2,-14,14,-6,0,-4,-4,-7,6,3,-5,1,-4,-7,8,-9,5,-5,0,-1,3,4,4,2,0,1,2,4,2,1,0,-2,1,0,2,1,0,52,28,24,20,8,12,9,1,8,15,13,8,6,3,0,7,11,4,3,-2,8,8,2,4,0,5,3,5,5,2,-1,1,4,0,3,1,1,4,-1,5,2,1,64,28,36,31,18,13,13,11,28,5,7,-3,5,9,14,-5,6,-3,8,2,14,10,1,0,6,4,9,9,3,-1,2,4,5,4,2,0,4,0,4,5,1,-1,47,4,43,26,15,11,4,-8,29,16,3,2,-7,-9,8,12,-2,1,11,1,21,4,5,1,1,-1,13,7,3,3,0,-1,6,5,3,2,1,0,7,2,0,1,9,17,-8,20,9,11,-19,5,13,7,-3,11,-3,3,8,9,-1,4,-16,2,5,-2,-2,7,4,2,3,3,4,3,1,1,2,1,1,2,3,1,1,2,3,1,21,11,10,-2,-1,-1,7,4,2,1,13,-7,4,-1,8,-3,6,-4,3,5,-6,4,7,-3,-2,2,1,-1,-1,-1,-2,2,3,-2,-2,0,0,0,-2,1,1,-1,16,-4,20,26,12,14,-4,-4,11,7,8,-1,-4,-5,2,3,1,1,0,1,9,4,7,-2,2,2,10,6,7,-1,1,0,5,4,2,0,1,2,5,2,5,-1,100,60,40,32,14,18,22,7,20,24,22,3,9,6,15,10,18,0,13,1,5,14,4,3,4,2,6,5,11,3,0,0,4,4,6,0,4,2,2,1,5,3
7,07060,Sineu,2675,101,52,49,42,24,18,17,16,23,29,12,3,4,9,10,20,8,1,13,7,13,9,4,2,8,6,10,13,5,0,4,3,6,8,3,0,4,3,4,5,2,0,58,33,25,44,24,20,15,14,10,12,5,0,8,6,11,4,2,1,7,8,-1,8,3,-1,12,7,4,13,6,1,6,4,3,7,3,0,6,3,1,6,3,1,63,33,30,60,30,30,-3,20,19,16,10,3,-1,11,12,6,6,-1,-2,9,7,10,4,4,8,18,9,14,9,2,2,9,4,10,4,1,6,9,5,4,5,1,110,65,45,44,20,24,18,16,34,28,7,7,8,9,23,16,6,3,10,7,11,12,1,4,8,10,11,11,4,0,2,5,5,5,3,0,6,5,6,6,1,0,110,56,54,42,24,18,20,21,15,24,16,15,8,12,11,5,10,9,12,9,4,19,6,6,2,13,11,6,6,4,0,9,8,1,3,3,2,4,3,5,3,1,114,76,38,39,26,13,5,21,39,27,14,9,4,16,24,18,11,4,1,5,15,9,3,5,5,7,14,7,4,2,3,6,11,3,2,1,2,1,3,4,2,1,120,74,46,55,29,26,35,12,20,27,21,3,22,7,19,18,10,-1,13,5,1,9,11,4,11,7,12,16,7,2,4,4,8,9,3,1,7,3,4,7,4,1,152,70,82,46,20,26,21,13,41,30,23,17,12,1,21,17,10,6,9,12,20,13,13,11,4,7,5,7,15,6,2,3,0,4,7,3,2,4,5,3,8,3,119,66,53,42,24,18,10,15,55,24,14,1,4,8,32,14,10,-1,6,7,23,10,4,2,7,8,15,8,4,0,3,5,8,5,3,0,4,3,7,3,1,0,133,74,59,33,18,15,12,22,47,17,19,10,14,5,25,15,8,2,-2,17,22,2,11,8,10,2,4,14,2,1,8,1,2,6,1,0,2,1,2,8,1,1,69,58,11,-9,-3,-6,21,6,6,33,7,-9,19,0,16,16,7,-4,2,6,-10,17,0,-5,-1,1,-10,-2,3,-1,0,0,-3,-3,2,0,-1,1,-7,1,1,-1,69,62,7,26,16,10,12,13,5,16,4,19,12,10,12,12,3,12,0,3,-7,4,1,7,0,4,4,10,4,4,-1,3,4,7,3,1,1,1,0,3,1,3,-68,-29,-39,-30,-21,-9,-29,-6,-10,-9,-2,-8,-18,-2,-2,4,-1,-6,-11,-4,-8,-13,-1,-2,-3,-5,-14,-2,-5,-1,-3,-4,-7,-2,-3,-2,0,-1,-7,0,-2,1,86,36,50,26,15,11,21,3,29,19,12,1,4,0,21,4,6,0,17,3,8,15,6,1,1,4,8,2,7,3,1,2,6,0,3,2,0,2,2,2,4,1,45,13,32,26,13,13,-3,6,6,3,19,14,-3,-1,-6,2,15,7,0,7,12,1,4,7,0,5,6,7,6,2,2,1,4,2,3,1,-2,4,2,5,3,1,56,45,11,12,4,8,6,-4,27,20,9,-5,5,-3,18,20,4,-2,1,-1,9,0,5,-3,-6,3,7,6,3,-1,-4,1,4,2,1,0,-2,2,3,4,2,-1,54,17,37,44,14,30,18,3,9,25,-1,-5,10,-3,3,5,0,-2,8,6,6,20,-1,-3,4,6,7,18,4,3,2,1,4,5,1,1,2,5,3,13,3,2,143,90,53,73,47,26,17,8,40,44,18,12,13,8,26,26,8,6,4,0,14,18,10,6,11,11,14,28,8,1,10,8,8,16,5,0,1,3,6,12,3,1
7,07061,Sóller,11464,131,94,37,16,8,8,19,29,59,31,-1,-12,10,28,32,24,-2,0,9,1,27,7,1,-12,8,2,2,0,4,0,3,2,2,0,1,0,5,0,0,0,3,0,161,102,59,10,6,4,3,81,47,21,1,10,4,50,28,13,3,4,-1,31,19,8,-2,6,6,1,0,1,1,1,4,0,0,1,1,0,2,1,0,0,0,1,196,106,90,95,48,47,39,51,49,31,16,2,16,22,36,16,10,4,23,29,13,15,6,-2,15,15,32,18,8,7,7,7,15,8,7,4,8,8,17,10,1,3,262,125,137,262,134,128,28,61,76,44,57,-1,18,22,40,22,27,-1,10,39,36,22,30,0,40,44,80,45,44,7,22,15,46,23,25,2,18,29,34,22,19,5,343,165,178,264,124,140,22,64,103,69,58,22,14,24,53,25,32,13,8,40,50,44,26,9,32,31,66,47,56,27,14,8,40,18,28,14,18,23,26,29,28,13,411,229,182,226,99,127,31,96,132,94,50,6,15,55,84,47,22,5,16,41,48,47,28,1,31,44,57,45,39,8,16,18,28,19,13,5,15,26,29,26,26,3,391,209,182,343,188,155,73,104,79,51,56,25,47,45,47,31,29,12,26,59,32,20,27,13,64,69,82,59,46,21,39,34,49,34,23,9,25,35,33,25,23,12,416,211,205,318,174,144,49,116,110,71,52,15,22,63,56,38,25,7,27,53,54,33,27,8,40,74,90,58,45,9,19,38,59,32,20,5,21,36,31,26,25,4,326,158,168,208,106,102,57,49,104,75,25,13,28,22,53,34,10,9,29,27,51,41,15,4,38,34,48,48,25,14,19,13,27,27,11,8,19,21,21,21,14,6,175,75,100,140,57,83,7,66,18,56,16,8,-1,26,22,23,6,-2,8,40,-4,33,10,10,17,32,25,38,18,7,5,8,14,19,8,2,12,24,11,19,10,5,112,80,32,49,33,16,-11,41,37,30,14,2,0,31,25,20,10,-7,-11,10,12,10,4,9,5,16,12,16,6,-7,6,9,6,13,3,-5,-1,7,6,3,3,-2,30,0,30,80,21,59,4,20,-14,-6,11,18,5,11,-19,-7,2,8,-1,9,5,1,9,10,14,17,15,11,14,5,8,6,2,-6,7,2,6,11,13,17,7,3,165,72,93,64,25,39,27,45,61,12,20,1,11,26,38,-10,4,2,16,19,23,22,16,-1,7,10,12,14,21,0,0,3,3,3,14,1,7,7,9,11,7,-1,126,86,40,59,26,33,-23,41,96,6,18,-3,-11,22,57,18,11,-6,-12,19,39,-12,7,3,4,15,23,10,12,-5,1,1,12,8,7,-3,3,14,11,2,5,-2,133,53,80,140,63,77,-5,53,43,-1,40,0,-13,27,26,-4,19,-7,8,26,17,3,21,7,17,29,34,31,21,5,6,13,11,17,12,0,11,16,23,14,9,5,243,126,117,149,65,84,27,81,95,44,-1,5,20,39,54,18,4,-5,7,42,41,26,-5,10,32,26,39,33,16,3,18,9,19,11,9,-1,14,17,20,22,7,4,125,63,62,83,43,40,3,84,33,6,-3,4,-6,43,19,11,-2,-1,9,41,14,-5,-1,5,2,36,25,4,10,5,1,20,11,1,3,6,1,16,14,3,7,-1,298,121,177,171,80,91,8,62,66,37,17,109,3,26,34,11,11,35,5,36,32,26,6,74,32,20,51,44,15,6,11,9,21,24,9,3,21,11,30,20,6,3
7,07063,Valldemossa,1651,106,62,44,38,19,19,7,14,38,26,11,10,4,11,21,15,5,6,3,3,17,11,6,4,4,1,22,5,5,1,2,1,11,2,2,1,2,0,11,3,3,0,28,17,11,13,8,5,13,3,11,2,1,-1,5,4,7,3,0,-1,8,-1,4,-1,1,0,1,0,9,2,1,0,1,0,5,2,0,0,0,0,4,0,1,0,-2,-1,-1,32,15,17,1,4,-22,16,2,-3,-2,1,-11,11,2,-1,3,3,-11,5,0,-2,8,4,10,6,2,2,4,2,4,3,1,1,4,2,6,3,1,1,52,38,14,34,16,18,-1,4,21,13,10,1,0,2,18,5,8,2,-1,2,3,8,2,-1,3,4,13,4,7,2,1,0,8,2,4,1,2,4,5,2,3,1,80,52,28,39,18,21,14,9,19,23,11,8,9,7,15,12,8,3,5,2,4,11,3,5,4,7,8,10,7,3,2,3,4,4,4,1,2,4,4,6,3,2,-12,-4,-8,23,9,14,3,-3,7,-12,-5,-2,-1,-2,10,-6,-5,-1,4,-1,-3,-6,0,-1,6,1,8,4,2,1,3,0,3,1,1,0,3,1,5,3,1,1,55,26,29,35,14,21,8,16,6,22,4,0,7,6,-5,10,6,2,1,10,11,12,-2,-2,7,10,6,7,5,0,4,3,1,2,4,0,3,7,5,5,1,0,5,6,-1,30,15,15,4,3,-9,9,0,-1,2,3,-1,2,0,2,2,0,-8,7,0,-3,6,4,4,9,2,4,2,1,5,4,1,2,4,3,-1,5,1,2,37,26,11,13,9,4,8,7,21,6,-3,-1,7,2,14,6,-4,1,1,5,7,0,1,-2,1,3,7,2,-2,2,1,2,2,4,-1,1,0,1,5,-2,-1,1,51,24,27,5,3,2,18,3,24,-6,4,2,10,2,8,-2,1,1,8,1,16,-4,3,1,6,0,4,-4,1,-3,4,0,2,-2,-1,-1,2,0,2,-2,2,-2,-19,-4,-15,9,5,4,2,-3,-1,-14,4,-6,1,2,0,-13,5,1,1,-5,-1,-1,-1,-7,4,-1,1,0,5,0,3,-1,1,-1,2,1,1,0,0,1,3,-1,8,17,-9,7,4,3,2,-7,4,13,0,-4,4,-2,5,10,5,-5,-2,-5,-1,3,-5,1,0,-2,4,3,2,-2,1,-1,2,3,1,-2,-1,-1,2,0,1,0,10,8,2,-3,0,-3,7,3,12,-4,-6,-3,9,-1,2,0,0,-2,-2,4,10,-4,-6,-1,2,1,2,-3,-3,-2,2,0,0,0,-1,-1,0,1,2,-3,-2,-1,-32,-17,-15,3,-4,7,-5,4,2,-22,-2,-7,-5,-2,1,-8,1,-3,0,6,1,-14,-3,-4,4,-4,7,-3,-1,0,2,-3,-1,-3,1,0,2,-1,8,0,-2,0,1,-1,2,16,6,10,6,1,-4,3,-1,0,2,0,2,0,-4,1,4,1,-6,3,3,-1,1,0,3,6,5,1,2,-1,0,3,1,1,-1,1,3,3,4,0,7,-5,12,22,12,10,3,4,-3,1,5,-2,-1,3,-5,-3,5,-3,4,1,2,4,0,1,3,3,0,6,5,3,0,2,0,5,3,2,3,1,0,1,2,1,-55,-23,-32,-36,-15,-21,-9,0,-6,-20,-10,-9,1,4,-3,-14,-8,-3,-10,-4,-3,-6,-2,-6,0,-8,-2,-14,-5,-7,2,-1,-3,-7,-4,-2,-2,-7,1,-7,-1,-5,20,14,6,4,5,-1,3,6,14,-1,0,-1,0,1,8,1,4,1,3,5,6,-2,-4,-2,-2,4,3,0,1,-1,-2,2,2,2,2,0,0,2,1,-2,-1,-1
7,07065,Vilafranca de Bonany,2326,60,40,20,27,19,8,9,24,18,3,7,-2,1,13,14,8,3,1,8,11,4,-5,4,-3,2,9,8,6,1,1,0,5,7,5,1,1,2,4,1,1,0,0,61,43,18,48,32,16,6,15,24,8,3,6,5,12,15,6,2,2,1,3,9,2,1,4,9,14,14,10,0,0,4,11,8,8,0,0,5,3,6,2,0,0,48,25,23,41,25,16,12,16,-1,7,6,7,7,11,-2,9,1,0,5,5,1,-2,5,7,7,12,11,6,2,1,5,7,8,4,0,1,2,5,3,2,2,0,9,3,6,26,9,17,5,6,-12,-1,4,8,2,7,-4,-4,-1,4,3,-1,-8,3,5,4,9,5,9,2,1,0,4,2,3,0,0,0,5,3,6,2,1,0,-48,-30,-18,27,9,18,-30,3,-20,-6,1,4,-12,-4,-11,-5,-1,3,-18,7,-9,-1,2,1,6,11,6,2,2,0,2,3,2,0,2,0,4,8,4,2,0,0,62,23,39,35,15,20,20,6,10,6,8,7,13,-4,1,5,4,3,7,10,9,1,4,4,12,9,9,3,1,1,5,3,5,1,0,1,7,6,4,2,1,0,52,38,14,42,19,23,5,8,32,-5,10,0,2,0,26,0,7,1,3,8,6,-5,3,-1,7,13,12,4,4,1,5,3,6,2,2,0,2,10,6,2,2,1,141,69,72,62,21,41,28,37,52,16,6,3,12,21,26,11,2,-3,16,16,26,5,4,6,21,19,12,4,4,1,7,7,4,1,2,0,14,12,8,3,2,1,137,80,57,61,39,22,25,19,58,21,6,6,15,12,36,14,3,0,10,7,22,7,3,6,15,13,19,9,4,1,9,9,14,5,2,0,6,4,5,4,2,1,74,43,31,38,20,18,18,17,26,-5,10,8,14,8,6,8,3,3,4,9,20,-13,7,5,13,10,7,4,2,1,9,5,2,2,0,1,4,5,5,2,2,0,-41,-22,-19,-65,-45,-20,-16,-1,-25,-2,5,-2,-4,-5,-18,-3,6,1,-12,4,-7,1,-1,-3,-12,-10,-26,-11,-3,-2,-7,-10,-16,-10,-1,0,-5,0,-10,-1,-2,-2,7,8,-1,-6,-2,-4,1,4,-3,-2,0,5,6,3,-4,3,-3,2,-5,1,1,-5,3,3,-3,0,0,-3,-1,0,-1,-1,2,-1,-1,-1,-2,1,-2,-2,0,1,-25,-15,-10,-42,-31,-11,-18,7,-23,9,-3,-3,-6,-1,-15,7,-2,-2,-12,8,-8,2,-1,-1,-19,-6,-16,-2,-1,0,-12,-10,-10,-1,0,0,-7,4,-6,-1,-1,0,-29,-11,-18,5,3,2,-7,-11,7,-11,-2,-3,-1,-4,7,-12,-1,1,-6,-7,0,1,-1,-4,0,-1,2,1,3,0,0,0,0,1,2,0,0,-1,2,0,1,0,19,6,13,5,5,0,1,8,8,0,4,-2,-4,7,6,-2,1,-2,5,1,2,2,3,0,1,3,1,0,-1,0,0,1,3,1,0,0,1,2,-2,-1,-1,0,35,16,19,15,10,5,1,0,32,-5,2,3,-4,-4,18,3,0,1,5,4,14,-8,2,2,0,5,5,2,1,2,1,2,4,1,1,1,-1,3,1,1,0,1,104,49,55,33,13,20,5,14,28,41,10,5,-3,6,21,20,6,-1,8,8,7,21,4,6,2,7,5,8,6,5,1,3,5,0,2,2,1,4,0,8,4,3,132,84,48,40,24,16,18,21,50,19,16,9,8,10,32,19,12,3,10,11,18,0,4,6,9,10,12,5,1,1,6,7,7,3,0,0,3,3,5,2,1,1
8,08001,Abrera,7728,256,163,93,62,41,21,16,53,118,26,28,15,6,32,82,16,19,8,10,21,36,10,9,7,1,15,27,15,3,1,0,8,19,11,3,0,1,7,8,4,0,1,293,166,127,80,53,27,21,43,130,34,33,28,11,28,74,11,25,14,10,15,56,23,8,14,13,20,24,15,4,3,7,16,15,11,2,1,6,4,9,4,2,2,283,161,122,120,74,46,38,59,101,42,16,30,23,32,60,28,5,13,15,27,41,14,11,17,17,28,39,31,3,0,9,16,28,18,3,0,8,12,11,13,0,0,240,124,116,86,43,43,45,15,120,15,25,19,14,11,77,7,8,6,31,4,43,8,17,13,19,24,22,17,3,0,5,11,15,9,2,0,14,13,7,8,1,0,306,135,171,98,64,34,29,43,140,28,38,22,13,15,70,11,14,10,16,28,70,17,24,12,6,20,29,27,14,4,2,10,18,26,8,2,4,10,11,1,6,2,367,198,169,68,38,30,56,67,149,59,7,20,32,34,68,45,5,5,24,33,81,14,2,15,7,20,20,15,1,5,3,9,17,7,1,1,4,11,3,8,0,4,507,307,200,175,126,49,56,81,220,97,25,22,30,39,143,72,5,12,26,42,77,25,20,10,20,32,55,56,8,4,11,19,43,49,2,2,9,13,12,7,6,2,278,142,136,109,70,39,25,63,110,32,33,14,26,43,47,9,15,3,-1,20,63,23,18,11,20,33,27,24,3,-2,11,23,16,18,0,0,9,10,11,6,3,-2,161,82,79,88,55,33,34,32,40,29,5,16,24,15,18,22,-1,4,10,17,22,7,6,12,23,17,24,21,4,-1,13,10,18,12,3,-1,10,7,6,9,1,0,-96,-101,5,-83,-66,-17,-3,-3,-42,-43,-20,15,-8,-15,-36,-29,-17,5,5,12,-6,-14,-3,10,-1,-2,-40,-27,-11,-1,3,-1,-37,-21,-8,-2,-4,-1,-3,-6,-3,1,30,-23,53,-3,-30,27,19,-4,31,-18,-6,2,11,-4,3,-23,-10,-2,8,0,28,5,4,4,5,6,8,-14,-9,-4,1,2,-5,-19,-9,-2,4,4,13,5,0,-2,173,95,78,16,1,15,26,-2,100,33,6,15,14,0,63,21,3,-4,12,-2,37,12,3,19,7,8,0,1,-4,3,1,4,2,-1,-6,0,6,4,-2,2,2,3,103,33,70,26,16,10,14,34,34,28,-11,1,11,9,14,11,-6,-7,3,25,20,17,-5,8,6,10,6,5,-1,0,5,4,4,3,0,0,1,6,2,2,-1,0,-27,-35,8,-15,-11,-4,-11,6,16,-42,-4,7,-13,2,10,-29,-7,3,2,4,6,-13,3,4,1,2,-9,-8,1,-2,-2,0,-4,-3,-1,-1,3,2,-5,-5,2,-1,-98,-80,-18,-136,-87,-49,-9,11,-44,-20,-31,-4,7,8,-42,-24,-23,-4,-16,3,-2,4,-8,0,-17,-2,-47,-31,-30,-9,-7,0,-29,-24,-22,-5,-10,-2,-18,-7,-8,-4,90,68,22,36,19,17,33,25,37,14,-11,-7,15,23,33,15,-11,-6,18,2,4,-1,0,-1,11,12,0,8,3,2,5,8,-1,6,1,0,6,4,1,2,2,2,66,20,46,31,11,20,4,-1,30,26,-5,11,7,-3,15,7,-2,-5,-3,2,15,19,-3,16,-6,7,16,8,2,4,-3,2,11,0,1,0,-3,5,5,8,1,4,-15,-12,-3,-15,-18,3,1,7,6,-9,-22,2,-7,4,12,-8,-10,-2,8,3,-6,-1,-12,4,-2,12,1,-17,-8,-2,-4,7,2,-15,-10,1,2,5,-1,-2,2,-3
8,08014,Aiguafreda,2162,-1,3,-4,9,3,6,0,2,-2,-5,-3,8,-2,2,3,-1,-1,3,2,0,-5,-4,-2,5,5,0,1,3,0,0,1,0,1,1,0,0,4,0,0,2,0,0,42,16,26,14,10,4,11,0,7,5,8,9,5,-3,8,1,4,1,6,3,-1,4,4,8,4,2,6,2,0,0,4,1,3,2,0,0,0,1,3,0,0,0,28,8,20,21,6,15,3,-2,14,10,4,-2,0,-1,8,2,-2,0,3,-1,6,8,6,-2,6,3,5,5,1,0,2,0,1,2,0,0,4,3,4,3,1,0,41,13,28,11,7,4,3,3,14,8,6,5,0,-1,8,3,4,-1,3,4,6,5,2,6,0,4,1,4,1,0,0,3,2,1,1,0,0,1,-1,3,0,0,58,37,21,14,6,8,14,12,9,16,-1,5,12,6,11,7,2,-1,2,6,-2,9,-3,6,3,5,1,2,2,0,2,3,0,0,1,0,1,2,1,2,1,0,74,25,49,12,5,7,11,6,7,7,16,25,6,-2,-3,2,9,11,5,8,10,5,7,14,3,1,3,1,2,1,1,0,2,0,0,1,2,1,1,1,2,0,36,11,25,28,13,15,3,0,7,11,-6,20,1,-5,7,4,-5,9,2,5,0,7,-1,11,5,6,11,2,2,2,1,3,7,1,0,1,4,3,4,1,2,1,74,40,34,11,7,4,9,4,21,15,0,24,6,5,9,7,1,12,3,-1,12,8,-1,12,0,2,5,2,0,2,0,2,4,0,0,1,0,0,1,2,0,1,40,12,28,21,8,13,5,6,23,-1,-1,4,3,0,13,0,-1,-3,2,6,10,-1,0,7,8,5,2,4,2,0,3,2,1,2,0,0,5,3,1,2,2,0,38,8,30,9,2,7,17,-2,12,-1,4,8,13,-4,-6,1,3,1,4,2,18,-2,1,7,1,1,1,1,3,2,0,0,0,0,1,1,1,1,1,1,2,1,-22,-12,-10,4,3,1,-11,-1,-10,-7,5,1,-4,2,-7,-4,1,0,-7,-3,-3,-3,4,1,3,1,0,1,-1,0,2,1,-1,1,0,0,1,0,1,0,-1,0,-11,-5,-6,-20,-11,-9,-10,2,6,-3,-11,5,-6,-1,6,-2,-5,4,-4,3,0,-1,-6,1,-6,-2,-4,-1,-5,-2,-5,-1,-3,0,-1,-1,-1,-1,-1,-1,-4,-1,29,10,19,10,4,6,-7,16,2,0,5,12,-3,8,2,-2,1,4,-4,8,0,2,4,8,0,3,2,1,3,0,0,2,0,1,1,0,0,1,2,0,2,0,8,0,8,3,2,1,5,-6,12,-7,5,2,2,-4,5,-5,5,0,3,-2,7,-2,0,2,-1,0,5,-2,1,0,0,0,3,-1,0,0,-1,0,2,-1,1,0,-16,-10,-6,1,1,0,-11,3,-14,-2,-2,10,-2,4,-6,-6,-4,5,-9,-1,-8,4,2,5,3,1,-3,1,-1,0,1,1,0,0,-1,0,2,0,-3,1,0,0,8,2,6,-3,-2,-1,6,9,-14,3,3,1,-2,2,-1,4,3,-3,8,7,-13,-1,0,4,-2,-1,-1,1,0,0,-1,-2,-1,1,1,0,-1,1,0,0,-1,0,60,34,26,-7,-2,-5,-4,4,7,15,19,19,2,-2,5,8,11,10,-6,6,2,7,8,9,-3,-3,-1,0,-1,0,1,-3,-1,1,0,0,-4,0,0,-1,-1,0,9,8,1,-1,-4,3,-4,1,6,0,0,6,-5,-1,7,5,0,1,1,2,-1,-5,0,5,-3,1,5,-1,-1,-2,-2,0,3,0,-2,-3,-1,1,2,-1,1,1
8,08003,Alella,8176,203,97,106,98,45,53,56,12,70,33,4,30,24,5,31,21,7,10,32,7,39,12,-3,20,17,21,29,20,6,4,8,9,13,9,4,2,9,12,16,11,2,2,170,87,83,107,54,53,34,30,41,54,-16,25,21,22,19,24,-8,7,13,8,22,30,-8,18,16,27,30,19,8,5,5,14,16,8,5,4,11,13,14,11,3,1,110,48,62,133,64,69,33,20,0,13,2,36,20,10,-3,5,4,8,13,10,3,8,-2,28,28,39,31,23,9,1,12,21,13,11,6,0,16,18,18,12,3,1,0,-46,46,83,35,48,32,-3,-24,0,-17,14,0,2,-24,-7,-13,-1,32,-5,0,7,-4,15,31,21,16,12,1,1,15,8,6,6,0,0,16,13,10,6,1,1,77,44,33,100,47,53,5,-5,22,29,18,4,8,-3,12,13,13,-1,-3,-2,10,16,5,5,11,25,27,26,7,1,6,13,13,10,4,1,5,12,14,16,3,0,67,-6,73,92,40,52,38,15,-32,26,-5,25,8,4,-31,13,-6,5,30,11,-1,13,1,20,19,14,27,25,2,3,9,2,14,14,-1,2,10,12,13,11,3,1,119,36,83,119,49,70,62,3,-7,40,13,10,42,-11,-27,23,5,-1,20,14,20,17,8,11,32,27,28,13,12,3,17,9,7,9,3,0,15,18,21,4,9,3,195,73,122,102,49,53,51,-1,49,41,11,37,20,-5,23,12,4,10,31,4,26,29,7,27,19,17,36,18,10,0,10,8,18,8,2,1,9,9,18,10,8,-1,153,84,69,76,38,38,50,-10,60,29,-13,26,31,5,30,21,-9,-2,19,-15,30,8,-4,28,22,15,30,6,2,-1,14,8,12,1,1,0,8,7,18,5,1,-1,157,43,114,46,23,23,43,-6,34,46,-8,44,20,-9,-9,28,-1,13,23,3,43,18,-7,31,7,5,10,10,8,5,5,6,-2,4,7,3,2,-1,12,6,1,2,0,-34,34,-95,-51,-44,19,-29,-12,15,-20,18,9,-20,-23,6,-12,3,10,-9,11,9,-8,15,-18,-9,-20,-26,-14,-8,-9,-5,-9,-14,-8,-6,-9,-4,-11,-12,-6,-2,43,-9,52,10,6,4,34,-12,0,28,-31,22,-4,-10,2,16,-17,6,38,-2,-2,12,-14,16,-3,16,-4,-1,-3,3,-5,6,1,7,-3,1,2,10,-5,-8,0,2,85,16,69,50,24,26,40,-4,-11,22,-6,42,17,-4,-2,9,-6,1,23,0,-9,13,0,41,25,6,0,9,7,1,12,2,-1,5,4,2,13,4,1,4,3,-1,17,0,17,-31,-18,-13,-12,12,21,-3,-15,10,-15,6,4,6,-8,5,3,6,17,-9,-7,5,-9,0,1,-12,-8,-4,-7,-1,-1,-3,-4,-3,-2,1,2,-9,-4,-1,11,-4,15,13,2,11,12,-21,12,8,-43,37,4,-17,19,0,-18,8,8,-4,-7,8,-25,29,12,7,3,-5,-5,-2,7,-1,5,-7,0,-3,5,8,-2,2,-5,1,39,2,37,10,-2,12,-1,-26,-14,15,1,57,4,-10,-5,0,0,10,-5,-16,-9,15,1,47,-6,4,1,1,5,1,-2,-1,-5,3,3,-1,-4,5,6,-2,2,2,62,42,20,28,11,17,20,-7,1,27,-6,27,4,0,2,18,2,15,16,-7,-1,9,-8,12,13,-3,6,10,-2,3,5,0,7,1,-3,0,8,-3,-1,9,1,3,228,90,138,48,12,36,50,7,11,72,24,58,29,11,7,22,10,8,21,-4,4,50,14,50,6,10,19,8,2,3,3,4,13,-4,-3,-1,3,6,6,12,5,4
8,08005,"Ametlla del Vallès, L'",5294,247,105,142,77,34,43,33,22,110,44,12,23,15,12,40,21,9,7,18,10,70,23,3,16,17,12,28,16,3,0,7,5,11,9,1,0,10,7,17,7,2,0,316,147,169,93,37,56,59,36,130,69,13,4,26,4,68,43,6,0,33,32,62,26,7,4,14,29,26,18,4,0,5,9,13,10,0,0,9,20,13,8,4,0,374,197,177,150,64,86,86,50,122,71,14,26,50,28,55,43,5,14,36,22,67,28,9,12,38,32,46,26,3,3,18,11,20,11,1,2,20,21,26,15,2,1,321,168,153,135,55,80,90,24,88,43,20,47,48,17,41,27,14,20,42,7,47,16,6,27,49,27,29,17,8,2,24,13,11,5,2,0,25,14,18,12,6,2,174,83,91,-19,-17,-2,39,-2,118,17,-13,12,18,9,51,7,-8,3,21,-11,67,10,-5,9,-2,3,-6,-7,-5,-1,-2,0,-7,-5,-2,-1,0,3,1,-2,-3,0,146,81,65,51,19,32,40,-13,95,28,-22,13,32,-2,35,12,-5,9,8,-11,60,16,-17,4,9,11,20,7,3,1,2,3,8,3,2,1,7,8,12,4,1,0,106,65,41,34,17,17,54,-14,13,16,-4,41,34,-10,17,16,-4,9,20,-4,-4,0,0,32,16,8,-3,8,2,3,11,1,-3,5,2,1,5,7,0,3,0,2,134,40,94,35,17,18,44,15,31,43,-13,9,18,11,10,15,-10,-5,26,4,21,28,-3,14,16,9,1,7,1,1,11,3,-1,4,0,0,5,6,2,3,1,1,121,68,53,34,15,19,21,22,26,21,-7,29,21,14,6,16,-2,6,0,8,20,5,-5,23,4,15,11,6,1,-4,1,11,3,1,2,-3,3,4,8,5,-1,-1,158,61,97,21,9,12,50,-4,64,23,11,17,26,-5,19,14,3,3,24,1,45,9,8,14,9,1,11,-5,5,-1,8,-3,3,-1,3,-1,1,4,8,-4,2,0,-4,3,-7,-33,-17,-16,15,-40,10,-10,3,17,17,-22,-4,2,1,6,-2,-18,14,-12,2,11,-7,-12,-7,-9,-1,1,-2,-6,-6,-5,0,0,-5,-6,-1,-4,-1,1,60,33,27,-13,-7,-6,9,-17,31,14,-3,26,0,-5,9,22,-3,8,9,-12,22,-8,0,18,-6,-2,-5,-3,-1,2,-4,-2,-2,-1,0,2,-2,0,-3,-2,-1,0,68,28,40,-12,-6,-6,-3,-5,11,18,3,42,-7,6,3,11,5,11,4,-11,8,7,-2,31,0,-5,-6,-4,2,-1,1,-3,-3,-2,0,1,-1,-2,-3,-2,2,-2,44,31,13,-14,-5,-9,13,-3,20,14,-16,18,14,-2,10,6,-4,7,-1,-1,10,8,-12,11,0,1,-3,-11,-2,0,2,-1,-5,-2,1,-1,-2,2,2,-9,-3,1,30,9,21,-22,-12,-10,3,-23,47,0,-9,10,2,-15,26,3,-9,0,1,-8,21,-3,0,10,-10,-1,8,-12,-6,-1,-6,-1,7,-7,-5,-1,-4,0,1,-5,-1,0,46,15,31,15,11,4,17,-15,30,20,-17,4,5,-15,10,20,-9,2,12,0,20,0,-8,2,8,0,5,2,-2,1,2,0,2,4,0,2,6,0,3,-2,-2,-1,30,24,6,14,8,6,-5,-7,29,19,-9,-1,0,-2,13,18,-6,-1,-5,-5,16,1,-3,0,-3,9,10,-1,1,-2,0,4,7,1,-2,-2,-3,5,3,-2,3,0,126,47,79,14,2,12,14,14,22,38,5,30,7,8,7,19,1,6,7,6,15,19,4,24,4,4,3,-2,-2,6,2,4,-2,-2,-3,3,2,0,5,0,1,3
8,08006,Arenys de Mar,12345,205,100,105,133,68,65,17,28,33,40,50,42,22,15,9,21,22,16,-5,13,24,19,28,26,28,38,39,14,7,6,18,23,17,4,4,2,10,15,22,10,3,4,278,161,117,213,124,89,48,39,93,33,31,34,23,25,60,23,15,15,25,14,33,10,16,19,36,43,71,45,13,4,18,28,39,28,8,2,18,15,32,17,5,2,264,147,117,201,109,92,16,58,83,16,36,56,24,27,50,11,20,16,-8,31,33,5,16,40,31,55,61,35,12,7,20,30,35,16,6,2,11,25,26,19,6,5,101,40,61,120,54,66,7,11,38,-16,48,15,3,3,18,-8,21,5,4,8,20,-8,27,10,27,34,33,18,5,3,12,12,15,12,2,1,15,22,18,6,3,2,429,195,234,191,96,95,74,56,147,81,44,23,39,20,70,34,17,10,35,36,77,47,27,13,41,38,41,31,24,9,17,22,20,17,10,4,24,16,21,14,14,5,154,83,71,136,75,61,-15,30,59,24,24,32,-8,28,30,18,8,8,-7,2,29,6,16,24,24,33,41,23,8,5,10,20,24,14,1,5,14,13,17,9,7,0,235,109,126,150,75,75,41,8,86,57,10,33,11,7,42,34,8,7,30,1,44,23,2,26,30,35,45,26,12,0,12,21,23,14,2,2,18,14,22,12,10,-2,293,108,185,162,67,95,7,65,85,18,28,80,-5,33,42,5,3,27,12,32,43,13,25,53,30,49,55,18,6,1,11,23,17,13,3,0,19,26,38,5,3,1,147,82,65,114,52,62,-4,36,42,6,9,61,0,16,38,8,8,16,-4,20,4,-2,1,45,21,45,33,20,-3,-2,12,18,18,6,-1,-1,9,27,15,14,-2,-1,68,12,56,8,1,7,13,20,-18,-6,27,35,5,5,-16,-1,14,5,8,15,-2,-5,13,30,18,19,-13,-11,-6,-1,9,5,-8,-4,-1,-1,9,14,-5,-7,-5,0,167,93,74,40,24,16,24,16,44,55,0,33,13,20,24,23,0,18,11,-4,20,32,0,15,1,11,10,19,-3,2,-3,9,8,12,-4,2,4,2,2,7,1,0,204,92,112,57,28,29,55,29,22,24,16,57,33,22,16,1,5,13,22,7,6,23,11,44,26,11,15,3,5,-3,15,5,5,3,4,-4,11,6,10,0,1,1,216,58,158,14,-9,23,10,6,53,34,22,88,8,-19,14,25,5,22,2,25,39,9,17,66,5,4,0,-5,4,3,2,-4,-8,-5,1,2,3,8,8,0,3,1,179,79,100,5,6,-1,27,9,17,48,10,70,1,9,27,18,12,16,26,0,-10,30,-2,54,-2,3,-6,0,3,5,0,0,-1,0,2,4,-2,3,-5,0,1,1,28,-20,48,2,-1,3,21,-23,-24,-13,16,48,2,-9,-20,-9,-1,17,19,-14,-4,-4,17,31,1,1,-2,-4,2,5,0,0,1,-1,-2,2,1,1,-3,-3,4,3,69,6,63,29,-5,34,-22,14,5,3,1,73,-7,4,-8,4,-2,18,-15,10,13,-1,3,55,7,10,11,0,2,0,3,0,0,-5,0,-2,4,10,11,5,2,2,254,81,173,58,17,41,30,27,52,42,22,73,17,11,4,12,14,18,13,16,48,30,8,55,14,19,21,-1,1,0,10,6,7,-6,-2,0,4,13,14,5,3,0,250,105,145,91,37,54,29,14,40,49,54,66,10,2,21,21,17,36,19,12,19,28,37,30,20,9,28,17,16,0,11,3,12,4,7,0,9,6,16,13,9,0
8,08007,Arenys de Munt,6037,219,101,118,39,17,22,41,54,68,34,7,12,18,29,26,22,1,5,23,25,42,12,6,7,10,18,4,4,2,1,3,11,2,1,0,0,7,7,2,3,2,1,283,159,124,59,39,20,39,31,101,57,30,19,25,26,50,26,16,9,14,5,51,31,14,10,11,19,15,8,4,1,8,14,8,6,2,0,3,5,7,2,2,1,175,94,81,54,36,18,-1,50,64,12,20,26,-1,25,40,15,8,6,0,25,24,-3,12,20,6,14,17,7,6,2,3,9,14,5,3,1,3,5,3,2,3,1,184,86,98,30,14,16,16,37,53,40,15,13,8,11,29,23,6,5,8,26,24,17,9,8,7,9,8,5,-2,1,3,4,5,1,-1,1,4,5,3,4,-1,0,92,25,67,70,30,40,0,26,55,-22,14,15,-3,4,30,-14,7,0,3,22,25,-8,7,15,20,14,19,9,5,1,11,3,8,5,1,1,9,11,11,4,4,0,293,142,151,44,26,18,77,11,139,32,12,19,26,3,73,20,5,11,51,8,66,12,7,8,11,1,15,12,4,0,5,3,8,8,2,-1,6,-2,7,4,2,1,132,78,54,70,36,34,4,18,50,30,15,13,9,13,16,23,4,8,-5,5,34,7,11,5,8,11,31,13,5,2,6,6,13,7,3,1,2,5,18,6,2,1,176,76,100,8,-4,12,35,14,49,38,5,30,18,8,24,14,7,6,17,6,25,24,-2,24,8,5,-1,-2,-1,-1,4,3,-5,-3,-2,-1,4,2,4,1,1,0,127,49,78,23,5,18,15,28,14,30,14,26,2,7,18,5,14,2,13,21,-4,25,0,24,1,9,12,0,1,0,0,1,4,0,0,0,1,8,8,0,1,0,110,56,54,25,10,15,21,21,27,20,5,15,17,7,10,11,0,10,4,14,17,9,5,5,1,7,8,7,3,-2,1,3,2,6,0,-2,0,4,6,1,3,0,128,54,74,17,5,12,21,3,56,18,6,15,5,2,21,12,-1,9,16,1,35,6,7,6,2,4,4,4,2,1,0,1,2,1,1,0,2,3,2,3,1,1,8,28,-20,0,6,-6,-11,-4,-4,4,3,22,-1,5,9,6,1,8,-10,-9,-13,-2,2,14,3,-1,-2,1,0,-1,3,1,1,1,1,-1,0,-2,-3,0,-1,0,34,28,6,7,5,2,14,6,-12,-8,10,27,14,5,3,-13,9,14,0,1,-15,5,1,13,4,4,0,-1,0,0,3,2,1,-1,0,0,1,2,-1,0,0,0,65,16,49,10,-2,12,15,3,26,-9,3,24,8,-3,4,-2,0,8,7,6,22,-7,3,16,6,3,4,-2,-2,1,2,-1,0,-2,-1,0,4,4,4,0,-1,1,70,26,44,7,-5,12,21,1,10,18,12,8,15,-3,2,10,2,-1,6,4,8,8,10,9,7,-1,-4,1,3,0,4,-3,-3,-1,-2,-1,3,2,-1,2,5,1,-62,-29,-33,-22,-14,-8,-10,-4,-32,-27,-4,15,3,-2,-21,-20,2,7,-13,-2,-11,-7,-6,8,-5,1,-3,-10,-7,1,-4,0,-3,-5,-5,1,-1,1,0,-5,-2,0,73,11,62,-12,-7,-5,10,1,11,19,10,15,5,0,-10,7,3,1,5,1,21,12,7,14,7,-2,-1,-8,-6,-2,6,-1,-3,-6,-3,0,1,-1,2,-2,-3,-2,146,73,73,38,24,14,7,20,60,11,20,26,-4,7,34,9,5,21,11,13,26,2,15,5,9,9,9,2,7,1,4,7,7,1,3,2,5,2,2,1,4,-1
8,08011,Avià,1816,36,22,14,6,4,2,6,7,17,4,1,1,3,4,13,1,0,1,3,3,4,3,1,0,3,0,3,0,0,0,2,0,2,0,0,0,1,0,1,0,0,0,42,17,25,13,8,5,6,0,12,14,1,8,1,-2,4,10,0,3,5,2,8,4,1,5,5,3,3,2,0,0,2,2,3,1,0,0,3,1,0,1,0,0,55,27,28,20,9,11,16,12,6,21,6,-5,9,2,2,14,3,-3,7,10,4,7,3,-2,6,8,3,2,1,0,4,2,1,2,0,0,2,6,2,0,1,0,24,12,12,7,2,5,6,0,9,6,6,-3,7,0,2,4,4,-5,-1,0,7,2,2,2,3,1,1,1,0,1,1,0,1,0,0,0,2,1,0,1,0,1,68,38,30,11,6,5,13,5,24,11,7,6,9,0,16,7,4,1,4,5,8,4,3,5,5,3,1,1,0,1,4,1,1,0,0,0,1,2,0,1,0,1,53,15,38,2,4,-2,12,7,31,-1,0,3,2,5,10,-2,-1,1,10,2,21,1,1,2,0,2,3,-2,0,-1,0,2,3,-1,0,0,0,0,0,-1,0,-1,57,33,24,8,4,4,13,-6,14,23,5,2,10,-5,1,16,2,6,3,-1,13,7,3,-4,4,4,-1,2,0,-1,3,1,-1,1,0,0,1,3,0,1,0,-1,41,31,10,6,3,3,9,3,4,6,8,9,4,2,10,5,5,3,5,1,-6,1,3,6,2,4,2,-2,0,0,0,3,1,-1,0,0,2,1,1,-1,0,0,46,20,26,6,1,5,7,10,13,5,5,5,1,6,4,5,0,3,6,4,9,0,5,2,3,0,0,2,1,0,0,-1,1,1,0,0,3,1,-1,1,1,0,11,-1,12,-6,-6,0,-1,0,9,2,2,-2,-6,0,4,0,1,0,5,0,5,2,1,-2,0,-1,-1,-4,-1,0,0,-2,0,-4,0,0,0,1,-1,0,-1,0,21,12,9,6,1,5,16,-6,6,-7,11,0,8,-1,-1,-4,9,0,8,-5,7,-3,2,0,3,3,0,0,0,0,1,2,0,-1,-1,0,2,1,0,1,1,0,18,2,16,-2,-3,1,4,9,-1,3,7,-5,-1,2,1,1,1,-3,5,7,-2,2,6,-2,0,1,-2,-1,0,0,0,0,-2,-1,0,0,0,1,0,0,0,0,31,17,14,-2,-1,-1,8,3,20,3,-1,-2,4,-1,11,5,-2,0,4,4,9,-2,1,-2,2,0,-2,-1,0,-1,0,-1,0,0,0,0,2,1,-2,-1,0,-1,-29,-9,-20,-4,-2,-2,-12,-6,-6,-7,-3,2,5,-2,-6,-6,-1,-1,-17,-4,0,-1,-2,3,-1,1,-2,-2,-1,0,0,1,-2,-1,-1,0,-1,0,0,-1,0,0,-27,-27,0,-3,-1,-2,-5,-2,-4,-6,-8,-2,-6,-4,-3,-4,-7,-2,1,2,-1,-2,-1,0,-3,1,-2,1,0,0,-1,1,-2,1,0,0,-2,0,0,0,0,0,34,15,19,13,7,6,14,3,12,8,-1,-1,6,1,6,3,0,0,8,2,6,5,-1,-1,4,2,3,4,0,0,0,2,2,3,0,0,4,0,1,1,0,0,-4,-1,-3,-6,-1,-5,-14,-7,10,2,2,4,-10,-5,1,8,3,3,-4,-2,9,-6,-1,1,-3,-1,-4,3,-1,0,-1,-1,-1,2,0,0,-2,0,-3,1,-1,0,6,8,-2,8,6,2,7,-3,-2,5,-3,1,7,-4,0,6,-3,1,0,1,-2,-1,0,0,3,3,0,2,-1,1,3,2,-1,2,0,0,0,1,1,0,-1,1
8,08012,Avinyó,1995,16,14,2,16,13,3,8,-5,9,1,5,-2,6,-1,9,0,1,-1,2,-4,0,1,4,-1,7,1,5,3,0,0,5,1,5,2,0,0,2,0,0,1,0,0,13,13,0,15,11,4,1,7,2,3,1,-1,1,3,5,3,1,0,0,4,-3,0,0,-1,3,5,3,4,0,0,1,4,3,3,0,0,2,1,0,1,0,0,2,4,-2,14,6,8,3,-5,-4,-2,4,7,1,-3,0,0,2,4,2,-2,-4,-2,2,3,4,2,4,3,1,0,1,0,2,2,1,0,3,2,2,1,0,0,28,14,14,11,5,6,5,13,-2,4,2,2,1,7,2,3,0,0,4,6,-4,1,2,2,1,4,2,1,1,1,1,3,0,0,0,1,0,1,2,1,1,0,-4,3,-7,20,12,8,-5,2,-2,2,0,-2,1,2,2,-1,-1,-1,-6,0,-4,3,1,-1,6,4,8,3,-1,0,5,2,5,1,-1,0,1,2,3,2,0,0,47,27,20,17,9,8,17,5,20,13,-1,-9,5,8,10,7,-2,-2,12,-3,10,6,1,-7,3,5,6,1,0,0,1,2,3,1,0,0,2,3,3,0,0,0,71,40,31,23,12,11,7,6,35,6,7,5,3,8,18,2,6,1,4,-2,17,4,1,4,4,5,9,2,0,1,2,1,5,2,1,0,2,4,4,0,-1,1,20,4,16,20,12,8,-3,8,4,3,2,6,-3,1,0,1,2,3,0,7,4,2,0,3,3,8,5,4,0,-1,3,3,4,2,0,0,0,5,1,2,0,-1,85,29,56,19,9,10,12,7,26,-5,4,39,8,1,17,-7,0,9,4,6,9,2,4,30,4,7,4,2,2,0,1,3,3,0,2,0,3,4,1,2,0,0,58,32,26,10,7,3,10,12,13,5,5,12,6,12,8,2,1,2,4,0,5,3,4,10,4,3,2,1,0,0,3,2,2,0,0,0,1,1,0,1,0,0,-11,-2,-9,3,-1,4,-4,0,1,-11,-2,4,1,1,2,-6,-2,2,-5,-1,-1,-5,0,2,6,1,3,-4,-1,-2,4,0,1,-4,-1,-1,2,1,2,0,0,-1,11,-4,15,14,8,6,0,9,-2,1,1,1,2,-1,-4,-2,0,1,-2,10,2,3,1,0,1,3,8,2,0,0,1,1,4,2,0,0,0,2,4,0,0,0,-5,-2,-3,6,3,3,-7,1,0,0,0,2,-2,2,-1,0,0,-1,-5,-1,1,0,0,3,2,2,1,1,0,0,2,1,1,-1,0,0,0,1,0,2,0,0,-14,-6,-8,6,3,3,1,-8,-7,10,-11,1,-1,-1,-2,5,-5,-2,2,-7,-5,5,-6,3,2,1,0,4,-1,0,1,0,-1,4,-1,0,1,1,1,0,0,0,-12,-13,1,-2,-3,1,-9,8,-16,-2,-1,7,-8,1,-5,-2,-3,4,-1,7,-11,0,2,3,-5,0,2,-1,1,0,-3,0,1,-1,0,0,-2,0,1,0,1,0,-12,1,-13,4,2,2,0,-3,4,-12,-3,-1,3,4,0,-7,0,0,-3,-7,4,-5,-3,-1,2,1,-2,3,-1,0,2,1,-2,1,0,0,0,0,0,2,-1,0,45,23,22,8,1,7,0,6,9,14,8,7,-2,3,9,7,3,2,2,3,0,7,5,5,1,1,1,2,2,1,0,1,-1,1,0,0,1,0,2,1,2,1,34,7,27,4,0,4,0,7,10,-5,-1,21,-3,2,6,-2,-3,5,3,5,4,-3,2,16,-2,5,-1,0,1,0,-2,3,-1,0,-1,0,0,2,0,0,2,0
8,08013,Avinyonet del Penedès,1187,49,27,22,26,20,6,6,13,11,8,9,2,0,8,10,4,5,0,6,5,1,4,4,2,0,10,13,2,1,0,0,5,12,2,1,0,0,5,1,0,0,0,58,32,26,27,16,11,13,11,12,15,4,-1,6,7,6,10,2,0,7,4,6,5,2,-1,8,6,7,3,0,0,4,5,5,1,0,0,4,1,2,2,0,0,29,21,8,13,10,3,7,4,12,-1,5,2,5,3,8,0,3,2,2,1,4,-1,2,0,0,7,3,1,2,0,0,6,2,1,1,0,0,1,1,0,1,0,81,44,37,12,8,4,14,8,26,23,3,5,10,4,12,16,1,1,4,4,14,7,2,4,2,2,4,4,0,0,1,1,3,3,0,0,1,1,1,1,0,0,107,56,51,26,16,10,25,14,45,19,6,-4,17,8,21,8,2,-2,8,6,24,11,4,-2,8,8,9,1,0,0,5,6,4,1,0,0,3,2,5,0,0,0,43,19,24,19,11,8,10,4,17,15,-1,-1,4,0,7,8,1,0,6,4,10,7,-2,-1,5,4,7,2,0,1,1,0,6,3,0,1,4,4,1,-1,0,0,13,16,-3,16,12,4,5,6,-9,11,3,-4,7,2,-4,10,1,-1,-2,4,-5,1,2,-3,5,6,3,1,0,0,4,3,4,0,0,0,1,3,-1,1,0,0,69,32,37,38,15,23,18,10,19,12,3,4,12,2,13,3,-1,1,6,8,6,9,4,3,8,6,9,9,5,0,4,2,4,3,2,0,4,4,5,6,3,0,16,16,0,14,8,6,9,8,3,-3,1,-2,13,6,-3,0,1,-1,-4,2,6,-3,0,-1,5,5,4,1,-1,0,3,2,3,1,-1,0,2,3,1,0,0,0,5,3,2,-8,-4,-4,20,-11,5,-3,-3,-3,10,-10,4,-2,2,-1,10,-1,1,-1,-5,-2,5,-5,-2,-5,-1,0,4,-3,-3,-1,-1,0,1,-2,1,-4,0,0,12,0,12,5,0,5,6,-4,-6,4,9,3,3,-2,-6,0,4,1,3,-2,0,4,5,2,3,1,0,0,0,1,3,-1,-1,0,-1,0,0,2,1,0,1,1,10,13,-3,-4,1,-5,19,2,-1,-6,-4,-1,16,0,2,-1,-3,-2,3,2,-3,-5,-1,1,0,3,-3,1,-4,-2,0,3,-1,1,-1,-1,0,0,-2,0,-3,-1,-8,-12,4,5,0,5,9,-21,-2,1,3,3,8,-11,-11,0,1,1,1,-10,9,1,2,2,2,-1,-1,1,4,0,1,-1,-2,0,2,0,1,0,1,1,2,0,-18,-22,4,8,4,4,-11,-5,6,-6,1,-2,-11,-6,0,-6,0,0,0,1,6,0,1,-2,4,0,2,0,2,0,4,-2,1,0,1,0,0,2,1,0,1,0,-18,-14,-4,-1,0,-1,-4,-6,-5,5,-4,-2,-6,-5,-5,3,0,-1,2,-1,0,2,-4,-1,1,1,2,-1,-3,-1,0,1,1,-1,-1,0,1,0,1,0,-2,-1,18,24,-6,13,9,4,-7,-11,13,16,6,3,-2,-5,12,18,1,1,-5,-6,1,-2,5,2,3,-1,4,5,2,0,3,-1,2,3,2,0,0,0,2,2,0,0,-11,-12,1,-8,-8,0,-15,-2,-2,1,5,-2,-13,2,1,-3,2,-2,-2,-4,-3,4,3,0,-3,3,2,-6,-3,-1,0,3,0,-6,-4,-1,-3,0,2,0,1,0,12,5,7,8,9,-1,5,-5,4,9,0,-2,3,0,-6,9,-2,1,2,-5,10,0,2,-3,5,-1,1,4,-1,0,6,-1,0,4,0,0,-1,0,1,0,-1,0
8,08015,Badalona,209635,-2484,-1240,-1244,76,38,38,-351,-392,-773,-497,-312,-127,-178,-199,-360,-274,-159,-61,-173,-193,-413,-223,-153,-66,8,19,26,9,11,1,3,9,12,4,7,1,5,10,14,5,4,0,-2325,-1128,-1197,79,39,40,-322,-311,-701,-500,-344,-143,-150,-140,-312,-280,-183,-65,-172,-171,-389,-220,-161,-78,12,20,28,8,9,2,6,13,13,5,2,0,6,7,15,3,7,2,-2180,-1032,-1148,45,30,15,-283,-257,-534,-425,-388,-246,-125,-157,-261,-175,-197,-105,-158,-100,-273,-250,-191,-141,22,11,-12,5,11,5,14,5,-3,5,6,1,8,6,-9,0,5,4,-2447,-1178,-1269,220,167,53,-518,-278,-649,-337,-404,-218,-274,-98,-278,-165,-222,-107,-244,-180,-371,-172,-182,-111,45,70,59,30,8,4,32,51,51,26,5,1,13,19,8,4,3,3,1946,1689,257,4430,2847,1583,95,918,900,492,-304,-127,80,646,886,372,-199,-75,15,272,14,120,-105,-52,666,1226,1559,797,116,46,387,795,1089,495,54,17,279,431,470,302,62,29,212,543,-331,3911,2454,1457,206,577,98,4,-437,-205,122,470,220,73,-247,-89,84,107,-122,-69,-190,-116,751,1161,1257,536,126,45,421,740,851,341,56,21,330,421,406,195,70,24,-2868,-2214,-654,491,-323,814,-162,-26,-1161,-745,-525,-220,-131,-132,-953,-538,-344,-107,-31,106,-208,-207,-181,-113,367,424,-115,-250,-1,44,190,114,-335,-285,-40,25,177,310,220,35,39,19,-2030,-1225,-805,1082,389,693,-37,36,-705,-571,-399,-306,38,43,-510,-418,-229,-122,-75,-7,-195,-153,-170,-184,468,586,126,-78,-19,-23,278,318,-80,-114,-20,-2,190,268,206,36,1,-21,2321,1371,950,2709,1418,1291,705,995,643,364,-204,-204,395,604,368,175,-133,-49,310,391,275,189,-71,-155,735,929,745,249,-2,12,425,527,373,71,-13,7,310,402,372,178,11,5,-1476,-1019,-457,-897,-729,-168,105,225,-749,-571,-271,-230,136,150,-613,-434,-192,-74,-31,75,-136,-137,-79,-156,105,189,-557,-515,-101,-51,103,143,-460,-427,-88,-22,2,46,-97,-88,-13,-29,268,-35,303,1380,578,802,485,378,-234,-50,-159,-201,314,195,-180,-172,-149,-77,171,183,-54,122,-10,-124,658,451,158,69,9,2,409,247,-1,-72,-21,0,249,204,159,141,30,2,1002,471,531,2401,1259,1142,291,552,181,58,67,-130,170,336,70,-72,20,-47,121,216,111,130,47,-83,480,731,637,389,93,29,271,424,332,170,36,4,209,307,305,219,57,25,-1792,-1259,-533,-609,-430,-179,-179,43,-696,-604,-200,-133,-119,77,-601,-440,-116,-34,-60,-34,-95,-164,-84,-99,-99,161,-272,-306,-81,-16,-39,120,-234,-224,-51,1,-60,41,-38,-82,-30,-17,-2640,-1745,-895,-1359,-1022,-337,-394,-178,-1019,-704,-196,-135,-210,-192,-678,-504,-126,-36,-184,14,-341,-200,-70,-99,-181,-76,-527,-453,-113,-31,-85,-119,-392,-353,-68,-12,-96,43,-135,-100,-45,-19,-1334,-1057,-277,-405,-381,-24,-96,-55,-436,-463,-167,-142,-58,-75,-370,-394,-125,-49,-38,20,-66,-69,-42,-93,-14,91,-207,-270,-39,4,-11,8,-163,-220,-18,5,-3,83,-44,-50,-21,-1,279,88,191,532,231,301,87,316,16,151,-27,-293,42,153,-68,98,-32,-100,45,163,84,53,5,-193,105,345,49,42,-24,-13,62,187,-15,26,-37,-6,43,158,64,16,13,-7,433,96,337,793,256,537,300,279,129,-33,-106,-181,155,106,-3,-93,-56,-43,145,173,132,60,-50,-138,224,337,246,-59,-4,7,113,150,93,-99,-24,-2,111,187,153,40,20,9,2124,1090,1034,1564,711,853,516,586,810,285,117,-267,320,314,375,84,20,-67,196,272,435,201,97,-200,321,534,485,126,62,1,188,297,220,2,-16,1,133,237,265,124,78,0
8,08017,Balenyà,3127,20,20,0,28,15,13,4,8,3,6,3,-5,5,5,8,0,1,-1,-1,3,-5,6,2,-4,6,5,10,6,1,0,4,3,8,0,0,0,2,2,2,6,1,0,10,-1,11,27,14,13,-1,3,-6,6,1,5,-4,3,3,-1,-1,-2,3,0,-9,7,2,7,4,7,8,5,2,0,1,3,6,3,0,0,3,4,2,2,2,0,14,16,-2,27,20,7,-4,-14,20,6,8,-2,3,-2,12,2,2,-1,-7,-12,8,4,6,-1,7,4,9,5,2,0,6,3,6,4,1,0,1,1,3,1,1,0,129,60,69,26,10,16,22,23,38,29,11,4,8,9,23,14,4,0,14,14,15,15,7,4,6,8,6,4,1,1,2,3,3,1,1,0,4,5,3,3,0,1,1,-5,6,12,8,4,3,3,-2,6,-3,-5,-5,2,-1,3,-1,-3,8,1,-1,3,-2,-2,1,5,3,4,-1,0,1,4,1,3,-1,0,0,1,2,1,0,0,35,23,12,18,11,7,-2,9,17,10,0,-3,0,-1,17,6,-1,2,-2,10,0,4,1,-5,1,4,9,3,0,0,0,1,7,2,1,0,1,3,2,1,-1,0,125,75,50,31,17,14,22,26,66,7,-2,7,11,17,36,7,-1,3,11,9,30,0,-1,4,4,10,6,7,4,0,2,3,3,7,2,0,2,7,3,0,2,0,76,34,42,35,13,22,-3,8,54,16,1,2,-4,6,22,8,2,-2,1,2,32,8,-1,4,4,11,9,9,0,1,1,6,3,0,3,0,3,5,6,9,-3,1,48,20,28,19,13,6,15,12,9,4,1,9,8,5,5,7,-4,-1,7,7,4,-3,5,10,3,6,7,1,1,0,2,4,7,1,-1,0,1,2,0,0,2,0,-34,-32,-2,-17,-17,0,3,5,-5,-26,-5,-6,3,-11,-14,-4,-3,-3,0,16,9,-22,-2,-3,-1,2,-9,-4,-6,1,-1,-1,-10,-1,-4,0,0,3,1,-3,-2,1,-27,-14,-13,2,-3,5,-2,-4,-25,-8,8,1,-1,0,-14,-6,5,0,-1,-4,-11,-2,3,1,2,-2,-2,1,2,0,1,-2,-3,0,1,0,1,0,1,1,1,0,4,4,0,9,5,4,1,4,-13,10,0,1,4,2,-2,1,-2,1,-3,2,-11,9,2,0,0,4,4,-4,3,0,1,2,4,-3,1,0,-1,2,0,-1,2,0,21,15,6,-7,-6,-1,1,2,5,-7,12,5,2,1,2,-2,8,2,-1,1,3,-5,4,3,1,-5,-4,0,-2,1,0,-3,-2,-1,-1,0,1,-2,-2,1,-1,1,-11,-12,1,-3,-3,0,1,0,-18,8,-7,5,0,-1,-10,0,-5,3,1,1,-8,8,-2,2,1,0,-2,0,-3,0,0,-1,-1,-1,-1,0,1,1,-1,1,-2,0,-5,-4,-1,-13,-9,-4,-6,1,-14,0,2,13,0,-2,-11,3,3,4,-6,3,-3,-3,-1,9,-2,0,-5,-4,-2,0,-2,-1,-3,-2,-1,0,0,1,-2,-2,-1,0,-23,1,-24,10,3,7,-14,-3,-8,10,-6,-2,-4,-1,5,4,-3,-1,-10,-2,-13,6,-3,-1,-3,0,0,6,6,1,0,1,-1,2,0,1,-3,-1,1,4,6,0,-6,7,-13,27,17,10,-3,6,-1,-6,8,-8,-2,7,-1,-2,6,-2,-1,-1,0,-4,2,-6,5,9,9,4,0,0,2,8,3,4,0,0,3,1,6,0,0,0,103,49,54,33,16,17,13,24,23,22,7,15,9,8,13,13,1,6,4,16,10,9,6,9,5,10,9,5,1,3,2,3,5,5,0,1,3,7,4,0,1,2
8,08018,Balsareny,3256,1,3,-2,2,1,1,9,-1,6,-1,-7,-2,8,-2,1,3,-3,-2,1,1,5,-4,-4,0,0,1,0,1,0,0,0,0,0,1,0,0,0,1,0,0,0,0,2,-4,6,2,1,1,2,1,8,-7,-1,-3,-2,0,5,-6,-1,-2,4,1,3,-1,0,-1,0,1,0,0,1,0,0,1,0,0,0,0,0,0,0,0,1,0,23,9,14,10,6,4,9,7,4,3,-4,4,7,1,-2,4,-2,1,2,6,6,-1,-2,3,3,3,1,2,1,0,3,1,1,1,0,0,0,2,0,1,1,0,-3,5,-8,16,4,12,-4,6,9,-5,-3,-5,-4,2,9,0,-1,-1,0,4,0,-5,-2,-4,3,5,4,1,3,0,0,2,1,0,1,0,3,3,3,1,2,0,43,22,21,27,17,10,12,10,7,8,7,-1,3,5,6,6,3,1,9,5,1,2,4,-2,2,3,11,7,3,0,1,2,7,6,1,0,1,1,4,1,2,0,44,20,24,29,18,11,13,3,11,13,6,-1,0,0,8,9,4,0,13,3,3,4,2,-1,9,1,9,7,2,1,3,0,6,7,2,0,6,1,3,0,0,1,92,79,13,68,48,20,13,23,37,19,2,-1,9,14,32,21,3,1,4,9,5,-2,-1,-2,7,18,21,17,3,1,4,11,15,15,2,0,3,7,6,2,1,1,108,91,17,98,73,25,13,16,45,32,9,-8,6,16,29,36,5,-2,7,0,16,-4,4,-6,13,23,23,37,2,0,7,16,16,32,2,0,6,7,7,5,0,0,15,5,10,26,9,17,-4,11,1,7,-3,1,-1,2,5,3,-4,-2,-3,9,-4,4,1,3,4,12,7,3,-1,-2,2,5,3,-1,-1,-1,2,7,4,4,0,-1,8,-14,22,6,5,1,5,6,0,-16,-1,11,2,1,-3,-21,-1,5,3,5,3,5,0,6,0,2,-2,3,3,0,2,1,-2,3,1,0,-2,1,0,0,2,0,29,15,14,28,15,13,-3,1,-2,23,0,9,-6,-1,-2,18,3,2,3,2,0,5,-3,7,3,9,4,12,0,0,1,4,2,8,0,0,2,5,2,4,0,0,6,7,-1,13,5,8,10,-4,-5,-5,7,-1,5,0,2,-3,-1,2,5,-4,-7,-2,8,-3,4,3,4,0,1,0,1,2,3,-2,0,0,3,1,1,2,1,0,16,9,7,7,3,4,-7,4,-14,19,0,12,-3,2,-5,14,-2,4,-4,2,-9,5,2,8,0,3,1,1,-1,1,0,1,1,1,-2,1,0,2,0,0,1,0,-7,-9,2,-6,-5,-1,-4,-2,-4,-1,2,3,-3,-1,0,-2,-2,0,-1,-1,-4,1,4,3,-1,-1,-3,-1,0,0,-1,0,-2,-2,0,0,0,-1,-1,1,0,0,3,5,-2,9,7,2,-2,2,0,-1,0,4,5,-3,1,4,-1,0,-7,5,-1,-5,1,4,1,0,6,3,0,-1,0,0,4,3,0,0,1,0,2,0,0,-1,-25,-5,-20,-16,-9,-7,-8,-1,-18,-4,-4,10,1,2,-7,-5,-1,5,-9,-3,-11,1,-3,5,0,1,-5,-8,-3,-1,1,2,-4,-5,-2,-1,-1,-1,-1,-3,-1,0,-21,-4,-17,13,10,3,-2,-6,-4,-9,3,-3,-4,3,-1,-2,0,0,2,-9,-3,-7,3,-3,2,5,0,4,2,0,1,4,0,4,1,0,1,1,0,0,1,0,-2,-11,9,9,1,8,2,-8,5,-6,4,0,-4,0,1,-5,-3,-1,6,-8,4,-1,7,1,2,2,5,0,0,0,0,1,1,-1,0,0,2,1,4,1,0,0
8,08252,Barberà del Vallès,26342,-260,-166,-94,12,6,6,-75,17,-84,-83,-37,15,-37,-11,-58,-41,-22,9,-38,28,-26,-42,-15,6,5,1,2,2,2,0,2,1,0,1,2,0,3,0,2,1,0,0,-116,-29,-87,5,2,3,-61,18,-89,3,-17,33,-30,17,-17,12,-9,1,-31,1,-72,-9,-8,32,0,1,1,1,1,1,0,1,0,1,0,0,0,0,1,0,1,1,-64,-34,-30,4,0,4,-12,24,-26,-41,-26,11,-4,1,-4,-21,-14,8,-8,23,-22,-20,-12,3,4,3,-4,-1,2,0,1,2,-3,-1,2,-1,3,1,-1,0,0,1,-137,-90,-47,-3,-1,-2,-28,8,-105,-46,-1,34,-19,23,-47,-51,-7,13,-9,-15,-58,5,6,21,2,-2,-2,-2,1,0,0,0,0,-1,0,0,2,-2,-2,-1,1,0,460,222,238,181,90,91,77,93,202,46,3,22,65,37,91,22,1,-6,12,56,111,24,2,28,46,46,49,23,11,2,22,21,26,15,3,1,24,25,23,8,8,1,617,311,306,193,85,108,92,85,313,39,-1,65,42,26,188,29,-9,27,50,59,125,10,8,38,46,51,54,29,7,2,22,24,23,13,2,1,24,27,31,16,5,1,449,182,267,167,74,93,69,94,216,10,-2,52,21,71,88,3,-7,5,48,23,128,7,5,47,48,42,51,15,2,3,23,28,18,2,1,-1,25,14,33,13,1,4,911,466,445,241,113,128,104,203,393,116,27,48,50,99,201,64,12,22,54,104,192,52,15,26,49,84,47,29,24,5,19,43,24,10,11,4,30,41,23,19,13,1,617,272,345,191,89,102,117,111,225,88,22,38,56,40,108,44,1,8,61,71,117,44,21,30,43,55,47,40,2,3,21,21,22,20,1,2,22,34,25,20,1,1,393,152,241,110,35,75,69,59,207,20,-19,44,31,23,94,-10,-2,13,38,36,113,30,-17,31,36,48,19,4,2,-3,17,16,8,-10,1,-1,19,32,11,14,1,-2,99,16,83,54,19,35,30,74,7,-26,-16,28,9,23,-7,-21,-13,17,21,51,14,-5,-3,11,20,20,6,0,4,0,11,4,3,-3,1,0,9,16,3,3,3,0,161,76,85,75,28,47,32,24,53,-5,-3,51,14,8,43,-9,1,15,18,16,10,4,-4,36,14,25,23,8,-3,5,12,2,9,6,-7,4,2,23,14,2,4,1,-40,-90,50,-7,-22,15,-11,5,-27,-48,7,32,-10,5,-26,-50,1,-3,-1,0,-1,2,6,35,4,12,-20,-2,0,-1,-2,7,-17,-9,0,-1,6,5,-3,7,0,0,-155,-86,-69,-68,-24,-44,-64,-10,-58,-33,-43,47,-28,-5,-27,-6,-36,10,-36,-5,-31,-27,-7,37,-19,4,-26,-21,-2,-6,-9,8,-13,-9,-2,-1,-10,-4,-13,-12,0,-5,-62,-66,4,-5,-10,5,-34,-25,-23,-61,-15,93,-35,-17,-21,-24,0,30,1,-8,-2,-37,-15,63,-7,4,-2,0,-7,5,-7,3,-6,-3,0,1,0,1,4,3,-7,4,184,65,119,99,59,40,37,10,64,-13,2,70,28,0,14,0,-5,23,9,10,50,-13,7,47,20,25,16,13,12,11,9,16,15,10,4,3,11,9,1,3,8,8,-12,-44,32,62,9,53,-18,-12,60,-63,-17,32,-2,-2,11,-46,-19,17,-16,-10,49,-17,2,15,13,30,9,-4,8,4,3,14,-2,-3,-4,1,10,16,11,-1,12,3,-16,-63,47,99,45,54,-35,19,18,-26,-50,55,-23,2,17,-39,-36,13,-12,17,1,13,-14,42,29,18,23,14,10,1,19,9,9,4,0,1,10,9,14,10,10,0
8,08019,Barcelona,1503451,-20546,-10602,-9944,1636,788,848,-2868,-2197,-5426,-3884,-3073,-2800,-1473,-1040,-3137,-2144,-1551,-1099,-1395,-1157,-2289,-1740,-1522,-1701,275,275,562,289,145,72,134,131,272,139,76,27,141,144,290,150,69,45,-17525,-8910,-8615,969,511,458,-2710,-1480,-4652,-3203,-2553,-2655,-1409,-691,-2607,-1738,-1272,-1061,-1301,-789,-2045,-1465,-1281,-1594,100,177,311,168,129,77,43,96,166,100,65,36,57,81,145,68,64,41,-26303,-13890,-12413,-975,-368,-607,-3602,-2686,-8027,-4970,-3521,-3023,-1878,-1287,-4614,-2911,-1784,-1194,-1724,-1399,-3413,-2059,-1737,-1829,59,-155,-632,-153,-48,-61,35,-58,-250,-71,-15,-15,24,-97,-382,-82,-33,-46,-31164,-16671,-14493,-24,14,-38,-4433,-3916,-9481,-6294,-3566,-2985,-2326,-2008,-5593,-3461,-1877,-1181,-2107,-1908,-3888,-2833,-1689,-1804,63,-31,-120,-2,31,28,37,4,-54,-1,16,9,26,-35,-66,-1,15,19,6181,2960,3221,34990,18875,16115,-550,7126,4326,-502,-1786,-2229,-316,3521,2153,-358,-1049,-884,-234,3605,2173,-144,-737,-1345,3527,10321,13651,5361,1487,380,1868,5219,7866,2996,659,153,1659,5102,5785,2365,828,227,12047,6045,6002,36393,19471,16922,71,8953,5927,80,-1082,-1817,105,4265,3329,-362,-592,-668,-34,4688,2598,442,-490,-1149,4149,11326,13533,5242,1342,468,2213,5730,7820,2782,592,167,1936,5596,5713,2460,750,301,11953,4821,7132,34560,16953,17607,174,10007,6162,-536,-1488,-2215,44,4710,2732,-666,-998,-903,130,5297,3430,130,-490,-1312,4013,11575,12521,4497,1296,327,2033,5521,6448,2185,481,120,1980,6054,6073,2312,815,207,17672,9638,8034,35014,19003,16011,1330,11360,7872,530,-1357,-2188,747,5803,4493,217,-829,-843,583,5557,3379,313,-528,-1345,4305,12369,12391,4392,992,171,2263,6415,7241,2414,414,70,2042,5954,5150,1978,578,101,17329,9090,8239,29517,15415,14102,1295,10712,8488,56,-1159,-2250,685,5429,4646,-175,-793,-774,610,5283,3842,231,-366,-1476,3537,11070,11031,2806,523,148,1881,5769,6195,1208,88,77,1656,5301,4836,1598,435,71,-9314,-5847,-3467,-3807,-3582,-225,-128,5074,-3914,-5174,-2554,-2734,-46,2330,-2552,-3428,-1217,-1008,-82,2744,-1362,-1746,-1337,-1726,1172,4305,-4326,-3751,-1146,-379,684,1957,-2899,-2761,-589,-144,488,2348,-1427,-990,-557,-235,-1922,-1607,-315,2017,117,1900,-259,6785,-1073,-3337,-1730,-2528,-50,3137,-620,-2220,-1007,-949,-209,3648,-453,-1117,-723,-1579,1122,5559,-1751,-2271,-646,-412,729,2648,-1030,-1795,-429,-202,393,2911,-721,-476,-217,-210,8304,2732,5572,9927,3821,6106,638,7991,2718,-1388,-476,-1343,457,3555,946,-1293,-614,-426,181,4436,1772,-95,138,-917,1392,6550,1968,-554,102,104,821,3041,653,-766,-191,50,571,3509,1315,212,293,54,-1454,-2873,1419,2994,-366,3360,90,5175,-1300,-2883,-1012,-1753,148,1936,-1505,-2172,-808,-622,-58,3239,205,-711,-204,-1131,917,4508,-756,-1785,-250,45,521,1827,-1099,-1526,-305,44,396,2681,343,-259,55,1,-3192,-2828,-364,-1781,-2166,385,20,4643,-1367,-3141,-1416,-2137,86,1762,-956,-2132,-846,-812,-66,2881,-411,-1009,-570,-1325,381,3403,-2634,-2632,-505,-107,257,1259,-1670,-1817,-291,-66,124,2144,-964,-815,-214,-41,6614,2860,3754,5465,2001,3464,755,7393,2634,-1615,-682,-1995,378,3320,1500,-1104,-544,-742,377,4073,1134,-511,-138,-1253,1171,5424,412,-1691,-136,-23,606,2403,249,-1178,-201,-28,565,3021,163,-513,65,5,10558,4638,5920,11291,5043,6248,1062,8749,4461,-1529,-393,-1969,602,3780,2421,-1036,-463,-721,460,4969,2040,-493,70,-1248,1779,6958,2669,-776,260,25,1055,3068,1476,-664,-78,4,724,3890,1193,-112,338,21,21062,9273,11789,26108,11834,14274,2977,10523,10071,-376,-439,-1818,1610,4515,4729,-597,-433,-594,1367,6008,5342,221,-6,-1224,3792,9249,9716,1657,974,356,2101,4069,4557,503,297,123,1691,5180,5159,1154,677,233,13036,5687,7349,19719,8656,11063,1219,10521,7788,-2805,-1323,-2394,693,4661,4189,-1919,-985,-985,526,5860,3599,-886,-338,-1409,2970,8916,7057,-153,460,59,1541,4049,3537,-621,-59,-12,1429,4867,3520,468,519,71
8,08022,Berga,14173,203,98,105,145,98,47,22,57,49,19,22,31,14,30,20,16,8,9,8,27,29,3,14,22,22,47,48,25,3,0,17,30,33,17,1,0,5,17,15,8,2,0,545,306,239,408,237,171,102,110,173,95,29,31,50,59,113,56,12,15,52,51,60,39,17,16,90,102,117,88,8,0,47,49,77,58,5,0,43,53,40,30,3,0,389,234,155,377,221,156,70,104,89,41,49,36,50,66,60,22,20,17,20,38,29,19,29,19,86,108,95,64,19,3,53,65,60,36,5,2,33,43,35,28,14,1,405,203,202,235,125,110,102,76,110,25,41,44,48,41,58,24,12,15,54,35,52,1,29,29,77,65,54,25,8,2,41,36,28,13,2,2,36,29,26,12,6,0,434,247,187,267,171,96,53,98,132,73,42,33,19,60,77,46,23,17,34,38,55,27,19,16,45,80,86,36,16,1,25,58,58,24,5,0,20,22,28,12,11,1,339,218,121,267,154,113,47,94,73,62,31,32,32,65,44,46,15,14,15,29,29,16,16,18,39,86,75,46,15,4,18,48,46,33,7,1,21,38,29,13,8,3,334,196,138,295,171,124,57,100,90,64,20,6,23,50,61,47,8,8,34,50,29,17,12,-2,70,70,91,52,10,1,31,38,57,36,7,1,39,32,34,16,3,0,462,305,157,455,290,165,77,127,141,83,25,7,38,95,97,53,11,6,39,32,44,30,14,1,81,137,120,88,22,7,36,90,84,58,17,5,45,47,36,30,5,2,119,38,81,149,50,99,17,44,23,29,15,-9,10,11,8,7,2,-4,7,33,15,22,13,-5,32,45,49,9,12,1,14,10,22,-3,5,1,18,35,27,12,7,0,-26,-64,38,-98,-102,4,23,-12,-39,-12,13,5,16,-14,-50,-17,-2,6,7,2,11,5,15,-1,14,-8,-41,-41,-28,3,11,-10,-49,-36,-19,0,3,2,8,-5,-9,3,-134,-124,-10,-133,-108,-25,5,10,-74,-51,-24,0,1,-10,-53,-49,-15,2,4,20,-21,-2,-9,-2,-10,-4,-30,-54,-24,-12,-7,-9,-24,-45,-19,-5,-3,5,-6,-9,-5,-7,-135,-98,-37,-17,-19,2,-12,-3,-53,-47,-11,-15,-5,-14,-37,-30,-5,-12,-7,11,-16,-17,-6,-3,-8,9,-13,-11,5,-4,-5,7,-11,-13,2,-3,-3,2,-2,2,3,-1,-174,-121,-53,-125,-91,-34,-46,13,-93,-56,12,-7,-17,14,-62,-51,-10,2,-29,-1,-31,-5,22,-9,-20,5,-45,-46,-18,-4,-7,6,-33,-37,-20,-2,-13,-1,-12,-9,2,-2,-126,-84,-42,-26,-15,-11,8,-38,-42,-25,-18,-8,-3,-22,-31,-13,-14,1,11,-16,-11,-12,-4,-9,-4,-6,-2,-7,-7,-1,0,-2,-2,-6,-6,0,-4,-4,0,-1,-1,-1,-124,-76,-48,-106,-73,-33,-33,4,-48,-51,-3,6,-11,2,-14,-52,0,-1,-22,2,-34,1,-3,7,-39,2,-29,-34,-7,0,-24,1,-15,-31,-3,-1,-15,1,-14,-3,-4,1,29,27,2,1,0,1,-24,38,10,-22,11,10,-16,19,15,-13,5,12,-8,19,-5,-9,6,-2,-18,17,8,-7,2,-2,-9,6,12,-7,-2,0,-9,11,-4,0,4,-2,45,50,-5,-16,-7,-9,20,-4,-1,24,-9,12,9,8,18,6,1,6,11,-12,-19,18,-10,6,-3,7,-4,-6,-14,3,-4,7,2,-7,-5,-1,1,0,-6,1,-9,4,189,85,104,165,87,78,41,67,58,20,-4,3,16,29,31,18,-12,4,25,38,27,2,8,-1,42,72,62,-7,-8,1,22,40,37,0,-12,1,20,32,25,-7,4,0
8,08023,Bigues i Riells,5006,238,129,109,15,8,7,26,35,99,25,34,17,22,17,43,21,16,9,4,18,56,4,18,8,0,6,1,5,2,1,0,3,0,3,1,1,0,3,1,2,1,0,259,136,123,11,5,6,54,30,108,44,6,10,36,7,52,27,6,1,18,23,56,17,0,9,3,3,3,2,0,0,3,0,2,0,0,0,0,3,1,2,0,0,353,181,172,30,15,15,63,93,116,47,6,25,32,51,57,30,-1,10,31,42,59,17,7,15,5,12,8,2,3,0,1,8,5,0,1,0,4,4,3,2,2,0,215,109,106,9,3,6,41,11,75,52,16,17,16,11,39,30,4,6,25,0,36,22,12,11,1,2,4,2,1,-1,1,0,2,0,1,-1,0,2,2,2,0,0,411,194,217,47,22,25,72,59,117,91,43,22,41,25,52,45,21,7,31,34,65,46,22,15,14,11,8,12,1,1,8,7,2,3,1,1,6,4,6,9,0,0,267,133,134,37,16,21,49,23,114,38,20,17,23,10,55,23,14,7,26,13,59,15,6,10,5,11,12,6,0,3,1,5,6,2,0,2,4,6,6,4,0,1,198,109,89,25,10,15,32,22,73,36,17,13,25,5,49,19,7,4,7,17,24,17,10,9,7,5,7,1,3,2,3,2,3,0,1,1,4,3,4,1,2,1,151,85,66,15,6,9,24,13,65,4,20,21,10,7,36,11,6,15,14,6,29,-7,14,6,1,10,4,2,-2,0,0,6,-2,3,-1,0,1,4,6,-1,-1,0,111,82,29,29,13,16,17,-11,57,7,26,18,6,-3,46,9,16,9,11,-8,11,-2,10,9,8,10,2,5,3,0,4,5,1,2,1,0,4,5,1,3,2,0,131,73,58,9,6,3,25,17,48,15,15,5,18,12,29,-1,13,1,7,5,19,16,2,4,1,5,4,0,-1,0,0,3,2,1,0,0,1,2,2,-1,-1,0,50,21,29,-1,-2,1,5,-17,26,21,-1,7,10,-18,7,20,1,-2,-5,1,19,1,-2,9,0,-1,2,-5,2,1,0,-1,-1,-1,1,0,0,0,3,-4,1,1,-8,-7,-1,-1,1,-2,-3,2,2,-2,-3,-3,8,-3,-4,4,-4,-6,-11,5,6,-6,1,3,6,-3,-2,-3,2,0,2,-2,0,0,1,0,4,-1,-2,-3,1,0,-17,3,-20,6,-1,7,-8,-12,7,-4,-9,11,-1,-1,12,-9,1,4,-7,-11,-5,5,-10,7,2,1,8,-5,-1,1,1,0,3,-5,0,0,1,1,5,0,-1,1,62,18,44,-13,-11,-2,16,-5,13,6,8,14,2,-2,2,6,2,4,14,-3,11,0,6,10,1,0,-6,-10,1,0,0,-1,-4,-7,1,0,1,1,-2,-3,0,0,-3,8,-11,7,9,-2,0,-21,18,17,-12,0,1,-7,-5,23,-5,4,-1,-14,23,-6,-7,-4,-1,-2,10,1,0,-1,-1,2,6,3,0,-1,0,-4,4,-2,0,0,58,17,41,5,1,4,6,10,-6,26,18,2,4,-2,-13,14,15,-2,2,12,7,12,3,4,1,3,4,-3,0,0,0,3,1,-3,1,-1,1,0,3,0,-1,1,61,33,28,16,8,8,19,-7,22,29,-2,-1,5,-11,16,25,3,-4,14,4,6,4,-5,3,8,-1,11,0,-2,0,4,-2,6,1,-1,0,4,1,5,-1,-1,0,48,23,25,-2,1,-3,9,5,6,15,-8,17,13,7,-5,7,-1,4,-4,-2,11,8,-7,13,-2,7,-4,-5,1,1,0,5,-2,-2,0,0,-2,2,-2,-3,1,1
8,08029,Cabrera de Mar,3628,39,1,38,22,11,11,16,13,10,-6,8,-1,3,-1,1,-5,4,-2,13,14,9,-1,4,1,4,5,9,2,2,0,2,2,5,0,2,0,2,3,4,2,0,0,58,18,40,26,7,19,19,6,13,15,-4,8,11,-2,0,7,-3,4,8,8,13,8,-1,4,3,6,12,4,1,0,1,1,4,1,0,0,2,5,8,3,1,0,12,10,2,44,18,26,1,8,-6,6,6,-1,5,5,-5,3,3,0,-4,3,-1,3,3,-1,12,6,12,9,4,0,6,4,2,4,1,0,6,2,10,5,3,0,130,91,39,38,20,18,36,-3,51,33,4,2,17,-5,32,31,4,7,19,2,19,2,0,-5,8,2,16,7,4,0,2,1,10,4,2,1,6,1,6,3,2,-1,86,36,50,34,16,18,25,6,5,30,10,3,15,3,-13,16,7,2,10,3,18,14,3,1,8,6,9,6,6,0,4,3,4,2,3,0,4,3,5,4,3,0,-11,-11,0,19,10,9,2,-5,-7,-4,3,1,-4,-3,-4,-2,3,0,6,-2,-3,-2,0,1,3,8,8,-1,1,0,2,2,6,0,0,0,1,6,2,-1,1,0,99,65,34,20,12,8,33,8,0,36,13,2,15,8,2,25,11,-1,18,0,-2,11,2,3,5,4,3,1,3,2,2,0,4,1,2,2,3,4,-1,0,1,0,39,16,23,34,20,14,2,16,17,-4,-2,6,-5,8,21,-13,-1,3,7,8,-4,9,-1,3,3,8,6,8,5,2,2,3,7,3,4,1,1,5,-1,5,1,1,37,39,-2,8,1,7,17,0,17,10,-6,-8,15,0,14,5,1,-1,2,0,3,5,-7,-7,1,2,4,4,-2,-1,0,1,2,0,-1,-1,1,1,2,4,-1,0,65,21,44,31,17,14,45,0,10,9,-1,0,20,-4,1,4,-7,5,25,4,9,5,6,-5,7,4,10,7,2,0,5,1,4,5,1,0,2,3,6,2,1,0,-5,-6,1,-33,-16,-17,6,2,-5,8,-10,-9,3,2,-7,9,-11,-2,3,0,2,-1,1,-7,-4,-2,-13,-8,-7,-1,-1,-1,-8,-2,-4,0,-3,-1,-5,-6,-3,-1,6,0,6,-2,-1,-1,12,0,-13,13,-3,-5,7,-2,-2,1,-4,-2,5,2,-11,12,1,-3,-1,1,-5,-1,1,2,0,-1,-2,0,0,1,-1,2,-3,-1,1,1,19,8,11,15,8,7,9,3,8,3,-10,4,2,2,4,2,-1,-3,7,1,4,1,-9,7,3,3,3,8,-2,0,1,3,3,2,-1,0,2,0,0,6,-1,0,-2,8,-10,-8,-5,-3,-3,-15,-16,19,8,-1,0,-5,-6,6,8,2,-3,-10,-10,13,0,-3,-2,-4,-2,-1,2,-1,-2,-1,-2,-1,2,-1,0,-3,0,0,0,0,-1,-4,3,4,0,4,11,1,-12,11,-23,9,12,3,-9,5,-16,1,-1,-2,-3,6,-7,8,-2,2,3,0,1,0,-1,0,1,0,0,0,-1,2,2,0,1,0,37,26,11,0,3,-3,12,7,-1,1,15,4,4,2,1,7,10,2,8,5,-2,-6,5,2,3,1,0,-3,0,-1,2,1,1,-2,1,0,1,0,-1,-1,-1,-1,45,30,15,34,23,11,19,-6,18,21,2,-9,10,-4,12,9,4,-2,9,-2,6,12,-2,-7,7,8,10,5,1,2,5,3,7,5,1,1,2,5,3,0,0,1,66,17,49,4,0,4,22,-1,26,21,4,-10,11,-1,4,10,-5,-4,11,0,22,11,9,-6,-2,1,5,-4,2,1,0,0,2,-3,1,0,-2,1,3,-1,1,1
8,08030,Cabrils,4352,226,100,126,73,34,39,49,21,76,50,14,13,17,10,33,24,10,6,32,11,43,26,4,7,15,16,26,12,4,0,6,8,13,5,2,0,9,8,13,7,2,0,199,86,113,100,41,59,30,25,63,44,13,24,17,12,32,15,5,6,13,13,31,29,8,18,19,21,32,18,5,5,6,11,15,7,1,1,13,10,17,11,4,4,333,154,179,54,26,28,88,35,71,87,26,20,37,12,24,49,20,9,51,23,47,38,6,11,9,19,7,13,6,0,7,10,2,5,2,0,2,9,5,8,4,0,244,108,136,55,27,28,76,18,43,79,4,17,38,7,16,37,-1,7,38,11,27,42,5,10,12,8,15,8,5,7,7,5,6,2,2,5,5,3,9,6,3,2,162,91,71,62,30,32,48,5,24,61,18,1,30,14,2,27,14,-2,18,-9,22,34,4,3,16,15,17,13,1,1,10,7,7,3,2,1,6,8,10,10,-1,0,234,98,136,39,16,23,73,14,64,68,3,4,32,12,17,37,-3,4,41,2,47,31,6,0,11,6,6,11,2,1,3,4,0,9,0,0,8,2,6,2,2,1,164,90,74,54,14,40,70,-16,32,58,12,5,36,-15,25,39,5,-1,34,-1,7,19,7,6,17,6,15,9,4,2,6,-2,6,3,0,1,11,8,9,6,4,1,97,59,38,29,10,19,34,0,18,39,-4,2,30,-2,-3,25,4,-1,4,2,21,14,-8,3,2,6,13,7,-1,1,2,2,2,2,0,1,0,4,11,5,-1,0,70,30,40,1,-12,13,27,-4,-1,38,-7,16,9,-4,8,20,-7,3,18,0,-9,18,0,13,1,3,1,3,-5,-2,-4,-4,0,2,-5,-1,5,7,1,1,0,-1,129,50,79,27,11,16,37,9,48,9,11,13,16,4,13,3,11,5,21,5,35,6,0,8,6,6,17,-4,-2,1,1,3,10,-2,-2,1,5,3,7,-2,0,0,53,13,40,10,-4,14,16,-5,9,32,-2,0,0,-2,8,10,-1,-3,16,-3,1,22,-1,3,2,2,6,2,-1,-1,-1,-1,3,-2,-3,0,3,3,3,4,2,-1,-65,-29,-36,-39,-12,-27,-10,-1,-20,-15,-12,-12,-7,-7,-6,-8,-2,-1,-3,6,-14,-7,-10,-11,-5,2,-8,-18,-1,-9,0,1,1,-10,-1,-3,-5,1,-9,-8,0,-6,32,23,9,-2,7,-9,15,-11,11,13,-16,13,8,-6,2,16,-7,5,7,-5,9,-3,-9,8,2,2,2,-2,-5,-3,4,1,1,0,0,-1,-2,1,1,-2,-5,-2,29,31,-2,16,11,5,-10,-6,-5,24,1,21,6,6,-3,20,-2,4,-16,-12,-2,4,3,17,0,5,5,5,0,0,2,0,3,5,0,1,-2,5,2,0,0,-1,28,19,9,12,6,6,39,-30,2,37,-18,-1,5,-16,7,18,1,4,34,-14,-5,19,-19,-5,9,-1,-6,5,4,1,4,-1,-4,2,5,0,5,0,-2,3,-1,1,27,18,9,17,3,14,-4,5,17,10,-2,-5,-4,12,17,-3,-3,-3,0,-7,0,13,1,-2,0,5,3,0,8,0,-2,1,5,-3,4,-3,2,4,-2,3,4,3,30,17,13,12,8,4,19,-6,14,0,-6,2,14,1,2,1,0,-3,5,-7,12,-1,-6,5,-5,11,3,-5,7,-1,-1,6,0,-3,7,-1,-4,5,3,-2,0,0,46,18,28,94,41,53,29,-15,-3,40,-3,-2,18,-7,-10,25,-5,-6,11,-8,7,15,2,4,25,7,18,23,14,6,10,3,8,12,5,2,15,4,10,11,9,4
8,08031,Calaf,3052,18,15,3,25,10,15,10,12,11,-6,-9,0,6,7,11,-5,-3,0,4,5,0,-1,-6,0,8,7,9,0,0,1,2,3,5,0,0,0,6,4,4,0,0,1,38,38,0,45,34,11,7,18,14,6,-3,-6,8,11,15,7,-2,-2,-1,7,-1,-1,-1,-4,12,16,9,6,1,0,10,11,8,4,0,0,2,5,1,2,1,0,39,44,-5,71,52,19,-4,21,7,8,8,0,-1,16,14,7,5,2,-3,5,-7,1,3,-2,12,16,31,9,2,0,7,10,25,7,2,0,5,6,6,2,0,0,112,80,32,82,44,38,21,37,36,13,8,-2,12,26,31,6,7,-2,9,11,5,7,1,0,19,31,24,5,2,1,10,18,14,1,1,0,9,13,10,4,1,1,52,37,15,98,67,31,8,22,13,5,0,2,4,24,5,1,2,1,4,-2,8,4,-2,1,13,30,36,13,2,2,7,21,28,8,2,1,6,9,8,5,0,1,67,41,26,115,74,41,33,21,5,7,-1,-1,23,9,1,6,0,0,10,12,4,1,-1,-1,32,26,40,15,1,0,18,16,30,9,1,0,14,10,10,6,0,0,127,84,43,111,67,44,44,30,35,29,-1,-8,19,20,27,24,-3,-3,25,10,8,5,2,-5,25,24,36,24,2,0,10,13,28,17,-1,0,15,11,8,7,3,0,116,81,35,106,65,41,20,32,19,42,5,-5,13,21,11,30,3,0,7,11,8,12,2,-5,20,38,26,17,4,0,14,21,16,13,1,0,6,17,10,4,3,0,62,33,29,86,48,38,21,17,16,8,-1,1,9,9,10,6,0,-1,12,8,6,2,-1,2,20,28,23,13,0,1,12,10,17,8,-1,1,8,18,6,5,1,0,-28,-25,-3,-3,-16,13,11,-1,-19,-9,-4,-4,4,-1,-13,-7,-5,-2,7,0,-6,-2,1,-2,1,8,-4,-8,0,0,-1,3,-9,-9,0,0,2,5,5,1,0,0,-91,-61,-30,-72,-56,-16,-22,-17,-19,-24,-8,-1,-9,-12,-17,-15,-6,-2,-13,-5,-2,-9,-2,1,-12,-8,-26,-22,-4,0,-6,-8,-20,-18,-3,-1,-6,0,-6,-4,-1,1,3,-22,25,18,-4,22,21,10,0,-18,-2,-5,6,8,-8,-21,-3,-2,15,2,8,3,1,-3,12,5,8,-12,5,-1,3,4,-1,-14,4,-1,9,1,9,2,1,0,-26,-19,-7,-28,-23,-5,4,3,-23,-14,3,6,0,1,-12,-13,3,3,4,2,-11,-1,0,3,6,-4,-10,-15,-5,1,3,-3,-7,-12,-4,0,3,-1,-3,-3,-1,1,-42,-29,-13,-23,-17,-6,-14,-5,-23,-6,2,1,-10,-5,-17,0,0,2,-4,0,-6,-6,2,-1,-8,3,-7,-7,-5,1,-6,0,-7,-2,-3,1,-2,3,0,-5,-2,0,-51,-42,-9,-24,-21,-3,-4,-6,-24,-13,0,-2,1,-6,-15,-18,0,-2,-5,0,-9,5,0,0,1,-2,-10,-6,-5,-1,1,-2,-7,-7,-4,-1,0,0,-3,1,-1,0,2,-1,3,-1,0,-1,-23,9,3,1,0,7,-13,4,5,0,2,-1,-10,5,-2,1,-2,8,-10,5,9,-4,-3,-1,-7,2,10,-3,-2,-1,-3,3,-1,-1,-1,0,69,28,41,18,0,18,15,13,6,17,17,1,10,-1,4,5,8,1,5,14,2,12,9,0,6,5,6,-2,4,-1,3,-2,1,-5,3,0,3,7,5,3,1,-1,52,8,44,38,13,25,19,6,-1,6,16,3,6,-2,-1,-1,7,-1,13,8,0,7,9,4,15,8,11,0,1,2,7,1,6,-1,0,0,8,7,5,1,1,2
8,08033,Caldes de Montbui,12445,279,177,102,160,100,60,36,63,107,45,14,16,9,52,70,27,10,8,27,11,37,18,4,8,11,54,64,24,5,2,5,37,43,13,2,0,6,17,21,11,3,2,407,239,168,263,167,96,81,92,132,61,25,11,32,62,91,31,14,7,49,30,41,30,11,4,43,78,93,42,4,2,23,51,68,22,1,1,20,27,25,20,3,1,372,182,190,183,107,76,71,99,70,85,24,13,38,43,34,47,12,5,33,56,36,38,12,8,27,69,51,29,5,1,14,37,36,19,1,0,13,32,15,10,4,1,364,174,190,205,115,90,73,80,131,48,2,15,52,39,63,21,-2,-2,21,41,68,27,4,17,37,65,68,24,5,2,22,40,39,12,1,0,15,25,29,12,4,2,373,168,205,140,82,58,91,60,83,87,26,20,42,26,22,55,10,11,49,34,61,32,16,9,16,38,54,23,7,0,8,21,32,18,1,0,8,17,22,5,6,0,335,179,156,184,98,86,62,49,120,74,14,6,34,26,68,43,7,-2,28,23,52,31,7,8,36,50,54,31,9,2,16,29,33,16,3,1,20,21,21,15,6,1,315,160,155,229,127,102,66,71,77,53,41,13,26,46,39,26,18,7,40,25,38,27,23,6,43,55,71,41,14,4,21,34,42,21,7,2,22,21,29,20,7,2,337,159,178,214,113,101,76,47,132,29,23,24,35,26,76,2,11,10,41,21,56,27,12,14,48,60,60,27,15,4,24,32,38,12,6,1,24,28,22,15,9,3,345,173,172,177,95,82,73,71,102,31,20,49,43,28,64,18,8,14,30,43,38,13,12,35,41,54,55,20,7,0,22,28,32,10,3,0,19,26,23,10,4,0,132,49,83,40,28,12,25,29,45,7,7,14,3,8,17,5,7,4,22,21,28,2,0,10,10,16,4,9,0,1,10,12,1,4,1,-1,0,4,3,5,-1,2,109,64,45,59,35,24,15,19,60,-6,14,10,16,20,32,-8,5,-1,-1,-1,28,2,9,11,14,22,18,4,2,-3,8,12,11,3,2,-1,6,10,7,1,0,-2,27,-8,35,45,26,19,2,-11,-17,12,14,22,3,-4,-25,2,7,6,-1,-7,8,10,7,16,16,12,-9,12,10,3,10,7,-8,8,6,2,6,5,-1,4,4,1,-211,-135,-76,-239,-152,-87,-1,-34,-78,-84,-29,9,-8,-19,-50,-47,-16,6,7,-15,-28,-37,-13,3,-13,-10,-77,-85,-40,-14,-13,-5,-51,-53,-25,-5,0,-5,-26,-32,-15,-9,-32,-44,12,-40,-15,-25,16,-13,-28,18,-49,23,1,-6,-19,3,-28,4,15,-7,-9,15,-21,19,0,5,-15,-18,-10,-3,3,0,-6,-6,-6,0,-3,5,-9,-12,-4,-3,-33,-23,-10,-76,-61,-15,-1,-3,-25,-31,-7,35,-3,2,-17,-4,-6,7,2,-5,-8,-27,-1,28,-9,3,-25,-41,-6,2,0,-3,-23,-29,-6,0,-9,6,-2,-12,0,2,108,32,76,-27,-17,-10,47,-12,43,-3,-13,42,26,-7,23,-10,-19,19,21,-5,20,7,6,23,-3,8,-22,-12,4,-2,-3,4,-9,-10,0,1,0,4,-13,-2,4,-3,81,21,60,-4,-17,13,20,5,-5,19,-8,44,10,2,-15,9,-2,15,10,3,10,10,-6,29,9,7,5,-18,-9,1,1,0,0,-14,-5,0,8,7,5,-4,-4,1,229,132,97,53,32,21,61,54,69,50,-2,-2,36,32,41,30,0,-9,25,22,28,20,-2,7,12,19,11,14,0,-2,9,13,7,3,2,-2,3,6,4,11,-2,0
8,08032,Caldes d'Estrac,1937,79,50,29,48,26,22,27,19,7,24,5,-6,17,9,8,17,2,-4,10,10,-1,7,3,-2,18,8,8,11,3,0,11,6,2,5,2,0,7,2,6,6,1,0,125,49,76,50,28,22,21,-1,42,24,8,30,10,-3,13,18,1,9,11,2,29,6,7,21,10,7,22,7,4,0,5,5,10,5,3,0,5,2,12,2,1,0,188,98,90,73,38,35,23,24,66,25,23,25,12,14,27,18,18,6,11,10,39,7,5,19,12,13,25,14,9,0,7,5,13,9,5,-1,5,8,12,5,4,1,162,82,80,52,25,27,11,26,34,29,28,31,11,15,25,7,15,5,0,11,9,22,13,26,7,18,12,8,2,1,3,11,6,0,2,0,4,7,6,8,0,1,68,14,54,67,33,34,-12,9,20,12,21,16,-15,5,6,3,8,6,3,4,14,9,13,10,17,10,16,16,5,2,7,4,9,10,3,0,10,6,7,6,2,2,103,45,58,50,25,25,-4,17,38,15,13,22,-1,11,11,13,6,3,-3,6,27,2,7,19,12,12,18,7,1,0,6,8,9,2,0,0,6,4,9,5,1,0,116,57,59,66,33,33,22,7,22,19,25,21,11,1,22,2,12,7,11,6,0,17,13,14,16,13,14,15,7,0,10,7,8,3,4,0,6,6,6,12,3,0,81,21,60,29,10,19,17,13,13,15,-2,18,-2,9,-1,8,-1,4,19,4,14,7,-1,14,2,9,12,-2,4,2,-1,4,5,-2,2,1,3,5,7,0,2,1,79,36,43,21,2,19,-4,16,28,20,-3,22,0,1,10,15,4,8,-4,15,18,5,-7,14,5,6,14,2,-6,0,2,2,2,1,-4,-1,3,4,12,1,-2,1,3,-16,19,-27,-12,-15,-8,2,-7,-10,6,21,-9,3,-9,-6,0,6,1,-1,2,-4,6,15,-2,-4,-2,-9,-5,-4,2,-5,-1,-1,-5,-1,-4,1,-1,-8,0,-3,22,4,18,-7,-2,-5,-4,-3,-15,1,11,28,-1,-3,-5,-1,3,9,-3,0,-10,2,8,19,-3,-1,-6,-3,4,1,-1,-1,-1,0,1,0,-2,0,-5,-3,3,1,23,-12,35,3,-10,13,11,11,3,-1,-4,1,-1,2,-7,3,-3,-4,12,9,10,-4,-1,5,6,6,-3,-2,-3,-2,2,-1,-5,-2,-3,-1,4,7,2,0,0,-1,19,13,6,-3,2,-5,-9,6,-1,6,-1,16,0,2,1,1,1,6,-9,4,-2,5,-2,10,-2,0,-6,2,2,1,1,1,-4,1,2,1,-3,-1,-2,1,0,0,6,10,-4,-19,-4,-15,4,-14,1,1,5,12,3,-6,8,0,1,5,1,-8,-7,1,4,7,-1,-1,-4,-5,-5,-3,-2,0,-1,2,-1,-2,1,-1,-3,-7,-4,-1,7,7,0,-24,-12,-12,6,0,3,-3,-24,24,2,10,1,3,-11,0,4,-10,2,-6,-13,24,0,0,-8,-8,-9,1,1,2,-6,-5,-4,0,-1,-2,-2,-3,-5,1,75,29,46,37,17,20,11,5,20,14,3,21,8,1,11,11,5,-5,3,4,9,3,-2,26,8,6,12,6,-1,4,7,2,4,3,-1,1,1,4,8,3,0,3,101,30,71,15,1,14,13,25,14,34,7,9,12,8,6,8,2,-5,1,17,8,26,5,14,-1,5,6,5,2,-2,1,-2,3,0,0,-1,-2,7,3,5,2,-1,47,26,21,17,11,6,12,4,-8,19,6,16,10,9,-5,17,-8,4,2,-5,-3,2,14,12,5,1,5,6,-4,2,4,2,2,6,-6,2,1,-1,3,0,2,0
8,08035,Calella,12503,687,367,320,412,244,168,97,127,188,113,108,51,57,59,120,55,60,14,40,68,68,58,48,37,42,111,136,71,41,9,29,59,88,44,20,3,13,52,48,27,21,6,689,362,327,541,299,242,92,123,257,114,45,50,46,69,141,69,14,21,46,54,116,45,31,29,93,116,199,94,23,10,44,61,121,53,10,6,49,55,78,41,13,4,870,455,415,648,367,281,110,164,253,166,66,101,62,90,133,99,34,29,48,74,120,67,32,72,100,172,225,102,33,9,51,90,140,61,16,4,49,82,85,41,17,5,780,402,378,500,284,216,90,160,234,143,93,67,28,90,140,75,45,28,62,70,94,68,48,39,62,132,160,81,51,12,32,74,97,53,22,6,30,58,63,28,29,6,714,369,345,472,266,206,82,125,197,132,84,89,41,57,133,61,39,33,41,68,64,71,45,56,60,123,160,84,25,13,28,62,106,50,14,5,32,61,54,34,11,8,756,355,401,505,286,219,68,186,265,81,98,68,38,103,131,25,35,33,30,83,134,56,63,35,68,146,157,86,35,11,44,80,96,45,14,7,24,66,61,41,21,4,701,397,304,490,286,204,94,188,213,41,89,73,49,110,126,32,43,30,45,78,87,9,46,43,70,177,139,64,32,7,36,104,81,43,16,5,34,73,58,21,16,2,455,198,257,311,125,186,80,89,94,23,61,111,28,47,32,9,42,40,52,42,62,14,19,71,71,89,94,24,31,1,29,43,36,-3,22,-2,42,46,58,27,9,3,132,44,88,90,43,47,49,37,-33,13,-12,83,37,30,-25,-12,-7,21,12,7,-8,25,-5,62,26,71,23,5,-22,-14,14,43,9,-7,-12,-7,12,28,14,12,-10,-7,46,40,6,-28,-25,-3,8,26,-29,-18,7,59,7,16,-19,17,3,22,1,10,-10,-35,4,37,14,9,8,-41,-18,-2,12,-1,-3,-19,-12,-2,2,10,11,-22,-6,0,102,76,26,-36,-21,-15,29,31,-84,25,30,69,41,32,-44,-3,23,26,-12,-1,-40,28,7,43,20,22,-55,-8,-19,0,21,8,-32,-10,-10,-1,-1,14,-23,2,-9,1,-111,-137,26,-137,-91,-46,-17,1,-73,-83,2,48,-13,-8,-83,-50,-10,18,-4,9,10,-33,12,30,-19,9,-51,-59,-16,-9,-5,4,-36,-39,-14,-7,-14,5,-15,-20,-2,-2,57,-19,76,-29,-32,3,15,-15,-36,11,19,75,-5,-11,-26,-5,10,25,20,-4,-10,16,9,50,21,13,-37,-14,-7,-5,19,1,-29,-20,-7,4,2,12,-8,6,0,-9,-46,-51,5,-35,-48,13,-5,1,-97,-16,3,71,8,-11,-62,-12,1,24,-13,12,-35,-4,2,47,16,8,-41,-11,-5,-2,11,-10,-34,-8,-9,1,5,18,-7,-3,4,-3,33,-31,64,-70,-54,-16,-27,-24,5,4,-24,91,-26,-19,-6,8,-13,20,-1,-5,11,-4,-11,71,-8,-4,-37,-17,-10,5,-9,-3,-23,-19,-3,2,1,-1,-14,2,-7,3,220,121,99,44,51,-7,-15,52,0,52,51,83,-7,14,21,44,15,35,-8,38,-21,8,36,48,-11,33,11,18,-10,-1,-3,12,23,17,-1,1,-8,21,-12,1,-9,-2,341,121,220,137,54,83,60,20,69,27,53,103,11,26,37,-5,18,28,49,-6,32,32,35,75,32,27,54,15,11,-2,10,18,25,2,-2,0,22,9,29,13,13,-2,422,179,243,209,112,97,72,47,72,82,56,88,29,23,44,22,30,26,43,24,28,60,26,62,43,60,34,37,24,11,20,38,27,10,15,2,23,22,7,27,9,9
8,08037,Calldetenes,1920,42,28,14,33,21,12,17,12,13,4,-2,-2,10,11,11,0,-2,-2,7,1,2,4,0,0,10,6,11,5,0,1,6,4,7,4,0,0,4,2,4,1,0,1,13,2,11,8,5,3,1,15,-5,-4,5,0,-1,7,-4,-1,2,-1,2,8,-1,-3,3,1,0,5,3,0,0,0,0,3,2,0,0,0,0,2,1,0,0,0,24,31,-7,37,24,13,-2,6,16,4,0,1,8,4,15,4,-1,2,-10,2,1,0,1,-1,8,10,11,5,1,2,4,7,9,2,0,2,4,3,2,3,1,0,47,20,27,18,10,8,17,8,-4,21,7,-2,9,3,-1,7,3,-2,8,5,-3,14,4,0,6,3,2,7,0,0,4,0,2,4,0,0,2,3,0,3,0,0,43,30,13,22,19,3,6,-1,20,16,4,-3,2,1,7,15,3,-1,4,-2,13,1,1,-2,1,8,6,7,0,0,0,6,6,7,0,0,1,2,0,0,0,0,33,6,27,32,11,21,9,1,6,6,5,7,-1,-2,1,3,4,2,10,3,5,3,1,5,20,2,6,2,1,1,7,0,3,0,1,0,13,2,3,2,0,1,49,24,25,9,2,7,-5,10,19,7,5,10,-2,3,11,5,0,5,-3,7,8,2,5,5,3,3,-2,2,1,2,1,1,-3,2,0,1,2,2,1,0,1,1,67,22,45,18,10,8,12,12,23,13,6,-2,6,4,8,1,4,-1,6,8,15,12,2,-1,5,6,3,3,1,0,4,2,2,1,1,0,1,4,1,2,0,0,47,30,17,12,5,7,7,12,28,2,-1,-2,5,2,24,0,-1,-2,2,10,4,2,0,0,4,7,4,0,-1,-2,2,2,3,0,-1,-1,2,5,1,0,0,-1,34,15,19,12,7,5,8,19,6,1,2,-2,5,8,0,1,1,1,3,11,6,0,1,-3,5,7,3,0,-1,-2,5,2,1,0,0,-1,0,5,2,0,-1,-1,-14,-2,-12,-6,-8,2,-9,-7,9,-2,-4,-1,-3,0,0,3,-3,1,-6,-7,9,-5,-1,-2,1,0,0,-4,-3,0,1,-2,-2,-2,-3,0,0,2,2,-2,0,0,-6,-9,3,1,1,0,-10,1,-4,0,5,-1,-1,-3,0,-4,0,-3,-9,4,-4,4,5,2,2,0,-2,1,0,0,1,1,-1,1,-1,0,1,-1,-1,0,1,0,23,14,9,-3,1,-4,5,-7,14,8,-1,5,0,-1,7,2,0,6,5,-6,7,6,-1,-1,0,1,-2,-2,-1,1,0,1,1,-1,0,0,0,0,-3,-1,-1,1,-48,-25,-23,1,0,1,-21,-3,-5,-12,-4,0,-9,-1,-8,-3,-3,1,-12,-2,3,-9,-1,-1,-1,1,0,0,0,1,-1,1,-1,1,0,0,0,0,1,-1,0,1,-18,-11,-7,-5,-1,-4,-1,2,-17,-10,1,5,5,-1,-10,-8,-1,2,-6,3,-7,-2,2,3,-4,0,-1,-1,0,1,-1,0,0,-1,0,1,-3,0,-1,0,0,0,-15,-6,-9,4,1,3,-2,1,5,-7,-7,-4,-1,1,6,-7,-3,-1,-1,0,-1,0,-4,-3,3,1,1,0,-1,0,1,0,1,0,-1,0,2,1,0,0,0,0,36,20,16,5,5,0,1,5,16,12,-1,4,-2,3,10,11,-2,0,3,2,6,1,1,4,2,1,2,0,-1,1,1,1,3,0,0,0,1,0,-1,0,-1,1,46,24,22,8,7,1,12,6,10,14,0,3,0,6,4,9,2,2,12,0,6,5,-2,1,1,2,1,3,0,1,0,1,2,3,1,0,1,1,-1,0,-1,1
8,08038,Callús,1347,8,-1,9,4,2,2,2,0,0,3,0,3,-2,-2,0,3,-1,1,4,2,0,0,1,2,1,1,1,1,0,0,0,0,1,1,0,0,1,1,0,0,0,0,31,17,14,18,9,9,9,3,10,4,1,3,4,1,9,1,0,2,5,2,1,3,1,1,5,6,6,0,0,0,2,3,4,0,0,0,3,3,2,0,0,0,54,33,21,12,6,6,-3,15,26,9,5,2,1,8,15,7,2,0,-4,7,11,2,3,2,0,7,3,2,0,0,0,2,3,1,0,0,0,5,0,1,0,0,21,9,12,12,0,12,11,6,11,0,1,-9,7,1,3,0,2,-4,4,5,8,0,-1,-5,2,3,5,0,1,1,0,-1,0,0,1,0,2,4,5,0,0,1,41,15,26,22,11,11,7,0,15,17,0,1,1,-2,3,12,-1,2,6,2,12,5,1,-1,4,5,6,5,3,-1,1,1,3,4,2,0,3,4,3,1,1,-1,92,48,44,16,7,9,21,16,21,23,7,1,12,8,5,18,2,0,9,8,16,5,5,1,4,7,2,2,1,0,1,6,0,0,0,0,3,1,2,2,1,0,42,17,25,17,2,15,11,4,10,14,2,3,6,-1,8,5,0,-1,5,5,2,9,2,4,3,6,3,2,3,0,2,0,0,0,0,0,1,6,3,2,3,0,49,26,23,12,4,8,0,3,20,4,7,12,-1,3,11,4,3,4,1,0,9,0,4,8,0,2,3,3,1,2,0,1,2,0,0,1,0,1,1,3,1,1,87,36,51,22,10,12,23,13,46,0,-7,10,17,2,16,4,-6,3,6,11,30,-4,-1,7,4,6,7,2,0,2,3,2,3,1,0,1,1,4,4,1,0,1,85,41,44,12,3,9,30,9,15,12,6,10,17,-3,12,7,2,4,13,12,3,5,4,6,6,2,1,0,0,2,1,-2,1,1,0,1,5,4,0,-1,0,1,83,40,43,1,-1,2,5,10,38,5,11,15,1,8,16,5,6,3,4,2,22,0,5,12,0,-1,2,-1,0,1,0,0,0,0,-1,0,0,-1,2,-1,1,1,-34,-8,-26,-9,-6,-3,-13,3,-7,-7,-6,-4,-2,1,1,-2,-5,-1,-11,2,-8,-5,-1,-3,-2,0,-2,-3,0,-2,-1,0,-1,-2,-1,-1,-1,0,-1,-1,1,-1,-6,-6,0,-1,-1,0,-7,8,-8,1,-3,5,-6,4,-2,0,0,-1,-1,4,-6,1,-3,6,-3,2,1,-2,0,0,0,1,0,-1,0,-1,-3,1,1,-1,0,1,94,31,63,-8,-8,0,23,17,20,19,14,-2,14,3,6,2,7,-2,9,14,14,17,7,0,-3,1,-2,-2,0,-2,-3,-1,0,-3,0,-1,0,2,-2,1,0,-1,41,32,9,-8,-5,-3,-7,5,13,11,10,8,-2,3,12,9,7,3,-5,2,1,2,3,5,-4,1,-2,-4,1,0,-2,1,-1,-3,0,0,-2,0,-1,-1,1,0,31,10,21,11,3,8,3,-2,22,-3,5,5,-1,-1,13,-2,1,0,4,-1,9,-1,4,5,5,2,2,1,2,-1,3,-1,0,1,0,0,2,3,2,0,2,-1,10,5,5,-10,-4,-6,-7,16,1,3,-4,0,-1,6,1,1,-1,0,-6,10,0,2,-3,0,-6,2,-3,-1,-2,-1,-3,1,0,-1,-1,0,-3,1,-3,0,-1,-1,24,16,8,18,13,5,12,-2,7,2,4,2,12,3,-3,5,2,-2,0,-5,10,-3,2,4,5,1,5,5,2,0,5,1,4,4,0,-1,0,0,1,1,2,1
8,08040,Canet de Mar,9852,520,293,227,134,71,63,87,70,159,100,78,22,52,46,82,60,41,9,35,24,77,40,37,13,32,25,36,32,5,2,15,16,17,18,2,2,17,9,19,14,3,0,495,229,266,144,65,79,91,75,115,83,64,61,54,34,56,38,34,7,37,41,59,45,30,54,45,24,43,18,9,2,25,11,14,10,2,1,20,13,29,8,7,1,514,259,255,157,70,87,96,63,166,85,48,49,39,24,95,46,27,23,57,39,71,39,21,26,45,27,48,23,8,5,21,10,23,12,3,1,24,17,25,11,5,4,403,183,220,129,58,71,62,56,111,30,58,82,39,18,67,4,28,24,23,38,44,26,30,58,31,29,33,19,9,7,20,12,17,3,3,3,11,17,16,16,6,4,346,166,180,139,65,74,63,43,42,97,47,53,37,16,25,41,23,21,26,27,17,56,24,32,28,39,26,25,14,7,17,16,12,11,6,3,11,23,14,14,8,4,239,73,166,104,48,56,27,26,77,3,42,57,20,4,20,-1,11,12,7,22,57,4,31,45,21,23,21,24,13,1,13,12,9,10,2,1,8,11,12,14,11,0,510,276,234,149,71,78,69,63,169,99,65,44,35,23,92,57,45,21,34,40,77,42,20,23,23,28,46,32,13,5,11,9,23,16,9,2,12,19,23,16,4,3,216,144,72,114,63,51,6,3,93,23,35,54,3,4,68,27,12,26,3,-1,25,-4,23,28,23,28,36,18,9,0,11,15,23,7,5,2,12,13,13,11,4,-2,247,130,117,113,56,57,46,24,91,40,-3,44,41,16,50,11,-1,10,5,8,41,29,-2,34,23,22,42,16,6,2,16,10,16,11,2,0,7,12,26,5,4,2,275,117,158,75,31,44,12,25,52,32,55,95,12,-3,30,15,25,37,0,28,22,17,30,58,13,17,15,12,8,7,7,4,7,5,3,4,6,13,8,7,5,3,57,8,49,-32,-13,-19,-35,9,-36,30,7,79,-19,-4,-18,22,-1,26,-16,13,-18,8,8,53,-14,11,-24,-2,1,-5,-4,1,-12,1,2,-2,-10,10,-12,-3,-1,-3,161,60,101,-38,-28,-10,17,26,15,-3,-3,102,10,12,17,-9,-4,33,7,14,-2,6,1,69,-5,4,1,-23,-12,-3,-6,2,2,-11,-11,-4,1,2,-1,-12,-1,1,7,-32,39,-124,-73,-51,14,-10,-26,-15,-7,51,5,-17,-18,-25,4,18,9,7,-8,10,-11,33,-10,-14,-32,-43,-22,-3,-7,-10,-15,-32,-9,0,-3,-4,-17,-11,-13,-3,67,0,67,-5,-16,11,-4,9,-19,-6,5,69,-5,-5,-22,-7,9,22,1,14,3,1,-4,47,4,4,0,-8,-3,-5,3,1,-7,-9,-2,-3,1,3,7,1,-1,-2,139,65,74,-11,-6,-5,42,-10,38,6,12,51,20,-7,31,-3,5,17,22,-3,7,9,7,34,2,-8,-3,2,-3,-2,2,-6,-3,1,1,-1,0,-2,0,1,-4,-1,143,55,88,40,21,19,-9,30,14,3,9,95,-10,13,7,0,13,31,1,17,7,3,-4,64,3,14,5,11,7,0,4,7,1,7,3,-1,-1,7,4,4,4,1,220,95,125,25,20,5,49,-2,35,50,42,49,27,10,4,22,14,23,22,-12,31,28,28,26,11,3,0,4,3,1,7,5,0,5,2,0,4,-2,0,-1,1,1,274,100,174,41,15,26,22,21,41,50,38,103,9,4,25,18,20,26,13,17,16,32,18,77,-2,7,29,9,-3,-1,2,-2,12,4,-1,-2,-4,9,17,5,-2,1
8,08041,Canovelles,13165,-104,-35,-69,40,25,15,3,-26,-45,-12,-15,-15,8,-4,-27,1,-12,-2,-5,-22,-18,-13,-3,-13,4,16,13,2,4,1,2,13,7,1,1,1,2,3,6,1,3,0,220,168,52,235,148,87,42,43,74,47,0,8,26,33,47,42,8,5,16,10,27,5,-8,3,41,56,92,38,4,3,23,33,60,28,3,0,18,23,32,10,1,3,276,187,89,349,205,144,63,124,76,27,-11,-2,36,79,65,17,-12,2,27,45,11,10,1,-4,65,112,106,59,5,1,30,70,68,34,2,0,35,42,38,25,3,1,351,210,141,261,134,127,82,83,141,37,4,-1,38,43,118,2,5,-1,44,40,23,35,-1,0,58,77,80,33,9,3,35,33,50,11,4,1,23,44,30,22,5,2,557,408,149,418,273,145,66,186,210,102,-12,-9,38,102,200,70,-5,-6,28,84,10,32,-7,-3,81,115,150,51,17,0,40,68,117,38,7,0,41,47,33,13,10,0,298,192,106,395,233,162,68,92,87,75,-5,-22,35,47,70,53,-2,-13,33,45,17,22,-3,-9,73,116,124,61,15,3,43,68,79,38,4,0,30,48,45,23,11,3,456,309,147,413,258,155,88,155,145,71,-15,4,70,103,91,48,-17,9,18,52,54,23,2,-5,61,140,147,52,7,5,40,89,99,21,3,5,21,51,48,31,4,0,160,174,-14,376,237,139,38,92,51,18,-3,-39,36,78,54,18,4,-18,2,14,-3,0,-7,-21,95,120,121,38,3,0,56,83,74,21,2,1,39,37,47,17,1,-1,41,19,22,200,111,89,37,45,-9,-31,-9,-2,29,30,-13,-27,-12,2,8,15,4,-4,3,-4,63,77,66,-11,4,-2,41,47,37,-14,-3,0,22,30,29,3,7,-2,-158,-144,-14,14,-12,26,49,-6,-137,-28,-29,-23,37,2,-121,-37,-17,-14,12,-8,-16,9,-12,-9,25,32,-23,-11,-6,-8,21,23,-28,-19,-4,-9,4,9,5,8,-2,1,-434,-282,-152,-229,-154,-75,-32,-61,-212,-89,-23,-12,-14,-34,-151,-68,-8,-3,-18,-27,-61,-21,-15,-9,-25,-25,-103,-62,-15,1,-11,-18,-73,-45,-8,1,-14,-7,-30,-17,-7,0,174,98,76,94,67,27,54,67,4,44,17,-16,35,39,-2,18,15,-3,19,28,6,26,2,-13,30,41,12,1,8,-3,29,19,8,4,6,1,1,22,4,-3,2,-4,-136,-98,-38,-49,-56,7,-2,-1,-89,-22,-14,1,5,-10,-61,-11,-17,5,-7,9,-28,-11,3,-4,6,16,-38,-25,-11,2,2,3,-34,-22,-9,3,4,13,-4,-3,-2,-1,-74,-29,-45,-18,-20,2,3,-23,-19,5,-24,-14,1,-11,3,-7,-12,-1,2,-12,-22,12,-12,-13,1,0,-13,-5,1,-3,-2,4,-11,-9,-4,0,3,-4,-2,4,5,-3,-72,-73,1,-40,-40,0,-2,-9,-61,-12,-1,13,-19,-11,-48,-2,-1,4,17,2,-13,-10,0,9,-3,-15,-14,-10,-2,3,-1,-16,-14,-10,-1,1,-2,1,0,0,-1,2,37,63,-26,40,27,13,26,-19,34,-8,-3,1,30,0,32,-6,-2,5,-4,-19,2,-2,-1,-4,18,11,2,3,0,5,12,11,2,3,-3,1,6,0,0,0,3,4,170,66,104,95,39,56,56,48,42,13,12,-6,46,7,14,-9,4,4,10,41,28,22,8,-10,11,30,48,-2,2,3,5,15,21,-7,2,2,6,15,27,5,0,1,239,188,51,217,143,74,29,66,89,30,40,-24,19,47,70,25,36,-16,10,19,19,5,4,-8,34,62,79,28,10,1,20,46,55,17,5,-2,14,16,24,11,5,3
8,08042,Cànoves i Samalús,1750,72,43,29,11,10,1,14,7,20,22,7,1,6,4,17,14,2,0,8,3,3,8,5,1,1,1,8,0,0,1,0,1,8,0,0,1,1,0,0,0,0,0,108,85,23,27,23,4,27,14,30,32,3,3,17,19,24,20,5,1,10,-5,6,12,-2,2,0,11,12,4,0,0,0,10,9,4,0,0,0,1,3,0,0,0,78,25,53,14,5,9,14,15,27,7,13,0,0,6,15,-1,6,-1,14,9,12,8,7,1,3,1,5,3,0,2,1,1,2,0,0,1,2,0,3,3,0,1,140,64,76,4,4,0,31,11,44,22,14,13,18,8,17,9,6,5,13,3,27,13,8,8,3,1,0,0,0,0,3,0,1,0,0,0,0,1,-1,0,0,0,63,29,34,14,7,7,13,10,5,5,16,12,10,4,-8,4,11,7,3,6,13,1,5,5,3,3,3,1,1,3,2,1,2,0,1,1,1,2,1,1,0,2,114,64,50,5,3,2,25,2,50,25,3,8,13,4,27,16,3,0,12,-2,23,9,0,8,0,0,1,1,0,3,0,0,1,1,0,1,0,0,0,0,0,2,142,68,74,14,9,5,18,17,56,12,23,12,3,11,25,7,13,7,15,6,31,5,10,5,0,4,8,0,2,0,0,2,5,0,2,0,0,2,3,0,0,0,52,17,35,20,13,7,11,6,9,12,9,3,-1,8,7,2,4,-3,12,-2,2,10,5,6,5,4,5,4,2,0,4,4,1,3,1,0,1,0,4,1,1,0,37,15,22,5,1,4,5,-8,28,-4,6,1,1,-9,15,2,3,-3,4,1,13,-6,3,4,1,3,0,0,1,0,-1,3,0,-1,0,0,2,0,0,1,1,0,60,37,23,5,0,5,11,5,20,4,14,3,12,-1,12,5,6,3,-1,6,8,-1,8,0,0,4,1,-1,1,0,0,1,-1,0,0,0,0,3,2,-1,1,0,-9,-2,-7,-14,-8,-6,0,-3,-7,-8,-1,9,4,0,-3,-6,-1,4,-4,-3,-4,-2,0,5,0,2,-6,-7,-3,-1,0,1,-4,-4,-1,0,0,1,-2,-3,-2,-1,32,15,17,7,1,6,2,3,19,8,-3,1,-3,2,14,1,-1,1,5,1,5,7,-2,0,0,1,2,4,0,0,0,0,0,1,0,0,0,1,2,3,0,0,14,5,9,-7,-5,-2,3,-7,17,11,-6,-6,1,-3,6,6,-2,-3,2,-4,11,5,-4,-3,-2,-2,0,-2,-2,-1,-1,-1,-2,-1,0,0,-1,-1,2,-1,-2,-1,-10,-15,5,-5,-5,0,-7,1,0,-4,1,-1,-6,-3,-2,0,-1,-2,-1,4,2,-4,2,1,-1,0,-1,-3,0,0,-2,0,-1,-1,-1,0,1,0,0,-2,1,0,27,17,10,-11,-1,-10,15,-10,-8,14,2,10,10,1,-12,8,1,8,5,-11,4,6,1,2,-1,-1,-8,-1,-1,0,1,1,-3,0,0,0,-2,-2,-5,-1,-1,0,-36,-20,-16,0,-1,1,-6,-2,6,-12,-12,-10,-1,3,-1,-7,-5,-9,-5,-5,7,-5,-7,-1,0,0,1,0,-1,0,0,-1,1,0,-1,0,0,1,0,0,0,0,22,10,12,5,3,2,19,11,5,7,-12,-8,10,4,0,4,-1,-5,9,7,5,3,-11,-3,2,2,-2,2,1,0,1,1,-1,2,0,0,1,1,-1,0,1,0,78,40,38,6,1,5,17,-6,29,22,13,0,10,-4,12,17,3,2,7,-2,17,5,10,-2,2,-2,2,3,0,1,1,-2,2,1,-1,0,1,0,0,2,1,1
8,08043,Canyelles,1684,174,91,83,8,2,6,42,21,56,39,14,1,22,10,26,20,10,1,20,11,30,19,4,0,0,2,3,1,0,2,0,0,1,0,0,1,0,2,2,1,0,1,225,124,101,35,20,15,50,33,54,57,26,2,27,20,27,28,19,2,23,13,27,29,7,0,9,6,9,7,2,2,4,5,6,4,0,1,5,1,3,3,2,1,229,117,112,40,19,21,39,26,60,68,33,1,18,19,20,42,17,-1,21,7,40,26,16,2,11,6,10,7,3,2,4,4,4,4,2,1,7,2,6,3,1,1,306,153,153,35,21,14,69,27,107,65,27,6,30,12,58,36,12,2,39,15,49,29,15,4,8,6,10,5,6,0,2,5,8,3,3,0,6,1,2,2,3,0,282,149,133,21,11,10,70,33,90,49,28,9,42,19,44,15,16,11,28,14,46,34,12,-2,8,1,3,6,1,2,5,1,2,1,0,2,3,0,1,5,1,0,260,121,139,18,8,10,70,18,75,51,32,12,37,4,36,24,17,1,33,14,39,27,15,11,1,2,3,4,7,1,1,0,1,3,3,0,0,2,2,1,4,1,325,164,161,24,16,8,60,36,108,61,45,6,42,13,58,30,19,-1,18,23,50,31,26,7,-1,3,11,5,1,5,-1,2,6,6,0,3,0,1,5,-1,1,2,171,70,101,-3,0,-3,26,18,65,35,25,3,4,6,34,19,10,1,22,12,31,16,15,2,-9,3,2,1,0,0,-3,1,1,2,0,-1,-6,2,1,-1,0,1,79,33,46,15,5,10,32,4,27,14,-6,8,16,-6,7,14,2,2,16,10,20,0,-8,6,6,8,1,1,-2,1,2,3,0,1,0,-1,4,5,1,0,-2,2,67,37,30,-3,-2,-1,7,-8,38,24,12,-7,9,-4,17,13,4,-4,-2,-4,21,11,8,-3,-1,0,1,-4,1,0,-1,1,1,-3,0,0,0,-1,0,-1,1,0,82,43,39,-8,-5,-3,14,2,52,3,8,-4,1,4,27,4,2,0,13,-2,25,-1,6,-4,-1,3,-3,-3,-3,-1,-1,1,-1,-1,-3,0,0,2,-2,-2,0,-1,-34,-11,-23,-43,-27,-16,-21,-6,-3,-10,5,-2,-9,3,-5,-3,5,-3,-12,-9,2,-7,0,1,-13,2,-6,-21,-5,0,-7,1,-3,-14,-4,0,-6,1,-3,-7,-1,0,29,29,0,2,0,2,-12,-3,17,12,13,0,-5,2,14,8,5,2,-7,-5,3,4,8,-2,0,-4,4,0,2,-1,0,-2,1,0,0,0,0,-2,3,0,2,-1,6,1,5,7,0,7,-2,-6,6,0,8,2,-2,1,8,-6,0,-1,0,-7,-2,6,8,3,1,0,8,-5,4,-1,1,0,3,-4,1,-1,0,0,5,-1,3,0,10,11,-1,-10,-2,-8,4,-2,5,-9,12,0,6,-2,11,-4,4,-4,-2,0,-6,-5,8,4,-2,-1,-1,-5,-3,1,1,-1,3,-4,-2,0,-3,0,-4,-1,-1,1,21,5,16,15,10,5,7,-1,1,7,2,4,2,3,2,-3,3,0,5,-4,-1,10,-1,4,9,3,-5,6,0,1,7,3,-4,4,0,-1,2,0,-1,2,0,2,-17,6,-23,1,8,-7,-7,4,14,-15,-6,-10,7,3,12,-13,-3,-2,-14,1,2,-2,-3,-8,-2,0,2,3,-1,-2,3,1,3,2,-1,-1,-5,-1,-1,1,0,-1,104,62,42,55,26,29,6,21,27,11,22,14,3,4,19,14,15,5,3,17,8,-3,7,9,10,9,11,14,9,2,4,2,3,11,6,0,6,7,8,3,3,2
8,08044,Capellades,4928,69,31,38,72,37,35,10,20,15,6,3,12,7,8,8,1,1,4,3,12,7,5,2,8,10,18,23,14,2,4,7,8,12,6,2,2,3,10,11,8,0,2,75,35,40,82,44,38,7,20,22,12,9,2,4,9,11,3,6,-1,3,11,11,9,3,3,12,29,22,16,0,1,9,17,9,7,0,0,3,12,13,9,0,1,60,29,31,75,34,41,18,14,4,10,8,5,7,8,3,10,1,1,11,6,1,0,7,4,18,19,21,10,6,-1,8,10,11,4,2,-1,10,9,10,6,4,0,64,20,44,49,22,27,35,6,4,2,13,3,12,8,-2,-2,4,1,23,-2,6,4,9,2,23,6,7,8,4,1,12,2,3,3,2,0,11,4,4,5,2,1,120,60,60,18,12,6,42,12,35,13,8,6,25,4,16,6,6,2,17,8,19,7,2,4,3,9,4,1,1,0,2,6,3,0,1,0,1,3,1,1,0,0,101,64,37,19,12,7,13,14,20,26,9,16,5,16,16,15,1,10,8,-2,4,11,8,6,2,7,0,5,2,3,2,5,0,3,0,2,0,2,0,2,2,1,2,10,-8,35,19,16,0,0,-8,1,4,4,4,4,4,-3,-2,2,-4,-4,-12,4,6,2,8,7,8,10,1,0,2,5,7,6,-1,0,6,2,1,4,2,0,77,30,47,22,9,13,20,20,15,14,-3,9,7,4,11,3,-2,6,13,16,4,11,-1,3,10,4,7,2,0,-1,3,0,8,-1,-1,0,7,4,-1,3,1,-1,47,34,13,22,19,3,22,7,35,-4,-9,-3,10,5,13,3,0,4,12,2,22,-7,-9,-7,8,9,6,1,-2,0,5,5,5,2,2,0,3,4,1,-1,-4,0,-21,-4,-17,8,9,-1,9,-16,-12,9,-18,6,9,-6,-9,7,-9,2,0,-10,-3,2,-9,4,5,2,-1,4,-1,-2,4,3,1,3,-1,-1,1,-1,-2,1,0,-1,-30,-17,-13,1,-7,8,-17,-5,1,-15,-1,6,-7,4,3,-11,-4,-1,-10,-9,-2,-4,3,7,0,2,1,-5,0,3,2,1,-4,-5,-1,0,-2,1,5,0,1,3,-61,-28,-33,0,0,0,-21,13,-17,-24,-7,-6,-10,10,-12,-13,-2,-1,-11,3,-5,-11,-5,-5,5,-5,3,-4,1,-1,3,-2,2,-4,1,0,2,-3,1,0,0,-1,-50,-14,-36,-37,-22,-15,-3,-10,-23,-1,-16,3,3,-5,-11,1,-10,6,-6,-5,-12,-2,-6,-3,-13,-3,-5,-9,-5,-3,-5,-2,-5,-6,-5,1,-8,-1,0,-3,0,-4,-74,-42,-32,-14,-9,-5,-22,-2,-33,-17,-1,5,-14,-3,-9,-15,0,2,-8,1,-24,-2,-1,3,-4,0,-5,-2,-3,0,-4,0,-2,1,-4,0,0,0,-3,-3,1,0,-9,-25,16,-2,-6,4,0,-9,-10,1,5,1,-5,-9,-11,-3,3,-3,5,0,1,4,2,4,1,-4,4,-2,-1,0,1,-3,-1,-2,-1,0,0,-1,5,0,0,0,-24,-17,-7,8,-1,9,-4,5,-20,-21,3,12,-2,-4,-11,-8,6,2,-2,9,-9,-13,-3,10,7,6,2,-3,-6,1,2,0,0,-1,-3,0,5,6,2,-2,-3,1,-2,2,-4,8,6,2,-10,-4,10,12,-3,-5,-4,-6,4,10,0,-1,-6,2,6,2,-3,-4,1,1,4,4,-1,-1,0,1,3,3,0,-1,1,0,1,1,-1,0,5,-2,7,12,1,11,-5,-10,-11,13,10,6,-1,7,-16,8,1,-1,-4,-17,5,5,9,7,0,2,2,6,1,1,-1,3,0,-1,0,0,1,-1,2,7,1,1
8,08046,Cardedeu,11676,460,237,223,110,71,39,54,87,165,89,28,32,32,52,85,51,9,7,22,35,80,38,19,25,11,29,46,16,6,2,5,21,31,11,2,1,6,8,15,5,4,1,393,203,190,167,90,77,33,98,156,36,23,44,17,42,100,20,7,13,16,56,56,16,16,31,32,50,45,27,9,3,18,27,26,12,3,3,14,23,19,15,6,0,596,304,292,126,65,61,81,103,226,91,45,41,50,45,115,51,22,19,31,58,111,40,23,22,30,33,38,16,6,3,14,19,19,8,5,0,16,14,19,8,1,3,562,272,290,129,69,60,81,49,268,81,36,40,41,16,126,56,8,19,40,33,142,25,28,21,32,35,35,12,13,1,17,17,24,6,3,1,15,18,11,6,10,0,360,152,208,131,67,64,76,50,104,50,42,33,39,24,36,20,14,16,37,26,68,30,28,17,35,21,34,17,10,13,20,18,12,8,2,6,15,3,22,9,8,7,404,185,219,140,65,75,60,40,139,74,30,51,23,34,68,25,14,16,37,6,71,49,16,35,38,29,37,27,6,-1,11,18,22,14,2,-2,27,11,15,13,4,1,189,114,75,134,66,68,-1,50,60,24,21,26,14,34,38,7,6,9,-15,16,22,17,15,17,30,33,36,21,7,3,21,12,15,15,0,2,9,21,21,6,7,1,162,61,101,74,50,24,16,23,62,40,12,7,7,-7,37,13,4,5,9,30,25,27,8,2,20,30,16,3,1,2,14,20,10,4,-2,2,6,10,6,-1,3,0,365,149,216,101,32,69,57,25,165,62,15,37,25,5,67,33,8,11,32,20,98,29,7,26,22,26,28,19,3,2,7,8,9,6,1,1,15,18,19,13,2,1,211,87,124,72,40,32,1,43,86,33,2,34,5,9,46,21,-4,4,-4,34,40,12,6,30,7,20,24,14,2,4,5,11,12,9,1,1,2,9,12,5,1,3,179,59,120,-21,-10,-11,44,9,109,4,2,11,18,-6,52,-3,3,-2,26,15,57,7,-1,13,1,7,-3,-11,-9,-5,1,3,-4,-7,-2,0,0,4,1,-4,-7,-5,101,31,70,45,16,29,14,28,12,4,8,32,7,22,-4,-7,2,8,7,6,16,11,6,24,5,10,18,-4,8,8,2,4,9,-2,1,2,3,6,9,-2,7,6,22,29,-7,-55,-26,-29,-4,-7,35,-22,-15,30,12,-5,24,-13,-12,18,-16,-2,11,-9,-3,12,-8,-1,-14,-15,-7,-11,-1,1,-8,-10,-4,-5,-7,-2,-6,-5,-3,-6,97,23,74,-8,-5,-3,60,-2,25,-3,-14,27,35,-11,1,-8,-4,5,25,9,24,5,-10,22,3,-10,2,-2,-3,3,3,-9,6,-3,-2,0,0,-1,-4,1,-1,3,173,71,102,5,9,-4,25,16,70,38,-4,21,8,-4,31,25,-1,5,17,20,39,13,-3,16,9,5,0,-3,-3,-4,2,4,4,-1,0,-1,7,1,-4,-2,-3,-3,175,124,51,32,19,13,27,4,80,25,7,28,23,7,63,15,7,10,4,-3,17,10,0,18,2,10,11,-3,7,4,1,5,8,3,0,2,1,5,3,-6,7,2,60,9,51,40,21,19,23,13,17,5,3,2,13,11,-6,-4,-6,1,10,2,23,9,9,1,7,10,14,5,1,1,4,7,7,1,-1,1,3,3,7,4,2,0,100,28,72,38,11,27,57,1,-11,37,-3,22,29,3,-15,18,-10,4,28,-2,4,19,7,18,12,10,8,-3,5,6,3,3,6,-7,3,3,9,7,2,4,2,3
8,08047,Cardona,5677,-37,-4,-33,35,27,8,3,1,-16,-10,-9,-4,6,5,-1,-6,-5,-2,-3,-4,-15,-4,-4,-2,10,11,11,3,0,0,9,9,8,1,0,0,1,2,3,2,0,0,-48,-28,-20,34,18,16,-5,-12,-16,-4,-1,-11,-2,-6,-14,0,-3,-5,-3,-6,-2,-4,2,-6,9,4,16,2,1,0,5,3,6,2,0,0,4,1,10,0,1,0,-67,-29,-38,10,7,3,-5,-23,-25,3,-4,-9,-2,-15,-13,6,-2,-2,-3,-8,-12,-3,-2,-7,2,1,4,3,0,0,0,1,4,2,0,0,2,0,0,1,0,0,-9,-7,-2,36,15,21,21,-1,-6,-12,2,-16,11,-4,-2,-7,0,-6,10,3,-4,-5,2,-10,15,4,13,2,2,0,6,1,7,1,0,0,9,3,6,1,2,0,-15,-13,-2,23,7,16,0,-11,4,-2,-3,-4,2,-6,-2,-2,-1,-4,-2,-5,6,0,-2,0,7,2,12,3,0,-2,2,1,4,1,0,-1,5,1,8,2,0,-1,24,20,4,41,18,23,14,4,3,8,-4,-3,10,7,-2,6,-3,2,4,-3,5,2,-1,-5,4,6,15,9,4,2,2,3,7,3,2,1,2,3,8,6,2,1,6,25,-19,22,10,12,6,6,-4,3,0,-8,8,6,3,6,0,0,-2,0,-7,-3,0,-8,3,7,6,2,2,1,1,2,4,1,1,0,2,5,2,1,1,1,38,22,16,32,15,17,15,7,9,-4,2,3,9,-1,9,-3,4,2,6,8,0,-1,-2,1,6,7,11,6,-1,1,3,2,6,4,-1,0,3,5,5,2,0,1,17,21,-4,29,21,8,6,14,-2,2,-5,1,7,14,-1,3,-6,4,-1,0,-1,-1,1,-3,9,13,3,1,3,0,8,10,1,0,2,0,1,3,2,1,1,0,24,6,18,17,8,9,13,-13,0,12,4,6,8,-8,-5,5,2,3,5,-5,5,7,2,3,2,4,3,7,0,1,0,3,1,3,0,1,2,1,2,4,0,0,-38,-17,-21,14,8,6,4,-14,-13,-9,1,-5,3,2,-6,-9,-2,-3,1,-16,-7,0,3,-2,8,0,4,0,1,1,5,2,1,-1,1,0,3,-2,3,1,0,1,-21,-11,-10,10,4,6,2,1,-23,1,-5,2,5,-2,-14,2,-2,-1,-3,3,-9,-1,-3,3,4,3,0,-1,2,2,2,2,0,-1,1,0,2,1,0,0,1,2,-39,-19,-20,4,-1,5,-5,-5,-10,-8,-6,-5,-5,0,-4,-5,-7,1,0,-5,-6,-3,1,-6,0,1,0,3,0,0,-1,0,0,1,-1,0,1,1,0,2,1,0,-43,-23,-20,-7,-6,-1,-5,2,-20,-15,-2,-5,2,1,-12,-12,-3,-2,-7,1,-8,-3,1,-3,-4,1,-1,-1,-1,-1,-1,-2,0,-2,-1,0,-3,3,-1,1,0,-1,21,8,13,0,1,-1,-12,-8,17,9,13,2,-6,-3,11,1,6,0,-6,-5,6,8,7,2,-1,-1,0,2,0,0,-1,-1,1,2,0,0,0,0,-1,0,0,0,-65,-21,-44,6,6,0,-10,-3,-18,-24,0,-9,-6,3,-7,-11,1,0,-4,-6,-11,-13,-1,-9,2,1,1,1,2,-1,2,1,2,0,1,0,0,0,-1,1,1,-1,-32,-21,-11,-4,-4,0,-4,-9,-3,-3,-10,-5,-3,-6,-4,-1,-4,-4,-1,-3,1,-2,-6,-1,-2,-4,3,0,-2,1,-3,-2,1,0,0,0,1,-2,2,0,-2,1,-21,-18,-3,17,6,11,-5,-1,-10,5,-11,2,-3,-4,-6,0,-7,3,-2,3,-4,5,-4,-1,1,1,2,9,4,0,0,0,0,4,2,0,1,1,2,5,2,0
8,08051,Castellar del Vallès,16863,581,311,270,86,44,42,91,117,206,116,12,37,57,47,126,56,7,12,34,70,80,60,5,25,17,11,30,21,5,0,11,4,17,9,2,0,6,7,13,12,3,0,394,203,191,142,70,72,55,79,94,103,14,42,32,42,36,60,9,18,23,37,58,43,5,24,23,31,49,30,4,3,11,13,27,14,2,1,12,18,22,16,2,2,312,134,178,138,67,71,83,37,67,70,18,35,33,18,44,26,7,10,50,19,23,44,11,25,20,31,50,19,11,2,7,15,28,9,6,1,13,16,22,10,5,1,471,242,229,128,62,66,83,66,161,32,49,74,47,27,98,16,19,30,36,39,63,16,30,44,44,25,36,20,0,1,27,7,19,7,0,0,17,18,17,13,0,1,761,366,395,164,81,83,149,62,293,146,15,85,64,30,141,86,9,31,85,32,152,60,6,54,29,41,53,33,5,2,12,23,22,21,3,0,17,18,31,12,2,2,493,273,220,152,81,71,123,41,174,84,10,45,63,19,88,63,9,18,60,22,86,21,1,27,45,37,31,22,9,5,21,16,13,22,4,4,24,21,18,0,5,1,485,231,254,155,76,79,87,38,235,60,26,25,52,15,117,33,5,3,35,23,118,27,21,22,29,45,62,5,7,6,16,26,26,5,0,3,13,19,36,0,7,3,469,202,267,111,40,71,91,56,190,71,20,33,51,32,75,27,6,6,40,24,115,44,14,27,24,18,37,23,6,-1,10,4,19,6,0,-1,14,14,18,17,6,0,205,83,122,74,29,45,32,6,74,34,34,24,7,9,31,8,22,7,25,-3,43,26,12,17,12,26,31,-1,4,1,2,11,14,-5,3,2,10,15,17,4,1,-1,43,-23,66,-35,-31,-4,17,17,29,-25,-8,8,-5,-9,3,-12,-1,0,22,26,26,-13,-7,8,-2,0,-2,-23,-5,-2,-2,-6,0,-19,-4,0,0,6,-2,-4,-1,-2,36,10,26,-21,-33,12,27,-31,31,-8,-4,17,22,-15,15,-26,-1,8,5,-16,16,18,-3,9,9,-3,-13,-9,-5,1,2,-3,-13,-16,-3,1,7,0,0,7,-2,0,31,9,22,-3,7,-10,25,4,-38,3,-13,43,21,-4,-21,-2,-6,16,4,8,-17,5,-7,27,0,4,-7,-2,0,2,4,2,1,0,-1,1,-4,2,-8,-2,1,1,48,-10,58,-18,-24,6,40,-27,1,-4,-15,51,20,-23,-10,2,-14,13,20,-4,11,-6,-1,38,10,-2,-8,-18,-2,0,1,-3,-7,-11,-2,-2,9,1,-1,-7,0,2,-76,-31,-45,-41,-19,-22,-32,-26,-8,-36,-4,36,-16,-9,5,-10,-11,11,-16,-17,-13,-26,7,25,-7,7,-19,-14,-5,-3,-2,4,-15,-4,1,-3,-5,3,-4,-10,-6,0,-27,4,-31,-32,-16,-16,8,0,-17,-26,-19,23,8,0,-8,-1,-4,8,0,0,-9,-25,-15,15,-5,-1,-1,-17,-7,-2,-5,-4,-3,-5,0,0,0,3,2,-12,-7,-2,198,75,123,6,-4,10,64,-3,26,31,18,54,34,-7,10,11,6,14,30,4,16,20,12,40,9,-4,-3,5,2,-4,6,-7,1,0,-2,-3,3,3,-4,5,4,-1,130,46,84,23,17,6,81,-22,68,29,-29,6,28,-15,38,16,-16,-3,53,-7,30,13,-13,9,13,4,8,-2,0,0,9,3,9,-3,0,-1,4,1,-1,1,0,1,229,126,103,41,25,16,69,15,57,76,-2,11,47,14,26,33,4,-3,22,1,31,43,-6,14,10,9,7,11,2,2,8,3,1,9,3,1,2,6,6,2,-1,1
8,08053,Castellbell i el Vilar,2694,22,15,7,19,16,3,-8,2,17,3,12,-4,-1,1,11,1,8,-5,-7,1,6,2,4,1,0,4,9,5,1,0,0,2,9,4,1,0,0,2,0,1,0,0,96,57,39,61,40,21,14,25,38,15,7,-4,11,14,15,13,7,-3,3,11,23,2,0,-1,13,15,21,9,1,1,7,10,13,8,1,0,6,5,8,1,0,1,47,39,8,40,29,11,-7,8,25,12,14,-10,1,7,20,5,8,-3,-8,1,5,7,6,-7,2,9,15,9,3,2,2,7,10,7,2,1,0,2,5,2,1,1,95,47,48,31,16,15,13,16,32,4,13,14,6,12,16,1,5,7,7,4,16,3,8,7,6,8,10,4,2,1,1,5,7,1,1,1,5,3,3,3,1,0,111,48,63,22,11,11,24,22,40,17,10,-2,6,15,13,10,4,-1,18,7,27,7,6,-1,6,7,6,2,1,0,3,3,3,2,0,0,3,4,3,0,1,0,72,40,32,21,9,12,11,23,18,17,2,1,3,15,13,5,5,0,8,8,5,12,-3,1,5,4,4,8,0,0,1,3,0,5,0,0,4,1,4,3,0,0,124,68,56,38,20,18,27,14,49,18,7,7,17,6,31,9,2,3,10,8,18,9,5,4,8,7,14,7,1,1,4,5,6,4,0,1,4,2,8,3,1,0,149,88,61,41,23,18,18,12,87,18,13,2,9,4,47,20,9,-1,9,8,40,-2,4,3,11,11,11,6,1,1,6,8,5,3,1,0,5,3,6,3,0,1,64,39,25,37,14,23,9,16,33,2,-1,6,13,8,22,-9,1,4,-4,8,11,11,-2,2,6,14,11,3,3,0,2,6,6,0,1,-1,4,8,5,3,2,1,44,9,35,19,6,13,27,-5,15,8,-2,2,10,-7,3,2,0,2,17,2,12,6,-2,0,5,7,8,-2,-1,1,2,2,2,0,-1,1,3,5,6,-2,0,0,-46,-20,-26,5,-4,9,-6,-6,16,-33,-8,-9,-3,-5,13,-14,-6,-5,-3,-1,3,-19,-2,-4,0,4,6,-3,-1,-1,-2,1,1,-1,-2,-1,2,3,5,-2,1,0,-68,-27,-41,3,1,2,-22,0,-33,-5,7,-8,-9,1,-16,-4,3,1,-13,-1,-17,-1,4,-9,3,-1,2,-2,1,0,1,-1,1,-1,0,1,2,0,1,-1,1,-1,-1,-4,3,2,1,1,-9,3,6,0,7,-8,-8,5,5,-3,3,-7,-1,-2,1,3,4,-1,0,1,0,1,0,1,0,1,-1,1,1,0,0,0,1,0,-1,1,8,11,-3,3,0,3,18,2,-10,0,-6,8,9,2,1,-2,-2,2,9,0,-11,2,-4,6,0,3,-1,1,0,0,0,1,-1,0,0,0,0,2,0,1,0,0,-53,-38,-15,11,4,7,-5,-13,-12,-9,-9,-2,-6,-9,-12,-8,0,-1,1,-4,0,-1,-9,-1,4,2,0,3,2,0,1,1,-1,1,2,0,3,1,1,2,0,0,-4,-4,0,-22,-11,-11,17,-10,-11,10,-9,-2,8,-2,-12,8,-4,-3,9,-8,1,2,-5,1,0,1,-4,-10,-7,-3,1,1,-2,-7,-4,0,-1,0,-2,-3,-3,-3,64,53,11,18,9,9,-9,21,28,-2,11,11,-5,11,22,5,14,3,-4,10,6,-7,-3,8,4,7,8,0,-1,0,1,4,5,-1,0,0,3,3,3,1,-1,0,3,-6,9,14,10,4,-6,-2,3,12,0,-3,-3,-1,6,-1,-5,-1,-3,-1,-3,13,5,-2,1,3,5,4,0,0,-1,3,3,4,1,0,2,0,2,0,-1,0
8,08054,Castellbisbal,7269,756,359,397,74,35,39,180,115,230,139,52,30,88,53,113,64,29,7,92,62,117,75,23,23,16,13,21,12,9,2,7,7,12,4,5,0,9,6,9,8,4,2,527,266,261,71,44,27,81,113,208,67,29,25,34,55,109,39,16,9,47,58,99,28,13,16,13,27,16,9,3,2,7,17,10,6,3,1,6,10,6,3,0,1,439,237,202,77,40,37,40,82,208,63,31,10,11,44,117,39,15,8,29,38,91,24,16,2,13,23,17,12,10,1,6,10,9,7,8,0,7,13,8,5,2,1,455,243,212,89,42,47,76,63,184,67,34,25,54,28,90,38,15,14,22,35,94,29,19,11,31,18,20,10,7,0,20,6,9,4,2,0,11,12,11,6,5,0,361,209,152,152,126,26,50,35,108,107,44,17,18,23,57,70,34,10,32,12,51,37,10,7,11,22,39,49,27,4,3,16,30,49,25,3,8,6,9,0,2,1,299,152,147,89,52,37,60,58,76,34,45,20,38,23,44,14,23,9,22,35,32,20,22,11,9,17,31,22,5,4,5,7,18,17,2,2,4,10,13,5,3,2,191,89,102,58,23,35,54,12,111,7,0,2,34,4,51,-2,1,1,20,8,60,9,-1,1,21,27,6,4,-3,1,14,18,-3,-2,-4,0,7,9,9,6,1,1,102,43,59,68,39,29,8,16,44,22,14,-4,1,9,19,8,5,-1,7,7,25,14,9,-3,8,15,29,13,2,-1,5,9,18,5,2,-1,3,6,11,8,0,0,30,22,8,59,26,33,-18,10,24,-1,4,1,-15,4,18,13,-4,-1,-3,6,6,-14,8,2,12,27,18,2,-1,1,2,17,9,1,-5,2,10,10,9,1,4,-1,151,68,83,14,8,6,31,41,39,10,25,-6,23,22,13,-6,12,-2,8,19,26,16,13,-4,-4,15,-10,13,7,-7,-2,5,-8,8,7,-2,-2,10,-2,5,0,-5,-41,-45,4,12,-3,15,-5,4,-2,-32,-5,6,-10,-10,-1,-24,-1,7,5,14,-1,-8,-4,-1,5,15,-4,-7,0,3,0,5,-4,-6,-1,3,5,10,0,-1,1,0,38,14,24,24,9,15,11,-2,44,-5,-16,8,7,-9,25,5,-10,-4,4,7,19,-10,-6,12,1,4,2,11,3,2,-1,1,3,5,0,0,2,3,-1,6,3,2,-61,-21,-40,-5,-11,6,3,-23,-19,-25,-11,-3,14,1,-18,-12,-11,-2,-11,-24,-1,-13,0,-1,1,5,-6,-2,-5,-1,0,2,-4,-4,-5,0,1,3,-2,2,0,-1,0,-24,24,-34,-32,-2,6,0,17,-21,-10,-6,-3,-7,10,-17,-11,-6,9,7,7,-4,1,0,2,1,-9,-8,-21,-1,0,-1,-8,-7,-15,-2,2,2,-1,-1,-6,1,-105,-60,-45,-35,-30,-5,-15,-10,5,-64,-40,10,-9,-11,9,-28,-31,3,-6,1,-4,-36,-9,7,1,-2,-7,-13,-19,5,-2,-1,1,-11,-18,1,3,-1,-8,-2,-1,4,-79,-50,-29,-58,-38,-20,-1,-17,-3,-32,-30,-12,5,-14,-1,-26,-18,-7,-6,-3,-2,-6,-12,-5,-10,5,-11,-28,-9,-7,-7,-1,-10,-15,-5,-2,-3,6,-1,-13,-4,-5,14,15,-1,6,7,-1,7,0,26,-25,1,-13,10,2,11,-11,5,-10,-3,-2,15,-14,-4,-3,2,0,-2,2,1,-1,2,0,0,-1,1,2,0,0,-2,3,0,-3,58,49,9,42,16,26,12,5,56,3,-10,-23,-1,12,53,-2,-9,-11,13,-7,3,5,-1,-12,6,14,13,3,7,-2,1,9,8,-3,3,-3,5,5,5,6,4,1
8,08056,Castelldefels,43307,458,227,231,80,36,44,7,48,197,81,37,78,-6,31,82,46,21,42,13,17,115,35,16,36,20,11,18,13,6,11,8,4,8,6,4,6,12,7,10,7,2,5,40,-24,64,77,42,35,-31,-16,53,-10,14,42,-13,-17,13,-15,5,10,-18,1,40,5,9,32,14,20,15,12,6,8,7,11,8,6,4,4,7,9,7,6,2,4,447,203,244,-14,-13,-1,-20,-10,274,89,38,67,-15,1,146,34,6,27,-5,-11,128,55,32,40,-10,12,-11,-10,5,-3,-9,9,-2,-13,1,0,-1,3,-9,3,4,-3,-11,-77,66,-64,-40,-24,-168,-8,176,-86,-2,66,-108,-32,93,-46,-5,14,-60,24,83,-40,3,52,2,-21,-16,-24,-8,0,8,-12,-16,-19,-3,1,-6,-9,0,-5,-5,-1,2090,1072,1018,1796,917,879,254,415,823,329,76,167,135,202,452,188,32,53,119,213,371,141,44,114,298,419,601,296,117,43,148,193,320,170,60,14,150,226,281,126,57,29,1447,765,682,1552,823,729,162,338,540,179,87,133,106,164,307,123,25,41,56,174,233,56,62,92,288,364,473,248,117,34,157,187,256,150,47,13,131,177,217,98,70,21,1071,507,564,1545,772,773,86,297,443,123,74,51,24,142,251,46,31,11,62,155,192,77,43,40,280,378,468,262,120,17,144,181,243,130,59,4,136,197,225,132,61,13,1139,649,490,1446,760,686,63,442,375,151,33,60,42,241,225,97,21,15,21,201,150,54,12,45,187,473,446,255,55,6,91,242,252,133,30,5,96,231,194,122,25,1,1172,566,606,1025,530,495,115,328,491,36,26,170,80,132,267,29,8,47,35,196,224,7,18,123,178,303,346,126,51,1,93,132,208,58,20,9,85,171,138,68,31,-8,-89,-164,75,-167,-154,-13,7,31,9,-166,-113,120,15,-20,-24,-104,-59,26,-8,51,33,-62,-54,94,31,43,-86,-97,-61,-13,21,3,-58,-77,-36,-11,10,40,-28,-20,-25,-2,696,268,428,248,103,145,15,87,292,117,26,113,2,49,102,45,17,26,13,38,190,72,9,87,37,94,41,26,20,10,23,39,12,1,11,5,14,55,29,25,9,5,-20,-114,94,-358,-234,-124,4,50,141,-216,-84,73,-4,10,42,-128,-69,36,8,40,99,-88,-15,37,-9,13,-100,-199,-66,-13,-3,6,-71,-126,-46,1,-6,7,-29,-73,-20,-14,-99,-97,-2,-62,-58,-4,-32,-6,10,-97,-51,75,-3,1,-2,-84,-37,18,-29,-7,12,-13,-14,57,42,31,-32,-86,-19,-8,32,36,-45,-73,-10,-5,10,-5,13,-13,-9,-3,295,118,177,-341,-174,-167,38,51,147,3,-74,110,48,7,95,-28,-41,29,-10,44,52,31,-33,81,2,7,-138,-158,-56,-11,23,10,-80,-101,-24,-6,-21,-3,-58,-57,-32,-5,742,258,484,54,-27,81,121,160,213,96,-4,116,46,66,44,63,-7,28,75,94,169,33,3,88,61,52,16,-76,-28,7,30,10,4,-51,-27,-5,31,42,12,-25,-1,12,826,402,424,313,120,193,143,101,287,172,-30,125,73,60,136,118,-32,33,70,41,151,54,2,92,98,79,109,13,-8,3,61,42,41,-6,-22,-5,37,37,68,19,14,8,965,501,464,733,368,365,125,192,234,228,29,129,70,106,149,139,-1,28,55,86,85,89,30,101,144,167,223,135,19,24,67,89,140,62,-6,7,77,78,83,73,25,17,611,258,353,760,367,393,117,116,283,20,-53,87,59,54,139,2,-30,4,58,62,144,18,-23,83,177,163,248,92,34,19,88,76,130,40,16,-2,89,87,118,52,18,21
8,08064,Castellterçol,2004,50,22,28,23,12,11,3,16,13,10,1,6,0,7,3,8,1,3,3,9,10,2,0,3,5,6,8,2,1,0,3,5,2,2,0,0,2,1,6,0,1,0,89,39,50,61,31,30,22,6,29,21,6,3,5,4,16,10,3,0,17,2,13,11,3,3,9,15,20,15,1,0,3,9,10,8,1,0,6,6,10,7,0,0,64,38,26,44,19,25,11,11,21,15,3,2,10,5,13,6,1,3,1,6,8,9,2,-1,10,16,10,8,0,0,5,5,6,3,0,0,5,11,4,5,0,0,25,10,15,31,16,15,4,-5,9,-3,3,17,1,-4,9,-3,4,3,3,-1,0,0,-1,14,8,7,13,1,2,0,4,4,5,2,1,0,4,3,8,-1,1,0,30,11,19,13,6,7,1,2,5,-3,9,15,1,1,5,-5,5,4,0,1,0,2,4,11,3,3,6,-3,3,0,2,3,3,-3,1,0,1,0,3,0,2,0,19,14,5,5,5,0,3,-1,11,2,-2,6,4,-2,6,1,2,3,-1,1,5,1,-4,3,0,2,3,-1,1,0,0,1,2,1,1,0,0,1,1,-2,0,0,65,35,30,4,-2,6,19,5,16,11,7,5,10,4,4,8,3,4,9,1,12,3,4,1,4,-1,-3,1,0,2,0,-1,-4,1,0,1,4,0,1,0,0,1,90,56,34,32,18,14,33,-3,28,21,2,7,21,-1,15,13,2,4,12,-2,13,8,0,3,18,5,3,5,0,1,12,2,1,4,-1,0,6,3,2,1,1,1,58,21,37,21,5,16,20,10,9,14,3,3,10,3,1,8,0,2,10,7,8,6,3,1,6,7,6,1,2,-2,3,1,4,-1,-1,-1,3,6,2,2,3,-1,18,1,17,1,0,1,-4,5,11,1,-4,8,-5,1,-1,3,1,1,1,4,12,-2,-5,7,-1,1,4,-3,0,0,-1,0,3,-2,0,0,0,1,1,-1,0,0,-1,11,-12,-3,0,-3,-12,5,-6,1,7,8,-3,5,1,6,3,3,-9,0,-7,-5,4,5,-1,1,-2,0,0,-1,1,1,-3,1,0,0,-2,0,1,-1,0,-1,25,6,19,-16,-10,-6,5,2,-2,-5,-2,26,4,0,-4,-6,1,11,1,2,2,1,-3,15,0,-5,-1,-11,0,1,3,-2,-3,-8,0,0,-3,-3,2,-3,0,1,7,9,-2,-4,-1,-3,-10,-2,15,-5,3,6,-7,-4,10,3,5,2,-3,2,5,-8,-2,4,-4,0,2,-3,0,1,-3,1,2,-1,0,0,-1,-1,0,-2,0,1,8,8,0,-20,-10,-10,6,-9,-2,-4,7,10,12,-4,4,-6,2,1,-6,-5,-6,2,5,9,-2,-6,-7,-4,0,-1,-1,-5,-3,-2,1,0,-1,-1,-4,-2,-1,-1,-18,0,-18,-3,2,-5,-12,10,-12,-8,-2,6,-4,9,-7,1,1,0,-8,1,-5,-9,-3,6,2,2,-3,-3,-1,0,1,3,-1,-1,0,0,1,-1,-2,-2,-1,0,-4,-3,-1,12,7,5,-4,-1,-7,3,5,0,-5,0,2,0,1,-1,1,-1,-9,3,4,1,3,0,4,4,1,0,2,2,2,1,0,0,1,-2,2,3,1,0,53,18,35,10,3,7,9,5,9,9,0,21,3,0,-2,3,5,9,6,5,11,6,-5,12,3,2,5,0,0,0,1,-1,3,-1,1,0,2,3,2,1,-1,0,61,33,28,18,7,11,8,3,17,13,8,11,-1,0,9,15,4,5,9,3,8,-2,4,6,6,5,5,2,0,0,1,2,2,3,-1,0,5,3,3,-1,1,0
8,08065,Castellví de la Marca,1459,-8,3,-11,10,8,2,1,-2,0,-4,0,-3,0,0,1,0,2,0,1,-2,-1,-4,-2,-3,1,4,2,3,0,0,0,3,2,3,0,0,1,1,0,0,0,0,26,14,12,21,14,7,2,-4,8,14,3,2,-1,-1,4,10,1,1,3,-3,4,4,2,1,1,4,13,3,0,0,0,2,9,3,0,0,1,2,4,0,0,0,39,24,15,21,14,7,8,2,8,10,6,3,7,2,4,7,3,0,1,0,4,3,3,3,2,4,8,6,0,0,1,3,6,4,0,0,1,1,2,2,0,0,29,22,7,17,12,5,21,-6,10,2,1,1,14,-2,5,2,2,1,7,-4,5,0,-1,0,6,3,1,5,1,1,5,3,0,3,0,1,1,0,1,2,1,0,41,22,19,15,7,8,13,7,5,6,6,2,7,2,2,6,5,0,6,5,3,0,1,2,5,5,2,2,1,0,1,2,1,2,1,0,4,3,1,0,0,0,35,8,27,14,5,9,12,-3,13,5,2,4,7,-7,1,5,-1,3,5,4,12,0,3,1,2,5,2,4,1,0,0,0,2,3,0,0,2,5,0,1,1,0,16,8,8,6,1,5,14,-9,20,-2,-6,-1,10,-8,11,-5,-2,1,4,-1,9,3,-4,-2,4,-3,5,-1,1,0,2,-3,3,-2,1,0,2,0,2,1,0,0,37,22,15,10,6,4,3,10,24,-3,4,-2,2,6,13,-2,2,0,1,4,11,-1,2,-2,1,2,2,1,1,2,0,1,1,1,1,1,1,1,1,0,0,1,18,10,8,29,13,16,-1,10,16,-1,-4,-5,0,9,7,-1,-3,-3,-1,1,9,0,-1,-2,9,6,7,3,1,0,4,4,2,1,0,0,5,2,5,2,1,0,-32,-18,-14,-2,-6,4,4,-6,-17,-1,-5,-7,2,-1,-9,-3,-4,-3,2,-5,-8,2,-1,-4,1,-2,0,0,-1,0,2,-2,-3,-2,-1,0,-1,0,3,2,0,0,10,14,-4,-3,-1,-2,2,8,2,-5,1,2,2,8,6,-5,1,1,0,0,-4,0,0,1,-2,3,-3,-1,-1,0,-2,0,0,0,0,0,0,3,-3,-1,-1,0,-3,-5,2,0,0,0,7,-8,-1,1,-2,-1,3,-3,-6,4,-2,-1,4,-5,5,-3,0,0,0,2,-2,0,0,0,0,2,-2,0,0,0,0,0,0,0,0,0,-21,-7,-14,-4,-4,0,-18,4,-2,-3,-1,-2,-10,-3,3,0,2,0,-8,7,-5,-3,-3,-2,-1,-1,1,-1,-2,-1,0,-1,0,-2,-1,-1,-1,0,1,1,-1,0,-22,-11,-11,-9,-7,-2,-5,-9,-5,-6,1,3,-2,-4,-4,-4,2,2,-3,-5,-1,-2,-1,1,-2,-3,-1,-2,-1,0,-2,-3,-1,-1,0,0,0,0,0,-1,-1,0,-44,-31,-13,-10,-10,0,-4,-5,-13,-12,0,-8,-4,0,-13,-8,1,-5,0,-5,0,-4,-1,-3,1,0,-2,-8,-1,0,2,1,-4,-8,-1,0,-1,-1,2,0,0,0,4,3,1,1,3,-2,1,3,2,-2,0,0,-1,1,1,-1,3,0,2,2,1,-1,-3,0,1,2,1,-1,-1,-1,1,1,2,0,-1,0,0,1,-1,-1,0,-1,23,8,15,2,0,2,5,2,6,7,3,0,2,2,-2,4,2,0,3,0,8,3,1,0,-2,1,1,1,1,0,-1,1,0,0,0,0,-1,0,1,1,1,0,-5,4,-9,6,1,5,2,1,8,-10,-5,-2,3,5,3,-2,-2,-4,-1,-4,5,-8,-3,2,4,1,3,-2,-1,1,2,1,0,-2,0,0,2,0,3,0,-1,1
8,08066,Castellví de Rosanes,1055,56,32,24,5,3,2,17,10,18,8,0,3,10,8,8,3,1,3,7,2,10,5,-1,0,2,1,0,2,0,0,1,1,0,1,0,0,1,0,0,1,0,0,32,8,24,9,5,4,9,1,9,5,4,1,3,-1,2,2,1,0,6,2,7,3,3,1,1,1,5,0,0,0,0,1,3,0,0,0,1,0,2,0,0,0,75,40,35,5,3,2,20,2,19,20,7,5,8,4,7,14,3,3,12,-2,12,6,4,2,1,2,1,1,0,0,0,1,1,1,0,0,1,1,0,0,0,0,22,16,6,5,3,2,3,-5,9,3,4,7,0,-2,9,3,1,3,3,-3,0,0,3,4,1,1,2,0,1,0,1,0,1,0,1,0,0,1,1,0,0,0,57,30,27,14,8,6,15,1,14,20,7,0,8,-1,6,11,4,3,7,2,8,9,3,-3,4,0,5,4,0,1,1,0,4,2,0,1,3,0,1,2,0,0,123,65,58,29,13,16,31,15,40,25,8,5,12,11,19,19,4,0,19,4,21,6,4,5,6,6,10,4,2,1,2,3,3,4,1,0,4,3,7,0,1,1,68,28,40,9,0,9,25,4,10,16,8,3,12,3,-3,8,7,1,13,1,13,8,1,2,7,1,-1,1,1,0,3,0,-3,-1,1,0,4,1,2,2,0,0,73,33,40,-10,0,-10,5,7,16,21,4,20,1,3,13,8,2,5,4,4,3,13,2,15,-6,0,-1,-5,1,0,-2,0,3,-3,1,0,-4,0,-4,-2,0,0,65,25,40,7,-1,8,10,9,17,10,-1,19,4,4,8,3,-1,7,6,5,9,7,0,12,2,4,1,2,-2,0,0,2,0,0,-2,-1,2,2,1,2,0,1,40,24,16,1,0,1,14,1,-3,6,5,15,8,0,-1,2,7,5,6,1,-2,4,-2,10,1,1,-1,-1,0,0,1,0,-1,-1,0,0,0,1,0,0,0,0,48,17,31,2,0,2,8,13,-1,13,0,13,5,6,-3,6,0,3,3,7,2,7,0,10,1,1,1,1,-1,-1,1,0,-1,0,0,0,0,1,2,1,-1,-1,-30,-26,-4,1,0,1,-8,-11,-7,-14,0,12,-6,-6,-6,-7,-2,3,-2,-5,-1,-7,2,9,1,1,-2,0,1,0,0,1,-1,0,0,0,1,0,-1,0,1,0,13,6,7,-2,0,-2,-10,-5,10,0,1,15,-3,-2,8,-5,3,4,-7,-3,2,5,-2,11,-3,1,-1,2,0,-1,-2,1,0,1,0,0,-1,0,-1,1,0,-1,27,16,11,1,1,0,4,4,14,4,-2,0,7,-1,10,4,-1,-4,-3,5,4,0,-1,4,1,0,0,0,0,0,0,0,1,0,0,0,1,0,-1,0,0,0,18,-1,19,-1,-2,1,8,-1,3,-6,1,11,2,6,-2,-2,-1,-4,6,-7,5,-4,2,15,1,0,0,-3,1,0,0,1,-1,-2,0,0,1,-1,1,-1,1,0,41,14,27,1,0,1,25,-9,15,16,-9,3,6,-2,10,5,-7,1,19,-7,5,11,-2,2,0,0,0,0,0,1,0,0,0,0,0,0,0,0,0,0,0,1,39,20,19,7,-1,8,-1,13,22,-1,1,2,0,7,8,4,0,0,-1,6,14,-5,1,2,3,2,0,0,1,0,1,0,-1,-1,0,0,2,2,1,1,1,0,43,10,33,8,1,7,20,-4,10,8,-5,13,5,1,2,4,-3,0,15,-5,8,4,-2,13,2,-1,5,1,0,1,0,0,0,1,0,0,2,-1,5,0,0,1
8,08067,Centelles,5739,14,13,1,8,5,3,4,-4,4,-7,4,11,4,3,-3,0,2,6,0,-7,7,-7,2,5,1,1,5,0,0,1,1,1,2,0,0,1,0,0,3,0,0,0,96,40,56,39,18,21,15,9,34,21,13,3,4,-1,17,10,7,3,11,10,17,11,6,0,9,6,12,8,2,2,4,3,8,2,0,1,5,3,4,6,2,1,205,110,95,30,16,14,39,22,86,33,10,9,20,16,40,20,5,5,19,6,46,13,5,4,9,5,12,4,0,0,3,6,6,1,0,0,6,-1,6,3,0,0,133,60,73,23,13,10,27,28,45,19,1,9,12,10,26,11,-1,2,15,18,19,8,2,7,8,1,6,3,5,0,4,1,4,2,2,0,4,0,2,1,3,0,163,72,91,24,11,13,27,25,73,18,11,6,14,9,35,9,3,0,13,16,38,9,8,6,2,5,8,4,5,0,2,1,3,2,3,0,0,4,5,2,2,0,164,72,92,36,17,19,8,22,81,19,17,18,3,7,34,5,15,5,5,15,47,14,2,13,9,5,15,4,1,2,4,1,8,2,1,1,5,4,7,2,0,1,225,115,110,50,23,27,26,25,82,57,19,12,14,12,55,24,10,1,12,13,27,33,9,11,10,8,18,9,3,2,5,5,12,1,0,0,5,3,6,8,3,2,190,86,104,61,27,34,31,39,85,21,0,5,10,20,33,17,2,-1,21,19,52,4,-2,6,16,14,15,10,5,0,8,8,4,4,2,0,8,6,11,6,3,0,33,20,13,-4,-2,-2,-2,17,9,-3,5,7,-2,5,14,-2,3,1,0,12,-5,-1,2,6,-1,4,4,-6,-3,-2,0,4,2,-6,-1,-1,-1,0,2,0,-2,-1,42,10,32,17,9,8,5,2,10,15,-4,10,-2,3,-4,5,-3,7,7,-1,14,10,-1,3,2,5,2,2,1,3,2,3,-1,0,0,3,0,2,3,2,1,0,37,14,23,-17,-13,-4,17,0,4,0,6,12,12,-4,5,-7,3,7,5,4,-1,7,3,5,-4,-2,-7,-3,0,-1,-2,-5,-1,-3,-1,-1,-2,3,-6,0,1,0,-17,-15,-2,4,6,-2,-1,-15,10,-20,6,0,-7,1,8,-16,1,-3,6,-16,2,-4,5,3,6,0,-2,-3,4,0,4,3,1,-3,1,0,2,-3,-3,0,3,0,54,39,15,10,4,6,9,25,-24,18,10,13,14,11,-14,17,6,4,-5,14,-10,1,4,9,2,3,6,-2,0,1,1,1,4,-1,-1,0,1,2,2,-1,1,1,13,2,11,-3,-1,-2,6,-4,0,-8,4,11,1,-2,-1,-9,2,7,5,-2,1,1,2,4,0,2,-1,-5,0,1,1,2,0,-3,-1,0,-1,0,-1,-2,1,1,56,16,40,-6,-6,0,21,1,25,8,0,-1,6,-1,7,2,-1,3,15,2,18,6,1,-4,1,0,-1,-5,0,-2,-1,1,-3,-4,1,0,2,-1,2,-1,-1,-2,39,29,10,-2,2,-4,-7,4,15,16,-5,12,1,5,18,10,-5,0,-8,-1,-3,6,0,12,-3,5,-2,-1,-2,0,-1,3,0,3,-3,0,-2,2,-2,-4,1,0,32,15,17,1,-2,3,4,8,13,-9,3,14,5,4,9,-6,2,2,-1,4,4,-3,1,12,0,5,-3,-2,3,-2,2,1,-4,-2,1,0,-2,4,1,0,2,-2,28,15,13,23,12,11,-11,4,11,21,7,-5,-9,9,3,15,0,-2,-2,-5,8,6,7,-3,2,4,9,6,0,1,3,4,2,3,0,0,-1,0,7,3,0,1
8,08266,Cerdanyola del Vallès,52166,367,194,173,476,250,226,60,43,225,10,-23,58,27,32,141,8,-20,5,33,11,84,2,-3,53,78,102,204,61,18,9,39,46,120,32,8,2,39,56,84,29,10,7,544,248,296,729,339,390,71,98,255,39,-28,105,32,65,99,38,-37,45,39,33,156,1,9,60,148,124,260,135,41,14,70,59,126,67,9,5,78,65,134,68,32,9,491,267,224,825,425,400,108,116,150,67,-15,51,63,60,97,38,-2,8,45,56,53,29,-13,43,143,198,276,153,35,7,79,83,146,90,18,3,64,115,130,63,17,4,328,94,234,720,305,415,70,103,53,45,-39,67,21,42,34,-1,-34,18,49,61,19,46,-5,49,108,200,252,109,39,5,48,66,122,50,13,3,60,134,130,59,26,2,399,95,304,944,489,455,42,145,139,33,-34,64,-17,41,59,17,-27,16,59,104,80,16,-7,48,102,241,326,180,54,27,48,100,187,107,29,12,54,141,139,73,25,15,199,34,165,806,417,389,23,65,99,21,-36,31,-9,15,14,44,-30,3,32,50,85,-23,-6,28,94,240,282,118,52,13,39,103,163,79,23,5,55,137,119,39,29,8,373,100,273,731,404,327,105,196,19,58,-41,27,19,98,-13,32,-43,-3,86,98,32,26,2,30,88,236,248,108,38,5,42,114,154,76,15,-1,46,122,94,32,23,6,436,163,273,773,381,392,99,231,39,28,-42,71,34,120,38,-13,-33,14,65,111,1,41,-9,57,107,304,228,85,34,8,47,162,116,43,12,-1,60,142,112,42,22,9,32,60,-28,482,226,256,8,130,21,-41,-58,-21,17,72,37,-16,-24,-19,-9,58,-16,-25,-34,-2,62,235,167,26,-13,-1,37,93,89,8,-2,-3,25,142,78,18,-11,2,-449,-290,-159,69,-22,91,32,-1,-259,-118,-110,-4,15,-28,-161,-64,-58,6,17,27,-98,-54,-52,-10,46,89,9,-43,-35,-5,28,-4,-7,-28,-16,2,18,93,16,-15,-19,-7,-261,-140,-121,-92,-141,49,25,82,-205,-157,-54,35,29,71,-122,-102,-29,8,-4,11,-83,-55,-25,27,0,120,-78,-114,-28,-2,-6,58,-79,-100,-17,-3,6,62,1,-14,-11,1,-342,-240,-102,-45,-82,37,4,117,-264,-136,-68,7,30,53,-135,-135,-47,-11,-26,64,-129,-1,-21,18,7,163,-74,-111,-18,-18,16,74,-55,-103,-14,-6,-9,89,-19,-8,-4,-12,-355,-231,-124,-125,-89,-36,-10,65,-322,-54,-60,26,-37,22,-155,-21,-45,4,27,43,-167,-33,-15,22,3,89,-129,-56,-24,-9,-3,30,-71,-21,-17,-8,6,59,-58,-35,-7,-1,-319,-222,-97,-215,-149,-66,-34,75,-168,-123,-68,5,-17,-2,-88,-78,-14,-17,-17,77,-80,-45,-54,22,-40,109,-112,-120,-42,-12,-22,26,-40,-81,-26,-7,-18,83,-72,-39,-16,-5,-83,-134,51,65,-13,78,-11,101,-57,-81,-33,-2,-35,54,-48,-57,-34,-11,24,47,-9,-24,1,9,-15,140,-32,-47,4,10,-12,53,-25,-31,-4,5,-3,87,-7,-16,8,5,223,99,124,273,109,164,92,187,-10,-10,-55,14,52,85,-16,-8,-31,11,40,102,6,-2,-24,3,17,209,86,-33,-16,5,14,94,31,-24,-14,7,3,115,55,-9,-2,-2,157,89,68,341,179,162,97,146,-28,-2,-51,-19,58,83,-13,11,-44,-16,39,63,-15,-13,-7,-3,42,171,88,18,3,9,34,79,52,12,-8,4,8,92,36,6,11,5,138,71,67,293,115,178,97,113,-54,28,-32,-6,31,60,-19,16,-12,-1,66,53,-35,12,-20,-5,64,142,33,39,12,2,37,57,4,11,4,1,27,85,29,28,8,1
8,08068,Cervelló,5617,152,87,65,33,19,14,14,12,43,47,12,23,12,13,23,28,4,6,2,-1,20,19,8,17,3,8,16,5,1,0,1,5,9,4,0,0,2,3,7,1,1,0,183,118,65,68,45,23,28,28,58,37,6,24,33,18,38,20,-1,8,-5,10,20,17,7,16,19,10,20,12,5,2,16,7,13,7,2,0,3,3,7,5,3,2,314,157,157,105,57,48,51,54,69,71,20,46,20,32,40,38,13,12,31,22,29,33,7,34,24,22,29,21,5,1,11,13,18,12,1,0,13,9,11,9,4,1,147,88,59,57,29,28,-2,17,41,40,26,24,0,15,25,27,8,12,-2,2,16,13,18,12,9,14,24,8,1,0,3,3,18,6,-1,0,6,11,6,2,2,0,336,173,163,73,37,36,26,57,129,49,37,30,14,33,73,21,18,11,12,24,56,28,19,19,15,16,23,12,7,0,7,11,12,5,2,0,8,5,11,7,5,0,230,104,126,48,26,22,24,25,112,39,18,13,22,7,51,19,7,0,2,18,61,20,11,13,4,14,16,10,4,0,3,8,8,7,0,0,1,6,8,3,4,0,264,134,130,35,16,19,35,44,69,81,14,14,22,26,38,36,4,3,13,18,31,45,10,11,7,10,6,8,3,1,5,5,3,2,1,0,2,5,3,6,2,1,211,87,124,37,17,20,43,24,64,42,-1,44,18,13,31,21,-7,12,25,11,33,21,6,32,7,5,11,11,-3,6,2,0,6,7,-1,3,5,5,5,4,-2,3,190,87,103,38,23,15,45,12,25,30,19,55,19,0,16,9,5,34,26,12,9,21,14,21,4,10,13,1,7,2,4,5,6,2,2,3,0,5,7,-1,5,-1,155,60,95,35,9,26,1,29,39,-3,15,72,5,10,14,-3,11,21,-4,19,25,0,4,51,9,13,8,5,-1,1,2,7,0,0,0,0,7,6,8,5,-1,1,37,2,35,-23,-13,-10,15,-14,1,1,-13,45,10,-4,-9,-1,-5,10,5,-10,10,2,-8,35,-1,1,0,-16,-4,-4,4,2,-5,-12,-1,-2,-5,-1,5,-4,-3,-2,17,-8,25,-2,-13,11,-18,7,9,-9,0,32,-12,-1,8,-6,-4,11,-6,8,1,-3,4,21,6,4,-3,-4,-4,-2,3,2,-4,-6,-6,-2,3,2,1,2,2,0,101,29,72,0,0,0,14,-11,17,15,-2,63,4,-10,-2,7,6,22,10,-1,19,8,-8,41,-3,-1,5,-3,0,2,-2,-2,3,-1,1,1,-1,1,2,-2,-1,1,75,41,34,-22,-12,-10,9,5,17,10,-1,38,3,10,6,14,-4,14,6,-5,11,-4,3,24,3,-1,-14,2,-9,-3,2,1,-9,0,-5,-1,1,-2,-5,2,-4,-2,77,21,56,-34,-32,-2,50,-10,10,7,-10,37,29,-11,-2,-4,0,14,21,1,12,11,-10,23,2,-6,-8,-16,-5,-2,-4,-4,-7,-11,-6,-1,6,-2,-1,-5,1,-1,-2,8,-10,25,10,15,-16,-5,5,-5,-4,20,-4,-5,4,4,-4,13,-12,0,1,-9,0,7,6,5,1,2,7,2,2,4,-1,1,3,1,4,1,2,1,4,1,51,-6,57,44,23,21,-7,5,27,14,-16,24,-14,5,2,5,-12,7,7,0,25,9,-4,17,10,6,17,11,0,0,5,3,5,10,1,-1,5,3,12,1,-1,1,72,39,33,40,23,17,0,4,44,27,-29,25,5,-1,29,21,-18,2,-5,5,15,6,-11,23,6,6,11,14,3,0,6,3,7,8,-1,0,0,3,4,6,4,0
8,08072,Corbera de Llobregat,8708,351,181,170,2,1,1,37,34,133,75,19,55,17,14,71,47,16,17,20,20,62,28,3,38,0,0,0,0,0,2,0,0,0,0,0,1,0,0,0,0,0,1,382,169,213,4,2,2,64,28,126,53,24,85,36,9,60,32,12,20,28,19,66,21,12,65,0,0,3,0,0,1,0,0,2,0,0,0,0,0,1,0,0,1,374,177,197,-2,-2,0,23,24,147,36,43,102,12,11,75,29,23,30,11,13,72,7,20,72,0,0,-1,-1,0,0,0,0,-1,-1,0,0,0,0,0,0,0,0,177,112,65,-10,-7,-3,4,10,75,20,19,56,2,3,56,16,18,21,2,7,19,4,1,35,-2,-1,-4,-4,0,0,-2,-2,-2,-1,0,0,0,1,-2,-3,0,0,641,328,313,308,162,146,98,105,247,101,17,68,52,47,130,67,8,21,46,58,117,34,9,47,53,84,99,56,12,3,29,35,50,36,10,1,24,49,49,20,2,2,649,294,355,294,138,156,122,102,195,120,37,70,58,39,95,61,20,21,64,63,100,59,17,49,60,78,84,55,16,1,33,34,36,26,9,0,27,44,48,29,7,1,434,209,225,174,72,102,75,50,166,67,15,52,40,18,88,34,8,16,35,32,78,33,7,36,23,55,50,20,17,5,9,27,20,6,8,1,14,28,30,14,9,4,329,160,169,216,103,113,36,52,105,67,23,44,-1,21,58,58,12,14,37,31,47,9,11,30,41,65,56,38,12,3,17,34,23,22,6,2,24,31,33,16,6,1,407,199,208,187,78,109,55,85,124,71,42,29,30,40,66,31,25,10,25,45,58,40,17,19,27,54,56,42,5,2,8,25,27,17,-1,3,19,29,29,25,6,-1,233,87,146,96,42,54,37,28,34,29,6,99,27,3,9,16,5,29,10,25,25,13,1,70,13,39,30,14,3,-1,8,17,14,8,-2,-1,5,22,16,6,5,0,-11,-13,2,47,12,35,1,-36,26,-33,-13,40,14,-22,24,-19,-16,4,-13,-14,2,-14,3,36,10,4,18,2,9,3,5,0,8,-1,0,0,5,4,10,3,9,3,67,37,30,37,13,24,-13,-11,16,4,-10,79,-9,-5,22,11,-9,27,-4,-6,-6,-7,-1,52,11,11,14,4,2,-5,6,4,7,-1,0,-3,5,7,7,5,2,-2,-16,34,-50,-4,2,-6,-13,-6,11,-26,-16,42,11,-2,41,-17,-8,12,-24,-4,-30,-9,-8,30,5,7,-6,-1,-7,0,5,3,-3,1,-3,0,0,4,-3,-2,-4,0,-66,26,-92,-53,-28,-25,-37,-10,-17,-29,-11,37,-1,1,17,-1,-10,20,-36,-11,-34,-28,-1,17,1,3,-10,-29,-14,-4,-1,4,-5,-16,-9,-1,2,-1,-5,-13,-5,-3,59,46,13,81,31,50,-9,-19,46,8,-33,61,-4,-5,20,15,-19,37,-5,-14,26,-7,-14,24,18,10,29,15,3,6,9,6,6,6,-1,4,9,4,23,9,4,2,15,16,-1,40,10,30,-11,-18,-3,25,-18,42,-5,-6,8,8,-5,15,-6,-12,-11,17,-13,27,5,13,5,8,9,0,-1,7,-1,0,5,0,6,6,6,8,4,0,259,142,117,89,33,56,22,21,69,53,30,67,13,11,37,30,25,29,9,10,32,23,5,38,10,19,24,21,13,2,5,9,8,6,5,0,5,10,16,15,8,2,171,115,56,64,33,31,30,-17,76,51,-11,37,30,2,32,30,9,8,0,-19,44,21,-20,29,17,8,21,12,8,-2,10,4,11,3,6,-1,7,4,10,9,2,-1
8,08073,Cornellà de Llobregat,80329,-1038,-482,-556,80,47,33,-166,-133,-301,-175,-193,-59,-70,-55,-135,-84,-96,-42,-96,-78,-166,-91,-97,-17,7,13,33,16,8,3,3,8,21,9,5,1,4,5,12,7,3,2,-1066,-555,-511,18,12,6,-131,-104,-409,-152,-173,-84,-59,-59,-220,-74,-99,-36,-72,-45,-189,-78,-74,-48,1,3,5,4,4,1,1,1,3,2,4,1,0,2,2,2,0,0,-1539,-778,-761,-25,-9,-16,-229,-128,-553,-270,-195,-149,-118,-71,-246,-152,-113,-68,-111,-57,-307,-118,-82,-81,-1,-8,-8,-7,4,-5,0,-3,-3,-2,1,-2,-1,-5,-5,-5,3,-3,-886,-448,-438,-31,-15,-16,-103,-70,-304,-137,-167,-101,-45,-6,-183,-62,-95,-52,-58,-64,-121,-75,-72,-49,0,-7,-13,-9,-1,-2,1,-2,-5,-8,-1,0,-1,-5,-8,-1,0,-2,95,102,-7,1329,762,567,9,282,58,36,-134,-132,-48,202,87,7,-85,-48,57,80,-29,29,-49,-84,239,384,435,193,52,16,116,220,276,125,19,5,123,164,159,68,33,11,836,486,350,1533,883,650,193,416,221,128,-96,-13,96,244,171,52,-60,-13,97,172,50,76,-36,0,322,437,439,233,67,21,171,251,279,138,29,9,151,186,160,95,38,12,540,399,141,1546,858,688,113,307,194,113,-112,-101,65,213,151,66,-63,-48,48,94,43,47,-49,-53,353,422,464,227,43,19,190,236,274,124,18,7,163,186,190,103,25,12,730,357,373,1524,853,671,182,419,164,89,-120,20,107,265,58,9,-82,8,75,154,106,80,-38,12,347,457,439,200,49,21,202,269,244,102,19,10,145,188,195,98,30,11,1681,905,776,1834,949,885,453,512,487,244,12,-64,259,268,278,123,-9,-30,194,244,209,121,21,-34,486,470,489,282,71,23,260,238,255,154,30,3,226,232,234,128,41,20,95,-4,99,151,-23,174,72,201,-34,1,-53,-116,41,58,-54,-10,-6,-57,31,143,20,11,-47,-59,87,144,-25,-20,-29,-21,52,58,-65,-48,-23,-7,35,86,40,28,-6,-14,-458,-415,-43,-178,-184,6,-31,26,-134,-142,-123,-67,-15,-15,-190,-111,-69,-28,-16,41,56,-31,-54,-39,12,44,-123,-69,-38,-15,11,1,-117,-67,-12,-6,1,43,-6,-2,-26,-9,364,119,245,318,70,248,168,182,127,-51,-60,-6,101,118,16,-85,-42,3,67,64,111,34,-18,-9,146,138,41,-27,-5,15,72,80,-22,-47,-25,6,74,58,63,20,20,9,-474,-391,-83,-532,-418,-114,-59,33,-262,-161,-39,5,-7,-1,-225,-133,-43,15,-52,34,-37,-28,4,-10,-6,-16,-243,-207,-59,-7,3,-24,-201,-159,-37,0,-9,8,-42,-48,-22,-7,-291,-262,-29,-313,-177,-136,-55,33,-16,-136,-64,-84,-33,-5,-45,-115,-36,-38,-22,38,29,-21,-28,-46,-54,18,-73,-141,-55,-12,-5,-3,-44,-86,-34,-6,-49,21,-29,-55,-21,-6,72,-34,106,-7,-32,25,71,93,44,-37,-59,-57,65,25,4,-67,-58,-11,6,68,40,30,-1,-46,28,68,-21,-76,-18,-2,35,7,-13,-57,-14,-1,-7,61,-8,-19,-4,-1,-90,-103,13,-115,-123,8,-34,140,-61,-116,5,-49,-16,31,-21,-92,5,-27,-18,109,-40,-24,0,-22,5,85,-21,-152,-41,-7,9,14,-9,-109,-28,-6,-4,71,-12,-43,-13,-1,749,295,454,520,186,334,135,240,265,87,70,-55,89,130,113,-11,3,-33,46,110,152,98,67,-22,178,173,129,-18,23,16,94,101,42,-51,-13,8,84,72,87,33,36,8,321,80,241,367,98,269,78,232,249,-109,-44,-95,50,96,138,-116,-36,-59,28,136,111,7,-8,-36,130,201,163,-104,-29,-10,66,86,74,-93,-37,-9,64,115,89,-11,8,-1
8,08075,Dosrius,2675,175,68,107,14,6,8,56,13,55,41,3,7,22,3,21,20,3,0,34,10,34,21,0,7,3,4,4,3,0,0,2,0,2,2,0,0,1,4,2,1,0,0,209,116,93,13,8,5,49,16,69,38,23,14,37,10,30,24,8,7,12,6,39,14,15,7,4,2,2,2,3,0,3,1,2,1,1,0,1,1,0,1,2,0,229,111,118,10,4,6,34,16,89,34,22,32,14,13,41,15,11,15,20,3,48,19,11,17,1,2,2,1,2,2,0,0,1,1,1,1,1,2,1,0,1,1,232,103,129,0,0,0,48,12,93,28,36,12,16,0,45,18,18,6,32,12,48,10,18,6,0,0,2,-2,0,0,0,0,1,-1,0,0,0,0,1,-1,0,0,273,129,144,16,8,8,48,26,105,54,15,23,25,10,51,29,5,6,23,16,54,25,10,17,4,5,5,3,-1,0,2,2,3,2,-1,0,2,3,2,1,0,0,336,169,167,16,4,12,72,43,107,78,19,14,39,21,47,46,13,4,33,22,60,32,6,10,2,1,10,3,0,0,1,-1,2,2,0,0,1,2,8,1,0,0,168,96,72,21,14,7,30,14,69,20,18,15,17,7,39,18,14,3,13,7,30,2,4,12,5,0,7,8,-1,2,4,2,5,3,0,0,1,-2,2,5,-1,2,159,84,75,17,11,6,28,16,43,34,19,21,16,6,26,21,8,8,12,10,17,13,11,13,6,1,5,3,0,0,4,0,3,3,0,0,2,1,2,0,0,0,40,20,20,14,8,6,16,-4,25,-4,0,6,14,-5,14,-4,2,-2,2,1,11,0,-2,8,1,1,4,4,4,0,2,1,2,1,2,0,-1,0,2,3,2,0,43,13,30,0,1,-1,-5,-9,48,-13,9,8,-6,-5,16,-3,3,3,1,-4,32,-10,6,5,-3,0,3,1,0,-1,0,-1,1,1,0,0,-3,1,2,0,0,-1,67,37,30,4,0,4,13,4,32,-2,20,2,10,4,8,8,7,3,3,0,24,-10,13,-1,0,3,0,0,1,0,-1,2,-1,0,0,0,1,1,1,0,1,0,38,30,8,6,0,6,-2,0,19,5,-3,16,2,3,13,4,-6,13,-4,-3,6,1,3,3,4,1,3,-2,-1,0,2,0,-2,0,-1,0,2,1,5,-2,0,0,-14,-18,4,-17,-10,-7,-25,-8,18,-12,-3,15,-24,-9,13,-7,2,7,-1,1,5,-5,-5,8,-6,-1,-4,-4,-3,0,-5,-2,-1,-2,-1,0,-1,1,-3,-2,-2,0,-70,-29,-41,-10,-10,0,-34,-5,30,-41,-16,-1,-15,0,8,-14,-8,0,-19,-5,22,-27,-8,-1,-5,2,2,-10,0,1,-5,0,-1,-4,-1,1,0,2,3,-6,1,0,43,14,29,-8,-4,-4,5,8,17,-8,16,10,9,4,6,-18,12,4,-4,4,11,10,4,6,-3,-5,-1,-2,0,3,0,-4,-1,-1,0,2,-3,-1,0,-1,0,1,-60,-28,-32,-3,-3,0,-26,-10,-1,-3,-21,3,-5,-8,2,-4,-8,-4,-21,-2,-3,1,-13,7,-2,-3,1,1,0,0,-1,-2,-1,-1,2,0,-1,-1,2,2,-2,0,32,10,22,9,2,7,-3,-4,30,14,-4,0,-1,-1,11,4,-1,1,-2,-3,19,10,-3,-1,4,-1,6,-2,3,-1,1,-1,2,0,1,-1,3,0,4,-2,2,0,51,34,17,25,20,5,5,26,11,11,-5,3,-2,18,4,19,-7,2,7,8,7,-8,2,1,9,17,-1,1,-1,0,7,15,-1,1,-2,0,2,2,0,0,1,0
8,08076,Esparreguera,16280,703,381,322,144,91,53,98,149,295,57,55,46,69,65,171,30,28,16,29,84,124,27,27,30,24,31,59,22,3,4,19,17,37,14,1,3,5,14,22,8,2,1,667,360,307,192,120,72,113,156,263,80,27,25,46,70,171,45,14,9,67,86,92,35,13,16,52,41,65,25,6,2,25,30,42,18,5,0,27,11,23,7,1,2,498,289,209,169,94,75,52,141,198,61,34,22,31,76,127,28,21,5,21,65,71,33,13,17,28,44,52,30,6,9,15,25,31,19,3,1,13,19,21,11,3,8,538,325,213,157,84,73,78,114,207,49,48,33,54,63,133,30,27,14,24,51,74,19,21,19,45,49,32,19,7,1,31,27,13,10,2,0,14,22,19,9,5,1,428,223,205,180,107,73,70,121,153,42,39,3,32,78,79,18,16,3,38,43,74,24,23,0,42,43,57,17,14,5,21,28,37,10,8,2,21,15,20,7,6,3,299,184,115,202,117,85,35,89,93,30,6,47,29,55,51,28,3,18,6,34,42,2,3,29,48,44,55,27,15,9,30,25,34,13,8,5,18,19,21,14,7,4,135,73,62,220,128,92,27,21,42,8,22,15,-3,21,35,9,9,6,30,0,7,-1,13,9,45,55,63,37,12,4,21,34,43,23,5,1,24,21,20,14,7,3,32,42,-10,166,104,62,-5,65,14,-38,2,-2,13,29,24,-22,-8,5,-18,36,-10,-16,10,-7,18,60,49,35,3,1,9,33,33,29,-1,1,9,27,16,6,4,0,179,99,80,213,135,78,27,61,50,21,9,13,9,27,18,31,5,6,18,34,32,-10,4,7,35,52,69,43,11,1,16,29,44,35,8,1,19,23,25,8,3,0,75,5,70,98,50,48,19,6,47,-9,-4,19,18,-2,3,-13,-5,6,1,8,44,4,1,13,24,30,18,16,8,1,17,15,2,8,6,1,7,15,16,8,2,0,-107,-38,-69,-98,-78,-20,27,-10,-70,-28,-7,-22,18,4,-29,-21,-5,-11,9,-14,-41,-7,-2,-11,8,0,-49,-38,-13,-7,11,-5,-46,-26,-7,-6,-3,5,-3,-12,-6,-1,-202,-113,-89,-32,-31,-1,-13,-33,-102,-45,-23,13,-14,-22,-44,-25,-19,9,1,-11,-58,-20,-4,4,1,11,-17,-28,-4,3,2,2,-9,-24,-8,4,-1,9,-8,-4,4,-1,-39,-27,-12,-43,-30,-13,-20,-2,30,-34,-31,23,-10,0,20,-24,-18,7,-10,-2,10,-10,-13,16,1,2,-20,-20,-8,0,2,-3,-12,-15,-3,1,-1,5,-8,-5,-5,-1,-261,-119,-142,-106,-72,-34,-46,-48,-69,-63,-31,-4,-10,-15,-40,-42,-11,0,-36,-33,-29,-21,-20,-4,-4,-3,-40,-42,-14,-4,0,-4,-27,-33,-9,-1,-4,1,-13,-9,-5,-3,-5,-45,40,-72,-69,-3,-8,32,28,-56,-2,-1,-1,16,-8,-45,-5,-4,-7,16,36,-11,3,3,-10,0,-31,-29,-5,1,-1,2,-36,-30,-7,1,-9,-2,5,1,2,0,9,11,-2,28,21,7,-5,10,-6,-5,-1,8,8,2,-7,-3,2,3,-13,8,1,-2,-3,5,2,12,5,4,7,-2,2,4,11,2,2,0,0,8,-6,2,5,-2,128,72,56,41,25,16,72,-1,56,9,-19,15,33,13,29,9,-17,1,39,-14,27,0,-2,14,13,16,28,-8,-10,-1,14,10,22,-12,-9,-3,-1,6,6,4,-1,2,150,70,80,86,29,57,32,41,45,23,-23,18,25,19,19,25,-34,12,7,22,26,-2,11,6,16,35,19,19,-3,-3,7,15,8,9,-10,-1,9,20,11,10,7,-2
8,08077,Esplugues de Llobregat,46304,49,-19,68,510,241,269,5,37,32,37,-73,4,-8,15,17,9,-47,-11,13,22,15,28,-26,15,74,117,191,94,26,5,30,60,90,45,11,3,44,57,101,49,15,2,58,30,28,674,350,324,45,35,27,52,-69,-32,7,21,25,34,-39,-22,38,14,2,18,-30,-10,110,159,249,125,19,7,52,72,144,68,10,2,58,87,105,57,9,5,110,33,77,816,415,401,110,42,33,-3,-62,-7,59,29,-10,4,-45,-3,51,13,43,-7,-17,-4,165,186,271,145,28,13,83,95,144,74,9,7,82,91,127,71,19,6,-452,-220,-232,470,212,258,38,-14,-227,-67,-151,-22,8,15,-114,-37,-79,-12,30,-29,-113,-30,-72,-10,111,117,122,82,23,10,43,59,62,34,7,4,68,58,60,48,16,6,161,7,154,649,337,312,150,107,-46,36,-100,7,64,53,-54,12,-60,-6,86,54,8,24,-40,13,135,169,178,125,31,3,70,97,88,61,15,1,65,72,90,64,16,2,175,14,161,717,358,359,144,114,-104,150,-69,-32,81,50,-112,66,-28,-15,63,64,8,84,-41,-17,164,170,196,128,38,11,87,77,103,64,18,6,77,93,93,64,20,5,25,32,-7,722,346,376,101,93,-78,-12,-90,14,60,23,-6,-23,-43,29,41,70,-72,11,-47,-15,151,180,226,113,31,13,77,82,111,57,13,5,74,98,115,56,18,8,46,-20,66,497,246,251,34,153,38,0,-118,-39,10,97,12,-24,-74,-32,24,56,26,24,-44,-7,130,167,135,41,14,1,71,93,59,17,3,-2,59,74,76,24,11,3,164,63,101,553,291,262,147,118,-15,24,-65,-49,92,44,1,10,-44,-36,55,74,-16,14,-21,-13,148,180,144,60,20,-9,78,83,79,40,9,0,70,97,65,20,11,-9,-370,-213,-157,146,46,100,-94,-43,-149,-10,-35,-14,-47,-35,-105,22,-31,4,-47,-8,-44,-32,-4,-18,32,63,24,19,2,0,18,19,-5,12,-4,2,14,44,29,7,6,-2,36,-83,119,80,-11,91,41,11,-1,-2,-31,30,9,0,-46,-4,-26,-7,32,11,45,2,-5,37,21,30,10,8,-5,-1,5,17,-26,-11,-3,-2,16,13,36,19,-2,1,58,-24,82,93,41,52,66,36,-34,33,-40,18,33,11,0,-16,-41,0,33,25,-34,49,1,18,22,45,25,5,-1,-6,19,21,17,-10,-5,-4,3,24,8,15,4,-2,5,-24,29,13,-11,24,102,5,-40,2,-26,-7,54,14,-40,-23,-10,-9,48,-9,0,25,-16,2,20,24,4,-24,-8,-6,10,19,-10,-15,-14,-2,10,5,14,-9,6,-4,-387,-257,-130,-435,-278,-157,-29,-55,-124,-85,-124,18,-10,-35,-118,-59,-57,7,-19,-20,-6,-26,-67,11,-42,-31,-131,-153,-78,-10,-22,-19,-89,-108,-41,-5,-20,-12,-42,-45,-37,-5,-236,-149,-87,-267,-182,-85,47,1,-119,-99,-50,-4,36,0,-48,-87,-34,-16,11,1,-71,-12,-16,12,-8,-4,-63,-135,-48,-15,-3,-11,-40,-91,-35,-5,-5,7,-23,-44,-13,-10,241,73,168,136,42,94,125,36,43,105,-38,-12,80,6,-31,68,-22,-24,45,30,74,37,-16,12,60,41,31,0,-6,4,39,14,7,-13,-6,-1,21,27,24,13,0,5,380,133,247,315,138,177,198,63,94,104,-58,-21,81,24,21,43,-22,-12,117,39,73,61,-36,-9,101,72,101,12,5,12,49,32,45,-5,6,3,52,40,56,17,-1,9,554,205,349,601,267,334,134,135,164,124,45,-51,68,30,70,56,12,-33,66,105,94,68,33,-18,107,127,168,122,60,8,50,51,84,55,21,2,57,76,84,67,39,6
8,08134,Figaró-Montmany,777,64,36,28,11,8,3,3,6,11,7,4,34,3,4,10,6,1,12,0,2,1,1,3,22,1,1,6,3,0,0,1,0,4,3,0,0,0,1,2,0,0,0,38,12,26,20,14,6,0,11,5,9,9,5,-2,6,0,3,4,1,2,5,5,6,5,4,1,10,7,2,0,0,1,8,4,1,0,0,0,2,3,1,0,0,52,24,28,28,17,11,12,4,9,1,3,22,7,0,8,1,3,4,5,4,1,0,0,18,2,10,8,5,3,0,1,4,7,4,1,0,1,6,1,1,2,0,56,26,30,15,7,8,14,3,-3,12,6,25,5,3,3,4,4,8,9,0,-6,8,2,17,8,1,3,2,0,1,3,0,3,0,0,1,5,1,0,2,0,0,34,18,16,19,8,11,-2,10,17,-5,0,15,0,6,12,-3,-1,5,-2,4,5,-2,1,10,5,7,3,1,2,1,2,3,1,1,0,1,3,4,2,0,2,0,9,-1,10,14,7,7,-2,0,0,3,1,5,1,3,-8,1,-1,1,-3,-3,8,2,2,4,1,4,4,3,1,0,1,2,1,2,0,0,0,2,3,1,1,0,37,15,22,16,7,9,5,5,4,1,-2,21,4,1,0,1,0,8,1,4,4,0,-2,13,2,5,6,0,2,0,1,0,3,0,2,0,1,5,3,0,0,0,47,18,29,14,4,10,3,15,6,3,10,7,3,4,-1,2,7,1,0,11,7,1,3,6,2,3,5,3,1,0,0,1,1,1,1,0,2,2,4,2,0,0,26,-1,27,12,2,10,9,-3,4,6,-5,13,1,1,-3,2,-3,0,8,-4,7,4,-2,13,1,4,5,0,1,1,0,1,1,0,0,0,1,3,4,0,1,1,22,5,17,10,3,7,-1,9,6,2,1,5,-1,2,3,-1,1,2,0,7,3,3,0,3,3,2,4,1,-1,1,0,2,2,0,-1,0,3,0,2,1,0,1,34,22,12,6,2,4,0,2,1,15,4,9,1,1,2,8,3,6,-1,1,-1,7,1,3,2,2,1,1,0,0,0,2,0,0,0,0,2,0,1,1,0,0,5,1,4,-14,-7,-7,8,0,-12,7,-3,4,4,-1,-7,1,0,3,4,1,-5,6,-3,1,0,0,-7,-2,-3,-2,-1,0,-4,-1,-1,0,1,0,-3,-1,-2,-2,15,4,11,-1,-2,1,-1,7,6,2,-7,10,-4,5,1,2,-3,4,3,2,5,0,-4,6,1,1,0,0,-2,-1,1,0,0,0,-3,0,0,1,0,0,1,-1,19,1,18,-3,0,-3,-4,-6,6,-3,6,21,-6,-2,7,-2,-1,6,2,-4,-1,-1,7,15,-1,0,-2,0,1,-1,-1,1,-1,0,1,0,0,-1,-1,0,0,-1,13,3,10,4,2,2,-3,-3,4,-7,-2,28,3,-3,1,-1,-1,7,-6,0,3,-6,-1,21,2,0,2,2,-1,0,2,0,1,1,-1,0,0,0,1,1,0,0,15,-3,18,7,4,3,-5,6,0,0,5,9,-3,0,-5,-6,5,5,-2,6,5,6,0,4,2,1,-1,3,1,1,2,0,0,1,1,0,0,1,-1,2,0,1,-11,-3,-8,-2,-5,3,-7,-8,6,-3,3,0,-2,-6,5,-5,3,2,-5,-2,1,2,0,-2,-3,-3,2,-2,1,2,-2,-2,1,-3,0,0,-1,-1,1,1,1,2,44,26,18,-2,0,-2,9,4,15,6,3,9,1,8,6,8,0,4,8,-4,9,-2,3,5,-1,3,0,-5,2,-1,-1,1,2,-2,0,0,0,2,-2,-3,2,-1
8,08085,Font-rubí,1219,39,23,16,14,9,5,5,11,6,6,9,1,2,6,3,3,7,1,3,5,3,3,2,0,5,3,3,2,1,0,3,3,2,0,1,0,2,0,1,2,0,0,55,28,27,19,14,5,16,8,15,10,2,2,8,5,8,4,1,2,8,3,7,6,1,0,2,4,7,3,2,0,1,4,5,2,2,0,1,0,2,1,0,0,3,14,-11,18,14,4,-4,2,1,8,6,-10,3,2,3,7,3,-4,-7,0,-2,1,3,-6,1,6,6,5,0,0,1,5,4,4,0,0,0,1,2,1,0,0,44,22,22,17,12,5,3,12,13,9,8,-1,-2,11,3,3,6,1,5,1,10,6,2,-2,0,6,8,2,1,0,0,6,4,1,1,0,0,0,4,1,0,0,41,29,12,27,15,12,3,8,19,7,4,-1,1,5,15,5,3,0,2,3,4,2,1,-1,9,7,7,4,0,0,4,2,6,3,0,0,5,5,1,1,0,0,28,14,14,10,5,5,11,-9,17,1,2,4,7,-2,7,0,1,1,4,-7,10,1,1,3,3,1,2,1,1,0,2,1,0,1,1,0,1,0,2,0,0,0,45,22,23,17,13,4,7,5,17,15,4,-4,4,5,8,3,3,-2,3,0,9,12,1,-2,3,7,4,2,1,0,2,7,2,1,1,0,1,0,2,1,0,0,33,16,17,18,13,5,12,1,15,4,1,3,2,2,12,0,2,0,10,-1,3,4,-1,3,3,5,4,4,2,0,2,4,4,2,1,0,1,1,0,2,1,0,20,4,16,3,0,3,12,2,7,0,-1,0,8,6,-2,-5,-1,-2,4,-4,9,5,0,2,4,6,-4,-1,-2,0,3,6,-5,-2,-2,0,1,0,1,1,0,0,-10,3,-13,14,8,6,-8,3,2,-1,-5,-2,-3,3,1,4,-3,0,-5,0,1,-5,-2,-2,3,8,1,2,0,0,3,4,0,1,0,0,0,4,1,1,0,0,9,7,2,8,2,6,6,2,-6,4,1,0,1,2,-6,3,5,0,5,0,0,1,-4,0,1,4,3,0,0,0,0,2,0,0,0,0,1,2,3,0,0,0,-27,-30,3,-6,-9,3,-1,-1,-17,-3,-1,-2,-2,-3,-12,-4,-1,-6,1,2,-5,1,0,4,3,2,-4,-4,-1,-2,2,1,-5,-3,-1,-3,1,1,1,-1,0,1,-17,-3,-14,7,5,2,-9,0,3,-9,2,-4,-5,1,4,-3,1,-1,-4,-1,-1,-6,1,-3,0,1,1,0,3,2,0,1,1,0,2,1,0,0,0,0,1,1,-48,-25,-23,-8,-4,-4,-11,-6,-17,-12,-1,0,-6,-4,-10,-5,0,0,-5,-2,-7,-7,-1,0,2,-3,-2,-1,-1,-2,2,-3,-2,0,0,-1,0,0,0,-1,-1,-1,-4,-3,-1,-6,-7,1,0,-2,5,-3,-1,-2,4,-3,0,-2,-2,0,-4,1,5,-1,1,-2,3,-2,0,-6,1,-2,2,-3,-1,-5,1,-1,1,1,1,-1,0,-1,9,2,7,-4,-6,2,3,0,5,-1,1,1,1,2,0,-3,1,1,2,-2,5,2,0,0,-1,-2,0,-2,1,0,-1,-2,-1,-2,0,0,0,0,1,0,1,0,8,7,1,6,2,4,4,0,4,8,-2,-8,3,-1,2,6,-2,-2,1,1,2,2,0,-6,1,1,0,4,0,0,1,0,0,1,0,0,0,1,0,3,0,0,13,14,-1,0,0,0,-1,-3,4,6,4,2,2,0,1,1,6,3,-3,-3,3,5,-2,-1,0,1,0,-2,0,0,0,0,0,-1,0,0,0,1,0,-1,0,0
8,08086,"Franqueses del Vallès, Les",11706,513,255,258,103,54,49,76,139,197,56,28,14,30,62,122,33,9,0,46,77,75,23,19,14,20,35,31,17,0,0,4,19,20,11,0,0,16,16,11,6,0,0,502,268,234,172,109,63,50,155,168,76,24,25,28,94,100,36,4,6,22,61,68,40,20,19,30,43,68,23,4,2,14,29,50,13,1,1,16,14,18,10,3,1,473,274,199,178,119,59,25,138,191,40,18,50,12,74,119,29,9,21,13,64,72,11,9,29,23,50,73,25,2,3,8,36,51,21,2,0,15,14,22,4,0,3,577,317,260,140,85,55,66,151,202,73,25,58,45,64,129,48,10,20,21,87,73,25,15,38,38,40,40,14,1,5,24,28,22,8,0,2,14,12,18,6,1,3,250,158,92,205,126,79,1,87,116,17,-4,24,5,45,74,30,-8,12,-4,42,42,-13,4,12,38,51,70,30,10,2,20,32,45,22,6,1,18,19,25,8,4,1,489,276,213,201,120,81,64,142,219,31,6,22,37,76,131,12,4,11,27,66,88,19,2,11,46,69,58,20,4,1,25,45,38,10,1,0,21,24,20,10,3,1,544,307,237,171,110,61,39,162,201,32,34,78,30,87,138,5,25,24,9,75,63,27,9,54,42,57,41,20,7,3,26,36,30,11,6,1,16,21,11,9,1,2,455,258,197,148,87,61,49,163,140,78,-11,35,26,80,90,46,-3,14,23,83,50,32,-8,21,38,59,29,18,3,1,21,42,15,11,-2,0,17,17,14,7,5,1,475,238,237,184,104,80,61,117,226,46,14,13,35,45,117,22,8,9,26,72,109,24,6,4,38,75,48,19,0,-2,25,41,25,13,-3,-1,13,34,23,6,3,-1,210,94,116,40,14,26,34,75,65,4,22,15,19,47,23,-17,13,10,15,28,42,21,9,5,14,21,18,-8,1,-7,14,5,6,-11,3,-3,0,16,12,3,-2,-4,400,220,180,126,65,61,39,64,168,56,29,34,13,21,103,45,17,20,26,43,65,11,12,14,28,21,44,25,2,2,13,10,24,19,-3,1,15,11,20,6,5,1,154,81,73,15,0,15,1,79,79,-27,-17,36,6,27,56,-13,-15,16,-5,52,23,-14,-2,20,10,5,5,-8,-2,2,10,-3,8,-11,-4,0,0,8,-3,3,2,2,-79,-84,5,-26,-26,0,5,-22,-49,-20,-6,8,3,-27,-39,-12,-2,-5,2,5,-10,-8,-4,13,-4,4,-18,-4,-3,-1,-1,-2,-20,-5,1,0,-3,6,2,1,-4,-1,-76,-52,-24,-13,-27,14,-3,-3,-47,-25,-12,19,-2,-6,-22,-20,-12,11,-1,3,-25,-5,0,8,13,2,-13,-15,-3,2,8,-5,-13,-14,-6,2,5,7,0,-1,3,0,149,78,71,-14,-15,1,16,63,38,-2,15,21,-7,33,44,-2,0,9,23,30,-6,0,15,12,-8,22,-1,-20,-4,-3,-10,16,2,-15,-5,-3,2,6,-3,-5,1,0,-103,-78,-25,-24,-27,3,-40,22,-55,-36,-3,13,-31,0,-19,-24,-4,2,-9,22,-36,-12,1,11,-5,7,3,-18,-10,-1,-6,-2,7,-12,-11,-2,1,9,-4,-6,1,1,116,80,36,23,13,10,4,58,38,-17,0,29,9,41,21,-11,8,8,-5,17,17,-6,-8,21,10,30,-10,-11,-1,1,6,18,-2,-13,1,2,4,12,-8,2,-2,-1,139,22,117,72,18,54,28,49,43,-14,8,19,27,22,12,-52,2,7,1,27,31,38,6,12,20,27,22,-9,1,4,15,14,3,-19,-2,4,5,13,19,10,3,0
8,08089,Gavà,39214,130,86,44,306,186,120,24,1,68,24,-13,14,36,-6,32,14,-4,9,-12,7,36,10,-9,5,55,63,114,56,12,3,38,36,69,34,7,1,17,27,45,22,5,2,941,474,467,403,191,212,156,163,400,125,53,34,72,83,205,67,24,22,84,80,195,58,29,12,96,84,110,77,16,11,43,35,58,37,8,7,53,49,52,40,8,4,941,511,430,664,349,315,144,208,450,101,31,-6,94,103,253,67,-5,-9,50,105,197,34,36,3,154,147,195,118,24,12,82,81,95,74,6,4,72,66,100,44,18,8,850,394,456,579,288,291,121,203,385,117,-29,53,50,100,199,59,-28,5,71,103,186,58,-1,48,150,134,154,104,17,16,87,64,65,57,7,5,63,70,89,47,10,11,629,281,348,507,248,259,129,164,252,47,6,24,73,69,118,13,2,7,56,95,134,34,4,17,98,113,161,88,28,9,51,47,92,39,12,3,47,66,69,49,16,6,530,240,290,608,314,294,16,182,255,46,3,6,-11,98,130,23,-14,7,27,84,125,23,17,-1,98,157,197,104,36,12,42,74,112,66,10,7,56,83,85,38,26,5,65,-15,80,531,249,282,62,6,31,20,-53,-19,46,-13,-23,16,-31,-20,16,19,54,4,-22,1,101,116,166,100,30,7,51,56,72,47,14,1,50,60,94,53,16,6,74,35,39,409,216,193,39,88,12,-31,-43,2,42,26,14,-15,-30,-6,-3,62,-2,-16,-13,8,82,131,112,45,30,2,48,62,70,20,11,-1,34,69,42,25,19,3,553,255,298,471,228,243,74,139,211,83,13,27,32,85,109,42,-6,-13,42,54,102,41,19,40,89,132,137,62,43,3,48,75,61,32,12,-2,41,57,76,30,31,5,270,112,158,164,63,101,87,106,100,18,-55,12,48,61,41,-27,-30,10,39,45,59,45,-25,2,36,63,64,3,-7,3,26,29,20,-9,-10,3,10,34,44,12,3,0,-365,-242,-123,-197,-156,-41,-91,-41,-77,-106,-29,-12,-63,-28,-49,-71,-27,-4,-28,-13,-28,-35,-2,-8,-36,5,-48,-87,-19,-16,-21,-13,-40,-58,-13,-14,-15,18,-8,-29,-6,-2,285,127,158,91,33,58,101,88,41,71,-37,7,59,39,27,15,-25,5,42,49,14,56,-12,2,53,38,-6,5,-5,-7,26,21,-9,-9,-2,1,27,17,3,14,-3,-8,-166,-124,-42,-115,-67,-48,4,30,-41,-98,-22,-39,2,28,-61,-69,-3,-16,2,2,20,-29,-19,-23,16,12,-34,-70,-21,-19,14,6,-33,-34,-11,-8,2,6,-1,-36,-10,-11,-135,-121,-14,-116,-74,-42,24,-12,7,-105,-77,21,-5,-26,-22,-55,-38,13,29,14,29,-50,-39,8,18,-2,-35,-68,-24,-6,19,-11,-21,-43,-20,1,-1,9,-14,-25,-4,-7,-11,17,-28,-61,-54,-7,35,-23,8,-3,-45,18,45,-9,18,-12,-27,4,-10,-14,-10,9,-18,14,15,7,-34,-39,-9,-4,15,-6,-14,-42,-11,2,0,13,-20,3,2,-6,-192,-126,-66,-36,-47,11,-24,18,-36,-40,-76,-32,-28,10,-32,-13,-42,-22,4,8,-4,-27,-34,-10,10,29,-23,-15,-42,-2,-5,15,-16,-12,-25,-7,15,14,-7,-3,-17,5,284,76,208,235,89,146,166,17,94,26,-24,-6,68,22,40,-10,-39,-13,98,-5,54,36,15,7,80,38,69,40,0,-2,36,28,33,9,-11,-9,44,10,36,31,11,7,286,151,135,287,159,128,111,37,48,91,-26,16,54,22,33,55,-22,3,57,15,15,36,-4,13,91,64,63,61,-8,12,58,32,31,34,-8,9,33,32,32,27,0,3
8,08091,Gelida,4270,108,74,34,34,25,9,7,12,56,17,15,1,7,13,34,12,7,1,0,-1,22,5,8,0,3,5,16,10,0,0,2,4,12,7,0,0,1,1,4,3,0,0,201,114,87,57,43,14,29,40,91,22,7,10,17,26,45,16,4,6,12,14,46,6,3,4,7,24,12,13,1,0,4,20,9,9,1,0,3,4,3,4,0,0,202,100,102,46,29,17,32,25,88,26,25,6,20,10,55,5,12,-1,12,15,33,21,13,7,9,10,15,8,1,2,6,6,11,5,1,0,3,4,4,3,0,2,421,220,201,64,30,34,64,45,183,67,26,23,38,14,97,37,18,9,26,31,86,30,8,14,16,14,15,10,3,4,9,7,9,3,1,0,7,7,6,7,2,4,210,102,108,63,34,29,30,28,90,51,16,-7,18,4,45,30,8,-4,12,24,45,21,8,-3,9,18,19,11,3,1,4,7,11,8,1,1,5,11,8,3,2,0,259,130,129,57,27,30,23,61,96,53,16,4,18,30,49,26,9,-3,5,31,47,27,7,7,11,14,11,13,5,2,2,7,8,8,0,1,9,7,3,5,5,1,172,85,87,49,21,28,0,25,78,24,21,30,-7,13,44,11,12,14,7,12,34,13,9,16,7,11,14,13,2,1,4,5,7,4,1,0,3,6,7,9,1,1,406,186,220,81,40,41,54,62,194,51,18,17,18,25,103,20,9,5,36,37,91,31,9,12,19,16,21,16,6,1,8,8,12,7,2,1,11,8,9,9,4,0,151,72,79,38,13,25,3,20,67,18,20,20,-3,12,33,9,11,6,6,8,34,9,9,14,13,9,10,3,4,-1,4,3,4,1,1,0,9,6,6,2,3,-1,116,53,63,2,-7,9,6,27,59,4,12,1,10,11,25,0,1,-2,-4,16,34,4,11,3,7,13,-2,-10,-7,-1,4,4,-2,-7,-7,-1,3,9,0,-3,0,0,89,18,71,-1,-15,14,12,13,36,22,-11,15,5,-1,15,7,-10,2,7,14,21,15,-1,13,4,-1,1,-3,-4,1,0,-5,-5,-4,-2,0,4,4,6,1,-2,1,22,2,20,-17,-10,-7,26,-4,0,-32,6,22,12,-5,0,-21,4,11,14,1,0,-11,2,11,3,12,-16,-18,-2,3,0,7,-9,-6,-2,0,3,5,-7,-12,0,3,14,7,7,-16,-9,-7,-5,13,-2,-13,2,17,1,4,1,-11,-1,10,-6,9,-3,-2,3,7,4,-8,-4,-6,-2,-1,2,-3,-6,-3,0,1,2,-5,2,-3,-2,-2,30,22,8,-24,-13,-11,-9,9,-12,22,16,7,-8,7,5,8,6,8,-1,2,-17,14,10,-1,-3,0,-14,-4,-2,1,-1,-3,-4,-3,-1,1,-2,3,-10,-1,-1,0,26,0,26,-5,-7,2,0,12,-12,28,0,-1,7,6,-15,8,0,-6,-7,6,3,20,0,5,-6,2,2,0,0,-3,-4,-1,3,-2,0,-3,-2,3,-1,2,0,0,-29,10,-39,9,2,7,-36,11,13,-13,-2,-5,-15,3,9,7,1,2,-21,8,4,-20,-3,-7,-2,5,8,-1,0,-1,-2,1,1,2,0,0,0,4,7,-3,0,-1,63,50,13,19,7,12,-5,13,30,12,8,-2,-2,7,21,19,4,-2,-3,6,9,-7,4,0,3,6,9,0,-1,1,1,1,6,2,-1,-2,2,5,3,-2,0,3,57,0,57,21,-2,23,3,21,12,2,11,3,-3,10,0,-10,3,-3,6,11,12,12,8,6,9,3,0,6,1,2,1,-1,-3,1,0,0,8,4,3,5,1,2
8,08092,Gironella,4913,18,19,-1,38,25,13,8,7,5,5,-3,-2,5,9,3,3,0,1,3,-2,2,2,-3,-3,5,16,10,4,2,0,2,12,8,2,1,0,3,4,2,2,1,0,34,29,5,45,33,12,3,15,-1,24,1,-9,2,8,5,18,0,-5,1,7,-6,6,1,-4,4,16,11,13,1,0,3,12,7,10,1,0,1,4,4,3,0,0,101,60,41,83,48,35,26,29,21,15,11,1,12,16,17,9,6,1,14,13,4,6,5,0,21,21,22,13,4,1,10,12,19,4,3,0,11,9,3,9,1,1,58,24,34,41,16,25,24,17,4,16,-1,-3,12,4,0,11,0,-4,12,13,4,5,-1,1,12,11,8,8,1,0,7,3,2,3,0,0,5,8,6,5,1,0,17,8,9,63,31,32,30,-2,13,-6,-6,-13,17,-7,6,-3,0,-4,13,5,7,-3,-6,-9,26,11,16,8,1,0,16,4,9,1,1,0,10,7,7,7,0,0,-14,-7,-7,52,24,28,15,-4,-19,0,-2,-6,5,-2,-7,-1,-3,1,10,-2,-12,1,1,-7,15,12,11,8,3,1,5,5,6,4,2,1,10,7,5,4,1,0,32,22,10,31,18,13,8,6,13,10,5,-9,5,4,9,7,4,-5,3,2,4,3,1,-4,2,10,10,9,0,0,-1,6,7,6,0,0,3,4,3,3,0,0,162,97,65,112,73,39,33,33,47,30,10,10,22,20,29,18,6,3,11,13,18,12,4,7,20,37,28,17,9,0,14,21,21,12,4,0,6,16,7,5,5,0,73,37,36,31,16,15,20,16,21,-1,13,6,11,9,15,-3,6,0,9,7,6,2,7,6,5,9,8,7,1,1,4,4,6,3,0,-1,1,5,2,4,1,2,104,86,18,37,23,14,9,12,23,57,4,-2,-3,8,24,54,4,-2,12,4,-1,3,0,0,4,6,15,6,4,1,0,2,12,5,2,1,4,4,3,1,2,0,45,10,35,30,16,14,21,2,12,8,1,0,12,-2,1,-2,1,1,9,4,11,10,0,-1,4,9,4,9,2,2,2,4,3,5,2,0,2,5,1,4,0,2,-46,-38,-8,15,7,8,-21,2,-17,-19,4,3,-9,1,-17,-19,3,3,-12,1,0,0,1,0,-1,9,3,0,1,2,0,3,2,-1,0,2,-1,6,1,1,1,0,-33,-32,-1,4,-2,6,0,-4,-21,-21,5,7,-2,-1,-15,-17,2,1,2,-3,-6,-4,3,6,0,1,1,1,1,0,-1,0,-1,0,0,0,1,1,2,1,1,0,-30,-18,-12,12,3,9,-12,0,-5,-5,-9,-1,-8,0,-6,-1,-7,1,-4,0,1,-4,-2,-2,1,5,4,2,0,0,0,1,2,1,-1,0,1,4,2,1,1,0,-20,-12,-8,10,5,5,6,0,-19,-9,-4,3,3,1,-10,-3,-6,2,3,-1,-9,-6,2,1,2,4,3,1,0,0,1,1,2,1,0,0,1,3,1,0,0,0,-89,-59,-30,-34,-28,-6,-15,-15,-15,-24,-18,-3,-8,-9,-14,-14,-14,-1,-7,-6,-1,-10,-4,-2,-5,2,-7,-15,-6,-4,-4,0,-6,-11,-5,-3,-1,2,-1,-4,-1,-1,17,9,8,26,12,14,-2,0,7,-6,10,6,-1,1,8,-3,3,0,-1,-1,-1,-3,7,6,10,4,3,7,1,0,8,2,-1,4,-1,0,2,2,4,3,2,0,78,61,17,28,17,11,21,5,6,21,13,4,12,8,8,12,12,4,9,-3,-2,9,1,0,11,3,6,4,4,0,3,2,5,3,4,0,8,1,1,1,0,0
8,08094,"Granada, La",1333,32,15,17,6,4,2,10,6,7,8,-1,0,10,-2,2,5,0,-1,0,8,5,3,-1,1,0,1,3,1,0,0,0,0,3,1,0,0,0,1,0,0,0,0,57,37,20,15,10,5,12,9,28,4,2,3,9,6,15,4,3,1,3,3,13,0,-1,2,4,2,5,1,1,2,2,2,3,1,1,1,2,0,2,0,0,1,46,25,21,8,5,3,9,7,18,8,5,0,5,3,10,6,1,1,4,4,8,2,4,-1,1,2,3,2,0,0,0,2,2,1,0,0,1,0,1,1,0,0,45,31,14,4,1,3,8,3,19,10,2,3,3,7,12,5,2,2,5,-4,7,5,0,1,2,1,0,0,1,0,1,0,0,-1,1,0,1,1,0,1,0,0,55,34,21,7,4,3,-2,11,23,18,2,2,1,2,18,11,0,1,-3,9,5,7,2,1,0,2,4,1,0,0,0,0,3,1,0,0,0,2,1,0,0,0,163,92,71,11,2,9,34,16,69,28,9,5,20,10,37,18,4,2,14,6,32,10,5,3,3,2,2,1,2,1,1,0,0,0,1,0,2,2,2,1,1,1,95,52,43,21,11,10,23,13,38,17,6,-1,10,4,21,11,5,2,13,9,17,6,1,-3,3,4,7,6,1,0,1,1,5,3,1,0,2,3,2,3,0,0,80,51,29,24,15,9,13,16,20,12,15,5,8,9,14,7,9,4,5,7,6,5,6,1,9,4,8,5,-2,0,5,3,4,4,-1,0,4,1,4,1,-1,0,22,5,17,-5,-7,2,5,8,14,0,0,-6,7,5,-1,-4,0,-4,-2,3,15,4,0,-2,1,0,-4,-3,0,0,0,-1,-2,-4,-1,0,1,1,-2,1,1,0,-20,-9,-11,-5,-4,-1,-3,-10,2,-2,-7,5,-2,-5,2,-1,-3,2,-1,-5,0,-1,-4,3,1,-2,0,-2,-2,0,1,-2,-1,-1,-1,0,0,0,1,-1,-1,0,28,0,28,-8,-6,-2,9,9,5,-2,1,5,-3,0,3,-3,2,1,12,9,2,1,-1,4,0,-1,-5,-3,-1,1,-1,-1,-3,-2,0,0,1,0,-2,-1,-1,1,42,22,20,19,8,11,9,13,9,-1,10,2,7,5,5,-2,5,2,2,8,4,1,5,0,6,4,6,3,0,0,3,1,2,2,0,0,3,3,4,1,0,0,-3,7,-10,-10,-4,-6,-9,-6,13,-5,6,-4,1,0,-1,2,5,0,-10,-6,14,-7,1,-4,-6,-1,0,-4,1,0,-1,0,-2,-2,1,0,-5,-1,2,-2,0,0,8,12,-4,1,4,-3,5,8,-2,-1,-5,3,9,4,0,1,-3,1,-4,4,-2,-2,-2,2,0,1,0,2,-1,-1,0,0,2,2,0,0,0,1,-2,0,-1,-1,13,5,8,4,4,0,0,1,3,5,0,2,-7,2,2,3,1,2,7,-1,1,2,-1,0,1,0,0,2,0,0,1,-1,0,2,1,0,0,1,0,0,-1,0,2,-4,6,0,-3,3,-4,10,-7,1,1,0,-5,5,-1,-3,-2,1,1,5,-6,4,3,-1,1,0,2,-2,-1,0,0,1,0,-3,-1,0,1,-1,2,1,0,0,28,18,10,-3,1,-4,13,2,8,6,-2,1,9,4,1,6,-2,0,4,-2,7,0,0,1,-1,0,-5,4,-1,0,0,1,-1,2,-1,0,-1,-1,-4,2,0,0,16,-1,17,8,4,4,11,2,6,7,-10,1,6,-3,5,-3,-5,0,5,5,1,10,-5,1,1,2,1,5,-1,0,0,1,1,2,0,0,1,1,0,3,-1,0
8,08096,Granollers,51925,-121,-87,-34,39,23,16,-59,58,-34,-91,-20,35,-53,33,8,-62,-21,10,-6,25,-42,-29,1,25,12,4,7,8,3,5,6,2,5,5,3,2,6,2,2,3,0,3,434,268,166,823,486,337,-24,172,263,10,-5,26,-19,117,170,9,-11,7,-5,55,93,1,6,19,126,234,306,126,22,4,68,139,194,72,10,1,58,95,112,54,12,3,1021,686,335,1278,776,502,116,308,392,126,68,23,75,207,285,88,34,4,41,101,107,38,34,19,226,319,463,182,61,15,129,186,308,112,29,5,97,133,155,70,32,10,541,292,249,1192,650,542,154,227,129,71,-36,17,101,117,70,38,-23,9,53,110,59,33,-13,8,281,313,355,174,43,17,153,170,208,93,16,6,128,143,147,81,27,11,842,464,378,1371,803,568,176,315,345,29,14,-3,75,201,210,1,-6,0,101,114,135,28,20,-3,238,390,470,183,55,20,129,233,303,99,23,9,109,157,167,84,32,11,783,479,304,1385,784,601,82,385,264,58,-33,29,38,234,197,65,-46,-3,44,151,67,-7,13,32,206,404,462,213,65,23,99,225,299,127,24,8,107,179,163,86,41,15,649,400,249,1466,829,637,27,366,166,103,0,-8,-16,245,162,41,-14,-11,43,121,4,62,14,3,255,416,483,218,63,10,127,240,320,110,21,2,128,176,163,108,42,8,945,667,278,1505,899,606,126,403,398,65,-2,-29,94,285,293,17,-3,-13,32,118,105,48,1,-16,278,505,533,156,30,-7,153,324,341,68,11,-3,125,181,192,88,19,-4,-39,-10,-29,542,310,232,-2,204,-55,-83,-89,-11,14,120,-16,-56,-56,-9,-16,84,-39,-27,-33,-2,141,234,161,9,-4,-11,86,139,102,-22,-2,-1,55,95,59,31,-2,-10,-814,-614,-200,-491,-413,-78,-32,-78,-391,-233,-80,-9,-20,-84,-284,-182,-39,-14,-12,6,-107,-51,-41,5,12,2,-268,-181,-45,-18,7,-29,-217,-147,-23,-9,5,31,-51,-34,-22,-9,61,36,25,67,35,32,49,102,6,-44,-45,-16,32,62,-2,-19,-37,1,17,40,8,-25,-8,-17,57,77,0,-58,-12,-6,45,44,2,-43,-13,-2,12,33,-2,-15,1,-4,-166,-147,-19,-39,-75,36,36,11,-132,-81,-16,22,53,-31,-107,-37,-32,12,-17,42,-25,-44,16,10,47,43,-66,-66,-8,6,41,9,-60,-55,-15,2,6,34,-6,-11,7,4,-275,-237,-38,-270,-198,-72,-73,11,-115,-60,-65,15,-40,-14,-89,-61,-54,8,-33,25,-26,1,-11,7,-36,1,-109,-95,-39,-3,-19,-6,-72,-81,-23,-1,-17,7,-37,-14,-16,-2,79,-18,97,-148,-119,-29,29,73,-69,-33,52,23,20,41,-70,-35,13,13,9,32,1,2,39,10,10,27,-94,-78,-20,3,3,11,-61,-61,-17,5,7,16,-33,-17,-3,-2,112,44,68,-21,1,-22,-31,108,27,-15,24,-1,-9,45,25,-29,13,-3,-22,63,2,14,11,2,-47,56,-12,-25,-4,6,-12,41,-5,-23,-4,-1,-35,15,-7,-2,0,7,238,18,220,83,-2,85,118,166,-34,-44,16,13,65,62,-47,-55,5,-5,53,104,13,11,11,18,63,89,13,-72,-16,-4,42,37,-2,-70,-11,-3,21,52,15,-2,-5,-1,429,209,220,351,172,179,56,168,134,26,-10,49,29,110,65,2,-19,15,27,58,69,24,9,34,95,132,110,5,-16,14,51,79,39,4,-13,5,44,53,71,1,-3,9,456,214,242,353,189,164,147,175,154,-37,15,2,77,101,88,-44,-24,11,70,74,66,7,39,-9,97,146,82,-7,20,5,62,92,56,-23,-5,1,35,54,26,16,25,4
8,08097,Gualba,748,15,2,13,10,4,6,-2,5,3,10,3,-5,-2,-4,4,5,2,-3,0,9,-1,5,1,-2,2,3,3,1,1,0,1,1,2,0,0,0,1,2,1,1,1,0,46,28,18,24,11,13,9,7,12,12,10,-2,1,3,9,9,7,-1,8,4,3,3,3,-1,4,4,12,1,2,0,2,0,8,0,1,0,2,4,4,1,1,0,60,30,30,23,15,8,17,10,21,4,5,2,9,6,10,0,3,2,8,4,11,4,2,0,7,6,6,3,0,0,5,3,4,3,0,0,2,3,2,0,0,0,35,26,9,19,6,13,6,4,13,13,4,-5,2,5,6,10,2,1,4,-1,7,3,2,-6,4,7,5,3,0,-1,1,1,3,0,0,0,3,6,2,3,0,-1,31,27,4,11,6,5,0,6,12,12,3,-2,5,1,13,7,1,-2,-5,5,-1,5,2,0,4,0,0,4,2,1,1,1,0,4,0,0,3,-1,0,0,2,1,46,16,30,12,9,3,10,0,22,17,-4,1,3,0,9,7,-2,-1,7,0,13,10,-2,2,1,2,6,2,1,0,0,2,5,1,1,0,1,0,1,1,0,0,16,0,16,10,3,7,1,0,9,3,1,3,-3,0,1,4,-3,1,4,0,8,-1,4,2,2,3,2,3,0,0,0,1,1,1,0,0,2,2,1,2,0,0,57,22,35,2,2,0,12,-1,25,6,14,-1,4,1,8,1,7,0,8,-2,17,5,7,-1,-2,0,2,1,1,0,0,0,1,1,0,0,-2,0,1,0,1,0,63,25,38,9,3,6,20,3,18,17,-2,5,5,4,7,9,-2,2,15,-1,11,8,0,3,5,0,2,1,0,0,2,1,0,0,0,0,3,-1,2,1,0,0,37,20,17,2,1,1,25,-4,-2,18,3,-3,11,-2,4,12,-2,-3,14,-2,-6,6,5,0,2,0,-1,-1,1,0,1,0,-1,0,1,0,1,0,0,-1,0,0,58,34,24,9,7,2,0,14,27,14,-1,3,0,9,14,12,-2,1,0,5,13,2,1,2,-1,4,3,3,0,0,-1,3,2,3,0,0,0,1,1,0,0,0,55,26,29,4,1,3,10,0,16,11,14,2,5,-1,11,4,5,0,5,1,5,7,9,2,2,0,2,-3,1,0,1,0,1,-2,0,0,1,0,1,-1,1,0,35,19,16,5,3,2,12,-2,15,7,1,2,14,-2,4,-1,4,0,-2,0,11,8,-3,2,3,0,2,-1,1,0,2,0,1,-1,1,0,1,0,1,0,0,0,36,23,13,4,3,1,23,-4,11,5,4,-4,13,-1,8,3,3,-3,10,-3,3,2,1,-1,0,0,0,1,3,0,0,0,0,1,2,0,0,0,0,0,1,0,-18,-7,-11,-5,-5,0,-5,0,0,-10,-1,-1,0,-2,0,-1,-1,-2,-5,2,0,-9,0,1,-1,0,-1,-2,-1,0,-2,0,0,-2,0,-1,1,0,-1,0,-1,1,-2,-11,9,1,1,0,0,-2,7,-3,0,-4,-3,-2,-1,-7,4,-3,3,0,8,4,-4,-1,2,0,-1,1,0,0,1,0,0,0,0,0,1,0,-1,1,0,0,7,4,3,6,3,3,8,-5,3,4,-1,-5,7,-5,-1,3,-1,-1,1,0,4,1,0,-4,4,0,1,1,0,-1,2,0,0,0,0,0,2,0,1,1,0,-1,49,29,20,1,-1,2,4,2,20,14,1,7,3,2,12,9,-2,4,1,0,8,5,3,3,0,0,-2,2,0,1,-1,1,-2,2,-1,0,1,-1,0,0,1,1
8,08101,"Hospitalet de Llobregat, L'",247986,527,191,336,4620,2318,2302,216,698,121,289,-493,-317,47,368,92,105,-268,-167,169,330,29,184,-225,-150,706,1123,1691,849,172,54,347,555,911,406,73,13,359,568,780,443,99,41,1602,995,607,6338,3365,2973,547,922,475,413,-434,-328,283,534,355,250,-271,-162,264,388,120,163,-163,-166,1077,1541,2280,1123,221,57,545,797,1286,610,87,19,532,744,994,513,134,38,4038,2097,1941,7937,4135,3802,946,1827,1307,701,-358,-478,429,934,764,380,-232,-214,517,893,543,321,-126,-264,1429,2098,2673,1309,308,77,705,1095,1470,701,113,32,724,1003,1203,608,195,45,4314,2192,2122,7038,3561,3477,1243,1571,1206,820,-292,-293,728,763,598,421,-151,-190,515,808,608,399,-141,-103,1604,1781,2142,1072,283,109,835,851,1116,567,132,37,769,930,1026,505,151,72,1508,966,542,6118,3320,2798,292,1157,720,416,-502,-588,88,660,513,258,-289,-288,204,497,207,158,-213,-300,917,1702,2137,969,263,100,476,868,1264,547,105,43,441,834,873,422,158,57,2731,1536,1195,6866,3604,3262,610,1525,868,520,-379,-465,262,898,510,268,-236,-205,348,627,358,252,-143,-260,1211,1880,2293,1046,290,104,598,994,1291,562,106,38,613,886,1002,484,184,66,3531,1923,1608,8040,4167,3873,729,2143,1143,414,-490,-491,360,1094,691,143,-223,-191,369,1049,452,271,-267,-300,1470,2445,2518,1206,296,68,743,1253,1375,625,128,25,727,1192,1143,581,168,43,2927,1572,1355,6506,3397,3109,1044,1758,654,179,-328,-521,530,949,370,81,-180,-250,514,809,284,98,-148,-271,1554,2118,1750,786,154,29,780,1104,958,417,66,7,774,1014,792,369,88,22,2164,1175,989,3543,1754,1789,647,1439,632,225,-282,-490,329,771,330,85,-157,-174,318,668,302,140,-125,-316,918,1340,1002,271,-1,-9,472,687,476,127,-14,0,446,653,526,144,13,-9,2047,1098,949,3290,1672,1618,731,1168,462,297,-269,-411,435,636,252,63,-162,-159,296,532,210,234,-107,-252,791,1139,864,385,47,0,435,592,434,157,13,2,356,547,430,228,34,-2,585,-249,834,2643,1054,1589,541,602,100,-159,-240,-303,255,223,-248,-228,-143,-135,286,379,348,69,-97,-168,716,806,765,246,30,21,366,395,260,17,-21,3,350,411,505,229,51,18,-811,-623,-188,363,37,326,112,542,-608,-430,-180,-342,89,255,-505,-317,-84,-132,23,287,-103,-113,-96,-210,215,603,-149,-244,-95,-23,151,304,-170,-206,-75,-6,64,299,21,-38,-20,-17,209,262,-53,1078,427,651,120,708,113,-199,-273,-364,58,343,161,-117,-143,-90,62,365,-48,-82,-130,-274,274,678,305,-155,-71,-33,120,320,178,-155,-58,-16,154,358,127,0,-13,-17,-785,-514,-271,-850,-572,-278,143,301,-424,-354,-240,-301,90,173,-267,-308,-159,-93,53,128,-157,-46,-81,-208,11,210,-444,-496,-156,-31,8,102,-247,-357,-100,-7,3,108,-197,-139,-56,-24,-423,-574,151,-1087,-979,-108,179,639,-310,-567,-83,-378,5,271,-300,-373,-76,-148,174,368,-10,-194,-7,-230,56,428,-558,-820,-221,-31,31,161,-444,-590,-146,-21,25,267,-114,-230,-75,-10,3708,1852,1856,2871,1427,1444,774,1240,1327,497,164,-375,443,531,721,158,85,-117,331,709,606,339,79,-258,572,942,832,351,115,16,303,442,443,172,46,2,269,500,389,179,69,14,3322,1441,1881,2748,1130,1618,461,1412,1130,411,209,-384,258,623,591,44,17,-137,203,789,539,367,192,-247,604,1083,924,-1,56,18,328,480,442,-131,-28,6,276,603,482,130,84,12,4760,2241,2519,5187,2357,2830,740,1809,1762,671,78,-382,377,874,865,249,-37,-112,363,935,897,422,115,-270,904,1698,1606,629,172,96,460,816,783,195,24,41,444,882,823,434,148,55
8,08162,"Hostalets de Pierola, Els",1212,111,61,50,39,30,9,27,11,44,22,8,0,10,6,25,16,7,-2,17,5,19,6,1,2,8,6,16,8,1,0,4,4,13,8,1,0,4,2,3,0,0,0,112,64,48,36,17,19,21,8,51,20,13,0,8,4,36,9,7,0,13,4,15,11,6,0,9,9,13,3,2,0,2,3,10,2,0,0,7,6,3,1,2,0,136,73,63,37,20,17,26,22,51,27,4,6,18,7,25,16,4,3,8,15,26,11,0,3,5,12,10,9,1,0,3,4,6,6,1,0,2,8,4,3,0,0,88,39,49,13,8,5,17,15,27,18,15,-2,4,6,12,12,9,-2,13,9,15,6,6,0,3,5,3,2,0,0,2,4,1,1,0,0,1,1,2,1,0,0,108,66,42,18,14,4,19,28,25,21,11,2,13,17,15,9,7,4,6,11,10,12,4,-2,3,4,6,3,1,0,3,4,4,1,1,0,0,0,2,2,0,0,120,52,68,23,12,11,25,15,49,16,5,6,16,6,19,7,1,2,9,9,30,9,4,4,6,9,5,2,1,0,4,5,1,2,0,0,2,4,4,0,1,0,170,95,75,22,13,9,27,35,59,35,8,3,12,17,39,21,4,0,15,18,20,14,4,3,2,4,9,5,1,1,2,3,6,2,-1,1,0,1,3,3,2,0,162,85,77,32,17,15,29,29,60,31,7,6,12,15,31,18,7,3,17,14,29,13,0,3,6,11,10,4,1,0,3,6,4,3,1,0,3,5,6,1,0,0,148,60,88,36,18,18,38,23,49,36,-3,1,17,6,18,24,-7,-2,21,17,31,12,4,3,9,9,10,9,-1,0,3,4,7,5,-1,0,6,5,3,4,0,0,112,55,57,21,9,12,27,21,44,15,6,2,13,11,16,14,5,-1,14,10,28,1,1,3,11,3,3,2,3,0,6,1,-1,1,2,0,5,2,4,1,1,0,40,23,17,-1,-8,7,-5,17,6,6,4,11,-1,6,6,6,0,6,-4,11,0,0,4,5,-1,0,-1,-2,2,1,-2,-3,-2,-2,1,0,1,3,1,0,1,1,30,5,25,20,12,8,1,6,8,3,9,2,3,-1,-2,-2,9,-3,-2,7,10,5,0,5,3,7,5,2,2,0,3,4,2,1,1,0,0,3,3,1,1,0,26,10,16,6,4,2,8,5,17,-11,5,1,1,0,9,-4,1,2,7,5,8,-7,4,-1,4,2,1,0,0,-1,4,1,-1,0,1,-1,0,1,2,0,-1,0,17,8,9,8,5,3,1,5,-15,16,3,7,-1,0,-10,12,5,3,2,5,-5,4,-2,4,0,2,3,1,0,2,0,0,3,1,0,1,0,2,0,0,0,1,-78,-36,-42,-51,-32,-19,-18,-5,-25,-25,-9,4,-5,-1,-17,-13,-1,3,-13,-4,-8,-12,-8,1,-4,-6,-16,-11,-12,-2,-3,-2,-12,-8,-7,0,-1,-4,-4,-3,-5,-2,-3,3,-6,-12,-9,-3,-3,9,-16,-4,-4,14,-3,8,0,-1,-6,4,0,1,-16,-3,2,10,-5,1,-2,-6,-1,1,-4,0,-1,-4,-1,1,-1,1,-1,-2,0,0,3,-6,9,20,8,12,-10,-2,12,-2,4,2,-12,1,9,-5,2,0,2,-3,3,3,2,2,3,0,4,10,3,-1,2,0,2,4,1,-1,1,0,2,6,2,0,-1,-16,15,-9,-8,-1,9,-12,-12,3,4,8,-3,-5,-6,-4,2,2,12,-7,-6,7,2,6,0,0,-5,-3,-1,0,-1,-1,-4,-1,-1,0,1,1,-1,-2,0,0
8,08102,Igualada,32526,142,69,73,25,15,10,48,13,50,26,-4,17,14,18,17,9,-1,14,34,-5,33,17,-3,3,11,1,1,8,0,4,6,1,0,5,0,3,5,0,1,3,0,1,14,11,3,13,7,6,10,25,-57,25,11,-2,2,26,-40,19,5,-4,8,-1,-17,6,6,2,0,2,3,4,2,1,0,0,0,4,2,0,0,2,3,0,0,1,451,316,135,340,207,133,100,77,203,79,15,-29,64,51,142,59,13,-19,36,26,61,20,2,-10,65,84,124,47,13,6,37,55,81,28,5,1,28,29,43,19,8,5,528,282,246,299,165,134,77,71,182,96,55,42,25,44,116,58,22,9,52,27,66,38,33,33,59,61,93,47,27,7,31,34,64,23,9,3,28,27,29,24,18,4,752,401,351,477,252,225,163,178,221,112,30,41,83,74,153,54,11,23,80,104,68,58,19,18,103,116,167,55,14,13,56,56,96,24,10,5,47,60,71,31,4,8,740,389,351,673,346,327,112,132,221,164,51,49,37,83,147,74,23,16,75,49,74,90,28,33,153,159,192,115,32,12,70,82,116,57,11,5,83,77,76,58,21,7,454,269,185,630,353,277,70,115,149,106,12,4,36,67,100,79,-8,1,34,48,49,27,20,3,87,163,227,102,31,13,45,84,150,60,9,3,42,79,77,42,22,10,894,519,375,560,298,262,162,158,349,145,60,6,87,110,207,69,32,2,75,48,142,76,28,4,104,144,194,82,27,5,59,84,97,42,10,3,45,60,97,40,17,2,525,172,353,419,155,264,216,120,141,26,-6,4,102,55,34,-14,-21,9,114,65,107,40,15,-5,153,133,97,32,2,-9,70,64,21,8,-8,-3,83,69,76,24,10,-6,161,-22,183,158,23,135,77,41,-12,27,-24,46,28,5,-57,5,-22,20,49,36,45,22,-2,26,48,62,27,7,3,5,14,13,-4,0,-2,1,34,49,31,7,5,4,-118,-126,8,-35,-56,21,-5,12,-122,-43,12,22,-4,-8,-79,-41,2,10,-1,20,-43,-2,10,12,19,28,-39,-38,-5,-5,12,3,-34,-30,-6,-2,7,25,-5,-8,1,-3,54,-41,95,17,-26,43,35,14,-61,-3,12,59,13,-10,-29,-23,-3,15,22,24,-32,20,15,44,12,16,0,-17,-2,4,4,4,-8,-27,-2,1,8,12,8,10,0,3,-228,-177,-51,-179,-144,-35,-92,32,-155,-52,-7,43,-66,21,-82,-50,-15,20,-26,11,-73,-2,8,23,-32,11,-64,-72,-21,-4,-17,-2,-42,-60,-22,-3,-15,13,-22,-12,1,-1,-73,-72,-1,-147,-107,-40,6,-36,-25,-66,-22,62,3,-21,-20,-55,-13,34,3,-15,-5,-11,-9,28,-19,-8,-40,-65,-15,-3,-13,-5,-20,-60,-9,-1,-6,-3,-20,-5,-6,-2,91,19,72,100,45,55,46,3,3,-9,2,29,26,0,4,-20,-6,8,20,3,-1,11,8,21,28,41,21,-17,7,11,15,16,22,-19,5,1,13,25,-1,2,2,10,344,156,188,139,59,80,92,54,28,94,32,30,48,25,18,30,17,9,44,29,10,64,15,21,29,42,28,22,5,3,12,17,14,9,1,-1,17,25,14,13,4,4,525,310,215,223,134,89,76,105,123,101,75,35,67,59,82,46,34,13,9,46,41,55,41,22,6,68,91,26,27,0,9,43,57,11,10,1,-3,25,34,15,17,-1,194,109,85,86,41,45,42,48,-1,49,-2,50,16,23,-3,23,17,23,26,25,2,26,-19,27,29,44,25,-23,3,5,15,15,21,-19,8,-2,14,29,4,-4,-5,7
8,08104,"Llacuna, La",833,1,8,-7,9,5,4,-8,0,2,3,3,1,-2,-1,6,2,2,1,-6,1,-4,1,1,0,3,1,3,0,2,0,1,0,3,0,1,0,2,1,0,0,1,0,-4,0,-4,3,1,2,-3,5,-5,1,-1,-1,0,0,-2,1,1,0,-3,5,-3,0,-2,-1,0,2,1,0,0,0,0,1,0,0,0,0,0,1,1,0,0,0,32,24,8,12,9,3,7,2,8,5,7,3,3,3,8,3,6,1,4,-1,0,2,1,2,2,1,4,3,2,0,1,1,3,2,2,0,1,0,1,1,0,0,7,0,7,13,7,6,9,3,-7,5,-3,0,5,-2,-3,2,-2,0,4,5,-4,3,-1,0,8,4,0,1,0,0,5,1,1,0,0,0,3,3,-1,1,0,0,3,2,1,12,7,5,-6,4,-1,7,2,-2,-4,0,3,5,0,-1,-2,4,-4,2,2,-1,1,5,6,0,0,0,1,2,4,0,0,0,0,3,2,0,0,0,-7,3,-10,14,9,5,-5,5,-6,-4,3,0,-4,2,-1,0,5,1,-1,3,-5,-4,-2,-1,1,7,3,1,2,0,1,4,2,1,1,0,0,3,1,0,1,0,18,14,4,5,3,2,2,7,5,-5,6,1,6,4,3,-4,3,2,-4,3,2,-1,3,-1,1,3,1,0,0,0,0,2,1,0,0,0,1,1,0,0,0,0,31,15,16,21,11,10,7,0,11,0,7,2,1,2,4,1,1,3,6,-2,7,-1,6,-1,5,5,6,2,1,2,2,3,2,2,0,2,3,2,4,0,1,0,18,11,7,8,7,1,-1,5,-1,6,4,7,1,7,0,0,1,3,-2,-2,-1,6,3,4,1,4,2,1,0,0,1,3,2,1,0,0,0,1,0,0,0,0,13,12,1,15,10,5,-1,8,-2,2,3,1,3,5,-1,2,1,0,-4,3,-1,0,2,1,3,4,3,4,0,0,2,2,2,3,0,0,1,2,1,1,0,0,6,5,1,8,7,1,-3,-2,7,10,-3,-3,-4,-1,5,7,-1,-1,1,-1,2,3,-2,-2,0,1,2,5,0,0,0,1,2,4,0,0,0,0,0,1,0,0,2,0,2,15,7,8,4,0,-4,1,1,0,1,-1,2,-2,1,-1,3,1,-6,3,0,1,3,4,4,3,1,0,2,1,2,1,1,0,1,3,2,2,0,0,16,9,7,4,2,2,2,5,0,5,1,2,7,-1,1,1,0,0,-5,6,-1,4,1,2,0,2,0,2,0,0,0,1,0,1,0,0,0,1,0,1,0,0,-17,-5,-12,4,3,1,-6,0,-8,-6,0,3,-2,1,-4,-3,3,0,-4,-1,-4,-3,-3,3,1,3,0,0,0,0,1,1,1,0,0,0,0,2,-1,0,0,0,-10,-7,-3,1,0,1,-9,-1,-3,0,1,1,-6,0,-1,0,1,-1,-3,-1,-2,0,0,2,0,0,-1,1,0,0,0,0,-2,1,0,0,0,0,1,0,0,0,3,4,-1,2,1,1,-4,1,-3,11,-2,0,-4,1,1,9,-3,0,0,0,-4,2,1,0,0,0,1,0,0,0,-1,0,1,1,0,0,1,0,0,-1,0,0,4,5,-1,5,3,2,-4,3,6,4,-2,-2,-3,2,5,3,0,-2,-1,1,1,1,-2,0,-1,2,3,1,0,0,-1,1,1,2,0,0,0,1,2,-1,0,0,2,-1,3,7,4,3,6,2,-1,2,-2,-5,1,0,-3,0,1,0,5,2,2,2,-3,-5,3,1,3,-1,-2,2,2,0,1,0,-1,1,1,1,2,-1,-1,1
8,08105,"Llagosta, La",11770,119,110,9,181,132,49,36,36,24,21,1,4,22,42,31,14,-3,2,14,-6,-7,7,4,2,22,56,64,34,4,0,13,39,52,24,3,0,9,17,12,10,1,0,171,97,74,162,103,59,3,68,53,29,9,6,-5,39,48,11,0,2,8,29,5,18,9,4,19,39,67,28,8,0,11,26,43,17,5,0,8,13,24,11,3,0,291,132,159,288,160,128,72,92,79,35,-2,16,32,38,49,18,-2,1,40,54,30,17,0,15,71,82,73,48,4,7,36,43,50,27,2,1,35,39,23,21,2,6,247,113,134,244,126,118,61,65,87,22,9,-1,17,43,39,15,4,-8,44,22,48,7,5,7,53,54,73,40,14,7,28,33,39,19,5,1,25,21,34,21,9,6,379,174,205,199,113,86,44,119,151,39,-1,17,15,58,76,25,-4,2,29,61,75,14,3,15,24,65,74,19,12,2,10,37,50,10,3,1,14,28,24,9,9,1,109,108,1,246,141,105,31,44,12,32,-10,-7,29,30,27,22,-11,3,2,14,-15,10,1,-10,60,58,79,36,8,4,40,30,47,20,1,2,20,28,32,16,7,2,-64,-28,-36,185,98,87,-11,54,-56,-16,-27,1,-1,26,-27,-8,-11,-2,-10,28,-29,-8,-16,3,30,67,45,33,7,3,20,34,27,15,2,0,10,33,18,18,5,3,31,34,-3,161,92,69,-9,65,18,-6,-12,-22,-3,47,2,3,-5,-11,-6,18,16,-9,-7,-11,29,73,38,21,0,-3,19,42,19,12,0,-2,10,31,19,9,0,-1,113,62,51,184,115,69,44,51,21,-11,4,7,25,28,1,-1,4,9,19,23,20,-10,0,-2,49,48,57,20,3,5,32,32,31,13,2,3,17,16,26,7,1,2,-126,-96,-30,-30,-42,12,8,-36,3,-58,-20,-29,3,-33,1,-48,-16,-12,5,-3,2,-10,-4,-17,11,-7,-6,-17,-7,-6,5,-15,-12,-13,-6,-3,6,8,6,-4,-1,-3,-51,-32,-19,91,47,44,7,16,-37,-25,3,-20,-5,17,-18,-14,-7,-4,12,-1,-19,-11,10,-16,14,25,34,7,6,4,7,16,16,5,1,1,7,9,18,2,5,3,-103,-77,-26,54,26,28,-2,16,-60,-32,-19,-3,-2,-1,-41,-21,-9,-4,0,17,-19,-11,-10,1,15,17,19,-1,1,3,14,7,6,-2,1,0,1,10,13,1,0,3,-145,-83,-62,-52,-41,-11,-26,-18,-46,-48,-5,-7,-7,-6,-41,-21,-9,-1,-19,-12,-5,-27,4,-6,-2,2,-31,-14,-9,1,-2,0,-26,-7,-8,1,0,2,-5,-7,-1,0,-1,-5,4,-20,-10,-10,7,15,26,-11,-21,-17,1,0,32,-18,-13,-4,6,15,-6,7,-8,-13,3,1,-14,-8,-4,2,5,-3,-8,-3,-2,1,-2,4,-6,-5,-2,1,-134,-39,-95,-59,-44,-15,-47,3,-48,-12,-19,-15,-16,-2,-16,8,-7,-9,-31,5,-32,-20,-12,-6,-19,4,-14,-20,-9,-1,-13,-6,-9,-11,-2,-2,-6,10,-5,-9,-7,1,-10,1,-11,77,54,23,-13,39,-9,-8,-9,-11,0,19,-1,-11,-5,-4,-13,20,-8,3,-4,-7,13,17,25,12,7,2,7,10,20,7,8,1,6,7,5,5,-1,1,77,42,35,117,58,59,7,42,18,6,9,-15,-11,27,17,8,0,-6,18,15,1,-2,9,-9,25,40,17,17,9,7,9,23,11,9,1,4,16,17,6,8,8,3,47,32,15,88,49,39,3,35,49,-24,15,-33,1,7,40,-19,12,-11,2,28,9,-5,3,-22,17,33,38,-7,5,2,15,16,26,-10,-1,3,2,17,12,3,6,-1
8,08107,Lliçà d'Amunt,8995,538,278,260,27,17,10,103,81,131,141,54,21,53,52,63,71,32,4,50,29,68,70,22,17,1,9,9,5,3,0,1,2,9,4,1,0,0,7,0,1,2,0,512,258,254,37,18,19,96,45,148,93,75,52,48,18,74,43,47,25,48,27,74,50,28,27,12,8,9,6,2,0,5,4,5,3,1,0,7,4,4,3,1,0,545,287,258,54,27,27,113,56,160,114,44,41,71,18,84,60,28,19,42,38,76,54,16,22,6,20,17,8,2,1,4,5,13,4,1,0,2,15,4,4,1,1,528,233,295,64,33,31,112,42,200,75,51,39,47,13,92,38,28,14,65,29,108,37,23,25,18,17,22,2,3,2,8,7,11,4,3,0,10,10,11,-2,0,2,323,184,139,63,34,29,76,-4,118,65,16,38,51,-2,61,43,12,13,25,-2,57,22,4,25,24,12,14,12,1,0,14,8,7,5,0,0,10,4,7,7,1,0,415,175,240,54,24,30,97,30,125,104,27,23,36,12,49,53,13,12,61,18,76,51,14,11,10,15,14,9,3,0,2,7,9,5,1,0,8,8,5,4,2,0,454,214,240,71,38,33,125,11,167,100,19,19,67,-6,75,59,10,3,58,17,92,41,9,16,12,17,20,18,2,0,9,11,8,10,0,0,3,6,12,8,2,0,219,131,88,70,34,36,44,25,93,25,8,16,24,11,56,19,0,16,20,14,37,6,8,0,14,17,14,13,9,1,6,10,4,8,4,1,8,7,10,5,5,0,221,126,95,46,32,14,49,7,81,22,30,29,34,2,51,9,23,4,15,5,30,13,7,25,4,14,10,15,1,0,5,7,3,14,2,-1,-1,7,7,1,-1,1,138,70,68,6,-3,9,37,18,29,16,7,31,11,10,22,9,4,14,26,8,7,7,3,17,6,11,-1,-5,-4,-1,2,4,0,-6,-3,0,4,7,-1,1,-1,-1,58,19,39,-29,-27,-2,10,-15,32,-7,11,21,9,-4,6,-6,6,5,1,-11,26,-1,5,16,7,-9,-2,-17,-5,-1,5,-4,-6,-17,-4,0,2,-5,4,0,-1,-1,100,65,35,-36,-26,-10,17,-19,66,26,0,6,24,-3,17,20,-2,6,-7,-16,49,6,2,0,-9,4,-22,-10,0,1,-2,3,-15,-11,-2,1,-7,1,-7,1,2,0,63,66,-3,4,-1,5,12,1,17,8,6,16,13,-1,29,-2,10,12,-1,2,-12,10,-4,4,4,0,3,1,-4,0,1,3,-2,0,-3,0,3,-3,5,1,-1,0,-29,-15,-14,-18,-10,-8,-7,-11,17,-37,3,1,-6,0,22,-28,-8,-1,-1,-11,-5,-9,11,2,-4,-4,-9,-1,0,-1,0,-4,-3,-1,-3,0,-4,0,-6,0,3,-1,48,48,0,-28,-12,-16,27,-6,26,5,6,-2,29,-13,28,2,7,0,-2,7,-2,3,-1,-2,-10,-5,-7,-7,2,-1,-6,-5,-2,-1,3,-1,-4,0,-5,-6,-1,0,26,83,-57,-4,8,-12,-11,-9,55,2,-19,2,2,15,43,20,-6,5,-13,-24,12,-18,-13,-3,-2,7,-4,-7,-2,3,-1,5,5,-5,1,2,-1,2,-9,-2,-3,1,144,45,99,36,18,18,38,-23,51,51,9,18,9,-25,19,34,8,-1,29,2,32,17,1,19,10,4,10,8,3,1,7,1,6,3,2,0,3,3,4,5,1,1,188,118,70,25,14,11,39,19,96,35,-17,6,38,11,39,24,-4,3,1,8,57,11,-13,3,4,8,8,3,3,-3,6,5,0,2,1,-1,-2,3,8,1,2,-2
8,08108,Lliçà de Vall,4954,141,61,80,5,4,1,34,-9,50,27,21,16,22,-16,16,17,11,7,12,7,34,10,10,9,1,1,2,1,0,0,1,0,2,1,0,0,0,1,0,0,0,0,117,76,41,10,4,6,31,1,37,28,8,12,20,9,18,20,2,9,11,-8,19,8,6,3,1,2,3,2,1,0,0,1,2,1,0,0,1,1,1,1,1,0,107,57,50,21,11,10,33,-8,45,22,-3,10,27,-10,23,11,-3,4,6,2,22,11,0,6,6,1,6,7,1,0,3,-1,3,5,1,0,3,2,3,2,0,0,150,92,58,9,8,1,44,-13,58,37,18,3,23,-4,37,21,12,0,21,-9,21,16,6,3,1,4,1,2,1,0,1,2,2,2,1,0,0,2,-1,0,0,0,77,26,51,21,13,8,19,-6,27,12,13,7,13,-5,3,6,3,4,6,-1,24,6,10,3,6,2,9,3,0,0,3,0,6,3,0,0,3,2,3,0,0,0,135,97,38,16,8,8,52,-2,39,31,8,0,38,3,26,17,5,1,14,-5,13,14,3,-1,3,4,5,4,0,0,2,0,4,2,0,0,1,4,1,2,0,0,48,2,46,7,-1,8,18,-18,27,13,4,6,2,-8,2,5,0,3,16,-10,25,8,4,3,2,4,3,-5,2,0,0,1,2,-5,1,0,2,3,1,0,1,0,39,28,11,11,4,7,26,-18,1,17,0,13,24,-11,2,9,1,4,2,-7,-1,8,-1,9,5,3,4,0,-1,0,3,-1,2,1,-1,0,2,4,2,-1,0,0,89,44,45,3,-1,4,38,-7,23,7,12,10,24,-2,10,-4,7,4,14,-5,13,11,5,6,1,-1,-1,2,1,1,0,-2,-1,1,0,1,1,1,0,1,1,0,44,14,30,5,-4,9,16,-4,23,3,2,2,10,-2,3,3,0,-1,6,-2,20,0,2,3,1,2,4,-2,-1,1,0,-1,0,-2,-1,0,1,3,4,0,0,1,29,12,17,5,0,5,16,-11,3,-3,7,15,9,-4,-6,3,3,7,7,-7,9,-6,4,8,0,3,-1,0,1,2,-1,1,1,-1,0,0,1,2,-2,1,1,2,-27,9,-36,-11,-1,-10,9,-19,0,-9,-5,-9,9,-8,3,-5,3,0,0,-11,-3,-4,-8,-9,3,1,-7,-5,0,-3,2,1,-3,-1,1,-1,1,0,-4,-4,-1,-2,28,6,22,-4,-8,4,10,-16,32,-1,-6,0,9,-15,14,-1,-6,-1,1,-1,18,0,0,1,2,5,-10,0,-1,0,3,0,-7,-2,-2,0,-1,5,-3,2,1,0,-65,-25,-40,-3,0,-3,-10,-12,3,-43,-10,9,4,-11,-2,-23,1,6,-14,-1,5,-20,-11,3,-3,-1,1,-4,4,0,-1,0,-1,-1,3,0,-2,-1,2,-3,1,0,2,23,-21,2,3,-1,18,-10,-28,4,0,16,18,-1,-14,9,0,8,0,-9,-14,-5,0,8,4,1,-3,1,-1,0,3,3,-2,0,-1,0,1,-2,-1,1,0,0,9,5,4,-12,-3,-9,23,-18,7,-6,-4,8,19,-13,-2,3,-2,-1,4,-5,9,-9,-2,9,0,-9,-5,3,-1,0,1,-4,-4,5,-1,0,-1,-5,-1,-2,0,0,-2,10,-12,-9,-9,0,8,-26,6,12,-3,-1,14,-9,3,9,-1,-5,-6,-17,3,3,-2,4,3,-8,-2,-4,1,1,1,-6,-1,-4,1,0,2,-2,-1,0,0,1,87,56,31,15,9,6,55,5,31,26,-9,-19,37,1,16,14,-6,-5,18,4,15,12,-3,-14,7,3,1,2,3,-1,4,3,2,-1,1,0,3,0,-1,3,2,-1
8,08106,Llinars del Vallès,6710,239,122,117,59,32,27,76,-2,107,28,18,4,37,5,50,14,12,1,39,-7,57,14,6,3,15,4,17,17,2,2,7,3,10,11,1,0,8,1,7,6,1,2,165,77,88,84,47,37,36,10,68,28,13,7,23,-1,34,13,6,2,13,11,34,15,7,5,26,15,24,15,2,1,13,9,13,11,1,0,13,6,11,4,1,1,254,140,114,146,79,67,48,20,104,55,18,7,20,12,50,37,15,1,28,8,54,18,3,6,25,35,50,29,5,1,10,21,25,20,3,0,15,14,25,9,2,1,149,74,75,113,55,58,19,35,38,9,35,9,19,16,10,6,15,3,0,19,28,3,20,6,27,29,19,24,11,2,13,12,11,14,3,1,14,17,8,10,8,1,236,99,137,71,21,50,20,28,86,31,32,37,16,12,43,3,14,8,4,16,43,28,18,29,18,17,20,10,2,3,6,5,6,2,1,0,12,12,14,8,1,3,224,133,91,55,34,21,44,35,47,59,12,22,25,23,32,27,11,8,19,12,15,32,1,14,20,18,7,4,3,0,15,12,3,-3,4,0,5,6,4,7,-1,0,143,61,82,53,21,32,-8,37,38,19,19,37,-8,9,24,16,5,15,0,28,14,3,14,22,7,23,10,1,10,2,1,7,7,4,1,1,6,16,3,-3,9,1,221,121,100,78,39,39,62,27,71,39,6,11,42,5,36,27,7,5,20,22,35,12,-1,6,36,15,14,14,-3,-1,21,6,7,8,-3,0,15,9,7,6,0,-1,183,70,113,19,-7,26,48,28,38,46,12,9,22,8,14,18,6,1,26,20,24,28,6,8,11,9,2,-3,-3,2,0,5,-5,-7,-2,2,11,4,7,4,-1,0,124,34,90,15,7,8,7,25,43,15,23,19,-8,3,18,-4,20,10,15,22,25,19,3,9,5,6,8,-1,-2,-1,4,2,1,-1,2,-1,1,4,7,0,-4,0,90,51,39,-7,-12,5,20,35,10,21,-22,10,15,12,20,11,-13,-3,5,23,-10,10,-9,13,4,14,-14,-4,-4,-6,3,4,-11,-2,-4,-3,1,10,-3,-2,0,-3,133,42,91,16,2,14,20,2,27,26,6,47,-4,0,17,9,2,17,24,2,10,17,4,30,10,-3,8,1,-1,-1,6,-2,1,-2,-2,0,4,-1,7,3,1,-1,98,56,42,-20,-5,-15,32,6,11,7,25,22,19,12,-6,11,17,3,13,-6,17,-4,8,19,-1,-4,-5,-10,-5,4,3,-2,-5,-1,-3,2,-4,-2,0,-9,-2,2,62,36,26,-39,-19,-20,13,12,15,10,4,7,12,10,15,8,-4,-5,1,2,0,2,8,12,-9,-1,-16,-10,-3,-4,-4,1,-8,-7,-3,-1,-5,-2,-8,-3,0,-3,57,13,44,-27,-17,-10,13,-11,2,10,9,34,7,0,10,-12,-2,9,6,-11,-8,22,11,25,-3,1,-13,-13,-1,0,-5,0,-3,-7,-3,-1,2,1,-10,-6,2,1,110,60,50,25,14,11,27,1,18,16,6,41,18,3,9,9,0,22,9,-2,9,7,6,19,4,9,10,3,-4,2,2,5,4,2,0,1,2,4,6,1,-4,1,79,39,40,35,17,18,5,-4,22,30,3,22,-7,-3,16,24,-4,10,12,-1,6,6,7,12,8,8,5,12,-1,2,4,3,1,8,-2,2,4,5,4,4,1,0,117,55,62,29,13,16,30,19,9,19,18,18,14,11,4,12,5,8,16,8,5,7,13,10,6,2,15,1,0,4,1,3,8,-1,0,2,5,-1,7,2,0,2
8,08110,Malgrat de Mar,13277,423,218,205,16,6,10,64,59,102,77,61,54,32,35,68,32,27,20,32,24,34,45,34,34,3,4,2,3,3,1,0,3,1,1,0,1,3,1,1,2,3,0,273,148,125,19,10,9,53,27,25,59,68,39,36,22,16,28,33,12,17,5,9,31,35,27,12,1,2,4,0,0,7,1,1,1,0,0,5,0,1,3,0,0,613,323,290,253,148,105,90,132,135,93,102,59,47,65,85,49,55,21,43,67,50,44,47,38,40,76,80,34,14,8,18,45,53,21,8,3,22,31,27,13,6,5,708,361,347,248,128,120,89,152,152,131,121,61,49,79,84,66,64,15,40,73,68,65,57,46,34,89,72,38,13,0,16,57,36,15,4,-1,18,32,36,23,9,1,598,338,260,228,134,94,77,92,139,130,83,79,43,70,75,80,47,28,34,22,64,50,36,51,22,56,78,46,16,6,10,32,50,30,9,1,12,24,28,16,7,5,609,313,296,268,159,109,57,105,173,91,107,82,28,72,97,51,39,29,29,33,76,40,68,53,34,80,76,42,22,8,14,52,49,29,12,2,20,28,27,13,10,6,519,267,252,262,153,109,98,29,156,107,69,58,61,15,100,52,25,14,37,14,56,55,44,44,39,63,76,48,25,10,23,32,55,28,9,6,16,31,21,20,16,4,407,141,266,197,92,105,63,91,69,94,28,49,23,28,28,35,6,10,40,63,41,59,22,39,35,60,45,31,23,1,22,21,21,16,9,1,13,39,24,15,14,0,159,38,121,114,42,72,28,31,17,20,18,50,4,11,-8,5,9,17,24,20,25,15,9,33,27,40,15,14,7,11,16,18,-2,0,5,5,11,22,17,14,2,6,133,83,50,50,39,11,3,82,18,-3,10,25,-1,49,26,-11,8,13,4,33,-8,8,2,12,8,38,12,2,-3,-7,9,22,7,-1,4,-2,-1,16,5,3,-7,-5,-167,-71,-96,-115,-60,-55,-25,-9,-61,-41,-28,7,-5,2,-38,-21,-3,1,-20,-11,-23,-20,-25,6,-17,15,-50,-27,-25,-11,-12,11,-26,-15,-12,-6,-5,4,-24,-12,-13,-5,69,39,30,53,28,25,18,7,18,6,2,11,16,-4,12,-1,13,-5,2,11,6,7,-11,16,6,22,23,1,-3,2,3,9,15,0,-1,1,3,13,8,1,-2,1,-48,1,-49,-12,1,-13,-16,12,-25,4,-11,-16,-2,19,-1,0,1,-18,-14,-7,-24,4,-12,2,6,-3,-3,4,-14,-4,6,0,2,2,-8,-2,0,-3,-5,2,-6,-2,37,-4,41,-14,-15,1,6,3,30,-10,-12,14,-3,-9,23,-7,-8,-2,9,12,7,-3,-4,16,-2,11,2,-24,-5,1,-2,6,-1,-17,-4,1,0,5,3,-7,-1,0,-28,-50,22,18,-5,23,9,30,-40,-39,-17,18,-1,21,-39,-24,-13,-2,10,9,-1,-15,-4,20,12,22,-16,-5,1,2,6,9,-12,-6,-5,2,6,13,-4,1,6,0,2,-35,37,3,-3,6,11,4,-4,-35,-9,33,2,-13,0,-33,-9,18,9,17,-4,-2,0,15,7,10,-3,-7,-5,-2,6,4,-7,-7,1,-1,1,6,4,0,-6,-1,144,99,45,67,42,25,37,15,46,3,22,17,40,28,25,-4,1,9,-3,-13,21,7,21,8,17,34,21,-11,0,3,15,19,16,-10,-2,4,2,15,5,-1,2,-1,152,72,80,85,42,43,16,30,13,46,9,31,0,14,0,40,3,12,16,16,13,6,6,19,7,33,25,-3,17,0,3,16,19,-1,4,-1,4,17,6,-2,13,1
8,08112,Manlleu,17360,284,253,31,334,267,67,10,117,103,32,-11,27,10,105,108,20,-7,12,0,12,-5,12,-4,15,33,106,128,46,9,9,17,89,115,34,5,5,16,17,13,12,4,4,260,168,92,395,256,139,62,74,79,22,12,5,32,61,47,16,10,-3,30,13,32,6,2,8,80,110,125,58,10,9,46,74,88,35,8,3,34,36,37,23,2,6,231,155,76,360,199,161,29,61,64,51,8,21,29,43,46,30,-1,11,0,18,18,21,9,10,78,91,105,52,23,9,44,52,66,25,9,3,34,39,39,27,14,6,305,164,141,315,171,144,71,96,58,26,23,22,37,31,46,23,9,12,34,65,12,3,14,10,53,95,93,30,27,14,30,42,59,21,10,8,23,53,34,9,17,6,571,313,258,458,254,204,148,121,145,92,15,35,75,59,96,62,6,12,73,62,49,30,9,23,99,111,143,65,21,14,52,59,89,40,9,4,47,52,54,25,12,10,380,222,158,384,207,177,124,82,99,72,-8,6,70,39,79,38,-7,-1,54,43,20,34,-1,7,97,98,115,55,12,5,52,41,73,32,6,1,45,57,42,23,6,4,320,192,128,381,207,174,37,84,114,41,17,24,5,42,109,19,7,9,32,42,5,22,10,15,76,84,110,78,16,14,35,43,70,44,8,6,41,41,40,34,8,8,302,183,119,417,234,183,35,92,125,34,11,4,12,51,66,35,17,1,23,41,59,-1,-6,3,78,102,140,56,27,7,35,50,89,35,18,2,43,52,51,21,9,5,-4,-43,39,185,65,120,6,27,-9,-21,-20,10,18,-3,-18,-28,-19,5,-12,30,9,7,-1,5,66,74,44,17,-10,-9,45,33,8,-5,-8,-9,21,41,36,22,-2,0,-272,-181,-91,-41,-70,29,-28,1,-113,-73,-43,-14,-3,-4,-76,-71,-22,-5,-25,5,-37,-2,-21,-9,16,27,-20,-39,-16,-13,11,4,-28,-42,-11,-4,5,23,8,3,-5,-9,-114,-127,13,4,-52,56,18,19,-126,-44,3,8,-5,-4,-84,-41,10,-6,23,23,-42,-3,-7,14,16,27,-23,-25,3,6,-3,11,-25,-34,1,-2,19,16,2,9,2,8,-52,-66,14,-19,-39,20,13,-7,-27,-51,4,-1,-3,2,-26,-47,-2,5,16,-9,-1,-4,6,-6,0,15,-20,-27,4,2,0,10,-23,-24,-5,3,0,5,3,-3,9,-1,-62,-37,-25,-12,-13,1,-42,5,-27,-3,-11,15,-22,9,-22,-11,-6,11,-20,-4,-5,8,-5,4,-24,10,-1,-2,-1,4,-10,8,-5,-7,-3,1,-14,2,4,5,2,3,-149,-90,-59,-106,-69,-37,-29,-18,-68,-33,5,-2,-14,-16,-33,-27,0,3,-15,-2,-35,-6,5,-5,-37,-10,-23,-29,-9,0,-19,-9,-11,-24,-5,-1,-18,-1,-12,-5,-4,1,-45,-6,-39,-71,-30,-41,-34,-6,-6,-24,7,12,-14,-3,-5,-3,11,4,-20,-3,-1,-21,-4,8,-63,7,-11,-18,10,2,-27,4,-4,-18,11,2,-36,3,-7,0,-1,0,-108,-66,-42,-59,-42,-17,-89,18,-2,-26,-1,-15,-62,6,12,-19,-1,-5,-27,12,-14,-7,0,-10,-74,10,3,0,1,-3,-45,3,9,-9,-1,-1,-29,7,-6,9,2,-2,-56,-21,-35,25,14,11,-92,20,14,23,-9,-19,-49,16,16,9,-13,-2,-43,4,-2,14,4,-17,-82,33,61,1,4,1,-38,23,38,-12,-4,2,-44,10,23,13,8,-1,242,108,134,174,81,93,10,33,109,62,28,-3,3,23,59,36,-5,-8,7,10,50,26,33,5,-19,36,60,48,29,17,-17,27,36,23,6,5,-2,9,24,25,23,12
8,08113,Manresa,63688,457,383,74,664,476,188,29,144,271,74,-19,-38,12,109,209,70,1,-18,17,35,62,4,-20,-20,86,156,293,105,15,8,48,104,230,80,10,4,38,52,63,25,5,4,1155,732,423,1006,653,353,184,274,438,210,12,17,96,168,290,153,3,8,88,106,148,57,9,9,174,250,382,159,26,6,90,165,266,112,10,4,84,85,116,47,16,2,1334,819,515,1186,703,483,180,422,488,216,56,-21,92,246,319,152,26,-15,88,176,169,64,30,-6,203,345,406,160,50,13,99,200,268,98,26,8,104,145,138,62,24,5,1187,602,585,1023,535,488,252,276,343,244,42,26,113,136,175,138,12,21,139,140,168,106,30,5,248,232,314,153,49,14,121,111,185,83,20,6,127,121,129,70,29,8,1670,876,794,1118,593,525,299,422,574,233,116,18,133,224,344,109,51,9,166,198,230,124,65,9,229,307,312,181,60,19,124,155,182,96,22,8,105,152,130,85,38,11,1819,1008,811,1438,755,683,330,428,706,296,49,9,143,223,459,178,7,4,187,205,247,118,42,5,300,354,485,201,63,21,145,181,283,109,25,5,155,173,202,92,38,16,1410,666,744,1199,574,625,209,381,518,179,75,54,93,164,263,99,23,21,116,217,255,80,52,33,258,336,329,177,58,31,124,156,170,83,21,13,134,180,159,94,37,18,1430,759,671,1292,690,602,213,526,530,153,45,-50,120,255,329,64,24,-27,93,271,201,89,21,-23,281,425,372,173,33,-8,159,227,198,79,26,-4,122,198,174,94,7,-4,828,400,428,917,401,516,198,346,234,132,-32,-62,89,162,142,49,-26,-24,109,184,92,83,-6,-38,276,290,255,104,-11,-9,138,121,107,42,-8,-6,138,169,148,62,-3,-3,-357,-249,-108,224,7,217,-71,46,-195,-75,-55,-25,-48,19,-119,-48,-51,-5,-23,27,-76,-27,-4,-20,110,126,-1,-17,-24,9,39,45,-34,-33,-22,1,71,81,33,16,-2,8,43,-118,161,142,-40,182,43,125,-65,-61,-17,10,12,56,-72,-83,-24,-9,31,69,7,22,7,19,66,117,-27,-26,-18,11,32,42,-59,-45,-23,3,34,75,32,19,5,8,41,-41,82,86,-16,102,6,76,-9,-21,34,-49,5,7,-23,-37,14,-19,1,69,14,16,20,-30,18,47,-9,3,17,4,12,4,-21,-22,7,-1,6,43,12,25,10,5,-424,-274,-150,-186,-160,-26,-80,-2,-204,-123,7,-9,-35,-4,-140,-102,0,13,-45,2,-64,-21,7,-22,-11,-1,-53,-99,-16,-8,1,-25,-42,-86,-10,2,-12,24,-11,-13,-6,-10,-535,-329,-206,-363,-235,-128,-111,23,-182,-157,-52,-55,-53,-15,-103,-108,-49,0,-58,38,-79,-49,-3,-55,-67,5,-123,-113,-56,-13,-32,-12,-78,-74,-38,-2,-35,17,-45,-39,-18,-11,-463,-289,-174,-260,-193,-67,10,38,-210,-172,-60,-72,2,20,-134,-132,-30,-17,8,18,-76,-40,-30,-55,9,19,-127,-94,-59,-15,2,5,-78,-76,-40,-9,7,14,-49,-18,-19,-6,273,146,127,137,51,86,64,124,93,-34,58,-38,56,51,90,-56,9,-10,8,73,3,22,49,-28,52,63,43,-30,0,-3,34,26,30,-37,-7,-4,18,37,13,7,7,1,282,131,151,49,-21,70,15,168,88,-19,43,-19,33,100,13,-13,-4,7,-18,68,75,-6,47,-26,-17,95,57,-73,-23,0,5,58,15,-60,-40,-4,-22,37,42,-13,17,4,700,302,398,387,168,219,162,263,213,71,-12,-10,93,103,113,34,-46,-4,69,160,100,37,34,-6,103,174,160,-44,-35,9,60,65,100,-31,-40,4,43,109,60,-13,5,5
8,08114,Martorell,19969,501,256,245,9,3,6,59,93,190,21,85,43,23,43,114,17,44,13,36,50,76,4,41,30,2,0,6,0,1,0,1,0,1,0,1,0,1,0,5,0,0,0,290,152,138,3,2,1,-2,104,138,20,19,7,8,49,74,7,10,4,-10,55,64,13,9,3,0,2,0,0,0,1,0,2,0,0,0,0,0,0,0,0,0,1,213,149,64,-7,-1,-6,-35,81,88,8,30,43,0,36,78,4,20,8,-35,45,10,4,10,35,0,-2,-3,-3,-1,2,0,0,-1,-1,0,1,0,-2,-2,-2,-1,1,64,16,48,-4,-3,-1,-60,44,59,-34,6,38,-30,13,48,-33,-2,17,-30,31,11,-1,8,21,0,-2,0,-1,-1,0,0,-1,-1,-1,0,0,0,-1,1,0,-1,0,426,261,165,506,325,181,-48,202,223,15,-17,50,-34,112,156,28,-18,15,-14,90,67,-13,1,35,65,154,184,81,12,7,32,91,132,61,5,1,33,63,52,20,7,6,190,130,60,541,345,196,-17,153,52,5,-10,25,-7,92,52,14,-17,8,-10,61,0,-9,7,17,78,146,209,76,23,6,42,92,146,48,12,2,36,54,63,28,11,4,321,155,166,681,380,301,29,154,83,48,17,-9,24,84,52,9,4,-8,5,70,31,39,13,-1,145,150,243,125,16,-2,81,86,140,67,6,-1,64,64,103,58,10,-1,240,153,87,548,300,248,29,111,77,37,-9,-4,9,63,58,28,3,-4,20,48,19,9,-12,0,106,157,166,100,11,2,51,73,98,63,10,0,55,84,68,37,1,2,289,202,87,465,292,173,-27,120,138,68,-6,1,-17,81,89,55,-5,1,-10,39,49,13,-1,0,65,148,165,68,13,3,36,97,96,51,7,2,29,51,69,17,6,1,-28,-7,-21,92,45,47,1,42,-1,-29,-19,-8,15,16,4,-19,-11,-1,-14,26,-5,-10,-8,-7,40,75,0,-15,-9,1,34,41,-4,-17,-10,0,6,34,4,2,1,1,259,176,83,281,146,135,-8,137,62,49,22,10,10,86,37,24,16,15,-18,51,25,25,6,-5,37,98,82,43,22,1,14,60,42,25,6,2,23,38,40,18,16,-1,284,116,168,137,84,53,28,112,106,-2,23,4,-1,56,56,-7,4,1,29,56,50,5,19,3,32,46,28,7,19,1,22,32,20,5,4,-1,10,14,8,2,15,2,-127,-109,-18,7,-23,30,34,-54,-31,-66,-22,25,18,-37,-26,-43,-16,10,16,-17,-5,-23,-6,15,24,19,-15,-20,-5,6,11,8,-18,-19,-4,1,13,11,3,-1,-1,5,-125,-131,6,-65,-76,11,-33,35,-83,-92,-7,53,-18,9,-80,-54,-11,19,-15,26,-3,-38,4,34,-11,20,-42,-39,-1,4,-3,3,-48,-28,-2,-2,-8,17,6,-11,1,6,-324,-202,-122,-158,-128,-30,-45,-22,-116,-114,-39,12,-21,-20,-74,-65,-30,4,-24,-2,-42,-49,-9,8,-14,-4,-60,-45,-35,-3,-15,-8,-42,-36,-30,1,1,4,-18,-9,-5,-4,4,-18,22,43,19,24,1,33,-44,-26,20,24,2,21,-24,-32,13,9,-1,12,-20,6,7,15,-2,37,12,-22,11,7,4,22,5,-25,9,4,-6,15,7,3,2,3,-46,-35,-11,3,-2,5,-45,34,-4,-37,-32,41,-25,15,-6,-19,-10,12,-20,19,2,-18,-22,29,-28,37,18,-9,-17,1,-19,23,13,-10,-9,0,-9,14,5,1,-8,1,-183,-161,-22,-215,-155,-60,-15,24,0,-137,-87,27,4,18,11,-104,-91,-4,-19,6,-11,-33,4,31,-9,35,1,-135,-96,-12,-11,31,8,-96,-79,-10,2,4,-7,-39,-17,-2
8,08118,"Masnou, El",21076,-188,-116,-72,4,2,2,-63,-27,-70,-27,-18,27,-28,-15,-41,-24,-12,11,-35,-12,-29,-3,-6,16,0,1,1,1,1,0,0,1,1,0,0,0,0,0,0,1,1,0,-154,-93,-61,6,3,3,-67,-27,-13,-87,-2,46,-31,-24,2,-49,-4,15,-36,-3,-15,-38,2,31,0,1,4,1,0,0,0,1,1,1,0,0,0,0,3,0,0,0,-202,-139,-63,-23,-14,-9,-80,-23,-38,-49,-32,23,-52,-2,-21,-38,-21,-3,-28,-21,-17,-11,-11,26,0,-4,-14,-2,-2,-1,0,-3,-9,-1,-1,0,0,-1,-5,-1,-1,-1,-127,-82,-45,-6,-2,-4,-29,-4,-86,-48,-31,76,-3,-4,-49,-21,-22,20,-26,0,-37,-27,-9,56,0,-1,-4,1,-2,0,0,0,0,0,-2,0,0,-1,-4,1,0,0,134,37,97,190,90,100,53,-10,65,17,-43,53,12,-4,33,1,-19,17,41,-6,32,16,-24,36,26,53,72,23,7,7,10,25,36,14,3,2,16,28,36,9,4,5,220,40,180,218,113,105,44,28,98,-10,31,23,17,-2,34,-20,9,3,27,30,64,10,22,20,28,56,74,29,23,7,12,27,41,16,12,4,16,29,33,13,11,3,165,65,100,162,92,70,24,34,62,-7,-5,51,2,25,22,5,-1,13,22,9,40,-12,-4,38,27,35,64,22,2,8,13,18,36,17,1,3,14,17,28,5,1,5,119,38,81,90,30,60,0,25,50,34,-7,23,3,15,6,15,-2,8,-3,10,44,19,-5,15,13,33,35,2,7,0,9,11,10,-3,3,0,4,22,25,5,4,0,183,53,130,180,91,89,4,54,45,18,-3,68,2,25,23,-6,-8,20,2,29,22,24,5,48,35,51,50,24,8,7,14,28,27,13,3,4,21,23,23,11,5,3,178,70,108,55,27,28,17,14,77,38,-2,38,4,3,33,24,-7,13,13,11,44,14,5,25,12,18,14,0,2,6,6,2,7,2,3,3,6,16,7,-2,-1,3,-27,-45,18,-41,-35,-6,15,13,14,-42,-41,15,11,5,-11,-38,-25,8,4,8,25,-4,-16,7,5,10,-14,-15,-18,-12,3,2,-14,-12,-13,-2,2,8,0,-3,-5,-10,18,12,6,-2,-6,4,-22,19,8,4,-20,24,-5,14,1,8,-12,4,-17,5,7,-4,-8,20,1,18,-5,-10,-2,-1,2,10,-3,-13,-4,1,-1,8,-2,3,2,-2,16,-21,37,-18,-20,2,-25,-5,21,-10,-8,41,-17,-19,6,0,-1,11,-8,14,15,-10,-7,30,-1,-4,-1,-8,-6,1,-4,-8,1,-5,-5,0,3,4,-2,-3,-1,1,61,35,26,-5,-6,1,-16,8,73,-7,-20,19,-3,7,32,-1,-10,9,-13,1,41,-6,-10,10,4,5,6,-23,-5,2,4,2,0,-14,-5,2,0,3,6,-9,0,0,130,65,65,37,16,21,26,17,69,22,-24,16,8,10,39,16,-19,4,18,7,30,6,-5,12,6,10,20,-9,0,6,1,1,12,1,-5,5,5,9,8,-10,5,1,254,88,166,89,44,45,71,6,72,63,-14,56,30,-4,32,29,-8,9,41,10,40,34,-6,47,21,17,11,14,11,13,12,11,4,4,6,6,9,6,7,10,5,7,299,135,164,162,77,85,29,53,84,71,19,30,11,24,43,41,5,-1,18,29,41,30,14,31,24,33,51,21,24,5,4,11,30,10,17,2,20,22,21,11,7,3,116,54,62,120,72,48,29,4,33,20,-5,28,19,8,6,2,12,2,10,-4,27,18,-17,26,19,26,49,8,7,6,18,21,23,2,5,0,1,5,26,6,2,6
8,08119,Masquefa,4143,598,318,280,45,34,11,103,113,195,109,57,7,51,49,117,58,32,2,52,64,78,51,25,5,8,9,16,11,0,0,7,4,13,9,0,0,1,5,3,2,0,0,437,218,219,58,35,23,87,62,169,68,34,14,45,30,81,42,14,5,42,32,88,26,20,9,20,6,22,10,0,0,10,5,13,7,0,0,10,1,9,3,0,0,453,247,206,50,33,17,105,40,158,91,35,9,63,21,83,57,15,2,42,19,75,34,20,7,5,12,20,11,1,1,5,8,11,8,1,0,0,4,9,3,0,1,424,222,202,41,19,22,89,50,160,88,18,5,42,21,88,41,18,5,47,29,72,47,0,0,10,10,9,8,3,1,4,5,6,2,1,1,6,5,3,6,2,0,308,160,148,31,12,19,50,83,108,37,26,3,28,38,53,24,15,2,22,45,55,13,11,1,8,12,3,6,0,2,4,7,-2,4,-2,1,4,5,5,2,2,1,279,125,154,38,14,24,59,16,93,44,34,24,32,4,41,27,14,8,27,12,52,17,20,16,9,8,12,5,1,2,2,1,7,4,0,0,7,7,5,1,1,2,269,114,155,36,12,24,32,47,108,34,26,15,15,17,40,18,12,9,17,30,68,16,14,6,11,4,11,5,4,1,3,2,3,1,2,1,8,2,8,4,2,0,219,136,83,35,31,4,45,29,80,29,15,12,29,19,58,14,2,7,16,10,22,15,13,5,6,15,12,3,1,-2,2,11,15,3,1,-1,4,4,-3,0,0,-1,90,35,55,42,16,26,22,38,23,2,1,3,8,19,1,4,-2,5,14,19,22,-2,3,-2,12,18,3,7,0,1,4,11,-2,4,-1,0,8,7,5,3,1,1,57,27,30,15,4,11,4,16,11,17,3,9,5,10,3,6,1,2,-1,6,8,11,2,7,5,4,6,0,-1,1,3,1,0,0,0,0,2,3,6,0,-1,1,-29,-11,-18,-15,-18,3,-14,-8,8,-12,-9,1,-9,-5,-3,4,-5,2,-5,-3,11,-16,-4,-1,-4,4,-4,-12,2,-1,-2,0,-7,-10,2,-1,-2,4,3,-2,0,0,50,32,18,12,7,5,16,-14,19,12,11,0,20,0,7,-1,6,-4,-4,-14,12,13,5,4,5,0,4,1,2,-2,4,-3,6,-1,1,-1,1,3,-2,2,1,-1,14,23,-9,2,-3,5,-9,10,13,-4,7,-7,-4,3,10,7,1,2,-5,7,3,-11,6,-9,5,1,0,0,-5,1,4,1,-2,-2,-5,1,1,0,2,2,0,0,-22,-20,-2,-38,-29,-9,-4,1,-27,-10,8,13,-5,-5,-7,-11,5,4,1,6,-20,1,3,9,-11,-2,-14,-7,-4,0,-8,-1,-9,-9,-2,0,-3,-1,-5,2,-2,0,-60,-32,-28,-20,-15,-5,-37,9,5,-34,3,1,-29,16,-4,-9,-1,1,-8,-7,9,-25,4,0,-7,4,2,-13,-4,-2,-3,2,-4,-6,-3,-1,-4,2,6,-7,-1,-1,30,6,24,9,6,3,5,-6,14,10,-5,8,0,0,6,0,-6,6,5,-6,8,10,1,2,1,2,5,1,-4,3,2,1,2,-1,-2,3,-1,1,3,2,-2,0,86,40,46,13,6,7,32,-4,37,11,7,2,13,-3,26,-5,7,-1,19,-1,11,16,0,3,4,2,3,3,1,0,2,1,6,-3,0,0,2,1,-3,6,1,0,119,69,50,15,10,5,23,25,26,25,7,12,9,16,11,22,3,8,14,9,15,3,4,4,-3,7,12,-5,2,2,-3,1,8,1,2,1,0,6,4,-6,0,1
8,08120,Matadepera,6533,228,108,120,26,14,12,84,5,56,73,5,2,44,2,19,41,4,-4,40,3,37,32,1,6,12,0,9,1,2,2,7,0,4,0,2,1,5,0,5,1,0,1,117,70,47,12,4,8,54,-2,26,39,-3,2,33,4,9,23,2,-2,21,-6,17,16,-5,4,1,1,5,1,2,2,0,1,2,0,1,0,1,0,3,1,1,2,70,35,35,42,19,23,49,-12,10,30,7,-13,28,-5,-1,18,7,-11,21,-7,11,12,0,-2,15,2,12,7,3,3,7,1,5,3,2,1,8,1,7,4,1,2,114,32,82,14,4,10,68,-16,11,34,-8,15,36,-10,-9,15,-2,-1,32,-6,20,19,-6,16,6,1,4,5,-2,0,3,-1,0,3,-1,0,3,2,4,2,-1,0,137,55,82,28,11,17,57,-19,36,54,-5,13,30,-10,8,26,-2,3,27,-9,28,28,-3,10,3,4,9,6,3,2,2,2,3,1,2,0,1,2,6,5,1,2,149,66,83,15,0,15,64,14,23,51,6,-12,35,-2,-1,30,7,-6,29,16,24,21,-1,-6,7,7,-1,0,1,0,4,1,-4,-1,-1,0,3,6,3,1,2,0,65,32,33,23,6,17,50,-1,-8,9,-2,14,34,2,-14,4,0,1,16,-3,6,5,-2,13,8,2,10,3,-3,2,5,0,1,0,-1,1,3,2,9,3,-2,1,100,18,82,13,-2,15,38,-12,7,48,5,13,11,-7,-17,29,2,3,27,-5,24,19,3,10,3,6,4,-1,1,0,0,1,-1,-3,1,0,3,5,5,2,0,0,98,54,44,31,16,15,40,11,6,24,5,11,18,10,8,13,2,3,22,1,-2,11,3,8,3,6,13,7,2,0,1,5,5,3,0,1,2,1,8,4,2,-1,-32,-3,-29,14,4,10,-8,-21,-15,-8,-5,19,6,-7,-5,-5,-1,6,-14,-14,-10,-3,-4,13,-3,4,9,-2,2,3,-2,0,4,0,2,0,-1,4,5,-2,0,3,-65,-8,-57,-2,5,-7,-1,-32,-14,-7,-9,-4,12,-20,2,2,1,-4,-13,-12,-16,-9,-10,0,1,0,3,-3,-2,-1,4,-1,6,-1,-2,-1,-3,1,-3,-2,0,0,11,-2,13,2,0,2,16,-26,-3,-10,5,25,4,-18,-11,5,8,8,12,-8,8,-15,-3,17,2,-3,-3,6,-2,2,1,-1,-1,2,0,-1,1,-2,-2,4,-2,3,103,51,52,-17,-9,-8,46,1,12,45,-18,1,26,3,7,23,-11,-4,20,-2,5,22,-7,5,-12,1,-2,-3,0,-1,-9,1,0,0,0,-1,-3,0,-2,-3,0,0,19,16,3,-12,-6,-6,24,-18,20,3,-30,16,17,-12,14,-1,-9,3,7,-6,6,4,-21,13,-3,1,-7,-4,-1,2,-4,1,-1,-4,0,2,1,0,-6,0,-1,0,76,44,32,2,0,2,44,-6,1,40,-1,-5,16,1,4,33,0,-10,28,-7,-3,7,-1,5,7,1,-9,3,0,-1,1,0,-4,3,0,-1,6,1,-5,0,0,0,83,48,35,-6,-11,5,43,-5,-10,51,-11,10,22,-9,1,28,0,3,21,4,-11,23,-11,7,-1,-1,-3,-5,-1,3,0,-5,-5,-3,-1,2,-1,4,2,-2,0,1,194,77,117,38,15,23,111,-9,17,78,-11,2,56,-7,4,38,-12,-4,55,-2,13,40,1,6,18,6,-3,11,4,2,7,2,-2,5,2,1,11,4,-1,6,2,1,132,64,68,23,11,12,63,-2,20,58,-14,10,28,0,6,34,-3,1,35,-2,14,24,-11,9,8,5,5,7,-2,1,3,2,1,6,-1,0,5,3,4,1,-1,1
8,08121,Mataró,104095,1493,1024,469,1423,937,486,173,452,652,142,46,15,123,292,481,86,24,4,50,160,171,56,22,11,210,395,571,172,51,15,121,275,395,111,23,5,89,120,176,61,28,10,1362,797,565,1635,994,641,113,483,544,129,27,63,50,281,380,56,13,23,63,202,164,73,14,40,252,462,599,231,50,27,133,289,399,133,28,7,119,173,200,98,22,20,1981,1186,795,1978,1177,801,269,649,686,248,105,13,145,410,444,126,45,11,124,239,242,122,60,2,334,573,684,267,77,31,168,357,449,152,32,15,166,216,235,115,45,16,2205,1188,1017,1885,1080,805,354,639,801,311,44,51,189,354,473,158,10,5,165,285,328,153,34,46,385,499,599,256,90,37,198,284,393,146,37,10,187,215,206,110,53,27,1920,1240,680,2290,1429,861,166,688,745,279,42,-5,55,448,551,162,15,10,111,240,194,117,27,-15,382,618,777,377,89,28,197,409,537,230,36,10,185,209,240,147,53,18,1489,875,614,2181,1297,884,51,632,606,176,-43,65,-9,377,425,110,-52,29,60,255,181,66,9,36,354,632,718,333,88,41,168,394,483,196,37,14,186,238,235,137,51,27,1339,813,526,2020,1221,799,100,543,658,73,-34,14,71,356,408,-3,-22,15,29,187,250,76,-12,-1,306,610,693,278,84,42,177,378,464,133,39,26,129,232,229,145,45,16,3,-103,106,921,506,415,15,373,-94,-133,-78,-66,0,222,-141,-92,-55,-41,15,151,47,-41,-23,-25,211,468,176,68,-3,-16,121,297,68,14,-6,-1,90,171,108,54,3,-15,1287,636,651,1463,736,727,335,546,472,32,-50,-34,201,283,234,-3,-54,-18,134,263,238,35,4,-16,396,490,490,108,-18,-18,239,244,270,35,-44,-16,157,246,220,73,26,-2,506,214,292,401,129,272,11,295,217,24,-29,-18,12,130,98,-16,-13,-10,-1,165,119,40,-16,-8,102,237,87,-36,10,-13,47,112,13,-51,11,-11,55,125,74,15,-1,-2,284,65,219,358,156,202,90,154,82,-41,-21,21,83,56,-15,-35,-18,-1,7,98,97,-6,-3,22,128,146,51,-3,15,4,72,70,5,-19,17,4,56,76,46,16,-2,0,-191,-268,77,-43,-128,85,-27,106,-87,-193,-20,39,-21,18,-132,-125,-26,22,-6,88,45,-68,6,17,23,97,-47,-117,-2,-1,22,38,-93,-83,-14,1,1,59,46,-34,12,-2,-350,-179,-171,-350,-219,-131,-138,62,-155,-118,-27,18,-57,76,-101,-75,-42,9,-81,-14,-54,-43,15,9,-80,50,-107,-153,-54,-12,-31,37,-77,-100,-48,-4,-49,13,-30,-53,-6,-8,-41,-117,76,39,-60,99,-82,106,-103,-19,28,46,-78,53,-37,-64,-9,26,-4,53,-66,45,37,20,29,65,3,-49,-27,11,2,34,-16,-71,-17,2,27,31,19,22,-10,9,75,-102,177,-43,-48,5,-14,89,-78,20,27,19,-21,22,-79,-33,-7,7,7,67,1,53,34,12,-27,52,-53,2,-35,10,-9,34,-42,-9,-33,7,-18,18,-11,11,-2,3,393,169,224,370,170,200,-8,138,105,11,123,22,-27,47,89,-15,52,17,19,91,16,26,71,5,69,119,82,22,57,0,36,65,28,6,34,-8,33,54,54,16,23,8,323,2,321,190,36,154,98,204,132,-100,-7,-19,21,78,-10,-93,11,-1,77,126,142,-7,-18,-18,84,164,80,-97,-32,-25,50,90,12,-91,-22,-13,34,74,68,-6,-10,-12,806,412,394,810,392,418,212,292,276,-31,43,2,139,170,161,-64,1,-3,73,122,115,33,42,5,188,257,293,23,17,25,106,148,163,-23,-16,11,82,109,130,46,33,14
8,08138,Moià,3922,106,50,56,21,9,12,13,16,35,18,15,7,9,9,11,10,9,2,4,7,24,8,6,5,2,4,8,4,2,1,2,2,3,1,1,0,0,2,5,3,1,1,240,124,116,78,40,38,44,36,82,43,15,15,13,17,56,19,7,9,31,19,26,24,8,6,16,16,27,13,5,0,5,9,16,7,3,0,11,7,11,6,2,0,307,165,142,140,84,56,70,46,80,58,28,18,35,28,48,31,12,7,35,18,32,27,16,11,33,32,37,24,5,6,18,20,24,14,3,3,15,12,13,10,2,3,227,124,103,97,61,36,49,21,74,57,9,14,23,19,40,31,6,5,26,2,34,26,3,9,29,25,25,16,1,1,17,16,17,9,1,1,12,9,8,7,0,0,254,160,94,108,70,38,43,31,79,56,29,15,30,14,60,35,13,8,13,17,19,21,16,7,23,17,42,20,2,3,13,9,30,14,1,3,10,8,12,6,1,0,219,122,97,77,48,29,36,46,71,38,27,-2,23,30,39,19,12,-2,13,16,32,19,15,0,10,22,30,9,3,2,4,16,21,5,1,1,6,6,9,4,2,1,92,42,50,74,42,32,29,15,18,26,7,-2,12,5,16,9,3,-2,17,10,2,17,4,0,22,25,13,9,4,1,11,12,11,6,2,0,11,13,2,3,2,1,135,51,84,54,20,34,22,26,36,4,26,20,10,10,12,3,5,7,12,16,24,1,21,13,16,22,5,3,6,2,6,15,1,-3,2,-1,10,7,4,6,4,3,33,16,17,38,22,16,10,17,15,-10,2,-6,-2,14,8,-11,3,-1,12,3,7,1,-1,-5,20,16,10,-9,0,1,12,12,4,-7,-1,2,8,4,6,-2,1,-1,-21,-16,-5,21,11,10,0,-7,-4,-8,-13,9,-1,-4,-2,-1,-14,4,1,-3,-2,-7,1,5,10,11,6,-3,-2,-2,5,5,4,-2,-1,-1,5,6,2,-1,-1,-1,24,14,10,7,1,6,7,8,14,-13,8,-3,3,9,7,-11,7,-2,4,-1,7,-2,1,-1,5,5,-2,-1,0,-1,3,-1,1,-2,-1,0,2,6,-3,1,1,-1,25,17,8,18,16,2,10,-1,17,0,0,-2,2,2,11,4,-1,-1,8,-3,6,-4,1,-1,5,5,8,3,-3,0,4,7,5,1,-1,0,1,-2,3,2,-2,0,-37,-18,-19,-57,-34,-23,-14,3,-9,-16,3,-3,-8,-1,-2,-14,5,2,-6,4,-7,-2,-2,-5,-8,-6,-18,-15,-3,-7,-5,0,-12,-14,0,-3,-3,-6,-6,-1,-3,-4,-16,-19,3,-21,-12,-9,2,-2,4,-5,-29,10,-4,-6,3,-4,-15,6,6,4,1,-1,-14,4,-2,-1,-2,-16,1,-1,1,-1,0,-12,0,0,-3,0,-2,-4,1,-1,107,53,54,16,5,11,19,1,24,27,9,23,20,1,0,15,7,8,-1,0,24,12,2,15,6,-2,10,-3,2,1,4,-3,4,-4,2,1,2,1,6,1,0,0,88,52,36,14,14,0,12,-3,27,15,19,18,3,1,13,15,12,8,9,-4,14,0,7,10,1,7,4,1,0,0,1,3,7,1,2,-1,0,4,-3,0,-2,1,121,94,27,33,23,10,23,26,30,30,4,8,22,23,16,27,3,3,1,3,14,3,1,5,-1,15,16,-4,1,5,1,9,12,-1,-2,3,-2,6,4,-3,3,2,137,74,63,19,11,8,19,38,27,20,21,11,11,27,20,2,9,6,8,11,7,18,12,5,1,12,10,-3,0,-1,1,9,5,-4,1,-1,0,3,5,1,-1,0
8,08123,Molins de Rei,19366,328,160,168,99,52,47,39,70,164,39,20,-6,26,32,83,17,8,-1,13,38,81,22,12,-5,23,26,29,16,4,0,14,12,16,9,1,0,9,14,13,7,3,0,815,405,410,122,67,55,103,169,386,90,43,7,49,77,196,54,21,2,54,92,190,36,22,5,21,24,47,23,6,1,10,11,28,14,4,0,11,13,19,9,2,1,755,405,350,207,113,94,121,126,342,84,40,25,76,71,177,35,22,12,45,55,165,49,18,13,59,43,55,31,11,4,35,24,28,19,3,3,24,19,27,12,8,1,486,232,254,128,57,71,63,90,287,54,7,-18,33,36,137,33,0,-9,30,54,150,21,7,-9,22,45,30,19,7,2,10,22,13,8,2,0,12,23,17,11,5,2,396,195,201,188,93,95,41,41,238,59,-3,3,30,3,128,40,-8,-3,11,38,110,19,5,6,31,47,48,42,13,4,18,18,29,19,8,1,13,29,19,23,5,3,258,100,158,155,59,96,15,87,113,43,-1,-4,0,38,46,25,-13,-1,15,49,67,18,12,-3,24,51,43,20,7,5,7,19,22,6,1,1,17,32,21,14,6,4,130,55,75,232,113,119,-12,51,135,7,-36,-23,-9,25,69,-4,-20,-7,-3,26,66,11,-16,-16,37,54,84,41,9,2,23,24,38,21,4,1,14,30,46,20,5,1,197,72,125,212,87,125,7,71,121,20,9,-26,1,37,49,2,-2,-11,6,34,72,18,11,-15,40,70,69,23,10,-3,19,34,24,6,2,2,21,36,45,17,8,-5,3,-55,58,71,15,56,-10,55,-10,-6,-10,-13,-15,17,-22,-8,-13,-12,5,38,12,2,3,-1,19,38,17,6,-4,-5,4,6,7,4,-4,-2,15,32,10,2,0,-3,84,-10,94,61,11,50,36,7,70,-13,-11,-4,8,-8,-1,-4,-5,2,28,15,71,-9,-6,-6,24,24,8,0,2,-1,11,3,-7,2,1,-2,13,21,15,-2,1,1,-18,-14,-4,-54,-34,-20,-24,7,15,-7,-8,-8,-11,-5,11,-20,7,0,-13,12,4,13,-15,-8,-15,2,-27,-20,1,1,-5,0,-25,-11,4,0,-10,2,-2,-9,-3,1,-143,-95,-48,-32,-27,-5,-45,5,-29,-53,-23,2,-27,-2,-11,-36,-16,-4,-18,7,-18,-17,-7,6,-5,1,-19,-14,-1,4,-4,-10,-4,-12,1,1,-1,11,-15,-2,-2,3,-37,-40,3,14,-1,15,-15,20,5,-27,-11,-6,-10,14,-32,-5,-6,2,-5,6,37,-22,-5,-8,2,13,-6,-8,4,4,4,7,-7,-7,-3,3,-2,6,1,-1,7,1,91,80,11,13,7,6,-9,14,97,16,-13,-10,11,1,58,18,2,-7,-20,13,39,-2,-15,-3,-3,20,6,-4,-7,-1,0,8,3,-3,-2,0,-3,12,3,-1,-5,-1,-59,-47,-12,3,0,3,-20,-7,33,-26,-47,-2,-11,-14,16,-26,-18,0,-9,7,17,0,-29,-2,-5,8,11,-11,-5,1,0,5,4,-10,-2,1,-5,3,7,-1,-3,0,66,28,38,0,0,0,31,24,-2,39,8,-30,20,16,-4,4,5,-18,11,8,2,35,3,-12,0,13,-16,12,-6,-4,0,6,-10,5,0,-2,0,7,-6,7,-6,-2,138,55,83,128,55,73,50,41,30,24,9,-16,28,14,17,9,-5,-5,22,27,13,15,14,-11,31,31,30,28,7,-1,11,12,15,15,1,0,20,19,15,13,6,-1,166,63,103,141,57,84,22,25,69,57,-11,-7,-1,22,22,26,-5,-7,23,3,47,31,-6,0,22,35,46,22,11,3,13,13,21,9,0,0,9,22,25,13,11,3
8,08124,Mollet del Vallès,45324,-127,-46,-81,27,14,13,-117,42,-1,-43,-19,20,-68,15,22,-11,-8,7,-49,27,-23,-32,-11,13,2,6,7,7,0,4,1,2,3,5,0,2,1,4,4,2,0,2,-111,-68,-43,13,8,5,-106,103,-66,-35,-4,10,-62,16,-1,-13,0,-3,-44,87,-65,-22,-4,13,2,3,2,2,4,0,0,3,2,1,2,0,2,0,0,1,2,0,-188,-57,-131,-3,6,-9,-125,93,-19,-97,-43,36,-73,51,32,-40,-23,9,-52,42,-51,-57,-20,27,1,-4,-3,0,2,1,1,0,0,1,3,1,0,-4,-3,-1,-1,0,-394,-191,-203,37,19,18,-178,59,-110,-183,-5,48,-62,36,-64,-87,-22,17,-116,23,-46,-96,17,31,14,8,8,5,1,0,9,1,4,3,1,1,5,7,4,2,0,-1,80,57,23,859,543,316,-111,252,-55,0,-33,43,-83,149,14,11,-28,12,-28,103,-69,-11,-5,31,107,250,299,164,28,8,52,154,207,112,13,4,55,96,92,52,15,4,71,96,-25,851,499,352,-135,242,-31,-21,13,26,-46,143,27,-13,0,1,-89,99,-58,-8,13,25,137,247,258,159,42,6,76,146,163,90,22,1,61,101,95,69,20,5,48,-38,86,773,376,397,-15,158,24,-24,-51,-35,-42,65,23,-35,-27,-20,27,93,1,11,-24,-15,186,243,217,112,17,-6,98,132,105,40,3,-3,88,111,112,72,14,-3,186,56,130,635,318,317,36,240,36,-83,-57,17,20,138,2,-50,-49,1,16,102,34,-33,-8,16,172,267,148,48,1,-8,94,136,77,21,-10,-3,78,131,71,27,11,-5,343,170,173,624,317,307,41,238,78,27,-51,-2,33,143,12,14,-39,-1,8,95,66,13,-12,-1,125,248,164,66,9,6,84,135,68,27,-1,2,41,113,96,39,10,4,-372,-280,-92,-106,-136,30,-37,34,-149,-141,-72,-11,-18,-16,-112,-96,-47,2,-19,50,-37,-45,-25,-13,38,38,-92,-78,-19,-1,17,16,-82,-75,-15,-2,21,22,-10,-3,-4,1,-379,-253,-126,-130,-115,-15,0,-15,-141,-117,-68,-20,5,-8,-87,-97,-58,2,-5,-7,-54,-20,-10,-22,11,26,-83,-55,-25,-9,11,12,-74,-43,-20,-4,0,14,-9,-12,-5,-5,-334,-234,-100,-27,-69,42,-55,26,-135,-143,-27,-7,-28,22,-122,-89,-20,-2,-27,4,-13,-54,-7,-5,21,46,-44,-29,-13,-5,9,16,-52,-24,-14,-2,12,30,8,-5,1,-3,-426,-308,-118,-445,-302,-143,-40,-8,-232,-103,-55,14,-28,-20,-131,-87,-44,5,-12,12,-101,-16,-11,9,-52,-42,-188,-125,-44,1,-22,-42,-102,-97,-40,-1,-30,0,-86,-28,-4,2,-416,-229,-187,-242,-176,-66,-18,-75,-137,-160,-64,39,-2,-31,-84,-114,-18,20,-16,-44,-53,-46,-46,19,-22,-5,-73,-108,-45,8,-11,-12,-50,-83,-21,0,-11,7,-23,-25,-24,8,-192,-125,-67,-125,-92,-33,-12,18,-87,-66,-27,-26,12,11,-79,-46,-14,-10,-24,7,-8,-20,-13,-16,-11,0,-53,-57,-11,3,4,-5,-50,-38,-7,3,-15,5,-3,-19,-4,0,-59,-78,19,-22,-18,-4,-28,32,-6,-113,-6,60,-21,13,-6,-69,-12,18,-7,19,0,-44,6,42,4,51,-9,-65,0,-7,6,24,-5,-38,-3,-3,-2,27,-4,-27,3,-4,-67,-111,44,60,-39,99,-52,81,-6,-117,-50,61,-47,12,30,-85,-49,25,-5,69,-36,-32,-1,36,9,65,43,-43,-27,7,-13,20,36,-48,-32,-3,22,45,7,5,5,10,-70,-91,21,200,89,111,-60,56,-3,-59,-23,36,-22,47,-6,-86,-29,17,-38,9,3,27,6,19,37,85,53,21,2,-1,22,45,35,-10,-7,4,15,40,18,31,9,-5
8,08127,Monistrol de Montserrat,2498,80,56,24,38,26,12,19,30,16,19,4,-7,12,21,14,11,-1,0,7,9,2,8,5,-7,6,9,13,6,2,2,4,7,9,4,0,2,2,2,4,2,2,0,24,22,2,8,4,4,-1,0,14,-3,7,7,2,2,8,-1,6,5,-3,-2,6,-2,1,2,0,1,4,2,0,0,0,1,1,1,0,0,0,0,3,1,0,0,-19,-24,5,2,1,1,-4,3,-7,0,-3,-7,-7,-5,-7,0,-1,-3,3,8,0,0,-2,-4,1,0,1,0,0,0,1,0,0,0,0,0,0,0,1,0,0,0,42,40,2,19,19,0,6,7,33,8,-5,-7,6,3,25,8,-1,-3,0,4,8,0,-4,-4,4,2,5,6,0,2,4,1,6,6,0,2,0,1,-1,0,0,0,66,47,19,66,50,16,-6,15,35,18,11,-8,2,8,17,19,3,-3,-8,7,18,-1,8,-5,3,16,15,26,6,0,2,11,13,21,3,0,1,5,2,5,3,0,70,46,24,32,17,15,13,29,32,8,-3,-8,7,16,24,6,-5,0,6,13,8,2,2,-8,10,8,6,6,2,0,6,4,4,2,1,0,4,4,2,4,1,0,100,52,48,37,19,18,20,31,44,19,-2,-9,6,16,26,7,0,-1,14,15,18,12,-2,-8,6,2,12,16,0,0,1,2,6,10,0,0,5,0,6,6,0,0,70,29,41,21,11,10,11,34,42,-1,-12,-6,-3,17,24,-7,-3,0,14,17,18,6,-9,-6,4,7,8,-1,2,0,1,2,5,0,3,0,3,5,3,-1,-1,0,41,16,25,24,7,17,11,19,7,5,2,0,7,-1,17,-6,0,1,4,20,-10,11,2,-1,12,12,-2,3,0,-1,9,3,-4,-1,0,0,3,9,2,4,0,-1,-13,-12,-1,23,13,10,-9,7,-2,-14,2,3,-7,8,1,-10,-2,-1,-2,-1,-3,-4,4,4,0,6,10,2,0,4,1,3,6,2,0,0,-1,3,4,0,0,4,-42,-19,-23,-22,-17,-5,-8,5,-12,-9,-6,-8,-3,4,-5,-8,-5,-2,-5,1,-7,-1,-1,-6,-4,4,-4,-12,-6,0,1,0,-2,-12,-4,0,-5,4,-2,0,-2,0,-22,-21,-1,-25,-16,-9,-4,7,-6,-6,-1,-9,-5,5,-13,-1,0,-6,1,2,7,-5,-1,-3,-8,-2,-3,-6,-4,-1,-5,0,-4,-4,-3,0,-3,-2,1,-2,-1,-1,-29,-25,-4,-10,-6,-4,0,-3,0,-16,-8,-1,-5,-7,0,-10,-2,0,5,4,0,-6,-6,-1,-1,0,-2,-6,0,-2,0,-1,-1,-5,1,0,-1,1,-1,-1,-1,-2,-40,-17,-23,-9,-6,-3,-14,-3,-16,-11,7,-1,-6,2,-10,-9,5,1,-8,-5,-6,-2,2,-2,0,-1,-3,-2,-4,0,0,-1,-2,-1,-3,0,0,0,-1,-1,-1,0,-37,-20,-17,5,8,-3,-18,-7,-12,4,0,-4,-11,-2,-4,-1,-3,1,-7,-5,-8,5,3,-5,3,1,-2,0,1,2,1,1,2,0,1,3,2,0,-4,0,0,-1,-10,-1,-9,9,4,5,-20,15,-12,-14,21,2,-5,5,-12,-7,17,1,-15,10,0,-7,4,1,2,7,3,-3,0,0,0,5,-1,-2,1,1,2,2,4,-1,-1,-1,58,27,31,11,8,3,5,16,25,10,-2,1,2,8,16,3,-5,2,3,8,9,7,3,-1,1,3,4,-1,3,1,1,3,3,0,0,1,0,0,1,-1,3,0,23,16,7,9,1,8,6,5,-3,7,6,3,7,-2,-4,12,3,-2,-1,7,1,-5,3,5,3,2,-4,7,0,1,1,-2,-4,4,1,1,2,4,0,3,-1,0
8,08125,Montcada i Reixac,27348,624,293,331,196,100,96,92,186,224,106,17,-11,42,64,125,56,7,-5,50,122,99,50,10,-6,32,44,69,42,4,4,18,23,34,22,2,1,14,21,35,20,2,3,237,112,125,245,126,119,24,57,117,36,-5,-5,6,26,59,23,-2,-3,18,31,58,13,-3,-2,43,55,92,45,7,0,23,30,48,22,1,0,20,25,44,23,6,0,560,341,219,486,278,208,122,155,194,82,8,-1,51,91,144,53,0,-3,71,64,50,29,8,2,96,122,146,92,19,7,49,71,91,51,10,4,47,51,55,41,9,3,535,275,260,379,200,179,115,191,214,36,-10,-5,56,96,123,22,-14,-3,59,95,91,14,4,-2,95,80,113,56,24,6,45,38,70,35,6,3,50,42,43,21,18,3,442,287,155,318,198,120,82,107,216,15,20,-12,48,45,133,32,15,6,34,62,83,-17,5,-18,42,91,111,36,30,3,28,53,69,32,11,2,14,38,42,4,19,1,171,113,58,214,94,120,30,99,12,63,-22,-20,39,50,2,37,-9,-14,-9,49,10,26,-13,-6,75,65,18,37,6,6,40,31,4,11,1,2,35,34,14,26,5,4,15,11,4,247,120,127,22,19,43,-17,-31,-25,21,6,49,-45,-24,1,1,13,-6,28,-7,-26,69,48,72,32,12,6,44,26,31,5,5,5,25,22,41,27,7,1,523,304,219,472,240,232,59,154,254,70,-4,-5,20,84,175,34,-3,-5,39,70,79,36,-1,0,102,151,122,74,14,7,50,82,75,26,3,2,52,69,47,48,11,5,330,88,242,206,66,140,88,75,134,49,-22,-10,30,22,65,-3,-17,-19,58,53,69,52,-5,9,71,74,64,5,-14,-5,33,24,31,-7,-12,-6,38,50,33,12,-2,1,141,80,61,54,9,45,13,44,61,40,-35,18,17,31,37,21,-26,-3,-4,13,24,19,-9,21,36,32,-24,11,-5,0,33,11,-31,-6,0,0,3,21,7,17,-5,0,352,143,209,90,29,61,93,108,142,-28,4,24,63,24,45,-22,5,22,30,84,97,-6,-1,2,46,44,2,-18,1,11,24,24,-12,-12,-1,4,22,20,14,-6,2,7,340,190,150,211,80,131,63,62,152,78,-6,-15,41,24,52,71,1,-9,22,38,100,7,-7,-6,44,58,75,13,10,3,26,15,32,2,-1,1,18,43,43,11,11,2,122,4,118,-97,-73,-24,63,53,10,18,-8,-20,38,-7,20,-21,-22,-2,25,60,-10,39,14,-18,3,-5,-52,-28,-12,-7,10,-13,-28,-30,-11,-1,-7,8,-24,2,-1,-6,-351,-222,-129,-338,-222,-116,-56,-27,-101,-105,-41,-27,-46,-2,-66,-90,-17,-7,-10,-25,-35,-15,-24,-20,-34,-45,-123,-108,-33,1,-29,-24,-72,-80,-17,-2,-5,-21,-51,-28,-16,3,43,-8,51,-27,-10,-17,61,18,35,-67,13,-9,29,-2,7,-26,-7,-2,32,20,28,-41,20,-7,29,18,-25,-39,-10,-1,22,7,-12,-18,-9,0,7,11,-13,-21,-1,-1,368,188,180,226,115,111,96,102,143,79,-24,-36,53,39,97,24,-20,-13,43,63,46,55,-4,-23,42,54,79,43,-1,3,23,26,40,27,-2,-2,19,28,39,16,1,5,257,99,158,209,73,136,16,93,72,72,17,-28,-3,41,35,34,1,-18,19,52,37,38,16,-10,45,58,42,37,16,5,28,12,12,16,2,-1,17,46,30,21,14,6,482,249,233,299,162,137,92,110,174,81,24,-17,57,51,90,45,-1,-2,35,59,84,36,25,-15,74,98,71,37,4,12,55,50,33,12,4,6,19,48,38,25,0,6
8,08126,Montgat,8089,69,56,13,27,16,11,-2,8,67,9,-2,-10,-3,9,45,7,2,-4,1,-1,22,2,-4,-6,1,4,17,1,2,2,1,1,11,0,2,1,0,3,6,1,0,1,186,91,95,65,30,35,26,52,100,28,-10,-9,9,33,41,18,-3,-7,17,19,59,10,-7,-2,15,10,20,16,4,0,10,5,7,8,0,0,5,5,13,8,4,0,42,14,28,60,23,37,-13,4,49,-10,15,-7,-22,8,24,-7,9,-2,9,-4,25,-3,6,-5,12,8,23,9,4,2,6,3,7,2,2,1,6,5,16,7,2,1,64,19,45,60,29,31,3,30,22,5,9,-10,-10,22,16,-7,3,-6,13,8,6,12,6,-4,6,12,23,7,7,2,2,4,11,6,3,1,4,8,12,1,4,1,217,79,138,41,19,22,9,35,100,46,14,4,8,5,42,14,2,4,1,30,58,32,12,0,5,12,9,12,1,1,5,3,2,8,1,0,0,9,7,4,0,1,262,94,168,50,15,35,33,55,113,52,3,9,11,5,49,35,-6,1,22,50,64,17,9,8,11,19,8,7,5,0,6,5,1,4,0,-1,5,14,7,3,5,1,311,139,172,40,5,35,19,49,181,40,17,3,18,13,84,12,14,-4,1,36,97,28,3,7,3,15,13,-4,2,8,-2,5,3,-4,-2,3,5,10,10,0,4,5,201,118,83,69,50,19,18,55,93,36,8,-8,13,35,58,19,4,-8,5,20,35,17,4,0,22,23,10,11,2,-1,20,11,9,6,1,1,2,12,1,5,1,-2,171,67,104,46,17,29,20,15,105,35,0,-4,8,6,42,16,-3,-3,12,9,63,19,3,-1,8,14,13,11,-1,1,5,5,1,6,0,0,3,9,12,5,-1,1,207,91,116,4,-10,14,19,59,102,18,3,0,9,17,47,6,8,0,10,42,55,12,-5,0,0,5,-2,-3,3,1,0,-1,-6,-3,1,-1,0,6,4,0,2,2,91,35,56,37,15,22,-22,29,80,3,10,-12,-13,11,46,-2,-2,-7,-9,18,34,5,12,-5,6,10,8,9,7,-5,4,4,5,4,-2,-2,2,6,3,5,9,-3,46,26,20,-14,-6,-8,-1,2,63,-27,8,-3,5,-2,33,-14,4,0,-6,4,30,-13,4,-3,-1,5,-10,-9,-3,2,2,1,-2,-3,-4,-1,-3,4,-8,-6,1,3,133,59,74,0,-1,1,13,21,73,22,10,-8,12,7,31,12,0,-1,1,14,42,10,10,-7,9,-3,-4,4,-1,-5,7,-3,-6,2,1,-2,2,0,2,2,-2,-3,160,105,55,17,9,8,27,3,91,40,1,-5,21,0,56,31,-2,0,6,3,35,9,3,-5,4,1,7,-3,1,3,1,0,4,-2,2,1,3,1,3,-1,-1,2,166,105,61,36,14,22,6,30,94,28,17,-12,8,11,65,13,2,-1,-2,19,29,15,15,-11,14,8,9,-2,6,1,7,3,4,-3,3,0,7,5,5,1,3,1,48,6,42,44,12,32,-12,17,41,14,-10,-7,-13,11,14,-1,-8,0,1,6,27,15,-2,-7,6,6,27,-1,6,-2,1,1,11,-3,2,-1,5,5,16,2,4,-1,44,-7,51,47,24,23,0,17,49,-10,-2,-17,1,8,11,-12,-4,-14,-1,9,38,2,2,-3,10,10,17,0,8,0,4,6,10,-1,4,0,6,4,7,1,4,0,12,1,11,-9,-8,-1,4,14,30,-5,-21,-7,2,13,25,-5,-19,-11,2,1,5,0,-2,4,5,5,1,-8,-11,-2,3,2,4,-10,-5,-2,2,3,-3,2,-6,0
8,08140,Navarcles,5285,48,24,24,14,6,8,18,-1,18,7,0,5,11,2,8,6,-3,0,7,-3,10,1,3,5,3,5,4,1,1,0,1,2,2,0,1,0,2,3,2,1,0,0,30,4,26,39,19,20,11,13,3,-6,1,8,7,0,0,-6,2,3,4,13,3,0,-1,5,12,10,12,5,0,0,8,3,6,2,0,0,4,7,6,3,0,0,45,20,25,43,20,23,17,10,10,11,-4,-1,9,2,7,8,-5,-3,8,8,3,3,1,2,11,9,12,7,2,0,4,6,5,4,0,0,7,3,7,3,2,0,87,46,41,22,10,12,16,12,43,14,-1,-2,10,6,23,4,-3,3,6,6,20,10,2,-5,4,4,5,5,3,1,2,3,3,1,0,1,2,1,2,4,3,0,117,66,51,47,24,23,23,35,13,26,12,5,12,15,10,18,5,5,11,20,3,8,7,0,8,15,3,11,7,2,4,9,2,5,3,1,4,6,1,6,4,1,92,29,63,21,1,20,14,11,21,0,21,22,0,-1,14,-6,13,8,14,12,7,6,8,14,10,7,2,2,0,-1,-1,1,1,-2,1,0,11,6,1,4,-1,-1,57,25,32,35,19,16,8,25,14,8,-10,10,8,7,11,5,-9,3,0,18,3,3,-1,7,9,8,8,8,0,3,4,4,5,7,0,0,5,4,3,1,0,3,81,31,50,49,26,23,-5,25,40,8,7,5,-6,5,23,6,3,0,1,20,17,2,4,5,8,14,15,10,2,0,3,3,11,6,3,0,5,11,4,4,-1,0,122,61,61,44,20,24,32,14,44,22,4,3,13,5,25,16,2,-1,19,9,19,6,2,4,12,7,15,8,1,0,5,3,7,4,1,0,7,4,8,4,0,0,7,-27,34,-1,-7,6,1,1,-6,7,2,11,-7,-3,-21,0,0,10,8,4,15,7,2,1,1,3,-4,0,-2,1,0,1,-3,-3,-2,0,1,2,-1,3,0,1,19,20,-1,-26,-16,-10,14,-9,6,-1,8,-2,11,-4,12,-2,4,-1,3,-5,-6,1,4,-1,-2,-4,-9,-7,-3,-1,1,-6,-6,-4,-1,0,-3,2,-3,-3,-2,-1,23,10,13,-14,-11,-3,24,4,7,-6,-8,5,12,3,4,-1,-10,2,12,1,3,-5,2,3,6,-7,-5,-5,-2,-1,1,-2,-2,-6,-1,-1,5,-5,-3,1,-1,0,19,10,9,-4,-1,-3,6,4,-13,-7,7,24,11,2,-10,-2,5,4,-5,2,-3,-5,2,20,2,-3,-6,2,1,0,2,-1,-3,0,1,0,0,-2,-3,2,0,0,50,24,26,-15,-8,-7,8,-1,16,13,0,19,-2,3,7,8,5,5,10,-4,9,5,-5,14,1,-2,-4,-7,-2,-1,1,-1,-3,-5,0,0,0,-1,-1,-2,-2,-1,19,15,4,-3,-4,1,-16,23,-13,8,9,11,-1,8,1,-4,11,2,-15,15,-14,12,-2,9,0,1,-3,-1,1,0,0,-1,-1,-1,0,0,0,2,-2,0,1,0,2,-7,9,1,-5,6,-4,9,-17,7,-4,10,-5,3,-6,2,-4,3,1,6,-11,5,0,7,-2,1,1,-1,-1,2,-2,0,0,-2,-1,0,0,1,1,1,0,2,-43,-30,-13,-12,-12,0,-19,-12,-13,0,-4,6,-12,-9,-2,-1,-6,0,-7,-3,-11,1,2,6,-6,4,-1,-4,-4,-1,-7,0,3,-5,-4,1,1,4,-4,1,0,-2,33,22,11,34,16,18,3,10,16,-3,-1,9,3,8,6,1,1,4,0,2,10,-4,-2,5,5,9,14,2,0,4,3,4,9,-1,0,1,2,5,5,3,0,3
8,08141,Navàs,5813,24,16,8,31,21,10,-10,-7,17,6,5,14,-6,-5,19,4,1,4,-4,-2,-2,2,4,10,1,5,19,4,1,1,0,3,15,3,0,0,1,2,4,1,1,1,50,20,30,56,33,23,28,14,8,5,-6,0,12,4,6,0,-4,2,16,10,2,5,-2,-2,11,16,18,10,1,0,6,6,14,7,0,0,5,10,4,3,1,0,36,14,22,29,19,10,15,16,0,-1,5,0,4,12,3,-7,2,0,11,4,-3,6,3,0,4,9,10,4,0,1,1,6,8,3,0,1,3,3,2,1,0,0,52,32,20,24,11,13,9,4,4,16,12,6,-2,4,6,9,10,4,11,0,-2,7,2,2,5,7,6,2,2,2,2,2,3,2,1,1,3,5,3,0,1,1,87,46,41,33,12,21,25,14,31,5,2,10,14,5,16,5,0,6,11,9,15,0,2,4,9,7,11,3,1,2,3,2,5,1,0,1,6,5,6,2,1,1,91,36,55,50,23,27,29,16,6,31,1,6,17,2,2,12,-2,3,12,14,4,19,3,3,6,11,17,14,1,0,2,4,10,7,0,0,4,7,7,7,1,0,181,100,81,69,39,30,35,33,69,23,10,9,18,16,39,17,3,4,17,17,30,6,7,5,15,15,21,13,3,1,9,6,13,9,1,0,6,9,8,4,2,1,170,107,63,64,42,22,35,41,66,9,11,2,21,23,44,8,9,-1,14,18,22,1,2,3,15,16,19,8,4,2,10,12,13,4,3,0,5,4,6,4,1,2,126,59,67,40,23,17,29,24,45,29,-9,2,17,12,15,16,-1,0,12,12,30,13,-8,2,7,14,12,7,-3,2,4,7,9,3,-1,1,3,7,3,4,-2,1,-63,-43,-20,-18,-13,-5,-12,-11,-21,-27,7,2,-4,-14,-13,-14,4,-1,-8,3,-8,-13,3,3,-2,4,-10,-11,2,-1,0,-3,-7,-4,1,0,-2,7,-3,-7,1,-1,-27,-15,-12,-19,-14,-5,-7,9,-34,1,2,1,-1,4,-16,-3,0,3,-6,5,-18,4,2,-2,-3,2,-11,-5,-1,-1,-2,-1,-4,-5,-2,0,-1,3,-7,0,1,-1,-22,-7,-15,-1,-7,6,-14,-8,9,-17,-1,5,-5,-5,8,-13,4,1,-9,-3,1,-4,-5,4,2,3,-4,-4,0,1,1,0,-2,-6,-1,0,1,3,-2,2,1,1,14,17,-3,-1,-8,7,9,4,9,4,-3,-16,3,5,7,-2,3,-5,6,-1,2,6,-6,-11,-3,4,0,-4,1,0,-5,2,-2,-4,0,0,2,2,2,0,1,0,-27,-30,3,3,-2,5,-1,2,6,-26,-6,0,-4,4,-6,-17,-9,0,3,-2,12,-9,3,0,-2,2,2,-4,2,3,-2,0,-1,-1,0,2,0,2,3,-3,2,1,-8,11,-19,-12,-3,-9,-6,-7,-3,-2,16,-8,5,-3,4,-2,8,-2,-11,-4,-7,0,8,-6,-5,-1,0,-3,-1,-2,0,-1,0,-1,0,-1,-5,0,0,-2,-1,-1,-41,-27,-14,0,2,-2,-11,1,-12,3,-6,-14,-9,3,-11,7,-5,-10,-2,-2,-1,-4,-1,-4,3,-4,0,0,1,0,5,-1,-1,-1,0,0,-2,-3,1,1,1,0,1,3,-2,22,13,9,-11,3,5,0,4,-1,-5,2,1,2,1,1,-6,1,4,-2,3,-2,6,5,10,-1,1,1,4,1,9,-1,0,0,2,4,1,0,1,1,25,-5,30,21,7,14,9,-1,5,15,-8,5,-4,-5,5,0,-2,1,13,4,0,15,-6,4,4,6,2,7,2,0,1,3,1,1,2,-1,3,3,1,6,0,1
8,08143,Òdena,2686,13,4,9,2,1,1,-4,5,7,8,-2,-2,-6,5,3,5,-2,0,2,0,4,3,0,-2,0,1,1,0,0,0,0,0,1,0,0,0,0,1,0,0,0,0,47,31,16,4,2,2,25,4,11,10,-2,-2,18,2,6,6,-2,0,7,2,5,4,0,-2,3,1,0,0,0,0,2,0,0,0,0,0,1,1,0,0,0,0,2,-8,10,10,5,5,-9,10,-19,17,1,1,-7,-2,-10,7,2,1,-2,12,-9,10,-1,0,0,5,3,2,0,0,0,3,1,1,0,0,0,2,2,1,0,0,74,42,32,14,7,7,16,14,11,22,4,2,9,3,10,13,3,1,7,11,1,9,1,1,3,3,2,3,1,2,0,2,2,1,1,1,3,1,0,2,0,1,87,57,30,19,13,6,16,17,33,17,9,-6,9,14,19,13,4,-2,7,3,14,4,5,-4,2,8,4,3,2,0,2,4,3,3,1,0,0,4,1,0,1,0,154,73,81,13,3,10,46,18,64,14,10,-3,26,8,27,6,4,-3,20,10,37,8,6,0,5,1,3,4,0,0,2,1,0,0,0,0,3,0,3,4,0,0,58,34,24,9,3,6,3,6,26,26,2,-7,1,6,14,11,2,-3,2,0,12,15,0,-4,5,4,-4,4,0,0,1,5,-3,0,0,0,4,-1,-1,4,0,0,95,49,46,16,10,6,17,38,29,19,0,-9,10,12,17,17,-2,-6,7,26,12,2,2,-3,4,4,2,4,2,0,3,3,2,2,0,0,1,1,0,2,2,0,34,15,19,5,3,2,-2,3,23,9,4,-4,-3,-2,13,8,0,-1,1,5,10,1,4,-3,-1,2,1,3,0,0,-1,2,1,1,0,0,0,0,0,2,0,0,79,22,57,15,1,14,14,19,20,16,7,0,-2,6,6,5,5,0,16,13,14,11,2,0,8,0,6,2,-1,0,1,-1,1,0,0,0,7,1,5,2,-1,0,12,23,-11,-2,3,-5,-5,-3,21,-6,7,-2,4,-1,17,0,3,-1,-9,-2,4,-6,4,-1,-1,0,1,-1,-1,0,-1,1,2,2,-1,0,0,-1,-1,-3,0,0,95,57,38,4,-2,6,27,15,18,20,4,3,15,7,13,10,4,1,12,8,5,10,0,2,0,4,-1,-1,0,2,0,0,-1,-1,0,0,0,4,0,0,0,2,30,12,18,-3,-2,-1,28,0,9,5,-7,-4,13,-4,3,5,-4,-2,15,4,6,0,-3,-2,3,-1,-1,-3,-1,0,2,-1,-2,-1,0,0,1,0,1,-2,-1,0,-5,5,-10,-9,-2,-7,-3,-2,2,6,4,-8,4,-5,-1,7,5,-3,-7,3,3,-1,-1,-5,-4,1,-3,-1,-1,-1,0,-1,0,-1,0,0,-4,2,-3,0,-1,-1,-20,-11,-9,21,15,6,8,-4,-16,-1,-1,-2,-4,2,-7,-2,6,-4,12,-6,-9,1,-7,2,10,1,3,5,2,0,5,1,3,2,4,0,5,0,0,3,-2,0,-5,2,-7,1,4,-3,-24,6,5,1,6,1,-12,-2,11,0,4,1,-12,8,-6,1,2,0,-7,-2,7,0,2,1,-2,-1,5,1,0,1,-5,-1,2,-1,2,0,-17,0,-17,6,2,4,-3,-10,3,0,-4,-3,-1,-10,10,2,-3,1,-2,0,-7,-2,-1,-4,-1,5,1,1,-1,1,-1,1,4,-1,-1,0,0,4,-3,2,0,1,10,-1,11,-1,1,-2,-7,16,5,-3,-5,0,-2,6,4,-4,-7,-1,-5,10,1,1,2,1,1,1,3,-3,-2,-1,0,0,3,0,-2,0,1,1,0,-3,0,-1
8,08145,Olèrdola,2121,84,53,31,13,9,4,22,9,24,18,6,3,16,6,16,8,5,1,6,3,8,10,1,2,3,2,7,1,0,0,2,2,4,1,0,0,1,0,3,0,0,0,81,44,37,22,10,12,26,6,27,19,-1,3,11,2,20,9,-1,2,15,4,7,10,0,1,5,5,10,2,0,0,2,2,6,0,0,0,3,3,4,2,0,0,98,44,54,23,16,7,32,4,33,25,2,1,17,0,14,11,2,-1,15,4,19,14,0,2,7,3,8,5,0,0,4,3,6,3,0,0,3,0,2,2,0,0,56,31,25,16,7,9,-4,7,27,9,18,-2,-7,3,17,6,8,2,3,4,10,3,10,-4,2,4,6,3,1,0,1,2,1,3,0,0,1,2,5,0,1,0,207,117,90,29,20,9,50,13,73,59,12,-2,33,9,33,36,7,-3,17,4,40,23,5,1,5,3,11,8,2,0,2,2,8,7,1,0,3,1,3,1,1,0,202,125,77,38,25,13,42,26,81,30,22,-2,26,21,48,17,13,-2,16,5,33,13,9,0,11,11,11,4,1,0,8,6,7,4,0,0,3,5,4,0,1,0,186,89,97,39,21,18,41,17,64,26,18,10,14,12,32,12,8,7,27,5,32,14,10,3,11,8,12,6,1,0,6,3,7,5,0,0,5,5,5,1,1,0,71,23,48,14,7,7,8,11,39,8,9,-4,2,3,14,1,4,-2,6,8,25,7,5,-2,-1,13,-2,2,2,0,-1,6,1,0,1,0,0,7,-3,2,1,0,48,11,37,18,1,17,24,-5,11,9,7,3,10,-3,1,-1,1,4,14,-2,10,10,6,-1,8,4,1,-1,1,4,4,-2,-2,-2,0,3,4,6,3,1,1,1,58,31,27,1,-2,3,18,-4,19,20,2,2,12,1,4,11,0,2,6,-5,15,9,2,0,2,0,-2,0,1,0,2,0,-4,0,0,0,0,0,2,0,1,0,18,18,0,13,10,3,14,-16,0,19,0,2,12,-12,0,17,1,-1,2,-4,0,2,-1,3,5,2,3,5,-1,-1,4,1,2,4,0,-1,1,1,1,1,-1,0,6,1,5,8,-1,9,4,-8,27,-13,-5,-1,2,-5,16,-6,-6,-1,2,-3,11,-7,1,0,10,4,1,-7,-1,0,6,1,-2,-5,-2,0,4,3,3,-2,1,0,7,3,4,4,2,2,-5,2,-7,10,2,3,-2,4,-11,5,2,1,-3,-2,4,5,0,2,0,3,2,-3,1,1,-1,2,1,-2,1,1,1,1,1,-1,0,0,-37,-24,-13,-7,-4,-3,-15,-8,4,-14,3,-8,-14,-1,2,-9,0,-2,-1,-7,2,-5,3,-6,-2,0,-3,-1,-1,-1,0,-1,-2,-2,0,0,-2,1,-1,1,-1,-1,-68,-35,-33,-7,-2,-5,-39,4,-14,-28,5,8,-26,4,0,-14,3,0,-13,0,-14,-14,2,8,-5,2,-3,-3,2,0,-3,0,1,-3,3,0,-2,2,-4,0,-1,0,16,5,11,4,-4,8,15,1,3,2,-2,-4,8,1,-4,-1,2,-1,7,0,7,3,-4,-3,1,4,1,-3,2,-2,-2,1,0,-4,2,-1,3,3,1,1,0,-1,35,1,34,22,10,12,14,0,2,24,-3,-3,3,6,-9,8,-2,-4,11,-6,11,16,-1,1,8,2,7,2,3,0,3,3,1,1,2,0,5,-1,6,1,1,0,43,30,13,32,17,15,7,-4,13,11,12,4,10,-7,8,8,8,3,-3,3,5,3,4,1,5,3,6,10,6,2,1,3,2,5,5,1,4,0,4,5,1,1
8,08146,Olesa de Bonesvalls,876,62,31,31,7,5,2,6,16,17,11,8,4,1,6,10,6,6,1,5,10,7,5,2,3,0,2,2,1,1,1,0,1,2,0,1,1,0,1,0,1,0,0,55,25,30,9,4,5,4,12,12,14,9,4,-1,9,7,8,3,-1,5,3,5,6,6,5,2,2,1,4,0,0,1,0,0,3,0,0,1,2,1,1,0,0,80,43,37,16,8,8,20,2,25,26,6,2,8,1,11,16,4,4,12,1,14,10,2,-2,2,2,7,2,1,1,1,1,4,1,0,0,1,1,3,1,1,1,97,42,55,12,6,6,31,16,30,14,4,1,11,5,14,10,3,-2,20,11,16,4,1,3,3,2,4,1,2,0,1,2,2,0,1,0,2,0,2,1,1,0,88,45,43,12,4,8,15,11,41,12,7,3,12,4,20,4,4,0,3,7,21,8,3,3,3,3,4,2,0,0,3,0,0,1,0,0,0,3,4,1,0,0,119,73,46,18,14,4,25,12,44,17,7,9,12,12,24,13,3,5,13,0,20,4,4,4,2,3,8,3,1,1,2,3,7,1,1,0,0,0,1,2,0,1,48,28,20,12,6,6,-3,7,17,22,9,-1,1,5,6,11,8,-1,-4,2,11,11,1,0,2,3,4,3,0,0,2,2,1,1,0,0,0,1,3,2,0,0,95,53,42,9,2,7,23,19,32,5,3,10,15,7,21,1,1,7,8,12,11,4,2,3,3,5,2,-2,0,0,2,1,0,-1,0,0,1,4,2,-1,0,0,55,26,29,9,4,5,6,2,8,10,11,21,5,3,1,5,5,8,1,-1,7,5,6,13,3,4,1,2,-1,0,1,3,-1,2,-1,0,2,1,2,0,0,0,-43,-29,-14,-9,-6,-3,-9,-15,-6,-7,-4,-2,-5,-10,-7,-1,-2,-4,-4,-5,1,-6,-2,2,-1,-3,-2,-2,0,-1,0,-3,-3,0,0,0,-1,0,1,-2,0,-1,59,30,29,-2,-1,-1,12,3,22,6,0,14,8,2,10,3,-1,7,4,1,12,3,1,7,2,-1,-5,2,0,0,1,0,-2,0,0,0,1,-1,-3,2,0,0,-15,-11,-4,-7,-3,-4,-1,0,-9,-9,4,2,-1,-1,-7,-5,3,-1,0,1,-2,-4,1,3,-2,0,1,-5,0,-1,-1,0,2,-4,0,0,-1,0,-1,-1,0,-1,-27,-15,-12,-11,-6,-5,-8,-4,-9,-7,-5,4,-6,-3,-3,-2,-1,0,-2,-1,-6,-5,-4,4,-1,-3,-4,-1,-1,-1,0,-1,-3,0,-1,-1,-1,-2,-1,-1,0,0,-1,-13,12,-3,-4,1,3,-5,0,6,-7,0,1,-3,-8,5,-6,-3,2,-2,8,1,-1,3,0,-2,-1,0,-1,1,0,-1,-2,0,-1,0,0,-1,1,0,0,1,-16,-4,-12,0,-2,2,-10,3,-8,2,-3,0,-4,1,0,-3,2,0,-6,2,-8,5,-5,0,0,3,-1,-3,0,1,0,1,0,-3,0,0,0,2,-1,0,0,1,20,24,-4,7,6,1,6,5,6,11,-2,-7,7,6,8,6,-2,-3,-1,-1,-2,5,0,-4,3,1,3,1,0,-1,3,1,1,1,0,0,0,0,2,0,0,-1,19,17,2,10,4,6,3,-3,13,8,-3,1,11,-4,5,7,-1,-1,-8,1,8,1,-2,2,1,0,1,4,3,1,0,0,0,2,2,0,1,0,1,2,1,1,61,34,27,12,9,3,16,5,10,9,13,8,7,4,4,10,6,3,9,1,6,-1,7,5,3,1,2,2,2,1,2,1,3,0,1,1,1,0,-1,2,1,0
8,08147,Olesa de Montserrat,16750,484,269,215,46,31,15,85,76,207,64,19,24,56,31,121,40,10,10,29,45,86,24,9,14,6,13,19,4,2,2,5,9,14,2,1,0,1,4,5,2,1,2,616,342,274,188,118,70,88,112,276,76,21,35,53,56,157,49,8,14,35,56,119,27,13,21,39,47,70,27,1,2,24,28,47,18,0,1,15,19,23,9,1,1,622,309,313,175,91,84,98,140,270,57,20,33,48,88,128,22,5,15,50,52,142,35,15,18,34,53,59,25,1,3,15,27,34,12,1,2,19,26,25,13,0,1,454,196,258,75,41,34,53,102,225,22,16,30,13,45,108,13,5,6,40,57,117,9,11,24,16,28,13,8,6,3,8,19,4,6,2,1,8,9,9,2,4,2,656,333,323,222,128,94,61,122,332,46,55,36,42,39,191,24,18,18,19,83,141,22,37,18,46,53,94,21,6,1,23,35,58,11,1,0,23,18,36,10,5,1,389,193,196,242,106,136,61,139,155,50,2,-6,38,63,86,15,6,-11,23,76,69,35,-4,5,60,66,72,30,8,5,26,30,34,11,3,1,34,36,38,19,5,4,-114,-75,-39,167,72,95,-4,67,-100,-57,-22,0,-14,32,-50,-37,-16,4,10,35,-50,-20,-6,-4,35,48,65,9,7,0,14,24,31,0,2,0,21,24,34,9,5,0,192,69,123,214,97,117,0,123,14,-10,7,48,-16,43,28,-11,7,13,16,80,-14,1,0,35,47,69,37,38,13,3,22,27,19,16,6,2,25,42,18,22,7,1,205,94,111,152,75,77,39,66,67,17,2,4,32,32,27,8,0,-7,7,34,40,9,2,11,46,47,33,16,-1,6,31,20,12,9,0,3,15,27,21,7,-1,3,216,107,109,86,41,45,13,81,78,15,23,3,12,25,46,4,14,1,1,56,32,11,9,2,25,26,21,9,4,-2,23,9,14,-3,1,-3,2,17,7,12,3,1,153,37,116,58,28,30,38,43,42,1,-12,33,9,7,17,-2,-10,8,29,36,25,3,-2,25,24,13,20,6,-7,0,15,4,14,3,-8,-1,9,9,6,3,1,1,-196,-123,-73,-129,-83,-46,-60,13,-69,-76,-9,2,-34,-9,-24,-36,-13,-5,-26,22,-45,-40,4,7,-24,2,-56,-34,-16,-4,-16,-5,-31,-23,-9,-1,-8,7,-25,-11,-7,-3,-207,-135,-72,-112,-68,-44,-60,-2,-100,-61,-18,36,-41,11,-64,-37,-17,12,-19,-13,-36,-24,-1,24,-28,-1,-33,-41,-7,-2,-16,-4,-15,-28,-3,-3,-12,3,-18,-13,-4,1,-212,-151,-61,-136,-74,-62,-49,4,-41,-124,-21,22,-36,-4,-24,-86,-15,13,-13,8,-17,-38,-6,9,-25,-15,-27,-50,-14,-5,-8,-5,-21,-30,-9,-1,-17,-10,-6,-20,-5,-4,-37,-15,-22,-58,-34,-24,15,-23,-29,-42,7,26,5,-10,-20,-21,14,12,10,-13,-9,-21,-7,14,-10,-9,-18,-15,-8,0,-7,-1,-16,-9,-3,1,-3,-8,-2,-6,-5,-1,29,12,17,2,-15,17,16,23,11,-19,-6,6,21,13,8,-29,-5,1,-5,10,3,10,-1,5,-4,22,-3,-17,-3,5,-2,7,0,-17,-4,0,-2,15,-3,0,1,5,-69,-97,28,-16,-24,8,-26,8,-8,-52,-5,13,-27,-1,-10,-38,-17,-3,1,9,2,-14,12,16,-2,12,-10,-16,-2,0,-4,13,-10,-19,-1,-4,2,-1,0,3,-1,4,195,133,62,141,70,71,29,4,65,85,20,-6,19,11,31,55,9,6,10,-7,34,30,11,-12,13,27,39,41,11,9,2,11,24,23,3,6,11,16,15,18,8,3
8,08148,Olivella,1165,136,71,65,20,9,11,29,17,30,31,20,4,11,8,17,20,10,2,18,9,13,11,10,2,2,5,6,3,4,0,0,2,3,3,1,0,2,3,3,0,3,0,91,55,36,34,20,14,16,8,28,25,12,1,8,3,20,14,7,2,8,5,8,11,5,-1,8,5,10,9,1,0,6,1,7,4,1,0,2,4,3,5,0,0,171,105,66,41,22,19,42,17,50,38,8,12,24,13,36,20,6,6,18,4,14,18,2,6,8,5,7,12,5,3,6,3,5,7,1,0,2,2,2,5,4,3,275,131,144,50,27,23,61,22,85,66,19,13,32,13,30,34,10,7,29,9,55,32,9,6,10,9,12,12,6,0,5,4,4,7,6,0,5,5,8,5,0,0,153,86,67,67,39,28,24,6,52,47,17,1,12,0,25,39,6,0,12,6,27,8,11,1,17,10,11,22,5,2,10,3,5,18,2,1,7,7,6,4,3,1,244,131,113,48,24,24,34,24,107,41,30,-5,24,10,52,27,19,-5,10,14,55,14,11,0,11,7,13,6,10,0,7,1,6,4,6,0,4,6,7,2,4,0,316,174,142,53,28,25,74,24,100,73,20,10,35,12,52,42,16,6,39,12,48,31,4,4,12,10,17,12,-1,1,5,5,7,8,0,1,7,5,10,4,-1,0,256,137,119,70,31,39,43,10,95,58,38,4,17,10,50,32,19,3,26,0,45,26,19,1,15,11,17,20,4,0,3,5,5,13,2,0,12,6,12,7,2,0,167,82,85,31,14,17,32,15,61,32,13,7,21,7,17,21,7,5,11,8,44,11,6,2,14,5,5,4,-1,4,8,1,0,3,-1,3,6,4,5,1,0,1,42,0,42,-36,-25,-11,10,-13,51,-21,14,-6,-3,-10,23,-17,7,-6,13,-3,28,-4,7,0,9,-10,-7,-23,-3,-4,6,-5,-4,-17,-3,-4,3,-5,-3,-6,0,0,157,96,61,50,21,29,12,12,40,53,33,3,8,15,22,28,18,1,4,-3,18,25,15,2,11,4,3,18,12,-2,4,3,1,5,6,-1,7,1,2,13,6,-1,60,25,35,30,17,13,1,19,20,11,5,2,-1,17,3,6,0,-1,2,2,17,5,5,3,2,4,3,16,3,1,1,5,4,7,1,-1,1,-1,-1,9,2,2,-82,-48,-34,-78,-47,-31,-7,-13,4,-41,-25,-3,3,-10,1,-31,-10,-3,-10,-3,3,-10,-15,0,-22,-5,-6,-30,-19,2,-9,-4,-5,-21,-10,1,-13,-1,-1,-9,-9,1,-19,6,-25,4,7,-3,-18,-4,27,-14,-9,-1,-8,-6,21,-4,1,1,-10,2,6,-10,-10,-2,-6,2,2,4,4,0,-4,1,3,5,2,0,-2,1,-1,-1,2,0,-40,-13,-27,-2,5,-7,-12,-12,15,-13,-11,-8,4,-11,4,2,-7,-5,-16,-1,11,-15,-4,-3,2,-6,4,-3,0,0,6,-5,-1,5,0,0,-4,-1,5,-8,0,0,-28,-19,-9,6,6,0,-24,0,14,-14,-2,-4,-21,1,9,-4,-5,-1,-3,-1,5,-10,3,-3,-1,4,4,1,-6,3,-2,4,3,-1,-1,2,1,0,1,2,-5,1,57,27,30,22,12,10,19,2,23,21,-17,7,10,2,5,13,-8,5,9,0,18,8,-9,2,2,3,16,10,-10,0,2,2,8,6,-6,0,0,1,8,4,-4,0,101,58,43,23,21,2,11,15,15,60,-1,-3,8,7,8,39,0,-5,3,8,7,21,-1,2,-2,3,6,9,4,0,2,-2,6,8,3,2,-4,5,0,1,1,-2
8,08155,Palafolls,4940,308,157,151,18,11,7,51,49,97,52,30,28,31,18,65,23,17,4,20,31,32,29,13,24,2,4,5,5,1,1,2,3,2,3,1,0,0,1,3,2,0,1,286,147,139,18,10,8,40,47,85,50,24,34,24,22,55,25,8,11,16,25,30,25,16,23,0,5,8,3,1,1,0,2,3,3,1,1,0,3,5,0,0,0,284,146,138,44,22,22,51,56,87,65,12,11,28,26,48,37,2,6,23,30,39,28,10,5,8,12,11,10,4,-1,5,5,6,6,2,-2,3,7,5,4,2,1,276,136,140,40,19,21,48,40,103,36,26,22,28,15,49,23,16,5,20,25,54,13,10,17,9,8,8,8,4,3,5,2,5,4,3,0,4,6,3,4,1,3,397,175,222,77,28,49,33,72,178,55,17,29,16,28,79,29,8,9,17,44,99,26,9,20,14,9,32,18,2,2,7,3,12,5,0,1,7,6,20,13,2,1,414,197,217,56,23,33,40,96,173,35,46,24,22,30,99,17,25,9,18,66,74,18,21,15,10,23,15,4,3,1,5,7,5,4,2,0,5,16,10,0,1,1,421,205,216,79,27,52,66,98,143,45,32,32,33,42,74,25,15,13,33,56,69,20,17,19,13,21,27,15,2,1,8,4,10,4,0,1,5,17,17,11,2,0,207,133,74,18,18,0,-12,49,100,19,36,12,1,32,53,16,21,8,-13,17,47,3,15,4,3,13,12,-6,-1,-3,3,9,8,0,0,-2,0,4,4,-6,-1,-1,142,71,71,3,9,-6,28,17,62,9,23,0,14,1,36,7,13,-1,14,16,26,2,10,1,6,6,-16,0,6,0,2,5,-3,0,3,2,4,1,-13,0,3,-2,139,83,56,6,0,6,31,0,30,12,27,33,13,6,24,19,8,9,18,-6,6,-7,19,24,4,0,0,-3,3,1,3,-1,-4,1,-1,1,1,1,4,-4,4,0,123,58,65,-12,-13,1,-10,35,54,12,3,23,-11,17,34,-2,7,9,1,18,20,14,-4,14,-1,-7,3,-1,-7,0,-3,-4,1,-5,-3,1,2,-3,2,4,-4,-1,22,-2,24,21,7,14,16,3,-3,-3,7,8,0,2,-4,-1,2,2,16,1,1,-2,5,6,3,9,4,-2,2,4,0,3,0,0,2,2,3,6,4,-2,0,2,8,13,-5,10,6,4,-9,-4,21,-26,11,17,3,-2,5,-8,6,10,-12,-2,16,-18,5,7,2,9,6,-6,-2,1,1,5,4,-2,-2,0,1,4,2,-4,0,1,-31,-33,2,-17,-16,-1,5,-11,-19,0,3,-14,-4,-8,-12,-6,5,-11,9,-3,-7,6,-2,-3,-1,-10,-2,-4,-1,0,-3,-7,-4,-1,-1,-1,2,-3,2,-3,0,1,41,38,3,-3,-1,-2,-6,-6,8,5,17,22,5,1,16,-3,5,14,-11,-7,-8,8,12,8,2,7,-8,-7,1,2,1,3,-3,-3,0,1,1,4,-5,-4,1,1,12,47,-35,9,12,-3,-28,29,10,-21,1,22,1,19,14,4,1,5,-29,10,-4,-25,0,17,1,-2,8,3,-5,4,4,0,8,0,-2,2,-3,-2,0,3,-3,2,31,31,0,19,7,12,-13,-15,32,16,-4,14,-5,-3,26,8,1,5,-8,-12,6,8,-5,9,5,0,4,8,4,-2,1,-2,4,5,0,-1,4,2,0,3,4,-1,96,27,69,25,7,18,29,25,31,-13,4,16,18,13,13,-16,-3,2,11,12,18,3,7,14,7,7,4,4,5,-3,5,3,-1,-2,1,0,2,4,5,6,4,-3
8,08156,Palau-solità i Plegamans,10760,275,139,136,53,31,22,64,44,71,60,10,19,44,15,31,35,7,2,20,29,40,25,3,17,9,12,22,8,2,0,6,5,15,4,1,0,3,7,7,4,1,0,83,54,29,33,19,14,25,13,38,-1,-9,17,25,10,4,8,-3,7,0,3,34,-9,-6,10,3,5,13,10,2,0,2,4,8,4,1,0,1,1,5,6,1,0,234,119,115,127,72,55,41,17,110,25,3,31,18,18,43,20,4,11,23,-1,67,5,-1,20,25,35,48,14,3,2,15,20,27,8,2,0,10,15,21,6,1,2,396,176,220,114,47,67,85,41,160,62,8,29,33,13,81,34,-1,13,52,28,79,28,9,16,33,17,39,13,7,3,15,6,19,4,1,2,18,11,20,9,6,1,268,151,117,139,77,62,60,9,136,51,18,-11,35,11,66,32,14,-8,25,-2,70,19,4,-3,17,41,47,25,4,3,10,20,28,16,1,2,7,21,19,9,3,1,310,184,126,135,95,40,24,26,148,12,36,47,18,26,79,13,24,14,6,0,69,-1,12,33,25,27,44,28,7,3,19,19,32,19,4,2,6,8,12,9,3,1,305,121,184,105,56,49,71,12,95,32,10,77,43,2,34,12,4,24,28,10,61,20,6,53,28,16,33,18,7,2,19,10,16,7,3,0,9,6,17,11,4,2,219,81,138,92,46,46,53,1,74,36,12,43,24,-1,27,17,-2,18,29,2,47,19,14,25,15,29,32,12,4,-1,9,16,16,6,0,-2,6,13,16,6,4,1,100,20,80,75,25,50,31,22,-19,17,-5,50,17,2,-20,0,-4,23,14,20,1,17,-1,27,23,23,18,6,2,2,14,9,5,-4,1,0,9,14,13,10,1,2,92,64,28,0,7,-7,17,-14,10,23,1,51,14,3,0,23,4,15,3,-17,10,0,-3,36,2,-1,1,0,-1,-1,2,-1,4,1,1,0,0,0,-3,-1,-2,-1,145,25,120,-26,-24,-2,21,-27,32,19,-1,93,-3,-6,-4,3,-1,31,24,-21,36,16,0,62,-5,4,-10,-11,-1,-3,-5,2,-10,-7,-2,-2,0,2,0,-4,1,-1,96,25,71,-26,-18,-8,24,-4,27,-12,13,40,-3,-3,16,-15,11,16,27,-1,11,3,2,24,0,2,-13,-10,0,-6,-4,-1,-5,-8,1,-2,4,3,-8,-2,-1,-4,-23,-29,6,-32,-12,-20,-13,-6,6,-28,-27,32,-3,-3,-9,-7,-20,8,-10,-3,15,-21,-7,24,-10,-2,-12,-9,-1,0,-2,0,-5,-5,0,0,-8,-2,-7,-4,-1,0,14,-48,62,-35,-27,-8,17,-19,-15,-3,1,35,7,-26,-25,-4,-1,4,10,7,10,1,2,31,-3,-2,-21,-6,-3,0,1,-6,-15,-6,-2,1,-4,4,-6,0,-1,-1,-34,-42,8,-17,-5,-12,10,-31,-16,-9,-24,36,6,-13,-22,-10,-15,15,4,-18,6,1,-9,21,-7,-5,0,-6,-1,0,-1,-3,0,-1,-1,0,-6,-2,0,-5,0,0,50,54,-4,18,4,14,17,17,6,9,-29,31,16,9,12,28,-9,-2,1,8,-6,-19,-20,33,5,11,12,-8,-5,2,2,4,6,-5,-3,0,3,7,6,-3,-2,2,147,38,109,40,18,22,37,7,18,25,18,36,7,2,11,8,6,0,30,5,7,17,12,36,7,14,-1,11,6,3,3,10,-1,2,2,2,4,4,0,9,4,1,54,5,49,55,28,27,10,9,7,20,-24,31,9,7,-3,6,-13,-1,1,2,10,14,-11,32,9,17,13,2,9,5,7,8,6,2,2,3,2,9,7,0,7,2
8,08905,"Palma de Cervelló, La",2519,95,54,41,25,16,9,0,16,39,12,2,21,1,10,26,3,3,7,-1,6,13,9,-1,14,2,5,11,6,1,0,1,3,9,2,1,0,1,2,2,4,0,0,104,55,49,15,10,5,18,15,28,0,15,28,8,9,17,3,11,7,10,6,11,-3,4,21,6,2,3,4,0,0,4,1,3,2,0,0,2,1,0,2,0,0,75,36,39,20,16,4,11,11,22,17,6,8,-1,10,9,12,5,2,12,1,13,5,1,6,3,4,7,6,0,0,2,3,5,6,0,0,1,1,2,0,0,0,18,-5,23,42,20,22,7,5,5,-1,-5,6,-3,-1,6,-3,-5,-2,10,6,-1,2,0,8,6,17,11,7,1,0,2,8,7,3,0,0,4,9,4,4,1,0,56,24,32,48,25,23,-4,11,17,11,11,10,-2,2,4,8,7,5,-2,9,13,3,4,5,7,12,16,11,2,0,4,5,8,6,2,0,3,7,8,5,0,0,51,23,28,48,23,25,5,10,36,-9,-2,8,1,1,23,-4,0,-1,4,9,13,-5,-2,9,11,16,14,5,0,0,8,4,8,1,0,0,3,12,6,4,0,0,42,15,27,74,33,41,11,17,12,4,2,-4,8,4,6,1,1,-3,3,13,6,3,1,-1,12,22,21,13,5,1,3,6,10,10,4,0,9,16,11,3,1,1,7,-13,20,45,22,23,7,0,-8,7,-7,8,-1,-2,-7,0,-7,4,8,2,-1,7,0,4,6,14,13,9,3,1,3,5,10,3,1,1,3,9,3,6,2,0,-1,3,-4,2,0,2,-17,3,16,-8,0,4,-9,-1,13,3,-3,-1,-8,4,3,-11,3,5,-8,10,9,-4,-4,0,-5,2,8,-1,-3,0,-3,8,1,-3,-1,0,-7,-1,-6,22,8,14,-8,10,12,-19,-4,-3,-1,2,8,-13,-2,2,-7,8,4,-6,-2,-5,5,3,11,2,0,0,2,0,5,1,0,0,3,3,6,1,0,0,-11,-5,-6,22,11,11,1,1,-13,1,-4,1,-6,5,-2,-2,-2,0,7,-4,-11,3,-2,1,5,6,5,5,1,0,3,2,2,3,1,0,2,4,3,2,0,0,-4,2,-6,6,5,1,5,-4,8,1,-14,1,4,2,-1,5,-7,0,1,-6,9,-4,-7,1,5,-1,3,0,0,-2,3,2,-1,1,0,0,2,-3,4,-1,0,-2,-87,-46,-41,-75,-35,-40,-6,-8,-38,-21,-10,-4,-1,-5,-21,-12,-6,-1,-5,-3,-17,-9,-4,-3,-6,-9,-34,-15,-12,1,-2,-5,-12,-8,-7,-1,-4,-4,-22,-7,-5,2,-8,-16,8,12,1,11,-2,-5,5,1,-7,0,-4,-4,1,0,-7,-2,2,-1,4,1,0,2,4,3,1,1,3,0,2,1,-3,0,1,0,2,2,4,1,2,0,-48,-18,-30,-7,-5,-2,-30,-1,10,-16,-4,-5,-21,2,12,-6,-3,-2,-9,-3,-2,-10,-1,-3,-1,-1,-2,-2,-2,1,0,0,-1,-2,-2,0,-1,-1,-1,0,0,1,39,5,34,5,1,4,-1,3,1,-2,3,33,0,-4,-2,-2,-1,15,-1,7,3,0,4,18,2,2,-5,6,1,-1,2,0,-2,1,0,0,0,2,-3,5,1,-1,-1,-14,13,5,-2,7,-1,2,9,-15,2,3,-8,1,1,-9,-3,5,7,1,8,-6,5,-2,5,4,-1,-4,-1,2,0,4,0,-6,-1,1,5,0,-1,2,0,1,-15,-7,-8,15,6,9,-1,6,0,-4,0,-13,0,2,1,-6,1,-3,-1,4,-1,2,-1,-10,3,4,5,3,1,-1,1,0,4,0,1,0,2,4,1,3,0,-1
8,08158,"Papiol, El",3434,-15,8,-23,30,20,10,-2,-10,-1,0,-1,0,-2,-5,11,-1,1,4,0,-5,-12,1,-2,-4,7,4,14,4,0,1,5,2,10,2,0,1,2,2,4,2,0,0,44,38,6,29,21,8,5,15,22,5,-5,3,4,10,23,4,-3,1,1,5,-1,1,-2,2,6,7,9,7,0,0,4,4,8,5,0,0,2,3,1,2,0,0,-11,1,-12,1,2,-1,-1,-4,14,-8,-8,-9,-1,1,9,-5,-2,-3,0,-5,5,-3,-6,-6,0,1,1,0,0,-1,0,1,1,0,0,0,0,0,0,0,0,-1,20,16,4,2,2,0,12,-5,15,2,2,-4,9,-4,6,3,1,0,3,-1,9,-1,1,-4,1,0,2,-1,0,0,1,0,2,-1,0,0,0,0,0,0,0,0,34,15,19,34,17,17,6,10,15,8,-1,-4,-4,8,10,5,-3,0,10,2,5,3,2,-4,7,9,9,5,3,0,0,6,6,4,1,0,7,3,3,1,2,0,31,21,10,23,14,9,2,6,35,0,-4,-8,2,4,21,-2,-1,-3,0,2,14,2,-3,-5,2,7,7,5,2,0,2,5,4,2,1,0,0,2,3,3,1,0,53,23,30,41,14,27,8,9,36,-5,-3,7,-1,3,26,-9,0,3,9,6,10,4,-3,4,19,7,6,3,2,3,7,1,3,1,1,1,12,6,3,2,1,2,44,26,18,29,13,16,28,11,4,11,-3,-9,9,7,3,12,-3,-1,19,4,1,-1,0,-8,12,3,9,4,0,0,2,2,4,5,0,0,10,1,5,-1,0,0,35,9,26,21,5,16,10,15,10,-2,-1,3,11,6,-2,-4,-2,-2,-1,9,12,2,1,5,1,11,0,4,4,1,0,4,-1,2,1,-1,1,7,1,2,3,2,16,2,14,8,-2,10,16,15,-8,-7,10,-12,7,9,-1,-12,5,-5,9,6,-7,5,5,-7,4,0,6,-3,1,-1,0,-1,3,-3,-1,0,4,1,3,0,2,-1,-18,-15,-3,-14,-14,0,3,-13,-2,-7,0,1,1,-8,2,-13,2,0,2,-5,-4,6,-2,1,-1,-5,-2,-6,-1,1,-2,-6,-2,-5,0,1,1,1,0,-1,-1,0,62,31,31,10,2,8,4,8,29,13,4,3,4,2,10,11,2,1,0,6,19,2,2,2,1,5,2,2,0,-1,0,3,1,-1,0,-1,1,2,1,3,0,0,26,16,10,-11,-5,-6,10,-2,7,13,4,-8,10,3,5,1,1,-5,0,-5,2,12,3,-3,1,-2,-7,-3,0,0,2,0,-3,-5,0,1,-1,-2,-4,2,0,-1,-16,-16,0,-11,-4,-7,-3,8,-10,-3,4,-10,0,3,-8,-6,3,-7,-3,5,-2,3,1,-3,-3,-1,-5,-1,-1,-2,0,0,-4,-2,0,0,-3,-1,-1,1,-1,-2,27,23,4,10,3,7,9,12,15,-5,-5,1,6,6,12,-2,0,2,3,6,3,-3,-5,-1,2,2,5,2,0,-1,2,1,1,-1,0,0,0,1,4,3,0,-1,-24,-17,-7,-7,-5,-2,-15,6,-4,12,-11,-18,-12,7,-4,6,-8,-9,-3,-1,0,6,-3,-9,-3,-1,1,-1,-1,-2,-1,0,-1,-1,-1,-1,-2,-1,2,0,0,-1,13,2,11,-3,-6,3,3,10,2,13,-6,-12,-5,7,3,7,-3,-10,8,3,-1,6,-3,-2,3,1,-8,1,0,0,0,1,-3,-3,0,-1,3,0,-5,4,0,1,9,9,0,9,5,4,8,13,19,-15,-4,-11,4,5,16,-13,-1,-1,4,8,3,-2,-3,-10,8,6,0,-2,-3,0,5,3,0,-3,0,0,3,3,0,1,-3,0
8,08159,Parets del Vallès,14008,313,183,130,128,92,36,15,111,108,20,31,24,5,71,82,4,11,8,10,40,26,16,20,16,13,44,57,14,0,0,6,32,45,9,0,0,7,12,12,5,0,0,278,124,154,180,113,67,22,84,113,37,-1,22,0,30,70,17,2,6,22,54,43,20,-3,16,27,45,81,22,5,0,13,27,57,14,2,0,14,18,24,8,3,0,305,152,153,209,124,85,39,93,111,20,13,22,11,57,68,12,-2,7,28,36,43,8,15,15,46,61,68,26,4,2,18,42,43,19,1,0,28,19,25,7,3,2,57,30,27,154,89,65,-22,62,18,-9,-5,12,-10,23,18,-2,-3,4,-12,39,0,-7,-2,8,28,48,48,24,3,2,12,29,29,17,1,1,16,19,19,7,2,1,125,89,36,184,127,57,5,77,34,8,-13,17,17,51,24,1,-6,6,-12,26,10,7,-7,11,12,63,75,26,7,1,9,48,49,17,3,1,3,15,26,9,4,0,193,142,51,183,129,54,-4,107,48,24,5,6,3,52,51,22,3,11,-7,55,-3,2,2,-5,17,56,67,30,6,5,12,38,47,25,3,2,5,18,20,5,3,3,154,49,105,43,-22,65,45,52,39,-15,-13,33,39,21,-5,-19,-11,14,6,31,44,4,-2,19,25,34,-11,-8,2,0,11,21,-26,-24,-4,-1,14,13,15,16,6,1,316,200,116,205,135,70,29,96,112,45,12,14,17,44,78,36,11,4,12,52,34,9,1,10,33,78,61,25,5,0,14,48,48,19,4,0,19,30,13,6,1,0,91,33,58,-47,-52,5,19,49,37,8,-1,-18,20,17,12,-2,-4,-9,-1,32,25,10,3,-9,5,5,-40,-12,-6,-1,2,4,-38,-14,-8,0,3,1,-2,2,2,-1,24,41,-17,24,-8,32,13,16,46,-22,-27,-1,11,13,45,-17,-15,5,2,3,1,-5,-12,-6,19,12,-2,-6,-5,3,10,-1,-6,-8,-7,2,9,13,4,2,2,1,246,111,135,40,13,27,19,37,120,41,10,14,10,3,71,16,4,5,9,34,49,25,6,9,2,17,4,14,1,1,2,6,2,3,1,-1,0,11,2,11,0,2,310,143,167,49,10,39,67,67,109,33,29,0,40,26,43,19,6,5,27,41,66,14,23,-5,5,18,14,1,6,2,3,9,-5,1,0,1,2,9,19,0,6,1,8,-20,28,-32,-20,-12,0,46,-10,-31,-30,29,-7,27,-22,-15,-17,13,7,19,12,-16,-13,16,-1,11,-34,-2,-4,-4,4,7,-24,-4,-3,0,-5,4,-10,2,-1,-4,49,47,2,-4,3,-7,-26,39,27,-1,-1,13,-11,29,35,-10,1,4,-15,10,-8,9,-2,9,-9,8,-1,-6,-1,5,0,2,1,-4,2,2,-9,6,-2,-2,-3,3,112,71,41,5,6,-1,32,11,24,30,5,6,31,0,23,14,4,-1,1,11,1,16,1,7,2,0,0,4,-4,1,2,-5,9,2,-2,0,0,5,-9,2,-2,1,-119,-44,-75,-2,-17,15,1,1,-33,-71,-34,12,4,8,-13,-45,-19,18,-3,-7,-20,-26,-15,-6,16,17,0,-29,-10,3,6,13,-3,-25,-9,1,10,4,3,-4,-1,2,119,39,80,63,24,39,39,33,19,5,4,18,16,25,-3,1,-5,5,23,8,22,4,9,13,8,19,17,6,7,2,-1,12,7,2,2,0,9,7,10,4,5,2,32,3,29,72,41,31,0,-8,34,10,-2,0,-5,-1,15,3,0,-5,5,-7,19,7,-2,5,5,14,24,13,10,6,6,8,13,7,6,1,-1,6,11,6,4,5
8,08161,Piera,8031,529,278,251,8,3,5,107,60,149,89,60,56,62,35,73,50,31,24,45,25,76,39,29,32,2,0,0,1,1,4,0,0,0,0,0,3,2,0,0,1,1,1,441,224,217,10,7,3,105,49,141,69,32,49,57,18,72,42,22,13,48,31,69,27,10,36,4,1,3,2,0,0,3,0,2,2,0,0,1,1,1,0,0,0,551,279,272,31,14,17,74,62,150,87,54,123,44,28,82,48,33,43,30,34,68,39,21,80,12,5,10,2,0,2,3,2,7,0,0,2,9,3,3,2,0,0,781,408,373,15,5,10,121,109,233,126,89,98,71,55,128,74,48,32,50,54,105,52,41,66,7,1,5,0,0,2,3,0,3,-1,0,0,4,1,2,1,0,2,708,340,368,46,16,30,126,67,273,91,91,47,56,24,156,32,38,25,70,43,117,59,53,22,7,9,19,6,2,2,3,4,7,1,0,1,4,5,12,5,2,1,663,355,308,59,31,28,132,90,224,100,61,45,63,51,122,71,29,15,69,39,102,29,32,30,16,15,13,11,3,0,8,7,7,5,3,0,8,8,6,6,0,0,609,286,323,77,41,36,117,72,196,86,87,47,60,19,105,50,43,9,57,53,91,36,44,38,16,23,18,11,8,1,10,10,12,5,4,0,6,13,6,6,4,1,336,187,149,99,52,47,65,53,127,48,7,26,34,30,82,27,1,7,31,23,45,21,6,19,29,27,20,18,3,0,13,12,11,15,0,0,16,15,9,3,3,0,286,144,142,91,31,60,71,41,63,35,48,26,39,10,34,18,28,15,32,31,29,17,20,11,26,22,31,7,0,2,12,8,12,-3,0,1,14,14,19,10,0,1,221,125,96,47,30,17,13,37,68,27,23,50,14,8,44,23,12,20,-1,29,24,4,11,30,2,13,16,13,2,0,0,6,12,10,1,0,2,7,4,3,1,0,244,123,121,47,19,28,60,10,64,33,44,29,35,10,24,13,29,11,25,0,40,20,15,18,20,5,7,11,1,0,11,1,2,4,-1,0,9,4,5,7,2,0,69,41,28,15,6,9,-18,17,64,-30,-4,39,-18,18,54,-16,-12,18,0,-1,10,-14,8,21,10,2,7,-5,-2,3,3,2,4,-3,-1,1,7,0,3,-2,-1,2,57,30,27,-15,-15,0,7,-3,3,1,11,34,21,-5,-6,3,1,15,-14,2,9,-2,10,19,-4,-1,-11,-3,1,2,-4,-1,-9,1,-3,0,0,0,-2,-4,4,2,-95,-50,-45,-56,-27,-29,-53,-8,-27,-42,19,17,-28,4,-12,-27,14,-1,-25,-12,-15,-15,5,18,-6,0,-15,-21,-7,-7,-3,2,-5,-14,-4,-3,-3,-2,-10,-7,-3,-4,-10,-8,-2,24,19,5,1,-39,10,-14,0,33,-15,-24,20,-14,5,19,16,-15,-10,0,-5,14,4,7,9,-3,0,6,3,4,8,0,0,3,1,3,1,-3,0,3,33,38,-5,33,17,16,-35,7,17,3,-17,53,-4,8,16,-2,-7,19,-31,-1,1,5,-10,34,8,7,17,2,0,-2,4,2,11,2,0,-2,4,5,6,0,0,0,185,89,96,28,9,19,57,-5,59,7,39,27,48,2,19,0,19,-3,9,-7,40,7,20,30,4,12,13,-3,4,-4,2,8,7,-4,-2,-3,2,4,6,1,6,-1,196,117,79,82,50,32,9,-11,65,69,38,27,2,-8,44,53,18,10,7,-3,21,16,20,17,14,12,19,18,11,6,5,9,15,11,5,4,9,3,4,7,6,2
8,08163,Pineda de Mar,19209,466,260,206,155,99,56,13,80,94,82,137,62,7,47,74,49,66,20,6,33,20,33,71,42,20,40,51,30,8,3,9,22,42,18,6,0,11,18,9,12,2,3,898,473,425,451,269,182,135,171,287,112,92,89,79,83,171,58,41,34,56,88,116,54,51,55,83,104,160,63,22,15,47,59,107,35,11,9,36,45,53,28,11,6,798,432,366,435,270,165,63,153,265,122,133,58,38,98,158,51,63,23,25,55,107,71,70,35,46,126,146,69,35,10,22,74,112,39,17,6,24,52,34,30,18,4,757,394,363,409,231,178,48,150,170,137,163,79,34,71,92,83,81,28,14,79,78,54,82,51,67,115,119,55,38,11,39,62,75,34,19,2,28,53,44,21,19,9,979,570,409,577,355,222,86,235,261,182,120,84,35,152,183,98,63,38,51,83,78,84,57,46,68,170,188,98,40,12,34,102,135,59,19,6,34,68,53,39,21,6,770,486,284,551,325,226,137,185,170,153,65,49,83,127,99,103,41,27,54,58,71,50,24,22,91,161,167,93,19,11,44,94,105,61,10,7,47,67,62,32,9,4,301,108,193,356,193,163,24,56,77,34,55,58,4,19,39,11,22,16,20,37,38,23,33,42,55,101,117,54,10,14,24,52,74,30,6,6,31,49,43,24,4,8,201,63,138,342,178,164,52,110,-13,6,31,15,22,74,-30,0,1,0,30,36,17,6,30,15,67,144,89,28,12,1,28,86,53,11,2,-2,39,58,36,17,10,3,204,103,101,211,94,117,43,68,94,0,2,-4,15,48,50,-7,-2,1,28,20,44,7,4,-5,60,91,63,7,-4,-5,26,46,29,-1,-3,-3,34,45,34,8,-1,-2,-218,-144,-74,-32,-45,13,-24,-23,-121,-41,-28,17,-14,-10,-62,-42,-22,6,-10,-13,-59,1,-6,11,-2,35,-15,-39,-10,-6,5,14,-28,-25,-12,0,-7,21,13,-14,2,-6,9,-23,32,55,49,6,5,-13,-28,-21,19,49,-7,-8,-26,-6,11,18,12,-5,-2,-15,8,31,16,21,-2,8,3,7,16,18,-4,10,4,4,0,3,2,-2,-1,3,-3,-62,59,7,-16,23,13,18,-88,-12,-5,65,14,3,-61,-33,-4,17,-1,15,-27,21,-1,48,22,28,-31,-12,-8,3,13,15,-21,-14,-10,-1,9,13,-10,2,2,4,47,30,17,38,23,15,4,-16,-14,-30,31,63,11,-10,6,-27,19,24,-7,-6,-20,-3,12,39,21,18,9,-24,6,6,14,8,5,-13,2,5,7,10,4,-11,4,1,-160,-85,-75,-267,-153,-114,-24,0,-92,-71,24,8,-25,11,-41,-39,9,0,1,-11,-51,-32,15,8,-33,-7,-86,-74,-36,-30,-15,-4,-54,-45,-17,-17,-18,-3,-32,-29,-19,-13,96,69,27,5,-8,13,12,22,-5,10,9,42,19,11,-8,15,2,31,-7,11,3,-5,7,11,6,13,-17,-6,-3,9,3,4,-13,-4,-3,4,3,9,-4,-2,0,5,293,156,137,145,64,81,50,54,20,97,37,24,23,23,8,67,18,14,27,31,12,30,19,10,34,40,6,27,25,10,16,18,-3,17,10,5,18,22,9,10,15,5,207,71,136,65,19,46,21,25,60,-14,49,61,15,19,18,-26,16,23,6,6,42,12,33,38,35,21,23,-22,4,0,19,9,18,-19,-6,-4,16,12,5,-3,10,4,374,173,201,171,75,96,41,54,23,113,75,64,29,25,22,47,27,24,12,29,1,66,48,40,27,48,30,33,20,8,13,21,14,17,9,0,14,27,16,16,11,8
8,08165,"Pobla de Claramunt, La",1657,27,13,14,12,4,8,3,7,5,7,7,-2,0,3,3,5,1,0,3,4,2,2,6,-2,5,1,3,1,2,0,2,0,2,0,0,0,3,1,1,1,2,0,69,39,30,26,17,9,12,13,31,10,3,0,5,9,17,6,4,-2,7,4,14,4,-1,2,6,6,6,6,2,0,3,5,2,5,2,0,3,1,4,1,0,0,56,31,25,44,26,18,11,22,26,3,0,-8,5,9,20,0,-1,-3,6,13,6,3,1,-5,7,12,17,2,3,1,2,5,15,1,2,0,5,7,2,1,1,1,74,50,24,31,24,7,10,8,36,5,8,2,10,5,17,8,5,3,0,3,19,-3,3,-1,7,3,12,4,4,1,6,3,8,3,3,1,1,0,4,1,1,0,81,45,36,51,26,25,13,23,28,17,3,-4,9,19,15,3,0,-1,4,4,13,14,3,-3,10,11,20,6,3,1,6,6,10,3,1,0,4,5,10,3,2,1,34,32,2,30,17,13,-2,11,11,4,4,2,-4,9,13,10,0,2,2,2,-2,-6,4,0,2,8,8,6,5,0,1,5,4,5,1,0,1,3,4,1,4,0,107,51,56,44,20,24,17,30,33,19,8,-3,-1,14,21,13,5,-1,18,16,12,6,3,-2,10,13,9,9,2,1,4,5,5,6,0,0,6,8,4,3,2,1,5,-7,12,9,-3,12,8,8,1,-4,-3,-4,8,-2,-8,-4,-1,1,0,10,9,0,-2,-5,3,2,1,4,-1,0,1,0,-3,1,-2,0,2,2,4,3,1,0,33,1,32,11,4,7,14,18,-5,2,1,4,6,7,-10,-5,2,1,8,11,5,7,-1,3,0,8,-1,2,2,0,0,4,-3,1,2,0,0,4,2,1,0,0,16,15,1,-4,-2,-2,2,7,-6,3,2,6,4,5,0,0,2,3,-2,2,-6,3,0,3,0,-4,-2,0,1,0,1,-4,1,-1,1,0,-1,0,-3,1,0,0,-30,-30,0,-15,-13,-2,-3,-2,-23,0,-1,-2,-6,1,-17,-5,-1,-2,3,-3,-6,5,0,0,2,-3,-10,1,-3,-2,1,-2,-9,0,-2,-1,1,-1,-1,1,-1,-1,-20,-14,-6,-3,-1,-2,-1,-8,-9,-3,-5,5,7,-8,-8,-3,-2,2,-8,0,-1,0,-3,3,0,1,-3,2,-3,0,0,0,-1,2,-2,0,0,1,-2,0,-1,0,-33,-17,-16,-4,1,-5,-10,0,2,-13,4,-13,-2,0,5,-10,0,-7,-8,0,-3,-3,4,-6,-1,-2,2,-3,0,0,3,-1,2,-3,0,0,-4,-1,0,0,0,0,-31,-24,-7,-24,-12,-12,-13,2,-4,-7,0,-10,-10,-2,0,-9,-2,-4,-3,4,-4,2,2,-6,-8,-2,-1,-5,-5,-3,-2,-2,-1,-3,-3,-1,-6,0,0,-2,-2,-2,-35,0,-35,-1,3,-4,-16,-7,-8,-9,2,1,-2,-1,1,-3,2,1,-14,-6,-9,-6,0,0,-1,-2,-4,5,1,0,-1,0,1,2,1,0,0,-2,-5,3,0,0,9,5,4,7,3,4,5,-8,9,13,-9,-1,2,-4,6,8,-6,-1,3,-4,3,5,-3,0,1,0,4,1,1,0,0,-1,4,-1,1,0,1,1,0,2,0,0,35,18,17,12,10,2,13,5,1,14,2,-1,11,4,1,7,-2,-3,2,1,0,7,4,2,1,1,4,3,3,0,1,2,4,2,1,0,0,-1,0,1,2,0,-7,-4,-3,-1,-1,0,2,6,5,-12,-1,-7,-1,9,-2,-7,1,-4,3,-3,7,-5,-2,-3,0,5,-2,-5,-1,1,-1,4,-3,-2,0,0,1,1,1,-3,-1,1
8,08167,Polinyà,4412,87,63,24,18,12,6,-2,33,49,-1,-1,10,2,17,32,6,4,2,-4,16,17,-7,-5,8,2,5,7,2,0,1,2,1,6,2,0,1,0,4,1,0,0,0,400,209,191,52,25,27,57,90,169,50,17,10,31,41,98,26,5,3,26,49,71,24,12,7,12,11,20,6,3,0,8,4,9,4,0,0,4,7,11,2,3,0,224,102,122,44,21,23,9,77,96,22,15,6,4,29,47,12,8,3,5,48,49,10,7,3,2,14,21,3,3,0,0,8,11,0,2,0,2,6,10,3,1,0,282,132,150,40,18,22,28,60,130,30,24,10,-2,24,76,17,12,2,30,36,54,13,12,8,10,8,10,9,3,1,2,5,4,6,1,0,8,3,6,3,2,1,463,250,213,74,35,39,57,97,230,44,19,11,34,45,131,28,9,2,23,52,99,16,10,9,17,11,21,17,6,1,6,4,13,10,2,0,11,7,8,7,4,1,210,106,104,50,24,26,-7,76,137,-5,1,9,5,27,80,-8,0,-1,-12,49,57,3,1,10,2,19,18,9,0,1,1,6,11,6,0,0,1,13,7,3,0,1,261,133,128,80,42,38,19,106,109,21,-3,3,-3,48,67,18,-5,3,22,58,42,3,2,0,16,24,25,11,3,0,7,11,17,6,0,0,9,13,8,5,3,0,209,126,83,63,32,31,27,36,112,20,5,9,13,12,76,13,5,3,14,24,36,7,0,6,7,17,22,13,2,2,3,4,14,9,1,1,4,13,8,4,1,1,165,79,86,54,35,19,12,58,49,22,12,10,5,27,20,12,5,5,7,31,29,10,7,5,11,14,14,13,1,1,8,10,9,8,0,0,3,4,5,5,1,1,42,19,23,45,21,24,4,21,2,11,2,4,5,9,5,3,-4,0,-1,12,-3,8,6,4,16,10,13,5,0,1,8,3,8,2,0,0,8,7,5,3,0,1,98,42,56,38,21,17,12,40,25,15,-6,5,3,16,15,4,-2,4,9,24,10,11,-4,1,9,12,15,2,-1,1,6,5,7,2,0,1,3,7,8,0,-1,0,2,2,0,9,6,3,-11,25,-9,-7,6,-3,2,13,-16,-2,2,2,-13,12,7,-5,4,-5,5,5,0,-1,1,-1,4,2,-1,0,1,0,1,3,1,-1,0,-1,-44,-15,-29,0,-3,3,-9,-19,-7,-4,0,-3,-3,-10,6,-7,3,-2,-6,-9,-13,3,-3,-1,1,3,-5,-3,2,1,-1,0,-1,-2,1,0,2,3,-4,-1,1,1,12,-14,26,-11,-6,-5,1,14,15,-26,-3,10,-7,2,6,-14,-7,3,8,12,9,-12,4,7,1,3,-7,-4,-2,-2,1,1,-5,-1,-2,0,0,2,-2,-3,0,-2,-77,-19,-58,-12,-9,-3,-35,2,-16,-35,1,6,-3,0,-4,-15,0,5,-32,2,-12,-20,1,1,-4,4,-1,-10,0,-1,-1,0,-2,-5,0,-1,-3,4,1,-5,0,0,23,11,12,12,6,6,2,1,4,12,-5,-1,-6,6,2,8,-4,1,8,-5,2,4,-1,-2,5,7,2,1,0,-3,3,5,1,0,-2,-1,2,2,1,1,2,-2,41,2,39,9,-4,13,3,24,21,-18,4,0,7,16,15,-24,-6,-6,-4,8,6,6,10,6,4,2,9,-3,-2,-1,0,1,6,-7,-3,-1,4,1,3,4,1,0,-37,-27,-10,46,24,22,-31,5,25,-35,1,-2,-22,4,7,-13,3,-8,-9,1,18,-22,-2,6,7,11,19,2,1,6,4,8,11,0,-1,2,3,3,8,2,2,4
8,08182,"Pont de Vilomara i Rocafort, El",2578,61,34,27,2,1,1,12,0,21,15,12,0,8,-1,13,8,7,-1,4,1,8,7,5,1,0,0,1,1,0,0,0,0,0,1,0,0,0,0,1,0,0,0,73,40,33,21,14,7,9,14,28,9,9,4,5,5,20,7,3,0,4,9,8,2,6,4,4,4,10,3,0,0,2,3,7,2,0,0,2,1,3,1,0,0,85,43,42,31,16,15,16,24,21,33,-5,-6,1,12,15,22,-3,-4,15,12,6,11,-2,-2,3,12,8,6,1,0,2,4,5,5,0,0,1,8,3,1,1,0,151,74,77,52,25,27,46,12,40,32,15,5,23,4,22,19,7,-1,23,8,18,13,8,6,7,17,13,13,2,0,1,8,6,9,1,0,6,9,7,4,1,0,163,85,78,39,23,16,36,34,50,25,9,9,19,19,27,8,8,3,17,15,23,17,1,6,4,14,12,9,0,0,3,9,9,2,0,0,1,5,3,7,0,0,152,82,70,31,13,18,47,19,50,14,15,5,32,13,25,1,9,3,15,6,25,13,6,2,13,7,6,5,1,-1,7,6,2,-1,0,-1,6,1,4,6,1,0,197,102,95,44,20,24,53,14,73,31,19,0,24,6,38,18,10,2,29,8,35,13,9,-2,13,7,13,7,3,1,7,2,4,5,1,1,6,5,9,2,2,0,97,54,43,48,31,17,-1,25,18,30,17,7,-4,7,16,20,10,3,3,18,2,10,7,4,6,17,11,11,1,2,1,9,9,10,1,1,5,8,2,1,0,1,49,12,37,13,9,4,-5,22,8,10,7,5,-7,7,0,7,5,0,2,15,8,3,2,5,-4,5,4,4,3,1,0,4,2,1,2,0,-4,1,2,3,1,1,37,20,17,3,0,3,5,0,20,-5,10,5,6,5,10,-9,5,0,-1,-5,10,4,5,5,-2,1,0,0,1,0,-1,1,-1,-1,0,0,-1,0,1,1,1,0,-30,-12,-18,-55,-25,-30,5,-6,-11,11,-25,-6,-3,-2,-6,12,-10,-4,8,-4,-5,-1,-15,-2,-7,-5,-16,-6,-18,-3,-4,-3,-7,-4,-6,-1,-3,-2,-9,-2,-12,-2,18,8,10,14,10,4,10,3,7,-12,7,3,0,1,7,-9,7,1,10,2,0,-3,0,2,3,3,5,1,3,-1,3,0,5,0,2,0,0,3,0,1,1,-1,-12,0,-12,-2,-5,3,0,8,-12,-1,-1,-5,3,2,-2,4,-2,-3,-3,6,-10,-5,1,-2,2,1,-1,-4,0,0,0,0,-1,-4,0,0,2,1,0,0,0,0,13,-12,25,7,0,7,2,-11,18,-4,6,-2,-5,-4,5,-9,1,0,7,-7,13,5,5,-2,4,2,2,-1,1,-1,1,2,-1,-1,0,-1,3,0,3,0,1,0,-75,-47,-28,-28,-22,-6,-21,6,-22,-29,-12,5,-9,-5,-12,-20,-3,2,-12,11,-10,-9,-9,3,-3,-5,-3,-12,-4,-1,-3,-4,-4,-8,-2,-1,0,-1,1,-4,-2,0,-11,2,-13,9,7,2,-1,-11,1,2,0,0,1,0,0,5,0,-2,-2,-11,1,-3,0,2,-1,1,7,1,1,0,2,2,2,0,1,0,-3,-1,5,1,0,0,80,38,42,8,3,5,28,11,1,13,19,6,14,6,3,3,8,4,14,5,-2,10,11,2,0,1,1,4,1,1,0,0,0,3,0,0,0,1,1,1,1,1,6,7,-1,8,5,3,6,-2,11,-8,5,-4,1,-2,7,-1,2,0,5,0,4,-7,3,-4,-1,3,5,-1,2,0,-1,1,3,1,1,0,0,2,2,-2,1,0
8,08169,"Prat de Llobregat, El",62773,-446,-242,-204,31,10,21,-103,-61,-92,-114,-58,-16,-44,-47,-24,-57,-47,-20,-59,-14,-68,-57,-11,4,9,3,6,5,4,3,3,0,3,2,1,1,6,3,3,3,3,2,-722,-382,-340,16,7,9,-139,-87,-235,-173,-79,-6,-83,-54,-92,-96,-44,-13,-56,-33,-143,-77,-35,7,3,1,2,3,6,1,1,0,1,1,4,0,2,1,1,2,2,1,-741,-399,-342,19,13,6,-131,-86,-280,-157,-63,-30,-82,-36,-138,-87,-39,-20,-49,-50,-142,-70,-24,-10,14,-3,-2,3,7,-1,6,0,1,2,4,-1,8,-3,-3,1,3,0,-736,-395,-341,50,27,23,-137,-65,-210,-159,-120,-36,-51,-41,-108,-84,-71,-30,-86,-24,-102,-75,-49,-6,15,12,3,11,7,0,9,5,6,3,4,-1,6,7,-3,8,3,1,-210,-106,-104,590,315,275,-52,81,-129,-20,-101,4,-25,38,-48,-14,-52,-4,-27,43,-81,-6,-49,8,100,165,159,106,39,12,47,95,99,53,12,2,53,70,60,53,27,10,-300,-244,-56,554,278,276,-76,125,-115,-118,-108,-12,-38,32,-61,-95,-76,-9,-38,93,-54,-23,-32,-3,127,156,164,72,25,2,57,87,92,32,5,0,70,69,72,40,20,2,-64,-1,-63,662,338,324,2,164,-111,12,-65,-50,13,104,-57,14,-44,-21,-11,60,-54,-2,-21,-29,132,181,160,125,48,14,71,104,75,56,23,7,61,77,85,69,25,7,82,42,40,767,449,318,11,113,-16,36,-54,-6,14,72,8,12,-44,-16,-3,41,-24,24,-10,10,153,195,252,122,34,4,83,111,155,77,19,4,70,84,97,45,15,0,312,125,187,456,200,256,41,191,111,0,-36,8,13,94,45,-6,-25,-2,28,97,66,6,-11,10,103,176,102,56,4,4,52,87,41,20,-6,-1,51,89,61,36,10,5,-294,-271,-23,-59,-108,49,-5,32,-147,-56,-74,-43,-8,-8,-136,-46,-51,-19,3,40,-11,-10,-23,-24,24,44,-44,-62,-19,-7,5,10,-52,-54,-18,-2,19,34,8,-8,-1,-5,-211,-121,-90,213,123,90,-15,17,-121,-40,-37,-16,-19,34,-89,-27,-25,0,4,-17,-32,-13,-12,-16,35,82,55,38,-2,0,27,45,25,23,-2,3,8,37,30,15,0,-3,-394,-293,-101,-285,-225,-60,-12,-48,-188,-110,-40,-8,2,-26,-157,-73,-27,-11,-14,-22,-31,-37,-13,3,-28,-7,-115,-119,-27,1,-11,-12,-93,-91,-19,-3,-17,5,-22,-28,-8,4,118,31,87,-3,-25,22,39,76,48,8,-34,-22,24,24,17,-8,-15,-16,15,52,31,16,-19,-6,9,53,-4,-35,-29,4,8,21,-11,-30,-15,3,1,32,7,-5,-14,1,-461,-287,-174,-239,-159,-80,-42,-49,-120,-146,-42,-65,-17,-43,-81,-104,-15,-22,-25,-6,-39,-42,-27,-43,-10,-21,-102,-71,-30,-11,8,-15,-73,-60,-17,-4,-18,-6,-29,-11,-13,-7,51,-29,80,-64,-65,1,-9,68,63,15,-27,-56,-20,20,62,-45,-18,-30,11,48,1,60,-9,-26,-2,25,-40,-46,-6,-2,-2,2,-25,-43,1,-2,0,23,-15,-3,-7,0,371,227,144,280,151,129,88,104,113,81,-9,-10,47,56,55,71,-4,2,41,48,58,10,-5,-12,52,84,83,24,13,20,35,43,36,21,5,9,17,41,47,3,8,11,350,140,210,246,109,137,63,97,122,114,2,-59,18,49,61,72,-20,-41,45,48,61,42,22,-18,50,91,72,17,6,0,26,46,24,17,-6,-3,24,45,48,0,12,3,330,103,227,287,115,172,14,132,145,92,-26,-36,7,58,19,54,-29,-16,7,74,126,38,3,-20,41,103,108,26,0,7,28,50,39,0,-9,4,13,53,69,26,9,3
8,08230,Premià de Dalt,8454,229,102,127,51,19,32,61,30,75,45,3,14,36,15,24,23,3,0,25,15,51,22,0,14,6,14,19,7,3,2,2,7,8,1,1,0,4,7,11,6,2,2,156,91,65,80,37,43,28,7,54,38,11,15,18,5,29,26,7,4,10,2,25,12,4,11,12,22,25,13,6,2,3,9,15,6,4,0,9,13,10,7,2,2,158,72,86,120,60,60,37,33,16,46,14,17,24,23,-12,28,7,5,13,10,28,18,7,12,21,27,43,19,10,0,12,16,19,8,5,0,9,11,24,11,5,0,171,82,89,81,39,42,28,40,48,33,9,12,9,30,21,18,-3,5,19,10,27,15,12,7,11,24,43,0,2,0,7,11,22,0,-1,0,4,13,21,0,3,0,-7,-11,4,87,54,33,14,11,-24,0,-25,12,5,12,-25,6,-12,2,9,-1,1,-6,-13,10,7,32,37,3,3,4,4,18,24,4,2,1,3,14,13,-1,1,3,28,-1,29,73,34,39,23,4,-35,39,1,-8,7,2,-28,24,-3,-4,16,2,-7,15,4,-4,8,12,28,19,4,1,1,8,17,8,0,0,7,4,11,11,4,1,-14,-16,2,115,52,63,13,14,-24,-22,-1,13,9,6,-9,-22,-4,7,4,8,-15,0,3,6,17,29,37,19,9,4,7,18,20,4,2,1,10,11,17,15,7,3,81,41,40,101,42,59,21,29,27,2,0,4,12,15,15,4,-3,2,9,14,12,-2,3,2,15,26,35,14,9,2,5,12,19,3,3,1,10,14,16,11,6,1,93,68,25,95,54,41,23,14,45,19,2,-9,17,13,29,10,5,-5,6,1,16,9,-3,-4,14,17,37,22,1,1,7,10,17,15,3,0,7,7,20,7,-2,1,106,43,63,62,34,28,29,22,22,28,5,-4,12,-3,8,19,6,-4,17,25,14,9,-1,0,11,14,17,15,0,4,6,8,11,8,-1,1,5,6,6,7,1,3,103,45,58,46,22,24,42,1,42,41,-30,4,27,7,15,16,-18,-1,15,-6,27,25,-12,5,5,8,16,11,3,2,2,4,12,3,1,0,3,4,4,8,2,2,93,51,42,47,18,29,21,9,38,16,1,0,15,-10,24,18,0,-3,6,19,14,-2,1,3,11,11,9,7,4,3,4,1,5,4,3,0,7,10,4,3,1,3,21,11,10,34,14,20,8,1,22,4,-8,-13,1,4,10,-5,-5,0,7,-3,12,9,-3,-13,0,9,12,10,-1,4,0,5,4,7,-2,0,0,4,8,3,1,4,46,20,26,14,3,11,59,-20,2,18,-8,-13,31,-6,-4,9,-2,-13,28,-14,6,9,-6,0,9,3,3,-3,1,0,2,0,0,1,0,-1,7,3,3,-4,1,1,90,55,35,45,27,18,59,9,7,44,-15,-14,36,9,-14,28,0,-4,23,0,21,16,-15,-10,8,6,18,9,1,2,7,3,8,8,1,0,1,3,10,1,0,2,-48,-23,-25,-52,-25,-27,43,-18,-12,0,-18,-50,31,-5,-24,-6,0,-26,12,-13,12,6,-18,-24,6,0,-10,-20,-14,-13,5,1,-10,-9,-8,-4,1,-1,0,-11,-6,-9,-160,-92,-68,-121,-69,-52,13,-27,-51,-40,-45,-9,4,-9,-23,-25,-31,-7,9,-18,-28,-15,-14,-2,-12,-8,-22,-57,-14,-9,-3,-2,-15,-32,-12,-6,-9,-6,-7,-25,-2,-3,40,0,40,54,20,34,19,7,21,-4,2,-11,4,6,10,-15,-1,-4,15,1,11,11,3,-7,23,10,11,6,-1,3,7,3,9,2,-1,0,16,7,2,4,0,3
8,08172,Premià de Mar,25882,194,119,75,291,157,134,12,11,84,-19,44,63,21,13,57,-20,23,23,-9,-2,27,1,21,40,71,60,89,43,17,10,38,31,53,25,7,3,33,29,36,18,10,7,124,76,48,345,203,142,38,47,90,-10,-30,-11,14,45,58,-6,-22,-12,24,2,32,-4,-8,1,41,104,127,53,10,5,18,67,81,28,5,1,23,37,46,25,5,4,79,52,27,446,260,186,22,19,61,-9,-40,21,16,10,44,-6,-17,1,6,9,17,-3,-23,20,80,106,154,74,20,8,43,67,97,40,9,2,37,39,57,34,11,6,250,100,150,496,263,233,18,76,93,-6,38,16,-2,25,63,-14,12,8,20,51,30,8,26,8,102,115,143,78,44,12,46,60,91,44,18,4,56,55,52,34,26,8,1,-9,10,357,215,142,9,21,54,-43,-45,3,17,19,20,-33,-28,-5,-8,2,34,-10,-17,8,56,99,134,42,16,4,35,58,91,17,8,3,21,41,43,25,8,1,-25,-44,19,363,208,155,-37,21,-6,16,-41,34,-16,23,-14,-12,-24,6,-21,-2,8,28,-17,28,44,116,125,53,11,11,20,72,77,26,8,4,24,44,48,27,3,7,25,-17,42,375,219,156,-10,46,-32,1,-13,37,-11,27,-17,-4,-23,10,1,19,-15,5,10,27,77,88,106,55,28,17,43,48,77,33,10,7,34,40,29,22,18,10,102,51,51,374,237,137,46,34,65,12,-34,-21,44,27,52,-15,-34,-19,2,7,13,27,0,-2,78,88,125,53,21,5,51,60,82,28,10,2,27,28,43,25,11,3,120,68,52,339,200,139,19,92,55,-26,-16,-3,20,51,51,-28,-19,-7,-1,41,4,2,3,4,52,120,103,41,15,7,26,70,74,22,8,0,26,50,29,19,7,7,-7,-47,40,91,36,55,6,-14,17,-28,-18,22,3,2,-25,-22,-11,3,3,-16,42,-6,-7,19,30,39,7,4,11,-4,17,21,-3,-4,5,-2,13,18,10,8,6,-2,-189,-143,-46,-116,-86,-30,-5,-42,-62,-43,-32,-12,-18,-42,-34,-27,-14,-11,13,0,-28,-16,-18,-1,7,-4,-58,-35,-8,-26,12,-19,-49,-24,2,-13,-5,15,-9,-11,-10,-13,-97,-101,4,9,-23,32,-9,-13,-38,-18,-27,5,3,-4,-48,-25,-29,-1,-12,-9,10,7,2,6,15,25,-13,-21,-5,3,15,11,-28,-18,-8,2,0,14,15,-3,3,1,-19,-7,-12,-5,-6,1,-18,-9,-21,-40,5,62,12,18,-34,-29,0,25,-30,-27,13,-11,5,37,2,12,4,-21,-12,2,9,11,-9,-17,-8,3,-7,1,13,-4,-4,-1,115,39,76,-32,-28,-4,-12,32,-37,19,13,90,-14,0,-27,21,11,43,2,32,-10,-2,2,47,3,10,-31,-22,4,2,7,2,-19,-22,2,1,-4,8,-12,0,2,1,-138,-114,-24,-151,-111,-40,-36,-1,-63,-56,-25,33,-12,-2,-51,-45,-16,9,-24,1,-12,-11,-9,24,5,-8,-48,-61,-27,-14,-4,-1,-35,-53,-14,-5,9,-7,-13,-8,-13,-9,-20,-4,-16,-71,-15,-56,3,4,-46,-34,-11,70,1,17,-6,-12,-16,20,2,-13,-40,-22,5,50,-8,23,-18,-48,-7,-15,3,19,-2,-15,-10,-10,-11,4,-16,-33,3,-5,262,107,155,118,52,66,19,23,121,13,1,80,12,26,43,6,-4,22,7,-3,78,7,5,58,28,20,73,-24,11,8,19,18,26,-17,0,6,9,2,47,-7,11,2,73,35,38,210,117,93,27,13,23,27,-29,17,26,5,7,9,-17,9,1,8,16,18,-12,8,58,59,40,26,14,8,43,29,20,11,6,6,15,30,20,15,8,2
8,08175,Puig-reig,4397,-10,-15,5,9,3,6,-6,4,-10,1,1,-1,-6,1,-5,-1,0,-4,0,3,-5,2,1,3,1,1,4,2,1,0,0,1,0,2,0,0,1,0,4,0,1,0,18,12,6,16,8,8,1,4,8,4,1,-1,4,1,3,4,2,-2,-3,3,5,0,-1,1,0,3,8,5,0,0,0,1,4,3,0,0,0,2,4,2,0,0,7,11,-4,19,12,7,9,9,-7,3,-3,-5,3,5,-9,9,1,2,6,4,2,-6,-4,-7,8,3,5,1,2,0,4,2,3,1,1,1,4,1,2,0,1,-1,1,-3,4,14,4,10,-12,1,-12,7,3,10,-8,-5,-1,6,3,1,-4,6,-11,1,0,9,0,6,3,4,1,0,-1,1,2,2,0,0,1,5,1,2,1,0,72,43,29,30,13,17,16,26,0,25,1,-1,11,7,-3,18,6,1,5,19,3,7,-5,-2,8,6,10,0,1,3,6,2,4,0,0,0,2,4,6,0,1,3,43,27,16,28,18,10,17,7,8,9,6,-4,6,5,7,4,7,-1,11,2,1,5,-1,-3,13,4,9,1,3,-2,6,5,6,-1,2,0,7,-1,3,2,1,-2,91,47,44,54,33,21,23,16,23,18,5,5,9,11,11,10,5,2,14,5,12,8,0,3,9,17,18,6,2,1,5,13,13,2,0,0,4,4,5,4,2,1,135,61,74,86,41,45,20,45,33,19,9,6,10,20,11,14,5,0,10,25,22,5,4,6,9,22,29,21,4,-1,5,10,13,11,2,0,4,12,16,10,2,-1,95,37,58,15,-4,19,1,7,23,17,9,34,-3,6,7,8,5,10,4,1,16,9,4,24,-3,5,5,3,5,-1,-3,1,-4,0,2,0,0,4,9,3,3,-1,-33,-17,-16,-9,-11,2,1,-11,-22,-4,-5,11,6,-5,-16,-5,-4,10,-5,-6,-6,1,-1,1,2,3,-4,-6,-3,-1,2,-2,-6,-4,-1,0,0,5,2,-2,-2,-1,36,31,5,12,11,1,9,1,-8,1,0,29,7,6,2,-1,5,11,2,-5,-10,2,-5,18,5,2,2,1,1,0,5,1,3,0,1,0,0,1,-1,1,0,0,4,-17,21,-20,-17,-3,3,3,-7,-9,-4,18,-6,-1,-2,-6,-5,4,9,4,-5,-3,1,14,-2,-1,-5,-10,-1,0,-1,0,-3,-10,-2,0,-1,-1,-2,0,1,0,0,-16,16,-19,-19,0,8,-11,-16,-11,-4,34,3,-5,-9,-7,-2,5,5,-6,-7,-4,-2,29,1,-7,-13,1,-3,2,-2,-5,-11,-1,-1,1,3,-2,-2,2,-2,1,-15,-14,-1,-8,-4,-4,7,3,-14,-1,-4,-5,5,3,-9,-5,-2,-6,2,0,-5,4,-2,1,-4,-2,4,-1,-4,-1,-2,-1,2,0,-3,0,-2,-1,2,-1,-1,-1,18,14,4,-11,-6,-5,-6,-10,-6,13,7,19,-3,-5,0,8,2,11,-3,-5,-6,5,5,8,-4,0,-5,0,-2,-1,-3,0,-2,-1,-1,0,-1,0,-3,1,-1,-1,3,-1,4,7,3,4,-7,-3,-10,-6,5,23,0,-1,-10,1,3,5,-7,-2,0,-7,2,18,7,-3,0,2,0,1,5,-3,-1,2,0,0,2,0,1,0,0,1,13,12,1,-4,-4,0,6,-1,9,-3,-6,9,6,0,5,0,0,2,0,-1,4,-3,-6,7,0,2,2,-3,-5,0,0,1,1,-1,-5,0,0,1,1,-2,0,0,61,39,22,24,12,12,-1,11,10,15,8,20,-2,4,14,7,3,14,1,7,-4,8,5,6,3,5,9,5,1,0,2,2,6,1,1,0,1,3,3,4,0,0
8,08180,Ripollet,29358,338,201,137,3,2,1,8,185,77,31,16,18,10,96,61,25,0,9,-2,89,16,6,16,9,0,2,1,0,0,0,0,1,1,0,0,0,0,1,0,0,0,0,361,206,155,12,6,6,-3,135,169,48,11,5,1,46,119,33,9,3,-4,89,50,15,2,2,0,2,3,5,2,0,0,2,2,1,1,0,0,0,1,4,1,0,436,260,176,-20,-8,-12,-5,145,252,85,-38,1,-5,83,145,68,-22,-10,0,62,107,17,-16,11,-2,-6,-7,2,-5,-2,-1,-2,-4,2,-2,-1,-1,-4,-3,0,-3,-1,229,95,134,34,13,21,-30,141,152,-1,-29,11,-24,61,84,-8,-14,8,-6,80,68,7,-15,3,11,11,10,3,1,-2,6,2,6,0,0,-1,5,9,4,3,1,-1,642,409,233,461,259,202,30,226,252,95,24,17,31,111,192,71,12,-1,-1,115,60,24,12,18,74,128,125,97,30,4,46,70,75,53,14,1,28,58,50,44,16,3,399,244,155,494,275,219,10,210,207,-7,-27,18,15,117,141,-9,-19,4,-5,93,66,2,-8,14,76,128,159,92,28,9,42,72,96,48,12,4,34,56,63,44,16,5,356,274,82,474,282,192,31,145,162,46,-5,-9,36,85,148,22,-2,-7,-5,60,14,24,-3,-2,78,119,146,85,27,11,43,70,97,48,14,4,35,49,49,37,13,7,183,130,53,468,238,230,-12,203,47,-43,3,-14,11,115,20,0,-5,-17,-23,88,27,-43,8,3,101,153,113,76,14,6,58,72,53,44,7,-1,43,81,60,32,7,7,310,193,117,381,191,190,80,161,78,27,-15,-22,39,91,55,13,-1,0,41,70,23,14,-14,-22,77,112,109,55,12,5,36,66,49,29,4,2,41,46,60,26,8,3,-151,-170,19,-81,-92,11,-21,63,-137,-6,-33,-17,-3,-4,-102,-27,-17,-16,-18,67,-35,21,-16,-1,18,14,-56,-37,-10,-13,15,-1,-50,-43,-10,-5,3,15,-6,6,0,-8,-6,-30,24,52,-18,70,46,22,26,-93,-15,-3,9,11,32,-78,-12,0,37,11,-6,-15,-3,-3,41,50,1,-39,-3,-1,13,18,-9,-41,-4,4,28,32,10,2,1,-5,-119,-107,-12,-100,-84,-16,-17,32,-22,-72,-13,-25,-1,18,-49,-58,-5,-12,-16,14,27,-14,-8,-13,12,-2,-23,-66,-19,-5,20,-10,-38,-47,-9,-1,-8,8,15,-19,-10,-4,-281,-178,-103,-180,-134,-46,-53,-9,-43,-101,-41,-29,-30,3,-18,-87,-25,-15,-23,-12,-25,-14,-16,-14,-27,18,-74,-61,-30,-10,-23,4,-37,-55,-20,-6,-4,14,-37,-6,-10,-4,-92,-69,-23,-127,-77,-50,-1,3,-10,-74,-32,16,23,10,-24,-41,-36,1,-24,-7,14,-33,4,15,-22,-3,-39,-59,-12,7,4,-5,-29,-35,-14,2,-26,2,-10,-24,2,5,60,133,-73,70,45,25,40,46,-1,23,-18,-33,52,14,36,42,-11,-4,-12,32,-37,-19,-7,-29,22,31,0,24,-6,-3,13,14,3,15,2,-2,9,17,-3,9,-8,-1,64,66,-2,45,26,19,-15,71,31,-32,11,-16,-1,45,17,-14,-1,15,-14,26,14,-18,12,-31,11,36,-7,-18,5,9,10,20,-7,-5,-3,8,1,16,0,-13,8,1,128,99,29,156,74,82,31,100,86,-62,2,-29,29,61,52,-32,-5,-9,2,39,34,-30,7,-20,51,69,42,-20,6,1,25,42,22,-22,1,0,26,27,20,2,5,1,440,233,207,271,110,161,64,140,170,75,4,-31,42,53,103,21,5,-1,22,87,67,54,-1,-30,60,86,74,35,9,1,22,41,41,-1,3,1,38,45,33,36,6,0
8,08181,"Roca del Vallès, La",7136,167,78,89,19,8,11,33,38,35,41,6,11,14,20,6,24,4,8,19,18,29,17,2,3,3,3,8,4,0,0,1,3,3,1,0,0,2,0,5,3,0,0,294,147,147,33,19,14,62,37,97,52,19,25,38,19,45,29,8,9,24,18,52,23,11,16,6,8,12,5,1,0,5,5,6,2,1,0,1,3,6,3,0,0,265,136,129,47,24,23,43,35,91,60,11,19,21,8,64,29,10,3,22,27,27,31,1,16,11,6,17,10,3,0,6,3,9,5,1,0,5,3,8,5,2,0,286,151,135,49,27,22,35,39,142,44,12,3,11,21,79,25,7,2,24,18,63,19,5,1,6,11,23,8,0,0,3,6,11,6,0,0,3,5,12,2,0,0,211,99,112,74,34,40,18,25,58,59,24,23,-3,15,30,31,12,11,21,10,28,28,12,12,10,17,20,12,5,6,6,7,4,10,1,3,4,10,16,2,4,3,387,202,185,52,19,33,86,60,130,65,17,22,50,28,68,36,9,8,36,32,62,29,8,14,12,17,12,8,2,1,5,6,3,3,2,0,7,11,9,5,0,1,217,82,135,81,32,49,46,38,77,19,26,7,20,10,26,5,16,2,26,28,51,14,10,5,16,28,15,14,4,3,6,9,10,5,1,0,10,19,5,9,3,3,262,139,123,62,33,29,51,23,85,56,16,26,26,23,34,36,6,13,25,0,51,20,10,13,13,16,19,6,5,1,7,7,8,5,4,0,6,9,11,1,1,1,91,35,56,34,19,15,40,16,15,29,-6,-3,3,5,23,11,1,-7,37,11,-8,18,-7,4,14,4,5,17,-5,-2,10,0,1,10,-2,-1,4,4,4,7,-3,-1,33,-2,35,0,5,-5,7,7,20,-4,-1,4,8,0,-2,-4,-7,5,-1,7,22,0,6,-1,2,5,6,-10,-1,0,3,3,8,-7,-2,1,-1,2,-2,-3,1,-1,-47,-15,-32,-16,-16,0,-23,-3,1,-16,-11,4,-11,-1,-1,7,-14,2,-12,-2,2,-23,3,2,-6,-3,-4,0,-4,0,-4,-3,-5,-2,-2,0,-2,0,1,2,-2,0,30,-1,31,-10,-11,1,15,11,1,4,3,-2,6,9,8,-17,1,-5,9,2,-7,21,2,3,4,5,-8,-6,-3,-3,1,6,-5,-8,-3,-3,3,-1,-3,2,0,0,-32,-27,-5,-2,-9,7,10,5,-16,-4,-23,-3,8,7,-16,-12,-15,0,2,-2,0,8,-8,-3,3,-3,-4,-1,1,2,0,-2,-6,-2,0,1,3,-1,2,1,1,1,65,32,33,4,2,2,32,3,26,23,-14,-8,5,2,14,14,-4,-1,27,1,12,9,-10,-7,-1,-1,-2,3,3,2,-2,-3,2,3,1,1,1,2,-4,0,2,1,-30,-13,-17,-11,-11,0,-35,8,21,-10,-14,2,-22,-1,28,-12,-4,-3,-13,9,-7,2,-10,5,-3,4,-3,-5,-6,1,-1,0,-1,-5,-5,0,-2,4,-2,0,-1,1,74,30,44,0,-8,8,24,15,39,15,-25,-2,8,10,16,4,-11,-1,16,5,23,11,-14,-1,-5,11,2,-6,-2,-1,-7,4,3,-5,-2,-1,2,7,-1,-1,0,0,-79,-28,-51,9,6,3,-13,-12,-20,-20,-10,-11,-3,-4,-12,-5,-4,-4,-10,-8,-8,-15,-6,-7,-2,0,11,-3,1,1,-2,1,7,-2,0,1,0,-1,4,-1,1,0,108,42,66,48,19,29,44,2,42,17,1,-1,21,-6,23,4,-1,0,23,8,19,13,2,-1,10,10,13,9,2,4,3,7,6,0,1,2,7,3,7,9,1,2
8,08184,Rubí,57030,792,393,399,28,16,12,75,166,245,93,109,105,45,77,140,48,47,38,30,89,105,45,62,67,9,1,7,1,5,5,5,1,5,1,2,2,4,0,2,0,3,3,637,304,333,27,13,14,-14,152,291,85,53,73,-31,72,155,55,24,32,17,80,136,30,29,41,8,2,8,6,0,1,4,2,2,3,0,1,4,0,6,3,0,0,335,164,171,2,3,-1,-64,97,207,15,-25,109,-47,29,142,19,-18,33,-17,68,65,-4,-7,76,8,-5,-10,8,-1,2,5,-4,-4,6,-1,1,3,-1,-6,2,0,1,365,153,212,12,19,-7,4,96,170,18,-5,78,-25,34,125,8,0,12,29,62,45,10,-5,66,18,7,-7,-3,-1,-2,7,8,2,0,1,1,11,-1,-9,-3,-2,-3,1174,608,566,908,510,398,144,334,500,86,47,70,61,173,260,70,12,36,83,161,240,16,35,34,172,221,301,142,39,29,80,124,182,93,14,13,92,97,119,49,25,16,1033,601,432,880,519,361,44,321,496,107,40,21,32,188,303,61,7,2,12,133,193,46,33,19,150,224,285,148,50,14,83,126,179,96,22,8,67,98,106,52,28,6,822,383,439,761,395,366,140,172,359,119,-18,38,67,98,195,52,-29,2,73,74,164,67,11,36,172,219,212,107,38,4,80,118,119,58,17,-1,92,101,93,49,21,5,1127,525,602,1008,502,506,185,330,444,128,16,10,80,137,241,64,9,-2,105,193,203,64,7,12,244,305,290,119,39,-1,119,149,150,67,15,-2,125,156,140,52,24,1,537,260,277,676,320,356,69,252,126,43,-15,56,38,109,86,23,-12,16,31,143,40,20,-3,40,201,228,185,47,5,4,108,95,90,27,-3,0,93,133,95,20,8,4,174,37,137,219,50,169,55,47,85,-34,-73,65,56,-17,13,-24,-43,28,-1,64,72,-10,-30,37,80,76,59,10,-24,5,57,1,5,-4,-18,1,23,75,54,14,-6,4,264,12,252,176,66,110,91,104,34,-2,-18,53,34,36,-20,-26,-21,15,57,68,54,24,3,38,54,83,25,1,3,9,34,41,5,-15,-3,3,20,42,20,16,6,6,-20,-182,162,-61,-108,47,-15,83,-3,-133,8,28,-13,0,-30,-114,-24,4,-2,83,27,-19,32,24,19,42,-41,-85,-9,6,16,4,-39,-75,-21,6,3,38,-2,-10,12,0,-207,-170,-37,-300,-239,-61,8,5,-106,-103,-14,-1,-29,4,-51,-72,-24,0,37,1,-55,-31,10,-1,-21,5,-124,-136,-20,-10,-13,-16,-88,-95,-23,-6,-8,21,-36,-41,3,-4,-293,-212,-81,-232,-165,-67,-69,4,-120,-104,-46,20,-18,-22,-68,-83,-33,-1,-51,26,-52,-21,-13,21,-46,16,-91,-84,-41,7,-22,4,-54,-66,-29,2,-24,12,-37,-18,-12,5,118,55,63,16,-35,51,-10,85,53,-83,18,47,3,23,9,-21,3,25,-13,62,44,-62,15,22,9,43,17,-54,-11,8,7,-2,0,-35,-15,6,2,45,17,-19,4,2,287,93,194,13,-35,48,60,108,119,-55,-17,48,27,37,53,-42,-11,23,33,71,66,-13,-6,25,7,60,9,-57,-17,4,-1,19,5,-42,-22,3,8,41,4,-15,5,1,304,188,116,461,209,252,41,123,149,0,-19,10,39,87,106,-13,-20,-13,2,36,43,13,1,23,98,106,146,61,25,18,52,49,71,25,6,1,46,57,75,36,19,17,665,309,356,510,222,288,110,186,201,133,24,3,57,95,116,37,7,0,53,91,85,96,17,3,97,170,139,65,11,16,47,80,81,10,-4,5,50,90,58,55,15,11
8,08187,Sabadell,184859,1022,538,484,1277,705,572,133,288,512,114,-74,42,25,159,333,56,-68,31,108,129,179,58,-6,11,196,310,490,199,53,25,102,189,267,110,21,15,94,121,223,89,32,10,1376,765,611,2044,1096,948,230,381,624,264,-130,-5,117,253,352,120,-82,6,113,128,272,144,-48,-11,351,523,702,352,83,14,177,290,389,189,33,6,174,233,313,163,50,8,2644,1426,1218,2757,1464,1293,458,874,1137,257,-83,-26,235,467,700,123,-79,-33,223,407,437,134,-4,7,532,757,911,417,91,25,281,398,520,211,32,12,251,359,391,206,59,13,2421,1330,1091,2709,1340,1369,494,716,939,303,-43,10,244,388,552,165,-33,3,250,328,387,138,-10,7,623,717,815,376,124,23,287,370,436,174,50,6,336,347,379,202,74,17,2623,1537,1086,2920,1578,1342,220,1009,1145,371,-84,-46,106,564,787,199,-90,-9,114,445,358,172,6,-37,458,871,931,485,129,28,223,478,561,248,60,5,235,393,370,237,69,23,3008,1598,1410,2872,1496,1376,412,1113,1173,320,-12,-40,186,572,721,169,-45,-22,226,541,452,151,33,-18,540,842,905,406,115,39,275,443,531,185,33,17,265,399,374,221,82,22,2141,1092,1049,3126,1526,1600,376,1041,757,158,-87,-81,206,522,445,31,-64,-31,170,519,312,127,-23,-50,627,950,963,381,138,43,307,467,514,159,49,21,320,483,449,222,89,22,1743,907,836,2704,1397,1307,328,901,675,89,-110,-129,153,434,413,46,-66,-63,175,467,262,43,-44,-66,571,922,825,296,66,-4,290,497,460,114,28,-5,281,425,365,182,38,1,1575,831,744,1551,712,839,394,762,359,132,-94,0,212,405,207,52,-57,11,182,357,152,80,-37,-11,504,569,328,110,7,-4,290,268,122,11,-2,1,214,301,206,99,9,-5,450,-25,475,204,-42,246,223,224,141,-133,-55,19,91,68,-1,-161,-47,1,132,156,142,28,-8,18,207,194,-30,-167,-35,9,126,70,-90,-139,-31,8,81,124,60,-28,-4,1,-157,-283,126,-124,-220,96,55,212,-186,-140,-74,-47,0,97,-172,-135,-64,-15,55,115,-14,-5,-10,-32,135,73,-149,-145,-40,-23,67,16,-155,-136,-15,-9,68,57,6,-9,-25,-14,-334,-260,-74,-783,-537,-246,35,136,-184,-202,-67,-67,31,93,-173,-157,-48,-14,4,43,-11,-45,-19,-53,-10,55,-424,-298,-93,-25,26,19,-318,-198,-61,-12,-36,36,-106,-100,-32,-13,-346,-378,32,-1050,-717,-333,14,122,-162,-211,-59,-53,8,17,-198,-161,-51,0,6,105,36,-50,-8,-53,-98,-10,-470,-338,-104,-45,-31,-35,-330,-243,-72,-13,-67,25,-140,-95,-32,-32,-140,-118,-22,-880,-568,-312,71,166,-194,-115,-55,-13,73,67,-142,-101,-32,18,-2,99,-52,-14,-23,-31,-43,-1,-420,-307,-102,-19,4,-28,-279,-202,-66,-6,-47,27,-141,-105,-36,-13,348,66,282,-297,-230,-67,54,242,15,-78,113,-1,13,97,27,-134,49,4,41,145,-12,56,64,-5,-18,81,-110,-215,-59,2,-18,29,-75,-155,-27,5,0,52,-35,-60,-32,-3,658,378,280,387,159,228,197,252,276,65,-41,-108,144,137,99,76,-58,-29,53,115,177,-11,17,-79,168,125,78,10,-19,1,117,42,3,16,-27,-2,51,83,75,-6,8,3,1735,803,932,851,261,590,334,453,577,214,87,39,187,184,302,44,39,25,147,269,275,170,48,14,221,260,294,27,13,15,107,94,120,-58,-20,4,114,166,174,85,33,11,2093,1008,1085,1278,587,691,389,678,673,203,84,28,160,322,359,115,14,14,229,356,314,88,70,14,231,452,409,76,52,35,95,216,206,22,18,19,136,236,203,54,34,16
8,08191,Sallent,7261,20,13,7,23,11,12,12,10,-4,16,-8,-10,0,7,6,13,-8,-5,12,3,-10,3,0,-5,4,7,5,1,1,2,1,4,4,1,0,0,3,3,1,0,1,2,-19,10,-29,26,13,13,3,3,-9,-5,-1,-11,1,10,2,0,1,-5,2,-7,-11,-5,-2,-6,11,3,10,2,0,0,5,1,5,2,0,0,6,2,5,0,0,0,35,13,22,39,22,17,13,9,3,3,1,3,-1,4,7,3,0,-1,14,5,-4,0,1,4,4,12,16,4,3,0,1,5,11,3,2,0,3,7,5,1,1,0,11,17,-6,46,25,21,0,7,4,-2,1,-3,2,9,8,-3,-2,3,-2,-2,-4,1,3,-6,10,10,13,2,6,4,6,5,11,-1,1,3,4,5,2,3,5,1,1,-11,12,44,22,22,6,4,0,-1,-3,-10,0,3,-8,-6,0,-1,6,1,8,5,-3,-9,9,13,11,7,4,0,5,6,4,3,4,0,4,7,7,4,0,0,72,53,19,23,15,8,4,27,19,8,9,-3,5,14,17,1,8,3,-1,13,2,7,1,-6,7,6,6,2,1,1,4,4,6,0,1,0,3,2,0,2,0,1,-1,2,-3,49,26,23,9,12,1,-5,-9,-9,-1,8,6,-1,-8,-1,10,4,-5,-4,-1,-8,9,10,11,16,1,1,4,5,4,12,1,0,5,5,7,4,0,1,24,32,-8,61,33,28,14,8,14,13,-13,-10,17,7,8,15,-12,-2,-3,1,6,-2,-1,-8,15,16,14,12,3,1,12,6,8,6,1,0,3,10,6,6,2,1,64,34,30,36,12,24,35,18,15,23,-7,-19,14,9,7,12,-3,-6,21,9,8,11,-4,-13,13,8,11,3,-1,2,7,1,2,0,0,2,6,7,9,3,-1,0,-65,-38,-27,19,5,14,1,-11,-22,-5,-10,-16,2,-8,-18,0,-8,-4,-1,-3,-4,-5,-2,-12,7,5,7,2,-2,0,3,1,2,2,-2,-1,4,4,5,0,0,1,-103,-59,-44,0,-1,1,-22,-7,-22,-30,-10,-10,-6,1,-18,-22,-8,-5,-16,-8,-4,-8,-2,-5,2,-1,0,0,0,-1,2,-4,1,-1,0,0,0,3,-1,1,0,-1,-12,-20,8,10,1,9,9,6,10,3,-16,-22,6,1,-4,0,-8,-15,3,5,14,3,-8,-7,1,6,6,-2,0,-1,3,0,1,-2,0,-1,-2,6,5,0,0,0,-21,-2,-19,5,2,3,0,-9,-2,-9,-7,0,4,-6,8,-7,-3,0,-4,-3,-10,-2,-4,0,1,3,3,-1,-1,0,1,1,3,-2,-1,0,0,2,0,1,0,0,0,-7,7,-17,-13,-4,15,0,1,-14,-10,3,1,-2,-3,-7,-4,4,14,2,4,-7,-6,-1,1,-3,-5,-9,0,-1,-2,-1,-4,-4,-1,-1,3,-2,-1,-5,1,0,-77,-27,-50,-14,-8,-6,-9,-24,-3,-33,-7,-1,-1,-3,-3,-14,-6,0,-8,-21,0,-19,-1,-1,-4,3,-7,-5,-1,-1,0,0,-4,-3,-2,0,-4,3,-3,-2,1,-1,-36,-18,-18,6,5,1,-18,-6,-4,-9,8,-5,-10,2,0,-8,1,-1,-8,-8,-4,-1,7,-4,-2,2,0,1,4,1,0,1,2,-1,2,1,-2,1,-2,2,2,0,41,23,18,19,12,7,11,4,8,20,4,-8,5,2,6,5,5,0,6,2,2,15,-1,-8,6,0,9,4,0,0,2,1,5,2,0,2,4,-1,4,2,0,-2,78,37,41,33,12,21,18,24,17,12,10,-3,6,6,11,9,7,-2,12,18,6,3,3,-1,7,7,12,5,2,1,0,4,6,2,0,0,7,3,6,3,2,1
8,08194,Sant Adrià de Besòs,32823,-42,-14,-28,152,76,76,-38,38,-24,-2,-26,4,-8,22,-1,-7,-25,5,-30,16,-23,5,-1,-1,33,38,52,22,1,4,19,19,28,8,0,1,14,19,24,14,1,3,79,65,14,262,138,124,7,59,-5,16,13,-16,-8,32,19,16,1,-1,15,27,-24,0,12,-15,54,69,81,42,11,2,26,37,44,24,3,1,28,32,37,18,8,1,175,122,53,324,171,153,10,61,89,4,-18,24,14,41,89,-15,-4,1,-4,20,0,19,-14,23,60,85,107,51,19,1,32,36,70,23,10,0,28,49,37,28,9,1,2,-14,16,320,157,163,26,40,-6,-27,-28,-21,1,23,3,-11,-17,-15,25,17,-9,-16,-11,-6,73,77,101,44,16,2,39,33,58,17,7,1,34,44,43,27,9,1,76,33,43,295,164,131,11,90,13,17,-36,-24,-8,52,-9,29,-22,-13,19,38,22,-12,-14,-11,46,82,94,52,11,9,25,41,55,35,6,2,21,41,39,17,5,7,-51,-51,0,281,157,124,30,2,-34,4,-30,-31,3,4,-27,3,-15,-22,27,-2,-7,1,-15,-9,57,70,95,35,17,6,33,35,61,19,7,2,24,35,34,16,10,4,86,47,39,291,167,124,44,15,48,49,-27,-40,29,14,30,6,-12,-16,15,1,18,43,-15,-24,49,73,109,43,14,3,26,48,65,21,5,2,23,25,44,22,9,1,469,226,243,332,169,163,97,137,169,82,-2,-18,52,67,70,54,4,-18,45,70,99,28,-6,0,74,89,95,47,17,9,40,47,52,22,4,3,34,42,43,25,13,6,503,272,231,377,204,173,43,126,195,102,-19,45,32,65,110,51,-21,15,11,61,85,51,2,30,67,113,111,58,11,13,40,62,53,35,3,7,27,51,58,23,8,6,-1,20,-21,19,6,13,6,56,-11,29,-21,-57,2,16,1,25,-12,-10,4,40,-12,4,-9,-47,10,40,-8,-6,-10,-12,1,12,-2,-3,-3,-3,9,28,-6,-3,-7,-9,12,-40,52,-14,-50,36,10,14,76,-52,-31,-14,-13,10,26,-42,-25,5,23,4,50,-10,-6,-19,42,10,-23,-33,-9,-9,15,-3,-20,-30,-13,-3,27,13,-3,-3,4,-6,262,121,141,110,48,62,33,113,39,32,16,21,16,44,33,15,5,3,17,69,6,17,11,18,46,40,6,4,-2,11,24,22,7,-9,-1,1,22,18,-1,13,-1,10,501,286,215,175,64,111,49,90,239,89,20,-2,55,48,118,45,6,7,-6,42,121,44,14,-9,39,56,51,21,2,4,24,25,20,-7,-3,3,15,31,31,28,5,1,264,154,110,19,-16,35,8,30,140,58,27,-22,2,13,86,31,21,-7,6,17,54,27,6,-15,9,42,-14,-22,0,-6,-8,21,-16,-16,-1,-2,17,21,2,-6,1,-4,266,153,113,214,105,109,-30,102,50,67,46,18,-12,57,39,45,18,3,-18,45,11,22,28,15,30,65,48,35,20,6,19,29,20,22,5,5,11,36,28,13,15,1,774,432,342,335,160,175,144,167,244,149,59,0,100,59,130,97,32,4,44,108,114,52,27,-4,60,100,86,40,30,10,34,38,47,17,11,5,26,62,39,23,19,5,58,6,52,249,112,137,-37,60,85,-39,-7,-1,-50,31,58,-10,-10,-10,13,29,27,-29,3,9,48,62,94,38,4,-8,17,37,28,29,0,-6,31,25,66,9,4,-2,6,-28,34,148,45,103,-82,109,88,-114,9,-8,-31,40,46,-77,0,-17,-51,69,42,-37,9,9,30,81,80,-31,-10,-10,15,41,28,-25,-12,-7,15,40,52,-6,2,-3
8,08196,Sant Andreu de la Barca,18854,-263,-164,-99,3,2,1,-119,42,-118,-40,-9,0,-73,9,-57,-14,-11,-3,-46,33,-61,-26,2,3,0,0,2,0,1,0,0,0,1,0,1,0,0,0,1,0,0,0,281,116,165,3,1,2,1,129,90,19,18,26,-6,40,46,19,6,10,7,89,44,0,12,16,3,0,0,0,0,0,1,0,0,0,0,0,2,0,0,0,0,0,411,223,188,-16,-7,-9,-27,159,173,22,44,30,1,69,104,15,21,11,-28,90,69,7,23,19,0,-2,-11,-3,1,0,0,-1,-4,-2,1,0,0,-1,-7,-1,0,0,183,73,110,122,54,68,-21,116,75,-1,-15,27,-17,46,67,-9,-27,13,-4,70,8,8,12,14,28,40,26,17,4,3,16,17,14,3,0,2,12,23,12,14,4,1,215,94,121,276,158,118,-4,126,94,-26,-3,30,-11,39,66,-19,10,8,7,87,28,-7,-13,22,49,63,112,34,13,3,23,33,72,24,6,-1,26,30,40,10,7,4,90,43,47,255,140,115,-65,130,21,-27,7,35,-48,67,39,-31,12,11,-17,63,-18,4,-5,24,36,70,74,45,19,8,17,44,41,22,12,2,19,26,33,23,7,6,254,97,157,229,112,117,23,170,16,26,-11,19,8,80,16,7,-19,0,15,90,0,19,8,19,46,71,62,31,18,-1,24,41,35,6,6,-1,22,30,27,25,12,0,147,86,61,333,192,141,-4,134,-10,34,-18,13,-9,59,7,30,-4,-1,5,75,-17,4,-14,14,76,92,91,68,6,-4,32,48,62,44,3,0,44,44,29,24,3,-4,-120,-134,14,211,93,118,-29,49,-126,-62,-23,72,-24,-2,-64,-45,-19,20,-5,51,-62,-17,-4,52,57,58,75,15,1,2,29,19,40,3,1,-1,28,39,35,12,0,3,172,33,139,124,40,84,-3,32,19,-46,-2,172,2,18,-3,-18,-10,47,-5,14,22,-28,8,125,43,45,20,2,6,4,29,16,-2,-5,0,0,14,29,22,7,6,4,186,85,101,15,-3,18,12,51,75,-10,-9,62,24,23,31,-6,-9,17,-12,28,44,-4,0,45,36,8,-11,-3,-13,-5,29,2,-14,-7,-13,-2,7,6,3,4,0,-3,122,45,77,85,51,34,-5,86,-35,-45,34,92,5,55,-33,-34,20,36,-10,31,-2,-11,14,56,28,52,-14,7,4,4,19,34,-16,4,4,3,9,18,2,3,0,1,-81,-79,-2,7,-18,25,-57,37,-58,-48,-18,68,-38,33,-34,-46,-12,17,-19,4,-24,-2,-6,51,7,30,-4,-26,-8,6,-1,20,-9,-23,-7,0,8,10,5,-3,-1,6,-204,-141,-63,-177,-108,-69,-35,-16,-45,-114,-46,55,-11,-11,-26,-75,-39,19,-24,-5,-19,-39,-7,36,-26,-9,-38,-74,-29,-1,-15,-2,-27,-42,-21,-1,-11,-7,-11,-32,-8,0,-28,17,-45,22,11,11,-9,15,-24,-57,-9,62,12,9,-1,-29,1,30,-21,6,-23,-28,-10,32,19,17,-19,5,1,0,15,9,-10,-4,1,1,4,8,-9,9,0,-1,68,-6,74,-4,-6,2,13,27,21,-60,-13,74,-1,3,2,-32,-5,24,14,24,19,-28,-8,50,0,9,-2,-12,0,-2,4,2,-4,-9,-3,3,-4,7,2,-3,3,-5,-30,-61,31,-25,-31,6,-73,46,9,-85,-3,73,-35,26,0,-60,-11,19,-38,20,9,-25,8,54,-14,32,-8,-37,-4,3,-5,21,-12,-32,-3,-2,-9,11,4,-5,-1,5,-4,-29,25,64,29,35,-55,20,20,-89,4,90,-46,17,11,-42,-2,28,-9,3,9,-47,6,62,13,22,34,-10,1,2,10,10,24,-9,-6,-1,3,12,10,-1,7,3
8,08197,Sant Andreu de Llavaneres,6767,9,-1,10,2,1,1,-3,-21,-5,-9,20,28,5,-5,-9,-5,4,8,-8,-16,4,-4,16,20,2,0,0,0,0,0,1,0,0,0,0,0,1,0,0,0,0,0,466,207,259,134,60,74,94,45,138,99,38,43,44,19,57,48,21,14,50,26,81,51,17,29,32,17,47,26,7,4,17,7,18,12,4,1,15,10,29,14,3,3,336,178,158,140,78,62,63,22,103,79,21,40,26,15,50,56,12,14,37,7,53,23,9,26,23,24,44,32,11,5,10,14,22,20,8,3,13,10,22,12,3,2,294,173,121,91,38,53,55,1,57,47,38,91,35,9,27,36,21,44,20,-8,30,11,17,47,15,16,26,17,10,6,7,8,8,8,4,3,8,8,18,9,6,3,292,214,78,107,54,53,64,35,78,52,31,28,51,23,63,32,23,18,13,12,15,20,8,10,23,28,35,14,4,1,15,14,16,5,2,0,8,14,19,9,2,1,80,39,41,83,32,51,36,-6,11,13,-9,34,23,-4,12,4,-1,5,13,-2,-1,9,-8,29,11,18,23,14,8,5,2,8,11,5,2,2,9,10,12,9,6,3,243,131,112,101,45,56,36,32,76,17,9,68,28,21,36,19,2,21,8,11,40,-2,7,47,26,16,23,20,9,7,13,8,11,10,2,1,13,8,12,10,7,6,187,96,91,51,18,33,6,38,59,31,5,49,-2,19,28,27,0,23,8,19,31,4,5,26,1,19,13,7,4,7,-4,6,6,3,3,3,5,13,7,4,1,4,155,91,64,89,37,52,-4,23,47,46,-3,36,6,9,34,18,4,12,-10,14,13,28,-7,24,3,27,27,26,3,1,2,10,12,10,0,1,1,17,15,16,3,0,73,31,42,27,0,27,11,2,15,17,-3,27,13,-14,19,10,0,4,-2,16,-4,7,-3,23,1,20,6,-6,2,2,0,5,-1,-5,0,-1,1,15,7,-1,2,3,107,54,53,31,18,13,19,-7,28,15,15,35,24,-4,6,18,5,1,-5,-3,22,-3,10,34,2,17,9,5,-2,-1,7,8,3,2,0,-3,-5,9,6,3,-2,2,136,40,96,57,25,32,42,23,12,21,-8,46,14,18,8,-5,-10,17,28,5,4,26,2,29,13,16,11,4,4,8,9,7,1,1,0,7,4,9,10,3,4,1,10,-9,19,17,5,12,28,2,8,-40,-6,17,17,4,-5,-26,-1,1,11,-2,13,-14,-5,16,5,4,2,-4,8,1,1,3,-4,-2,5,1,4,1,6,-2,3,0,22,-39,61,-64,-43,-21,18,-14,-7,8,-25,31,2,-14,-16,-7,-23,12,16,0,9,15,-2,19,-12,-1,-3,-29,-9,-13,-5,-7,0,-15,-11,-7,-7,6,-3,-14,2,-6,-34,-6,-28,-34,-15,-19,-21,6,-35,-5,-22,46,-6,5,-14,0,-13,22,-15,1,-21,-5,-9,24,-3,4,-7,-20,-3,-5,-1,6,-3,-11,-5,-1,-2,-2,-4,-9,2,-4,195,124,71,73,42,31,57,-4,28,72,10,25,37,0,24,43,3,12,20,-4,4,29,7,13,16,9,24,18,-3,4,10,3,14,11,-2,2,6,6,10,7,-1,2,106,44,62,44,8,36,27,4,8,34,5,27,4,-2,-1,36,-4,11,23,6,9,-2,9,16,15,10,7,10,-6,6,6,3,-1,7,-7,-1,9,7,8,3,1,7,132,51,81,111,47,64,39,-4,39,34,29,-15,11,-3,12,15,25,-12,28,-1,27,19,4,-3,14,14,24,29,28,0,6,2,10,17,12,-1,8,12,14,12,16,1
8,08200,Sant Boi de Llobregat,79050,-564,-247,-317,30,18,12,-120,-41,-165,-161,-96,24,-56,4,-59,-84,-58,3,-64,-45,-106,-77,-38,21,3,8,3,7,7,2,0,5,3,3,5,2,3,3,0,4,2,0,-464,-243,-221,173,94,79,-97,-27,-126,-124,-72,-18,-44,-21,-60,-64,-48,-8,-53,-6,-66,-60,-24,-10,34,42,55,28,12,1,17,24,32,13,6,1,17,18,23,15,6,0,-621,-332,-289,-37,-21,-16,-180,9,-167,-160,-111,-3,-126,20,-52,-84,-60,-22,-54,-11,-115,-76,-51,19,8,-6,-23,-11,1,-5,3,-3,-10,-8,1,-3,5,-3,-13,-3,0,-2,-397,-204,-193,166,96,70,-69,86,-100,-121,-133,-43,-51,43,-16,-65,-70,-32,-18,43,-84,-56,-63,-11,31,49,53,28,7,-2,15,26,33,19,4,-1,16,23,20,9,3,-1,-45,21,-66,815,444,371,-35,181,-58,-60,-56,-22,-1,80,8,-11,-53,-11,-34,101,-66,-49,-3,-11,166,216,242,104,61,17,88,126,140,57,22,6,78,90,102,47,39,11,-84,-45,-39,763,415,348,-65,162,-1,-51,-107,-15,-21,108,18,-54,-64,-26,-44,54,-19,3,-43,11,136,186,243,125,46,18,70,106,144,63,18,8,66,80,99,62,28,10,-213,-199,-14,738,327,411,-61,93,-52,-63,-118,13,-64,48,-17,-38,-84,-38,3,45,-35,-25,-34,51,129,209,231,106,43,19,43,105,112,49,11,6,86,104,119,57,32,13,388,160,228,910,469,441,146,206,115,3,-74,4,86,119,23,-3,-52,-11,60,87,92,6,-22,15,224,230,280,133,47,-7,111,121,150,68,20,-4,113,109,130,65,27,-3,793,423,370,797,430,367,109,310,304,82,-27,15,73,158,217,24,-22,-23,36,152,87,58,-5,38,171,233,229,101,42,18,107,104,136,50,21,10,64,129,93,51,21,8,4,0,4,-100,-126,26,-33,206,-9,-79,-77,2,10,92,-3,-47,-53,6,-43,114,-6,-32,-24,-4,9,95,-90,-70,-35,-14,13,31,-93,-57,-22,1,-4,64,3,-13,-13,-15,143,62,81,530,248,282,81,80,14,7,-33,-6,39,54,23,-45,-9,-9,42,26,-9,52,-24,3,107,134,166,75,37,5,57,59,89,23,15,1,50,75,77,52,22,4,-168,-169,1,90,6,84,-48,102,-153,-73,-15,30,-31,36,-84,-62,-20,6,-17,66,-69,-11,5,24,34,109,-30,-31,-6,5,19,40,-22,-21,-12,-2,15,69,-8,-10,6,7,-151,-133,-18,-220,-165,-55,-16,20,-25,-97,-33,8,9,15,-43,-81,-23,0,-25,5,18,-16,-10,8,-29,24,-87,-98,-13,-27,-9,5,-66,-82,-6,-11,-20,19,-21,-16,-7,-16,-223,-219,-4,-360,-259,-101,32,23,-145,-117,-45,26,25,1,-101,-113,-37,12,7,22,-44,-4,-8,14,-17,-33,-124,-124,-54,-11,-12,-16,-98,-95,-36,-1,-5,-17,-26,-29,-18,-10,-649,-449,-200,-353,-286,-67,-2,5,-218,-321,-89,-2,5,-12,-109,-243,-69,-5,-7,17,-109,-78,-20,3,-1,31,-144,-188,-40,-14,1,6,-100,-154,-29,-10,-2,25,-44,-34,-11,-4,56,-61,117,95,24,71,42,96,-57,4,-21,-18,-22,22,-27,-13,-14,-14,64,74,-30,17,-7,-4,15,53,25,-10,15,-9,-3,29,4,-10,3,-3,18,24,21,0,12,-6,80,87,-7,216,82,134,-2,59,120,-78,23,-37,8,63,79,-57,10,-20,-10,-4,41,-21,13,-17,74,73,57,-5,7,5,46,43,19,-21,-6,-4,28,30,38,16,13,9,518,240,278,432,205,227,91,168,215,56,-16,13,53,77,127,0,-28,12,38,91,88,56,12,1,87,98,162,50,16,14,49,52,82,12,1,6,38,46,80,38,15,8
8,08203,Sant Cebrià de Vallalta,1625,119,60,59,12,7,5,10,8,55,34,12,-2,2,2,30,21,5,-1,8,6,25,13,7,-1,2,5,3,2,0,0,2,3,2,0,0,0,0,2,1,2,0,0,95,50,45,12,6,6,13,11,41,27,7,-3,7,3,22,13,5,-1,6,8,19,14,2,-2,3,2,3,4,0,0,1,1,1,3,0,0,2,1,2,1,0,0,92,46,46,20,7,13,2,7,39,22,15,4,1,-2,20,14,10,2,1,9,19,8,5,2,3,5,7,3,2,0,2,0,3,1,1,0,1,5,4,2,1,0,128,92,36,15,11,4,3,6,79,31,14,-5,4,6,43,29,10,-1,-1,0,36,2,4,-4,2,1,9,1,2,0,2,1,6,1,1,0,0,0,3,0,1,0,185,82,103,34,15,19,25,15,87,37,15,-1,13,3,35,25,6,-3,12,12,52,12,9,2,3,8,12,5,3,2,0,3,8,3,0,0,3,5,4,2,3,2,275,137,138,18,11,7,52,27,135,36,16,4,28,8,73,16,10,-2,24,19,62,20,6,6,2,3,9,1,2,1,1,1,5,1,2,1,1,2,4,0,0,0,203,82,121,16,-1,17,15,12,111,38,14,12,1,0,59,13,4,4,14,12,52,25,10,8,4,7,4,-1,2,-1,1,1,-2,-2,1,0,3,6,6,1,1,-1,85,37,48,15,8,7,17,14,10,13,26,8,8,5,6,6,11,2,9,9,4,7,15,6,3,3,2,0,4,3,3,1,-2,3,2,1,0,2,4,-3,2,2,64,34,30,22,13,9,15,8,34,9,-6,4,12,3,19,4,-5,1,3,5,15,5,-1,3,1,9,7,0,1,3,1,7,4,-1,1,1,0,2,3,1,0,2,43,26,17,3,3,0,6,-3,6,27,-2,7,7,2,1,10,0,3,-1,-5,5,17,-2,4,-3,3,-2,0,2,2,1,0,0,0,1,0,-4,3,-2,0,1,2,1,3,-2,8,4,4,2,-3,-9,-4,14,6,3,-3,3,-6,10,-1,-1,0,-12,2,4,7,6,2,-1,0,1,0,5,0,0,-3,2,0,1,2,-1,3,-1,0,-80,-38,-42,-28,-12,-16,-6,-22,0,-19,-24,-8,1,-7,-5,-8,-13,-5,-7,-15,5,-11,-11,-3,-4,-8,1,-9,-4,-4,0,-3,0,-6,-2,-1,-4,-5,1,-3,-2,-3,-16,-9,-7,9,4,5,-16,-5,17,-11,3,-7,-9,0,5,-4,-1,-1,-7,-5,12,-7,4,-6,2,1,2,0,3,1,2,0,0,1,2,-1,0,1,2,-1,1,2,-57,-27,-30,-1,2,-3,-13,-2,2,-27,-8,-8,2,-3,-8,-7,-3,-6,-15,1,10,-20,-5,-2,-4,3,1,-3,3,-1,-1,3,3,-1,-1,-1,-3,0,-2,-2,4,0,-16,-4,-12,5,1,4,-14,5,-12,7,-1,0,-10,1,-1,8,-3,1,-4,4,-11,-1,2,-1,0,3,1,4,-4,1,-1,0,3,1,-2,0,1,3,-2,3,-2,1,0,-1,1,1,-2,3,3,-5,2,3,-6,6,-3,-3,2,5,-3,1,6,-2,0,-2,-3,5,-4,-1,1,3,0,2,-4,0,-1,3,-1,1,0,-1,2,0,1,1,-12,-1,-11,-7,0,-7,5,-6,1,-5,4,-9,6,-3,3,-3,1,-3,-1,-3,-2,-2,3,-6,2,-1,-5,-3,3,-3,1,0,-3,-1,2,1,1,-1,-2,-2,1,-4,32,12,20,16,5,11,5,-5,25,3,-4,9,4,0,2,5,1,1,1,-5,23,-2,-5,8,1,-3,12,0,2,4,1,-3,5,-2,2,2,0,0,7,2,0,2
8,08205,Sant Cugat del Vallès,50168,1694,861,833,148,71,77,366,98,699,318,35,128,198,37,361,180,12,50,168,61,338,138,23,78,52,18,34,22,9,5,25,8,15,12,5,2,27,10,19,10,4,3,1688,849,839,146,74,72,476,45,583,372,68,119,276,23,263,196,30,50,200,22,320,176,38,69,78,11,19,19,8,4,38,6,10,11,3,2,40,5,9,8,5,2,1818,855,963,1101,532,569,478,191,592,368,32,120,256,99,253,187,19,31,222,92,339,181,13,89,282,218,310,193,49,30,140,104,153,93,25,9,142,114,157,100,24,21,2029,970,1059,1423,634,789,487,227,622,436,12,177,277,78,268,231,3,87,210,149,354,205,9,90,304,301,437,262,52,34,153,117,195,113,25,14,151,184,242,149,27,20,1042,406,636,1003,448,555,234,125,331,198,14,90,119,52,128,63,-9,27,115,73,203,135,23,63,183,211,331,187,54,20,95,77,153,83,28,9,88,134,178,104,26,11,1562,677,885,1001,450,551,363,149,541,292,41,130,179,40,225,146,16,43,184,109,316,146,25,87,177,218,326,182,58,18,85,75,153,85,30,10,92,143,173,97,28,8,1658,711,947,1371,590,781,421,258,534,232,26,137,231,82,195,124,7,50,190,176,339,108,19,87,261,324,430,229,79,22,136,125,195,88,31,4,125,199,235,141,48,18,1490,706,784,1234,559,675,411,274,415,252,-25,130,225,127,194,152,-30,28,186,147,221,100,5,102,259,315,363,214,45,16,143,136,166,82,17,5,116,179,197,132,28,11,1493,683,810,232,82,150,348,189,774,111,-79,66,184,67,349,45,-42,24,164,122,425,66,-37,42,88,179,115,-77,-63,-33,62,66,46,-58,-36,-10,26,113,69,-19,-27,-23,1829,854,975,425,151,274,299,173,876,233,61,109,162,63,443,125,4,23,137,110,433,108,57,86,104,116,181,-15,17,-5,44,25,76,-3,0,-4,60,91,105,-12,17,-1,890,392,498,-545,-277,-268,-23,93,649,33,-78,131,-12,12,315,31,-45,41,-11,81,334,2,-33,90,-166,73,-100,-262,-88,-20,-68,29,-28,-152,-51,-14,-98,44,-72,-110,-37,-6,1055,474,581,147,13,134,256,51,362,153,-31,182,172,-11,145,95,-30,60,84,62,217,58,-1,122,65,113,7,-63,-8,6,44,28,-9,-60,-9,6,21,85,16,-3,1,0,680,289,391,-68,-59,-9,16,63,339,9,15,193,3,41,170,-4,4,55,13,22,169,13,11,138,-38,67,27,-115,-36,9,-16,31,5,-68,-14,-4,-22,36,22,-47,-22,13,598,184,414,-169,-107,-62,104,27,212,62,-47,200,48,-11,61,37,-31,60,56,38,151,25,-16,140,12,65,-133,-90,-22,-7,18,22,-80,-60,-12,1,-6,43,-53,-30,-10,-8,531,185,346,-209,-168,-41,187,50,159,54,-108,126,104,8,45,37,-57,27,83,42,114,17,-51,99,13,94,-139,-172,-26,-2,-18,45,-74,-98,-29,-4,31,49,-65,-74,3,2,1232,609,623,484,260,224,347,145,284,296,-86,160,215,92,104,164,-59,47,132,53,180,132,-27,113,140,163,106,22,21,6,105,95,20,14,12,2,35,68,86,8,9,4,613,272,341,550,266,284,241,33,237,60,-113,96,136,-9,68,30,-31,36,105,42,169,30,-82,60,190,155,146,23,-17,17,110,64,75,4,-11,5,80,91,71,19,-6,12,517,212,305,831,366,465,189,100,88,162,-116,59,133,7,71,46,-57,-1,56,93,17,116,-59,60,201,188,180,184,27,23,129,40,90,77,2,13,72,148,90,107,25,10
8,08207,Sant Esteve de Palautordera,1363,39,9,30,4,1,3,8,3,8,8,5,5,3,1,0,2,0,3,5,2,8,6,5,2,2,1,1,0,0,0,1,0,0,0,0,0,1,1,1,0,0,0,67,37,30,16,7,9,13,6,27,12,5,2,7,3,16,8,2,1,6,3,11,4,3,1,2,1,7,5,0,0,0,1,4,2,0,0,2,0,3,3,0,0,89,34,55,23,12,11,28,6,28,13,7,7,12,1,8,5,3,4,16,5,20,8,4,3,8,4,4,4,1,2,3,2,3,2,1,1,5,2,1,2,0,1,123,45,78,54,31,23,36,18,50,22,-1,-1,0,7,21,18,0,1,36,11,29,4,-1,-2,13,11,17,10,2,1,5,7,9,9,1,0,8,4,8,1,1,1,147,88,59,50,25,25,39,20,35,43,11,-1,23,18,23,19,5,1,16,2,12,24,6,-2,14,5,15,12,3,1,5,4,9,6,1,0,9,1,6,6,2,1,109,55,54,25,16,9,32,6,38,18,7,5,8,6,23,10,3,3,24,0,15,8,4,2,4,6,5,6,4,0,0,4,7,4,1,0,4,2,-2,2,3,0,153,70,83,57,31,26,41,9,48,32,13,6,23,-1,21,12,6,6,18,10,27,20,7,0,9,17,18,10,2,0,7,7,10,3,2,1,2,10,8,7,0,-1,112,55,57,34,17,17,29,24,19,19,5,13,20,14,3,7,6,5,9,10,16,12,-1,8,7,13,8,4,0,2,6,7,1,3,0,0,1,6,7,1,0,2,63,36,27,12,-2,14,5,5,35,17,-5,3,3,-1,22,14,-5,0,2,6,13,3,0,3,6,4,2,1,-1,-1,1,1,1,-4,-1,-1,5,3,1,5,0,0,32,11,21,-2,-1,-1,8,1,20,0,3,1,1,0,14,-3,0,1,7,1,6,3,3,0,4,2,-7,-2,1,-1,4,-1,-4,-1,1,-1,0,3,-3,-1,0,0,-7,-14,7,-18,-7,-11,6,-9,7,-7,2,-6,2,-8,-1,-6,0,-2,4,-1,8,-1,2,-4,-1,-3,-9,-7,3,-1,0,0,-4,-4,1,0,-1,-3,-5,-3,2,-1,39,13,26,7,-1,8,8,6,4,14,1,5,1,1,2,2,6,1,7,5,2,12,-5,4,2,0,5,-2,0,1,2,-1,3,-4,-1,0,0,1,2,2,1,1,-10,-11,1,-7,-1,-6,8,1,-12,1,0,-6,5,2,-14,3,-2,-4,3,-1,2,-2,2,-2,2,0,-5,-4,0,0,2,3,-5,-2,1,0,0,-3,0,-2,-1,0,-13,-15,2,-13,-9,-4,11,0,-8,-9,-9,-2,2,2,-2,-7,-7,-3,9,-2,-6,-2,-2,1,0,3,-5,-8,-3,-1,-1,2,-3,-5,-2,0,1,1,-2,-3,-1,-1,19,20,-1,-9,0,-9,-4,-2,13,5,2,5,1,-4,10,4,7,3,-5,2,3,1,-5,2,-4,2,-4,-2,-1,-1,0,0,-3,1,2,0,-4,2,-1,-3,-3,-1,25,5,20,-2,-4,2,8,-8,5,13,1,4,1,-2,0,7,-3,0,7,-6,5,6,4,4,1,2,-1,-1,-2,-1,0,1,-2,-1,-2,0,1,1,1,0,0,-1,52,43,9,10,3,7,12,-2,16,38,-4,-8,11,2,1,31,3,-4,1,-4,15,7,-7,-4,3,0,0,6,1,0,1,0,-2,3,1,0,2,0,2,3,0,0,83,44,39,23,10,13,29,1,18,27,2,2,13,5,5,15,2,1,16,-4,13,12,0,1,2,8,9,4,0,-1,1,5,4,1,0,-1,1,3,5,3,0,0
8,08210,Sant Feliu de Codines,4179,157,104,53,75,61,14,19,50,51,8,13,12,21,31,31,7,7,3,-2,19,20,1,6,9,6,25,35,6,1,0,6,21,27,4,1,0,0,4,8,2,0,0,207,139,68,144,94,50,19,60,77,20,14,18,13,36,60,16,5,8,6,24,17,4,9,10,19,42,58,15,8,0,10,28,42,9,4,0,9,14,16,6,4,0,164,104,60,100,73,27,27,47,66,18,12,0,8,28,51,16,7,-1,19,19,15,2,5,1,15,37,31,15,1,1,7,26,25,12,2,1,8,11,6,3,-1,0,140,93,47,117,79,38,20,35,67,9,-1,8,7,19,58,6,1,2,13,16,9,3,-2,6,23,32,45,11,4,0,12,20,34,9,3,0,11,12,11,2,1,0,215,124,91,162,122,40,39,62,83,7,5,13,18,44,49,4,2,4,21,18,34,3,3,9,24,46,64,20,6,1,13,41,50,15,2,0,11,5,14,5,4,1,123,51,72,108,62,46,38,7,35,25,10,6,17,2,17,11,5,0,21,5,18,14,5,6,25,24,30,21,7,0,13,13,19,12,4,0,12,11,11,9,3,0,203,73,130,136,84,52,33,50,75,26,-6,17,11,19,41,4,-6,1,22,31,34,22,0,16,20,33,58,18,1,3,13,23,39,9,0,0,7,10,19,9,1,3,122,68,54,133,85,48,11,42,29,25,6,11,14,24,11,17,-1,5,-3,18,18,8,7,6,23,37,41,22,9,1,15,21,30,14,5,0,8,16,11,8,4,1,22,6,16,5,10,-5,17,38,-7,-36,5,7,18,17,-6,-29,3,4,-1,21,-1,-7,2,3,12,13,-13,-4,-2,-1,9,11,-5,-6,0,1,3,2,-8,2,-2,-2,113,45,68,14,2,12,29,26,39,18,-3,0,12,8,19,6,-5,4,17,18,20,12,2,-4,8,10,2,-2,-1,-3,6,4,0,-5,-2,-1,2,6,2,3,1,-2,147,49,98,20,-4,24,31,24,63,1,12,9,5,7,24,-1,4,5,26,17,39,2,8,4,13,3,-8,2,7,1,2,1,-8,-4,2,1,11,2,0,6,5,0,75,37,38,-4,-22,18,3,23,19,15,10,10,-3,12,19,7,4,1,6,11,0,8,6,9,5,1,-8,0,-1,-3,-1,-3,-13,-2,-2,-1,6,4,5,2,1,-2,-81,-70,-11,-79,-56,-23,-12,-17,-28,-29,-5,10,-8,-18,-25,-17,-2,0,-4,1,-3,-12,-3,10,-17,-7,-22,-18,-11,-4,-9,-6,-16,-16,-6,-3,-8,-1,-6,-2,-5,-1,-105,-57,-48,-67,-41,-26,-22,-7,-18,-46,-10,-1,-11,-4,-7,-33,-3,2,-11,-3,-11,-13,-7,-3,-10,-9,-21,-17,-11,1,-8,-5,-13,-12,-4,1,-2,-4,-8,-5,-7,0,13,5,8,-22,-19,-3,-8,16,32,-20,-1,-8,0,5,16,-8,-3,-6,-8,11,16,-12,2,-2,-4,10,-4,-12,-6,-7,-1,1,-5,-7,-4,-3,-3,9,1,-5,-2,-4,84,47,37,3,-2,5,17,27,-4,23,14,7,18,9,-5,19,2,4,-1,18,1,4,12,3,5,10,-9,-8,2,2,7,4,-8,-2,-4,1,-2,6,-1,-6,6,1,79,57,22,19,17,2,-7,17,34,21,13,3,0,19,24,10,6,0,-7,-2,10,11,7,3,0,7,23,-6,-5,0,2,6,15,-5,-1,0,-2,1,8,-1,-4,0,119,64,55,27,20,7,28,44,5,20,11,11,13,25,4,6,7,7,15,19,1,14,4,4,3,21,1,2,2,-2,3,13,0,3,1,0,0,8,1,-1,1,-2
8,08211,Sant Feliu de Llobregat,36953,1135,611,524,335,169,166,148,209,510,203,31,29,76,87,280,129,18,15,72,122,230,74,13,14,48,94,125,42,20,4,19,41,75,21,8,3,29,53,50,21,12,1,729,328,401,450,221,229,132,155,294,97,-39,91,57,81,139,46,-22,26,75,74,155,51,-17,65,86,125,142,71,16,7,38,65,70,39,6,2,48,60,72,32,10,5,421,204,217,577,293,284,34,119,186,65,-13,18,17,44,108,45,-18,3,17,75,78,20,5,15,105,146,178,100,32,9,42,74,108,52,9,5,63,72,70,48,23,4,251,76,175,486,223,263,68,66,71,29,-21,36,30,19,30,6,-11,0,38,47,41,23,-10,36,101,120,146,74,29,11,49,48,72,37,7,6,52,72,74,37,22,5,-25,-44,19,411,192,219,-4,60,-45,-8,-52,35,-21,38,-13,1,-39,-2,17,22,-32,-9,-13,37,86,105,121,66,24,8,36,50,74,24,6,2,50,55,47,42,18,6,-11,-75,64,435,221,214,-9,32,-46,11,-24,18,-32,2,4,-13,-30,-5,23,30,-50,24,6,23,72,107,131,89,23,9,40,46,74,48,7,4,32,61,57,41,16,5,-16,-62,46,471,217,254,-21,35,10,17,-67,7,-12,9,-10,-12,-31,-6,-9,26,20,29,-36,13,82,125,135,95,20,7,40,48,65,49,11,1,42,77,70,46,9,6,177,29,148,515,267,248,56,139,-14,23,-24,10,36,70,-54,21,-25,-7,20,69,40,2,1,17,95,146,151,84,32,3,53,76,75,46,18,-1,42,70,76,38,14,4,-44,-65,21,158,64,94,9,84,-33,-52,-39,-13,-7,35,-15,-29,-32,-16,16,49,-18,-23,-7,3,70,60,39,-10,1,-2,36,24,16,-10,-3,2,34,36,23,0,4,-4,85,72,13,147,72,75,20,70,20,41,-41,-23,30,45,23,2,-27,2,-10,25,-3,39,-14,-25,17,86,23,14,2,4,12,43,16,-3,0,3,5,43,7,17,2,1,-298,-162,-136,-167,-86,-81,-17,-21,-90,-120,-76,11,3,-20,-49,-79,-29,2,-20,-1,-41,-41,-47,9,-21,-11,-69,-31,-26,-9,-10,-13,-35,-18,-8,-3,-11,2,-34,-13,-18,-6,433,209,224,198,73,125,65,90,168,69,-12,44,33,38,106,38,-19,8,32,52,62,31,7,36,27,65,59,36,5,2,7,32,24,14,-5,0,20,33,35,22,10,2,86,-32,118,-131,-95,-36,10,6,32,13,10,8,-5,-19,-28,-1,12,7,15,25,60,14,-2,1,-21,4,-64,-35,-15,-4,-16,-15,-40,-17,-7,-2,-5,19,-24,-18,-8,-2,-7,14,-21,-16,0,-16,25,45,-27,-4,-49,3,33,28,-1,-30,-16,-2,-8,17,-26,26,-33,5,-3,33,-7,-28,-15,0,4,17,9,-27,-3,-2,-7,16,-16,-1,-12,2,-16,-67,51,-190,-106,-84,50,37,21,-76,-46,-3,12,25,-1,-61,-33,-5,38,12,22,-15,-13,2,-10,19,-49,-88,-45,-19,-1,7,-20,-52,-31,-8,-9,12,-29,-36,-14,-11,197,98,99,18,18,0,60,58,54,-25,35,10,24,30,48,-38,28,6,36,28,6,13,7,4,20,30,-5,-26,5,-6,9,18,13,-24,4,-1,11,12,-18,-2,1,-5,87,3,84,-20,-26,6,31,44,72,7,-56,-11,17,1,20,6,-34,-10,14,43,52,1,-22,-1,6,39,-25,-30,-14,1,1,14,-19,-18,-6,-2,5,25,-6,-12,-8,3,270,102,168,210,73,137,64,69,121,37,-15,-4,34,25,54,15,-18,-9,30,44,67,22,3,5,27,63,60,27,20,12,7,17,27,15,6,0,20,46,33,12,14,12
8,08209,Sant Fost de Campsentelles,6034,188,72,116,37,19,18,62,10,51,56,2,6,27,-5,26,25,-4,2,35,15,25,31,6,4,10,5,14,7,0,0,5,3,7,3,0,0,5,2,7,4,0,0,179,99,80,30,9,21,53,2,61,40,10,9,30,14,15,19,12,6,23,-12,46,21,-2,3,7,6,10,3,2,2,2,2,3,1,0,1,5,4,7,2,2,1,103,60,43,28,20,8,22,-1,25,28,6,23,12,7,17,17,4,2,10,-8,8,11,2,21,6,6,12,4,0,0,5,6,7,2,0,0,1,0,5,2,0,0,185,107,78,48,19,29,58,-5,32,76,10,15,37,-10,25,44,8,4,21,5,7,32,2,11,10,10,7,13,4,4,6,3,3,6,0,1,4,7,4,7,4,3,141,73,68,34,22,12,17,-12,50,18,9,54,11,-4,29,11,6,17,6,-8,21,7,3,37,9,4,11,8,1,1,7,1,9,4,1,0,2,3,2,4,0,1,155,62,93,25,13,12,36,10,46,36,-3,24,20,-1,14,24,-7,10,16,11,32,12,4,14,4,6,7,8,1,-1,2,4,3,5,0,-1,2,2,4,3,1,0,177,87,90,22,16,6,59,-5,38,35,-6,54,33,-10,32,13,1,16,26,5,6,22,-7,38,3,8,5,2,1,3,2,4,5,2,1,2,1,4,0,0,0,1,292,143,149,33,20,13,69,5,75,38,3,92,40,4,44,21,9,19,29,1,31,17,-6,73,5,9,7,9,3,0,4,6,5,4,1,0,1,3,2,5,2,0,308,148,160,46,24,22,56,24,80,23,24,102,40,11,45,10,17,25,16,13,35,13,7,77,8,14,12,1,5,4,5,9,6,-1,2,2,3,5,6,2,3,2,129,39,90,12,12,0,45,-9,5,9,5,78,40,-8,-5,-3,-2,16,5,-1,10,12,7,62,7,9,-5,4,1,-4,6,6,-4,1,2,0,1,3,-1,3,-1,-4,186,109,77,10,3,7,38,-1,15,19,26,87,19,5,17,16,22,28,19,-6,-2,3,4,59,3,8,-3,-1,3,0,-1,4,-3,1,2,0,4,4,0,-2,1,0,107,37,70,6,5,1,7,1,-7,-3,10,95,1,-4,4,-2,6,29,6,5,-11,-1,4,66,0,4,-2,3,1,0,1,1,-1,3,1,0,-1,3,-1,0,0,0,129,43,86,6,3,3,28,-4,13,16,11,66,18,1,1,0,5,17,10,-5,12,16,6,49,0,3,6,-1,-1,-1,1,2,3,-2,-1,0,-1,1,3,1,0,-1,137,56,81,-33,-14,-19,43,-17,39,18,-15,65,40,-7,3,9,-9,18,3,-10,36,9,-6,47,0,-6,-16,-4,-6,-1,1,-2,-8,-3,-1,-1,-1,-4,-8,-1,-5,0,-12,-12,0,-33,-12,-21,-8,-22,-19,-12,-21,71,-15,-9,0,8,-9,14,7,-13,-19,-20,-12,57,-7,-8,-7,-9,-4,0,-2,-5,-1,-3,-1,-1,-5,-3,-6,-6,-3,1,102,29,73,-4,-7,3,25,0,-1,10,-7,73,8,-3,-1,11,-1,15,17,3,0,-1,-6,58,2,4,-6,-4,0,0,0,0,-7,0,0,0,2,4,1,-4,0,0,103,12,91,-8,-9,1,15,-12,8,32,-21,78,-5,-11,8,7,-9,22,20,-1,0,25,-12,56,-5,2,-6,-3,2,1,-4,1,-4,-2,-1,1,-1,1,-2,-1,3,0,118,36,82,25,11,14,33,-7,26,12,-12,59,17,-4,14,1,-8,10,16,-3,12,11,-4,49,5,5,15,-3,-1,2,3,2,9,-5,0,1,2,3,6,2,-1,1
8,08213,Sant Fruitós de Bages,5453,143,68,75,2,1,1,40,36,38,36,-7,-9,14,17,20,22,-5,-3,26,19,18,14,-2,-6,1,0,0,1,0,0,1,0,0,0,0,0,0,0,0,1,0,0,224,125,99,20,9,11,51,40,83,35,10,5,27,18,50,20,7,2,24,22,33,15,3,3,3,7,6,4,0,0,2,3,2,2,0,0,1,4,4,2,0,0,279,138,141,56,28,28,57,38,99,46,18,12,26,12,51,29,9,7,31,26,48,17,9,5,8,16,18,7,3,3,4,5,11,3,1,3,4,11,7,4,2,0,245,143,102,27,18,9,44,52,87,53,3,8,31,31,44,33,4,3,13,21,43,20,-1,5,8,8,6,6,0,-1,7,3,2,6,1,-1,1,5,4,0,-1,0,82,54,28,27,14,13,13,-4,38,27,5,4,8,3,27,17,3,-1,5,-7,11,10,2,5,9,8,6,2,1,0,4,7,2,1,0,0,5,1,4,1,1,0,348,202,146,53,36,17,56,56,117,80,23,9,40,30,70,40,15,2,16,26,47,40,8,7,7,17,11,13,3,0,4,11,10,10,0,0,3,6,1,3,3,0,182,94,88,28,9,19,17,39,82,29,8,9,10,15,41,19,8,3,7,24,41,10,0,6,4,1,14,6,2,0,-1,1,4,2,2,0,5,0,10,4,0,0,282,132,150,54,20,34,80,41,73,70,12,9,38,12,34,43,4,4,42,29,39,27,8,5,15,14,16,4,2,3,2,7,7,3,1,0,13,7,9,1,1,3,147,73,74,33,8,25,27,31,47,20,22,-2,12,18,23,6,10,3,15,13,24,14,12,-5,14,15,-8,7,1,2,4,7,-6,0,1,1,10,8,-2,7,0,1,162,65,97,17,0,17,44,18,56,21,13,6,20,-3,26,5,15,1,24,21,30,16,-2,5,5,2,8,1,1,0,0,-3,4,-2,2,-1,5,5,4,3,-1,1,-58,-20,-38,4,-7,11,0,0,-31,-11,-6,-6,10,-3,-9,-8,-2,-6,-10,3,-22,-3,-4,0,6,6,1,-7,-2,-1,4,2,-4,-7,-1,-1,2,4,5,0,-1,0,-14,-1,-13,-21,-8,-13,-2,-15,3,-17,12,7,8,-20,13,-18,15,2,-10,5,-10,1,-3,5,0,7,-11,-10,-6,-2,1,1,5,-11,-3,-1,-1,6,-16,1,-3,-1,30,20,10,17,6,11,16,-11,13,9,-4,3,6,-1,3,9,-2,4,10,-10,10,0,-2,-1,0,4,6,6,1,-1,-2,4,3,1,0,0,2,0,3,5,1,-1,-46,-40,-6,-3,-4,1,-4,-9,-34,-21,22,0,4,-10,-23,-16,10,-3,-8,1,-11,-5,12,3,1,1,-6,-2,4,-2,2,0,-5,-2,3,-2,-1,1,-1,0,1,0,86,42,44,-3,-2,-1,32,14,36,9,-1,-4,13,7,20,9,-2,-8,19,7,16,0,1,4,1,9,-1,-9,0,-3,-1,5,0,-5,1,-2,2,4,-1,-4,-1,-1,-7,-26,19,21,9,12,-12,5,-4,-8,6,5,-14,-1,-9,-9,1,6,2,6,5,1,5,-1,6,9,3,1,2,0,1,5,0,1,1,1,5,4,3,0,1,-1,112,41,71,-6,-13,7,41,13,24,22,-5,20,18,1,13,15,-5,1,23,12,11,7,0,19,0,5,-4,-6,-1,0,0,-1,-9,1,-3,-1,0,6,5,-7,2,1,88,56,32,8,8,0,15,-2,33,11,12,19,13,-3,19,9,7,9,2,1,14,2,5,10,2,2,2,4,-1,-3,4,-1,4,0,0,-1,-2,3,-2,4,-1,-2
8,08218,Sant Joan de Vilatorrada,8917,168,86,82,21,10,11,31,36,41,24,22,10,19,10,27,11,13,3,12,26,14,13,9,7,3,5,9,3,0,1,3,2,2,2,0,1,0,3,7,1,0,0,-22,3,-25,36,30,6,0,-7,1,2,-11,-7,-2,6,8,3,-7,-4,2,-13,-7,-1,-4,-3,4,10,11,10,0,0,3,9,8,10,0,0,1,1,3,0,0,0,161,98,63,80,42,38,17,34,59,27,18,1,14,15,39,12,9,4,3,19,20,15,9,-3,13,23,16,23,5,0,5,12,10,14,1,0,8,11,6,9,4,0,118,61,57,63,37,26,28,37,50,-5,3,6,9,19,23,2,1,8,19,18,27,-7,2,-2,8,14,20,17,1,3,4,7,14,11,0,1,4,7,6,6,1,2,153,101,52,86,41,45,20,50,67,10,8,-4,24,28,35,8,3,-1,-4,22,32,2,5,-3,13,28,30,13,1,1,7,13,13,8,0,0,6,15,17,5,1,1,67,42,25,96,46,50,16,29,24,-18,11,5,22,9,18,-15,9,-1,-6,20,6,-3,2,6,29,24,26,13,2,1,22,12,6,5,1,0,7,12,20,8,1,1,26,39,-13,101,55,46,13,4,-15,17,-4,7,4,8,15,15,2,-4,9,-4,-30,2,-6,11,19,26,22,25,7,0,10,12,14,16,3,0,9,14,8,9,4,0,173,125,48,168,96,72,44,50,48,36,-9,-1,31,29,43,19,-5,5,13,21,5,17,-4,-6,44,36,59,23,5,0,17,20,42,14,1,1,27,16,17,9,4,-1,108,69,39,111,58,53,40,33,15,18,2,-5,17,12,14,15,10,-3,23,21,1,3,-8,-2,42,19,31,19,0,-1,23,7,14,13,1,-1,19,12,17,6,-1,0,21,-20,41,-18,-24,6,25,14,0,-24,5,1,12,-2,-2,-31,4,-2,13,16,2,7,1,3,-3,13,-9,-14,-5,0,-1,3,-7,-15,-4,0,-2,10,-2,1,-1,0,-96,-75,-21,-23,-36,13,-15,1,-44,-39,3,-2,-7,-12,-20,-31,-3,-2,-8,13,-24,-8,6,0,8,5,-14,-18,1,-5,5,-3,-14,-21,0,-3,3,8,0,3,1,-2,-8,-11,3,-18,-14,-4,13,5,-19,-7,-11,6,4,6,-7,-11,-10,5,9,-1,-12,4,-1,1,-1,3,-5,-14,0,-1,-1,2,-1,-14,1,0,0,1,-4,0,-1,-1,-11,-29,18,-6,-21,15,-2,-10,23,-15,-4,-1,-8,-8,0,-15,0,1,6,-2,23,0,-4,-2,6,0,-4,-9,1,0,-1,-2,-7,-8,-2,-1,7,2,3,-1,3,1,-52,-21,-31,-82,-51,-31,4,-13,-25,-40,4,15,3,7,-9,-29,-1,6,1,-20,-16,-11,5,9,-9,0,-24,-43,-10,3,-8,2,-16,-27,-5,2,-1,-2,-8,-16,-5,1,8,-2,10,-15,-5,-10,19,16,-6,-22,-5,6,7,4,-2,-11,-2,1,12,12,-4,-11,-3,5,-6,2,-2,-7,-1,-1,-4,1,2,-3,0,-1,-2,1,-4,-4,-1,0,8,13,-5,8,6,2,21,1,-5,-20,8,4,18,2,-6,-6,5,0,3,-1,1,-14,3,4,11,-6,8,-8,4,-1,9,-5,4,-4,4,-2,2,-1,4,-4,0,1,53,15,38,48,19,29,39,-8,16,2,-5,5,15,-8,11,-5,-3,3,24,0,5,7,-2,2,15,16,9,6,2,-1,5,9,6,-1,0,0,10,7,3,7,2,-1,26,30,-4,34,21,13,3,0,2,14,-3,5,-2,3,7,17,0,2,5,-3,-5,-3,-3,3,9,6,11,10,1,-3,2,4,9,7,0,-1,7,2,2,3,1,-2
8,08217,Sant Joan Despí,27470,471,220,251,193,101,92,110,34,259,65,7,-8,58,5,138,32,-1,-13,52,29,121,33,8,5,49,32,66,34,9,1,32,17,26,18,6,0,17,15,40,16,3,1,582,322,260,206,109,97,73,66,362,58,-9,28,48,51,166,40,1,11,25,15,196,18,-10,17,41,51,69,36,5,2,20,29,37,19,1,2,21,22,32,17,4,0,672,302,370,261,127,134,109,107,387,104,-17,-24,51,50,167,63,-11,-19,58,57,220,41,-6,-5,47,69,88,40,13,1,21,36,44,24,1,0,26,33,44,16,12,1,180,71,109,167,81,86,32,82,112,-6,-44,1,10,36,85,-35,-24,-3,22,46,27,29,-20,4,56,41,32,24,12,0,27,17,18,10,9,0,29,24,14,14,3,0,136,54,82,235,107,128,8,86,64,10,-28,-1,23,31,38,0,-25,-8,-15,55,26,10,-3,7,43,71,79,32,5,2,21,33,39,12,-1,1,22,38,40,20,6,1,-84,-80,-4,232,114,118,2,4,-17,-35,-42,7,23,-15,-38,-28,-22,0,-21,19,21,-7,-20,7,51,46,67,38,12,13,29,17,36,15,5,7,22,29,31,23,7,6,152,88,64,269,113,156,10,33,93,7,-3,8,11,10,50,7,11,-3,-1,23,43,0,-14,11,45,68,88,43,14,5,20,19,40,22,8,3,25,49,48,21,6,2,-152,-153,1,206,83,123,-15,29,-62,-42,-72,12,-12,2,-51,-35,-51,-3,-3,27,-11,-7,-21,15,45,69,47,35,7,4,26,26,10,21,-3,4,19,43,37,14,10,0,77,39,38,230,99,131,16,64,-11,8,-6,0,8,36,-13,-12,10,5,8,28,2,20,-16,-5,50,62,70,32,9,2,23,25,34,10,3,1,27,37,36,22,6,1,102,22,80,48,6,42,52,-1,45,28,-2,-22,41,-11,3,13,-7,-18,11,10,42,15,5,-4,30,15,11,-7,0,-3,16,7,-3,-10,-3,-3,14,8,14,3,3,0,145,66,79,36,11,25,36,76,76,-37,-48,25,25,46,45,-18,-41,4,11,30,31,-19,-7,21,13,39,-8,-13,-1,1,10,17,-8,-11,-2,1,3,22,0,-2,1,0,22,-9,31,-79,-48,-31,22,11,-20,2,-20,18,22,-7,-17,-7,-6,4,0,18,-3,9,-14,14,-28,22,-47,-31,3,-1,-6,1,-28,-20,4,-1,-22,21,-19,-11,-1,0,-21,-12,-9,-73,-52,-21,3,3,16,-12,-21,-13,2,-4,3,4,-17,-3,1,7,13,-16,-4,-10,2,-5,-16,-40,-12,-2,-1,-11,-8,-27,-6,1,3,6,-8,-13,-6,-3,125,59,66,-48,-30,-18,61,40,76,-8,-31,-25,31,12,46,-4,-18,-14,30,28,30,-4,-13,-11,-1,20,-22,-24,-13,-12,0,10,-13,-20,-5,-4,-1,10,-9,-4,-8,-8,248,116,132,48,5,43,69,36,69,42,-8,28,42,21,30,20,-7,6,27,15,39,22,-1,22,19,18,9,-15,7,5,3,7,4,-13,2,0,16,11,5,-2,5,5,149,15,134,24,-4,28,17,-12,144,50,-63,1,-3,-11,53,31,-45,-12,20,-1,91,19,-18,13,-7,22,13,-12,-4,8,-3,8,5,-9,-6,0,-4,14,8,-3,2,8,270,104,166,132,42,90,83,28,131,21,-4,2,35,8,76,-13,-2,-6,48,20,55,34,-2,8,38,17,28,26,8,12,18,5,10,5,0,2,20,12,18,21,8,10,159,50,109,202,55,147,42,45,72,35,-19,-23,4,11,37,8,-7,-5,38,34,35,27,-12,-18,50,34,59,38,14,4,14,6,15,12,4,4,36,28,44,26,10,0
8,08220,Sant Julià de Vilatorta,2203,62,40,22,22,13,9,19,6,9,21,2,5,12,6,7,8,4,3,7,0,2,13,-2,2,8,6,4,3,0,0,6,5,2,0,0,0,2,1,2,3,0,0,118,65,53,16,4,12,29,16,49,14,3,4,12,9,28,9,2,3,17,7,21,5,1,1,4,6,1,4,0,0,0,3,0,1,0,0,4,3,1,3,0,0,89,44,45,18,6,12,23,11,17,24,7,4,12,7,3,14,4,3,11,4,14,10,3,1,4,3,7,3,0,0,1,1,3,1,0,0,3,2,4,2,0,0,48,17,31,6,2,4,16,4,27,-2,-2,1,6,-2,14,1,-3,-1,10,6,13,-3,1,2,2,1,3,0,0,0,0,0,2,0,0,0,2,1,1,0,0,0,90,45,45,13,7,6,14,12,27,25,4,10,7,3,15,16,1,5,7,9,12,9,3,5,4,3,3,3,0,0,3,1,1,2,0,0,1,2,2,1,0,0,67,27,40,11,6,5,19,-7,33,10,7,3,11,-8,16,5,3,1,8,1,17,5,4,2,1,2,5,1,2,0,1,0,3,1,1,0,0,2,2,0,1,0,55,29,26,12,7,5,20,5,10,13,3,4,7,7,5,6,5,-1,13,-2,5,7,-2,5,2,5,5,1,-1,0,0,3,3,1,0,0,2,2,2,0,-1,0,36,3,33,19,6,13,11,3,15,1,-4,8,6,-4,7,-4,-4,2,5,7,8,5,0,6,4,7,4,2,1,0,2,2,2,0,0,0,2,5,2,2,1,0,21,12,9,2,1,1,-7,5,4,11,4,2,-3,4,0,7,3,1,-4,1,4,4,1,1,1,3,-1,0,-1,0,1,1,0,0,-1,0,0,2,-1,0,0,0,2,1,1,-4,-1,-3,5,2,-9,8,0,-5,1,2,-6,4,-1,-1,4,0,-3,4,1,-4,-1,0,-2,-1,0,0,0,0,0,-1,0,0,-1,0,-2,0,0,0,5,10,-5,2,2,0,-4,-4,-7,15,0,4,5,-4,-4,11,0,1,-9,0,-3,4,0,3,0,1,-1,2,0,0,3,1,-1,-1,0,0,-3,0,0,3,0,0,25,12,13,1,1,0,13,-3,17,-8,2,0,7,0,9,-5,0,1,6,-3,8,-3,2,-1,0,-1,1,0,1,0,1,0,1,-1,0,0,-1,-1,0,1,1,0,41,19,22,11,7,4,15,4,-1,15,2,2,3,0,4,3,3,4,12,4,-5,12,-1,-2,5,0,3,3,0,0,4,0,2,1,0,0,1,0,1,2,0,0,36,12,24,0,-2,2,9,1,13,8,-1,5,3,-3,7,7,-4,1,6,4,6,1,3,4,1,0,0,-1,0,0,1,0,-2,-1,0,0,0,0,2,0,0,0,-3,-5,2,-17,-12,-5,1,0,-1,-4,-1,-1,-1,-4,0,-4,4,-2,2,4,-1,0,-5,1,-4,1,-5,-8,-2,1,-3,0,-3,-6,0,0,-1,1,-2,-2,-2,1,2,-1,3,9,3,6,2,-2,-2,2,2,-3,-2,5,-8,4,2,-2,4,-7,6,-2,0,-1,0,3,2,0,3,0,0,2,0,-1,2,0,0,1,2,1,1,0,17,23,-6,1,-1,2,17,-6,4,7,-2,-5,20,-3,1,8,-3,-2,-3,-3,3,-1,1,-3,2,-4,3,1,-1,0,0,-1,1,0,-1,0,2,-3,2,1,0,0,5,7,-2,4,-1,5,-15,4,-3,4,11,2,-11,7,2,1,6,1,-4,-3,-5,3,5,1,-4,3,0,1,3,0,-4,3,0,-1,1,0,0,0,0,2,2,0
8,08222,Sant Llorenç d'Hortons,1502,92,52,40,7,6,1,12,0,47,12,8,9,3,2,27,9,3,5,9,-2,20,3,5,4,0,2,2,3,0,0,0,1,2,3,0,0,0,1,0,0,0,0,136,69,67,11,6,5,26,9,41,37,12,9,12,4,22,19,8,3,14,5,19,18,4,6,0,3,3,1,4,0,0,1,3,0,2,0,0,2,0,1,2,0,61,28,33,17,12,5,20,-2,30,2,4,6,8,2,13,3,1,1,12,-4,17,-1,3,5,4,6,2,4,1,0,3,5,1,2,1,0,1,1,1,2,0,0,94,40,54,18,5,13,2,10,45,24,8,3,1,3,17,12,3,3,1,7,28,12,5,0,2,7,6,3,0,0,0,1,2,2,0,0,2,6,4,1,0,0,71,39,32,9,2,7,8,17,31,15,0,-1,10,4,16,7,1,0,-2,13,15,8,-1,-1,0,6,3,-1,1,0,0,2,0,-1,1,0,0,4,3,0,0,0,91,55,36,17,13,4,16,27,40,6,5,-3,8,19,26,2,2,-3,8,8,14,4,3,0,-1,6,8,3,1,0,0,5,6,2,0,0,-1,1,2,1,1,0,86,51,35,33,18,15,16,9,46,10,0,4,6,7,22,14,1,1,10,2,24,-4,-1,3,8,5,9,8,1,1,2,3,7,6,0,0,6,2,2,2,1,1,80,53,27,27,16,11,1,24,41,7,11,-2,5,12,31,3,7,-3,-4,12,10,4,4,1,5,8,6,5,2,1,3,3,5,3,2,0,2,5,1,2,0,1,95,41,54,32,13,19,19,17,38,19,2,-1,11,6,23,4,-1,-3,8,11,15,15,3,2,9,9,10,5,0,0,4,5,4,1,0,0,5,4,6,4,0,0,-18,-26,8,-14,-16,2,-3,-2,-9,-5,-1,4,-12,0,-10,-4,-1,2,9,-2,1,-1,0,2,-2,3,-6,-6,-2,-1,-3,1,-9,-3,-2,0,1,2,3,-3,0,-1,54,27,27,10,0,10,2,4,18,18,4,4,5,5,3,7,3,1,-3,-1,15,11,1,3,5,4,-3,4,0,0,3,0,-3,0,0,0,2,4,0,4,0,0,22,8,14,5,2,3,-6,6,5,5,6,7,-3,2,5,-4,5,5,-3,4,0,9,1,2,-3,4,1,2,2,-1,-1,1,0,1,1,0,-2,3,1,1,1,-1,3,4,-1,-15,-5,-10,-2,1,-10,6,7,0,0,0,-9,10,2,0,-2,1,-1,-4,5,0,-6,-2,-8,1,1,-1,-1,0,-4,0,0,0,-5,-2,-4,1,1,-1,-11,-8,-3,0,0,0,-6,1,4,-3,-4,-1,-3,1,3,-2,-9,2,-3,0,1,-1,5,-3,-1,0,1,-3,3,0,1,0,0,-2,1,0,-2,0,1,-1,2,0,18,14,4,-4,-5,1,1,4,-3,10,-2,6,4,3,0,1,1,2,-3,1,-3,9,-3,4,0,2,-5,2,-3,0,0,1,-4,1,-3,0,0,1,-1,1,0,0,10,25,-15,4,1,3,-2,5,3,-11,10,2,1,5,11,-4,5,4,-3,0,-8,-7,5,-2,3,-1,3,-1,0,0,2,-2,1,0,0,0,1,1,2,-1,0,0,-10,-5,-5,8,1,7,-17,3,-2,2,-1,5,-11,2,3,-1,1,2,-6,1,-5,3,-2,3,2,2,-1,0,2,1,1,1,-2,0,0,1,1,1,1,0,2,0,50,28,22,11,9,2,2,8,19,11,2,6,4,4,2,12,3,3,-2,4,17,-1,-1,3,-1,6,1,6,-1,0,1,2,0,6,0,0,-2,4,1,0,-1,0
8,08227,Sant Martí Sarroca,2457,36,16,20,25,16,9,2,12,10,4,2,4,0,4,8,-2,2,2,2,8,2,6,0,2,3,9,10,3,0,0,2,5,8,1,0,0,1,4,2,2,0,0,18,8,10,30,15,15,-5,2,12,4,4,0,-7,8,6,0,0,1,2,-6,6,4,4,-1,5,7,11,5,2,0,1,4,6,3,1,0,4,3,5,2,1,0,32,35,-3,32,26,6,9,-7,25,3,5,-4,5,0,19,8,2,1,4,-7,6,-5,3,-5,6,6,12,7,1,0,3,6,9,7,1,0,3,0,3,0,0,0,75,27,48,53,23,30,27,19,12,18,2,-6,14,8,2,4,1,-4,13,11,10,14,1,-2,17,11,18,4,1,0,10,5,6,2,-1,0,7,6,12,2,2,0,56,49,7,41,23,18,13,5,27,12,-2,1,9,6,17,15,0,0,4,-1,10,-3,-2,1,5,9,21,7,-1,0,3,2,14,5,-1,0,2,7,7,2,0,0,123,59,64,16,9,7,20,37,43,13,6,2,12,19,22,1,4,0,8,18,21,12,2,2,1,8,6,-2,3,0,1,6,4,-3,1,0,0,2,2,1,2,0,185,97,88,16,8,8,31,11,85,27,14,13,19,3,45,17,6,5,12,8,40,10,8,8,-1,5,6,3,2,0,-2,3,3,3,0,0,1,2,3,0,2,0,68,18,50,16,2,14,25,9,23,3,13,-6,6,4,4,-4,7,0,19,5,19,7,6,-6,6,0,9,1,0,0,3,-1,3,-3,0,0,3,1,6,4,0,0,59,25,34,20,10,10,4,28,22,2,5,-2,4,10,13,-6,2,3,0,18,9,8,3,-5,2,11,7,2,0,-2,1,4,3,2,1,-1,1,7,4,0,-1,-1,30,8,22,11,4,7,10,-1,16,-12,2,15,8,0,7,-12,0,5,2,-1,9,0,2,10,3,3,1,2,3,0,4,2,-1,-1,1,0,-1,1,2,3,2,0,34,10,24,-8,-10,2,10,-4,6,7,0,13,4,-5,4,2,1,5,6,1,2,5,-1,8,1,-1,-5,1,-2,-2,0,-3,-6,1,-1,-1,1,2,1,0,-1,-1,23,13,10,17,5,12,1,9,-1,15,0,-1,-5,3,-1,16,-3,4,6,6,0,-1,3,-5,3,5,5,-2,2,3,-1,3,2,-1,0,2,4,2,3,-1,2,1,-36,-34,-2,-9,-8,-1,-10,-8,-10,-4,0,-2,-13,-4,-4,-9,-1,-1,3,-4,-6,5,1,-1,-6,0,2,-5,-1,1,-4,-1,0,-3,-1,1,-2,1,2,-2,0,0,-27,-16,-11,4,0,4,-8,5,1,-6,-4,-16,-1,-3,3,-5,-1,-9,-7,8,-2,-1,-3,-7,2,3,-1,0,0,0,1,1,-2,0,0,0,1,2,1,0,0,0,-51,-37,-14,-12,-5,-7,-14,-14,-6,-10,-4,-4,-13,-4,-2,-7,-6,-5,-1,-10,-4,-3,2,1,-7,0,-5,-6,4,1,-3,0,-4,-2,3,0,-4,0,-1,-4,1,1,6,6,0,8,6,2,-3,-6,0,15,-9,9,-2,-2,2,12,-7,5,-1,-4,-2,3,-2,4,-1,2,4,2,1,0,-1,1,4,1,1,0,0,1,0,1,0,0,98,52,46,9,6,3,24,6,19,34,0,13,14,2,5,24,1,6,10,4,14,10,-1,7,0,2,1,4,0,1,0,0,1,3,1,1,0,2,0,1,-1,0,36,20,16,10,9,1,2,7,10,5,18,-7,2,4,5,5,10,-6,0,3,5,0,8,-1,0,1,5,3,3,-2,0,1,3,4,2,-1,0,0,2,-1,1,-1
8,08231,Sant Pere de Ribes,21057,683,324,359,263,136,127,91,158,176,114,69,67,41,70,105,59,31,18,50,88,71,55,38,49,57,56,74,47,17,9,25,27,41,30,8,4,32,29,33,17,9,5,644,320,324,339,182,157,71,129,239,89,61,42,34,65,135,44,24,14,37,64,104,45,37,28,67,70,102,59,24,9,36,39,59,30,11,1,31,31,43,29,13,8,643,333,310,508,274,234,95,152,212,85,43,56,31,67,142,61,4,32,64,85,70,24,39,24,110,97,158,92,41,5,57,53,89,47,22,3,53,44,69,45,19,2,592,294,298,407,187,220,53,179,152,98,61,44,34,87,67,69,23,14,19,92,85,29,38,30,84,106,114,66,25,5,36,51,51,38,8,1,48,55,63,28,17,4,578,340,238,560,296,264,-8,159,270,98,49,12,-1,73,167,74,23,6,-7,86,103,24,26,6,98,117,162,131,40,5,40,65,98,68,21,2,58,52,64,63,19,3,915,420,495,513,241,272,150,192,331,133,44,57,59,90,158,68,22,22,91,102,173,65,22,35,133,98,151,79,32,12,53,44,75,49,14,3,80,54,76,30,18,9,672,320,352,523,226,297,106,138,270,97,29,40,62,57,139,47,7,14,44,81,131,50,22,26,89,128,150,100,39,9,39,54,70,43,10,4,50,74,80,57,29,5,566,292,274,465,239,226,87,170,200,74,33,-1,52,76,113,36,21,-5,35,94,87,38,12,4,102,132,139,63,29,-4,51,60,81,37,14,-3,51,72,58,26,15,-1,526,256,270,239,131,108,34,130,208,47,32,44,17,59,99,37,10,12,17,71,109,10,22,32,30,76,89,19,13,1,12,35,53,17,6,1,18,41,36,2,7,0,-172,-102,-70,-51,-35,-16,7,-28,-107,-33,-27,10,6,-29,-48,-37,-2,10,1,1,-59,4,-25,0,6,16,-44,-17,-19,-2,11,-1,-23,-17,-8,1,-5,17,-21,0,-11,-3,5,-40,45,-96,-68,-28,-6,0,-6,-19,-16,47,1,-9,-14,-41,-3,23,-7,9,8,22,-13,24,-10,12,-43,-43,-16,-3,-9,-5,-22,-29,-6,-1,-1,17,-21,-14,-10,-2,337,165,172,44,9,35,98,33,57,68,21,46,67,20,19,42,-5,18,31,13,38,26,26,28,13,10,7,-10,12,8,5,8,1,-12,2,4,8,2,6,2,10,4,-34,2,-36,-72,-32,-40,-44,19,-86,45,7,10,11,18,-53,14,-1,4,-55,1,-33,31,8,6,-28,14,-45,-2,-4,-11,-11,7,-19,-2,-7,-3,-17,7,-26,0,3,-8,123,38,85,175,86,89,58,13,-9,28,15,15,26,-5,5,6,1,1,32,18,-14,22,14,14,48,26,47,30,12,11,27,17,21,11,3,7,21,9,26,19,9,4,223,140,83,124,72,52,16,-19,93,47,23,56,26,-24,55,47,10,21,-10,5,38,0,13,35,18,27,24,28,22,1,12,7,15,17,15,2,6,20,9,11,7,-1,138,32,106,156,83,73,35,12,9,37,4,39,-4,15,-7,21,-6,10,39,-3,16,16,10,29,36,24,33,42,13,3,22,10,18,23,10,-2,14,14,15,19,3,5,357,193,164,254,152,102,56,45,100,111,25,6,27,13,70,58,15,-5,29,32,30,53,10,11,56,31,75,49,29,7,36,21,45,28,19,1,20,10,30,21,10,6,258,108,150,52,14,38,85,38,82,42,7,-4,49,32,41,-10,-3,-5,36,6,41,52,10,1,47,20,14,-4,-10,-19,25,13,0,-17,-6,-3,22,7,14,13,-4,-16
8,08232,Sant Pere de Riudebitlles,2098,45,23,22,3,1,2,9,9,9,9,6,3,9,6,4,4,2,-2,0,3,5,5,4,5,1,2,0,0,0,0,0,1,0,0,0,0,1,1,0,0,0,0,19,10,9,4,3,1,8,6,0,-1,5,1,1,4,1,0,3,1,7,2,-1,-1,2,0,2,0,1,0,0,1,1,0,1,0,0,1,1,0,0,0,0,0,-4,5,-9,9,5,4,2,6,-14,2,-2,0,3,2,-3,1,2,0,-1,4,-11,1,-4,0,2,3,3,1,0,0,0,2,3,0,0,0,2,1,0,1,0,0,-1,-2,1,13,5,8,4,5,1,-13,-3,2,4,2,1,-8,-3,1,0,3,0,-5,0,1,4,3,4,0,1,0,3,0,2,0,0,0,1,3,2,0,1,0,53,36,17,18,11,7,7,12,21,10,0,0,3,6,19,5,1,1,4,6,2,5,-1,-1,2,10,4,2,0,0,2,5,3,1,0,0,0,5,1,1,0,0,59,33,26,31,20,11,31,13,6,10,-4,1,19,3,4,7,-3,1,12,10,2,3,-1,0,18,6,1,5,0,0,13,4,-1,3,0,0,5,2,2,2,0,0,65,37,28,13,9,4,13,7,32,13,-1,-2,5,3,21,8,-1,-1,8,4,11,5,0,-1,1,5,6,0,0,0,1,3,5,0,0,0,0,2,1,0,0,0,29,10,19,-3,-4,1,2,16,10,-1,-4,3,3,8,0,-1,-3,1,-1,8,10,0,-1,2,-2,2,0,-3,0,0,0,-1,0,-3,0,0,-2,3,0,0,0,0,1,-3,4,-3,-1,-2,1,-3,1,6,-3,2,-2,-1,2,-2,-1,2,3,-2,-1,8,-2,0,0,-1,-2,1,-1,0,2,-2,0,0,-1,0,-2,1,-2,1,0,0,-13,-9,-4,10,1,9,-9,-3,-4,-4,2,2,-3,-4,1,-4,0,0,-6,1,-5,0,2,2,6,2,0,1,0,1,2,0,1,-1,-1,0,4,2,-1,2,1,1,-6,-1,-5,6,5,1,-5,-3,2,-2,3,-3,-3,-2,4,-2,2,-1,-2,-1,-2,0,1,-2,1,2,2,0,1,0,1,2,2,0,0,0,0,0,0,0,1,0,-14,-7,-7,-9,-3,-6,-13,5,-9,1,0,1,-7,5,-9,0,0,3,-6,0,0,1,0,-2,-6,-2,-1,1,-1,0,-2,-1,0,0,0,0,-4,-1,-1,1,-1,0,-27,-9,-18,1,-2,3,-13,-8,1,4,-8,-2,-3,0,3,-1,-9,1,-10,-8,-2,5,1,-3,-1,-1,1,2,0,0,-2,0,1,-1,0,0,1,-1,0,3,0,0,13,3,10,4,3,1,7,-3,12,-4,-7,5,2,-4,3,5,-3,-1,5,1,9,-9,-4,6,1,1,2,0,0,0,1,0,1,1,0,0,0,1,1,-1,0,0,10,4,6,3,2,1,4,-2,-7,11,4,1,6,-3,-5,1,2,3,-2,1,-2,10,2,-2,0,0,0,1,2,0,0,0,0,1,1,0,0,0,0,0,1,0,6,-1,7,-7,-4,-3,-4,0,14,-4,-3,1,-1,0,2,-3,-1,1,-3,0,12,-1,-2,0,-2,1,-2,-1,-2,-1,-1,0,-1,-1,0,-1,-1,1,-1,0,-2,0,-18,-6,-12,-22,-12,-10,-1,-1,-5,-12,-4,5,-3,-1,-3,-2,-2,3,2,0,-2,-10,-2,2,-5,0,-9,-8,-1,0,-3,0,-3,-5,-1,0,-2,0,-6,-3,0,0,-7,-10,3,12,4,8,3,-6,-9,0,6,0,-1,-5,-6,2,2,-1,4,-1,-3,-2,4,1,3,0,3,4,2,0,1,0,0,2,1,0,2,0,3,2,1,0
8,08233,Sant Pere de Torelló,2202,53,30,23,39,25,14,24,7,6,13,3,0,17,5,1,5,2,0,7,2,5,8,1,0,16,8,8,6,1,0,11,6,4,3,1,0,5,2,4,3,0,0,8,11,-3,27,16,11,-1,3,-1,7,3,-3,-1,6,2,5,0,-1,0,-3,-3,2,3,-2,0,8,9,5,5,0,0,6,6,3,1,0,0,2,3,2,4,0,35,19,16,31,15,16,8,12,-2,15,0,2,8,3,3,3,1,1,0,9,-5,12,-1,1,6,8,9,5,0,3,2,3,6,3,0,1,4,5,3,2,0,2,21,7,14,27,13,14,5,2,3,10,0,1,3,1,-2,5,0,0,2,1,5,5,0,1,6,6,10,5,0,0,2,3,5,3,0,0,4,3,5,2,0,0,12,3,9,21,11,10,4,8,8,-3,-1,-3,1,2,0,1,1,-2,3,6,8,-4,-2,-1,4,6,8,3,0,0,1,4,4,2,0,0,3,2,4,1,0,0,18,18,0,21,9,12,1,-2,12,-4,4,5,6,-1,9,-1,2,1,-5,-1,3,-3,2,4,5,7,5,4,0,0,6,1,2,0,0,0,-1,6,3,4,0,0,31,22,9,29,14,15,-1,21,13,0,-2,0,-2,11,14,1,-1,0,1,10,-1,-1,-1,0,1,10,9,6,2,1,0,5,5,3,1,0,1,5,4,3,1,1,40,16,24,29,15,14,10,14,5,7,8,-4,8,2,1,2,1,2,2,12,4,5,7,-6,10,7,2,7,3,0,8,2,1,3,1,0,2,5,1,4,2,0,65,36,29,12,3,9,5,9,25,11,9,4,7,2,10,7,4,5,-2,7,15,4,5,-1,4,3,5,1,-1,0,2,0,1,1,-1,0,2,3,4,0,0,0,27,20,7,3,0,3,8,5,1,8,-1,5,1,7,0,9,1,1,7,-2,1,-1,-2,4,-5,4,1,1,2,0,-5,2,1,1,1,0,0,2,0,0,1,0,-1,-1,0,7,3,4,-7,4,11,-1,-7,-1,-6,0,6,1,-2,1,-1,4,5,-2,-5,-2,1,6,1,1,-1,-1,1,0,2,0,0,0,0,6,-1,1,-1,-1,49,27,22,-1,2,-3,15,9,10,6,4,3,6,4,8,3,3,3,9,5,2,3,1,0,1,-2,1,-3,2,0,0,1,2,-2,1,0,1,-3,-1,-1,1,0,-29,-15,-14,7,2,5,-9,-7,-11,-6,2,-2,-3,-3,-6,-2,1,-2,-6,-4,-5,-4,1,0,0,2,2,1,-1,0,0,1,1,0,0,0,0,1,1,1,-1,0,3,17,-14,1,3,-2,-6,0,3,4,4,-1,1,-2,10,3,5,1,-7,2,-7,1,-1,-2,-2,0,-1,3,1,0,0,-1,2,1,1,0,-2,1,-3,2,0,0,14,-3,17,-1,-1,0,-3,6,8,-6,3,6,-1,4,6,-12,1,-1,-2,2,2,6,2,7,-4,0,1,1,1,0,-2,0,0,0,1,0,-2,0,1,1,0,0,14,6,8,-4,-1,-3,2,14,5,-8,-2,0,2,8,2,-3,-2,-1,0,6,3,-5,0,1,-2,1,3,-3,-2,-1,0,3,1,-2,-2,-1,-2,-2,2,-1,0,0,30,24,6,22,15,7,0,11,2,6,5,5,-1,6,7,3,6,1,1,5,-5,3,-1,4,1,2,8,5,3,2,0,1,7,3,3,0,1,1,1,2,0,2,-13,-16,3,0,-2,2,0,-7,-3,-4,-1,4,-1,-4,-7,-3,0,1,1,-3,4,-1,-1,3,5,-4,2,-3,0,0,2,-1,0,-2,-1,0,3,-3,2,-1,1,0
8,08235,Sant Pol de Mar,3413,198,92,106,47,21,26,21,24,49,54,35,10,13,10,21,15,25,6,8,14,28,39,10,4,4,11,10,9,9,4,1,8,3,4,3,2,3,3,7,5,6,2,181,78,103,74,28,46,29,22,42,48,28,12,12,5,18,22,11,9,17,17,24,26,17,3,15,11,19,17,8,3,4,3,7,9,4,0,11,8,12,8,4,3,206,106,100,70,39,31,30,24,66,46,29,3,14,12,31,28,15,1,16,12,35,18,14,2,11,19,24,8,4,2,8,7,14,6,2,1,3,12,10,2,2,1,190,103,87,107,62,45,36,32,36,54,21,3,24,16,20,31,8,0,12,16,16,23,13,3,14,36,29,16,8,3,6,21,15,13,6,0,8,15,14,3,2,3,51,31,20,70,42,28,-1,23,12,-2,15,1,0,11,14,-2,7,0,-1,12,-2,0,8,1,7,29,23,9,1,1,3,18,13,6,1,1,4,11,10,3,0,0,179,62,117,123,58,65,30,42,48,30,9,13,8,17,11,9,10,3,22,25,37,21,-1,10,11,45,33,9,9,12,7,16,17,6,5,5,4,29,16,3,4,7,133,73,60,92,49,43,14,31,52,23,14,0,7,17,33,9,5,5,7,14,19,14,9,-5,10,44,27,9,2,-1,6,23,15,4,1,0,4,21,12,5,1,-1,-67,-54,-13,-76,-42,-34,-17,9,-32,-13,-13,-2,-4,-6,-22,-10,-12,-1,-13,15,-10,-3,-1,-1,-22,8,-36,-14,-3,-10,-11,2,-20,-5,-5,-3,-11,6,-16,-9,2,-7,119,50,69,40,12,28,-1,20,40,4,26,32,-5,5,23,3,12,12,4,15,17,1,14,20,3,29,16,-4,-2,-2,1,10,8,-5,-1,-1,2,19,8,1,-1,-1,16,24,-8,40,21,19,-11,18,6,1,-2,2,3,15,-8,15,2,-4,-14,3,14,-14,-4,6,0,16,11,7,4,2,1,8,3,7,2,0,-1,8,8,0,2,2,13,3,10,37,16,21,10,10,1,-7,-5,1,10,3,5,-13,-6,1,0,7,-4,6,1,0,-3,28,11,2,-3,2,-2,12,8,0,-3,1,-1,16,3,2,0,1,8,-2,10,53,32,21,-14,7,24,-14,13,-13,-11,14,14,-18,5,-7,-3,-7,10,4,8,-6,5,21,5,7,13,0,0,19,5,1,6,0,5,2,0,6,7,0,11,12,-1,40,20,20,-10,7,6,8,-20,17,0,9,-7,8,-5,4,-10,-2,13,0,-15,13,1,22,12,1,3,1,3,9,7,0,1,0,-2,13,5,1,2,1,2,-15,17,19,10,9,-6,9,9,-16,0,7,-11,4,4,-7,-5,1,5,5,5,-9,5,6,-1,21,4,-2,-4,1,-1,11,3,2,-4,-1,0,10,1,-4,0,2,30,2,28,18,14,4,11,5,3,4,1,6,7,-4,-7,-1,9,-1,4,9,10,5,-8,7,5,10,3,-5,2,3,0,7,3,0,2,2,5,3,0,-5,0,1,-119,-51,-68,-80,-38,-42,6,-8,-60,-9,-27,-27,1,0,-27,-7,-8,-13,5,-8,-33,-2,-19,-14,-9,9,-51,-15,-11,-5,-4,2,-24,-8,-5,-1,-5,7,-27,-7,-6,-4,145,63,82,81,36,45,14,31,19,40,19,19,11,14,1,26,4,6,3,17,18,14,15,13,10,21,20,13,13,1,5,10,8,6,7,-1,5,11,12,7,6,2,87,47,40,52,30,22,11,0,29,29,9,2,13,-3,18,13,6,-4,-2,3,11,16,3,6,7,14,19,4,5,2,4,5,11,3,5,2,3,9,8,1,0,0
8,08236,Sant Quintí de Mediona,1632,90,58,32,42,28,14,22,15,24,25,1,3,14,10,18,16,-1,2,8,5,6,9,2,1,15,9,13,5,0,0,8,7,10,3,0,0,7,2,3,2,0,0,40,37,3,26,22,4,1,17,11,2,7,3,6,9,13,5,2,2,-5,8,-2,-3,5,1,1,12,12,0,1,0,1,9,12,0,0,0,0,3,0,0,1,0,56,49,7,29,23,6,5,15,16,8,5,5,6,12,17,6,6,1,-1,3,-1,2,-1,4,0,10,14,3,2,0,0,7,11,3,2,0,0,3,3,0,0,0,65,42,23,43,33,10,10,15,17,13,4,4,4,9,15,11,2,-1,6,6,2,2,2,5,5,14,12,10,2,0,2,10,11,8,2,0,3,4,1,2,0,0,34,23,11,36,23,13,9,16,-12,9,10,2,9,15,-15,9,4,1,0,1,3,0,6,1,10,16,3,6,1,0,8,10,2,3,0,0,2,6,1,3,1,0,36,2,34,38,18,20,21,1,8,-7,7,3,15,-1,-4,-11,2,0,6,2,12,4,5,3,22,8,6,0,1,0,15,2,2,-2,1,0,7,6,4,2,0,0,123,51,72,62,21,41,39,21,15,36,12,-2,15,7,2,18,9,0,24,14,13,18,3,-2,30,6,9,15,1,0,11,1,1,7,1,0,19,5,8,8,0,0,2,-19,21,-11,-9,-2,10,-3,1,-6,-4,5,-2,-3,-9,-4,-3,3,12,0,10,-2,-1,2,-1,-3,-3,-3,-1,0,1,-3,-4,-2,-1,0,-2,0,1,-1,0,0,-18,-12,-6,12,8,4,-10,8,-4,-3,-4,-1,-6,3,1,-6,-1,-2,-4,5,-5,3,-3,1,3,4,5,1,-1,0,2,1,6,0,-1,0,1,3,-1,1,0,0,17,17,0,5,3,2,11,-1,-4,3,2,0,15,-1,-2,-2,1,2,-4,0,-2,5,1,-2,7,-2,3,-2,-1,0,5,1,0,-2,-1,0,2,-3,3,0,0,0,-51,-21,-30,-12,-6,-6,-15,-5,-17,2,-2,-11,-13,2,-13,3,0,0,-2,-7,-4,-1,-2,-11,-7,-1,0,-4,0,0,-4,0,-1,-3,1,0,-3,-1,1,-1,-1,0,-10,-11,1,12,1,11,0,-7,-5,3,-2,-1,-3,-7,-2,1,-3,3,3,0,-3,2,1,-4,4,0,3,2,1,0,0,1,0,-1,1,0,4,-1,3,3,0,0,8,0,8,9,6,3,4,1,4,-2,1,0,5,3,0,-5,-3,1,-1,-2,4,3,4,-1,-1,2,5,1,0,1,1,2,3,0,-1,1,-2,0,2,1,1,0,-70,-34,-36,0,-3,3,-40,-5,-4,-20,0,-1,-22,-5,5,-10,-1,-2,-18,0,-9,-10,1,1,-3,5,4,-6,-1,0,-2,0,3,-5,-1,0,-1,5,1,-1,0,0,14,7,7,1,2,-1,-3,9,7,10,-1,-7,-1,0,4,7,2,-4,-2,9,3,3,-3,-3,1,0,-1,2,-1,0,0,1,-1,2,0,0,1,-1,0,0,-1,0,8,8,0,16,6,10,0,3,0,4,5,-5,0,5,0,3,-1,1,0,-2,0,1,6,-6,8,0,4,5,-1,0,5,1,0,1,-1,0,3,-1,4,4,0,0,36,21,15,23,9,14,13,4,7,6,6,0,15,-4,6,3,2,-1,-2,8,1,3,4,1,13,6,1,2,1,0,8,2,-2,0,1,0,5,4,3,2,0,0,30,21,9,0,-2,2,-8,7,9,14,9,0,-3,1,7,10,5,1,-5,6,2,4,4,-1,-7,5,3,-1,0,0,-5,1,3,-1,0,0,-2,4,0,0,0,0
8,08237,Sant Quirze de Besora,1986,7,5,2,15,11,4,6,1,-1,1,4,-3,3,4,-2,0,1,0,3,-3,1,1,3,-3,4,3,6,2,0,0,3,3,4,1,0,0,1,0,2,1,0,0,27,16,11,14,6,8,-3,5,6,12,2,4,0,3,3,7,2,1,-3,2,3,5,0,3,1,3,7,3,0,0,0,1,4,1,0,0,1,2,3,2,0,0,-1,-1,0,8,6,2,-3,6,-5,1,-1,1,-1,1,-3,1,-1,1,-2,5,-2,0,0,0,0,6,1,1,0,0,0,3,2,1,0,0,0,3,-1,0,0,0,29,15,14,8,3,5,11,-1,5,6,6,3,7,5,-2,0,4,1,4,-6,7,6,2,2,2,2,2,1,1,0,1,1,1,0,0,0,1,1,1,1,1,0,23,16,7,14,8,6,3,2,7,2,4,6,0,3,6,2,3,2,3,-1,1,0,1,4,0,5,6,1,2,0,0,5,2,1,0,0,0,0,4,0,2,0,71,26,45,18,12,6,11,21,6,10,15,5,2,9,2,1,9,3,9,12,4,9,6,2,5,6,3,0,2,1,4,4,2,0,1,1,1,2,1,0,1,0,100,42,58,22,10,12,32,16,22,19,5,5,16,7,5,11,-1,4,16,9,17,8,6,1,8,8,2,3,2,-1,3,4,1,1,1,0,5,4,1,2,1,-1,74,41,33,25,10,15,16,15,23,9,7,1,8,3,17,7,3,0,8,12,6,2,4,1,5,9,2,5,4,0,3,4,0,2,1,0,2,5,2,3,3,0,48,26,22,29,16,13,5,11,15,20,-2,-2,1,4,11,13,-2,-1,4,7,4,7,0,-1,4,10,7,8,0,0,2,4,6,4,0,0,2,6,1,4,0,0,-16,2,-18,7,4,3,-7,-5,-7,0,-4,7,-4,5,-4,1,0,3,-3,-10,-3,-1,-4,4,-2,3,5,0,0,1,-1,1,4,0,0,0,-1,2,1,0,0,1,-28,-30,2,7,-2,9,-7,0,-21,0,2,1,-3,-9,-13,-6,3,0,-4,9,-8,6,-1,1,1,6,1,-2,0,0,0,0,0,-2,0,0,1,6,1,0,0,0,-9,-3,-6,12,8,4,0,-2,2,-8,-1,-1,1,-2,5,-6,-2,0,-1,0,-3,-2,1,-1,2,3,3,3,0,1,2,2,2,1,0,1,0,1,1,2,0,0,-8,1,-9,10,7,3,-5,0,-8,-1,4,3,-1,1,1,-5,3,2,-4,-1,-9,4,1,1,2,3,1,2,1,1,3,1,1,1,1,0,-1,2,0,1,0,1,-4,-5,1,4,3,1,-7,3,3,-7,4,-1,-8,0,6,-3,-2,1,1,3,-3,-4,6,-2,2,1,0,1,0,-1,1,1,-1,1,0,0,1,0,1,0,0,-1,1,6,-5,-5,-2,-3,-5,3,3,1,1,-1,0,2,5,-1,0,1,-5,1,-2,2,1,-2,-5,0,1,0,-1,0,-1,0,1,-1,-1,0,-4,0,0,1,0,0,4,11,-7,-2,4,-6,1,4,-2,-7,8,-1,4,7,1,-4,3,0,-3,-3,-3,-3,5,-1,-1,3,-3,-3,1,0,2,3,-1,-1,1,0,-3,0,-2,-2,0,0,-22,-14,-8,5,3,2,-3,-4,3,-9,-3,-3,-2,-1,2,-8,1,-4,-1,-3,1,-1,-4,1,2,2,4,-1,0,-2,2,2,2,-1,-1,-1,0,0,2,0,1,-1,38,12,26,17,7,10,5,8,11,9,4,-1,3,1,0,7,2,-2,2,7,11,2,2,1,1,5,7,2,0,2,-1,3,5,0,0,0,2,2,2,2,0,2
8,08238,Sant Quirze del Vallès,11994,434,213,221,52,24,28,107,26,182,86,9,20,56,12,87,44,5,8,51,14,95,42,4,12,14,10,16,11,1,0,5,4,10,4,1,0,9,6,6,7,0,0,479,239,240,69,33,36,103,55,210,70,17,19,58,31,108,34,7,0,45,24,102,36,10,19,12,14,28,11,2,0,7,6,14,3,2,0,5,8,14,8,0,0,620,292,328,99,46,53,111,43,273,117,22,39,62,20,130,52,2,17,49,23,143,65,20,22,19,19,38,15,5,0,14,7,16,8,0,0,5,12,22,7,5,0,871,400,471,74,27,47,214,40,373,160,22,30,98,11,174,80,12,8,116,29,199,80,10,22,19,10,19,14,5,4,6,5,7,7,0,1,13,5,12,7,5,3,669,319,350,89,32,57,123,72,265,104,34,51,75,15,119,67,21,16,48,57,146,37,13,35,22,18,30,11,4,2,9,4,11,5,2,1,13,14,19,6,2,1,404,197,207,82,32,50,68,20,171,59,14,62,30,16,85,40,4,17,38,4,86,19,10,45,25,19,27,3,2,3,10,12,8,-2,-1,3,15,7,19,5,3,0,574,281,293,65,36,29,97,34,243,107,13,58,61,8,115,52,13,17,36,26,128,55,0,41,21,16,14,11,2,-1,12,7,6,8,3,-1,9,9,8,3,-1,0,250,87,163,93,28,65,30,46,64,45,10,49,4,15,27,22,3,14,26,31,37,23,7,35,10,42,23,8,8,0,-1,15,7,3,3,1,11,27,16,5,5,-1,104,62,42,70,25,45,8,1,73,-9,-4,39,19,-2,37,-1,-6,16,-11,3,36,-8,2,23,22,20,18,5,4,1,11,4,3,6,0,1,11,16,15,-1,4,0,96,24,72,46,12,34,50,3,52,-9,-28,15,21,-1,24,-14,-14,1,29,4,28,5,-14,14,21,12,10,8,-3,-4,10,4,1,1,-2,-3,11,8,9,7,-1,-1,239,88,151,40,12,28,84,0,57,47,-1,38,44,0,11,22,-3,10,40,0,46,25,2,28,16,9,2,3,6,1,7,0,1,1,1,1,9,9,1,2,5,0,-93,-65,-28,-29,-10,-19,-9,-17,-23,-41,-26,31,-10,-14,-3,-26,-14,6,1,-3,-20,-15,-12,25,2,-1,-15,-5,-9,-1,3,1,-6,-7,-1,0,-1,-2,-9,2,-8,-1,116,31,85,-23,-2,-21,41,-10,16,22,-17,50,20,-2,6,-5,-9,13,21,-8,10,27,-8,37,2,6,-19,-19,4,3,6,3,-7,-10,4,2,-4,3,-12,-9,0,1,72,35,37,4,-4,8,9,31,-1,1,-13,41,24,7,4,-1,-10,11,-15,24,-5,2,-3,30,4,7,-5,-5,1,2,3,-4,0,-3,-2,2,1,11,-5,-2,3,0,-12,-4,-8,-69,-33,-36,27,-6,-11,12,-52,14,20,2,1,4,-33,-2,7,-8,-12,8,-19,16,-8,-8,-20,-18,-10,-7,-2,-2,-9,-11,-6,-3,-6,-6,-11,-7,-4,-4,-44,-3,-41,-32,-13,-19,27,-49,7,-18,-44,30,17,-19,18,-5,-18,4,10,-30,-11,-13,-26,26,-6,-2,3,-23,-5,-2,-1,2,0,-12,-2,-1,-5,-4,3,-11,-3,-1,149,-1,150,40,5,35,50,-3,21,42,-13,47,8,-11,-9,6,0,3,42,8,30,36,-13,44,12,11,6,-2,5,7,2,1,7,-11,3,2,10,10,-1,9,2,5,39,20,19,74,51,23,26,3,2,27,-29,-1,13,7,-9,17,-13,-7,13,-4,11,10,-16,6,9,15,13,25,10,3,6,12,11,15,7,0,3,3,2,10,3,3
8,08240,Sant Sadurní d'Anoia,9387,119,74,45,79,53,26,33,4,49,26,-2,7,21,7,22,18,2,1,12,-3,27,8,-4,6,20,13,28,16,1,1,10,10,21,11,1,0,10,3,7,5,0,1,220,121,99,63,51,12,60,27,87,31,10,0,32,15,53,15,4,-1,28,12,34,16,6,1,9,13,29,10,0,0,6,11,23,9,0,0,3,2,6,1,0,0,466,280,186,100,63,37,113,58,168,67,26,26,68,34,106,44,13,13,45,24,62,23,13,13,26,29,25,17,1,1,15,16,18,13,0,0,11,13,7,4,1,1,323,141,182,97,43,54,82,22,123,65,12,12,33,5,53,34,3,8,49,17,70,31,9,4,20,20,32,18,3,1,6,8,21,7,0,0,14,12,11,11,3,1,268,115,153,137,70,67,74,14,83,66,7,22,29,16,33,29,1,8,45,-2,50,37,6,14,37,21,44,33,1,1,14,13,24,19,0,0,23,8,20,14,1,1,237,113,124,134,73,61,55,58,95,34,-5,-5,25,26,55,13,-4,-6,30,32,40,21,-1,1,25,31,41,32,4,1,15,17,25,13,2,1,10,14,16,19,2,0,258,135,123,127,77,50,39,56,81,45,20,10,22,34,44,21,5,5,17,22,37,24,15,5,22,30,43,21,8,1,12,17,27,14,4,2,10,13,16,7,4,-1,51,6,45,10,-18,28,0,2,34,-2,5,12,9,5,2,-10,2,-1,-9,-3,32,8,3,13,11,12,-8,-5,-1,1,4,1,-19,-2,-1,-1,7,11,11,-3,0,2,272,133,139,107,47,60,34,55,118,32,12,11,21,25,64,11,8,-2,13,30,54,21,4,13,29,33,26,16,1,1,14,12,12,8,2,-1,15,21,14,8,-1,2,49,6,43,-11,-18,7,0,14,45,-18,4,0,-14,2,15,-8,5,5,14,12,30,-10,-1,-5,1,11,1,-24,1,-3,-3,1,4,-20,1,-1,4,10,-3,-4,0,-2,-31,-30,-1,-40,-27,-13,10,7,-28,-14,-14,3,9,-3,-10,-18,-10,-1,1,10,-18,4,-4,4,2,0,-17,-13,-11,-2,8,-3,-14,-11,-7,0,-6,3,-3,-2,-4,-2,97,35,62,3,1,2,33,-1,4,51,21,-18,4,2,-9,31,12,-9,29,-3,13,20,9,-9,-1,11,-4,-6,1,0,1,8,-5,-3,-1,0,-2,3,1,-3,2,0,48,4,44,-49,-29,-20,6,23,13,9,-12,11,-8,14,11,-4,-8,2,14,9,2,13,-4,9,-17,0,-9,-15,-9,0,-13,3,-1,-11,-7,0,-4,-3,-8,-4,-2,0,-46,-45,-1,-19,-18,-1,-13,-11,-36,-9,3,20,-6,-14,-22,-14,2,9,-7,3,-14,5,1,11,-1,-7,-10,-1,0,0,-1,-7,-11,-1,2,0,0,0,1,0,-2,0,64,54,10,5,0,5,15,13,9,13,3,8,17,8,11,9,2,5,-2,5,-2,4,1,3,-2,9,-1,-3,3,-1,-1,1,2,-3,1,0,-1,8,-3,0,2,-1,-30,-15,-15,-9,-10,1,9,-17,-12,5,-12,0,12,-10,-13,7,-7,-5,-3,-7,1,-2,-5,5,-9,10,4,-10,-3,-1,-2,1,-3,-3,-3,0,-7,9,7,-7,0,-1,57,21,36,23,2,21,28,11,12,22,-22,7,15,9,8,2,-17,5,13,2,4,20,-5,2,7,9,6,7,-1,-4,1,3,1,-2,0,-1,6,6,5,9,-1,-3,114,56,58,56,30,26,47,25,11,34,-4,2,12,12,5,25,0,3,35,13,6,9,-4,-1,14,20,-4,14,8,3,5,10,-1,9,5,1,9,10,-3,5,3,2
8,08262,Sant Vicenç de Castellet,7323,42,23,19,6,3,3,4,9,-5,6,-4,33,3,11,-1,6,-4,9,1,-2,-4,0,0,24,1,1,0,2,1,1,0,1,0,1,0,1,1,0,0,1,1,0,-4,-7,3,3,2,1,-16,-6,6,0,5,5,-7,-1,0,-4,2,2,-9,-5,6,4,3,3,0,0,3,0,0,0,0,0,2,0,0,0,0,0,1,0,0,0,104,62,42,-7,-5,-2,26,4,17,21,10,22,15,1,16,14,8,6,11,3,1,7,2,16,-3,1,-3,-1,-1,0,-2,0,-1,-1,-1,0,-1,1,-2,0,0,0,66,39,27,4,-1,5,11,15,12,6,8,14,5,17,7,0,3,7,6,-2,5,6,5,7,3,0,-1,1,0,1,1,0,-2,0,0,0,2,0,1,1,0,1,187,108,79,80,50,30,46,43,64,29,4,-6,21,24,45,16,1,-2,25,19,19,13,3,-4,12,21,30,11,5,1,6,15,20,8,1,0,6,6,10,3,4,1,221,107,114,50,30,20,55,13,81,37,15,13,25,6,35,22,11,1,30,7,46,15,4,12,8,13,14,14,-1,2,7,7,9,7,0,0,1,6,5,7,-1,2,333,188,145,77,40,37,38,63,114,65,32,10,15,28,71,40,14,12,23,35,43,25,18,-2,10,24,20,14,8,1,5,13,13,7,1,1,5,11,7,7,7,0,245,191,54,89,61,28,27,48,133,42,3,-10,21,47,87,37,-1,-1,6,1,46,5,4,-9,18,34,17,15,3,2,14,25,10,8,2,2,4,9,7,7,1,0,325,258,67,82,55,27,66,85,125,39,-8,8,51,70,90,33,-1,5,15,15,35,6,-7,3,21,29,17,9,2,3,13,25,8,7,0,1,8,4,9,2,2,2,121,80,41,53,29,24,26,40,36,12,-4,5,32,15,15,14,-4,4,-6,25,21,-2,0,1,20,21,4,5,2,1,14,13,-2,3,-1,2,6,8,6,2,3,-1,137,73,64,59,29,30,36,13,14,39,4,13,16,10,12,18,2,6,20,3,2,21,2,7,26,6,13,5,-1,2,15,1,6,2,0,0,11,5,7,3,-1,2,150,62,88,38,15,23,31,40,23,18,15,17,22,10,3,19,2,5,9,30,20,-1,13,12,7,13,7,8,1,0,6,4,-1,7,-2,0,1,9,8,1,3,0,-29,-28,-1,-59,-40,-19,-2,3,-13,-22,4,3,-5,4,-11,-16,-2,6,3,-1,-2,-6,6,-3,6,-7,-20,-20,-14,-4,6,-6,-17,-13,-9,-1,0,-1,-3,-7,-5,-3,-69,-28,-41,-30,-20,-10,-9,5,-58,-9,2,2,-1,2,-29,-3,4,0,-8,3,-29,-6,-2,2,-13,2,-9,-11,0,1,-9,1,-8,-8,2,1,-4,1,-1,-3,-2,0,-70,-53,-17,-45,-27,-18,11,-36,-48,-6,-1,9,8,-23,-31,-8,-1,1,3,-13,-17,2,0,8,-5,-8,-11,-11,-11,-1,-2,-4,-11,-6,-5,0,-3,-4,0,-5,-6,-1,-9,-2,-7,10,7,3,0,-4,1,6,-6,-5,-1,-7,-3,11,-3,2,1,3,4,-5,-3,-7,7,2,5,-3,0,-3,2,0,2,0,2,0,5,2,3,-3,-2,-3,42,21,21,37,11,26,9,14,14,-16,16,4,6,7,15,-14,7,0,3,7,-1,-2,9,4,3,12,11,0,8,1,-1,6,1,-2,6,0,4,6,10,2,2,1,30,19,11,41,16,25,-9,-13,29,4,6,10,0,-13,19,2,2,10,-9,0,10,2,4,0,14,8,17,1,0,-1,10,-3,9,-1,-1,1,4,11,8,2,1,-2
8,08264,Sant Vicenç de Montalt,2920,355,171,184,29,15,14,72,43,88,101,31,12,32,17,47,50,17,6,40,26,41,51,14,6,7,4,8,8,1,1,5,0,6,4,0,0,2,4,2,4,1,1,321,168,153,32,18,14,55,24,141,65,18,11,33,12,65,36,13,4,22,12,76,29,5,7,6,4,5,9,3,3,4,2,2,6,1,1,2,2,3,3,2,2,228,101,127,56,27,29,38,32,70,52,23,8,14,10,31,35,10,-2,24,22,39,17,13,10,10,11,11,11,8,4,7,5,2,7,4,1,3,6,9,4,4,3,212,99,113,45,26,19,38,13,61,27,14,53,30,13,33,7,8,7,8,0,28,20,6,46,12,2,11,13,3,4,7,2,7,7,2,1,5,0,4,6,1,3,178,97,81,37,18,19,16,21,71,32,15,19,13,13,31,17,13,7,3,8,40,15,2,12,6,9,9,9,2,1,3,3,4,4,2,1,3,6,5,5,0,0,212,92,120,42,15,27,58,15,20,78,21,-4,29,-1,4,36,20,-6,29,16,16,42,1,2,5,9,7,11,4,3,2,3,4,4,1,0,3,6,3,7,3,3,145,62,83,37,15,22,33,-5,38,30,23,21,18,-3,17,14,11,8,15,-2,21,16,12,13,7,7,16,4,4,-1,5,4,6,1,1,-2,2,3,10,3,3,1,121,54,67,33,16,17,31,-11,30,33,19,15,27,-3,8,9,12,-1,4,-8,22,24,7,16,6,7,12,6,3,-1,4,3,4,2,3,0,2,4,8,4,0,-1,174,81,93,52,19,33,38,1,24,47,24,35,29,-3,6,22,8,16,9,4,18,25,16,19,7,9,15,14,4,3,3,2,5,6,1,2,4,7,10,8,3,1,146,71,75,21,12,9,47,4,21,40,4,22,26,5,4,20,2,7,21,-1,17,20,2,15,6,-1,9,2,2,2,3,0,5,2,0,1,3,-1,4,0,2,1,99,33,66,14,6,8,21,3,24,34,-4,20,2,1,9,15,0,5,19,2,15,19,-4,15,5,1,9,-1,0,-2,2,-1,3,1,1,-2,3,2,6,-2,-1,0,1,-11,12,-5,-7,2,-21,-5,30,-8,-9,9,-10,1,7,-9,-6,2,-11,-6,23,1,-3,7,-8,5,2,-5,2,-2,-3,3,1,-7,0,-2,-5,2,1,2,2,0,97,41,56,14,3,11,22,-5,15,45,6,12,5,-7,15,22,-2,8,17,2,0,23,8,4,3,4,1,2,1,1,-1,2,-3,0,2,2,4,2,4,2,-1,-1,88,52,36,13,5,8,17,5,11,41,-9,17,11,10,6,13,2,7,6,-5,5,28,-11,10,7,5,-1,6,-6,2,1,6,-2,1,-3,2,6,-1,1,5,-3,0,66,20,46,26,9,17,-5,12,39,1,-14,27,-5,4,12,1,-10,16,0,8,27,0,-4,11,5,10,10,-4,6,-2,1,3,7,-5,3,0,4,7,3,1,3,-2,167,43,124,77,37,40,41,-13,42,39,11,47,12,-9,6,29,1,5,29,-4,36,10,10,42,29,4,14,21,7,2,16,3,2,14,3,-1,13,1,12,7,4,3,114,68,46,83,42,41,19,-23,28,37,14,35,19,-17,18,21,13,12,0,-6,10,16,1,23,23,1,26,21,5,5,11,0,15,9,3,2,12,1,11,12,2,3,130,60,70,56,25,31,19,-2,1,25,12,66,11,0,-1,8,15,22,8,-2,2,17,-3,44,20,3,11,1,10,7,8,-1,6,0,6,4,12,4,5,1,4,3
8,08244,Santa Coloma de Cervelló,4116,330,183,147,23,13,10,52,51,139,47,13,23,30,22,90,21,9,7,22,29,49,26,4,16,3,8,7,3,2,0,1,7,4,0,1,0,2,1,3,3,1,0,519,269,250,34,17,17,71,83,212,63,49,35,38,34,120,30,25,20,33,49,92,33,24,15,9,6,13,4,0,1,6,3,6,2,0,0,3,3,7,2,0,1,478,241,237,44,24,20,66,57,205,84,28,34,44,23,95,47,12,18,22,34,110,37,16,16,15,8,6,8,5,1,9,5,2,3,4,0,6,3,4,5,1,1,352,163,189,41,21,20,50,60,149,50,12,24,24,18,74,27,3,15,26,42,75,23,9,9,22,10,4,5,0,0,12,6,2,2,-1,0,10,4,2,3,1,0,221,126,95,32,15,17,2,45,118,2,33,17,5,17,78,-1,17,5,-3,28,40,3,16,12,14,4,7,3,1,1,7,1,3,3,-1,1,7,3,4,0,2,0,252,115,137,46,27,19,33,24,77,57,20,41,7,15,38,28,11,16,26,9,39,29,9,25,14,10,8,13,1,0,7,6,5,9,0,0,7,4,3,4,1,0,116,49,67,35,18,17,1,43,76,-20,10,7,-2,17,36,-12,9,2,3,26,40,-8,1,5,9,14,14,-2,-1,0,3,7,9,0,0,-1,6,7,5,-2,-1,1,45,15,30,22,11,11,4,-6,-6,18,10,20,3,-12,-4,13,5,7,1,6,-2,5,5,13,0,5,8,5,4,0,0,2,4,4,1,0,0,3,4,1,3,0,12,-7,19,14,4,10,1,-11,-2,6,4,17,-2,-9,-2,-2,5,8,3,-2,0,8,-1,9,6,-3,7,-1,1,4,3,0,2,-2,0,1,3,-3,5,1,1,3,7,-30,37,22,12,10,11,0,7,-29,-7,25,-8,-1,4,-31,-5,11,19,1,3,2,-2,14,11,9,2,4,-3,-1,6,7,0,-1,0,0,5,2,2,5,-3,-1,23,3,20,10,3,7,-3,15,-3,-18,3,28,6,5,1,-13,-1,6,-9,10,-4,-5,4,22,2,5,-4,4,1,1,1,2,-2,0,1,0,1,3,-2,4,0,1,-33,-36,3,-30,-17,-13,3,-38,2,-17,-3,15,5,-23,-4,-10,-5,1,-2,-15,6,-7,2,14,6,-17,-9,-6,-2,-2,6,-14,-6,-2,0,-1,0,-3,-3,-4,-2,-1,46,-2,48,0,-2,2,23,-6,-3,9,2,22,7,-9,-17,4,5,9,16,3,14,5,-3,13,5,-2,0,0,-3,-1,2,-2,-1,1,-2,0,3,0,1,-1,-1,-1,-15,-11,-4,-11,-7,-4,-3,-12,25,-15,-13,4,3,-5,17,-16,-8,-2,-6,-7,8,1,-5,6,6,-3,-10,0,-3,-1,6,-3,-5,0,-4,-1,0,0,-5,0,1,0,-41,-24,-17,-22,-15,-7,-1,-16,12,-11,-26,-3,-1,-11,6,-1,-16,-2,0,-5,6,-10,-10,-1,1,-11,-2,-8,-4,1,-1,-7,-1,-4,-2,0,2,-4,-1,-4,-2,1,50,14,36,21,13,8,14,12,13,-11,7,17,14,1,10,-11,7,-4,0,11,3,0,0,21,2,11,6,0,1,-1,4,3,8,-4,1,0,-2,8,-2,4,0,-1,19,8,11,19,10,9,9,4,6,2,-16,16,10,7,-2,2,-9,1,-1,-3,8,0,-7,15,10,6,6,-2,-1,0,8,5,1,-3,0,-1,2,1,5,1,-1,1,84,52,32,26,20,6,27,-13,32,17,0,18,14,-5,19,11,3,7,13,-8,13,6,-3,11,8,3,9,3,2,1,7,3,8,1,1,0,1,0,1,2,1,1
8,08245,Santa Coloma de Gramenet,120802,-2449,-1159,-1290,198,118,80,-358,-324,-878,-371,-375,-125,-161,-107,-444,-192,-188,-58,-197,-217,-434,-179,-187,-67,40,42,82,27,7,0,24,25,52,15,2,0,16,17,30,12,5,0,-2595,-1353,-1242,28,17,11,-387,-340,-990,-366,-330,-163,-185,-140,-559,-198,-176,-86,-202,-200,-431,-168,-154,-77,2,5,7,7,7,0,2,3,5,3,4,0,0,2,2,4,3,0,-2064,-1068,-996,-44,-36,-8,-312,-113,-791,-210,-398,-213,-194,-58,-383,-124,-198,-89,-118,-55,-408,-86,-200,-124,8,-10,-33,-8,-1,-1,2,-5,-24,-8,-1,-1,6,-5,-9,0,0,0,-1695,-787,-908,0,0,0,-179,-52,-694,-214,-340,-192,-97,-26,-266,-105,-192,-95,-82,-26,-428,-109,-148,-97,19,5,-9,-9,-1,-2,6,-1,1,-4,-1,0,13,6,-10,-5,0,-2,534,569,-35,2779,1607,1172,245,541,186,150,-353,-206,191,338,227,121,-194,-104,54,203,-41,29,-159,-102,570,719,954,428,72,23,323,405,585,255,27,6,247,314,369,173,45,17,298,497,-199,2899,1743,1156,66,659,266,-5,-354,-281,99,404,263,51,-189,-101,-33,255,3,-56,-165,-180,538,826,994,415,98,21,317,490,626,250,45,11,221,336,368,165,53,10,1158,922,236,3251,1837,1414,185,764,519,284,-317,-244,145,466,381,227,-152,-123,40,298,138,57,-165,-121,581,860,1068,572,127,30,321,469,639,331,59,17,260,391,429,241,68,13,297,319,-22,2182,1250,932,171,554,9,35,-296,-161,181,333,9,28,-158,-64,-10,221,0,7,-138,-97,497,666,686,265,51,7,306,369,388,157,17,8,191,297,298,108,34,-1,-326,-139,-187,738,216,522,111,253,-60,-156,-293,-157,95,168,-75,-97,-158,-62,16,85,15,-59,-135,-95,397,352,166,-101,-79,-13,190,188,-6,-103,-53,-8,207,164,172,2,-26,-5,1175,541,634,2284,1202,1082,393,491,334,212,-130,-100,213,240,165,35,-54,-44,180,251,169,177,-76,-56,511,614,677,380,68,20,300,324,381,153,31,8,211,290,296,227,37,12,-58,-64,6,1269,624,645,178,407,-136,-137,-175,-177,151,193,-100,-110,-105,-83,27,214,-36,-27,-70,-94,387,419,352,93,19,-12,235,223,158,2,6,-5,152,196,194,91,13,-7,-1412,-850,-562,-754,-509,-245,-312,77,-555,-430,-104,-80,-158,35,-341,-283,-72,-23,-154,42,-214,-147,-32,-57,-201,71,-335,-287,-8,-8,-99,36,-242,-196,-7,-4,-102,35,-93,-91,-1,-4,-701,-335,-366,337,156,181,-138,52,-186,-214,-73,-115,-83,53,-44,-169,-44,-41,-55,-1,-142,-45,-29,-74,57,191,74,5,-7,2,16,115,42,-24,-8,1,41,76,32,29,1,1,-1214,-656,-558,-387,-271,-116,-139,43,-424,-371,-158,-146,-51,27,-261,-232,-78,-58,-88,16,-163,-139,-80,-88,-82,114,-159,-199,-59,-13,-21,50,-113,-158,-39,3,-61,64,-46,-41,-20,-16,-1183,-815,-368,-484,-423,-61,-127,133,-454,-389,-197,-143,-42,11,-299,-284,-124,-64,-85,122,-155,-105,-73,-79,-57,151,-190,-232,-164,-4,-21,36,-126,-209,-102,-7,-36,115,-64,-23,-62,3,145,103,42,333,101,232,-12,262,143,-25,-51,-155,10,127,83,-4,-62,-56,-22,135,60,-21,11,-99,50,239,74,-10,-34,-3,31,124,25,-25,-46,-15,19,115,49,15,12,12,172,72,100,675,287,388,-44,359,152,-109,-41,-135,10,206,47,-88,-43,-53,-54,153,105,-21,2,-82,136,305,207,5,-4,9,88,179,80,-52,-21,9,48,126,127,57,17,0,1153,479,674,1630,782,848,245,503,370,177,14,-155,149,271,159,-11,-24,-69,96,232,211,188,38,-86,330,474,527,218,39,24,177,266,280,65,-20,6,153,208,247,153,59,18
8,08248,Santa Eulàlia de Ronçana,4365,214,121,93,15,8,7,47,33,51,45,25,16,28,18,30,20,18,8,19,15,21,25,7,8,5,1,6,1,2,0,4,1,2,0,1,0,1,0,4,1,1,0,192,91,101,19,7,12,40,22,51,38,20,18,17,12,20,25,7,7,23,10,31,13,13,11,3,4,10,2,0,0,1,2,3,1,0,0,2,2,7,1,0,0,197,98,99,52,28,24,44,24,66,31,13,17,25,14,28,15,8,2,19,10,38,16,5,15,11,6,18,15,2,0,6,5,8,8,1,0,5,1,10,7,1,0,293,167,126,51,22,29,33,52,105,65,18,21,22,31,67,36,9,3,11,21,38,29,9,18,10,13,14,10,3,1,5,4,7,5,1,0,5,9,7,5,2,1,259,114,145,48,19,29,53,35,114,23,13,7,29,0,48,14,8,5,24,35,66,9,5,2,11,15,12,10,0,0,4,6,6,3,0,0,7,9,6,7,0,0,252,99,153,45,9,36,45,37,91,20,28,23,32,3,50,-5,15,3,13,34,41,25,13,20,8,8,13,10,3,3,1,1,4,1,0,2,7,7,9,9,3,1,292,144,148,65,24,41,73,35,72,63,17,22,40,23,20,40,3,13,33,12,52,23,14,9,12,14,17,14,3,0,9,3,4,5,2,0,3,11,13,9,1,0,183,94,89,44,23,21,34,27,68,33,-2,21,12,13,46,16,1,6,22,14,22,17,-3,15,10,12,12,5,2,3,5,6,8,3,0,1,5,6,4,2,2,2,101,55,46,17,10,7,10,5,50,8,15,11,10,-3,25,11,10,2,0,8,25,-3,5,9,2,5,11,-3,-1,1,1,3,5,0,-1,0,1,2,6,-3,0,1,9,-21,30,4,-3,7,17,-21,0,1,-4,15,9,-14,-11,-4,-9,3,8,-7,11,5,5,12,2,5,-3,2,-2,0,1,2,-2,-1,-3,0,1,3,-1,3,1,0,46,17,29,-16,-6,-10,7,6,-13,28,2,14,5,1,-7,10,3,5,2,5,-6,18,-1,9,3,-5,-13,-1,2,-2,1,-4,-4,0,2,-1,2,-1,-9,-1,0,-1,81,36,45,10,4,6,35,-2,14,23,0,9,13,-2,15,7,-2,3,22,0,-1,16,2,6,1,4,3,1,0,1,0,1,1,1,1,0,1,3,2,0,-1,1,-6,4,-10,-24,-10,-14,8,-5,7,-13,-14,9,6,4,4,-10,-1,1,2,-9,3,-3,-13,8,0,-4,-7,-10,-3,-1,0,-2,-3,-4,-1,0,0,-2,-4,-6,-2,-1,55,36,19,-9,-1,-8,-3,0,17,15,4,14,-3,2,15,14,0,4,0,-2,2,1,4,10,-1,0,-6,0,-1,-1,-1,1,-2,1,-1,1,0,-1,-4,-1,0,-2,-7,-9,2,8,4,4,-33,15,2,-5,-2,14,-23,9,-3,2,2,2,-10,6,5,-7,-4,12,0,7,2,-2,-1,2,0,3,1,0,0,0,0,4,1,-2,-1,2,-5,-7,2,12,3,9,-10,3,11,-8,-6,2,-12,-5,14,-5,-1,2,2,8,-3,-3,-5,0,3,1,4,1,1,2,1,0,1,-1,0,2,2,1,3,2,1,0,72,32,40,-6,-5,-1,1,0,52,8,9,5,-4,4,27,1,3,2,5,-4,25,7,6,3,-1,1,-1,-3,-2,0,-2,2,-2,-2,-1,0,1,-1,1,-1,-1,0,71,27,44,13,5,8,28,-6,35,21,-7,-3,10,-5,11,11,-2,1,18,-1,24,10,-5,-4,2,5,4,0,0,0,1,1,1,1,0,0,1,4,3,-1,0,0
8,08250,Santa Margarida de Montbui,9181,-76,-9,-67,18,13,5,-23,0,-27,-15,-10,-8,-1,7,-2,-6,-5,-5,-22,-7,-25,-9,-5,-3,3,4,10,1,0,0,3,3,6,1,0,0,0,1,4,0,0,0,-56,-24,-32,26,19,7,13,-25,-23,-8,-14,0,8,-14,-4,-6,-5,-3,5,-11,-19,-2,-9,3,7,4,10,4,0,0,6,3,7,3,0,0,1,1,3,1,0,0,47,38,9,54,38,16,21,22,26,-8,-10,-5,3,12,29,-3,-3,0,18,10,-3,-5,-7,-5,8,14,24,7,0,0,3,7,23,5,0,0,5,7,1,2,0,0,53,38,15,69,37,32,28,22,0,15,-12,-1,15,12,7,9,-6,2,13,10,-7,6,-6,-3,17,27,14,8,2,1,7,17,8,3,2,0,10,10,6,5,0,1,95,46,49,76,35,41,12,14,33,5,12,11,5,10,21,7,1,-2,7,4,12,-2,11,13,16,28,17,6,6,1,8,11,11,0,3,0,8,17,6,6,3,1,191,91,100,117,54,63,52,50,65,14,2,-7,23,-5,49,19,-3,-2,29,55,16,-5,5,-5,23,33,35,16,6,1,10,11,20,10,2,0,13,22,15,6,4,1,116,85,31,87,49,38,27,59,-8,46,7,-18,10,36,11,30,4,-7,17,23,-19,16,3,-11,15,30,21,12,7,1,8,18,12,6,4,1,7,12,9,6,3,0,-20,-7,-13,83,35,48,-2,-6,9,-15,-11,1,0,-15,15,-3,-8,2,-2,9,-6,-12,-3,-1,21,32,17,8,4,0,12,9,9,4,0,0,9,23,8,4,4,0,7,39,-32,99,50,49,0,36,-12,11,-8,-16,9,29,-6,10,0,-5,-9,7,-6,1,-8,-11,33,36,19,6,3,0,21,20,3,1,2,0,12,16,16,5,1,0,-93,-65,-28,-37,-34,-3,-8,-11,-25,-22,-9,-17,-4,-12,-19,-20,-9,-1,-4,1,-6,-2,0,-16,-3,8,-18,-20,-1,-2,3,-2,-15,-18,-2,0,-6,10,-3,-2,1,-2,-114,-65,-49,-12,-11,-1,-28,-10,-44,-20,-4,-4,-11,-7,-34,-10,-3,0,-17,-3,-10,-10,-1,-4,5,-1,-13,-4,-3,0,6,-5,-11,-2,-1,-1,-1,4,-2,-2,-2,1,-140,-87,-53,-1,-12,11,-44,-13,-38,-22,-14,-6,-27,-10,-21,-12,-4,-8,-17,-3,-17,-10,-10,2,-3,6,-1,0,-4,1,-2,0,-3,-4,-3,0,-1,6,2,4,-1,1,-25,-3,-22,-15,-20,5,-5,-13,-6,5,5,-7,1,-6,-8,10,1,0,-6,-7,2,-5,4,-7,1,-2,-7,-1,-6,0,-3,-1,-8,-3,-5,0,4,-1,1,2,-1,0,-38,-37,-1,5,3,2,-16,14,-29,-9,3,-2,-3,0,-16,-15,-2,0,-13,14,-13,6,5,-2,-8,12,3,-9,8,-1,-4,6,1,-5,5,0,-4,6,2,-4,3,-1,-20,8,-28,-28,-15,-13,17,-3,-18,-9,-1,-7,15,-4,-3,-5,1,-1,2,1,-15,-4,-2,-6,-5,-6,-4,-17,1,0,1,-4,-1,-13,-1,0,-6,-2,-3,-4,2,0,10,8,2,-9,-5,-4,3,2,7,18,-11,-12,-5,1,7,13,-8,-4,8,1,0,5,-3,-8,1,-3,-1,3,-5,-4,-1,-3,3,1,-5,0,2,0,-4,2,0,-4,103,47,56,39,20,19,16,27,19,25,11,3,3,13,14,12,4,1,13,14,5,13,7,2,6,6,10,9,5,2,5,3,3,5,3,1,1,3,7,4,2,1,124,62,62,56,22,34,19,26,35,7,26,11,13,7,22,10,9,6,6,19,13,-3,17,5,13,16,10,7,5,5,7,8,2,1,2,2,6,8,8,6,3,3
8,08251,Santa Margarida i els Monjos,4544,185,113,72,71,42,29,57,29,46,34,1,19,29,18,32,25,0,10,28,11,14,9,1,9,23,20,19,8,1,0,13,12,12,5,0,0,10,8,7,3,1,0,268,153,115,78,47,31,46,63,93,40,17,7,28,29,66,16,10,4,18,34,27,24,7,3,13,25,22,14,2,1,6,14,16,9,1,1,7,11,6,5,1,0,158,83,75,4,2,2,15,33,57,31,9,13,10,8,41,19,1,2,5,25,16,12,8,11,1,2,-1,1,0,1,1,1,0,0,0,0,0,1,-1,1,0,1,68,40,28,24,19,5,-14,22,24,11,15,9,-8,12,17,11,9,1,-6,10,7,0,6,8,6,3,9,4,2,0,3,2,8,5,1,0,3,1,1,-1,1,0,172,73,99,122,73,49,15,62,37,17,31,12,9,26,11,6,14,8,6,36,26,11,17,4,30,28,34,18,6,6,18,16,24,8,3,4,12,12,10,10,3,2,227,120,107,116,71,45,21,78,82,13,20,-1,-4,45,57,0,9,5,25,33,25,13,11,-6,23,35,31,21,4,0,13,23,21,11,1,1,10,12,10,10,3,-1,255,109,146,91,41,50,48,59,65,53,12,15,18,31,13,39,1,5,30,28,52,14,11,10,29,19,24,16,5,-2,14,9,10,8,1,-1,15,10,14,8,4,-1,247,107,140,102,42,60,54,42,86,21,26,11,31,20,37,8,10,0,23,22,49,13,16,11,41,28,21,6,6,-1,22,16,3,0,3,-2,19,12,18,6,3,1,131,55,76,80,39,41,42,31,57,1,0,-2,17,14,21,0,4,0,25,17,36,1,-4,-2,27,31,16,5,-1,1,14,13,7,3,1,1,13,18,9,2,-2,0,-97,-76,-21,-67,-57,-10,-9,-7,-31,-34,-18,-5,-3,-19,-29,-22,-13,0,-6,12,-2,-12,-5,-5,-7,1,-26,-26,-10,1,-2,-5,-24,-21,-6,1,-5,6,-2,-5,-4,0,30,-12,42,-10,-9,-1,3,8,31,-7,-2,-3,-9,-6,17,-10,-3,2,12,14,14,3,1,-5,3,1,-2,-10,1,-4,3,-4,2,-10,0,0,0,5,-4,0,1,-4,27,-1,28,21,-3,24,-10,27,-33,25,13,8,-15,4,-24,20,11,2,5,23,-9,5,2,6,9,16,-3,2,-3,0,1,8,-9,1,-3,-1,8,8,6,1,0,1,105,49,56,10,7,3,7,19,51,0,21,5,7,14,32,-15,7,2,0,5,19,15,14,3,-5,1,19,-8,4,-2,-2,1,15,-8,0,0,-3,0,4,0,4,-2,-10,10,-20,-1,-7,6,-20,3,-5,2,4,7,2,2,3,3,1,2,-22,1,-8,-1,3,5,-4,4,0,-3,-1,2,-1,3,-4,-3,-2,0,-3,1,4,0,1,2,-43,-19,-24,-45,-18,-27,-8,-5,-42,4,4,0,-7,-7,-20,8,0,3,-1,2,-22,-4,4,-3,-11,-6,-17,-10,-2,1,-2,-4,-9,-1,-2,0,-9,-2,-8,-9,0,1,6,33,-27,9,4,5,-11,4,14,-9,-1,2,12,2,17,0,-1,-1,-23,2,-3,-9,0,3,3,4,4,-3,-4,3,4,3,4,-3,-5,1,-1,1,0,0,1,2,103,31,72,47,10,37,5,3,47,24,8,11,-7,0,23,8,2,3,12,3,24,16,6,8,3,8,10,13,6,6,-4,4,1,4,2,3,7,4,9,9,4,3,19,13,6,76,48,28,12,-12,12,14,8,-17,6,-3,8,7,0,-4,6,-9,4,7,8,-13,11,12,29,14,7,1,5,7,22,10,4,0,6,5,7,4,3,1
8,08254,Santa Maria de Corcó,2039,33,19,14,15,9,6,7,5,-5,10,5,10,2,0,2,8,1,5,5,5,-7,2,4,5,2,1,8,0,2,1,1,0,6,0,0,1,1,1,2,0,2,0,9,10,-1,10,4,6,5,-3,1,3,-1,3,6,-2,2,2,-1,2,-1,-1,-1,1,0,1,2,1,5,2,0,0,2,0,2,0,0,0,0,1,3,2,0,0,71,29,42,19,11,8,16,10,22,14,9,1,6,2,13,6,6,-3,10,8,9,8,3,4,6,4,6,3,0,0,4,2,4,1,0,0,2,2,2,2,0,0,-15,-6,-9,13,3,10,-2,-2,-7,5,-5,-2,-1,-2,-4,1,-1,2,-1,0,-3,4,-4,-4,4,2,0,5,0,2,1,0,0,1,0,1,3,2,0,4,0,1,25,5,20,13,4,9,9,-3,10,6,6,-1,1,1,2,2,2,-1,8,-4,8,4,4,0,1,2,3,3,4,0,0,1,1,2,0,0,1,1,2,1,4,0,49,31,18,12,8,4,16,5,5,12,3,7,7,2,7,11,1,3,9,3,-2,1,2,4,4,2,3,2,1,0,1,1,3,2,1,0,3,1,0,0,0,0,24,17,7,17,7,10,9,2,8,-1,1,5,11,1,1,0,2,2,-2,1,7,-1,-1,3,8,1,8,2,-2,0,5,0,1,1,0,0,3,1,7,1,-2,0,35,13,22,18,6,12,16,8,2,4,3,1,9,0,1,-1,4,-2,7,8,1,5,-1,3,8,4,4,1,0,0,3,2,1,0,-1,0,5,2,3,1,1,0,1,4,-3,-1,1,-2,5,-2,-10,8,1,1,6,2,-7,3,2,0,-1,-4,-3,5,-1,1,-2,-1,1,1,0,0,0,0,0,1,0,0,-2,-1,1,0,0,0,-33,-14,-19,-4,-4,0,-14,-1,-6,-9,-5,2,-3,2,-5,-6,-4,2,-11,-3,-1,-3,-1,0,-5,1,-1,2,-1,0,-2,0,-2,0,0,0,-3,1,1,2,-1,0,-42,-23,-19,-8,-5,-3,-17,2,-8,-14,-4,1,-13,1,-2,-7,-2,0,-4,1,-6,-7,-2,1,2,1,-3,-5,-1,-2,1,1,-3,-3,0,-1,1,0,0,-2,-1,-1,-30,-20,-10,-4,-4,0,-9,-2,-8,-1,0,-8,-6,-1,-6,1,-5,-2,-3,-1,-2,-2,5,-6,0,-4,-2,0,1,1,0,-2,-1,0,-1,0,0,-2,-1,0,2,1,13,12,1,-8,-8,0,4,-1,-8,6,9,4,3,1,-3,4,5,2,1,-2,-5,2,4,2,-1,0,-5,-3,1,0,0,0,-4,-4,0,0,-1,0,-1,1,1,0,-3,-10,7,-14,-9,-5,4,-7,-3,7,-1,-4,0,-5,-4,1,0,-2,4,-2,1,6,-1,-2,-2,-1,-3,-5,-2,-1,-3,-1,-1,-2,-2,0,1,0,-2,-3,0,-1,-32,-20,-12,-5,-3,-2,-7,-7,-1,-8,-2,-5,-1,-6,-4,-8,1,0,-6,-1,3,0,-3,-5,-1,-2,2,-2,-1,-1,-1,-1,0,0,0,-1,0,-1,2,-2,-1,0,32,25,7,4,3,1,4,0,12,7,7,0,2,1,12,5,3,1,2,-1,0,2,4,-1,1,1,2,1,-1,0,1,0,2,0,0,0,0,1,0,1,-1,0,1,3,-2,-3,-2,-1,-5,-1,-4,-10,11,10,-1,-1,0,-7,7,5,-4,0,-4,-3,4,5,2,-1,-2,-3,0,1,3,0,-1,-4,0,0,-1,-1,-1,1,0,1,5,-2,7,7,3,4,3,-2,1,3,2,-2,3,1,-6,2,-1,-1,0,-3,7,1,3,-1,5,2,-2,1,1,0,3,0,-1,0,1,0,2,2,-1,1,0,0
8,08259,Santa Maria de Palautordera,6047,230,123,107,33,27,6,31,28,78,43,24,25,14,11,48,26,14,10,17,17,30,17,10,15,1,9,17,6,0,0,1,7,15,4,0,0,0,2,2,2,0,0,171,99,72,32,20,12,32,15,27,52,24,20,16,9,23,24,16,11,16,6,4,28,8,9,5,9,11,5,2,0,1,6,8,4,1,0,4,3,3,1,1,0,274,164,110,1,4,-3,53,40,96,46,19,15,33,30,58,23,10,7,20,10,38,23,9,8,0,2,0,-1,0,0,0,3,1,0,0,0,0,-1,-1,-1,0,0,139,96,43,36,23,13,1,26,59,14,20,20,12,24,33,9,14,7,-11,2,26,5,6,13,7,7,16,6,0,0,3,5,9,5,1,0,4,2,7,1,-1,0,211,112,99,136,77,59,43,36,52,43,28,4,28,21,27,27,13,-4,15,15,25,16,15,8,27,42,40,19,4,2,13,24,25,13,1,1,14,18,15,6,3,1,279,168,111,121,78,43,49,34,75,63,28,21,28,32,52,31,13,9,21,2,23,32,15,12,13,41,49,10,5,1,4,28,36,7,3,0,9,13,13,3,2,1,253,140,113,145,81,64,40,37,84,52,21,12,21,15,49,33,12,6,19,22,35,19,9,6,20,32,56,25,9,1,10,20,31,14,4,1,10,12,25,11,5,0,350,169,181,189,102,87,87,42,131,64,18,7,46,25,64,25,5,4,41,17,67,39,13,3,45,45,63,31,5,0,24,26,36,15,0,1,21,19,27,16,5,-1,199,114,85,126,66,60,74,39,57,20,10,-1,40,28,35,9,5,-1,34,11,22,11,5,0,26,31,47,17,5,0,12,16,27,9,3,-1,14,15,20,8,2,1,178,80,98,50,34,16,57,38,37,37,4,-1,35,10,11,20,0,-2,22,28,26,17,4,1,10,19,13,6,1,1,7,11,9,6,0,1,3,8,4,0,1,0,80,51,29,35,18,17,-3,-8,35,20,16,24,1,-8,25,11,9,15,-4,0,10,9,7,9,6,12,5,12,-2,1,4,5,2,8,-2,1,2,7,3,4,0,0,-51,-57,6,-67,-53,-14,6,-20,-29,-17,2,4,9,-14,-45,-8,1,0,-3,-6,16,-9,1,4,1,-4,-33,-15,-10,-6,3,-6,-32,-8,-7,-3,-2,2,-1,-7,-3,-3,45,5,40,12,-6,18,-1,4,9,-7,16,18,-3,-1,8,-20,2,13,2,5,1,13,14,5,3,11,-2,-5,3,1,-1,4,-2,-7,-1,1,4,7,0,2,4,0,-39,-57,18,-67,-53,-14,-3,-17,-15,-19,4,4,-10,-14,-27,-16,1,4,7,-3,12,-3,3,0,-6,-8,-21,-26,-8,0,-7,-8,-17,-17,-6,0,1,0,-4,-9,-2,0,-21,-41,20,-33,-21,-12,0,-19,-8,9,-12,8,-5,-14,-15,3,-11,1,5,-5,7,6,-1,7,-1,-3,-13,-16,-3,2,1,-4,-5,-12,-2,0,-2,1,-8,-4,-1,2,78,43,35,10,10,0,44,-15,18,22,-12,14,22,0,4,13,-7,6,22,-15,14,9,-5,8,10,0,2,-5,1,2,4,4,3,-1,0,0,6,-4,-1,-4,1,2,102,40,62,18,-5,23,44,9,30,12,-2,5,29,4,12,-9,-2,2,15,5,18,21,0,3,5,16,5,-10,0,2,0,7,1,-12,-4,3,5,9,4,2,4,-1,31,7,24,26,12,14,-16,-9,26,4,16,7,-9,-2,12,-2,10,0,-7,-7,14,6,6,7,-2,8,11,1,5,2,-1,5,4,2,2,-1,-1,3,7,-1,3,3
8,08260,Santa Perpètua de Mogoda,18670,155,74,81,90,64,26,33,20,124,2,-21,-7,14,0,56,19,-10,-3,19,20,68,-17,-11,-4,17,20,38,9,3,1,11,17,28,7,1,0,6,3,10,2,2,1,294,143,151,30,18,12,92,20,123,35,6,9,52,0,70,12,2,5,40,20,53,23,4,4,5,11,7,5,2,0,1,8,4,4,1,0,4,3,3,1,1,0,219,140,79,114,72,42,11,46,107,46,-24,26,3,40,66,39,-22,9,8,6,41,7,-2,17,26,30,36,14,7,1,10,22,27,10,4,-1,16,8,9,4,3,2,148,56,92,140,73,67,19,23,77,17,10,7,16,-2,40,8,-5,3,3,25,37,9,15,4,46,29,23,29,7,4,28,14,11,16,2,1,18,15,12,13,5,3,380,219,161,263,162,101,22,63,156,81,34,24,7,42,103,42,18,8,15,21,53,39,16,16,47,54,89,55,14,2,27,30,62,34,6,2,20,24,27,21,8,0,101,78,23,184,114,70,-18,72,57,9,-33,16,-2,47,37,14,-23,3,-16,25,20,-5,-10,13,25,49,63,35,3,6,18,29,37,24,-2,5,7,20,26,11,5,1,378,230,148,147,96,51,22,93,218,33,-31,28,6,64,113,38,-15,13,16,29,105,-5,-16,15,25,50,43,10,11,-1,11,33,30,13,5,1,14,17,13,-3,6,-2,129,46,83,60,21,39,49,51,48,-19,-11,3,29,23,33,-26,-11,-1,20,28,15,7,0,4,32,49,15,-27,-7,-6,23,26,5,-25,-5,-4,9,23,10,-2,-2,-2,408,235,173,279,155,124,83,90,147,94,-26,7,46,55,81,71,-18,-3,37,35,66,23,-8,10,78,82,73,43,-1,-3,48,50,32,24,1,-3,30,32,41,19,-2,0,-18,-3,-15,111,63,48,14,14,-31,-7,0,-3,13,19,-32,3,4,-7,1,-5,1,-10,-4,4,53,48,3,7,-2,-1,45,33,-15,1,0,-2,8,15,18,6,-2,1,-136,-57,-79,2,-1,3,-24,-15,-52,-34,-20,1,6,0,-37,-19,-14,0,-30,-15,-15,-15,-6,1,7,7,-9,-7,0,1,1,10,-6,-5,-2,-1,6,-3,-3,-2,2,2,141,39,102,129,67,62,42,65,62,-34,-2,12,24,13,31,-28,-2,4,18,52,31,-6,0,8,36,52,19,11,3,4,30,20,13,-5,2,4,6,32,6,16,1,0,-277,-198,-79,-183,-139,-44,11,-64,-96,-116,-13,13,13,-39,-77,-84,-14,6,-2,-25,-19,-32,1,7,-2,-14,-75,-78,-9,-4,10,-8,-61,-68,-8,-4,-12,-6,-14,-10,-1,0,-148,-136,-12,-177,-120,-57,6,-2,-103,-46,-27,17,-3,-10,-87,-33,-16,4,9,8,-16,-13,-11,13,-16,-13,-81,-48,-19,-2,-7,-11,-60,-27,-14,-2,-9,-2,-21,-21,-5,0,35,-18,53,-31,-36,5,8,2,32,-15,-9,3,-10,-8,19,-20,3,-4,18,10,13,5,-12,7,-3,8,-15,-12,-7,-4,-7,0,-10,-13,-4,-2,4,8,-5,1,-3,-2,22,0,22,34,24,10,-7,4,55,-25,-28,12,-24,-8,38,-16,-6,10,17,12,17,-9,-22,2,0,17,17,1,-1,0,2,6,16,2,-2,0,-2,11,1,-1,1,0,-3,-8,5,96,34,62,9,20,-3,-30,-10,10,7,11,-5,-16,-16,7,2,9,2,-14,6,3,32,41,22,-8,6,2,15,24,11,-15,-3,1,17,17,11,7,9,1,66,1,65,144,58,86,36,18,30,-35,25,-8,20,15,7,-34,-5,-2,16,3,23,-1,30,-6,36,46,50,-1,10,2,23,23,19,-6,-2,0,13,23,31,5,12,2
8,08261,Santa Susanna,1779,90,52,38,35,26,9,22,12,18,16,10,12,13,8,8,11,7,5,9,4,10,5,3,7,7,9,11,4,1,3,6,6,9,3,1,1,1,3,2,1,0,2,227,101,126,53,31,22,37,31,75,43,32,8,11,14,40,19,15,2,26,17,35,24,17,6,8,12,17,8,4,4,4,9,10,5,1,2,4,3,7,3,3,2,163,88,75,42,23,19,24,16,42,29,21,23,20,9,16,16,14,13,4,7,26,13,7,10,5,9,11,6,3,7,5,5,5,5,0,3,0,4,6,1,3,4,291,141,150,41,19,22,67,34,69,66,39,14,36,17,33,27,19,8,31,17,36,39,20,6,6,14,14,3,5,-1,2,8,3,3,3,0,4,6,11,0,2,-1,169,81,88,47,21,26,37,10,60,28,28,3,16,7,24,24,9,0,21,3,36,4,19,3,8,6,21,5,7,0,0,5,11,1,4,0,8,1,10,4,3,0,67,54,13,30,28,2,5,5,19,5,22,7,4,10,15,9,8,4,1,-5,4,-4,14,3,-2,12,11,3,3,3,1,7,13,3,2,2,-3,5,-2,0,1,1,114,51,63,40,18,22,14,23,12,28,18,18,12,5,4,19,7,3,2,18,8,9,11,15,8,14,3,5,6,4,5,6,5,3,0,-1,3,8,-2,2,6,5,96,25,71,31,1,30,31,25,31,12,3,-12,16,1,8,4,3,-9,15,24,23,8,0,-3,9,8,0,11,7,-3,4,-1,-5,3,4,-3,5,9,5,8,3,0,119,68,51,37,29,8,22,15,27,39,15,-5,12,11,15,21,9,-3,10,4,12,18,6,-2,4,9,8,12,3,0,4,8,5,9,2,1,0,1,3,3,1,-1,53,14,39,17,2,15,15,0,11,17,2,3,9,1,-3,2,5,-1,6,-1,14,15,-3,4,6,10,1,1,-1,0,1,3,-3,0,1,0,5,7,4,1,-2,0,5,6,-1,-11,-4,-7,-2,-4,20,4,-4,-16,-6,1,12,-1,-3,-3,4,-5,8,5,-1,-13,1,2,0,-3,-4,-8,0,1,2,-4,0,-3,1,1,-2,1,-4,-5,2,1,1,-28,-24,-4,2,-11,11,3,-10,4,-2,-10,14,2,-4,0,4,-1,-3,1,-6,4,-3,0,-12,-16,0,3,-6,-1,-3,-13,-2,1,3,1,-9,-3,2,2,-22,-5,-17,4,5,-1,8,-3,-9,-6,-11,0,17,-1,-6,-2,-13,0,-9,-2,-3,-4,2,0,1,0,0,1,1,0,1,0,1,2,0,0,0,0,-1,-1,1,0,-27,-34,7,-9,-19,10,-8,7,1,-17,-3,-4,-10,2,-2,-6,-4,-12,2,5,3,-11,1,8,5,2,-1,-8,-3,-3,0,0,-7,-4,-3,-5,5,2,6,-4,0,2,-35,-12,-23,-1,-1,0,0,-10,21,2,-20,-26,3,-6,4,10,-9,-14,-3,-4,17,-8,-11,-12,5,-4,1,0,1,-4,2,-2,-4,4,0,-1,3,-2,5,-4,1,-3,55,32,23,8,9,-1,17,-4,51,-1,-8,-5,15,-1,25,-5,-2,-1,2,-3,26,4,-6,-4,1,3,11,-4,-2,-2,1,2,7,-3,1,0,0,1,4,-1,-3,-2,31,4,27,12,4,8,7,9,3,8,-3,12,-2,3,0,8,-5,2,9,6,3,0,2,10,3,5,-2,1,3,2,2,3,-2,2,-1,0,1,2,0,-1,4,2,18,1,17,14,4,10,9,0,6,5,3,-6,12,-4,-3,-1,3,-7,-3,4,9,6,0,1,7,2,6,-2,1,-1,5,-1,2,-1,0,-2,2,3,4,-1,1,1
8,08192,Santpedor,5242,78,45,33,12,5,7,27,14,4,21,1,11,13,8,4,12,0,8,14,6,0,9,1,3,7,0,3,1,0,1,3,0,1,0,0,1,4,0,2,1,0,0,31,17,14,7,4,3,-5,17,3,7,4,6,-5,9,11,-2,3,1,0,8,-8,9,1,5,0,4,1,2,0,0,0,2,1,1,0,0,0,2,0,1,0,0,111,65,46,12,7,5,29,4,43,24,-1,8,19,3,25,13,-2,5,10,1,18,11,1,3,4,4,1,3,0,0,4,1,0,2,0,0,0,3,1,1,0,0,163,98,65,16,7,9,22,35,55,28,9,16,8,29,37,15,2,7,14,6,18,13,7,9,8,2,5,1,0,0,3,1,3,0,0,0,5,1,2,1,0,0,173,90,83,46,35,11,14,31,79,29,9,7,11,1,53,16,4,3,3,30,26,13,5,4,5,8,23,9,1,0,4,3,19,8,1,0,1,5,4,1,0,0,213,85,128,38,16,22,39,32,92,27,1,18,9,9,43,12,2,8,30,23,49,15,-1,10,9,6,16,2,3,1,3,2,9,0,2,0,6,4,7,2,1,1,246,127,119,71,40,31,56,17,106,48,9,7,11,12,63,30,5,2,45,5,43,18,4,5,10,17,24,14,4,2,1,8,17,14,0,0,9,9,7,0,4,2,223,123,100,110,78,32,39,19,88,56,10,7,10,10,53,38,9,2,29,9,35,18,1,5,23,11,39,32,5,-1,8,10,30,27,4,-1,15,1,9,5,1,0,37,19,18,-21,-20,-1,-2,22,35,-25,0,5,17,6,8,-16,1,5,-19,16,27,-9,-1,0,-8,8,-1,-18,-2,-1,1,1,-5,-16,-1,0,-9,7,4,-2,-1,-1,139,55,84,-9,-16,7,43,24,47,-2,15,5,27,5,14,-10,12,3,16,19,33,8,3,2,6,0,-9,-6,0,0,3,-3,-9,-7,0,0,3,3,0,1,0,0,83,55,28,-26,-16,-10,9,8,32,16,4,13,7,7,17,4,6,11,2,1,15,12,-2,2,-1,0,-12,-14,-1,1,0,3,-6,-14,0,0,-1,-3,-6,0,-1,1,-36,-43,7,-31,-34,3,-13,-8,0,-21,-1,5,-4,1,-7,-23,-6,-2,-9,-9,7,2,5,7,0,0,-9,-24,2,0,0,0,-11,-22,-1,0,0,0,2,-2,3,0,110,38,72,-21,-8,-13,22,9,60,3,2,9,11,2,32,-10,0,0,11,7,28,13,2,9,-1,-1,-6,-9,-2,-2,0,0,1,-7,-2,0,-1,-1,-7,-2,0,-2,25,13,12,3,-3,6,12,-4,0,9,5,0,9,2,-10,2,3,3,3,-6,10,7,2,-3,2,-1,4,0,-1,-1,0,-1,0,0,-1,-1,2,0,4,0,0,0,54,22,32,10,7,3,6,3,5,13,10,16,10,0,-1,3,4,7,-4,3,6,10,6,9,-1,1,6,2,1,1,0,1,3,2,1,0,-1,0,3,0,0,1,70,13,57,3,-3,6,32,-4,38,-5,-18,29,18,-9,7,-3,-10,10,14,5,31,-2,-8,19,4,4,-2,-2,-1,0,2,2,-3,-2,-3,1,2,2,1,0,2,-1,-31,-32,1,15,12,3,3,-9,-24,-13,-6,21,-3,-8,-14,-11,-3,6,6,-1,-10,-2,-3,15,0,5,5,2,1,0,0,4,4,3,0,0,0,1,1,-1,1,0,22,15,7,18,9,9,6,-4,2,-2,2,18,2,2,6,3,-3,3,4,-6,-4,-5,5,15,1,3,6,7,0,1,1,2,2,5,-1,0,0,1,4,2,1,1
8,08267,Sentmenat,5469,146,75,71,16,7,9,37,28,35,47,3,-5,15,16,16,25,4,0,22,12,19,22,-1,-5,6,4,3,3,0,0,1,4,1,1,0,0,5,0,2,2,0,0,142,79,63,19,7,12,31,14,61,23,13,0,27,11,35,8,3,-4,4,3,26,15,10,4,5,3,4,3,3,0,1,2,3,1,0,0,4,1,1,2,3,0,305,143,162,70,39,31,72,49,92,66,15,2,34,17,37,45,7,1,38,32,55,21,8,1,23,12,16,12,5,2,11,6,8,10,3,1,12,6,8,2,2,1,199,113,86,57,27,30,37,34,71,20,24,12,25,24,43,9,10,1,12,10,28,11,14,11,17,14,13,10,2,0,9,8,5,5,0,0,8,6,8,5,2,0,322,162,160,74,40,34,70,27,133,66,17,2,38,10,65,35,9,-2,32,17,68,31,8,4,18,13,27,12,3,0,10,4,18,7,1,0,8,9,9,5,2,0,182,106,76,66,37,29,24,43,29,39,28,13,14,29,34,8,17,2,10,14,-5,31,11,11,14,22,15,10,3,1,8,13,9,6,1,0,6,9,6,4,2,1,181,84,97,59,35,24,58,31,52,32,12,-6,23,15,25,18,5,-4,35,16,27,14,7,-2,15,14,14,9,4,1,9,10,7,6,2,0,6,4,7,3,2,1,218,105,113,40,17,23,62,26,74,49,6,-4,36,12,35,22,6,-4,26,14,39,27,0,0,4,16,15,2,3,-3,3,6,8,1,0,-2,1,10,7,1,3,-1,207,131,76,50,34,16,42,21,85,37,14,8,17,14,57,27,6,6,25,7,28,10,8,2,8,11,19,7,5,0,6,7,15,5,1,0,2,4,4,2,4,0,195,99,96,21,13,8,10,32,105,18,11,13,9,13,50,14,5,6,1,19,55,4,6,7,6,3,7,3,-1,1,5,4,-1,1,0,3,1,-1,8,2,-1,-2,222,99,123,35,15,20,44,16,115,24,13,9,20,13,56,3,5,1,24,3,59,21,8,8,15,8,9,4,3,-4,7,4,4,2,0,-2,8,4,5,2,3,-2,45,15,30,-31,-16,-15,24,19,49,-26,-33,10,15,7,16,-13,-17,7,9,12,33,-13,-16,3,4,0,-12,-14,-10,1,2,1,-3,-12,-5,1,2,-1,-9,-2,-5,0,98,49,49,-9,-7,-2,-8,49,46,-2,16,-2,-1,12,25,-2,14,0,-7,37,21,0,2,-2,1,0,-3,-6,0,-1,2,-2,-4,-3,1,-1,-1,2,1,-3,-1,0,-62,-45,-17,-51,-37,-14,-15,-1,-12,-17,-15,-2,-8,-8,-9,-14,-10,4,-7,7,-3,-3,-5,-6,-4,-6,-13,-21,-6,-1,-4,-6,-9,-15,-3,0,0,0,-4,-6,-3,-1,-33,-9,-24,-15,-5,-10,-8,-2,1,-7,-14,-2,-12,8,14,-14,-6,-1,4,-10,-13,7,-8,-1,-2,0,-1,-8,-5,1,0,-1,0,-3,-2,1,-2,1,-1,-5,-3,0,-3,-18,15,-10,-21,11,11,10,-38,6,5,6,9,2,-31,-3,5,0,2,8,-7,9,0,6,3,-4,-7,-3,0,1,-3,-7,-8,-2,-1,0,6,3,1,-1,1,1,58,34,24,27,19,8,-9,29,10,31,1,-4,-12,16,10,19,-2,5,3,13,0,12,3,-9,0,8,9,3,5,2,0,7,7,2,1,2,0,1,2,1,4,0,114,69,45,21,10,11,29,5,46,29,3,0,17,6,19,19,4,2,12,-1,27,10,-1,-2,6,8,17,-8,-1,-1,4,7,8,-7,0,-2,2,1,9,-1,-1,1
8,08269,Seva,2444,33,15,18,10,5,5,8,-7,23,-1,5,4,3,-9,14,2,0,5,5,2,9,-3,5,-1,3,1,2,1,2,1,2,0,2,0,1,0,1,1,0,1,1,1,100,57,43,13,6,7,15,15,30,20,11,9,12,5,18,15,2,5,3,10,12,5,9,4,1,2,1,6,3,0,0,0,1,4,1,0,1,2,0,2,2,0,96,46,50,15,8,7,20,3,26,21,13,8,6,7,8,12,8,2,14,-4,18,9,5,6,3,4,7,0,0,0,1,3,4,-1,0,0,2,1,3,1,0,0,88,39,49,7,2,5,15,1,13,33,12,8,10,-7,6,22,6,2,5,8,7,11,6,6,0,1,4,1,0,0,0,0,1,1,0,0,0,1,3,0,0,0,101,53,48,20,8,12,7,14,57,4,6,10,8,11,31,-5,0,7,-1,3,26,9,6,3,6,2,7,3,2,0,4,1,1,2,0,0,2,1,6,1,2,0,143,59,84,9,3,6,28,16,54,28,9,8,12,1,28,10,5,5,16,15,26,18,4,3,2,2,3,2,0,0,0,0,2,1,0,0,2,2,1,1,0,0,77,50,27,22,13,9,7,-2,39,19,12,2,8,5,20,9,8,0,-1,-7,19,10,4,2,6,3,8,3,2,0,4,2,6,0,1,0,2,1,2,3,1,0,69,43,26,19,7,12,16,4,17,23,7,1,8,5,12,10,6,3,8,-1,5,13,1,-2,5,5,6,1,2,0,2,2,4,-2,1,0,3,3,2,3,1,0,87,50,37,15,5,10,26,19,20,18,0,1,15,20,3,13,-1,0,11,-1,17,5,1,1,5,5,2,-1,2,1,4,1,0,-1,0,1,1,4,2,0,2,0,39,20,19,12,0,12,12,14,1,-1,5,6,9,12,-4,-3,4,1,3,2,5,2,1,5,4,1,2,2,3,0,2,-1,0,-1,0,0,2,2,2,3,3,0,-6,-7,1,8,3,5,-6,-10,10,-13,9,4,2,-9,-5,-6,9,2,-8,-1,15,-7,0,2,2,-1,1,2,4,0,0,0,0,2,2,-1,2,-1,1,0,2,1,16,4,12,-4,-3,-1,9,7,6,0,-9,2,4,0,5,-3,-2,-1,5,7,1,3,-7,3,0,2,-4,-3,0,1,0,0,-1,-2,0,0,0,2,-3,-1,0,1,42,21,21,0,1,-1,8,-10,16,16,1,9,0,-7,16,8,1,2,8,-3,0,8,0,7,0,-2,0,0,1,1,0,-2,2,0,1,0,0,0,-2,0,0,1,13,7,6,-2,-2,0,0,-1,11,10,-6,-5,6,0,3,5,-7,-4,-6,-1,8,5,1,-1,2,2,-1,-2,-3,0,1,1,-1,-2,-2,1,1,1,0,0,-1,-1,-62,-35,-27,-2,-2,0,-21,-3,-19,-7,-2,-6,-11,0,-18,-1,-1,-2,-10,-3,-1,-6,-1,-4,-2,-1,0,-1,3,-1,-1,-1,-1,-1,2,0,-1,0,1,0,1,-1,11,-12,23,0,-5,5,10,-6,7,-9,3,4,2,-3,-6,-4,0,-1,8,-3,13,-5,3,5,2,0,-4,-2,0,4,-1,-1,-3,-1,-1,2,3,1,-1,-1,1,2,10,0,10,11,0,11,8,-2,12,-10,5,-5,3,-1,3,-3,-2,-1,5,-1,9,-7,7,-4,2,4,8,-3,0,0,1,1,1,-2,-1,0,1,3,7,-1,1,0,30,25,5,13,7,6,-2,-9,24,7,13,-4,-1,0,13,3,10,0,-1,-9,11,4,3,-4,4,-1,6,8,1,-6,2,-1,4,4,0,-2,2,0,2,4,1,-4
8,08270,Sitges,18546,446,195,251,43,16,27,55,22,134,118,75,35,21,19,57,52,31,10,34,3,77,66,44,25,9,3,15,9,2,5,3,1,5,4,1,2,6,2,10,5,1,3,215,93,122,31,16,15,15,14,116,9,27,33,6,15,46,-13,26,13,9,-1,70,22,1,20,13,1,4,3,6,2,6,0,3,1,3,1,7,1,1,2,3,1,352,160,192,-3,2,-5,10,39,130,71,61,24,18,6,60,25,38,4,-8,33,70,46,23,20,1,5,-5,-2,-6,2,-1,5,5,-3,-4,0,2,0,-10,1,-2,2,240,95,145,-9,-10,1,6,31,75,51,62,6,-9,9,21,34,41,-6,15,22,54,17,21,12,3,-1,0,-12,4,-2,-2,-1,-3,-6,3,-1,5,0,3,-6,1,-1,1146,501,645,792,386,406,169,171,341,277,129,50,59,68,153,138,63,15,110,103,188,139,66,35,114,136,262,174,72,23,47,53,130,102,40,10,67,83,132,72,32,13,761,379,382,740,379,361,109,141,255,190,44,14,62,54,132,109,22,0,47,87,123,81,22,14,118,132,229,155,77,17,65,57,112,91,40,10,53,75,117,64,37,7,1078,607,471,901,490,411,166,199,363,233,81,24,93,99,202,140,52,14,73,100,161,93,29,10,144,179,277,199,72,20,69,86,137,127,48,16,75,93,140,72,24,4,770,378,392,699,346,353,135,122,221,178,51,55,76,58,83,121,19,17,59,64,138,57,32,38,122,136,201,145,74,11,69,59,94,79,33,8,53,77,107,66,41,3,437,197,240,372,177,195,74,72,103,139,19,33,26,22,47,79,9,14,48,50,56,60,10,19,64,75,107,87,25,9,27,36,46,51,7,6,37,39,61,36,18,3,386,224,162,331,164,167,49,74,128,70,14,42,30,40,64,71,-8,19,19,34,64,-1,22,23,49,57,77,82,36,22,19,27,36,50,20,7,30,30,41,32,16,15,394,176,218,122,50,72,82,36,127,124,0,22,47,12,65,60,-5,-5,35,24,62,64,5,27,25,31,21,36,6,-3,21,2,5,21,2,-6,4,29,16,15,4,3,557,281,276,324,195,129,21,88,148,170,78,35,1,47,90,91,40,4,20,41,58,79,38,31,29,73,96,69,46,4,9,46,63,49,23,1,20,27,33,20,23,3,29,29,0,-77,-13,-64,49,11,24,-25,-24,-4,23,9,16,2,0,-15,26,2,8,-27,-24,11,15,-5,-2,-58,-17,-12,7,4,2,-15,-4,-7,8,-9,-4,-43,-13,-5,144,85,59,-33,-22,-11,38,0,88,10,-11,7,23,4,28,31,-2,-5,15,-4,60,-21,-9,12,31,9,-11,-50,-12,-8,10,1,-11,-22,4,-10,21,8,0,-28,-16,2,-704,-384,-320,-875,-472,-403,-43,-45,-73,-299,-209,-45,-13,-19,-36,-161,-120,-40,-30,-26,-37,-138,-89,-5,-93,-29,-93,-414,-163,-88,-45,-9,-36,-234,-103,-48,-48,-20,-57,-180,-60,-40,124,107,17,-92,-51,-41,81,31,3,21,-34,22,55,28,27,-4,-15,19,26,3,-24,25,-19,3,12,27,-18,-53,-53,-13,7,11,4,-29,-45,-2,5,16,-22,-24,-8,-11,277,173,104,269,137,132,10,35,148,17,35,34,31,23,70,31,11,5,-21,12,78,-14,24,29,55,68,84,12,44,3,27,37,38,14,25,-8,28,31,46,-2,19,11,620,278,342,566,278,288,137,57,165,165,52,48,70,22,79,71,12,25,67,35,86,94,40,23,121,98,149,101,57,33,73,37,76,50,24,14,48,61,73,51,33,19
8,08273,Subirats,2432,47,20,27,26,13,13,15,12,9,8,6,-4,5,7,7,2,3,-5,10,5,2,6,3,1,9,6,7,2,2,0,4,5,2,1,1,0,5,1,5,1,1,0,59,26,33,16,6,10,17,5,19,13,5,-1,4,2,8,8,3,0,13,3,11,5,2,-1,2,7,4,2,0,1,1,1,3,1,0,0,1,6,1,1,0,1,52,23,29,12,7,5,7,4,13,7,4,12,2,0,12,4,0,3,5,4,1,3,4,9,2,5,3,2,0,0,0,3,3,1,0,0,2,2,0,1,0,0,86,38,48,27,11,16,9,19,21,16,16,2,3,6,13,8,6,0,6,13,8,8,10,2,9,6,6,5,0,1,3,1,4,3,0,0,6,5,2,2,0,1,75,46,29,19,9,10,16,8,25,14,12,-2,11,6,11,9,8,1,5,2,14,5,4,-3,-2,12,5,2,2,0,-1,4,3,2,1,0,-1,8,2,0,1,0,134,72,62,22,10,12,21,20,25,33,21,11,9,10,15,15,15,6,12,10,10,18,6,5,2,9,5,4,2,0,2,3,3,1,1,0,0,6,2,3,1,0,91,46,45,24,7,17,19,7,38,21,7,2,9,-1,23,12,5,0,10,8,15,9,2,2,3,11,6,1,2,1,1,3,3,0,0,0,2,8,3,1,2,1,50,35,15,38,20,18,18,4,15,10,0,4,11,2,4,10,1,5,7,2,11,0,-1,-1,17,6,8,6,1,0,10,2,3,4,1,0,7,4,5,2,0,0,39,16,23,8,1,7,9,5,19,1,3,1,3,-1,15,-6,3,-1,6,6,4,7,0,2,-1,4,1,7,-2,-1,-1,2,-1,3,-2,0,0,2,2,4,0,-1,-3,-10,7,6,0,6,-6,-6,5,6,2,-8,-11,-5,2,5,0,-2,5,-1,3,1,2,-6,0,4,0,-1,2,0,1,0,-2,0,1,0,-1,4,2,-1,1,0,3,-3,6,7,3,4,12,-6,-1,2,1,-9,11,-4,0,-5,-1,-7,1,-2,-1,7,2,-2,1,3,1,0,2,0,1,2,0,-1,1,0,0,1,1,1,1,0,13,20,-7,14,5,9,-2,4,2,7,2,-1,2,3,2,4,6,1,-4,1,0,3,-4,-2,0,3,4,5,2,0,1,0,1,1,2,0,-1,3,3,4,0,0,-30,-11,-19,-3,0,-3,-8,-8,3,0,-7,-10,-2,-6,3,1,-3,-3,-6,-2,0,-1,-4,-7,-2,1,3,-5,0,0,1,0,2,-3,0,0,-3,1,1,-2,0,0,-5,15,-20,-23,-8,-15,2,-1,-3,-1,1,-2,5,4,4,4,0,-1,-3,-5,-7,-5,1,-1,0,-5,-9,-7,0,-2,0,-1,-3,-3,0,-1,0,-4,-6,-4,0,-1,-26,-8,-18,-15,-6,-9,-3,-8,0,-7,-5,-3,-1,-6,2,-2,-1,-1,-2,-2,-2,-5,-4,-2,1,1,-10,-6,-1,0,0,2,-6,-2,0,0,1,-1,-4,-4,-1,0,28,17,11,8,3,5,-11,6,15,2,13,1,-8,0,1,6,13,2,-3,6,14,-4,0,-1,1,1,4,1,0,0,1,-1,1,0,1,0,0,2,3,1,-1,0,29,-5,34,5,0,5,9,4,17,-5,7,-3,-2,2,6,-9,3,-5,11,2,11,4,4,2,1,1,3,0,-1,1,1,-1,1,-1,0,0,0,2,2,1,-1,1,43,19,24,0,-2,2,21,-4,3,17,2,2,11,-3,6,7,-2,0,10,-1,-3,10,4,2,-2,-2,-1,2,3,0,0,-1,-1,-1,1,0,-2,-1,0,3,2,0
8,08274,Súria,6193,-17,-5,-12,14,7,7,8,5,-15,-11,3,-7,3,5,-5,-6,2,-3,5,0,-10,-5,1,-4,3,6,4,1,0,0,0,4,2,1,0,0,3,2,2,0,0,0,9,9,0,23,14,9,4,3,14,-3,-7,-4,0,3,9,1,-4,-2,4,0,5,-4,-3,-2,7,4,5,2,3,0,4,2,2,2,2,0,3,2,3,0,1,0,48,21,27,47,24,23,21,3,-8,18,0,14,5,-1,1,9,-1,9,16,4,-9,9,1,5,16,9,15,7,0,0,4,5,9,6,0,0,12,4,6,1,0,0,56,23,33,47,20,27,12,14,10,8,2,9,3,2,4,9,2,3,9,12,6,-1,0,6,20,12,8,7,0,0,10,3,2,5,0,0,10,9,6,2,0,0,44,20,24,50,23,27,-1,22,-4,32,3,-7,-4,13,-10,24,0,-3,3,9,6,8,3,-4,4,23,15,6,2,0,1,12,10,0,0,0,3,11,5,6,2,0,107,50,57,59,28,31,19,34,20,16,5,12,10,13,9,10,5,3,9,21,11,6,0,9,8,22,15,9,5,0,5,12,7,2,2,0,3,10,8,7,3,0,102,67,35,107,67,40,8,17,34,32,4,3,4,16,16,25,4,-1,4,1,18,7,0,4,13,30,30,25,7,1,6,18,19,18,5,1,7,12,11,7,2,0,95,52,43,101,58,43,28,31,27,9,-5,5,12,24,7,5,1,0,16,7,20,4,-6,5,17,33,26,18,6,0,11,24,10,9,3,0,6,9,16,9,3,0,7,9,-2,39,19,20,3,11,4,0,-2,-8,0,6,6,2,-3,-2,3,5,-2,-2,1,-6,6,18,10,7,0,-2,4,10,5,1,0,-1,2,8,5,6,0,-1,-57,-40,-17,-5,-12,7,-22,14,-36,-17,1,2,-14,2,-19,-12,1,0,-8,12,-17,-5,0,2,-4,7,0,-6,-3,0,-1,-4,0,-8,0,0,-3,11,0,2,-3,0,-75,-51,-24,-39,-42,3,-1,-14,-39,-8,-20,5,1,-8,-23,-13,-12,4,-2,-6,-16,5,-8,1,-2,-3,-17,-12,-4,-1,-3,-6,-14,-13,-4,-2,1,3,-3,1,0,1,-22,-36,14,-23,-19,-4,8,-5,-24,-7,2,0,-2,-3,-17,-11,-2,-2,10,-2,-7,4,4,2,-1,-1,-15,-1,-8,3,-1,-1,-10,-2,-7,2,0,0,-5,1,-1,1,-49,-29,-20,-58,-38,-20,3,-1,-18,-10,-20,-7,4,1,-6,-11,-13,-6,-1,-2,-12,1,-7,-1,-1,-8,-13,-18,-16,-2,-3,-3,-7,-13,-11,-1,2,-5,-6,-5,-5,-1,-52,-33,-19,-10,-3,-7,-1,-14,-19,-9,-10,0,-3,-6,-17,-4,-5,2,2,-8,-2,-5,-5,-2,7,2,-6,-9,-4,0,4,2,-4,-3,-2,0,3,0,-2,-6,-2,0,-46,-19,-27,-25,-24,-1,-3,-9,-30,2,-3,-4,-1,-2,-20,5,-2,1,-2,-7,-10,-3,-1,-5,-2,-5,-9,-6,-5,2,-4,-3,-9,-5,-3,0,2,-2,0,-1,-2,2,-2,2,-4,8,4,4,4,17,-6,-8,-5,-4,5,5,1,-6,-2,-1,-1,12,-7,-2,-3,-3,0,15,-6,-1,0,0,2,7,-2,0,-3,0,-2,8,-4,-1,3,0,60,44,16,30,15,15,24,11,24,-6,-2,9,14,9,14,3,-3,5,10,2,10,-9,1,4,12,13,16,-1,-7,-4,7,8,8,-3,-4,-2,5,5,8,2,-3,-2,9,6,3,17,6,11,-2,8,5,4,-5,-3,-5,5,7,2,-1,-1,3,3,-2,2,-4,-2,3,10,1,4,-2,0,2,5,1,-1,-1,0,1,5,0,5,-1,0
8,08278,Taradell,4877,139,73,66,38,22,16,36,21,24,36,8,13,16,12,16,17,7,6,20,9,8,19,1,7,9,9,10,8,0,1,4,6,6,5,0,1,5,3,4,3,0,0,132,76,56,73,48,25,22,17,46,24,16,6,6,16,30,13,10,0,16,1,16,11,6,6,17,18,21,13,2,2,8,14,14,10,2,0,9,4,7,3,0,2,129,72,57,55,36,19,33,19,23,33,7,12,28,8,6,18,5,5,5,11,17,15,2,7,8,18,15,12,1,1,7,8,12,9,0,0,1,10,3,3,1,1,53,51,2,39,21,18,20,1,7,-7,16,15,14,8,14,-1,7,10,6,-7,-7,-6,9,5,8,8,15,3,3,0,3,3,11,2,2,0,5,5,4,1,1,0,75,33,42,46,21,25,17,7,17,20,12,-2,7,-1,6,14,5,-1,10,8,11,6,7,-1,5,14,12,9,3,1,3,5,7,5,1,0,2,9,5,4,2,1,63,42,21,41,25,16,13,8,25,10,0,3,12,0,13,11,-2,4,1,8,12,-1,2,-1,5,11,13,9,1,0,1,7,9,6,0,0,4,4,4,3,1,0,105,56,49,33,15,18,19,13,45,17,-4,16,13,3,25,8,0,8,6,10,20,9,-4,8,2,8,13,9,1,0,2,2,5,5,1,0,0,6,8,4,0,0,84,43,41,15,2,13,22,-3,44,10,-2,12,11,-1,24,2,2,5,11,-2,20,8,-4,7,5,3,6,2,-1,0,3,-1,1,-1,0,0,2,4,5,3,-1,0,14,10,4,17,9,8,25,-17,-12,3,4,11,18,-7,-10,2,3,4,7,-10,-2,1,1,7,8,10,2,-2,-2,1,7,3,0,0,-2,1,1,7,2,-2,0,0,94,50,44,10,8,2,10,14,35,13,4,12,3,8,25,8,0,3,7,6,10,5,4,9,-2,8,8,-1,-2,0,-1,3,7,0,-1,1,-1,5,1,-1,-1,-1,65,11,54,27,12,15,4,-7,33,3,20,14,-2,-9,16,-3,7,3,6,2,17,6,13,11,4,2,11,5,4,1,2,0,5,3,2,0,2,2,6,2,2,1,-4,-10,6,-8,-3,-5,12,-21,9,-22,3,13,9,-3,-8,-11,-2,4,3,-18,17,-11,5,9,-7,3,-2,0,-1,-1,-2,4,-1,-2,-1,-1,-5,-1,-1,2,0,0,9,7,2,-23,-9,-14,19,-11,-10,6,1,3,7,-5,-9,6,5,1,12,-6,-1,0,-4,2,-6,-4,-11,-2,0,0,-3,-3,-2,-3,1,1,-3,-1,-9,1,-1,-1,-13,-7,-6,-9,-9,0,1,-3,-18,-2,6,1,3,-1,-11,-3,3,0,-2,-2,-7,1,3,1,-5,7,-8,-1,-2,0,-3,2,-7,-1,-1,1,-2,5,-1,0,-1,-1,32,-8,40,-7,-11,4,11,5,1,4,4,6,1,0,-5,-2,-5,1,10,5,6,6,9,5,1,5,-4,-8,-1,0,-1,5,-5,-7,-3,0,2,0,1,-1,2,0,72,29,43,8,4,4,23,6,28,11,-7,8,8,2,13,4,-3,4,15,4,15,7,-4,4,1,12,-4,-6,2,1,1,7,-1,-3,0,0,0,5,-3,-3,2,1,35,20,15,18,6,12,15,-6,13,9,-2,5,13,-2,8,-1,-1,1,2,-4,5,10,-1,4,5,-2,9,2,1,3,3,0,3,0,-1,1,2,-2,6,2,2,2,83,41,42,40,18,22,27,-2,11,33,12,3,11,-2,5,21,4,3,16,0,6,12,8,0,14,10,7,4,4,1,9,4,0,1,3,1,5,6,7,3,1,0
8,08281,Teià,5065,104,45,59,33,19,14,46,6,6,35,8,1,22,5,-4,18,6,0,24,1,10,17,2,1,10,6,9,3,4,1,5,4,5,2,3,0,5,2,4,1,1,1,111,40,71,29,12,17,31,1,48,22,7,3,16,-7,14,13,1,3,15,8,34,9,6,0,11,6,5,6,1,0,3,3,3,2,1,0,8,3,2,4,0,0,61,19,42,33,12,21,26,-1,11,23,-3,6,10,-1,-3,20,-7,0,16,0,14,3,4,6,4,6,14,6,3,0,1,4,5,2,0,0,3,2,9,4,3,0,14,19,-5,13,3,10,1,2,-3,9,-2,6,5,-7,6,9,2,3,-4,9,-9,0,-4,3,0,6,7,3,-2,-1,0,-1,4,2,-2,0,0,7,3,1,0,-1,54,47,7,36,23,13,13,0,25,10,-7,7,13,7,17,10,-6,3,0,-7,8,0,-1,4,6,9,11,9,0,-1,4,6,10,4,0,-1,2,3,1,5,0,0,0,5,-5,20,9,11,5,-6,-14,7,-15,23,5,-3,-3,11,-12,7,0,-3,-11,-4,-3,16,7,6,5,1,0,0,5,1,3,1,-1,0,2,5,2,0,1,0,108,64,44,24,12,12,1,-2,6,3,6,94,5,7,9,11,4,27,-4,-9,-3,-8,2,67,5,4,11,4,0,0,3,1,6,2,0,0,2,3,5,2,0,0,20,29,-9,6,9,-3,12,-17,-8,2,1,33,13,-2,6,-2,9,7,-1,-15,-14,4,-8,26,0,3,1,1,-1,0,4,3,3,-2,1,0,-4,0,-2,3,-2,0,102,41,61,41,15,26,24,10,9,23,10,27,12,-1,-5,20,9,6,12,11,14,3,1,21,10,12,9,7,1,2,4,3,3,3,1,1,6,9,6,4,0,1,14,-6,20,10,0,10,12,-12,-9,13,-11,21,6,-7,-5,3,-4,3,6,-5,-4,10,-7,18,3,4,2,-4,3,2,2,1,0,-4,2,0,1,3,2,0,1,2,49,27,22,18,11,7,18,-11,-2,28,-18,36,12,-2,-1,17,-9,14,6,-9,-1,11,-9,22,2,0,8,6,1,1,2,1,4,4,0,0,0,-1,4,2,1,1,35,17,18,11,9,2,18,-7,-21,11,-5,37,21,-4,-15,1,-3,15,-3,-3,-6,10,-2,22,4,1,5,1,-1,1,4,1,3,1,0,0,0,0,2,0,-1,1,-2,8,-10,-29,-12,-17,-1,-10,2,-4,-19,25,-5,-1,6,2,-11,17,4,-9,-4,-6,-8,8,-8,-3,-5,-8,-2,-3,-4,-1,-1,-3,-2,-1,-4,-2,-4,-5,0,-2,23,33,-10,-24,-10,-14,22,-29,-7,23,-7,19,12,-13,-3,21,2,12,10,-16,-4,2,-9,7,-1,-5,-10,-5,-2,-1,0,-1,-4,-3,-1,-1,-1,-4,-6,-2,-1,0,127,50,77,-11,-4,-7,41,6,27,11,-8,49,22,0,10,3,-6,20,19,6,17,8,-2,29,2,-3,-5,-7,0,2,1,-4,-2,-2,2,1,1,1,-3,-5,-2,1,41,10,31,40,20,20,8,0,-5,17,-5,24,10,-4,-3,3,-9,11,-2,4,-2,14,4,13,11,4,7,7,7,2,6,1,2,6,2,1,5,3,5,1,5,1,111,54,57,53,22,31,30,-11,41,30,-8,29,29,-7,21,16,-8,3,1,-4,20,14,0,26,13,7,14,14,2,3,6,2,4,8,1,1,7,5,10,6,1,2,31,-3,34,20,11,9,6,-6,-7,14,-7,30,-1,0,-13,11,-6,5,7,-6,6,3,-1,25,7,-3,1,13,3,-1,4,0,0,7,0,0,3,-3,1,6,3,-1
8,08279,Terrassa,168695,2513,1463,1050,1592,961,631,198,852,1114,280,33,30,106,461,708,149,24,10,92,391,406,131,9,20,243,410,579,276,53,26,135,266,361,159,26,10,108,144,218,117,27,16,1401,751,650,612,350,262,53,497,686,96,65,12,14,237,441,36,20,-1,39,260,245,60,45,13,107,159,198,98,26,18,57,95,124,52,11,8,50,64,74,46,15,10,1426,828,598,91,58,33,-41,438,742,171,45,84,-19,207,498,101,18,35,-22,231,244,70,27,49,36,30,12,12,2,-5,17,29,13,4,0,-4,19,1,-1,8,2,-1,1278,735,543,68,29,39,-68,542,734,98,16,-19,-21,244,492,46,-5,-9,-47,298,242,52,21,-10,23,30,24,-5,-3,-3,11,6,19,-7,0,-1,12,24,5,2,-3,-2,3749,2117,1632,2491,1409,1082,359,1272,1545,417,80,45,201,689,953,224,23,8,158,583,592,193,57,37,503,695,765,357,107,34,276,370,484,198,49,19,227,325,281,159,58,15,3226,1790,1436,2615,1424,1191,348,1119,1321,321,37,80,213,522,859,172,-10,34,135,597,462,149,47,46,586,726,789,361,89,38,319,368,462,216,33,13,267,358,327,145,56,25,2865,1606,1259,2745,1538,1207,237,1137,1307,306,-90,-20,109,568,841,202,-77,-18,128,569,466,104,-13,-2,538,782,840,438,98,23,295,404,491,285,46,9,243,378,349,153,52,14,2604,1440,1164,2755,1386,1369,367,1053,1209,22,-60,15,188,538,814,-67,-49,6,179,515,395,89,-11,9,726,817,883,255,31,18,370,403,487,87,10,14,356,414,396,168,21,4,3272,1542,1730,2371,1010,1361,758,1105,1169,219,-60,58,427,511,569,49,-50,28,331,594,600,170,-10,30,731,811,592,230,-14,-2,383,357,219,56,-19,8,348,454,373,174,5,-10,602,52,550,217,-176,393,149,550,47,-164,6,38,107,219,-70,-188,-21,19,42,331,117,24,27,19,222,283,-123,-161,-15,-18,125,85,-200,-171,-25,-10,97,198,77,10,10,-8,56,-224,280,-210,-318,108,-33,347,-79,-260,38,46,-3,129,-153,-185,-32,18,-30,218,74,-75,70,28,99,83,-151,-198,-47,-23,68,16,-183,-167,-49,-21,31,67,32,-31,2,-2,931,320,611,323,26,297,24,398,247,98,33,108,-1,135,110,10,-15,57,25,263,137,88,48,51,79,196,81,-43,-25,2,41,61,11,-71,-34,0,38,135,70,28,9,2,-905,-642,-263,-1194,-845,-349,-315,153,-400,-434,27,75,-149,49,-231,-343,-8,45,-166,104,-169,-91,35,30,-155,13,-495,-452,-101,-22,-92,-15,-337,-339,-69,-4,-63,28,-158,-113,-32,-18,-491,-360,-131,-347,-236,-111,-197,123,-314,-192,69,35,-89,82,-236,-158,43,11,-108,41,-78,-34,26,24,-95,61,-147,-143,-37,4,-39,40,-101,-124,-19,-3,-56,21,-46,-19,-18,7,-450,-543,93,-746,-565,-181,-200,199,-95,-431,19,31,-153,69,-103,-306,-51,-4,-47,130,8,-125,70,35,-171,83,-261,-347,-61,-6,-101,28,-188,-257,-54,-3,-70,55,-73,-90,-7,-3,108,-155,263,-230,-262,32,-168,360,37,-202,15,48,-118,144,23,-209,-36,37,-50,216,14,7,51,11,-42,141,-67,-214,-67,-6,-43,40,-41,-184,-44,-3,1,101,-26,-30,-23,-3,1408,685,723,766,271,495,238,424,499,63,118,49,161,191,269,-17,31,38,77,233,230,80,87,11,204,244,236,13,18,19,97,124,102,-52,-24,11,107,120,134,65,42,8,1966,889,1077,1560,740,820,261,617,670,239,113,52,130,300,336,63,25,35,131,317,334,176,88,17,306,417,477,194,102,38,166,213,233,64,23,27,140,204,244,130,79,11
8,08282,Tiana,5565,263,116,147,27,13,14,71,19,82,79,-4,10,37,9,27,41,1,-1,34,10,55,38,-5,11,4,8,7,3,1,2,2,4,3,1,1,0,2,4,4,2,0,2,180,74,106,26,10,16,31,22,72,43,2,11,15,3,32,26,-3,4,16,19,40,17,5,7,8,4,12,2,0,0,4,0,5,1,0,0,4,4,7,1,0,0,277,150,127,30,10,20,60,26,105,68,10,2,38,16,41,43,7,1,22,10,64,25,3,1,7,8,6,5,4,-1,1,4,0,2,3,-1,6,4,6,3,1,0,246,119,127,25,4,21,45,17,84,71,6,16,21,9,29,46,1,7,24,8,55,25,5,9,0,7,11,2,0,3,-3,2,2,1,0,0,3,5,9,1,0,3,235,113,122,15,2,13,35,26,74,68,8,19,19,6,35,41,8,0,16,20,39,27,0,19,1,4,11,2,-5,2,0,0,4,0,-2,0,1,4,7,2,-3,2,191,98,93,22,8,14,48,15,28,67,22,8,24,2,22,37,9,3,24,13,6,30,13,5,1,2,14,1,3,-1,0,1,5,1,1,-1,1,1,9,0,2,0,70,33,37,19,7,12,31,17,11,9,-1,-3,14,9,7,0,1,0,17,8,4,9,-2,-3,9,1,6,1,2,-1,4,0,1,0,2,0,5,1,5,1,0,-1,67,19,48,18,6,12,29,3,17,16,-3,0,15,-8,8,9,-4,-1,14,11,9,7,1,1,4,3,9,5,-2,-1,2,0,4,2,-1,-1,2,3,5,3,-1,0,55,23,32,35,15,20,22,8,-6,28,-4,6,8,3,-12,16,0,5,14,5,6,12,-4,1,11,7,7,9,1,0,5,4,1,4,1,0,6,3,6,5,0,0,145,48,97,18,3,15,41,1,44,27,9,19,20,-3,16,10,-2,6,21,4,28,17,11,13,3,6,5,-1,4,0,0,2,1,-2,1,0,3,4,4,1,3,0,170,68,102,1,-5,6,23,13,37,39,8,49,11,3,13,20,8,10,12,10,24,19,0,39,-2,4,-2,-2,0,3,-1,-1,-3,0,-1,1,-1,5,1,-2,1,2,157,38,119,8,3,5,40,6,50,25,2,31,4,-3,19,4,0,12,36,9,31,21,2,19,0,4,2,-3,0,4,-1,2,-1,-1,0,3,1,2,3,-2,0,1,33,12,21,-13,-5,-8,8,-7,13,18,-17,17,5,-2,2,8,-3,0,3,-5,11,10,-14,17,-2,-1,-9,-3,1,0,-1,-1,-2,-1,0,0,-1,0,-7,-2,1,0,91,42,49,7,5,2,2,11,64,6,0,8,11,4,20,-2,5,4,-9,7,44,8,-5,4,1,2,3,-3,5,-2,4,0,-1,-2,3,0,-3,2,4,-1,2,-2,93,48,45,12,6,6,18,6,26,21,21,-3,9,-2,18,8,17,0,9,8,8,13,4,-3,3,4,1,1,2,1,1,2,2,0,0,1,2,2,-1,1,2,0,123,34,89,4,-3,7,22,9,14,31,6,38,13,2,1,16,-4,4,9,7,13,15,10,34,6,2,-1,-1,-2,0,3,0,-4,-2,0,0,3,2,3,1,-2,0,80,48,32,30,12,18,30,0,8,56,-17,-2,24,4,5,31,-10,-5,6,-4,3,25,-7,3,9,4,3,7,4,3,5,2,-1,4,1,1,4,2,4,3,3,2,57,20,37,50,27,23,22,-2,11,32,-12,9,7,4,2,15,-6,0,15,-6,9,17,-6,9,12,4,11,16,7,0,9,2,4,9,3,0,3,2,7,7,4,0
8,08283,Tona,5842,112,58,54,45,27,18,17,24,28,23,8,10,7,11,19,14,4,3,10,13,9,9,4,7,8,11,17,8,0,0,4,7,10,6,0,0,4,4,7,2,0,0,178,109,69,56,32,24,46,30,51,33,3,17,31,23,27,21,0,7,15,7,24,12,3,10,11,15,16,11,3,0,6,10,9,6,1,0,5,5,7,5,2,0,292,166,126,74,35,39,74,11,97,63,14,26,33,12,61,41,4,11,41,-1,36,22,10,15,19,20,7,20,3,4,9,10,4,10,0,2,10,10,3,10,3,2,221,123,98,70,34,36,56,36,49,46,10,15,41,20,24,22,4,7,15,16,25,24,6,8,19,18,21,9,2,0,11,9,9,4,0,0,8,9,12,5,2,0,270,126,144,78,31,47,45,58,94,50,14,3,20,13,52,32,5,1,25,45,42,18,9,2,11,25,26,13,0,2,6,12,8,5,0,0,5,13,18,8,0,2,276,121,155,89,35,54,76,40,69,54,2,24,37,20,32,20,3,6,39,20,37,34,-1,18,23,25,23,11,2,3,10,13,8,3,1,0,13,12,15,8,1,3,230,118,112,112,55,57,28,11,130,19,19,18,13,0,67,19,6,7,15,11,63,0,13,11,19,25,39,15,8,5,6,16,18,8,4,2,13,9,21,7,4,3,201,92,109,80,37,43,31,32,48,47,21,12,10,13,26,25,11,5,21,19,22,22,10,7,12,24,28,13,1,0,5,13,11,8,-1,0,7,11,17,5,2,0,125,64,61,8,12,-4,9,24,30,4,12,47,6,9,27,-1,7,15,3,15,3,5,5,32,0,8,9,-7,2,-3,2,2,12,-4,1,-1,-2,6,-3,-3,1,-2,2,8,-6,-2,2,-4,-10,-3,2,4,-4,10,-7,9,3,0,-1,3,-3,-12,-1,4,-3,7,2,1,-8,5,-1,-1,5,4,-5,-1,-1,0,-3,-3,-3,6,0,-1,89,30,59,-28,-17,-11,19,7,25,20,-5,16,14,-10,13,8,-8,9,5,17,12,12,3,7,-10,-3,-6,-7,-3,-1,-1,-2,-4,-7,-3,0,-9,-1,-2,0,0,-1,-28,-10,-18,-19,-16,-3,20,0,-39,-20,6,4,24,-3,-28,-14,4,6,-4,3,-11,-6,2,-2,-2,2,-10,-5,-1,-3,1,-4,-5,-6,-1,-1,-3,6,-5,1,0,-2,-28,-43,15,-12,-8,-4,-3,16,-18,-25,-11,14,-15,13,-21,-15,-5,0,12,3,3,-10,-6,14,10,7,-13,-7,-9,0,3,6,-11,-4,-2,0,7,1,-2,-3,-7,0,-82,-72,-10,-29,-16,-13,-46,3,-17,-27,-1,8,-36,-3,-13,-19,1,0,-10,6,-4,-8,-2,8,-1,-1,-11,-11,-5,0,-1,-1,-6,-5,-2,0,0,0,-5,-6,-3,0,-10,16,-26,-19,-10,-9,-18,-12,16,-2,2,4,2,-6,17,3,2,-1,-20,-6,-1,-5,0,5,-7,-3,5,-10,-3,-1,-1,-3,3,-6,-2,-1,-6,0,2,-4,-1,0,-39,-12,-27,1,3,-2,-5,-16,-15,4,-14,8,-11,-2,0,3,-4,4,6,-14,-15,1,-10,4,-4,1,11,-8,2,-1,-1,3,6,-6,1,0,-3,-2,5,-2,1,-1,164,100,64,42,19,23,23,33,43,42,13,5,17,20,24,22,10,3,6,13,19,20,3,2,4,14,10,8,5,1,3,9,5,-1,3,0,1,5,5,9,2,1,35,22,13,44,21,23,10,24,4,2,-3,3,8,14,3,-5,3,1,2,10,1,7,-6,2,14,10,10,3,5,2,6,3,8,1,2,1,8,7,2,2,3,1
8,08285,Torelló,12077,93,71,22,120,76,44,14,28,14,15,7,13,12,16,21,6,3,10,2,12,-7,9,4,3,23,30,36,25,2,2,14,20,25,15,1,0,9,10,11,10,1,2,159,119,40,168,99,69,19,66,48,23,3,1,13,39,48,21,2,-4,6,27,0,2,1,5,28,57,49,25,6,2,15,31,32,17,4,0,13,26,17,8,2,2,82,60,22,152,91,61,13,52,-1,4,8,5,1,35,8,3,11,1,12,17,-9,1,-3,4,24,49,41,25,5,7,13,27,27,15,5,3,11,22,14,10,0,4,230,110,120,143,57,86,58,39,89,26,9,9,28,19,58,8,0,2,30,20,31,18,9,7,42,30,43,17,5,5,18,9,21,7,1,1,24,21,22,10,4,4,167,89,78,163,86,77,42,44,51,23,8,1,25,25,31,11,4,-6,17,19,20,12,4,7,33,54,37,26,7,4,18,29,17,16,3,2,15,25,20,10,4,2,218,104,114,151,75,76,36,66,50,47,9,13,16,17,26,37,2,7,20,49,24,10,7,6,17,50,46,26,8,3,8,15,30,16,2,3,9,35,16,10,6,0,237,146,91,155,95,60,47,56,75,38,20,-3,29,25,66,22,8,-5,18,31,9,16,12,2,32,38,46,30,6,3,19,15,41,18,1,1,13,23,5,12,5,2,208,121,87,165,90,75,23,100,35,49,9,-8,8,48,33,31,6,-4,15,52,2,18,3,-4,31,62,39,31,1,1,17,30,21,19,3,0,14,32,18,12,-2,1,61,52,9,40,13,27,8,29,17,14,-7,-6,8,24,20,5,-3,-5,0,5,-3,9,-4,-1,1,23,16,-9,1,4,1,10,3,-7,1,3,0,13,13,-2,0,1,73,10,63,27,7,20,6,31,25,9,-2,0,2,11,19,-9,-7,-7,4,20,6,18,5,7,10,19,3,-3,-1,-1,6,11,2,-9,0,-3,4,8,1,6,-1,2,-32,-23,-9,-51,-40,-11,9,-24,-5,-7,-4,-6,9,-9,-11,-9,-3,-3,0,-15,6,2,-1,-3,-11,-3,-17,-15,-4,-1,-3,-7,-10,-12,-5,-2,-8,4,-7,-3,1,1,-66,-43,-23,5,-11,16,-11,-2,-45,-11,8,-3,-4,-6,-23,-8,-8,6,-7,4,-22,-3,16,-9,-2,9,-4,-3,4,0,-2,0,-6,-4,0,1,0,9,2,1,4,-1,14,-16,30,-94,-74,-20,5,20,-1,-17,2,3,0,-3,-5,-10,-2,3,5,23,4,-7,4,0,-12,-3,-33,-30,-13,-3,-9,-9,-29,-19,-8,0,-3,6,-4,-11,-5,-3,-11,-2,-9,-31,-18,-13,-14,18,-6,-6,-8,3,-3,7,1,-3,-10,4,-11,11,-7,-3,2,-1,-17,0,2,-12,-5,0,-5,-1,2,-9,-6,0,-12,1,0,-3,1,0,-77,-30,-47,-82,-39,-43,-50,2,-23,9,-2,-10,-28,3,-5,10,-1,-6,-22,-1,-18,-1,-1,-4,-37,-3,-21,-12,-4,-5,-18,1,-7,-8,-5,-2,-19,-4,-14,-4,1,-3,9,15,-6,-29,-9,-20,-10,16,-21,14,13,-6,-10,15,5,-6,6,1,0,1,-26,20,7,-7,-18,9,-6,-12,-4,2,-9,6,5,-12,-2,3,-9,3,-11,0,-2,-1,141,85,56,52,34,18,18,29,50,25,13,2,16,15,25,18,8,1,2,14,25,7,5,1,7,8,18,8,8,2,8,7,9,3,7,0,-1,1,9,5,1,2,194,124,70,102,44,58,27,37,48,49,17,8,18,23,29,30,16,2,9,14,19,19,1,6,12,30,31,25,0,1,5,13,16,11,-2,-1,7,17,15,14,2,2
8,08288,Torrelles de Foix,1702,27,16,11,4,2,2,12,2,3,10,8,-10,10,-1,2,8,4,-8,2,3,1,2,4,-2,0,3,0,1,0,0,0,1,0,1,0,0,0,2,0,0,0,0,51,33,18,25,16,9,3,17,19,7,1,5,5,13,8,1,4,1,-2,4,11,6,-3,4,5,8,5,5,1,1,5,5,2,3,0,1,0,3,3,2,1,0,84,50,34,14,12,2,11,14,9,32,10,9,7,7,5,18,8,6,4,7,4,14,2,3,0,6,5,3,0,0,0,4,5,2,1,0,0,2,0,1,-1,0,133,70,63,19,6,13,37,20,31,21,19,5,22,7,13,13,11,3,15,13,18,8,8,2,3,10,4,1,0,0,0,4,2,-1,0,0,3,6,2,2,0,0,216,132,84,27,19,8,36,35,71,46,18,9,17,24,43,33,9,4,19,11,28,13,9,5,6,8,11,1,2,-1,5,6,6,1,1,0,1,2,5,0,1,-1,86,38,48,37,20,17,27,19,16,20,12,-8,12,6,2,13,9,-4,15,13,14,7,3,-4,9,8,7,11,1,1,3,3,6,7,0,1,6,5,1,4,1,0,94,51,43,38,24,14,14,16,15,26,13,14,6,14,10,12,7,5,8,2,5,14,6,9,10,8,10,7,1,2,5,7,8,3,0,1,5,1,2,4,1,1,88,50,38,19,7,12,21,5,25,29,9,1,10,5,11,18,4,2,11,0,14,11,5,-1,7,3,4,2,1,2,2,2,1,0,0,2,5,1,3,2,1,0,0,-9,9,12,-5,17,18,-7,1,-9,-1,-1,8,-1,-7,-8,3,-3,10,-6,8,-1,-4,2,12,2,0,-3,1,-1,5,-3,-5,-2,0,-1,7,5,5,-1,1,0,73,30,43,29,11,18,40,15,-1,16,10,-7,20,7,-2,4,4,-3,20,8,1,12,6,-4,14,5,5,3,1,1,10,1,1,-1,-1,1,4,4,4,4,2,0,-81,-32,-49,-11,-5,-6,-6,-23,-32,-15,4,-9,3,-9,-22,0,1,-4,-9,-14,-10,-15,3,-5,-2,-3,-3,-3,-1,1,-1,-2,0,-2,-1,1,-1,-1,-3,-1,0,0,-41,-41,0,-17,-17,0,10,-18,-11,-16,-3,-7,-1,-13,-8,-11,-6,-5,11,-5,-3,-5,3,-2,3,-1,-4,-13,0,-2,0,-3,-4,-10,0,0,3,2,0,-3,0,-2,-39,-13,-26,19,10,9,7,-32,-5,4,-8,-3,8,-19,0,7,-2,-5,-1,-13,-5,-3,-6,2,5,3,4,5,0,2,4,0,3,3,0,0,1,3,1,2,0,2,-24,-16,-8,2,1,1,3,-3,-20,-3,13,-13,-1,0,-9,-3,7,-8,4,-3,-11,0,6,-5,6,-6,3,2,0,-2,3,-4,2,2,1,-2,3,-2,1,0,-1,0,-66,-17,-49,3,5,-2,-3,-12,-7,-18,-18,-9,7,-6,-1,-6,-8,-4,-10,-6,-6,-12,-10,-5,-2,2,5,-2,0,-1,0,1,4,0,0,-1,-2,1,1,-2,0,0,-23,3,-26,-8,-3,-5,-5,-15,-7,3,6,-2,-2,-8,-2,8,5,2,-3,-7,-5,-5,1,-4,-1,-1,-4,0,-1,-1,0,0,-3,0,0,0,-1,-1,-1,0,-1,-1,42,27,15,24,11,13,14,9,9,8,20,-20,6,1,7,8,11,-8,8,8,2,0,9,-12,8,5,5,6,3,-3,1,2,2,4,3,-1,7,3,3,2,0,-2,51,26,25,41,19,22,19,-9,20,13,7,2,2,-7,12,11,6,3,17,-2,8,2,1,-1,10,10,10,8,2,1,3,5,3,7,0,1,7,5,7,1,2,0
8,08291,Vacarisses,2349,217,129,88,6,4,2,48,18,83,29,20,16,33,10,43,19,12,10,15,8,40,10,8,6,2,1,3,0,0,0,2,1,1,0,0,0,0,0,2,0,0,0,209,109,100,9,3,6,33,35,75,34,19,5,23,19,36,16,9,3,10,16,39,18,10,2,1,2,3,2,1,0,0,1,1,1,0,0,1,1,2,1,1,0,277,138,139,24,12,12,61,21,100,49,26,8,26,10,56,22,16,2,35,11,44,27,10,6,3,4,9,3,3,1,1,3,4,1,2,1,2,1,5,2,1,0,424,220,204,18,6,12,85,37,181,81,30,3,47,15,85,48,18,0,38,22,96,33,12,3,1,3,5,6,2,0,0,1,1,2,1,0,1,2,4,4,1,0,517,248,269,32,23,9,127,55,163,98,32,38,53,32,88,46,14,15,74,23,75,52,18,23,11,6,6,7,1,1,7,7,4,5,0,0,4,-1,2,2,1,1,377,180,197,15,7,8,72,44,134,52,38,26,34,23,64,25,20,9,38,21,70,27,18,17,3,2,3,1,2,4,0,2,1,0,1,3,3,0,2,1,1,1,293,167,126,16,7,9,42,26,124,29,29,24,33,15,64,16,15,11,9,11,60,13,14,13,3,7,6,-4,1,3,4,5,2,-4,-1,1,-1,2,4,0,2,2,292,144,148,7,0,7,45,32,108,50,42,6,30,16,39,33,19,0,15,16,69,17,23,6,3,2,4,5,2,-9,2,1,-2,4,0,-5,1,1,6,1,2,-4,64,15,49,31,15,16,11,-3,21,23,3,6,-1,-1,-5,17,0,2,12,-2,26,6,3,4,8,10,5,6,1,1,4,4,3,3,1,0,4,6,2,3,0,1,22,12,10,10,5,5,-13,1,16,11,-4,11,1,4,2,9,-3,0,-14,-3,14,2,-1,11,1,6,1,2,1,-1,-1,2,1,2,1,0,2,4,0,0,0,-1,119,73,46,15,4,11,34,-3,27,37,8,11,22,-6,23,21,6,6,12,3,4,16,2,5,6,-1,7,-1,2,1,5,0,1,-3,0,1,1,-1,6,2,2,0,2,-5,7,-12,-8,-4,-8,-14,35,-18,-7,11,-3,-4,18,-10,-8,1,-5,-10,17,-8,1,10,-6,0,-3,-1,-1,-1,-4,1,-1,-1,-2,-1,-2,-1,-2,0,1,0,-24,-31,7,-7,0,-7,-24,0,20,-28,10,4,-20,-3,5,-18,7,3,-4,3,15,-10,3,1,-1,4,-4,-4,-1,-1,-1,4,-1,-3,1,0,0,0,-3,-1,-2,-1,-48,-13,-35,6,6,0,-23,-7,3,-20,-2,3,-7,-6,12,-7,1,-6,-16,-1,-9,-13,-3,9,2,0,1,-1,3,1,3,0,2,-1,2,0,-1,0,-1,0,1,1,-109,-48,-61,-4,-4,0,-57,-4,7,-54,-6,7,-36,-1,6,-19,-4,7,-21,-3,1,-35,-2,0,0,2,-3,-4,-2,3,-3,0,-1,0,-1,1,3,2,-2,-4,-1,2,26,0,26,4,-4,8,17,4,37,-1,-18,-15,10,-5,21,-4,-4,-17,7,9,16,3,-14,2,5,3,-1,-3,-1,1,1,1,-2,-3,-1,0,4,2,1,0,0,1,131,52,79,10,6,4,34,19,51,34,-18,4,11,9,21,17,-7,-1,23,10,30,17,-11,5,-2,6,8,-1,-1,-2,1,1,3,0,1,-1,-3,5,5,-1,-2,-1,160,102,58,15,14,1,39,3,80,31,8,-6,39,8,39,10,5,-4,0,-5,41,21,3,-2,1,2,4,0,3,5,2,3,4,1,2,2,-1,-1,0,-1,1,3
8,08292,Vallbona d'Anoia,1065,-9,-2,-7,5,4,1,-2,-1,-2,0,-4,1,-1,-2,-1,2,-2,2,-1,1,-1,-2,-2,-1,2,1,1,1,0,0,2,0,1,1,0,0,0,1,0,0,0,0,2,-1,3,9,4,5,2,-2,6,-4,0,-1,1,0,2,-2,0,-2,1,-2,4,-2,0,1,1,1,5,2,0,0,1,1,1,1,0,0,0,0,4,1,0,0,41,21,20,15,9,6,-1,6,19,10,1,7,-2,4,15,4,-1,3,1,2,4,6,2,4,1,2,7,3,0,2,1,0,5,2,0,1,0,2,2,1,0,1,81,43,38,15,9,6,18,9,29,13,7,5,10,9,11,8,4,1,8,0,18,5,3,4,3,4,5,3,0,0,2,1,4,2,0,0,1,3,1,1,0,0,64,35,29,25,18,7,15,5,23,7,13,1,11,4,11,0,8,1,4,1,12,7,5,0,3,8,6,5,3,0,2,5,6,2,3,0,1,3,0,3,0,0,74,35,39,21,9,12,19,8,31,-4,13,6,12,2,13,-1,6,2,7,6,18,-3,7,4,6,9,4,1,0,1,4,3,1,1,0,0,2,6,3,0,0,1,23,1,22,9,2,7,13,2,8,8,1,-9,3,-2,3,2,-1,-4,10,4,5,6,2,-5,3,4,1,1,0,0,0,2,0,0,0,0,3,2,1,1,0,0,44,34,10,16,12,4,3,7,12,15,-1,8,2,7,9,10,-1,7,1,0,3,5,0,1,1,4,7,3,1,0,0,3,5,3,1,0,1,1,2,0,0,0,35,19,16,15,7,8,9,4,11,7,4,0,5,2,2,9,1,0,4,2,9,-2,3,0,5,2,3,3,1,1,3,1,0,2,1,0,2,1,3,1,0,1,-6,-7,1,-1,0,-1,1,-3,-3,4,1,-3,-1,0,-6,0,1,0,2,-3,3,4,0,-3,0,-1,0,0,0,0,0,0,0,0,0,0,0,-1,0,0,0,0,8,6,2,8,1,7,1,-1,-1,7,2,-1,0,0,0,7,0,-1,1,-1,-1,0,2,0,3,1,1,2,0,0,2,-1,0,1,-1,0,1,2,1,1,1,0,-16,0,-16,-5,-2,-3,1,-9,-11,-4,5,2,7,-3,-8,-1,4,1,-6,-6,-3,-3,1,1,-1,-2,0,-3,0,1,0,0,-1,-1,0,0,-1,-2,1,-2,0,1,8,-5,13,4,0,4,2,2,7,-5,-3,3,1,-1,0,-6,-3,3,1,3,7,1,0,0,0,2,2,0,-1,1,0,0,1,0,-1,0,0,2,1,0,0,1,-3,5,-8,0,0,0,9,-2,1,-10,0,-2,3,0,4,-6,3,0,6,-2,-3,-4,-3,-2,1,0,1,-2,0,0,0,0,1,-1,0,0,1,0,0,-1,0,0,-16,-11,-5,-8,-6,-2,1,-5,1,0,-7,-5,-2,-2,1,-3,-1,-3,3,-3,0,3,-6,-2,0,-2,0,-2,-3,-1,0,-1,-1,-2,-2,0,0,-1,1,0,-1,-1,-5,11,-16,3,4,-1,0,-1,4,2,-5,-3,1,1,8,4,-2,0,-1,-2,-4,-2,-3,-3,3,0,1,1,-2,0,3,0,2,1,-2,0,0,0,-1,0,0,0,-1,-5,4,0,1,-1,-2,0,-1,8,-3,-2,-1,-1,-2,3,-4,0,-1,1,1,5,1,-2,-5,1,2,1,1,0,-1,1,0,0,1,0,-4,0,2,1,0,0,-3,-4,1,0,1,-1,0,-1,2,-4,-2,2,-1,0,1,-3,-2,2,1,-1,1,-1,0,0,0,1,-3,2,0,0,0,0,-1,2,0,0,0,1,-2,0,0,0
8,08294,Vallgorguina,1252,85,41,44,4,1,3,13,18,22,23,8,1,6,6,13,10,6,0,7,12,9,13,2,1,0,0,4,0,0,0,0,0,1,0,0,0,0,0,3,0,0,0,99,50,49,6,3,3,21,7,33,20,12,4,12,5,10,16,2,4,9,2,23,4,10,0,1,2,2,1,0,0,1,1,0,1,0,0,0,1,2,0,0,0,109,58,51,14,5,9,19,12,42,32,2,0,6,7,26,18,-1,0,13,5,16,14,3,0,4,5,4,1,0,0,1,1,2,1,0,0,3,4,2,0,0,0,104,39,65,12,5,7,8,16,54,11,13,-1,-2,3,28,6,5,-3,10,13,26,5,8,2,4,4,2,1,0,1,0,2,1,1,0,1,4,2,1,0,0,0,163,81,82,18,8,10,35,16,78,27,8,0,16,6,35,17,4,4,19,10,43,10,4,-4,3,3,4,7,1,0,1,1,2,4,0,0,2,2,2,3,1,0,125,58,67,9,3,6,17,12,52,23,10,5,10,6,20,12,6,1,7,6,32,11,4,4,1,2,0,5,0,1,1,1,-1,2,0,0,0,1,1,3,0,1,143,70,73,16,9,7,32,5,74,17,8,3,16,1,34,14,3,0,16,4,40,3,5,3,4,2,4,2,1,2,5,0,2,1,0,0,-1,2,2,1,1,2,175,97,78,46,25,21,28,15,82,30,11,7,17,9,38,22,5,4,11,6,44,8,6,3,16,8,14,5,1,2,9,3,9,3,0,1,7,5,5,2,1,1,34,3,31,15,6,9,1,-1,20,7,4,2,-7,-2,7,0,3,1,8,1,13,7,1,1,6,3,2,2,1,1,4,2,-1,0,0,1,2,1,3,2,1,0,100,53,47,7,6,1,21,7,34,28,7,1,10,5,15,20,1,0,11,2,19,8,6,1,0,5,1,0,-2,3,0,3,2,1,-1,1,0,2,-1,-1,-1,2,-3,2,-5,11,0,11,-22,4,10,1,3,5,-12,1,8,4,1,0,-10,3,2,-3,2,5,2,1,2,4,0,2,0,0,-2,2,0,0,2,1,4,2,0,2,18,17,1,4,0,4,0,-5,3,20,-1,3,-2,-3,3,12,4,1,2,-2,0,8,-5,2,-1,3,1,0,-1,2,-1,1,0,0,-1,1,0,2,1,0,0,1,66,25,41,13,6,7,22,11,9,18,6,2,9,4,0,8,4,0,13,7,9,10,2,2,1,1,2,5,5,-1,1,0,1,2,2,0,0,1,1,3,3,-1,-57,-34,-23,0,-3,3,-24,-2,-6,-22,-4,0,-11,1,-3,-21,2,-2,-13,-3,-3,-1,-6,2,0,-2,2,0,-2,1,-1,-1,-1,0,0,-1,1,-1,3,0,-2,2,45,28,17,13,6,7,12,1,29,-1,1,4,6,-1,17,6,0,1,6,2,12,-7,1,3,0,4,3,2,1,3,0,1,3,1,0,1,0,3,0,1,1,2,-17,-14,-3,-34,-15,-19,4,0,2,-19,3,-6,0,-5,7,-16,3,-2,4,5,-5,-3,0,-4,2,-1,-8,-13,-7,-7,0,-1,-4,-6,-2,-2,2,0,-4,-7,-5,-5,18,8,10,7,4,3,3,-1,19,5,0,-8,-5,-7,7,11,3,-1,8,6,12,-6,-3,-7,-1,0,5,0,3,0,-1,-1,3,1,2,0,0,1,2,-1,1,0,64,25,39,-1,-2,1,3,5,27,26,0,-4,3,1,13,10,-3,-2,0,4,14,16,3,-2,0,3,0,1,-3,-2,2,0,0,0,-2,-2,-2,3,0,1,-1,0
8,08295,Vallirana,8914,362,196,166,67,41,26,59,49,106,63,38,41,25,38,57,36,20,17,34,11,49,27,18,24,12,9,28,10,5,2,8,5,15,9,2,1,4,4,13,1,3,1,512,236,276,124,64,60,67,54,168,74,42,93,31,28,73,46,19,29,36,26,95,28,23,64,33,24,37,18,3,5,18,14,17,8,2,2,15,10,20,10,1,3,552,241,311,81,44,37,80,51,177,61,54,122,40,10,84,35,33,37,40,41,93,26,21,85,23,24,14,12,7,0,13,12,6,8,5,0,10,12,8,4,2,0,500,251,249,107,65,42,85,69,182,79,32,42,44,32,93,37,17,20,41,37,89,42,15,22,15,23,32,24,8,4,11,11,21,14,6,2,4,12,11,10,2,2,546,282,264,106,57,49,112,71,171,81,43,57,69,32,86,49,20,24,43,39,85,32,23,33,20,26,34,15,8,2,11,10,19,12,5,0,9,16,15,3,3,2,440,206,234,84,50,34,55,53,183,40,37,60,13,28,104,29,13,16,42,25,79,11,24,44,16,23,18,18,8,0,8,14,11,14,2,0,8,9,7,4,6,0,388,182,206,96,40,56,61,59,148,88,8,22,28,22,81,41,1,8,33,37,67,47,7,14,16,34,27,15,2,1,9,9,10,10,0,1,7,25,17,5,2,0,375,177,198,62,10,52,62,36,75,75,33,83,36,6,39,31,29,35,26,30,36,44,4,48,13,13,10,16,3,5,0,1,1,4,2,1,13,12,9,12,1,4,247,123,124,43,16,27,16,25,95,25,20,62,16,16,31,23,9,28,0,9,64,2,11,34,12,19,12,-2,3,-1,9,7,2,-1,0,-1,3,12,10,-1,3,0,78,20,58,13,-1,14,-4,9,10,22,8,33,-12,-1,6,13,6,6,8,10,4,9,2,27,10,9,3,-5,-1,-2,3,1,0,-3,0,-2,7,8,3,-2,-1,0,144,77,67,-12,-12,0,38,0,56,7,-4,36,23,4,29,5,-1,14,15,-4,27,2,-3,22,7,-3,-9,-1,-4,-5,5,-2,-7,0,-7,-2,2,-1,-2,-1,3,-3,97,1,96,35,12,23,-21,32,34,-1,-7,54,-28,5,18,-7,-3,15,7,27,16,6,-4,39,7,8,16,2,-1,3,0,3,12,-2,-1,0,7,5,4,4,0,3,59,17,42,14,1,13,-39,27,5,-25,13,76,-18,4,15,-20,2,30,-21,23,-10,-5,11,46,4,10,5,-1,-1,-3,0,3,3,-3,0,-2,4,7,2,2,-1,-1,10,25,-15,-23,3,-26,1,-21,-22,-2,-4,58,1,-7,-3,5,6,21,0,-14,-19,-7,-10,37,-14,-4,-13,0,3,3,-5,-2,-1,0,6,4,-9,-2,-12,0,-3,-1,3,-14,17,-71,-43,-28,-4,-3,-18,-9,-25,55,-3,-1,-11,-2,-10,10,-1,-2,-7,-7,-15,45,-14,5,-19,-20,-23,-2,-6,3,-10,-11,-17,-2,-8,2,-9,-9,-6,0,56,16,40,20,5,15,-23,-11,13,17,19,37,-10,-2,4,15,5,5,-13,-9,9,2,14,32,-9,7,9,9,4,-2,-4,0,6,4,0,-2,-5,7,3,5,4,0,114,78,36,42,20,22,-6,22,68,14,-15,27,8,11,55,-6,-8,13,-14,11,13,20,-7,14,1,19,12,10,0,-2,2,12,8,-4,1,0,-1,7,4,14,-1,-2,89,28,61,54,28,26,23,1,31,12,1,29,4,3,6,4,-3,15,19,-2,25,8,4,14,18,14,2,5,7,8,8,4,3,8,4,1,10,10,-1,-3,3,7
8,08296,Vallromanes,1209,91,53,38,9,5,4,20,5,33,18,8,3,7,4,21,13,3,2,13,1,12,5,5,1,0,1,4,3,1,0,0,0,3,2,0,0,0,1,1,1,1,0,87,38,49,13,3,10,9,7,32,17,9,12,7,3,10,10,4,4,2,4,22,7,5,8,2,1,4,6,0,0,1,0,1,1,0,0,1,1,3,5,0,0,71,39,32,11,5,6,23,8,22,18,1,-3,13,0,13,13,0,-1,10,8,9,5,1,-2,2,3,3,3,0,0,2,0,1,1,1,0,0,3,2,2,-1,0,87,44,43,12,5,7,15,3,43,18,7,0,11,-1,23,8,7,-3,4,4,20,10,0,3,7,0,3,1,1,0,2,0,1,1,1,0,5,0,2,0,0,0,77,38,39,12,3,9,10,0,40,16,7,-1,4,2,13,12,1,2,6,-2,27,4,6,-3,2,0,8,1,0,0,1,0,1,0,0,0,1,0,7,1,0,0,154,57,97,12,3,9,33,17,52,28,13,8,9,5,19,13,8,3,24,12,33,15,5,5,1,3,4,2,1,0,0,1,0,1,1,0,1,2,4,1,0,0,74,39,35,19,8,11,13,-1,22,17,13,7,8,-7,16,6,10,6,5,6,6,11,3,1,0,5,7,4,2,0,0,3,3,2,0,0,0,2,4,2,2,0,-22,-6,-16,18,5,13,-16,-6,0,-11,8,-1,-1,-4,-1,-5,6,-1,-15,-2,1,-6,2,0,6,4,9,-1,-1,0,5,-1,3,-2,0,0,1,5,6,1,-1,0,59,31,28,17,9,8,19,9,11,7,13,-1,7,8,6,4,5,0,12,1,5,3,8,-1,0,8,-1,3,5,2,0,3,0,2,2,2,0,5,-1,1,3,0,59,24,35,18,6,12,6,10,19,13,8,0,0,4,9,7,4,0,6,6,10,6,4,0,6,5,2,4,0,1,3,2,-1,2,0,0,3,3,3,2,0,1,19,15,4,1,1,0,4,-4,-1,12,2,1,5,0,-2,6,3,0,-1,-4,1,6,-1,1,0,0,0,0,1,0,0,1,1,-2,1,0,0,-1,-1,2,0,0,71,30,41,5,5,0,21,-1,11,16,9,15,10,-1,8,6,3,4,11,0,3,10,6,11,1,2,4,-1,-1,0,1,1,3,0,0,0,0,1,1,-1,-1,0,55,22,33,2,1,1,12,8,36,6,-2,-8,8,6,13,0,-1,-4,4,2,23,6,-1,-4,6,0,-1,0,-3,0,4,0,1,-2,-2,0,2,0,-2,2,-1,0,-16,-12,-4,0,-2,2,-15,-5,6,-7,-1,5,-8,-2,4,-3,-2,-1,-7,-3,2,-4,1,6,0,1,1,-2,1,-1,0,0,0,-2,0,0,0,1,1,0,1,-1,-3,8,-11,-7,-2,-5,6,-5,2,6,-11,-1,10,-3,0,4,-3,1,-4,-2,2,2,-8,-2,2,0,-7,-1,-2,0,1,0,-2,0,-1,0,1,0,-5,-1,-1,0,-5,4,-9,-9,-5,-4,-3,-6,9,-7,1,1,-5,-6,6,3,3,3,2,0,3,-10,-2,-2,-1,0,-3,-4,-1,0,-1,0,-1,-3,0,0,0,0,-2,-1,-1,0,-10,-15,5,21,7,14,-2,-2,-7,3,-6,3,-2,-6,-6,2,-3,0,0,4,-1,1,-3,3,9,1,6,4,0,1,3,0,2,1,1,0,6,1,4,3,-1,1,18,19,-1,19,11,8,6,-4,15,15,-6,-8,6,-3,9,9,1,-3,0,-1,6,6,-7,-5,3,4,7,2,2,1,2,2,4,0,2,1,1,2,3,2,0,0
8,08301,Viladecans,55575,236,81,155,23,15,8,-73,112,190,-25,16,32,-52,32,118,-22,2,15,-21,80,72,-3,14,17,8,3,7,2,3,0,5,3,4,2,1,0,3,0,3,0,2,0,65,33,32,13,7,6,-133,80,168,-83,-37,68,-69,55,111,-56,-35,28,-64,25,57,-27,-2,40,0,2,2,5,1,1,0,1,0,5,0,1,0,1,2,0,1,0,1,-19,20,-12,-8,-4,-101,55,132,-42,-44,0,-44,-3,91,-28,-31,-2,-57,58,41,-14,-13,2,4,-6,-9,-1,2,-2,1,-3,-4,-2,1,-1,3,-3,-5,1,1,-1,-27,-19,-8,1,0,1,-204,168,184,-117,-65,21,-104,46,150,-67,-38,4,-100,122,34,-50,-27,17,0,0,2,-1,0,0,0,0,1,-1,0,0,0,0,1,0,0,0,411,173,238,489,279,210,-63,270,279,-67,-25,19,-3,84,173,-49,-30,-1,-60,186,106,-18,5,20,69,145,165,74,26,11,32,73,111,50,9,4,37,72,54,24,17,7,218,96,122,481,252,229,37,174,27,22,-66,30,16,91,14,31,-49,-3,21,83,13,-9,-17,33,98,128,114,99,29,8,47,64,66,55,14,4,51,64,48,44,15,4,-120,-113,-7,509,260,249,-169,227,-18,-87,-71,1,-94,97,-1,-60,-51,-6,-75,130,-17,-27,-20,7,94,153,139,70,37,12,47,80,78,32,14,7,47,73,61,38,23,5,-87,-75,-12,408,231,177,-60,107,-18,-87,-47,33,-37,44,20,-58,-39,0,-23,63,-38,-29,-8,33,101,137,121,56,-1,-6,55,83,75,27,-7,-3,46,54,46,29,6,-3,243,111,132,451,253,198,7,161,100,20,-29,-1,5,93,67,-1,-29,-23,2,68,33,21,0,22,101,134,141,57,14,-2,56,72,92,29,10,-7,45,62,49,28,4,5,360,161,199,199,86,113,76,113,218,-10,-65,16,47,37,88,9,-42,8,29,76,130,-19,-23,8,58,82,45,11,-13,8,35,30,12,7,-9,4,23,52,33,4,-4,4,205,11,194,-103,-98,-5,16,105,182,-76,-23,-1,-6,42,77,-73,-26,-7,22,63,105,-3,3,6,-9,17,-40,-62,-13,1,-3,-3,-29,-53,-14,3,-6,20,-11,-9,1,-2,26,-42,68,-29,-75,46,15,29,86,-93,-19,3,10,-8,31,-47,-42,8,5,37,55,-46,23,-5,16,25,-35,-18,-13,-10,4,2,-45,-20,-13,-7,12,23,10,2,0,-3,-23,-15,-8,-177,-128,-49,-14,52,-5,-33,-43,18,-25,27,18,-25,-30,15,11,25,-23,-8,-13,3,-14,1,-57,-90,-15,-4,-16,3,-50,-61,-10,3,2,-2,-7,-29,-5,-7,-288,-171,-117,-196,-121,-75,-33,-26,-116,-95,-24,14,-9,9,-94,-64,-9,-1,-24,-35,-22,-31,-15,15,-16,-13,-68,-100,-3,3,-9,-6,-30,-77,-1,1,-7,-7,-38,-23,-2,2,-79,-72,-7,-50,-21,-29,-22,-14,1,-42,-5,11,5,1,-32,-33,-4,-1,-27,-15,33,-9,-1,12,-12,7,-11,-36,2,2,2,8,-10,-15,-4,-2,-14,-1,-1,-21,6,4,34,-23,57,142,83,59,4,43,25,-56,-24,45,-16,29,27,-60,-19,19,20,14,-2,4,-5,26,32,40,36,14,9,7,11,21,40,4,1,3,21,19,-4,10,8,4,127,14,113,156,59,97,27,57,34,0,0,3,0,34,17,-10,-25,1,27,23,17,10,25,2,26,48,36,12,22,7,19,31,14,-9,4,-3,7,17,22,21,18,10,105,48,57,190,72,118,-21,102,56,-26,-18,2,-5,48,32,-30,-9,5,-16,54,24,4,-9,-3,36,78,76,-16,1,9,15,41,26,-14,0,1,21,37,50,-2,1,8
8,08300,Viladecavalls,5509,223,136,87,23,15,8,63,20,48,42,19,17,43,20,24,24,14,6,20,0,24,18,5,11,3,8,10,2,0,0,1,6,6,2,0,0,2,2,4,0,0,0,199,115,84,40,32,8,56,19,54,35,14,12,22,17,39,18,10,1,34,2,15,17,4,11,2,19,8,7,1,3,0,18,7,5,0,2,2,1,1,2,1,1,148,76,72,20,15,5,61,2,36,35,1,3,35,7,9,12,4,5,26,-5,27,23,-3,-2,3,4,9,5,-1,0,2,3,7,3,0,0,1,1,2,2,-1,0,188,67,121,17,9,8,52,-19,98,38,-7,4,19,-19,40,15,-2,2,33,0,58,23,-5,2,2,4,5,3,3,0,2,2,4,0,1,0,0,2,1,3,2,0,2,6,-4,12,3,9,10,-31,-2,-2,18,0,12,-15,-3,1,9,-4,-2,-16,1,-3,9,4,9,-6,2,2,2,1,5,-5,2,0,1,0,4,-1,0,2,1,1,129,51,78,29,12,17,59,-11,67,16,-17,2,24,-7,24,13,-10,0,35,-4,43,3,-7,2,4,13,7,4,1,0,0,6,4,2,0,0,4,7,3,2,1,0,41,18,23,21,12,9,2,-29,30,7,10,15,-7,-5,16,7,5,1,9,-24,14,0,5,14,4,6,3,5,0,3,2,6,2,2,0,0,2,0,1,3,0,3,65,31,34,43,24,19,37,-19,22,14,3,1,24,-20,11,11,2,-1,13,1,11,3,1,2,12,4,19,5,2,0,7,1,9,4,3,0,5,3,10,1,-1,0,130,67,63,26,13,13,32,11,36,28,4,3,22,5,14,18,2,0,10,6,22,10,2,3,1,12,14,0,-1,-1,-1,6,9,-1,0,0,2,6,5,1,-1,-1,-27,-33,6,-3,-3,0,15,-15,19,-13,-21,-16,-2,-7,-7,3,-13,-8,17,-8,26,-16,-8,-8,-3,3,4,-5,-1,-1,-3,2,2,-3,-1,0,0,1,2,-2,0,-1,24,31,-7,-3,-3,0,29,-31,28,5,-15,-3,17,-18,24,3,-2,2,12,-13,4,2,-13,-5,1,1,-3,-1,0,-2,0,1,-4,-2,1,0,1,0,1,1,-1,-2,8,9,-1,-12,-5,-7,11,-2,-14,19,0,-10,12,-2,-5,3,0,-2,-1,0,-9,16,0,-8,0,-1,-4,-7,0,0,-1,-1,0,-3,0,0,1,0,-4,-4,0,0,-31,-13,-18,1,-3,4,-4,-26,5,-17,3,6,-3,-10,-3,-8,6,1,-1,-16,8,-9,-3,5,0,0,2,-1,-1,1,1,-2,0,-2,0,0,-1,2,2,1,-1,1,-9,-12,3,0,4,-4,4,-11,-9,3,-4,7,5,-2,-12,2,-6,1,-1,-9,3,1,2,6,-1,1,-2,-1,2,1,0,2,1,0,1,0,-1,-1,-3,-1,1,1,-30,-15,-15,-1,1,-2,22,-7,-3,-9,-36,2,10,-2,9,-10,-22,0,12,-5,-12,1,-14,2,3,4,-1,-4,-5,2,0,3,3,-1,-4,0,3,1,-4,-3,-1,2,-8,-12,4,4,4,0,25,-23,10,-13,-18,5,0,-10,3,-3,-4,-2,25,-13,7,-10,-14,7,-6,5,3,0,1,0,-2,2,1,1,1,0,-4,3,2,-1,0,0,48,4,44,14,8,6,6,-8,19,18,-11,16,-8,-3,0,17,-7,2,14,-5,19,1,-4,14,6,-1,3,1,4,0,4,-1,5,-2,2,0,2,0,-2,3,2,0,89,42,47,5,3,2,29,-12,27,23,5,14,14,-11,21,8,7,0,15,-1,6,15,-2,14,3,-4,5,1,0,0,1,-2,4,1,-1,0,2,-2,1,0,1,0
8,08305,Vilafranca del Penedès,29273,826,497,329,484,327,157,80,177,374,87,57,49,26,114,267,54,18,15,54,63,107,33,39,34,80,116,194,77,8,6,43,85,147,46,4,1,37,31,47,31,4,5,963,539,424,624,385,239,155,233,342,97,76,60,84,127,206,59,33,31,71,106,136,38,43,29,106,169,231,95,14,9,62,103,154,55,5,6,44,66,77,40,9,3,1174,622,552,747,460,287,187,270,353,188,67,92,69,155,205,116,35,40,118,115,148,72,32,52,148,171,243,135,30,13,77,102,166,92,14,4,71,69,77,43,16,9,1156,588,568,783,430,353,145,324,414,142,54,69,73,152,259,66,18,19,72,172,155,76,36,50,148,237,259,88,28,12,72,132,162,46,10,3,76,105,97,42,18,9,1062,604,458,783,482,301,113,291,369,148,74,61,61,137,273,72,32,27,52,154,96,76,42,34,105,221,277,128,35,12,52,123,204,75,19,6,53,98,73,53,16,6,606,285,321,800,408,392,87,167,206,63,32,60,48,66,113,42,3,18,39,101,93,21,29,42,187,203,252,108,28,12,93,99,142,53,12,3,94,104,110,55,16,9,534,290,244,962,542,420,78,203,166,43,28,38,38,128,122,9,3,3,40,75,44,34,25,35,231,235,308,132,37,16,127,129,186,77,15,6,104,106,122,55,22,10,668,324,344,698,348,350,102,271,185,42,5,43,67,144,83,8,-9,23,35,127,102,34,14,20,164,248,172,79,20,10,92,132,84,35,1,3,72,116,88,44,19,7,750,350,400,582,282,300,99,184,301,102,30,37,42,75,180,51,-5,13,57,109,121,51,35,24,105,167,186,84,24,9,55,70,106,37,5,8,50,97,80,47,19,1,-362,-312,-50,-314,-261,-53,-19,-7,-207,-112,-57,41,0,-18,-173,-104,-27,8,-19,11,-34,-8,-30,33,6,-15,-153,-95,-59,-5,7,-16,-139,-78,-36,-5,-1,1,-14,-17,-23,0,346,242,104,248,138,110,43,103,113,48,2,34,36,43,99,54,-5,14,7,60,14,-6,7,20,50,55,99,26,9,3,28,20,66,18,0,3,22,35,33,8,9,0,-42,-55,13,-67,-72,5,55,49,-72,-69,7,-6,31,26,-51,-62,8,-6,24,23,-21,-7,-1,0,18,22,-40,-62,-6,-3,10,8,-37,-49,-5,-1,8,14,-3,-13,-1,-2,-206,-230,24,-548,-373,-175,-9,-23,-152,-70,10,39,-6,-18,-131,-72,-9,11,-3,-5,-21,2,19,28,-92,-54,-202,-157,-27,-17,-44,-42,-139,-120,-18,-8,-48,-12,-63,-37,-9,-9,294,91,203,-47,-63,16,112,35,-4,67,14,46,39,4,-27,39,19,11,73,31,23,28,-5,35,5,20,-24,-44,-8,0,-4,1,-29,-25,-6,0,9,19,5,-19,-2,0,-13,-31,18,-84,-68,-16,-8,29,-24,-78,40,33,0,13,-27,-43,18,15,-8,16,3,-35,22,18,1,-7,-31,-38,-11,-5,4,-14,-20,-24,-10,-6,-3,7,-11,-14,-1,1,181,-14,195,-33,-45,12,95,58,13,-13,-3,35,32,13,-13,-45,-13,17,63,45,26,32,10,18,-1,22,-17,-41,-4,5,9,5,-20,-26,-15,3,-10,17,3,-15,11,2,57,8,49,-19,-30,11,9,45,24,-68,2,40,6,4,27,-33,-15,9,3,41,-3,-35,17,31,13,28,-2,-39,-23,-1,0,1,5,-24,-14,-3,13,27,-7,-15,-9,2,591,242,349,299,135,164,95,76,137,147,37,90,30,31,60,77,-1,41,65,45,77,70,38,49,58,75,81,56,13,9,15,37,45,22,5,7,43,38,36,34,8,2
8,08302,Vilanova del Camí,10111,77,44,33,39,19,20,29,15,31,2,-5,6,8,10,35,-5,-4,1,21,5,-4,7,-1,5,21,7,6,4,1,0,4,5,6,3,1,0,17,2,0,1,0,0,23,13,10,13,8,5,-1,19,28,-9,-10,-1,-4,5,20,-1,-6,0,3,14,8,-8,-4,-1,5,1,4,2,0,0,3,0,3,1,0,0,2,1,1,1,0,0,124,72,52,11,7,4,42,15,45,-4,13,13,22,13,24,-8,9,10,20,2,21,4,4,3,7,0,1,2,0,0,4,0,1,2,0,0,3,0,0,0,0,0,236,143,93,70,35,35,32,68,72,24,27,16,32,37,42,18,6,11,0,31,30,6,21,5,14,17,22,12,3,2,7,8,13,5,1,1,7,9,9,7,2,1,306,166,140,84,42,42,79,55,103,26,6,22,28,23,60,32,3,14,51,32,43,-6,3,8,22,16,26,12,4,0,10,8,12,8,3,0,12,8,14,4,1,0,292,151,141,106,51,55,42,81,117,40,12,5,32,22,66,22,6,1,10,59,51,18,6,4,29,30,29,16,2,0,17,10,12,10,2,0,12,20,17,6,0,0,147,139,8,132,77,55,1,58,101,-9,-2,-2,11,42,72,10,4,-2,-10,16,29,-19,-6,0,25,31,49,21,4,1,11,18,33,13,1,0,14,13,16,8,3,1,109,32,77,71,10,61,-7,14,51,-9,17,38,-22,12,20,-4,10,15,15,2,31,-5,7,23,25,17,21,2,7,-2,7,5,0,-4,3,-1,18,12,21,6,4,-1,151,53,98,91,31,60,31,38,26,4,4,46,14,12,24,-1,-5,6,17,26,2,5,9,40,23,35,15,13,5,1,12,8,9,0,1,1,11,27,6,13,4,0,-69,-48,-21,11,-5,16,-1,-27,2,-21,-8,-12,-5,-15,-7,-12,-10,-1,4,-12,9,-9,2,-11,14,13,1,-10,-8,0,7,3,-4,-7,-5,1,7,10,5,-3,-3,-1,-171,-84,-87,-52,-40,-12,-61,-14,-48,-32,-18,-4,-24,-2,-34,-19,-10,0,-37,-12,-14,-13,-8,-4,-13,-3,-26,-9,-3,0,-12,1,-18,-9,-4,0,-1,-4,-8,0,1,0,-83,-32,-51,-30,-17,-13,-24,-14,-14,-13,-10,0,-10,-5,-2,-6,-3,0,-14,-9,-12,-7,-7,0,-16,6,-1,-14,-8,2,-7,3,0,-11,-4,1,-9,3,-1,-3,-4,1,-92,-95,3,-75,-51,-24,-17,-6,-36,-23,-21,9,-11,-8,-35,-24,-18,0,-6,2,-1,1,-3,9,-24,-1,-20,-22,-7,-1,-18,-2,-12,-16,-3,0,-6,1,-8,-6,-4,-1,-74,-33,-41,-8,-1,-7,-35,-15,-19,-8,-1,6,-16,-15,2,-6,2,-3,-19,0,-21,-2,-3,9,-5,-2,4,-9,1,2,1,-2,4,-4,-1,1,-6,0,0,-5,2,1,-95,-51,-44,-21,-11,-10,-29,5,-29,-44,3,2,-20,16,-22,-23,1,0,-9,-11,-7,-21,2,2,-2,0,-6,-12,-1,-2,2,1,-6,-7,-2,1,-4,-1,0,-5,1,-3,-49,-31,-18,-29,-20,-9,-4,5,-21,-32,3,0,-8,-3,-14,-8,4,1,4,8,-7,-24,-1,-1,-2,5,-10,-18,-4,0,-4,0,-4,-9,-3,0,2,5,-6,-9,-1,0,-63,-50,-13,-10,-7,-3,-19,-11,-18,-18,-1,0,-26,2,-5,-12,-1,-9,7,-13,-13,-6,0,9,-7,15,-2,-8,-6,-5,-7,10,2,-8,-3,-3,0,5,-4,0,-3,-2,0,-15,15,27,11,16,-14,11,2,-19,17,-1,-18,7,-4,-9,9,0,4,4,6,-10,8,-1,14,2,7,2,2,0,8,-1,2,0,1,1,6,3,5,2,1,-1
8,08902,Vilanova del Vallès,2224,108,44,64,13,5,8,17,14,50,7,15,6,8,4,19,6,8,0,9,10,31,1,7,6,5,2,5,1,0,0,2,1,2,0,0,0,3,1,3,1,0,0,135,68,67,16,7,9,23,20,44,47,3,-2,13,8,24,26,1,-3,10,12,20,21,2,1,6,2,2,5,0,1,3,1,1,2,0,0,3,1,1,3,0,1,198,114,84,15,8,7,42,18,78,27,20,9,33,5,37,20,12,6,9,13,41,7,8,3,-1,3,7,4,0,2,0,2,2,3,0,1,-1,1,5,1,0,1,103,58,45,24,12,12,27,5,35,10,22,4,16,6,12,11,12,0,11,-1,23,-1,10,4,7,7,3,3,3,0,4,3,2,2,1,0,3,4,1,1,2,0,319,170,149,35,22,13,64,18,145,48,33,4,37,6,79,30,16,0,27,12,66,18,17,4,6,7,10,10,0,1,3,5,7,6,0,0,3,2,3,4,0,1,450,243,207,15,6,9,65,40,221,72,36,11,35,19,119,46,19,6,30,21,102,26,17,5,3,4,6,2,0,0,1,1,2,2,0,0,2,3,4,0,0,0,297,142,155,23,11,12,60,21,115,64,20,11,30,7,49,39,13,2,30,14,66,25,7,9,5,1,8,5,1,2,3,1,4,1,0,1,2,0,4,4,1,1,257,132,125,28,13,15,50,18,95,41,27,14,19,4,51,31,14,7,31,14,44,10,13,7,3,8,9,3,4,1,1,3,4,1,4,0,2,5,5,2,0,1,146,76,70,20,10,10,34,14,46,16,20,11,26,7,17,9,10,3,8,7,29,7,10,8,4,7,5,3,0,0,2,4,3,1,0,0,2,3,2,2,0,0,98,46,52,6,0,6,6,32,19,21,10,8,-1,19,15,8,3,1,7,13,4,13,7,7,5,2,0,-2,1,0,3,0,0,-3,0,0,2,2,0,1,1,0,141,60,81,5,4,1,37,10,50,29,12,-3,17,-3,27,6,8,0,20,13,23,23,4,-3,3,-1,6,-2,-1,0,2,1,4,-2,-1,0,1,-2,2,0,0,0,41,15,26,1,0,1,25,-22,20,8,14,-3,9,-9,7,-2,11,-3,16,-13,13,10,3,0,3,-1,-1,0,0,0,1,-1,0,0,0,0,2,0,-1,0,0,0,58,42,16,-4,-3,-1,1,12,31,2,-1,10,1,14,23,1,-4,3,0,-2,8,1,3,7,-1,3,-6,-1,1,-1,-1,1,-1,-1,-2,0,0,2,-5,0,3,-1,82,39,43,-9,-7,-2,19,7,29,20,10,-2,13,3,15,14,3,-5,6,4,14,6,7,3,-1,0,-4,-2,0,-2,0,0,-4,0,-1,-2,-1,0,0,-2,1,0,-4,-5,1,-5,-1,-4,2,-5,31,-14,-14,-3,-2,-3,13,-3,-8,0,4,-2,18,-11,-6,-3,0,-1,4,-2,-6,0,2,-2,2,0,-3,0,-2,1,2,-2,-3,0,-28,-25,-3,-4,-3,-1,-1,-15,15,-13,-9,-1,-11,-11,4,-3,1,-2,10,-4,11,-10,-10,1,3,2,-2,-6,0,-1,-1,-1,0,-1,1,-1,4,3,-2,-5,-1,0,57,17,40,18,10,8,20,-3,34,-2,0,7,6,-4,14,-1,2,0,14,1,20,-1,-2,7,4,4,3,3,2,2,0,3,2,3,1,2,4,1,1,0,1,0,26,18,8,-6,-1,-5,-7,12,24,-12,8,-4,3,2,11,0,-1,-1,-10,10,13,-12,9,-3,3,0,2,-4,-3,-5,2,-1,4,-2,-3,-1,1,1,-2,-2,0,-4
8,08307,Vilanova i la Geltrú,51409,407,224,183,56,26,30,30,-23,158,94,105,40,7,8,70,52,62,24,23,-31,88,42,43,16,6,8,17,9,11,5,1,5,7,5,7,1,5,3,10,4,4,4,611,285,326,34,17,17,144,13,208,97,86,57,86,-7,82,51,38,28,58,20,126,46,48,29,12,3,7,6,4,2,6,2,5,3,1,0,6,1,2,3,3,2,632,329,303,1,-2,3,76,3,309,120,76,51,48,-9,152,70,41,25,28,12,157,50,35,26,24,-18,-11,0,1,1,8,-6,-5,0,0,0,16,-12,-6,0,1,1,730,324,406,23,16,7,148,1,276,153,110,40,52,-7,149,60,48,23,96,8,127,93,62,17,19,-2,0,-3,2,3,12,1,-1,-1,1,4,7,-3,1,-2,1,-1,1543,760,783,1117,615,502,299,299,418,320,121,72,119,156,214,176,67,23,180,143,204,144,54,49,201,272,322,182,78,42,103,143,203,103,38,16,98,129,119,79,40,26,1120,562,558,1060,554,506,151,233,337,238,111,32,79,121,157,146,44,6,72,112,180,92,67,26,196,284,311,163,66,27,103,133,176,96,32,6,93,151,135,67,34,21,1420,648,772,1364,733,631,226,321,446,246,86,81,96,157,190,128,40,29,130,164,256,118,46,52,229,358,436,225,79,26,111,200,236,127,39,12,118,158,200,98,40,14,1163,615,548,950,510,440,182,195,369,234,127,54,84,114,202,129,50,39,98,81,167,105,77,15,174,260,266,169,68,6,89,146,143,88,31,9,85,114,123,81,37,-3,733,301,432,590,245,345,113,198,246,71,70,33,62,91,135,-9,15,11,51,107,111,80,55,22,123,207,153,54,34,5,51,88,83,10,10,0,72,119,70,44,24,5,522,247,275,218,83,135,102,150,185,46,38,-13,61,68,80,18,16,-9,41,82,105,28,22,-4,60,91,65,3,-5,-2,30,39,13,-3,-4,4,30,52,52,6,-1,-6,169,44,125,29,3,26,0,84,51,9,18,-15,-2,38,3,-4,3,-4,2,46,48,13,15,-11,11,70,-19,-17,-7,-19,10,35,-29,-10,-2,-4,1,35,10,-7,-5,-15,-220,-255,35,15,-57,72,22,-48,-172,-73,11,32,-4,-39,-148,-55,-26,16,26,-9,-24,-18,37,16,35,39,-33,-27,-15,5,6,11,-37,-16,-24,1,29,28,4,-11,9,4,-196,-171,-25,-318,-252,-66,3,-32,-62,-110,-40,34,11,-31,-68,-77,-30,18,-8,-1,6,-33,-10,16,-32,-1,-85,-146,-44,-13,-15,-15,-78,-111,-30,-4,-17,14,-7,-35,-14,-9,-218,-152,-66,-428,-239,-189,-51,-5,-76,-76,-41,15,-21,-12,-36,-72,-27,3,-30,7,-40,-4,-14,12,-73,-21,-91,-158,-69,-24,-34,-6,-44,-107,-45,-7,-39,-15,-47,-51,-24,-17,15,-66,81,-133,-65,-68,22,38,-12,-93,35,30,18,17,-16,-87,2,9,4,21,4,-6,33,21,-27,22,-18,-76,-30,-6,4,12,-11,-48,-21,-4,-31,10,-7,-28,-9,-2,636,355,281,201,106,95,142,88,136,147,71,17,89,46,65,99,30,7,53,42,71,48,41,10,34,49,72,29,21,-14,17,24,42,18,7,-8,17,25,30,11,14,-6,210,36,174,92,38,54,63,51,87,-61,18,48,8,28,39,-53,3,13,55,23,48,-8,15,35,20,68,40,-50,-4,13,7,37,42,-36,-13,1,13,31,-2,-14,9,12,421,200,221,300,146,154,104,37,140,107,-10,34,39,19,67,59,-15,24,65,18,73,48,5,10,69,64,92,59,3,-3,24,34,53,22,0,3,45,30,39,37,3,-6
8,08214,Vilassar de Dalt,7417,-4,2,-6,10,4,6,4,-14,12,-4,-15,9,6,-3,-3,3,-3,0,-2,-11,15,-7,-12,9,2,0,1,4,1,0,1,0,0,2,0,0,1,0,1,2,1,0,203,113,90,5,1,4,41,11,63,60,22,6,17,7,44,34,11,1,24,4,19,26,11,5,3,1,0,1,0,0,0,1,0,0,0,0,3,0,0,1,0,0,75,27,48,35,18,17,33,-10,54,-10,3,1,14,-5,31,-9,0,-4,19,-5,23,-1,3,5,10,10,9,4,2,0,5,6,6,1,0,0,5,4,3,3,2,0,91,53,38,41,20,21,32,2,34,28,7,-13,16,3,16,20,4,-7,16,-1,18,8,3,-6,6,7,10,11,5,1,2,6,4,5,3,0,4,1,6,6,2,1,43,4,39,42,16,26,5,1,21,17,-14,12,-5,-3,14,3,-10,4,10,4,7,14,-4,8,4,7,14,11,4,2,1,3,5,4,2,1,3,4,9,7,2,1,34,14,20,27,15,12,22,3,4,12,-9,-3,7,4,-4,5,0,-2,15,-1,8,7,-9,-1,2,7,10,4,3,1,2,4,4,3,2,0,0,3,6,1,1,1,126,59,67,60,25,35,32,7,33,37,4,11,11,6,20,13,3,6,21,1,13,24,1,5,10,4,23,17,5,0,4,5,7,7,2,0,6,-1,16,10,3,0,95,46,49,61,30,31,18,-2,17,33,10,5,16,3,5,11,4,2,2,-5,12,22,6,3,8,13,24,8,5,2,6,5,11,5,2,1,2,8,13,3,3,1,42,-9,51,15,-1,16,9,4,16,-19,-3,30,-4,-7,0,-3,-4,9,13,11,16,-16,1,21,4,12,-5,4,0,-2,3,1,-4,0,-1,0,1,11,-1,4,1,-2,39,21,18,25,10,15,16,7,6,13,3,-8,22,5,-1,7,0,-10,-6,2,7,6,3,2,5,6,11,3,0,0,4,3,3,2,-1,0,1,3,8,1,1,0,36,13,23,-2,-2,0,9,8,-8,19,6,3,9,-1,-1,12,-3,-4,0,9,-7,7,9,7,8,-4,-3,-1,-3,1,5,-1,-5,2,-2,-1,3,-3,2,-3,-1,2,61,40,21,-14,-13,-1,18,6,13,17,1,5,21,0,6,5,2,3,-3,6,7,12,-1,2,-3,0,-6,-1,-2,-3,-2,-3,-4,1,-3,-2,-1,3,-2,-2,1,-1,26,9,17,-15,-3,-12,19,2,27,-14,-16,7,12,-1,0,3,-9,2,7,3,27,-17,-7,5,1,1,-6,-8,-2,-1,1,1,0,-3,-1,-1,0,0,-6,-5,-1,0,-2,2,-4,6,1,5,2,6,-3,15,-12,-12,0,2,-2,10,-4,-6,2,4,-1,5,-8,-6,-3,6,-4,6,-1,0,-2,4,-4,1,0,1,-1,2,0,5,-1,-1,87,27,60,3,0,3,39,3,33,13,-9,6,22,1,8,-7,1,-1,17,2,25,20,-10,7,2,3,1,-5,2,-1,1,-1,-1,-3,2,1,1,4,2,-2,0,-2,20,9,11,28,16,12,7,5,6,23,-17,-7,4,4,-3,18,-4,-12,3,1,9,5,-13,5,4,7,4,11,1,1,2,7,4,4,-1,0,2,0,0,7,2,1,80,51,29,8,2,6,37,6,19,17,-1,5,16,11,5,18,2,2,21,-5,14,-1,-3,3,6,5,7,-4,-4,-2,2,2,-2,3,-2,-1,4,3,9,-7,-2,-1,53,14,39,47,25,22,28,-4,35,3,1,-9,13,-4,20,-4,-1,-9,15,0,15,7,2,0,10,7,11,9,9,1,5,4,5,4,6,1,5,3,6,5,3,0
8,08219,Vilassar de Mar,16572,204,85,119,165,79,86,12,-10,118,10,18,52,0,-2,51,11,5,14,12,-8,67,-1,13,38,32,34,53,28,13,3,15,17,28,11,7,0,17,17,25,17,6,3,226,118,108,189,97,92,25,35,100,-6,29,33,20,10,61,2,14,6,5,25,39,-8,15,27,35,43,67,34,5,3,21,24,32,13,5,1,14,19,35,21,0,2,168,37,131,114,59,55,-4,8,107,3,-6,47,1,-2,46,-11,-13,11,-5,10,61,14,7,36,20,24,27,21,14,4,12,12,14,10,8,0,8,12,13,11,6,4,108,46,62,158,75,83,32,2,16,20,0,36,30,0,4,1,-1,6,2,2,12,19,1,30,47,31,31,29,10,7,25,14,15,14,2,3,22,17,16,15,8,4,76,30,46,249,116,133,-25,23,47,-23,1,54,-6,12,28,-17,-3,14,-19,11,19,-6,4,40,37,55,84,38,20,10,19,19,39,19,10,7,18,36,45,19,10,3,-23,-27,4,164,75,89,12,-22,-3,-47,-21,53,13,-11,-10,-20,-22,18,-1,-11,7,-27,1,35,38,28,51,24,12,10,19,13,23,13,5,2,19,15,28,11,7,8,41,-30,71,105,41,64,-16,1,7,9,-16,48,-12,16,-17,-7,-25,15,-4,-15,24,16,9,33,26,32,14,23,4,6,10,17,7,9,-4,2,16,15,7,14,8,4,-41,-60,19,135,50,85,2,-9,-25,-35,-4,22,0,-15,-42,-22,3,5,2,6,17,-13,-7,17,27,37,28,20,16,1,16,11,0,7,10,2,11,26,28,13,6,-1,291,120,171,49,16,33,39,68,120,51,-13,5,16,36,45,28,-5,-6,23,32,75,23,-8,11,-5,26,30,3,-5,-6,-8,9,9,5,-2,-1,3,17,21,-2,-3,-5,91,-22,113,-6,-33,27,6,19,51,18,-34,29,-14,-9,22,-2,-26,7,20,28,29,20,-8,22,12,21,-16,-7,-19,2,2,0,-14,-11,-12,1,10,21,-2,4,-7,1,115,75,40,39,26,13,11,-15,73,15,14,11,0,2,46,19,5,-1,11,-17,27,-4,9,12,10,-1,17,9,5,-1,6,0,10,9,5,-3,4,-1,7,0,0,2,76,24,52,10,1,9,23,-15,3,39,-11,34,12,-10,2,15,-11,15,11,-5,1,24,0,19,16,8,-3,-9,-4,-2,11,0,5,-10,-7,1,5,8,-8,1,3,-3,123,62,61,-37,-20,-17,34,-2,43,8,15,11,12,10,22,9,8,-3,22,-12,21,-1,7,14,-1,-8,-3,-30,0,-1,-2,-4,-1,-12,0,-2,1,-4,-2,-18,0,1,114,31,83,-15,-9,-6,41,31,23,-16,9,19,12,8,15,-23,6,11,29,23,8,7,3,8,0,18,-15,-23,3,2,1,7,-13,-10,1,4,-1,11,-2,-13,2,-2,232,79,153,9,3,6,69,11,38,68,-3,42,24,10,-5,28,6,12,45,1,43,40,-9,30,11,-1,-11,6,-4,9,7,1,-8,-1,1,3,4,-2,-3,7,-5,6,197,76,121,-3,-6,3,35,7,34,43,31,35,18,-2,4,24,15,15,17,9,30,19,16,20,4,10,-4,-13,-5,1,2,3,-3,-5,-4,1,2,7,-1,-8,-1,0,1,-9,10,7,1,6,1,-12,-13,-7,-12,33,5,-6,-12,0,-19,17,-4,-6,-1,-7,7,16,-3,12,6,-2,-3,-4,2,5,1,-1,-3,-4,-5,7,5,-1,0,0,185,108,77,122,65,57,40,28,54,54,-18,16,32,27,22,24,-2,0,8,1,32,30,-16,16,35,34,31,14,0,6,21,22,8,10,-1,3,14,12,23,4,1,3
9,09907,Alfoz de Quintanadueñas,635,117,66,51,4,3,1,24,14,41,28,6,0,13,7,23,16,4,0,11,7,18,12,2,0,0,1,2,1,0,0,0,1,2,0,0,0,0,0,0,1,0,0,261,134,127,17,11,6,46,36,111,50,13,2,29,16,57,22,7,0,17,20,54,28,6,2,3,6,5,2,1,0,3,3,3,1,1,0,0,3,2,1,0,0,136,76,60,21,10,11,28,19,53,21,12,-2,15,14,26,13,6,-2,13,5,27,8,6,0,6,8,4,2,1,0,1,8,1,0,0,0,5,0,3,2,1,0,70,43,27,13,7,6,3,13,27,17,5,3,-1,5,23,11,4,1,4,8,4,6,1,2,1,3,5,2,1,0,1,2,1,2,1,0,0,1,4,0,0,0,88,53,35,17,9,8,15,13,30,15,13,1,9,7,20,7,10,0,6,6,10,8,3,1,1,4,5,3,3,1,1,2,3,1,2,0,0,2,2,2,1,1,64,35,29,13,4,9,8,6,36,8,7,1,3,2,19,6,5,0,5,4,17,2,2,1,3,3,5,1,1,0,0,1,2,0,1,0,3,2,3,1,0,0,119,52,67,11,6,5,13,21,55,17,10,3,7,11,25,5,4,2,6,10,30,12,6,1,2,1,6,2,0,0,1,1,4,0,0,0,1,0,2,2,0,0,75,44,31,32,20,12,6,14,49,3,-4,5,1,9,27,7,-2,1,5,5,22,-4,-2,4,6,9,9,7,0,0,3,5,7,4,0,0,3,4,2,3,0,0,34,17,17,9,3,6,-10,9,20,7,-1,6,-5,4,12,4,-2,3,-5,5,8,3,1,3,1,2,1,4,0,1,1,1,-1,2,0,0,0,1,2,2,0,1,75,48,27,16,10,6,15,9,32,16,1,0,8,3,23,10,4,-1,7,6,9,6,-3,1,1,3,7,2,0,3,1,2,6,0,0,1,0,1,1,2,0,2,22,10,12,-1,-1,0,-4,6,20,-7,3,4,-2,4,5,-1,1,2,-2,2,15,-6,2,2,1,2,-3,-1,0,0,1,1,-2,-1,0,0,0,1,-1,0,0,0,26,17,9,2,0,2,-6,2,38,-11,8,-5,1,-3,26,-5,1,-3,-7,5,12,-6,7,-2,-1,1,1,1,0,0,0,-1,1,0,0,0,-1,2,0,1,0,0,-9,-4,-5,0,0,0,-19,-1,16,-1,3,-6,-15,-2,13,2,-1,-1,-4,1,3,-3,4,-5,0,-1,1,1,0,-1,0,-1,1,0,0,0,0,0,0,1,0,-1,-17,-2,-15,-3,-1,-2,0,-10,3,-5,-7,2,2,-4,3,-3,-2,1,-2,-6,0,-2,-5,1,0,-1,0,-1,-1,0,0,0,0,-1,0,0,0,-1,0,0,-1,0,20,9,11,-5,-4,-1,3,5,11,0,-1,1,4,3,1,-1,2,-1,-1,2,10,1,-3,2,-2,-2,1,-3,1,0,-1,-1,0,-2,0,0,-1,-1,1,-1,1,0,-35,-22,-13,-2,-6,4,-4,-2,-5,-9,-9,-6,-1,0,-6,-6,-4,-5,-3,-2,1,-3,-5,-1,5,1,-1,-3,-5,0,2,1,-2,-4,-4,0,3,0,1,1,-1,0,24,11,13,4,2,2,8,-1,14,1,5,-3,5,-1,8,-3,4,-1,3,0,6,4,1,-2,-1,0,3,1,1,0,0,0,1,0,1,0,-1,0,2,1,0,0,0,-11,11,2,1,1,-2,-1,9,-8,-3,2,-6,-1,3,-4,-5,0,4,0,6,-4,2,2,0,-1,0,1,1,0,0,-1,1,1,0,0,0,0,-1,0,1,0
9,09018,Aranda de Duero,29695,142,75,67,266,139,127,13,28,88,18,-9,8,-3,16,53,19,-11,5,16,12,35,-1,2,3,30,65,109,45,13,4,14,28,66,23,5,3,16,37,43,22,8,1,267,163,104,358,187,171,48,40,117,45,-8,24,28,18,60,44,-9,19,20,22,57,1,1,5,67,82,133,61,11,1,37,36,73,34,4,1,30,46,60,27,7,0,71,39,32,247,134,113,39,35,4,15,-12,-2,22,31,1,-3,-8,0,17,4,3,18,-4,-2,58,61,66,48,11,3,34,37,32,24,5,2,24,24,34,24,6,1,242,140,102,271,151,120,84,50,80,32,-30,26,45,30,47,25,-19,14,39,20,33,7,-11,12,82,72,67,37,8,4,43,35,44,24,3,2,39,37,23,13,5,2,255,134,121,317,171,146,28,80,105,30,-17,30,21,44,54,20,-16,14,7,36,51,10,-1,16,47,89,116,57,4,5,21,52,67,30,-1,2,26,37,49,27,5,3,261,117,144,288,145,143,55,50,87,25,-3,48,22,38,33,7,-7,22,33,12,54,18,4,26,55,83,94,33,13,6,23,45,53,14,6,1,32,38,41,19,7,5,470,274,196,443,231,212,133,123,71,117,6,21,73,69,47,73,1,12,60,54,24,44,5,9,98,126,129,64,22,-2,49,75,68,32,7,-1,49,51,61,32,15,-1,522,274,248,662,354,308,124,109,83,132,28,48,60,57,37,85,23,16,64,52,46,47,5,32,118,200,176,132,27,6,54,103,90,82,20,2,64,97,86,50,7,4,384,196,188,292,128,164,83,97,68,53,35,42,59,46,34,13,19,18,24,51,34,40,16,24,66,91,76,38,16,0,36,41,34,7,8,0,30,50,42,31,8,0,162,6,156,151,50,101,-15,61,24,-8,11,87,-17,-1,-11,-5,8,28,2,62,35,-3,3,59,34,49,36,18,1,8,13,18,8,5,1,2,21,31,28,13,0,6,-8,-46,38,60,5,55,13,23,-32,8,-18,4,5,16,-35,-6,-17,-7,8,7,3,14,-1,11,25,36,7,-9,5,-6,4,18,0,-14,0,-3,21,18,7,5,5,-3,176,25,151,72,-10,82,78,24,47,13,-11,29,23,1,-2,3,-14,14,55,23,49,10,3,15,30,25,9,4,0,2,9,-2,-6,-5,-6,0,21,27,15,9,6,2,-157,-146,-11,-109,-98,-11,5,16,-79,-69,-40,16,20,7,-79,-67,-25,1,-15,9,0,-2,-15,15,-1,5,-49,-47,-17,-2,8,-3,-46,-43,-12,-4,-9,8,-3,-4,-5,2,-254,-209,-45,-205,-155,-50,10,-40,-106,-81,-48,10,-8,-32,-85,-59,-29,1,18,-8,-21,-22,-19,9,-17,-12,-78,-61,-40,2,-8,-11,-57,-50,-31,2,-9,-1,-21,-11,-9,0,4,-38,42,-33,-34,1,18,14,-52,2,6,19,22,-3,-40,-27,-1,14,-4,17,-12,29,7,5,-5,27,-34,-13,-4,-7,-6,14,-22,-16,0,-4,1,13,-12,3,-4,-3,-11,-18,7,59,21,38,2,-17,-33,-16,15,38,7,-10,-10,-18,-7,20,-5,-7,-23,2,22,18,17,21,9,-10,11,5,6,5,9,-7,0,4,11,16,0,-3,11,1,79,12,67,102,18,84,20,29,-4,-6,33,7,5,1,-10,-4,18,3,15,28,6,-2,15,4,23,55,23,-3,2,0,12,15,4,-11,-3,0,11,40,19,8,5,0,193,53,140,257,93,164,59,15,17,43,12,44,20,14,-7,1,9,14,39,1,24,42,3,30,54,72,76,27,14,11,22,33,29,0,7,1,32,39,47,27,7,10
9,09048,Belorado,2094,9,6,3,14,6,8,6,-5,9,-11,6,4,2,-3,7,-5,3,2,4,-2,2,-6,3,2,5,1,7,1,0,0,3,1,2,0,0,0,2,0,5,1,0,0,12,-3,15,25,4,21,-5,12,5,-10,4,4,-4,3,-2,-7,2,3,-1,9,7,-3,2,1,1,12,11,1,0,0,0,1,3,0,0,0,1,11,8,1,0,0,91,48,43,80,41,39,18,29,22,8,10,0,10,15,11,3,8,1,8,14,11,5,2,-1,13,23,27,12,4,1,7,10,16,6,2,0,6,13,11,6,2,1,5,13,-8,49,23,26,-6,-3,6,5,6,-4,-4,7,3,5,4,-2,-2,-10,3,0,2,-2,7,15,16,8,3,0,3,10,7,3,0,0,4,5,9,5,3,0,41,11,30,44,21,23,13,10,2,8,2,4,10,-2,-2,0,1,4,3,12,4,8,1,0,8,10,17,9,0,0,4,4,9,4,0,0,4,6,8,5,0,0,25,24,1,53,29,24,-6,25,-2,1,4,3,-4,20,6,-1,1,2,-2,5,-8,2,3,1,6,25,13,5,3,1,3,14,10,2,0,0,3,11,3,3,3,1,58,32,26,66,34,32,9,18,15,7,9,1,3,6,4,13,3,4,6,12,11,-6,6,-3,12,18,20,14,2,0,6,8,10,9,1,0,6,10,10,5,1,0,55,30,25,75,44,31,10,7,14,15,7,1,8,9,6,5,3,-1,2,-2,8,10,4,2,11,25,19,19,2,-1,7,15,12,10,1,-1,4,10,7,9,1,0,7,14,-7,19,12,7,4,12,-2,-2,-4,-2,2,8,5,1,-2,0,2,4,-7,-3,-2,-2,3,5,9,3,-2,0,2,3,6,2,-1,0,1,2,3,1,-1,0,2,2,0,8,3,5,-3,4,-2,10,4,-9,-2,-2,4,4,2,-4,-1,6,-6,6,2,-5,2,2,0,4,0,0,2,-1,0,2,0,0,0,3,0,2,0,0,19,12,7,14,6,8,14,-1,0,6,5,-7,8,2,0,-1,3,-2,6,-3,0,7,2,-5,8,2,2,3,-1,0,4,2,0,1,-1,0,4,0,2,2,0,0,-35,-17,-18,5,3,2,-11,0,-5,-13,-5,-1,-4,0,-3,-6,-4,-1,-7,0,-2,-7,-1,0,0,2,1,-1,2,0,0,-1,0,1,2,0,0,3,1,-2,0,0,-8,3,-11,-2,1,-3,-1,-5,5,-5,2,-3,-2,0,3,1,3,-2,1,-5,2,-6,-1,-1,-3,0,-2,0,3,0,0,1,0,-1,1,0,-3,-1,-2,1,2,0,-2,-3,1,1,-2,3,-3,6,-6,6,2,-7,-2,3,-2,-1,0,-1,-1,3,-4,7,2,-6,-2,2,1,1,-2,1,-1,0,1,-2,0,0,-1,2,0,3,-2,1,-29,-24,-5,-18,-14,-4,5,-7,-18,-8,3,-3,0,-1,-10,-8,-1,-3,5,-6,-8,0,4,0,6,-1,-11,-10,-2,0,2,0,-6,-7,-3,0,4,-1,-5,-3,1,0,-51,-30,-21,-18,-13,-5,1,-1,-23,-6,-10,-12,-1,0,-10,-4,-9,-6,2,-1,-13,-2,-1,-6,0,5,-12,-4,-6,-1,0,3,-7,-3,-5,-1,0,2,-5,-1,-1,0,-32,-27,-5,-6,-6,0,-2,0,-12,-11,-3,-5,0,-1,-10,-11,-4,-1,-2,1,-2,0,1,-4,2,2,-4,-4,-2,0,3,1,-2,-5,-3,0,-1,1,-2,1,1,0,-18,-7,-11,5,3,2,-6,8,-1,-12,1,-7,-6,3,4,-8,3,-3,0,5,-5,-4,-2,-4,-3,11,3,-5,1,-2,-3,5,3,-3,2,-1,0,6,0,-2,-1,-1
9,09056,Briviesca,6128,150,111,39,127,86,41,12,27,86,19,5,1,5,28,64,12,2,0,7,-1,22,7,3,1,13,32,53,28,1,0,8,22,35,20,1,0,5,10,18,8,0,0,47,38,9,30,13,17,-5,3,38,1,1,7,-1,0,20,12,3,2,-4,3,18,-11,-2,5,2,10,12,4,1,1,1,4,6,2,0,0,1,6,6,2,1,1,146,50,96,84,37,47,48,20,47,14,-3,16,17,3,20,3,-4,8,31,17,27,11,1,8,27,24,24,8,1,-1,15,11,9,1,1,-1,12,13,15,7,0,0,181,96,85,102,47,55,40,44,46,25,11,4,19,19,23,15,10,4,21,25,23,10,1,0,25,27,37,11,1,-2,14,5,17,8,2,-1,11,22,20,3,-1,-1,157,72,85,150,85,65,-5,60,80,-4,10,13,-10,35,45,-10,1,6,5,25,35,6,9,7,19,59,44,18,6,2,11,37,23,10,3,1,8,22,21,8,3,1,266,158,108,259,154,105,50,73,76,47,13,-1,27,45,33,39,6,4,23,28,43,8,7,-5,51,79,69,50,6,0,30,43,42,35,2,0,21,36,27,15,4,0,94,55,39,125,60,65,27,43,5,20,-1,3,8,22,9,13,3,0,19,21,-4,7,-4,3,30,45,25,21,1,1,16,19,12,9,2,0,14,26,13,12,-1,1,527,322,205,450,285,165,76,128,183,85,25,24,40,85,118,60,9,7,36,43,65,25,16,17,64,128,149,81,15,7,40,81,99,55,5,3,24,47,50,26,10,4,123,54,69,114,48,66,50,21,28,0,16,2,18,3,16,2,13,1,32,18,12,-2,3,1,33,26,24,17,10,3,13,9,14,5,6,1,20,17,10,12,4,2,-63,-37,-26,12,-2,14,-29,-14,-24,-13,1,10,-15,2,-26,-2,-1,4,-14,-16,2,-11,2,6,1,9,-1,-2,3,-2,4,5,-9,-3,0,0,-3,4,8,1,3,-2,-192,-129,-63,-106,-89,-17,-31,-36,-49,-65,-10,-3,-20,-26,-34,-41,-11,1,-11,-10,-15,-24,1,-4,-14,-13,-38,-32,-7,-3,-13,-11,-33,-24,-7,-1,-1,-2,-5,-8,0,-2,-56,-21,-35,5,-6,11,-30,-7,-18,-14,-2,15,-19,-2,-1,-5,0,6,-11,-5,-17,-9,-2,9,2,9,-5,1,-2,0,-1,6,-3,-6,-1,-1,3,3,-2,7,-1,1,-82,-47,-35,-9,-14,5,-23,-14,-28,-18,-2,7,-13,-13,-11,-11,-5,6,-10,-1,-17,-7,3,1,-5,0,2,-2,-6,2,-7,-6,1,0,-3,1,2,6,1,-2,-3,1,-269,-179,-90,-181,-128,-53,-46,-44,-87,-77,-17,4,-27,-27,-65,-51,-10,3,-19,-17,-22,-26,-7,1,-24,-24,-56,-60,-16,-1,-15,-16,-44,-39,-13,-1,-9,-8,-12,-21,-3,0,-118,-72,-46,-66,-44,-22,-7,-6,-53,-42,-16,7,6,2,-33,-36,-16,5,-13,-8,-20,-6,0,2,-11,4,-28,-26,-11,5,-2,1,-19,-19,-9,3,-9,3,-9,-7,-2,2,-176,-108,-68,-89,-56,-33,-10,-12,-70,-62,-12,-7,-2,-13,-45,-41,-2,-1,-8,1,-25,-21,-10,-6,-3,-1,-49,-29,-3,-3,3,0,-30,-24,-3,-1,-6,-1,-19,-5,0,-2,-58,-52,-6,-20,-13,-7,-2,-27,-22,-2,-1,-6,-10,-18,-17,-5,-1,-2,8,-9,-5,3,0,-4,-1,-5,-12,3,-3,-2,-5,-3,-7,2,1,-1,4,-2,-5,1,-4,-1,-148,-83,-65,-55,-31,-24,-17,-32,-31,-44,-20,-4,-11,-14,-13,-33,-15,2,-6,-18,-18,-11,-5,-6,-8,-1,-9,-24,-12,-2,-4,0,-2,-16,-10,0,-4,-1,-7,-8,-2,-2
9,09059,Burgos,162802,-182,-109,-73,56,26,30,-40,-56,-7,-3,-76,27,-7,-27,-6,-5,-51,2,-33,-29,-1,2,-25,25,5,5,9,6,11,20,1,4,4,4,4,9,4,1,5,2,7,11,-494,-321,-173,32,15,17,-33,-135,-203,-103,-84,68,-19,-68,-116,-80,-55,20,-14,-67,-87,-23,-29,48,5,2,9,7,5,4,0,0,6,4,3,2,5,2,3,3,2,2,-1105,-635,-470,-112,-49,-63,-98,-243,-500,-60,-161,-9,-87,-107,-284,-34,-93,-7,-11,-136,-216,-26,-68,-2,0,-18,-68,-21,-5,0,0,-5,-32,-12,0,0,0,-13,-36,-9,-5,0,-749,-404,-345,-7,0,-7,-41,-147,-379,-111,-126,71,-19,-47,-238,-76,-70,50,-22,-100,-141,-35,-56,21,3,-4,-8,-1,0,2,0,-1,-3,0,1,2,3,-3,-5,-1,-1,0,1655,895,760,1519,843,676,219,496,406,315,26,210,118,300,258,156,-17,94,101,196,148,159,43,116,187,440,530,273,69,16,86,234,338,157,20,5,101,206,192,116,49,11,1175,473,702,1198,558,640,271,307,234,240,6,128,114,137,106,114,-45,60,157,170,128,126,51,68,254,332,354,199,40,10,111,138,192,103,9,4,143,194,162,96,31,6,1881,927,954,2548,1286,1262,402,581,530,395,-75,47,222,276,299,208,-88,17,180,305,231,187,13,30,467,663,821,471,102,13,242,303,449,238,38,10,225,360,372,233,64,3,3300,1834,1466,3351,1944,1407,478,974,893,713,103,141,218,516,577,408,40,78,260,458,316,305,63,63,466,1054,1070,598,137,15,241,578,671,362,77,13,225,476,399,236,60,2,1683,802,881,2029,1058,971,368,548,257,306,73,133,190,263,136,151,10,58,178,285,121,155,63,75,356,684,578,304,77,15,215,321,308,168,28,10,141,363,270,136,49,5,-101,-310,209,538,174,364,184,24,-260,-55,-49,64,88,-8,-255,-63,-69,6,96,32,-5,8,20,58,185,223,102,14,-2,-1,92,88,6,-7,-14,1,93,135,96,21,12,-2,-1439,-1038,-401,-713,-557,-156,70,-265,-814,-316,-180,81,31,-157,-535,-269,-132,34,39,-108,-279,-47,-48,47,25,-80,-384,-211,-55,-20,1,-77,-270,-175,-34,-6,24,-3,-114,-36,-21,-14,509,113,396,583,215,368,268,21,-1,97,-16,137,147,12,-41,9,-35,28,121,9,40,88,19,109,170,166,136,53,35,17,91,66,43,-1,18,-2,79,100,93,54,17,19,-656,-535,-121,-416,-326,-90,97,-58,-384,-232,-113,25,57,-37,-269,-212,-102,21,40,-21,-115,-20,-11,4,15,46,-228,-185,-79,5,11,17,-147,-153,-64,4,4,29,-81,-32,-15,1,-1043,-753,-290,-793,-539,-254,-13,-101,-491,-350,-156,47,-1,-70,-323,-270,-116,8,-12,-31,-168,-80,-40,39,-41,-11,-328,-295,-119,-15,-16,-19,-217,-199,-90,-7,-25,8,-111,-96,-29,-8,-686,-505,-181,-277,-205,-72,63,-49,-398,-146,-135,-34,39,-30,-249,-135,-97,-30,24,-19,-149,-11,-38,-4,16,58,-206,-128,-44,13,18,33,-125,-108,-31,3,-2,25,-81,-20,-13,10,-329,-329,0,-63,-104,41,30,26,-393,-89,64,26,-5,-9,-207,-121,5,7,35,35,-186,32,59,19,-5,110,-107,-90,5,12,-16,48,-48,-87,-6,0,11,62,-59,-3,11,12,-570,-411,-159,-211,-147,-64,101,-116,-309,-250,-92,80,70,-46,-234,-179,-51,28,31,-70,-75,-71,-41,52,85,47,-112,-187,-65,10,51,39,-82,-130,-35,4,34,8,-30,-57,-30,6,580,241,339,589,273,316,256,150,-38,151,28,25,133,70,-30,79,-22,4,123,80,-8,72,50,21,151,246,93,66,19,2,71,118,54,28,0,-2,80,128,39,38,19,4
9,09174,Huerta de Rey,1175,27,17,10,44,26,18,-6,13,2,23,1,-6,-5,7,1,15,1,-2,-1,6,1,8,0,-4,0,13,7,24,0,0,0,7,3,16,0,0,0,6,4,8,0,0,17,7,10,29,17,12,0,10,0,0,5,2,-3,3,4,-1,3,1,3,7,-4,1,2,1,3,8,10,6,1,1,1,3,8,4,1,0,2,5,2,2,0,1,-2,-1,-1,9,5,4,-3,5,-1,-7,3,2,1,2,-3,-5,3,2,-4,3,2,-2,0,0,2,4,3,0,0,0,1,2,2,0,0,0,1,2,1,0,0,0,22,11,11,19,11,8,3,8,5,6,2,-1,0,5,1,4,2,0,3,3,4,2,0,-1,2,4,5,7,1,0,1,3,3,4,0,0,1,1,2,3,1,0,5,9,-4,25,17,8,2,4,0,4,2,-7,2,5,2,3,0,-3,0,-1,-2,1,2,-4,4,6,4,9,2,0,4,5,3,4,1,0,0,1,1,5,1,0,-3,-2,-1,17,4,13,3,-1,-8,4,0,-1,1,-2,-7,4,1,1,2,1,-1,0,-1,-2,5,3,5,4,0,0,2,0,1,1,0,0,3,3,4,3,0,0,-4,-1,-3,7,4,3,0,2,3,-7,-1,-1,1,0,3,-5,1,0,-1,2,0,-2,-2,-1,1,3,1,3,-1,0,1,1,0,1,1,0,0,2,1,2,-2,0,-1,9,-10,24,13,11,-1,-7,0,4,5,0,0,2,2,3,2,1,-1,-9,-2,1,3,-1,5,6,5,5,3,-1,4,4,2,1,1,0,1,2,3,4,2,-1,-14,-5,-9,2,3,-1,2,-7,-1,5,-1,-12,1,-3,-2,6,-1,-6,1,-4,1,-1,0,-6,0,1,0,1,0,0,0,1,0,2,0,0,0,0,0,-1,0,0,-10,-2,-8,-3,-1,-2,-1,-7,-8,-2,3,5,0,-2,-7,1,2,4,-1,-5,-1,-3,1,1,0,0,0,-3,0,0,0,0,0,-1,0,0,0,0,0,-2,0,0,-7,1,-8,0,-1,1,-2,-1,-5,3,2,-4,1,0,-4,3,1,0,-3,-1,-1,0,1,-4,0,0,-1,1,0,0,0,0,-1,0,0,0,0,0,0,1,0,0,5,5,0,1,2,-1,3,1,-2,4,1,-1,2,1,1,0,2,0,1,0,-3,4,-1,-1,0,1,1,1,-2,0,0,1,1,0,0,0,0,0,0,1,-2,0,-10,-8,-2,-2,-3,1,-3,-2,3,-7,0,-1,-3,-1,-1,-5,3,-1,0,-1,4,-2,-3,0,-2,0,0,0,0,0,-2,0,0,-1,0,0,0,0,0,1,0,0,6,5,1,1,2,-1,-1,4,0,2,1,0,0,5,2,0,-3,1,-1,-1,-2,2,4,-1,0,2,0,-1,0,0,0,2,0,0,0,0,0,0,0,-1,0,0,1,3,-2,-2,-2,0,-2,3,6,-6,1,-2,0,0,3,-1,2,-1,-2,3,3,-5,-1,-1,-2,0,0,0,0,0,-2,0,0,0,0,0,0,0,0,0,0,0,-26,-6,-20,3,2,1,-3,-6,-6,-2,-1,-7,-1,-3,1,-1,0,-2,-2,-3,-7,-1,-1,-5,0,1,0,1,1,0,0,1,0,1,0,0,0,0,0,0,1,0,10,4,6,4,2,2,3,2,-1,2,4,0,0,1,0,1,2,0,3,1,-1,1,2,0,2,0,0,1,0,1,1,0,0,1,0,0,1,0,0,0,0,1,13,13,0,9,5,4,4,1,4,2,3,-1,2,1,4,2,4,0,2,0,0,0,-1,-1,3,2,2,1,1,0,1,1,2,0,1,0,2,1,0,1,0,0
9,09194,Lerma,2527,-40,-26,-14,4,1,3,-16,-7,-11,-10,4,0,-8,-5,-10,-4,2,-1,-8,-2,-1,-6,2,1,0,0,1,1,2,0,0,0,0,0,1,0,0,0,1,1,1,0,13,-1,14,3,2,1,0,6,-2,2,4,3,-4,-4,1,1,2,3,4,10,-3,1,2,0,0,0,3,0,0,0,0,0,2,0,0,0,0,0,1,0,0,0,15,9,6,18,11,7,-4,10,7,3,-1,0,1,1,6,4,-2,-1,-5,9,1,-1,1,1,5,2,8,3,0,0,4,1,5,1,0,0,1,1,3,2,0,0,38,18,20,8,3,5,0,17,14,-1,8,0,0,8,5,-1,6,0,0,9,9,0,2,0,0,2,2,4,0,0,0,1,1,1,0,0,0,1,1,3,0,0,65,27,38,20,9,11,18,22,13,17,-5,-1,10,4,6,10,-3,-1,8,18,7,7,-2,0,1,8,8,4,0,0,1,2,4,3,0,0,0,6,4,1,0,0,37,16,21,25,14,11,13,-9,13,7,5,8,11,-4,7,3,-2,0,2,-5,6,4,7,8,3,6,7,4,4,1,4,2,3,2,3,0,-1,4,4,2,1,1,5,13,-8,11,8,3,5,2,-2,3,3,-6,8,4,3,0,1,-3,-3,-2,-5,3,2,-3,6,5,1,0,-1,0,4,3,1,0,0,0,2,2,0,0,-1,0,76,45,31,69,39,30,4,20,23,25,3,-1,2,9,15,14,2,2,2,11,8,11,1,-3,14,15,16,18,4,0,9,10,9,9,2,0,5,5,7,9,2,0,40,36,4,44,25,19,26,2,1,9,3,0,16,5,7,8,2,-1,10,-3,-6,1,1,1,13,9,15,5,2,0,8,5,7,4,1,0,5,4,8,1,1,0,-14,23,-37,26,11,15,9,8,-9,-6,-1,-14,4,3,15,0,-1,2,5,5,-24,-6,0,-16,5,7,11,3,0,0,2,2,6,1,0,0,3,5,5,2,0,0,10,2,8,5,3,2,-2,10,12,-6,0,-5,1,6,3,-6,0,-2,-3,4,9,0,0,-3,1,1,0,1,1,1,2,0,0,1,0,0,-1,1,0,0,1,1,3,11,-8,24,11,13,1,3,-3,-6,5,2,3,1,0,1,4,2,-2,2,-3,-7,1,0,8,7,-2,5,6,0,5,1,0,3,2,0,3,6,-2,2,4,0,-14,3,-17,-13,-7,-6,-4,-5,-6,-8,9,-1,-1,1,0,-4,6,0,-3,-6,-6,-4,3,-1,1,-5,-2,-7,0,0,-1,-2,1,-5,0,0,2,-3,-3,-2,0,0,-96,-52,-44,-52,-32,-20,-28,-14,-18,-21,-16,1,-15,-8,-10,-7,-13,1,-13,-6,-8,-14,-3,0,-12,-1,-12,-16,-11,0,-7,2,-8,-11,-8,0,-5,-3,-4,-5,-3,0,-36,-33,-3,-17,-14,-3,-14,1,-14,-5,-7,3,-7,-1,-12,-7,-8,1,-7,2,-2,2,1,2,-11,0,1,-4,-3,0,-7,-1,-1,-2,-3,0,-4,1,2,-2,0,0,-36,-17,-19,-8,-4,-4,-8,-4,-14,-9,-3,2,-8,0,-10,-1,1,1,0,-4,-4,-8,-4,1,0,0,-5,-2,-1,0,0,-1,-3,-1,1,0,0,1,-2,-1,-2,0,-20,-9,-11,-15,-10,-5,3,1,-10,-8,-7,-1,2,-3,-4,-3,-4,3,1,4,-6,-5,-3,-4,2,-1,-3,-6,-8,0,-1,-1,-2,-3,-3,0,3,0,-1,-3,-5,0,-17,-11,-6,12,2,10,-7,-3,-7,-10,3,7,-4,-3,-4,-10,5,4,-3,0,-3,0,-2,3,1,5,2,1,3,0,0,0,0,0,2,0,1,5,2,1,1,0
9,09209,Medina de Pomar,5026,-123,-64,-59,15,6,9,-5,-31,-12,-24,-32,-16,-7,-15,-6,-7,-18,-8,2,-16,-6,-17,-14,-8,0,4,8,3,0,0,0,2,2,2,0,0,0,2,6,1,0,0,-19,9,-28,37,32,5,1,-11,19,-13,-10,-6,0,-2,20,-6,-6,2,1,-9,-1,-7,-4,-8,2,11,21,3,0,0,0,11,18,3,0,0,2,0,3,0,0,0,51,22,29,49,23,26,30,12,8,4,4,-7,17,10,1,4,0,-8,13,2,7,0,4,1,16,13,10,10,0,0,7,7,4,5,0,0,9,6,6,5,0,0,32,24,8,29,16,13,-12,-4,10,33,11,-5,-6,-1,6,15,12,-4,-6,-3,4,18,-1,-1,0,5,8,15,1,0,0,4,5,6,1,0,0,1,3,9,0,0,158,81,77,97,56,41,19,25,76,28,7,-1,16,16,41,3,5,0,3,9,35,25,2,-1,15,27,32,16,4,3,11,18,19,5,1,2,4,9,13,11,3,1,110,69,41,97,55,42,6,20,23,45,15,-1,-1,15,16,30,6,1,7,5,7,15,9,-2,17,25,27,22,4,0,8,9,19,16,2,0,9,16,8,6,2,0,241,130,111,88,42,46,58,34,45,57,20,23,25,17,25,36,13,9,33,17,20,21,7,14,21,12,24,23,6,0,7,3,12,12,6,0,14,9,12,11,0,0,423,296,127,297,204,93,66,97,132,91,29,6,33,68,95,67,21,13,33,29,37,24,8,-7,41,73,85,81,15,0,18,47,64,58,14,1,23,26,21,23,1,-1,116,68,48,50,27,23,13,28,40,30,10,-5,6,18,16,15,10,0,7,10,24,15,0,-5,8,18,14,6,2,1,4,12,7,2,1,0,4,6,7,4,1,1,2,-18,20,-17,-26,9,15,17,-19,2,-11,-7,3,2,-11,-4,-11,0,12,15,-8,6,0,-7,1,0,3,-17,-5,0,0,-4,-1,-18,-4,0,1,4,4,1,-1,0,-40,-32,-8,-77,-57,-20,-28,-8,-35,-16,12,32,-14,-7,-27,-7,4,16,-14,-1,-8,-9,8,16,-19,1,-27,-21,-12,0,-7,-2,-26,-11,-12,0,-12,3,-1,-10,0,0,38,11,27,25,-1,26,17,18,-14,11,3,-2,5,15,-13,-2,-2,3,12,3,-1,13,5,-5,10,12,-3,4,2,0,5,4,-8,-1,-1,0,5,8,5,5,3,0,-153,-119,-34,-109,-86,-23,-9,5,-60,-54,-23,-14,-5,-4,-36,-52,-16,-8,-4,9,-24,-2,-7,-6,-4,-3,-34,-44,-18,-6,-1,-4,-23,-37,-16,-5,-3,1,-11,-7,-2,-1,-95,-57,-38,-68,-42,-26,-13,-23,-27,-20,-22,7,-8,-16,-16,-8,-12,2,-5,-7,-11,-12,-10,5,-7,-8,-26,-17,-8,-2,-3,-4,-19,-9,-5,-2,-4,-4,-7,-8,-3,0,69,36,33,10,4,6,29,2,20,32,1,-15,20,-2,9,20,-2,-10,9,4,11,12,3,-5,3,9,0,0,-3,0,1,5,1,-2,-2,0,2,4,-1,2,-1,0,-78,-40,-38,-22,-12,-10,-17,-6,-21,-28,-11,5,-6,-10,-10,-17,1,1,-11,4,-11,-11,-12,4,-7,1,-9,-15,4,4,-2,0,-6,-7,2,1,-5,1,-3,-8,2,3,5,-1,6,0,-3,3,31,4,-13,0,-15,-2,12,4,-4,-3,-8,-2,19,0,-9,3,-7,0,0,1,-4,2,1,0,-3,3,-2,0,0,-1,3,-2,-2,2,1,1,14,16,-2,38,23,15,-10,-11,5,6,13,10,-1,-5,7,6,10,0,-9,-6,-2,0,3,10,6,8,10,7,5,1,5,3,7,3,3,2,1,5,3,4,2,-1
9,09219,Miranda de Ebro,35547,-437,-209,-228,94,50,44,-75,-77,-124,-81,-41,-31,-39,-26,-63,-42,-22,-12,-36,-51,-61,-39,-19,-19,10,32,35,12,4,0,4,18,17,9,2,0,6,14,18,3,2,0,333,179,154,373,184,189,47,116,170,36,-24,-15,13,51,101,31,-11,-8,34,65,69,5,-13,-7,66,114,131,42,13,1,28,60,63,22,7,1,38,54,68,20,6,0,244,152,92,374,204,170,91,111,39,59,-26,-35,46,56,43,39,-15,-19,45,55,-4,20,-11,-16,87,105,103,61,10,2,40,55,64,40,2,1,47,50,39,21,8,1,140,83,57,419,207,212,39,70,66,8,-27,-26,17,37,45,5,-19,-7,22,33,21,3,-8,-19,93,121,111,68,13,4,46,54,56,40,3,1,47,67,55,28,10,3,547,339,208,597,356,241,121,152,194,83,14,-38,60,86,139,61,5,-20,61,66,55,22,9,-18,116,154,181,110,26,3,61,90,112,72,18,1,55,64,69,38,8,2,643,425,218,719,461,258,85,214,219,146,-6,-19,49,117,161,117,-9,-15,36,97,58,29,3,-4,124,194,225,148,17,4,69,118,149,111,8,2,55,76,76,37,9,2,432,321,111,688,409,279,58,146,159,89,-5,-17,35,76,129,80,2,-4,23,70,30,9,-7,-13,109,204,207,133,25,1,53,102,132,101,16,-1,56,102,75,32,9,2,1138,770,368,1083,655,428,178,315,360,230,25,16,124,177,261,164,23,13,54,138,99,66,2,3,190,308,329,194,38,8,107,162,225,124,26,4,83,146,104,70,12,4,-270,-185,-85,-34,-92,58,10,-15,-130,-66,-60,-17,1,12,-100,-39,-45,-19,9,-27,-30,-27,-15,2,44,13,-54,-28,-14,-3,15,-1,-68,-28,-11,-5,29,14,14,0,-3,2,-236,-168,-68,-7,-26,19,-32,0,-88,-58,-64,4,-16,-1,-60,-57,-36,1,-16,1,-28,-1,-28,3,24,32,-43,-17,-6,0,16,17,-28,-27,-6,1,8,15,-15,10,0,-1,-138,-111,-27,9,-22,31,42,-8,-72,-36,-52,-10,16,-8,-47,-25,-39,-2,26,0,-25,-11,-13,-8,30,23,-37,-9,-8,7,11,-1,-28,-4,-4,2,19,24,-9,-5,-4,5,-466,-332,-134,-246,-200,-46,-51,-43,-166,-167,-27,1,-41,-25,-97,-145,-17,3,-10,-18,-69,-22,-10,-2,-13,-17,-91,-110,-20,4,-17,-22,-59,-91,-11,0,4,5,-32,-19,-9,4,-608,-438,-170,-456,-362,-94,-65,-30,-180,-209,-98,-30,-31,-12,-145,-171,-73,-13,-34,-18,-35,-38,-25,-17,-45,-4,-137,-183,-79,-10,-24,-4,-113,-157,-62,-5,-21,0,-24,-26,-17,-5,-776,-467,-309,-461,-305,-156,-133,-126,-206,-192,-86,-34,-65,-63,-133,-139,-62,-8,-68,-63,-73,-53,-24,-26,-73,-46,-148,-136,-51,-8,-42,-24,-95,-103,-40,-3,-31,-22,-53,-33,-11,-5,-331,-165,-166,-110,-80,-30,-37,-53,-66,-96,-58,-22,-4,-30,-37,-46,-36,-11,-33,-23,-29,-50,-22,-11,3,-15,-34,-55,-11,1,1,-14,-18,-34,-13,-2,2,-1,-16,-21,2,3,-163,-70,-93,70,40,30,0,-42,-32,-91,24,-23,-5,-11,-15,-57,18,-4,5,-31,-17,-34,6,-19,28,23,12,-12,5,8,16,8,9,-9,6,6,12,15,3,-3,-1,2,-171,-95,-76,-81,-54,-27,0,3,-82,-54,-14,-36,7,4,-51,-36,-5,-17,-7,-1,-31,-18,-9,-19,-3,22,-49,-48,-11,1,-3,13,-30,-25,-8,-3,0,9,-19,-23,-3,4,-3,9,-12,86,37,49,23,21,-5,4,-27,-24,23,16,7,-7,-17,-15,0,5,-12,11,-10,-9,20,35,23,-3,4,2,16,17,8,-4,-3,0,4,18,15,1,7,2
9,09330,Salas de los Infantes,2063,8,15,-7,35,23,12,-3,1,-4,10,3,1,1,2,1,9,2,0,-4,-1,-5,1,1,1,2,8,10,14,1,0,1,5,6,10,1,0,1,3,4,4,0,0,39,24,15,54,31,23,11,6,7,14,2,-1,6,6,2,7,2,1,5,0,5,7,0,-2,10,15,14,13,1,0,6,7,8,8,1,0,4,8,6,5,0,0,55,41,14,81,49,32,6,23,-2,17,7,2,7,11,5,11,3,3,-1,12,-7,6,4,-1,19,20,14,21,4,1,15,9,8,13,2,1,4,11,6,8,2,0,-20,-3,-17,28,20,8,0,-10,3,-10,-2,-2,-4,-4,10,-4,-1,-1,4,-6,-7,-6,-1,-1,2,5,17,4,0,0,2,3,12,3,0,0,0,2,5,1,0,0,6,4,2,22,12,10,2,-10,11,8,-2,-2,-4,-1,6,5,0,-3,6,-9,5,3,-2,1,3,4,12,3,1,-1,2,3,7,1,0,-1,1,1,5,2,1,0,-10,-5,-5,23,14,9,-4,4,0,-15,1,2,-1,-1,0,-6,1,1,-3,5,0,-9,0,1,5,5,11,1,0,0,3,4,6,1,0,0,2,1,5,0,0,0,56,36,20,43,28,15,19,1,25,7,-1,4,15,2,16,3,-1,1,4,-1,9,4,0,3,8,10,16,6,3,0,7,7,10,2,2,0,1,3,6,4,1,0,61,38,23,64,37,27,14,9,16,16,8,-3,0,3,16,10,8,-1,14,6,0,6,0,-2,10,18,16,12,5,1,3,6,12,10,5,0,7,12,4,2,0,1,32,32,0,33,20,13,5,21,-1,10,4,-8,1,13,4,11,4,-1,4,8,-5,-1,0,-7,6,8,10,9,0,0,3,4,7,6,0,0,3,4,3,3,0,0,32,20,12,20,10,10,13,4,12,1,2,1,13,0,4,2,1,0,0,4,8,-1,1,1,7,6,4,1,1,1,6,3,1,0,0,0,1,3,3,1,1,1,-18,-3,-15,-3,3,-6,-3,4,-10,-8,-2,1,4,1,-7,-2,-2,2,-7,3,-3,-6,0,-1,4,5,-1,-9,-2,0,8,3,0,-6,-2,0,-4,2,-1,-3,0,0,8,14,-6,19,11,8,2,9,-8,4,1,1,-1,12,-5,7,0,1,3,-3,-3,-3,1,0,2,8,3,5,1,0,1,5,2,2,1,0,1,3,1,3,0,0,13,1,12,2,-1,3,6,9,3,-4,-4,4,-1,4,4,-5,-3,2,7,5,-1,1,-1,2,-2,2,-1,1,1,1,-2,0,0,0,1,0,0,2,-1,1,0,1,18,11,7,5,3,2,11,-1,-7,10,3,3,4,3,0,2,2,1,7,-4,-7,8,1,2,2,0,2,0,1,0,1,0,2,-1,1,0,1,0,0,1,0,0,-14,-1,-13,5,6,-1,-3,1,-1,-1,-8,-1,0,0,6,-2,-6,1,-3,1,-7,1,-2,-2,1,3,3,-2,-1,1,1,1,6,-2,-1,1,0,2,-3,0,0,0,-68,-39,-29,-26,-18,-8,-18,-5,-15,-17,-10,-3,-8,0,-12,-11,-7,-1,-10,-5,-3,-6,-3,-2,-6,-3,-1,-12,-2,-2,-4,0,-2,-9,-1,-2,-2,-3,1,-3,-1,0,-3,12,-15,3,2,1,8,1,-8,-1,-1,-2,9,2,1,0,3,-3,-1,-1,-9,-1,-4,1,0,4,-3,0,3,-1,1,4,-4,0,2,-1,-1,0,1,0,1,0,-31,-11,-20,-22,-17,-5,-2,-4,-15,-11,3,-1,-3,0,-5,-7,3,1,1,-4,-10,-4,0,-2,-4,2,-9,-10,1,-2,-2,2,-7,-8,-1,-1,-2,0,-2,-2,2,-1
9,09903,Villarcayo de Merindad de Castilla la Vieja,3809,4,1,3,5,2,3,5,-1,-3,-6,9,2,1,-3,-4,-6,6,7,4,2,1,0,3,-5,1,2,0,1,1,0,1,0,0,0,1,0,0,2,0,1,0,0,90,65,25,51,31,20,23,9,24,27,3,5,16,9,13,21,4,2,7,0,11,6,-1,3,9,11,15,14,2,0,6,5,9,9,2,0,3,6,6,5,0,0,69,43,26,80,43,37,23,16,11,18,-1,0,4,17,16,4,0,1,19,-1,-5,14,-1,-1,18,18,28,14,1,1,6,13,19,6,-1,0,12,5,9,8,2,1,96,56,40,63,36,27,22,24,30,17,6,-3,10,18,20,7,6,-5,12,6,10,10,0,2,10,15,23,14,1,0,7,7,13,8,1,0,3,8,10,6,0,0,170,97,73,128,75,53,28,38,52,26,16,8,14,26,28,13,10,5,14,12,24,13,6,3,19,27,47,28,5,0,12,17,25,17,3,0,7,10,22,11,2,0,204,155,49,208,141,67,8,34,77,70,12,0,9,21,59,55,6,4,-1,13,18,15,6,-4,24,46,64,59,12,2,15,26,45,46,7,1,9,20,19,13,5,1,215,129,86,196,115,81,48,48,51,37,26,0,29,26,36,19,13,2,19,22,15,18,13,-2,41,40,64,29,16,4,21,18,45,16,11,2,20,22,19,13,5,2,258,181,77,239,163,76,56,41,83,65,10,-1,35,20,65,50,6,1,21,21,18,15,4,-2,36,47,87,52,15,0,20,28,61,42,10,0,16,19,26,10,5,0,58,5,53,32,13,19,7,-2,27,9,12,2,0,-12,9,5,2,-1,7,10,18,4,10,3,4,9,14,4,2,-1,4,1,4,4,1,-1,0,8,10,0,1,0,57,53,4,25,11,14,12,-1,11,10,9,16,17,2,13,1,12,9,-5,-3,-2,9,-3,7,7,7,3,3,4,0,6,1,0,1,3,0,1,6,3,2,1,0,15,13,2,27,9,18,11,13,-12,1,4,-3,12,9,-10,2,1,-2,-1,4,-2,-1,3,-1,8,9,8,2,0,-1,4,4,2,-1,0,-1,4,5,6,3,0,0,-26,-6,-20,7,0,7,1,3,-21,-8,-2,1,-3,4,-2,-4,-4,2,4,-1,-19,-4,2,-1,6,7,-9,-2,4,1,0,5,-4,-3,1,1,6,2,-5,1,3,0,49,10,39,13,2,11,11,-14,4,7,15,26,-1,-11,2,2,7,11,12,-3,2,5,8,15,5,4,0,-2,5,2,2,-1,0,-2,3,1,3,5,0,0,2,1,5,-8,13,13,8,5,12,-6,-4,10,-2,-7,7,-5,-4,1,-4,-3,5,-1,0,9,2,-4,2,2,5,1,1,0,3,1,4,0,0,0,-1,1,1,1,1,0,-6,21,-27,6,3,3,0,-2,6,-3,0,-7,3,7,3,7,1,1,-3,-9,3,-10,-1,-8,0,5,1,2,-2,0,1,3,-1,2,-2,0,-1,2,2,0,0,0,-39,-30,-9,-39,-26,-13,-4,-11,-3,-22,-10,8,-6,-6,-7,-14,-2,2,2,-5,4,-8,-8,6,-7,-3,-8,-15,-7,0,-6,0,-5,-12,-4,0,-1,-3,-3,-3,-3,0,-388,-271,-117,-385,-267,-118,-23,-39,-86,-149,-83,-5,-15,-24,-52,-110,-68,1,-8,-15,-34,-39,-15,-6,-29,-28,-76,-150,-89,-13,-18,-16,-47,-110,-69,-7,-11,-12,-29,-40,-20,-6,8,11,-3,13,9,4,4,4,0,8,-11,5,5,5,-1,5,-5,3,-1,-1,1,3,-6,2,1,4,4,5,-1,-1,3,3,1,3,0,-1,-2,1,3,2,-1,0
10,10037,Cáceres,78614,183,23,160,92,28,64,99,-39,102,55,-36,14,21,-20,21,16,-25,15,78,-19,81,39,-11,-1,18,24,19,21,8,2,5,4,7,9,3,0,13,20,12,12,5,2,928,410,518,270,127,143,187,193,274,200,58,4,82,75,120,98,28,0,105,118,154,102,30,4,48,56,94,53,18,1,29,28,48,18,4,0,19,28,46,35,14,1,1690,733,957,303,131,172,259,208,537,300,117,251,117,72,254,148,49,85,142,136,283,152,68,166,57,79,99,39,14,10,25,32,46,18,6,2,32,47,53,21,8,8,786,298,488,306,138,168,158,147,274,94,70,29,77,47,123,23,8,16,81,100,151,71,62,13,58,86,86,49,19,7,27,37,41,23,5,4,31,49,45,26,14,3,714,326,388,294,135,159,160,136,199,175,9,36,89,47,96,75,0,20,71,89,103,100,9,16,41,93,87,44,22,5,19,42,48,15,7,2,22,51,39,29,15,3,714,327,387,368,157,211,174,96,186,174,46,24,79,51,65,80,30,15,95,45,121,94,16,9,68,91,108,64,31,4,29,36,56,20,13,3,39,55,52,44,18,1,753,361,392,458,176,282,192,197,217,133,3,-16,108,109,92,42,-8,4,84,88,125,91,11,-20,95,115,134,84,22,7,43,39,56,29,5,3,52,76,78,55,17,4,861,385,476,555,241,314,215,162,275,177,15,-5,119,64,123,85,-8,4,96,98,152,92,23,-9,82,133,177,115,28,6,47,55,77,48,8,3,35,78,100,67,20,3,614,194,420,196,70,126,164,135,191,114,-17,12,69,46,46,41,-13,3,95,89,145,73,-4,9,46,85,22,23,19,-4,25,37,-1,4,5,-2,21,48,23,19,14,-2,921,421,500,362,170,192,195,165,373,122,13,16,131,78,139,56,5,-9,64,87,234,66,8,25,71,90,101,60,19,9,44,38,49,23,8,1,27,52,52,37,11,8,173,87,86,39,36,3,148,15,8,13,-4,-31,79,6,-28,23,13,-16,69,9,36,-10,-17,-15,40,31,5,-27,-14,-4,26,16,-8,-2,-2,0,14,15,13,-25,-12,-4,584,231,353,302,110,192,106,67,149,169,33,30,56,-3,55,79,14,22,50,70,94,90,19,8,45,64,84,59,29,11,19,21,31,20,11,3,26,43,53,39,18,8,15,145,-130,-14,-4,-10,36,1,-67,31,27,-14,30,32,32,21,28,-2,6,-31,-99,10,-1,-12,17,19,-37,-25,3,-2,13,9,-9,-23,-3,1,4,10,-28,-2,6,-3,63,63,0,-2,5,-7,58,-46,-34,59,0,34,48,-23,-37,58,4,14,10,-23,3,1,-4,20,23,-1,-14,-3,-11,1,14,-2,-2,-1,-5,0,9,1,-12,-2,-6,1,-245,-59,-186,52,4,48,42,-67,-141,-49,-44,12,39,-28,-40,-27,-10,4,3,-39,-101,-22,-34,8,23,25,-15,3,11,1,7,7,-12,-1,1,0,16,18,-3,4,10,1,127,19,108,77,48,29,95,-36,-65,94,-15,43,54,-23,-61,28,-1,14,41,-13,-4,66,-14,29,24,19,-3,11,12,7,19,12,0,7,5,-1,5,7,-3,4,7,8,130,35,95,150,90,60,90,-31,-42,73,9,15,63,-26,-39,9,-5,15,27,-5,-3,64,14,0,22,44,52,13,8,2,17,28,29,7,1,3,5,16,23,6,7,-1,71,23,48,262,130,132,75,-5,-51,19,-6,15,58,-2,-32,-1,-11,-5,17,-3,-19,20,5,20,46,81,83,26,9,3,22,46,43,9,7,-3,24,35,40,17,2,6
10,10067,Coria,11811,48,38,10,6,5,1,15,1,3,17,3,8,15,-5,7,4,5,10,0,6,-4,13,-2,-2,2,1,2,1,0,0,2,1,1,1,0,0,0,0,1,0,0,0,-61,-23,-38,6,3,3,-7,-21,-22,-11,6,-6,-3,-8,-12,0,2,-2,-4,-13,-10,-11,4,-4,3,0,1,0,2,0,2,0,0,0,1,0,1,0,1,0,1,0,-28,-25,-3,-7,-5,-2,-2,-59,-7,-5,-6,49,-10,-34,1,-1,-1,18,8,-25,-8,-4,-5,31,0,-2,-4,0,-1,0,0,-1,-3,0,-1,0,0,-1,-1,0,0,0,-48,-8,-40,1,2,-1,1,-23,-36,-12,11,10,4,-14,-7,-4,3,8,-3,-9,-29,-8,8,2,0,0,0,1,0,0,0,0,1,1,0,0,0,0,-1,0,0,0,110,57,53,34,19,15,24,1,24,18,6,36,16,-8,23,12,-1,16,8,9,1,6,7,20,2,5,19,5,1,2,-1,1,15,4,0,0,3,4,4,1,1,2,63,25,38,53,37,16,0,0,10,-2,23,29,2,-3,2,0,17,7,-2,3,8,-2,6,22,5,9,20,8,9,1,1,6,15,8,5,1,4,3,5,0,4,0,-36,2,-38,49,23,26,-14,-10,-6,-13,2,5,-3,-5,5,-3,9,-1,-11,-5,-11,-10,-7,6,6,14,7,11,8,3,2,7,2,6,5,1,4,7,5,5,3,2,45,33,12,50,28,22,0,18,4,16,5,3,1,11,2,13,5,1,-1,7,2,3,0,2,0,17,19,9,4,1,0,10,11,4,2,1,0,7,8,5,2,0,-32,-6,-26,43,29,14,-20,-12,10,-11,1,1,-11,-4,7,-1,2,2,-9,-8,3,-10,-1,-1,6,10,17,8,2,0,4,6,13,4,2,0,2,4,4,4,0,0,64,61,3,37,19,18,19,-7,12,26,7,8,18,-6,18,26,6,-2,1,-1,-6,0,1,10,9,7,10,5,3,2,6,1,5,4,2,0,3,6,5,1,1,2,56,10,46,28,10,18,17,0,-10,20,2,25,4,-3,-4,3,-3,9,13,3,-6,17,5,16,5,4,12,1,4,2,3,1,4,0,2,0,2,3,8,1,2,2,77,50,27,18,9,9,12,1,11,14,12,29,9,6,11,6,8,13,3,-5,0,8,4,16,4,10,4,-1,2,0,3,4,3,-2,2,0,1,6,1,1,0,0,-34,-14,-20,3,0,3,5,-21,-20,-4,5,1,0,-6,-13,-1,0,4,5,-15,-7,-3,5,-3,0,-1,3,-1,0,0,0,-1,0,0,0,0,0,0,3,-1,0,0,-113,-66,-47,-85,-55,-30,-6,-19,-41,-44,-4,1,-1,-16,-15,-32,-3,1,-5,-3,-26,-12,-1,0,-9,-6,-22,-33,-9,-7,-5,-5,-15,-20,-7,-3,-4,-1,-7,-13,-2,-4,-31,-16,-15,1,-3,4,-12,-12,8,-14,-9,7,-8,-12,4,-6,-2,6,-4,0,4,-8,-7,1,-2,1,0,3,-1,0,0,1,-4,1,-1,0,-2,0,4,2,0,0,18,19,-1,5,5,0,12,-23,-12,-3,6,36,13,-13,0,-6,4,19,-1,-10,-12,3,2,17,1,-2,6,1,-2,0,1,-2,5,0,0,0,0,0,1,1,-2,0,-111,-52,-59,11,8,3,-17,-42,-24,-25,-5,-2,-19,-15,-16,-11,2,5,2,-27,-8,-14,-7,-7,1,1,-2,5,3,2,1,1,-1,4,2,1,0,0,-1,1,1,1,-115,-61,-54,12,3,9,-18,-38,-38,-21,0,4,-2,-17,-21,-13,0,-6,-16,-21,-17,-8,0,10,-1,5,9,-3,3,-1,1,2,2,-1,0,-1,-2,3,7,-2,3,0
10,10110,Losar de la Vera,3007,122,81,41,72,44,28,42,13,30,18,10,7,21,14,19,18,4,4,21,-1,11,0,6,3,23,15,21,8,4,0,12,12,15,4,1,0,11,3,6,4,3,0,-62,-49,-13,5,3,2,-13,-13,-29,-5,-1,0,-6,-12,-21,-8,-3,1,-7,-1,-8,3,2,-1,0,3,0,1,1,0,0,3,0,0,0,0,0,0,0,1,1,0,-58,-23,-35,1,2,-1,-15,-10,-21,-14,3,0,-3,-6,-10,-5,0,1,-12,-4,-11,-9,3,-1,2,0,0,0,0,-1,2,0,0,1,0,-1,0,0,0,-1,0,0,-60,-35,-25,10,6,4,-5,-14,-27,-13,-1,-1,-1,-10,-18,-7,-1,1,-4,-4,-9,-6,0,-2,6,-1,2,2,5,-4,4,0,0,1,3,-2,2,-1,2,1,2,-2,-46,-23,-23,20,13,7,-7,-8,-28,-6,0,3,0,-7,-13,-5,-1,4,-7,-1,-15,-1,1,-1,5,5,3,4,3,0,5,2,1,3,1,1,0,3,2,1,2,-1,-33,-14,-19,22,14,8,1,-9,-16,-4,-1,-2,5,-6,-12,-2,2,-1,-4,-3,-4,-2,-3,-1,11,1,6,2,1,0,9,1,2,0,1,0,2,0,4,2,0,0,5,-6,11,22,10,12,6,3,-6,0,5,-3,2,-1,-8,1,1,-1,4,4,2,-1,4,-2,6,6,0,6,4,0,3,3,0,3,1,0,3,3,0,3,3,0,24,20,4,23,12,11,24,-10,-5,6,10,-4,14,-2,-6,6,7,0,10,-8,1,0,3,-4,6,5,5,1,4,2,5,2,1,1,2,1,1,3,4,0,2,1,11,18,-7,9,5,4,-3,2,-3,2,12,-2,2,2,4,-4,8,4,-5,0,-7,6,4,-6,2,2,5,-1,1,0,1,0,2,0,2,0,1,2,3,-1,-1,0,26,9,17,14,7,7,10,-12,11,6,11,-4,2,-9,9,0,7,-3,8,-3,2,6,4,-1,4,2,2,1,3,1,3,0,1,0,1,1,1,2,1,1,2,0,-23,-18,-5,7,1,6,-11,-4,-13,-1,4,2,-6,-1,-12,0,4,-3,-5,-3,-1,-1,0,5,1,2,0,3,1,0,1,1,-1,0,0,0,0,1,1,3,1,0,-24,-1,-23,-2,0,-2,-7,6,3,-8,-7,-9,2,4,9,-8,-6,-1,-9,2,-6,0,-1,-8,0,0,1,-1,-1,-1,0,0,2,-1,-1,0,0,0,-1,0,0,-1,64,38,26,2,4,-2,24,0,14,19,2,-1,11,2,3,15,2,1,13,-2,11,4,0,-2,1,1,-1,1,1,-1,0,2,0,1,1,0,1,-1,-1,0,0,-1,17,9,8,1,3,-2,-1,1,-9,10,4,7,-7,1,-2,10,2,3,6,0,-7,0,2,4,0,0,2,1,-1,-1,0,0,2,1,0,0,0,0,0,0,-1,-1,-22,-16,-6,1,-2,3,-11,-4,-4,-5,-7,1,-6,-2,-5,-4,-4,0,-5,-2,1,-1,-3,1,-1,2,0,0,0,0,0,1,-1,0,0,-2,-1,1,1,0,0,2,8,0,8,6,3,3,-2,-1,-2,2,1,6,-4,-1,-4,3,4,0,2,0,2,-1,-3,6,0,1,0,1,1,3,0,0,0,0,2,1,0,1,0,1,-1,2,5,6,-1,8,5,3,-5,-4,2,10,2,1,-1,-6,4,7,0,3,-4,2,-2,3,2,-2,0,1,2,4,0,1,0,1,1,2,0,1,0,0,1,2,0,0,-5,-2,-3,9,4,5,-1,-4,1,1,2,-6,-4,3,5,-4,1,-3,3,-7,-4,5,1,-3,2,1,1,3,1,1,0,1,1,1,0,1,2,0,0,2,1,0
10,10116,Malpartida de Plasencia,4191,28,8,20,13,3,10,9,1,5,7,-2,7,-1,-6,5,7,-1,3,10,7,0,0,-1,4,6,3,0,1,2,0,1,0,0,0,1,0,5,3,0,1,1,0,-5,3,-8,6,4,2,1,-9,11,-11,1,3,5,-2,3,-5,2,0,-4,-7,8,-6,-1,3,0,2,1,0,1,1,0,1,1,0,1,0,0,1,0,0,0,1,54,26,28,27,10,17,11,11,7,16,10,-2,1,4,5,8,6,0,10,7,2,8,4,-2,8,6,9,1,3,0,1,3,4,1,1,0,7,3,5,0,2,0,-38,-23,-15,7,3,4,-7,-6,0,-9,-6,-12,-4,-10,1,-5,-1,-6,-3,4,-1,-4,-5,-6,4,3,0,0,0,0,3,1,-1,0,0,0,1,2,1,0,0,0,39,22,17,10,4,6,4,2,6,13,10,5,1,1,6,8,3,3,3,1,0,5,7,2,2,3,2,3,0,0,0,2,1,1,0,0,2,1,1,2,0,0,25,20,5,13,4,9,15,-1,11,2,1,-3,9,4,3,2,1,0,6,-5,8,0,0,-3,5,1,6,0,0,1,1,0,3,0,0,0,4,1,3,0,0,1,114,58,56,10,6,4,27,15,24,32,8,5,15,6,10,16,4,5,12,9,14,16,4,0,3,1,5,0,1,0,2,1,3,0,0,0,1,0,2,0,1,0,53,36,17,14,8,6,12,-3,13,9,17,3,6,5,6,6,7,5,6,-8,7,3,10,-2,5,1,3,4,0,1,3,0,2,3,0,0,2,1,1,1,0,1,74,35,39,10,5,5,18,-1,30,17,5,2,3,1,15,7,6,1,15,-2,15,10,-1,1,3,0,7,1,0,-1,0,1,3,0,1,0,3,-1,4,1,-1,-1,52,26,26,9,5,4,14,17,7,12,4,-5,9,2,9,7,2,-4,5,15,-2,5,2,-1,1,4,3,0,1,0,0,2,2,0,1,0,1,2,1,0,0,0,16,23,-7,14,8,6,4,-4,1,6,12,-2,4,3,3,5,7,1,0,-7,-2,1,5,-3,1,7,5,0,1,0,1,3,3,0,1,0,0,4,2,0,0,0,42,9,33,3,4,-1,12,19,3,-1,2,7,8,3,3,-7,0,2,4,16,0,6,2,5,4,1,-2,0,-1,1,3,1,0,0,-1,1,1,0,-2,0,0,0,-60,-27,-33,-9,-4,-5,-13,-16,-7,-25,3,0,-7,-4,-3,-13,1,0,-6,-12,-4,-12,2,0,0,-2,-3,-4,0,0,-1,1,-1,-3,0,0,1,-3,-2,-1,0,0,-7,0,-7,2,2,0,8,-10,-5,1,6,-11,5,-4,-3,-4,8,-4,3,-6,-2,5,-2,-7,0,1,-1,0,2,0,0,1,0,-1,2,0,0,0,-1,1,0,0,17,9,8,3,4,-1,14,-11,8,10,-4,1,7,-1,2,4,-5,2,7,-10,6,6,1,-1,2,1,0,0,1,0,3,1,0,0,0,0,-1,0,0,0,1,0,-33,-20,-13,-8,-7,-1,-11,-9,-2,-19,1,5,-8,-5,-1,-7,-1,1,-3,-4,-1,-12,2,4,0,2,-4,-3,-2,-1,0,0,-3,-2,-1,-1,0,2,-1,-1,-1,0,-21,-15,-6,5,0,5,3,-6,-21,4,1,-1,-1,-4,-9,-1,1,0,4,-2,-12,5,0,-1,4,3,-2,1,0,-1,0,1,-1,0,0,0,4,2,-1,1,0,-1,25,7,18,17,11,6,23,-7,-2,7,5,-5,8,-6,2,1,2,-2,15,-1,-4,6,3,-3,5,1,2,5,2,2,4,0,3,3,0,1,1,1,-1,2,2,1
10,10121,Miajadas,9629,1,-6,7,20,4,16,-7,-6,7,3,2,2,-2,-8,0,2,-1,2,-5,2,7,1,3,0,0,4,10,4,0,2,0,0,3,0,0,1,0,4,7,4,0,1,15,12,3,34,19,15,7,3,-8,6,7,-2,4,4,1,2,1,-3,3,-1,-9,4,6,1,6,8,9,7,3,0,5,4,6,3,0,0,1,4,3,4,3,0,9,10,-1,45,17,28,4,8,-6,-2,9,-4,6,3,0,-2,3,-2,-2,5,-6,0,6,-2,7,15,12,6,3,2,4,4,5,2,1,1,3,11,7,4,2,1,41,30,11,37,15,22,5,13,-6,18,2,8,0,7,-5,17,6,5,5,6,-1,1,-4,3,8,3,14,8,3,1,4,0,7,3,1,0,4,3,7,5,2,1,54,4,50,38,14,24,22,9,-8,17,3,6,8,-6,-12,7,2,5,14,15,4,10,1,1,6,7,13,10,1,0,3,1,6,3,1,0,3,6,7,7,0,0,0,-14,14,35,14,21,2,2,-7,1,8,-8,-3,-8,-2,0,2,-4,5,10,-5,1,6,-4,6,4,13,8,4,0,4,1,5,3,1,0,2,3,8,5,3,0,56,31,25,23,11,12,4,8,17,9,12,8,-1,3,14,3,10,4,5,5,3,6,2,4,0,6,7,7,3,0,0,1,5,3,2,0,0,5,2,4,1,0,136,86,50,74,38,36,29,24,14,47,19,1,20,25,-4,33,10,0,9,-1,18,14,9,1,9,25,18,17,4,0,4,14,9,8,2,0,5,11,9,9,2,0,63,28,35,31,12,19,27,9,11,-8,22,-2,9,3,7,-7,10,3,18,6,4,-1,12,-5,9,10,10,2,0,0,2,6,3,1,0,0,7,4,7,1,0,0,-8,7,-15,15,7,8,21,-8,-14,-8,4,-5,19,-4,-4,-6,3,-2,2,-4,-10,-2,1,-3,10,3,2,0,-1,1,7,-1,2,-2,0,1,3,4,0,2,-1,0,-36,-7,-29,18,5,13,2,-14,-10,-8,-4,-2,3,-3,3,-5,-4,-2,-1,-11,-13,-3,0,0,7,2,9,-1,-2,1,2,-2,6,0,-3,0,5,4,3,-1,1,1,-44,-23,-21,0,-2,2,-14,-9,-23,-6,7,0,-11,-6,-10,1,6,-2,-3,-3,-13,-7,1,2,-2,0,6,-3,-1,0,-1,-2,2,-2,1,0,-1,2,4,-1,-2,0,-76,-42,-34,-68,-30,-38,0,-18,-19,-13,-16,-9,-3,-10,-4,-18,-3,-4,3,-8,-15,5,-13,-5,-2,-6,-23,-18,-16,-3,-1,-6,-8,-11,-4,0,-1,0,-15,-7,-12,-3,-71,-27,-44,-55,-31,-24,-6,3,-34,-12,-11,-11,-4,0,-11,-5,-3,-3,-2,3,-23,-7,-8,-8,-5,-3,-20,-17,-7,-3,-1,-4,-11,-10,-3,-2,-4,1,-9,-7,-4,-1,-31,1,-32,-9,-2,-7,-5,7,-11,-26,5,-1,-2,10,1,-7,3,-4,-3,-3,-12,-19,2,3,-1,3,-6,-3,-2,0,0,2,-1,-2,-1,0,-1,1,-5,-1,-1,0,-42,-26,-16,-11,-2,-9,-12,-13,-17,3,0,-9,-9,-10,-7,-3,4,-3,-3,-3,-10,6,-4,-6,-3,-5,0,-6,1,1,-1,0,1,-2,0,0,-2,-5,-1,-4,1,1,-81,-36,-45,-21,-13,-8,-6,-27,-34,-20,0,9,-6,-6,-15,-12,1,3,0,-21,-19,-8,-1,6,6,-7,-7,-9,0,-2,-1,-2,-5,-4,0,-1,7,-5,-2,-5,0,-1,-58,-54,-4,5,-4,9,9,-13,-28,-18,-4,-11,-4,-14,-17,-14,-5,-4,13,1,-11,-4,1,-7,6,2,1,-3,-2,0,1,-2,1,-1,-4,0,5,4,0,-2,2,0
10,10127,Montehermoso,5211,56,34,22,13,7,6,7,2,21,7,10,6,6,1,15,4,4,2,1,1,6,3,6,4,2,3,2,3,3,0,1,2,1,2,1,0,1,1,1,1,2,0,27,12,15,12,7,5,8,7,-1,0,11,0,3,-1,-2,2,9,0,5,8,1,-2,2,0,4,1,2,1,3,0,2,0,1,1,2,0,2,1,1,0,1,0,14,16,-2,13,7,6,4,-2,1,1,12,-2,2,5,4,-1,6,0,2,-7,-3,2,6,-2,1,8,1,0,3,0,1,4,1,0,1,0,0,4,0,0,2,0,-12,7,-19,14,8,6,-7,4,-12,1,6,-3,0,3,1,0,3,0,-7,1,-13,1,3,-3,3,1,2,6,2,0,2,1,2,3,0,0,1,0,0,3,2,0,-16,3,-19,3,4,-1,0,-7,-9,-4,7,0,4,-1,1,-2,3,0,-4,-6,-10,-2,4,0,0,3,-1,2,-1,0,0,2,1,1,0,0,0,1,-2,1,-1,0,23,6,17,11,4,7,3,-2,12,-1,7,2,3,-3,6,-5,3,2,0,1,6,4,4,0,3,3,2,3,-1,0,2,1,1,1,-1,0,1,2,1,2,0,0,29,17,12,8,3,5,12,-3,16,1,0,0,11,-6,6,2,2,1,1,3,10,-1,-2,-1,6,0,0,1,0,0,3,0,-1,0,1,0,3,0,1,1,-1,0,35,29,6,21,8,13,1,5,12,8,1,10,-3,2,14,10,1,4,4,3,-2,-2,0,6,4,4,8,3,0,1,2,2,1,1,0,1,2,2,7,2,0,0,21,18,3,21,11,10,13,-10,-2,8,11,-2,7,-8,5,5,7,0,6,-2,-7,3,4,-2,5,3,4,3,4,2,3,1,2,2,2,1,2,2,2,1,2,1,16,9,7,-10,-6,-4,-3,0,9,12,0,-3,-2,1,5,6,1,-1,-1,-1,4,6,-1,-2,-4,-3,1,-2,-2,0,-2,-2,1,-2,-1,0,-2,-1,0,0,-1,0,-22,-7,-15,7,4,3,3,-5,-8,-5,1,-3,5,0,-5,-3,0,-1,-2,-5,-3,-2,1,-2,0,2,0,1,3,0,0,2,0,0,2,0,0,0,0,1,1,0,30,15,15,10,6,4,2,9,5,2,15,-4,0,5,0,3,8,0,2,4,5,-1,7,-4,4,0,8,-3,2,-1,1,0,6,-1,1,-1,3,0,2,-2,1,0,-20,-19,-1,2,-1,3,-4,-4,-12,2,0,-2,-1,-6,-13,2,0,-1,-3,2,1,0,0,-1,1,2,1,-1,0,-1,0,0,0,-1,0,0,1,2,1,0,0,-1,12,11,1,3,0,3,2,-8,6,-1,6,6,-2,-1,6,0,4,3,4,-7,0,-1,2,3,1,0,1,2,0,0,0,0,0,1,0,0,1,0,1,1,0,0,-14,-7,-7,1,2,-1,-5,4,-16,-1,9,-4,1,-6,-7,2,6,-2,-6,10,-9,-3,3,-2,-1,0,1,-1,2,0,0,0,1,0,1,0,-1,0,0,-1,1,0,-37,-28,-9,-3,0,-3,8,-7,-27,-5,-1,-3,3,-6,-20,0,1,-5,5,-1,-7,-5,-2,2,1,0,-4,3,-3,0,0,0,-1,3,-2,0,1,0,-3,0,-1,0,-40,-21,-19,-1,0,-1,-13,-12,-14,-4,6,-1,-6,-5,-8,-4,4,-1,-7,-7,-6,0,2,0,0,0,0,0,0,-1,0,0,0,0,1,-1,0,0,0,0,-1,0,-40,-26,-14,-1,2,-3,0,-11,-23,-3,-2,0,-6,-2,-19,3,-1,-1,6,-9,-4,-6,-1,1,-1,0,-2,0,-1,3,0,0,0,1,-1,2,-1,0,-2,-1,0,1
10,10131,Navalmoral de la Mata,14934,16,17,-1,89,38,51,-30,-1,32,-8,19,6,-16,7,11,9,9,-1,-14,-8,21,-17,10,7,9,30,35,11,2,2,7,15,10,6,0,0,2,15,25,5,2,2,-139,-82,-57,4,2,2,-61,-39,-26,-13,-10,11,-26,-27,-22,-10,1,2,-35,-12,-4,-3,-11,9,0,0,1,0,1,2,0,0,0,0,1,1,0,0,1,0,0,1,-47,-2,-45,134,78,56,-7,3,-8,-33,-4,-4,-11,21,5,-17,-2,-1,4,-18,-13,-16,-2,-3,45,37,24,18,5,0,27,23,16,7,1,1,18,14,8,11,4,-1,298,155,143,228,119,109,99,45,83,35,9,22,55,27,50,6,1,12,44,18,33,29,8,10,68,55,58,25,13,6,41,29,32,11,4,1,27,26,26,14,9,5,235,141,94,172,108,64,104,16,35,69,-5,9,66,1,21,43,1,7,38,15,14,26,-6,2,42,34,42,34,9,6,25,22,25,24,5,5,17,12,17,10,4,1,32,-35,67,163,78,85,23,-27,-1,12,0,28,-15,-14,-9,-1,-4,13,38,-13,8,13,4,15,27,44,43,27,9,11,12,21,26,11,5,3,15,23,17,16,4,8,159,28,131,181,79,102,52,2,68,-2,2,31,23,-12,20,-8,-4,6,29,14,48,6,6,25,37,43,49,24,20,5,12,19,22,13,10,2,25,24,27,11,10,3,178,94,84,167,88,79,75,6,32,40,3,14,45,2,18,23,-3,6,30,4,14,17,6,8,45,32,44,20,17,6,27,18,25,11,6,1,18,14,19,9,11,5,-18,-24,6,62,15,47,34,-9,7,-23,-20,-11,10,-20,1,-3,-6,-9,24,11,6,-20,-14,-2,11,31,22,4,-2,-3,4,10,5,-1,2,-4,7,21,17,5,-4,1,16,-10,26,70,22,48,9,-20,54,-32,-4,5,4,-10,20,-22,-10,6,5,-10,34,-10,6,-1,11,30,22,2,1,3,7,5,11,-3,-2,3,4,25,11,5,3,0,2,3,-1,14,5,9,28,-25,15,2,-29,10,15,-21,10,4,-10,11,13,-4,5,-2,-19,-1,17,8,-13,-1,1,0,7,3,-11,2,4,0,10,5,-2,-3,-3,0,-67,-94,27,-3,-16,13,-46,-23,18,-14,-6,1,-37,-13,-7,-30,-7,-6,-9,-10,25,16,1,7,-11,12,-2,5,-8,-1,-11,3,-5,-2,-4,1,0,9,3,7,-4,-2,-92,-83,-9,-32,-36,4,-8,-11,-15,-29,-36,5,-19,-6,-18,-16,-27,3,11,-5,3,-13,-9,2,5,-4,-15,-16,-2,-2,-2,-9,-11,-8,-8,1,7,5,-4,-8,6,-3,-84,-63,-21,-40,-24,-16,-12,-10,-28,-1,-20,-10,-7,-26,-13,-6,-4,-5,-5,16,-15,5,-16,-5,-15,-4,0,-12,-10,1,-8,-5,1,-6,-5,-1,-7,1,-1,-6,-5,2,-119,-66,-53,-7,-15,8,-5,-41,-21,-22,-16,-15,-1,-28,-6,-15,-5,-10,-4,-13,-15,-7,-11,-5,1,4,-7,-4,1,-3,2,-1,-6,-7,-1,-2,-1,5,-1,3,2,-1,55,27,28,35,28,7,12,-14,14,42,-7,-2,20,-3,0,19,-16,-1,-8,-11,14,23,9,-1,14,5,12,6,1,-3,11,3,12,5,-2,0,3,2,0,1,3,-3,48,14,34,58,32,26,39,-2,-2,1,19,-4,13,-2,-14,9,11,-2,26,0,12,-8,8,-2,10,20,5,3,9,9,6,10,2,4,6,2,4,10,3,-1,3,7,-142,-66,-76,67,21,46,-18,-38,-10,-44,-28,-6,2,-20,-5,-22,-16,-5,-20,-18,-5,-22,-12,-1,23,21,15,-5,11,-1,19,9,0,-10,5,-1,4,12,15,5,6,0
10,10148,Plasencia,36465,-250,-149,-101,59,28,31,-54,-65,-59,-51,-15,-6,-31,-31,-49,-31,-4,-4,-23,-34,-10,-20,-11,-2,6,11,21,11,4,5,2,7,11,5,1,2,4,4,10,6,3,3,87,7,80,129,59,70,46,-6,16,15,-3,19,6,-14,0,1,-2,18,40,8,16,14,-1,1,38,24,37,23,4,3,20,9,20,6,2,2,18,15,17,17,2,1,186,96,90,138,71,67,48,18,63,37,10,2,29,-4,18,34,13,2,19,22,45,3,-3,0,30,24,46,23,11,2,18,9,21,15,4,2,12,15,25,8,7,0,255,96,159,129,58,71,78,48,79,46,0,1,28,9,40,18,0,0,50,39,39,28,0,1,28,33,40,12,8,8,13,14,18,6,4,3,15,19,22,6,4,5,522,241,281,172,75,97,127,28,157,99,60,36,47,22,67,50,32,13,80,6,90,49,28,23,35,39,57,22,13,3,11,18,26,12,6,0,24,21,31,10,7,3,219,81,138,158,76,82,19,54,64,51,24,11,-1,17,34,25,9,2,20,37,30,26,15,9,31,38,43,27,14,4,13,22,23,11,4,3,18,16,20,16,10,1,354,162,192,194,94,100,130,64,87,78,8,-11,80,29,32,29,-5,-6,50,35,55,49,13,-5,41,44,63,31,12,3,27,18,36,8,3,2,14,26,27,23,9,1,182,67,115,246,119,127,60,0,44,41,16,19,34,-7,15,13,3,10,26,7,29,28,13,9,53,62,74,34,16,6,33,21,39,15,8,2,20,41,35,19,8,4,271,129,142,156,84,72,102,0,95,58,1,10,59,7,35,18,-2,12,43,-7,60,40,3,-2,22,44,55,18,11,3,17,25,29,4,6,1,5,19,26,14,5,2,237,97,140,139,70,69,49,45,51,58,9,21,21,19,8,30,2,14,28,26,43,28,7,7,39,26,36,25,6,6,25,11,15,10,7,2,14,15,21,15,-1,4,-349,-193,-156,-250,-128,-122,-19,-87,-62,-85,-78,-21,-8,-46,-48,-42,-37,-11,-11,-41,-14,-43,-41,-10,-23,-26,-70,-82,-40,-9,-14,-22,-35,-41,-15,-1,-9,-4,-35,-41,-25,-8,-68,-34,-34,104,48,56,7,-37,-14,-17,-5,-3,-7,-22,10,-8,-4,-4,14,-15,-24,-9,-1,1,24,20,29,18,10,3,14,6,17,9,3,-1,10,14,12,9,7,4,-36,-38,2,38,16,22,9,-6,-57,24,0,-7,7,-12,-37,1,-3,2,2,6,-20,23,3,-9,5,14,10,9,3,-3,1,7,8,-3,3,0,4,7,2,12,0,-3,-8,-41,33,-16,-20,4,8,-38,-19,47,-10,0,5,-26,-30,17,-3,0,3,-12,11,30,-7,0,-3,-1,-8,-4,-3,3,-3,-4,-9,-4,-2,2,0,3,1,0,-1,1,-152,-83,-69,50,28,22,-7,-72,-28,-20,-37,2,-14,-28,-13,-15,-31,12,7,-44,-15,-5,-6,-10,5,8,21,12,-3,4,9,1,12,8,-4,2,-4,7,9,4,1,2,-58,-51,-7,86,40,46,36,-85,-9,-20,3,15,18,-43,-25,-13,2,9,18,-42,16,-7,1,6,29,11,18,8,11,5,11,5,9,5,5,2,18,6,9,3,6,3,-137,-115,-22,78,41,37,2,-27,-54,-29,-29,2,-8,-20,-46,-25,-11,-5,10,-7,-8,-4,-18,7,19,20,20,10,7,2,9,12,11,5,3,1,10,8,9,5,4,1,-150,-55,-95,65,39,26,-7,-61,-56,10,-2,-28,3,-20,-21,9,-8,-14,-10,-41,-35,1,6,-14,21,16,8,8,6,6,9,13,10,4,1,2,12,3,-2,4,5,4
10,10205,Valverde del Fresno,2690,-54,-21,-33,15,9,6,-25,-12,-9,-9,2,-1,-9,-2,-5,-5,-1,1,-16,-10,-4,-4,3,-2,2,1,2,9,1,0,2,0,1,6,0,0,0,1,1,3,1,0,-34,-18,-16,4,1,3,-6,-13,-4,-10,1,-2,-6,-5,-1,-8,2,0,0,-8,-3,-2,-1,-2,1,1,2,0,0,0,0,0,1,0,0,0,1,1,1,0,0,0,-16,-11,-5,8,6,2,1,-3,-7,-7,8,-7,0,-4,-2,-4,3,-4,1,1,-5,-3,5,-3,1,1,0,0,6,0,1,2,0,0,3,0,0,-1,0,0,3,0,-24,-8,-16,8,5,3,-6,-6,-13,2,4,-5,-6,-4,-2,-1,5,-1,0,-2,-11,3,-1,-4,2,1,1,0,3,0,0,0,2,0,2,0,2,1,-1,0,1,0,16,4,12,0,-2,2,5,-8,4,10,4,2,2,-1,-3,4,0,2,3,-7,7,6,4,0,-2,0,-1,0,1,2,-1,0,-2,-1,1,1,-1,0,1,1,0,1,-8,3,-11,17,10,7,-2,-4,-3,1,5,-5,0,0,0,1,0,2,-2,-4,-3,0,5,-7,1,4,5,5,-1,2,1,3,3,2,-1,2,0,1,2,3,0,0,-23,-14,-9,12,8,4,1,-14,-10,-2,8,-5,2,-9,-12,1,5,-1,-1,-5,2,-3,3,-4,2,1,3,4,2,0,2,0,1,4,0,1,0,1,2,0,2,-1,-21,-5,-16,10,7,3,-3,-7,-10,-3,7,-5,4,-3,-8,2,2,-2,-7,-4,-2,-5,5,-3,0,0,3,3,4,0,0,0,2,3,2,0,0,0,1,0,2,0,-15,-13,-2,10,4,6,1,-16,1,-3,0,2,0,-9,-4,1,-1,0,1,-7,5,-4,1,2,3,0,3,2,1,1,1,0,1,1,1,0,2,0,2,1,0,1,-5,-1,-4,1,3,-2,-1,-5,1,0,4,-5,-2,-5,0,1,4,0,1,0,1,-1,0,-5,-1,-1,2,-1,2,0,-1,0,2,0,2,0,0,-1,0,-1,0,0,-10,-2,-8,5,1,4,-4,-2,-4,-3,3,-1,1,2,-5,-3,4,-1,-5,-4,1,0,-1,0,0,2,1,-2,5,-1,0,2,0,-3,3,-1,0,0,1,1,2,0,5,-1,6,3,-1,4,0,1,9,-3,9,-10,-1,1,0,-3,6,-4,1,0,9,0,3,-6,0,1,1,-2,3,0,0,0,0,-2,1,0,0,1,1,0,2,0,-10,-13,3,9,2,7,0,-1,0,-6,7,-11,0,-3,-3,-7,5,-6,0,2,3,1,2,-5,3,2,1,0,2,1,1,0,-1,0,1,1,2,2,2,0,1,0,31,19,12,3,1,2,13,4,2,6,7,0,5,2,2,6,3,1,8,2,0,0,4,-1,0,-1,-1,1,4,0,0,-1,-1,1,2,0,0,0,0,0,2,0,-13,-11,-2,5,3,2,1,0,-2,-4,-2,-4,0,0,-4,-4,-1,-1,1,0,2,0,-1,-3,0,1,0,0,4,0,0,1,0,0,2,0,0,0,0,0,2,0,-14,-6,-8,-2,1,-3,-4,-8,-3,-2,2,1,-1,-7,0,-2,2,2,-3,-1,-3,0,0,-1,0,-1,-3,1,0,1,0,-1,-1,1,1,1,0,0,-2,0,-1,0,4,2,2,9,2,7,2,0,-6,5,11,-10,-2,1,-1,3,5,-5,4,-1,-5,2,6,-5,2,1,1,1,4,0,0,0,0,0,2,0,2,1,1,1,2,0,-3,-3,0,0,-1,1,-2,-4,6,1,0,-4,1,0,0,2,-2,-3,-3,-4,6,-1,2,-1,-3,1,-1,-1,3,1,-2,0,0,-1,1,1,-1,1,-1,0,2,0
11,11004,Algeciras,103106,75,36,39,52,23,29,73,-86,76,-29,37,13,11,-35,58,-20,20,1,62,-51,18,-9,17,12,11,5,10,6,15,5,5,1,5,2,7,3,6,4,5,4,8,2,207,119,88,50,27,23,60,-55,79,40,20,57,16,-25,42,41,20,20,44,-30,37,-1,0,37,12,1,14,6,12,4,4,1,10,5,4,3,8,0,4,1,8,1,211,73,138,3,-3,6,126,-43,142,-18,-3,-2,52,-5,45,-7,-8,1,74,-38,97,-11,5,-3,13,-8,-9,3,9,-6,5,-1,-9,3,3,-4,8,-7,0,0,6,-2,255,107,148,154,75,79,125,-61,152,44,-33,14,69,-56,64,35,-25,9,56,-5,88,9,-8,5,34,32,25,37,13,9,17,13,14,18,6,6,17,19,11,19,7,3,969,585,384,736,377,359,190,170,329,181,32,32,83,101,218,132,4,21,107,69,111,49,28,11,138,170,192,132,62,19,59,80,117,69,31,8,79,90,75,63,31,11,1259,644,615,1060,512,548,249,197,433,264,71,42,100,115,215,145,46,27,149,82,218,119,25,15,198,241,309,214,78,14,90,123,144,107,39,8,108,118,165,107,39,6,1280,672,608,1302,670,632,225,311,366,275,60,23,113,142,220,137,19,23,112,169,146,138,41,0,210,347,353,265,87,23,110,166,190,137,47,9,100,181,163,128,40,14,1272,714,558,1012,517,495,275,264,434,241,-12,39,127,126,233,194,2,17,148,138,201,47,-14,22,182,294,245,204,48,33,87,136,133,118,26,16,95,158,112,86,22,17,959,542,417,817,418,399,180,187,338,180,34,10,76,75,244,92,26,12,104,112,94,88,8,-2,157,190,230,139,79,12,67,86,133,81,40,3,90,104,97,58,39,9,79,26,53,372,199,173,40,-35,103,-56,-14,28,40,-38,25,-13,-10,14,0,3,78,-43,-4,14,75,102,114,49,20,-1,55,48,53,24,12,1,20,54,61,25,8,-2,56,-5,61,-82,-103,21,96,-40,68,-57,-62,24,72,-45,1,-37,-34,19,24,5,67,-20,-28,5,24,30,-17,-82,-39,-10,19,18,-34,-83,-24,-6,5,12,17,1,-15,-4,-401,-141,-260,198,101,97,-172,-36,-63,-86,-45,-8,-58,-5,-16,-26,-39,-6,-114,-31,-47,-60,-6,-2,44,76,71,-9,2,6,25,34,39,5,-7,2,19,42,32,-14,9,4,-373,-331,-42,-40,-106,66,-17,-24,-155,-75,-47,-53,-42,-48,-98,-75,-49,-16,25,24,-57,0,2,-37,61,52,-62,-60,-11,-26,16,13,-47,-55,-22,-14,45,39,-15,-5,11,-12,-54,-58,4,-170,-128,-42,12,-22,-68,0,-3,1,-11,-27,-91,-9,33,26,23,5,23,9,-36,-25,-12,14,-90,-50,-17,-21,3,-12,-64,-44,-9,-5,-15,26,-26,-6,-8,-16,382,208,174,191,95,96,46,72,85,39,49,41,12,28,52,32,24,30,34,44,33,7,25,11,40,75,47,3,1,3,23,26,29,-2,-1,4,17,49,18,5,2,-1,373,157,216,290,136,154,137,34,36,120,32,4,61,-15,12,64,16,14,76,49,24,56,16,-10,85,84,19,76,12,9,42,34,5,47,4,6,43,50,14,29,8,3,-313,-200,-113,-465,-298,-167,-23,-28,-126,-132,-31,2,-6,-14,-104,-89,-27,21,-17,-14,-22,-43,-4,-19,-63,-3,-153,-183,-57,-22,-24,-23,-83,-125,-41,-9,-39,20,-70,-58,-16,-13,10,-23,33,197,47,150,-16,43,86,-86,2,-27,-9,28,46,-61,-16,-5,-7,15,40,-25,18,-22,20,109,71,-34,7,6,17,59,39,-54,-19,0,3,50,32,20,26,6
11,11005,Algodonales,5680,-11,-12,1,9,5,4,1,-9,-1,-15,10,3,0,-10,0,-8,4,2,1,1,-1,-7,6,1,0,3,2,1,3,0,0,1,2,1,1,0,0,2,0,0,2,0,-17,-10,-7,9,2,7,5,-18,-15,3,10,0,2,-9,-6,0,3,2,3,-9,-9,3,7,-2,1,1,1,1,5,0,0,0,1,0,1,0,1,1,0,1,4,0,-13,-9,-4,5,2,3,3,-14,3,-11,6,-2,0,-8,4,-9,3,0,3,-6,-1,-2,3,-2,2,-1,0,3,1,0,0,-2,1,2,1,0,2,1,-1,1,0,0,29,9,20,16,4,12,7,-16,5,11,14,8,6,-12,1,4,6,3,1,-4,4,7,8,5,3,2,2,3,4,2,1,0,0,1,2,0,2,2,2,2,2,2,-32,4,-36,10,8,2,-2,-32,-20,10,14,-1,-1,-8,-9,9,12,2,-1,-24,-11,1,2,-3,1,-1,2,3,4,1,1,0,1,1,4,1,0,-1,1,2,0,0,42,29,13,15,8,7,3,-5,8,28,10,-1,4,2,1,14,9,0,-1,-7,7,14,1,-1,2,0,4,5,3,1,1,-1,3,3,1,1,1,1,1,2,2,0,10,1,9,20,10,10,-3,3,-10,3,17,0,-8,-2,-6,3,11,1,5,5,-4,0,6,-1,3,4,3,2,6,2,1,2,1,1,4,1,2,2,2,1,2,1,-7,-15,8,15,1,14,-1,-5,-7,6,2,-1,-5,-4,-6,-2,4,1,4,-1,-1,8,-2,-2,5,1,1,6,1,1,0,0,0,1,0,0,5,1,1,5,1,1,4,4,0,5,5,0,0,-16,-7,1,7,19,-3,-6,-1,1,2,10,3,-10,-6,0,5,9,1,0,0,0,2,2,0,0,2,0,1,2,1,0,-2,0,1,0,16,11,5,7,4,3,2,-10,10,3,8,0,2,-6,5,4,4,0,0,-4,5,-1,4,0,2,0,1,3,1,0,3,0,1,0,0,0,-1,0,0,3,1,0,63,18,45,6,0,6,23,10,-2,-4,7,27,16,1,-1,-5,2,5,7,9,-1,1,5,22,2,4,-5,3,2,0,0,1,-3,1,1,0,2,3,-2,2,1,0,-16,-5,-11,-1,-1,0,-15,0,-14,-8,4,18,-8,1,-6,-6,5,11,-7,-1,-8,-2,-1,7,-1,-1,1,-2,2,0,0,-1,0,-1,1,0,-1,0,1,-1,1,0,-16,-3,-13,-5,0,-5,-2,-5,-1,6,-4,-7,-5,1,-1,9,-2,-2,3,-6,0,-3,-2,-5,-2,-3,-1,0,0,1,-2,-1,0,0,2,1,0,-2,-1,0,-2,0,-16,2,-18,2,5,-3,4,-10,-16,9,-3,-2,3,-1,-10,8,2,-1,1,-9,-6,1,-5,-1,3,-5,-1,5,2,-2,3,-1,-1,2,3,-1,0,-4,0,3,-1,-1,-20,-14,-6,-3,-3,0,-3,-11,-6,2,0,-2,1,-6,-5,-1,3,-5,-4,-5,-1,3,-3,3,0,-1,-3,0,1,-1,0,-1,-1,1,0,-2,0,0,-2,-1,1,1,31,21,10,3,1,2,13,-9,-5,6,21,7,5,-2,3,0,11,5,8,-7,-8,6,10,2,3,0,-3,3,-1,1,0,0,0,1,-1,1,3,0,-3,2,0,0,2,6,-4,2,2,0,-8,-9,1,12,1,5,-3,-6,6,4,1,4,-5,-3,-5,8,0,1,-1,1,-2,3,-1,2,0,0,-1,1,0,2,-1,1,-1,2,-1,0,-23,-4,-19,2,1,1,4,-11,-11,-6,-4,5,7,-4,-3,-5,-4,5,-3,-7,-8,-1,0,0,-1,-1,0,0,4,0,0,-1,-1,1,1,1,-1,0,1,-1,3,-1
11,11006,Arcos de la Frontera,27948,2,-14,16,3,2,1,26,-29,-7,3,10,-6,10,-20,-6,1,4,-7,16,-9,-1,2,6,1,0,0,1,0,2,0,0,0,0,0,2,0,0,0,1,0,0,0,69,20,49,9,4,5,26,-12,30,-12,9,28,21,-12,10,-16,6,13,5,0,20,4,3,15,2,0,4,0,1,1,1,0,1,0,1,0,1,0,3,0,0,1,89,50,39,-4,-5,1,16,-34,30,33,25,5,15,-11,7,23,10,3,1,-23,23,10,15,2,0,0,-6,1,2,-1,0,1,-6,0,1,-1,0,-1,0,1,1,0,197,115,82,15,9,6,65,7,72,25,20,4,29,5,48,16,13,2,36,2,24,9,7,2,0,-1,3,0,11,2,0,0,1,0,7,1,0,-1,2,0,4,1,227,115,112,81,48,33,62,10,67,43,15,32,34,8,35,24,11,6,28,2,32,19,4,26,20,8,17,19,15,2,13,3,12,11,8,1,7,5,5,8,7,1,357,195,162,135,72,63,98,7,82,93,42,26,56,-9,48,55,29,11,42,16,34,38,13,15,28,16,37,27,22,1,15,6,18,15,16,1,13,10,19,12,6,0,317,178,139,104,59,45,55,20,96,80,51,14,24,21,53,46,27,5,31,-1,43,34,24,9,12,16,24,20,27,4,5,9,15,11,15,4,7,7,9,9,12,0,333,192,141,107,59,48,69,36,82,48,34,60,49,21,40,28,25,25,20,15,42,20,9,35,25,24,26,20,15,-2,13,16,10,12,10,0,12,8,16,8,5,-2,18,11,7,79,50,29,11,-18,-20,15,24,6,20,-16,-1,-6,9,3,-9,-2,-19,21,15,3,33,10,11,8,14,2,27,4,7,2,8,1,6,6,4,6,6,1,141,98,43,76,48,28,27,-24,40,37,34,27,21,-14,16,31,25,16,6,-10,24,6,9,11,29,6,11,17,10,1,19,5,4,13,4,1,10,1,7,4,6,0,10,-14,24,53,27,26,21,-25,-10,2,26,-3,1,-20,-2,1,4,-1,20,-5,-8,1,22,-2,11,12,8,9,13,-1,5,8,3,7,5,-1,6,4,5,2,8,0,-87,-43,-44,74,28,46,-9,-34,-15,-10,-5,-5,-12,-23,0,-2,-1,-3,3,-11,-15,-8,-4,-2,19,19,22,4,5,4,9,9,10,0,-1,1,10,10,12,4,6,3,-17,-8,-9,22,8,14,-1,-15,5,-18,2,10,10,-16,-2,-14,8,3,-11,1,7,-4,-6,7,3,3,6,-1,9,1,-1,-1,1,1,6,1,4,4,5,-2,3,0,-61,-37,-24,17,10,7,-26,-8,-26,-31,15,6,-16,-5,-17,-14,6,5,-10,-3,-9,-17,9,1,3,2,-4,0,16,0,2,0,-1,2,7,0,1,2,-3,-2,9,0,-123,-82,-41,-72,-61,-11,19,-46,-95,-2,-9,7,8,-26,-61,-4,-3,2,11,-20,-34,2,-6,5,-6,-19,-18,-29,-3,3,-3,-17,-14,-22,-4,-1,-3,-2,-4,-7,1,4,-234,-120,-114,-171,-89,-82,-19,-61,-37,-81,-23,-7,-10,-40,-21,-34,-10,-2,-9,-21,-16,-47,-13,-5,-20,-14,-21,-53,-44,-19,-12,-7,-11,-24,-21,-14,-8,-7,-10,-29,-23,-5,-224,-112,-112,-50,-28,-22,-27,-39,-72,-64,-13,-8,-8,-18,-37,-45,-12,4,-19,-21,-35,-19,-1,-12,-8,-4,-8,-6,-17,-8,-4,-4,-7,-1,-13,-1,-4,0,-1,-5,-4,-7,-192,-126,-66,-25,-16,-9,10,-74,-100,1,-18,-12,10,-31,-67,-21,-8,-8,0,-43,-33,22,-10,-4,9,-4,-5,-9,-6,-12,4,2,-5,-14,0,-5,5,-6,0,5,-6,-7
11,11007,Barbate,22011,-56,-27,-29,68,39,29,-46,-18,-13,-1,24,0,-20,-2,-8,-8,15,-2,-26,-16,-5,7,9,2,10,13,17,14,12,1,4,8,9,9,8,0,6,5,8,5,4,1,45,19,26,84,45,39,14,-21,10,13,22,3,1,-17,1,16,14,1,13,-4,9,-3,8,2,30,3,23,14,9,2,12,2,11,11,6,0,18,1,12,3,3,2,0,23,-23,78,43,35,-5,-25,6,2,23,-5,11,-15,7,2,12,2,-16,-10,-1,0,11,-7,14,7,17,21,14,5,10,2,6,14,8,3,4,5,11,7,6,2,85,62,23,58,35,23,-6,-12,51,25,27,-2,2,-6,33,13,15,2,-8,-6,18,12,12,-4,18,0,20,10,5,5,11,1,13,3,4,3,7,-1,7,7,1,2,-18,-4,-14,83,45,38,36,-16,-45,16,-7,-2,7,7,-17,5,-8,0,29,-23,-28,11,1,-2,23,9,23,13,13,2,10,6,13,9,6,1,13,3,10,4,7,1,21,8,13,85,35,50,0,6,-15,13,25,-5,-6,-2,-4,7,16,0,6,8,-11,6,9,-5,14,13,28,14,12,3,6,5,10,5,5,3,8,8,18,9,7,0,-14,0,-14,91,45,46,-6,2,-30,13,10,-7,11,14,-21,1,-1,-4,-17,-12,-9,12,11,-3,18,23,17,20,10,1,11,14,10,5,5,0,7,9,7,15,5,1,20,22,-2,63,37,26,-5,-14,-6,37,28,-14,4,-3,-5,19,12,-2,-9,-11,-1,18,16,-12,0,18,13,13,14,5,0,10,9,9,6,3,0,8,4,4,8,2,87,29,58,48,14,34,28,9,9,16,32,-8,22,-9,-10,9,19,0,6,18,19,7,13,-8,11,6,17,-3,14,4,4,-3,12,-6,7,1,7,9,5,3,7,3,32,40,-8,26,21,5,26,-3,-32,42,3,-3,15,-2,-11,32,10,-3,11,-1,-21,10,-7,0,14,7,-4,10,-7,6,9,1,-3,11,-1,4,5,6,-1,-1,-6,2,-40,-17,-23,-29,-12,-17,-20,-1,-9,-16,8,-8,-18,-1,10,-7,1,-5,-2,0,-19,-9,7,-3,-1,0,-5,-16,-3,-4,-3,0,6,-8,-5,-2,2,0,-11,-8,2,-2,-85,-1,-84,23,12,11,-9,-9,-26,-14,-5,-20,2,3,-3,-2,6,-6,-11,-12,-23,-12,-11,-14,8,1,2,6,2,1,6,-3,2,5,0,1,2,4,0,1,2,0,-15,6,-21,28,18,10,-21,-7,-12,19,6,1,-10,0,2,15,-3,-1,-11,-7,-14,4,9,2,6,0,7,10,2,2,3,0,7,5,1,1,3,0,0,5,1,1,-41,-4,-37,13,6,7,-11,-18,1,4,-2,-8,0,-3,5,8,-7,-2,-11,-15,-4,-4,5,-6,6,3,8,0,0,-4,6,-1,5,1,-2,-3,0,4,3,-1,2,-1,-33,-23,-10,16,3,13,12,-37,-40,20,12,-1,16,-15,-31,8,0,-1,-4,-22,-9,12,12,0,5,-3,5,1,5,1,5,-3,-1,-1,2,0,0,0,6,2,3,1,-47,-15,-32,1,-3,4,14,-6,-39,-4,-1,-7,12,-4,-21,-8,8,1,2,-2,-18,4,-9,-8,2,2,1,-5,0,1,1,-2,-1,-2,0,1,1,4,2,-3,0,0,-81,-42,-39,24,13,11,-13,-23,-43,-10,9,-3,-5,-16,-18,-15,5,6,-8,-7,-25,5,4,-9,-2,5,5,5,9,0,-1,3,2,3,2,2,-1,2,3,2,7,-2,41,22,19,37,14,23,6,-2,6,25,20,-16,15,-3,-14,21,7,-5,-9,1,20,4,13,-11,6,4,10,3,8,2,5,0,7,1,-1,1,1,4,3,2,9,1
11,11008,"Barrios, Los",16511,331,169,162,77,47,30,73,41,125,52,25,11,44,29,53,22,12,7,29,12,72,30,13,4,6,20,21,15,12,3,5,14,16,5,5,2,1,6,5,10,7,1,422,208,214,115,59,56,55,81,191,43,36,17,27,31,99,22,24,7,28,50,92,21,12,10,19,30,20,21,16,8,9,11,14,10,9,5,10,19,6,11,7,3,442,247,195,113,58,55,62,60,194,60,36,22,45,27,101,38,19,11,17,33,93,22,17,11,21,23,29,14,22,4,10,12,15,6,11,4,11,11,14,8,11,0,621,300,321,106,53,53,134,82,253,77,37,26,77,20,123,45,17,10,57,62,130,32,20,16,37,10,24,19,15,0,21,3,14,9,5,1,16,7,10,10,10,-1,596,303,293,150,82,68,138,73,222,85,49,27,65,24,118,48,32,14,73,49,104,37,17,13,29,22,45,23,22,8,18,11,22,13,12,5,11,11,23,10,10,3,561,299,262,239,111,128,80,74,214,116,44,27,47,37,116,73,18,3,33,37,98,43,26,24,54,31,73,49,20,7,30,12,35,23,8,2,24,19,38,26,12,5,527,297,230,204,100,104,64,74,182,115,50,22,37,23,109,81,27,5,27,51,73,34,23,17,19,57,47,43,25,7,11,21,22,25,13,3,8,36,25,18,12,4,381,188,193,177,98,79,43,41,117,85,30,52,5,22,65,48,18,18,38,19,52,37,12,34,31,31,52,39,15,6,18,18,29,22,7,2,13,13,23,17,8,4,290,133,157,151,75,76,77,29,90,39,23,21,30,16,40,10,24,5,47,13,50,29,-1,16,38,30,41,23,11,5,19,15,21,9,7,2,19,15,20,14,4,3,154,76,78,91,46,45,24,8,57,10,31,14,28,-7,26,6,15,2,-4,15,31,4,16,12,15,17,24,25,1,3,9,8,11,15,1,0,6,9,13,10,0,3,127,54,73,80,35,45,35,3,40,5,2,36,5,5,24,7,-6,13,30,-2,16,-2,8,23,14,19,22,9,9,4,2,5,11,7,3,4,12,14,11,2,6,0,246,115,131,75,42,33,54,17,50,36,37,41,14,0,29,25,19,18,40,17,21,11,18,23,10,15,12,14,16,7,8,8,4,10,9,3,2,7,8,4,7,4,236,89,147,22,9,13,57,25,30,52,30,25,14,-1,1,36,19,9,43,26,29,16,11,16,2,5,-4,7,8,2,2,3,-6,0,6,2,0,2,2,7,2,0,44,35,9,47,21,26,5,19,3,-22,9,21,14,22,0,-21,8,7,-9,-3,3,-1,1,14,14,8,8,9,5,0,8,5,2,1,1,2,6,3,6,8,4,-2,157,107,50,18,16,2,62,-37,65,41,1,22,43,-13,18,38,7,10,19,-24,47,3,-6,12,4,-2,11,3,3,-2,5,-1,2,6,4,-1,-1,-1,9,-3,-1,-1,156,49,107,50,21,29,35,9,66,9,-2,38,9,-5,29,-3,0,17,26,14,37,12,-2,21,9,10,17,3,3,4,3,6,7,1,0,2,6,4,10,2,3,2,40,10,30,36,12,24,25,-12,14,-9,-9,37,1,2,8,10,-16,9,24,-14,6,-19,7,28,9,7,5,11,-2,4,2,4,3,5,-5,2,7,3,2,6,3,2,139,71,68,40,19,21,81,-13,48,-8,2,25,64,-9,20,-25,14,7,17,-4,28,17,-12,18,13,2,14,2,5,2,5,1,8,-3,5,2,8,1,6,5,0,0
11,11010,Bornos,8029,30,21,9,11,9,2,21,3,-2,8,-2,2,9,8,4,1,-1,0,12,-5,-6,7,-1,2,4,4,1,2,0,0,4,3,1,1,0,0,0,1,0,1,0,0,-26,-19,-7,2,1,1,-3,-28,-9,4,6,5,1,-18,-6,2,3,0,-4,-10,-3,2,3,5,0,0,0,2,0,0,0,0,0,1,0,0,0,0,0,1,0,0,36,19,17,10,6,4,28,-9,-1,16,-4,4,10,-2,0,12,-2,0,18,-7,-1,4,-2,4,3,1,3,1,0,1,3,1,1,1,0,0,0,0,2,0,0,1,-7,-9,2,9,2,7,6,-6,-7,0,3,-3,-2,-4,-1,-3,1,1,8,-2,-6,3,2,-4,3,1,3,0,1,1,0,0,1,0,0,1,3,1,2,0,1,0,11,3,8,10,6,4,10,-7,-15,16,9,-5,4,-2,-9,7,5,-3,6,-5,-6,9,4,-2,2,0,0,3,4,0,1,0,1,1,3,0,1,0,-1,2,1,0,-46,-1,-45,11,5,6,-9,-18,-12,-12,8,-3,-2,-3,0,-4,6,1,-7,-15,-12,-8,2,-4,0,2,0,0,7,2,0,0,0,0,4,1,0,2,0,0,3,1,-24,-14,-10,11,7,4,7,-14,-11,1,4,-10,-2,-1,-6,0,0,-4,9,-13,-5,1,4,-6,1,1,1,3,5,0,1,1,1,2,2,0,0,0,0,1,3,0,-18,-10,-8,13,4,9,-8,-6,-9,6,-3,1,-8,-6,1,8,-4,-1,0,0,-10,-2,1,2,4,1,3,5,0,-1,1,0,0,2,0,0,3,1,3,3,0,-1,-19,-12,-7,15,4,11,1,-8,2,-18,9,-3,2,-7,1,-13,6,0,-1,-1,1,-5,3,-3,5,1,3,2,3,1,2,0,0,1,1,0,3,1,3,1,2,1,-47,-31,-16,7,4,3,0,-11,-16,3,-11,-14,0,-7,-14,5,-5,-10,0,-4,-2,-2,-6,-4,3,-1,4,-1,0,2,3,0,0,0,0,1,0,-1,4,-1,0,1,-24,8,-32,-5,-1,-4,8,-14,-7,-4,-3,-5,3,-4,6,3,1,-1,5,-10,-13,-7,-4,-4,1,-1,-2,-1,-1,-1,2,0,-2,0,-1,0,-1,-1,0,-1,0,-1,-8,-11,3,1,-1,2,3,0,-13,1,5,-5,4,1,-9,-2,-2,-3,-1,-1,-4,3,7,-2,1,2,0,0,-1,-1,0,0,0,0,0,-1,1,2,0,0,-1,0,-19,-12,-7,9,3,6,-1,-12,-19,6,5,1,-4,-5,-11,3,3,1,3,-7,-8,3,2,0,3,2,0,2,2,0,1,1,-1,1,1,0,2,1,1,1,1,0,-57,-27,-30,-22,-13,-9,-15,-11,-18,-6,-4,-3,-3,-8,-6,-4,-3,-4,-12,-3,-12,-2,-1,1,-6,-4,0,-6,-4,-2,-1,-3,0,-4,-3,-2,-5,-1,0,-2,-1,0,-87,-42,-45,-5,-2,-3,-20,-14,-27,-9,-8,-4,-15,-6,-10,-6,-1,-2,-5,-8,-17,-3,-7,-2,-1,1,-2,-1,-2,0,-2,1,0,0,-1,0,1,0,-2,-1,-1,0,-54,-23,-31,2,2,0,-9,-6,-22,-13,5,-8,-11,-3,-1,-11,4,-1,2,-3,-21,-2,1,-7,0,2,1,0,2,-3,0,1,0,1,1,-1,0,1,1,-1,1,-2,-43,-11,-32,11,5,6,-2,-11,-23,-10,2,2,-3,0,-7,-3,1,1,1,-11,-16,-7,1,1,2,1,1,1,3,3,1,0,0,0,3,1,1,1,1,1,0,2,-47,-17,-30,-4,-6,2,-23,-9,-16,-9,13,-5,-14,-7,-1,-4,8,0,-9,-2,-15,-5,5,-5,0,0,-3,-1,0,0,-1,-1,-3,-1,0,0,1,1,0,0,0,0
11,11012,Cádiz,142449,-2390,-1317,-1073,244,138,106,-287,-569,-908,-323,-176,-99,-137,-294,-564,-160,-100,-43,-150,-275,-344,-163,-76,-56,28,47,84,42,30,12,10,29,52,28,13,6,18,18,32,14,17,6,-1453,-777,-676,138,83,55,-39,-305,-729,-162,-114,-85,-21,-154,-404,-97,-62,-33,-18,-151,-325,-65,-52,-52,25,26,33,31,14,7,14,16,19,19,8,5,11,10,14,12,6,2,-1929,-961,-968,95,58,37,-83,-466,-891,-156,-190,-100,-33,-226,-465,-82,-92,-36,-50,-240,-426,-74,-98,-64,29,16,0,22,11,16,16,5,8,13,9,7,13,11,-8,9,2,9,-1498,-799,-699,217,85,132,-53,-329,-770,-157,-102,-62,-45,-148,-423,-97,-42,-28,-8,-181,-347,-60,-60,-34,51,35,60,42,21,5,20,14,21,15,13,1,31,21,39,27,8,4,-1279,-621,-658,336,144,192,-68,-199,-749,-14,-118,-105,-33,-80,-358,-34,-59,-45,-35,-119,-391,20,-59,-60,52,72,104,57,37,10,21,23,51,26,14,6,31,49,53,31,23,4,-1088,-631,-457,356,170,186,69,-209,-626,-118,-99,-79,58,-95,-404,-78,-62,-36,11,-114,-222,-40,-37,-43,51,97,114,58,27,6,22,42,56,33,14,1,29,55,58,25,13,5,-1724,-908,-816,327,147,180,-72,-246,-1007,-150,-126,-72,-37,-110,-566,-73,-66,-34,-35,-136,-441,-77,-60,-38,51,88,89,55,27,13,25,41,42,23,10,5,26,47,47,32,17,8,-1266,-758,-508,235,95,140,52,-239,-816,-130,-66,-41,8,-121,-467,-113,-34,-17,44,-118,-349,-17,-32,-24,43,74,59,31,23,4,24,24,25,6,12,3,19,50,34,25,11,1,-274,-264,-10,286,131,155,124,-59,-320,47,0,-45,57,-45,-231,2,-2,-29,67,-14,-89,45,2,-16,45,71,106,49,8,4,37,33,35,22,0,4,8,38,71,27,8,0,-781,-459,-322,179,72,107,92,-114,-595,-27,-73,-41,51,-47,-343,-51,-28,-18,41,-67,-252,24,-45,-23,39,49,51,25,14,2,18,16,28,9,4,-1,21,33,23,16,10,3,-655,-405,-250,120,28,92,-8,-90,-414,2,-62,-74,17,-76,-263,5,-50,-30,-25,-14,-151,-3,-12,-44,23,61,15,6,9,1,16,17,-7,-3,3,-1,7,44,22,9,6,2,-592,-277,-315,148,84,64,120,-83,-401,-26,-86,-100,63,-20,-243,2,-44,-26,57,-63,-158,-28,-42,-74,37,60,28,11,0,7,27,30,7,14,0,3,10,30,21,-3,0,4,-485,-306,-179,38,6,32,96,-75,-403,-20,-26,-34,62,-44,-259,-31,-7,-9,34,-31,-144,11,-19,-25,26,23,-18,-8,5,8,19,4,-17,-14,9,4,7,19,-1,6,-4,4,-636,-365,-271,-50,-30,-20,1,-74,-321,-88,-75,-66,-8,-54,-194,-49,-34,-21,9,-20,-127,-39,-41,-45,9,4,-54,-11,-9,2,3,-6,-30,-2,-4,4,6,10,-24,-9,-5,-2,-489,-238,-251,128,55,73,44,-107,-291,-31,-10,-71,18,-50,-162,-12,0,-23,26,-57,-129,-19,-10,-48,26,29,24,23,17,6,16,9,1,17,7,3,10,20,23,6,10,3,-548,-236,-312,91,20,71,24,-65,-370,-52,-10,-58,44,-19,-222,-29,17,-8,-20,-46,-148,-23,-27,-50,26,32,-12,22,11,9,13,17,-27,6,7,4,13,15,15,16,4,5,-390,-262,-128,137,56,81,88,-52,-374,64,-19,-65,33,-29,-227,41,-24,-41,55,-23,-147,23,5,-24,47,46,-5,26,15,4,22,17,-5,14,7,-2,25,29,0,12,8,6,-419,-274,-145,190,91,99,51,-1,-367,12,13,-111,15,-8,-193,-36,1,-45,36,7,-174,48,12,-66,43,59,20,31,24,8,17,30,9,20,11,2,26,29,11,11,13,6
11,11013,Castellar de la Frontera,2483,24,8,16,10,4,6,5,-1,8,8,1,1,-3,2,3,5,1,1,8,-3,5,3,0,0,2,0,3,5,0,0,0,0,2,2,0,0,2,0,1,3,0,0,55,28,27,13,6,7,4,15,23,5,4,5,1,4,17,1,2,4,3,11,6,4,2,1,1,2,3,2,4,1,1,0,1,1,2,1,0,2,2,1,2,0,28,17,11,22,12,10,11,-9,14,5,4,1,10,-5,6,3,3,0,1,-4,8,2,1,1,7,1,7,6,1,0,4,0,3,4,1,0,3,1,4,2,0,0,131,63,68,27,17,10,27,14,40,32,9,8,9,10,21,14,6,3,18,4,19,18,3,5,5,2,7,9,2,2,2,2,5,6,1,1,3,0,2,3,1,1,24,16,8,23,12,11,4,5,-3,8,11,-1,4,1,-1,5,6,1,0,4,-2,3,5,-2,5,1,8,6,3,0,3,-1,5,4,1,0,2,2,3,2,2,0,32,19,13,26,16,10,5,19,4,1,4,1,-5,12,9,1,2,0,10,7,-5,0,2,1,7,5,6,6,1,1,4,3,4,4,0,1,3,2,2,2,1,0,29,15,14,19,11,8,9,6,2,13,2,-3,7,2,-1,4,3,-1,2,4,3,9,-1,-2,1,7,3,5,3,0,2,4,2,1,2,0,-1,3,1,4,1,0,96,59,37,44,26,18,25,21,25,25,-1,0,16,11,15,13,2,2,9,10,10,12,-3,-2,8,3,7,21,4,1,3,1,5,13,3,1,5,2,2,8,1,0,35,14,21,27,14,13,3,3,10,14,2,3,-2,2,2,12,0,0,5,1,8,2,2,3,5,8,10,0,4,0,1,3,6,1,3,0,4,5,4,-1,1,0,9,-1,10,11,6,5,2,-2,4,1,3,1,2,0,-3,-2,2,0,0,-2,7,3,1,1,2,1,0,7,3,-2,0,1,1,4,1,-1,2,0,-1,3,2,-1,6,0,6,-1,-2,1,2,2,2,2,2,-2,2,3,-1,3,-4,-1,0,-1,3,-1,6,-1,0,1,-2,-1,1,0,0,0,-1,-1,0,0,0,1,-1,0,1,0,5,11,-6,1,2,-1,4,8,0,-9,3,-3,5,4,0,-2,4,-1,-1,4,0,-7,-1,-2,0,1,0,1,-1,0,0,0,1,1,0,0,0,1,-1,0,-1,0,-89,-64,-25,-66,-46,-20,-2,-4,-39,-25,-23,3,-4,-3,-24,-17,-17,1,2,-1,-15,-8,-6,2,-4,-5,-15,-26,-18,1,-1,-2,-12,-15,-16,0,-3,-3,-3,-11,-2,1,-44,-22,-22,-18,-8,-10,-4,-12,-16,-6,-5,-1,-2,-4,-7,-7,-2,-1,-2,-8,-9,1,-3,0,-3,-5,-5,-7,1,1,0,-3,-3,-5,2,1,-3,-2,-2,-2,-1,0,-45,-19,-26,-22,-13,-9,-8,-16,0,-10,-9,-2,-4,-10,4,-4,-4,-1,-4,-6,-4,-6,-5,-1,0,-6,1,-6,-9,-2,0,-5,2,-4,-6,0,0,-1,-1,-2,-3,-2,2,-5,7,2,-1,3,1,-1,2,2,-1,0,-3,2,-3,3,-4,1,4,-3,5,-1,3,-1,2,-2,0,0,2,0,1,-2,-1,1,0,0,1,0,1,-1,2,0,-9,-16,7,4,4,0,0,-1,8,-20,3,0,-1,0,3,-18,2,-1,1,-1,5,-2,1,1,-1,1,2,-1,3,0,1,1,1,-1,2,0,-2,0,1,0,1,0,-22,-7,-15,10,3,7,-2,-4,1,-5,-7,-4,-1,1,0,0,-3,-3,-1,-5,1,-5,-4,-1,1,2,5,2,0,-1,1,1,1,0,0,-1,0,1,4,2,0,0
11,11015,Chiclana de la Frontera,57585,1377,688,689,39,23,16,220,206,487,233,160,53,126,79,241,112,95,26,94,127,246,121,65,27,6,3,13,7,8,1,4,2,8,5,4,0,2,1,5,2,4,1,981,496,485,21,10,11,168,133,337,205,101,35,72,59,182,110,56,17,96,74,155,95,45,18,7,1,5,3,4,1,3,1,3,1,2,0,4,0,2,2,2,1,1134,562,572,21,14,7,140,171,406,187,142,65,70,76,197,92,82,26,70,95,209,95,60,39,12,-5,1,1,7,5,7,-2,3,-2,4,4,5,-3,-2,3,3,1,1263,617,646,129,62,67,157,192,443,232,178,46,56,94,242,102,94,22,101,98,201,130,84,24,27,8,23,25,33,11,12,5,10,13,17,4,15,3,13,12,16,7,1605,800,805,511,253,258,237,230,441,296,270,100,99,114,205,169,151,53,138,116,236,127,119,47,86,56,98,104,127,32,42,26,39,56,66,19,44,30,59,48,61,13,1304,619,685,549,271,278,133,143,475,227,250,51,67,58,220,105,136,17,66,85,255,122,114,34,82,80,109,100,152,19,39,43,48,40,87,10,43,37,61,60,65,9,1243,639,604,565,288,277,182,162,383,248,229,12,93,57,194,141,128,16,89,105,189,107,101,-4,110,78,131,118,107,18,50,32,72,61,59,14,60,46,59,57,48,4,1154,586,568,465,225,240,189,187,318,170,195,83,92,81,185,83,103,36,97,106,133,87,92,47,92,64,93,77,107,26,46,25,48,33,51,18,46,39,45,44,56,8,453,225,228,212,98,114,32,85,114,94,93,33,32,37,45,51,48,6,0,48,69,43,45,27,30,51,30,36,55,6,22,27,6,12,23,5,8,24,24,24,32,1,813,342,471,162,58,104,104,105,247,99,158,81,41,14,135,35,76,33,63,91,112,64,82,48,21,25,31,18,44,19,7,7,12,1,19,9,14,18,19,17,25,10,813,390,423,196,87,109,165,55,243,146,104,87,72,31,113,74,50,35,93,24,130,72,54,52,42,28,35,43,37,7,15,8,21,19,18,5,27,20,14,24,19,2,687,372,315,23,24,-1,49,99,186,115,116,98,45,44,94,71,61,45,4,55,92,44,55,53,-2,5,-12,8,11,7,-1,4,-1,10,4,4,-1,1,-11,-2,7,3,589,322,267,83,44,39,98,91,139,53,103,76,37,60,100,22,60,29,61,31,39,31,43,47,-4,19,8,16,28,14,-6,6,10,10,15,8,2,13,-2,6,13,6,356,190,166,-10,-13,3,28,-2,111,42,112,63,40,-37,65,24,66,33,-12,35,46,18,46,30,-6,0,-15,-13,13,7,-7,-3,-4,-11,9,2,1,3,-11,-2,4,5,210,102,108,29,6,23,13,-31,17,21,125,32,9,-12,27,1,62,10,4,-19,-10,20,63,22,13,-8,-6,0,23,0,7,-4,-12,-4,14,2,6,-4,6,4,9,-2,190,56,134,82,45,37,33,4,18,-2,81,51,1,5,-22,10,48,14,32,-1,40,-12,33,37,26,10,-4,13,25,9,17,3,-7,7,19,6,9,7,3,6,6,3,272,144,128,65,32,33,21,-41,50,75,110,49,44,-40,-3,50,62,30,-23,-1,53,25,48,19,8,-3,-5,4,39,18,7,-2,-7,0,19,13,1,-1,2,4,20,5,-370,-271,-99,-535,-299,-236,33,-110,-6,-137,-45,-128,8,-68,-27,-103,-22,-69,25,-42,21,-34,-23,-59,-18,-52,-51,-165,-113,-140,-13,-25,-24,-103,-66,-68,-5,-27,-27,-62,-47,-72
11,11016,Chipiona,16200,126,62,64,9,3,6,-2,15,17,33,43,11,4,1,6,20,20,6,-6,14,11,13,23,5,1,1,1,0,5,1,1,0,0,0,2,0,0,1,1,0,3,1,104,35,69,5,3,2,4,23,34,16,20,6,-5,10,13,10,11,-4,9,13,21,6,9,10,0,0,2,1,2,0,0,0,2,0,1,0,0,0,0,1,1,0,39,44,-5,-3,-3,0,-20,-18,19,31,16,9,-12,-1,17,23,11,4,-8,-17,2,8,5,5,0,-2,-6,2,3,0,0,-1,-3,0,1,0,0,-1,-3,2,2,0,154,68,86,13,5,8,20,5,48,20,51,6,11,0,17,11,22,5,9,5,31,9,29,1,4,0,5,-1,4,1,3,0,1,-1,1,1,1,0,4,0,3,0,98,7,91,48,17,31,12,13,-18,28,45,17,-15,-3,-13,6,24,8,27,16,-5,22,21,9,6,5,12,11,13,1,1,2,4,4,6,0,5,3,8,7,7,1,45,0,45,46,20,26,15,2,9,16,1,0,-10,-1,-5,11,8,-2,25,3,14,5,-7,2,3,5,13,11,8,4,1,3,4,6,4,2,2,2,9,5,4,2,178,113,65,46,23,23,19,7,7,69,55,22,17,12,-3,41,36,13,2,-5,10,28,19,9,4,8,7,16,11,1,6,4,1,7,4,1,-2,4,6,9,7,0,161,83,78,59,31,28,29,16,45,29,30,11,18,3,25,18,14,5,11,13,20,11,16,6,9,7,19,9,13,2,4,4,10,6,6,1,5,3,9,3,7,1,43,24,19,46,22,24,19,-3,-18,13,27,6,8,3,-3,4,13,2,11,-6,-15,9,14,4,12,5,12,8,6,3,6,2,8,2,3,1,6,3,4,6,3,2,50,27,23,25,13,12,8,11,-5,4,26,8,0,2,3,3,14,7,8,9,-8,1,12,1,2,8,10,1,5,-1,0,2,6,0,5,0,2,6,4,1,0,-1,82,25,57,39,24,15,24,11,22,-3,15,10,8,1,11,-11,9,8,16,10,11,8,6,2,13,6,5,10,4,1,9,1,6,5,2,1,4,5,-1,5,2,0,-63,-27,-36,4,-6,10,-27,-21,-18,3,13,-11,-19,-5,-13,13,4,-4,-8,-16,-5,-10,9,-7,0,-5,2,-6,9,3,-2,-5,1,-4,2,2,2,0,1,-2,7,1,22,23,-1,-22,-10,-12,13,0,-13,-14,37,-1,15,-3,-3,-13,22,7,-2,3,-10,-1,15,-8,2,-4,-9,-9,-1,-1,4,-4,-4,-7,1,0,-2,0,-5,-2,-2,-1,37,26,11,-33,-12,-21,15,0,10,-8,-1,16,6,7,7,-4,0,7,9,-7,3,-4,-1,9,8,-1,-1,-21,-17,-4,7,-1,2,-12,-9,-2,1,0,-3,-9,-8,-2,-15,-21,6,6,-3,9,7,1,-32,1,11,-4,5,-3,-24,2,8,-8,2,4,-8,-1,3,4,10,4,1,-7,-3,1,6,1,0,-6,-3,-1,4,3,1,-1,0,2,-13,-12,-1,44,24,20,16,0,-22,-11,20,-14,8,7,-14,-9,9,-11,8,-7,-8,-2,11,-3,20,6,8,0,6,3,13,7,0,-2,2,4,7,-1,8,2,4,-1,-4,17,-21,11,8,3,20,-15,-37,17,12,1,14,-6,-10,12,6,2,6,-9,-27,5,6,-1,2,2,6,0,0,1,3,-1,5,-1,-1,3,-1,3,1,1,1,-2,-42,-35,-7,-9,-11,2,-20,-3,-32,3,12,-6,-11,-4,-27,6,8,-8,-9,1,-5,-3,4,2,-8,4,-13,1,4,3,-6,1,-8,0,0,2,-2,3,-5,1,4,1
11,11014,Conil de la Frontera,17470,196,105,91,81,36,45,24,26,38,51,43,12,8,14,28,22,25,7,16,12,10,29,18,5,10,3,22,21,21,3,4,1,9,9,12,1,6,2,13,12,9,2,130,74,56,61,31,30,24,9,29,23,36,10,11,14,18,12,15,5,13,-5,11,11,21,5,13,14,12,14,5,3,3,10,7,7,3,1,10,4,5,7,2,2,253,119,134,100,57,43,58,44,44,67,31,8,25,12,27,37,18,1,33,32,17,30,13,7,15,13,24,23,20,4,5,7,18,11,14,1,10,6,6,12,6,3,300,166,134,89,45,44,68,26,85,82,29,7,43,13,48,40,15,5,25,13,37,42,14,2,12,10,31,21,14,0,6,3,16,11,8,0,6,7,15,10,6,0,309,150,159,134,63,71,43,23,116,64,49,11,17,7,49,43,27,7,26,16,67,21,22,4,22,14,33,33,25,7,9,8,14,18,11,3,13,6,19,15,14,4,340,192,148,134,66,68,59,38,103,100,28,8,27,20,61,58,19,6,32,18,42,42,9,2,19,17,42,32,17,4,5,10,22,17,8,2,14,7,20,15,9,2,347,177,170,186,95,91,64,72,82,90,38,2,43,36,35,42,21,3,21,36,47,48,17,-1,41,35,49,45,12,3,27,14,24,21,4,4,14,21,25,24,8,-1,307,183,124,158,89,69,42,32,112,79,29,9,16,14,70,50,22,9,26,18,42,29,7,0,18,26,53,33,18,11,8,14,28,21,11,7,10,12,25,12,7,4,144,43,101,89,32,57,35,10,42,46,5,4,20,1,11,10,-2,3,15,9,31,36,7,1,20,13,18,22,12,2,12,2,4,8,4,1,8,11,14,14,8,1,230,115,115,85,40,45,43,41,23,50,52,20,16,12,21,33,23,10,27,29,2,17,29,10,9,16,20,18,15,7,4,8,11,7,8,2,5,8,9,11,7,5,206,102,104,74,36,38,24,2,48,65,47,13,20,-1,37,9,34,3,4,3,11,56,13,10,16,15,13,18,9,3,14,7,7,4,4,0,2,8,6,14,5,3,158,108,50,72,39,33,15,13,46,19,36,29,15,8,28,27,10,18,0,5,18,-8,26,11,17,3,20,17,10,4,7,-1,9,17,4,2,10,4,11,0,6,2,92,47,45,-1,2,-3,13,10,-28,17,39,39,14,8,-15,3,20,18,-1,2,-13,14,19,21,-2,11,-11,-9,-3,13,-3,4,-2,-6,3,6,1,7,-9,-3,-6,7,-79,-52,-27,-127,-67,-60,-2,-12,-39,-25,26,-26,-9,-1,-39,-7,20,-15,7,-11,0,-18,6,-11,-14,-9,-27,-46,-8,-23,-9,-2,-22,-19,-3,-12,-5,-7,-5,-27,-5,-11,-42,-19,-23,-47,-28,-19,-23,5,18,-31,-1,-12,-16,2,13,-9,-6,-2,-7,3,5,-22,5,-10,-1,5,-2,-20,-14,-16,-6,4,4,-15,-9,-6,5,1,-6,-5,-5,-10,120,58,62,27,7,20,42,-17,39,34,12,10,19,-18,24,13,16,6,23,1,15,21,-4,4,15,1,0,1,8,1,8,-2,0,-4,6,-1,7,3,0,5,2,2,136,59,77,25,12,13,45,5,9,32,33,7,27,0,-14,24,14,6,18,5,23,8,19,1,1,5,-5,2,11,10,-2,5,-6,2,6,6,3,0,1,0,5,4,27,32,-5,60,32,28,9,-6,19,23,-7,-12,3,1,14,23,-9,-2,6,-7,5,0,2,-10,15,5,16,17,1,2,7,3,10,11,-3,2,8,2,6,6,4,0
11,11020,Jerez de la Frontera,182660,-216,-215,-1,64,30,34,132,-465,92,-25,14,26,60,-276,1,-18,5,8,72,-189,91,-7,9,18,14,3,17,9,13,8,7,1,9,5,5,3,7,2,8,4,8,5,196,47,149,32,18,14,186,-189,98,55,36,7,77,-98,10,26,18,8,109,-91,88,29,18,-1,9,2,7,4,4,2,6,2,3,1,2,2,3,0,4,3,2,0,1109,552,557,-46,-18,-28,439,-47,404,179,61,52,237,-66,213,99,34,24,202,19,191,80,27,28,8,-25,-46,2,11,2,4,-9,-13,-4,4,-1,4,-16,-33,6,7,3,902,452,450,114,58,56,279,-34,366,178,84,21,164,-50,170,105,50,5,115,16,196,73,34,16,40,12,20,13,21,7,22,2,10,7,12,4,18,10,10,6,9,3,1988,912,1076,603,262,341,419,225,755,348,177,41,214,59,339,169,88,33,205,166,416,179,89,8,110,129,182,118,46,10,52,56,71,51,22,6,58,73,111,67,24,4,1598,717,881,717,302,415,402,204,501,269,164,54,231,28,211,124,91,34,171,176,290,145,73,20,128,156,229,126,60,6,60,54,92,58,35,2,68,102,137,68,25,4,2068,975,1093,889,388,501,474,279,707,398,162,37,244,64,353,227,59,22,230,215,354,171,103,15,162,200,278,156,70,16,77,85,128,69,19,9,85,115,150,87,51,7,1595,769,826,753,359,394,337,258,506,339,131,6,182,109,208,175,74,5,155,149,298,164,57,1,150,190,194,143,54,15,86,86,87,68,24,5,64,104,107,75,30,10,1147,588,559,515,234,281,228,57,477,249,110,17,117,11,261,131,55,12,111,46,216,118,55,5,72,125,176,80,40,13,40,49,87,30,19,4,32,76,89,50,21,9,628,345,283,407,187,220,127,35,200,170,69,28,73,3,102,91,56,21,54,32,98,79,13,7,83,96,104,79,34,7,46,42,39,41,13,4,37,54,65,38,21,3,1146,583,563,433,223,210,282,199,215,283,120,25,135,96,102,162,54,22,147,103,113,121,66,3,107,116,92,77,34,3,61,60,47,38,14,3,46,56,45,39,20,0,502,207,295,368,179,189,66,51,135,145,90,12,31,15,40,80,36,5,35,36,95,65,54,7,81,81,92,48,47,13,43,38,48,21,20,9,38,43,44,27,27,4,-13,12,-25,272,135,137,59,10,-41,-64,57,-8,74,-12,-25,-41,26,9,-15,22,-16,-23,31,-17,67,81,47,19,38,14,39,44,15,7,20,8,28,37,32,12,18,6,-157,-52,-105,-55,-46,-9,70,-41,-104,-81,13,-2,41,-15,-30,-69,18,8,29,-26,-74,-12,-5,-10,21,32,-32,-59,-11,-16,3,15,-25,-32,-5,-5,18,17,-7,-27,-6,-11,-155,-143,-12,3,-29,32,63,-121,-131,-37,67,23,7,-76,-105,-5,38,5,56,-45,-26,-32,29,18,16,36,-30,-21,2,-5,2,10,-21,-22,2,-2,14,26,-9,1,0,-3,-854,-469,-385,-402,-205,-197,-72,-137,-356,-231,-61,17,-27,-70,-232,-134,-19,16,-45,-67,-124,-97,-42,1,-22,33,-157,-191,-38,-29,-10,17,-88,-108,-7,-10,-12,16,-69,-83,-31,-19,-127,-195,68,169,63,106,14,-82,-119,-95,82,68,-15,-46,-90,-109,27,27,29,-36,-29,14,55,41,58,48,-9,0,36,23,36,25,-8,-16,11,11,22,23,-1,16,25,12,-282,-257,-25,491,269,222,-10,-96,-99,-132,27,29,-25,-34,-125,-92,-4,21,15,-62,26,-40,31,8,84,169,98,63,46,19,51,123,41,25,13,10,33,46,57,38,33,9
11,11022,"Línea de la Concepción, La",59828,-109,-39,-70,121,62,59,-26,2,-69,-21,7,4,-11,3,-35,-15,16,8,-15,-1,-34,-6,-9,-4,24,7,36,15,28,11,13,5,15,7,16,6,11,2,21,8,12,5,-3,20,-23,53,31,22,32,0,-43,6,2,-4,18,11,-24,1,9,1,14,-11,-19,5,-7,-5,18,5,11,8,9,2,13,2,3,3,9,1,5,3,8,5,0,1,-17,52,-69,-1,-7,6,-14,2,-10,0,6,8,20,12,12,0,3,11,-34,-10,-22,0,3,-3,5,-2,-10,-1,4,3,2,-2,-6,-4,1,2,3,0,-4,3,3,1,24,29,-5,33,17,16,-24,-12,57,8,-2,1,-5,-15,51,-4,9,-1,-19,3,6,12,-11,2,7,2,4,9,7,4,3,0,1,7,4,2,4,2,3,2,3,2,575,339,236,612,339,273,157,72,124,129,75,13,101,49,62,77,37,7,56,23,62,52,38,6,123,99,163,127,64,25,73,53,79,79,36,12,50,46,84,48,28,13,504,294,210,563,325,238,83,46,142,133,57,41,32,27,90,93,29,16,51,19,52,40,28,25,81,90,169,125,64,30,48,45,96,85,36,13,33,45,73,40,28,17,523,284,239,803,435,368,75,64,165,119,89,3,42,27,96,56,48,12,33,37,69,63,41,-9,117,144,243,167,96,22,68,66,136,94,53,13,49,78,107,73,43,9,344,217,127,610,351,259,59,39,125,84,36,-3,42,15,84,57,16,1,17,24,41,27,20,-4,124,123,174,132,42,5,79,68,97,80,19,3,45,55,77,52,23,2,492,302,190,592,356,236,83,111,125,139,49,-19,44,47,80,103,28,1,39,64,45,36,21,-20,103,108,163,129,65,13,67,47,110,83,38,7,36,61,53,46,27,6,66,77,-11,340,206,134,9,-29,68,17,21,-20,12,-17,41,21,20,-3,-3,-12,27,-4,1,-17,57,54,106,71,37,2,37,35,49,50,23,4,20,19,57,21,14,-2,61,9,52,298,152,146,56,9,-31,37,8,-3,13,11,-19,-1,10,0,43,-2,-12,38,-2,-3,63,43,102,57,13,15,26,23,60,26,8,6,37,20,42,31,5,9,233,132,101,385,205,180,54,35,42,51,84,-33,38,21,5,14,57,-2,16,14,37,37,27,-31,35,70,143,61,55,10,20,35,71,38,29,5,15,35,72,23,26,5,315,150,165,275,143,132,94,14,178,53,-3,-25,42,13,76,35,-5,-10,52,1,102,18,2,-15,58,31,128,34,15,0,24,14,66,24,11,-1,34,17,62,10,4,1,76,77,-1,297,163,134,-1,3,96,13,-3,-39,16,8,47,16,4,-17,-17,-5,49,-3,-7,-22,31,39,140,54,18,3,19,25,71,31,11,0,12,14,69,23,7,3,241,101,140,328,177,151,22,33,104,51,29,-31,2,8,53,10,25,-10,20,25,51,41,4,-21,16,33,154,63,34,5,8,21,83,29,21,3,8,12,71,34,13,2,190,185,5,428,243,185,-25,66,123,29,18,-37,1,50,82,51,6,-10,-26,16,41,-22,12,-27,37,68,180,85,32,5,25,42,89,56,18,6,12,26,91,29,14,-1,221,138,83,453,245,208,16,59,122,51,10,-51,10,30,58,41,8,-16,6,29,64,10,2,-35,44,73,175,104,27,14,25,41,79,64,16,12,19,32,96,40,11,2,128,75,53,457,224,233,-47,54,116,15,5,-20,-16,13,72,9,6,-8,-31,41,44,6,-1,-12,39,79,183,86,39,19,22,32,95,35,26,9,17,47,88,51,13,10
11,11023,Medina-Sidonia,10844,1,17,-16,9,8,1,-7,-19,8,-17,9,24,2,-8,12,-10,10,10,-9,-11,-4,-7,-1,14,1,2,6,0,0,0,0,2,6,0,0,0,1,0,0,0,0,0,-7,1,-8,8,5,3,0,-10,-25,1,11,17,1,-14,-7,4,8,10,-1,4,-18,-3,3,7,7,1,0,0,0,0,5,0,0,0,0,0,2,1,0,0,0,0,31,28,3,15,9,6,7,-11,0,10,15,10,4,-3,3,6,10,8,3,-8,-3,4,5,2,3,4,6,2,0,0,1,2,4,3,-1,0,2,2,2,-1,1,0,19,28,-9,34,20,14,7,-20,-10,15,14,16,12,-5,-5,8,9,11,-5,-15,-5,7,5,5,5,10,7,6,5,0,3,7,3,3,3,0,2,3,4,3,2,0,78,33,45,53,27,26,25,3,12,26,15,-3,11,5,-1,13,10,-6,14,-2,13,13,5,3,8,10,8,14,11,2,3,5,5,8,5,1,5,5,3,6,6,1,122,73,49,49,25,24,23,10,33,27,21,5,8,9,23,15,11,4,15,1,10,12,10,1,5,12,14,8,7,1,4,5,8,2,4,1,1,7,6,6,3,0,107,54,53,66,33,33,22,7,49,11,7,9,10,0,22,12,4,4,12,7,27,-1,3,5,12,11,20,11,8,3,4,5,9,8,5,1,8,6,11,3,3,2,123,49,74,60,28,32,29,7,28,33,18,5,12,-1,10,15,10,3,17,8,18,18,8,2,15,7,14,10,12,0,10,3,5,4,5,0,5,4,9,6,7,0,80,48,32,27,10,17,20,14,6,26,16,-1,12,12,-2,14,12,1,8,2,8,12,4,-2,7,3,4,8,5,0,2,1,0,4,3,0,5,2,4,4,2,0,45,24,21,26,9,17,7,4,12,14,16,-6,3,-3,6,5,14,1,4,7,6,9,2,-7,9,2,1,12,4,-2,4,0,-1,4,3,-1,5,2,2,8,1,-1,75,34,41,20,7,13,17,-7,10,2,18,24,8,-9,7,1,9,13,9,2,3,1,9,11,7,2,5,4,3,-2,2,1,0,2,2,0,5,1,5,2,1,-2,22,8,14,14,5,9,-2,4,11,-4,-2,15,-2,-1,0,4,-3,10,0,5,11,-8,1,5,2,1,6,3,2,0,1,0,1,3,0,0,1,1,5,0,2,0,27,6,21,14,5,9,-8,-4,-9,19,13,16,-2,-7,-11,10,6,6,-6,3,2,9,7,10,-1,1,7,2,3,2,0,-1,2,1,2,1,-1,2,5,1,1,1,6,-1,7,11,5,6,-8,-4,14,-11,10,10,-9,-5,10,-3,4,4,1,1,4,-8,6,6,4,-1,1,4,2,1,1,-1,0,3,1,1,3,0,1,1,1,0,-14,-6,-8,16,10,6,-3,-11,-18,-1,2,13,1,-5,-8,-3,3,5,-4,-6,-10,2,-1,8,0,3,7,6,1,-1,2,2,3,3,1,-1,-2,1,4,3,0,0,-2,0,-2,-12,1,-13,2,-17,-23,26,3,10,4,-9,-18,19,-2,6,-2,-8,-5,7,5,4,-1,0,-14,2,1,-2,2,1,-5,1,1,0,-3,-1,-9,1,0,-2,-23,-15,-8,1,1,0,6,-2,-23,-27,17,3,1,-3,-11,-13,11,0,5,1,-12,-14,6,3,2,-1,5,-6,0,1,1,0,4,-6,1,1,1,-1,1,0,-1,0,-74,-53,-21,11,2,9,-9,-2,-32,-18,-10,-2,-6,-2,-24,-16,-4,-3,-3,0,-8,-2,-6,1,-1,4,4,3,2,-1,-1,2,0,1,1,-1,0,2,4,2,1,0
11,11024,Olvera,8818,-109,-59,-50,12,6,6,-16,-41,-27,-22,7,-10,-9,-21,-15,-14,3,-5,-7,-20,-12,-8,4,-5,1,0,5,0,4,1,0,0,3,0,2,0,1,0,2,0,2,1,-30,-14,-16,2,1,1,0,-12,-19,-5,7,-1,-1,-4,-7,-3,3,-2,1,-8,-12,-2,4,1,0,0,1,1,0,0,0,0,0,1,0,0,0,0,1,0,0,0,-67,-45,-22,0,1,-1,-2,-42,-20,-3,1,-4,-5,-28,-8,-1,0,-2,3,-14,-12,-2,1,-2,0,-1,-1,0,2,0,0,-1,1,0,1,0,0,0,-2,0,1,0,-29,-31,2,9,5,4,-8,-8,-33,9,13,-4,-10,-6,-28,6,7,-1,2,-2,-5,3,6,-3,0,1,2,-1,7,0,0,0,2,-1,4,0,0,1,0,0,3,0,54,20,34,41,20,21,12,-7,5,6,26,8,3,-4,2,1,10,6,9,-3,3,5,16,2,3,3,6,8,19,2,0,1,4,2,11,2,3,2,2,6,8,0,27,17,10,35,20,15,6,-3,-6,23,10,-5,4,-1,-5,15,5,-3,2,-2,-1,8,5,-2,1,2,7,12,10,3,1,1,5,7,4,2,0,1,2,5,6,1,48,35,13,51,29,22,27,-1,-2,13,4,6,14,1,4,10,1,5,13,-2,-6,3,3,1,13,4,4,16,10,2,7,3,2,9,7,1,6,1,2,7,3,1,-33,-11,-22,36,19,17,3,-14,-23,-1,17,-18,6,-7,-19,2,14,-8,-3,-7,-4,-3,3,-10,4,5,4,7,14,0,4,3,0,3,8,0,0,2,4,4,6,0,-41,-21,-20,22,9,13,-8,-8,-21,-1,-2,-2,-9,-2,-8,0,-3,2,1,-6,-13,-1,1,-4,3,1,2,4,7,5,0,0,0,3,3,3,3,1,2,1,4,2,-8,-1,-7,22,10,12,-3,-8,-8,1,11,-3,-2,-1,-4,-4,7,2,-1,-7,-4,5,4,-5,2,1,2,6,8,2,0,0,1,3,4,1,2,1,1,3,4,1,-40,-35,-5,-18,-14,-4,3,-4,-29,-14,-3,10,3,-4,-24,-6,-5,1,0,0,-5,-8,2,9,-6,-2,-1,-12,-2,5,-1,-3,-5,-5,-4,4,-5,1,4,-7,2,1,-41,-15,-26,14,5,9,-6,-15,-15,0,2,-1,-4,-7,-6,6,-1,1,-2,-8,-9,-6,3,-2,-1,2,3,0,6,4,0,1,0,-1,3,2,-1,1,3,1,3,2,-17,-11,-6,13,6,7,-3,0,-7,-10,8,-7,-6,2,-3,-5,4,-2,3,-2,-4,-5,4,-5,0,2,-1,4,5,3,0,1,-1,1,2,3,0,1,0,3,3,0,-12,-20,8,6,0,6,10,-16,1,-4,3,-7,5,-13,-2,-4,0,-5,5,-3,3,0,3,-2,-2,2,3,3,2,-2,0,-1,2,0,0,-1,-2,3,1,3,2,-1,-53,-21,-32,-14,-9,-5,-3,-23,-14,-7,0,-6,-1,-7,-4,-4,-4,-1,-2,-16,-10,-3,4,-5,0,0,-8,-3,-1,-2,0,-1,-4,-2,-1,-1,0,1,-4,-1,0,-1,-28,-12,-16,-6,-6,0,-8,-6,-15,2,3,-2,-3,-1,-10,-3,5,1,-5,-5,-5,5,-2,-3,-3,2,-2,0,-2,-1,0,-1,-1,-2,-1,-1,-3,3,-1,2,-1,0,-50,-27,-23,10,2,8,-10,-16,-30,-6,10,0,-6,-4,-15,-6,5,-3,-4,-12,-15,0,5,3,2,-1,1,-4,12,0,1,-1,0,-2,5,-1,1,0,1,-2,7,1,-15,-14,-1,23,6,17,8,-4,-18,8,5,-12,-1,-5,-8,0,7,-7,9,1,-10,8,-2,-5,1,10,0,6,3,3,0,3,0,1,2,0,1,7,0,5,1,3
11,11026,Prado del Rey,5814,-20,-15,-5,9,2,7,-1,-7,-10,-1,-1,0,-2,-9,-2,-1,-3,1,1,2,-8,0,2,-1,1,2,2,2,1,1,0,0,1,0,0,1,1,2,1,2,1,0,-10,-2,-8,8,4,4,-5,-4,-6,-1,3,4,1,-4,-2,1,1,2,-6,0,-4,-2,2,2,3,1,3,0,1,0,3,0,1,0,0,0,0,1,2,0,1,0,7,10,-3,12,7,5,-2,-4,7,1,3,3,4,0,3,-3,6,1,-6,-4,4,4,-3,2,4,4,-1,4,1,0,3,2,0,1,1,0,1,2,-1,3,0,0,6,7,-1,11,6,5,-5,-6,14,-2,5,-3,-4,-8,12,1,3,0,-1,2,2,-3,2,-3,4,2,3,2,0,0,2,1,2,1,0,0,2,1,1,1,0,0,64,40,24,8,5,3,20,-6,21,17,7,4,18,-5,9,11,5,2,2,-1,12,6,2,2,2,1,2,1,2,0,2,0,1,1,1,0,0,1,1,0,1,0,10,5,5,6,2,4,0,-10,11,4,3,-1,0,-5,4,3,1,-1,0,-5,7,1,2,0,3,0,2,1,0,0,2,0,0,0,0,0,1,0,2,1,0,0,-9,-5,-4,8,3,5,6,-8,-1,-4,6,-7,-1,-3,6,-6,4,-3,7,-5,-7,2,2,-4,2,1,2,3,0,0,0,0,1,2,0,0,2,1,1,1,0,0,-5,-4,-1,-2,-1,-1,-1,-5,-6,8,4,-3,0,-2,-4,6,2,-4,-1,-3,-2,2,2,1,-1,-2,1,0,0,0,0,0,-1,0,0,0,-1,-2,2,0,0,0,-35,-14,-21,11,5,6,-3,3,-21,-7,-2,-4,-6,3,-2,-5,-2,-3,3,0,-19,-2,0,-1,4,2,1,3,0,1,2,0,1,2,0,0,2,2,0,1,0,1,-34,-24,-10,8,4,4,-4,-5,-17,-4,0,-4,-3,-4,-10,-4,-1,-1,-1,-1,-7,0,1,-3,1,2,2,1,0,2,0,0,2,1,0,1,1,2,0,0,0,1,-18,0,-18,8,7,1,1,-10,3,-6,0,-4,3,-4,2,3,2,-3,-2,-6,1,-9,-2,-1,0,2,1,0,3,2,0,2,2,0,1,2,0,0,-1,0,2,0,8,0,8,2,1,1,6,2,-3,1,-1,5,-1,-6,3,4,-2,3,7,8,-6,-3,1,2,0,1,0,0,1,0,0,0,0,0,1,0,0,1,0,0,0,0,-1,9,-10,5,4,1,-1,-4,-8,4,4,1,3,-1,2,-1,3,2,-4,-3,-10,5,1,-1,0,0,0,1,4,0,0,0,0,1,3,0,0,0,0,0,1,0,-55,-19,-36,5,3,2,-11,-6,-18,-5,-5,-8,-5,0,-4,-1,-3,-4,-6,-6,-14,-4,-2,-4,2,0,3,-1,0,0,1,0,3,-1,0,0,1,0,0,0,0,0,-62,-27,-35,2,3,-1,-18,-11,-23,-11,1,-1,-10,-2,-8,-7,-2,1,-8,-9,-15,-4,3,-2,0,0,0,2,0,0,0,0,1,2,0,0,0,0,-1,0,0,0,-20,-4,-16,8,4,4,-2,-4,0,-14,2,-5,0,-1,2,-4,1,-4,-2,-3,-2,-10,1,-1,0,0,5,2,1,0,0,0,3,1,0,0,0,0,2,1,1,0,-44,-33,-11,3,2,1,-1,-15,-20,-6,-2,-2,-4,-9,-12,-6,-2,-1,3,-6,-8,0,0,-1,0,3,0,-1,1,0,0,1,0,1,0,0,0,2,0,-2,1,0,-37,-15,-22,5,4,1,-7,-13,-20,-4,1,6,-2,-1,-14,-1,3,0,-5,-12,-6,-3,-2,6,3,-1,0,0,2,1,3,0,-1,0,1,1,0,-1,1,0,1,0
11,11027,"Puerto de Santa María, El",75097,311,134,177,50,25,25,81,-31,164,45,39,14,46,-21,71,16,15,6,35,-10,93,29,24,8,9,6,15,5,10,5,3,3,9,2,7,1,6,3,6,3,3,4,205,118,87,38,19,19,4,-28,98,63,46,17,10,-16,63,30,23,5,-6,-12,35,33,23,12,12,3,9,7,6,1,4,3,4,4,4,0,8,0,5,3,2,1,408,165,243,-13,5,-18,101,-33,167,60,57,55,35,-7,64,23,31,22,66,-26,103,37,26,33,12,-15,-17,-10,5,9,9,-1,-7,-6,4,5,3,-14,-10,-4,1,4,437,247,190,80,33,47,124,-48,150,105,85,16,79,-26,82,61,26,15,45,-22,68,44,59,1,26,6,19,15,11,3,12,3,6,7,3,2,14,3,13,8,8,1,1073,475,598,644,277,367,170,66,455,177,121,72,89,-12,216,85,66,29,81,78,239,92,55,43,127,110,183,143,62,11,67,30,69,64,39,6,60,80,114,79,23,5,952,428,524,556,243,313,149,173,349,184,58,20,62,64,146,107,28,9,87,109,203,77,30,11,78,127,190,110,40,3,40,33,88,56,18,2,38,94,102,54,22,1,963,381,582,567,257,310,269,77,283,192,71,41,113,12,122,66,40,16,156,65,161,126,31,25,118,119,177,89,45,12,57,44,85,35,24,6,61,75,92,54,21,6,613,316,297,577,256,321,125,49,215,125,39,54,55,43,94,81,26,19,70,6,121,44,13,35,107,147,152,111,39,15,57,55,68,47,22,7,50,92,84,64,17,8,393,154,239,287,111,176,36,-2,145,120,41,26,25,-23,51,58,21,14,11,21,94,62,20,12,31,70,92,57,18,13,16,23,35,20,7,7,15,47,57,37,11,6,280,70,210,230,85,145,39,76,-11,62,66,27,32,36,-44,28,11,-2,7,40,33,34,55,29,53,40,70,39,18,6,31,11,16,16,7,3,22,29,54,23,11,3,26,-26,52,229,88,141,80,-56,18,-13,-27,25,65,-35,-31,-9,-20,3,15,-21,49,-4,-7,22,79,24,54,43,18,9,40,6,17,14,7,2,39,18,37,29,11,7,264,144,120,251,132,119,99,6,81,21,34,11,56,-10,18,31,41,2,43,16,63,-10,-7,9,41,63,52,33,58,-1,28,21,27,16,36,1,13,42,25,17,22,-2,-45,-14,-31,201,117,84,-9,-39,-24,-62,35,28,-14,-24,10,-32,14,16,5,-15,-34,-30,21,12,44,22,37,50,36,5,24,17,15,34,21,1,20,5,22,16,15,4,-250,-155,-95,144,40,104,16,-75,-157,-28,-22,2,-13,-35,-79,-13,-13,-5,29,-40,-78,-15,-9,7,60,22,20,25,10,-3,16,2,4,13,5,-3,44,20,16,12,5,0,-78,-80,2,183,88,95,27,-8,-93,-28,-16,23,13,-11,-59,-10,-20,7,14,3,-34,-18,4,16,50,27,51,16,17,12,30,14,15,15,4,6,20,13,36,1,13,6,-127,-87,-40,198,86,112,6,-85,-83,-58,20,47,36,-54,-79,-7,-1,8,-30,-31,-4,-51,21,39,69,46,28,12,30,3,44,9,10,7,10,2,25,37,18,5,20,1,166,85,81,283,135,148,77,-47,3,15,37,41,72,-30,-17,1,10,30,5,-17,20,14,27,11,73,45,59,41,42,9,39,25,33,12,13,6,34,20,26,29,29,3,210,33,177,336,150,186,157,-45,-73,48,52,43,60,-23,-55,6,19,11,97,-22,-18,42,33,32,126,29,78,45,38,13,60,11,23,20,23,9,66,18,55,25,15,4
11,11030,Rota,25198,160,70,90,11,4,7,11,47,35,45,15,2,6,24,11,19,8,0,5,23,24,26,7,2,1,2,3,3,2,0,0,2,0,1,1,0,1,0,3,2,1,0,46,15,31,20,8,12,-20,26,-41,24,33,26,1,-10,-17,13,19,10,-21,36,-24,11,14,16,8,0,6,4,2,0,6,0,1,0,1,0,2,0,5,4,1,0,91,58,33,-2,1,-3,21,-6,28,15,37,0,6,11,9,10,24,0,15,-17,19,5,13,0,4,-4,-3,-1,1,1,2,-1,-1,0,1,0,2,-3,-2,-1,0,1,166,73,93,14,8,6,20,21,32,39,38,6,0,8,8,26,20,4,20,13,24,13,18,2,1,0,0,5,5,2,0,0,0,3,3,1,1,0,0,2,2,1,121,79,42,87,48,39,27,32,11,24,11,6,18,24,14,13,4,-1,9,8,-3,11,7,7,22,11,20,20,7,4,10,8,10,15,2,1,12,3,10,5,5,3,186,83,103,99,51,48,17,9,64,40,50,-3,-1,-2,31,19,29,1,18,11,33,21,21,-4,24,15,16,25,16,2,14,5,9,11,9,3,10,10,7,14,7,-1,127,75,52,124,55,69,-3,44,17,33,17,16,5,42,-13,18,10,8,-8,2,30,15,7,8,26,22,26,27,20,4,17,12,3,15,7,2,9,10,23,12,13,2,16,6,10,-100,-69,-31,-41,96,-8,-29,4,-13,-14,55,-11,-15,-12,1,-27,41,3,-14,16,-14,-33,7,-29,-38,-1,-8,-14,-2,-18,-24,-6,-6,-19,9,-11,-14,5,-2,386,166,220,210,92,118,52,143,87,44,34,19,20,77,29,21,8,2,32,66,58,23,26,17,51,50,56,38,9,1,29,20,19,22,0,0,22,30,37,16,9,1,235,146,89,88,42,46,45,70,60,12,20,24,30,39,39,9,10,13,15,31,21,3,10,11,18,27,26,1,11,4,5,17,15,-3,3,4,13,10,11,4,8,0,217,124,93,87,41,46,-1,67,38,73,25,5,-3,33,27,45,11,1,2,34,11,28,14,4,24,15,20,4,16,6,14,7,7,-3,10,4,10,8,13,7,6,2,27,-1,28,23,9,14,34,14,-16,-34,25,-1,14,-1,-21,-16,20,-2,20,15,5,-18,5,1,16,1,7,-14,8,3,8,2,2,-10,5,1,8,-1,5,-4,3,2,-68,-73,5,-40,-37,-3,-8,-27,-13,-10,-5,-6,-17,-22,-19,-7,-9,-2,9,-5,6,-3,4,-4,-14,1,-20,-16,4,0,-17,-1,-11,-8,-3,0,3,2,-9,-8,7,0,-251,-120,-131,-135,-56,-79,-58,-25,-75,-30,-23,-36,-28,-10,-38,-11,-8,-24,-30,-15,-37,-19,-15,-12,-18,-4,-26,-38,-25,-24,-5,2,-9,-14,-20,-10,-13,-6,-17,-24,-5,-14,-63,-60,-3,60,23,37,-14,-31,-54,21,15,4,-23,-15,-40,5,9,3,9,-16,-14,16,6,1,5,5,9,26,8,4,0,3,3,14,3,-1,5,2,6,12,5,5,-88,-80,-8,48,11,37,24,-1,-34,-54,-9,-8,12,-13,-28,-35,-3,-9,12,12,-6,-19,-6,1,25,2,17,-12,8,6,14,3,-1,-7,-1,3,11,-1,18,-5,9,3,74,73,1,184,100,84,39,9,-18,10,18,8,36,16,-7,4,15,3,3,-7,-11,6,3,5,61,22,41,28,22,6,31,12,22,14,16,4,30,10,19,14,6,2,2,-32,34,62,24,38,36,-11,-21,-17,17,-8,15,-10,-19,-22,11,-8,21,-1,-2,5,6,0,30,10,16,-11,15,0,11,9,5,-9,7,0,19,1,11,-2,8,0
11,11031,San Fernando,87179,91,27,64,45,19,26,26,-54,18,2,40,55,17,-31,14,-10,11,18,9,-23,4,12,29,37,11,7,11,10,3,3,5,2,4,5,1,2,6,5,7,5,2,1,-162,-86,-76,59,29,30,-57,-85,43,-81,-10,9,6,-53,-16,-31,0,-1,-63,-32,59,-50,-10,10,19,8,15,9,5,2,8,5,6,5,3,1,11,3,9,4,2,1,-164,-88,-76,88,48,40,-9,-152,-14,-70,40,42,-8,-43,-22,-48,20,12,-1,-109,8,-22,20,30,31,0,18,15,16,1,16,4,12,4,8,2,15,-4,6,11,8,-1,687,304,383,166,84,82,117,84,285,42,59,78,62,13,122,42,19,39,55,71,163,0,40,39,43,38,36,26,15,2,23,18,19,12,8,1,20,20,17,14,7,1,1129,485,644,249,107,142,222,141,468,99,93,73,110,26,234,47,34,20,112,115,234,52,59,53,53,58,65,40,14,10,21,23,29,21,4,6,32,35,36,19,10,4,444,235,209,165,77,88,97,-18,154,80,57,74,37,5,94,48,14,40,60,-23,60,32,43,34,34,39,46,24,7,7,20,16,20,14,2,2,14,23,26,10,5,5,781,336,445,282,117,165,123,52,401,123,14,55,47,14,200,30,15,15,76,38,201,93,-1,40,74,49,90,48,13,5,32,15,41,22,5,1,42,34,49,26,8,4,130,61,69,204,94,110,36,-59,89,10,40,-2,30,-24,21,11,13,0,6,-35,68,-1,27,-2,38,48,55,41,14,2,22,22,22,20,5,1,16,26,33,21,9,1,-200,-117,-83,116,50,66,-36,12,-134,-63,-19,39,-7,13,-75,-50,-22,24,-29,-1,-59,-13,3,15,28,34,42,1,8,1,12,19,15,-2,3,1,16,15,27,3,5,0,-219,-100,-119,141,53,88,-78,11,-96,-50,-14,-1,-46,16,-51,-7,-17,-6,-32,-5,-45,-43,3,5,26,39,38,18,13,3,7,12,16,7,6,3,19,27,22,11,7,0,-290,-218,-72,113,53,60,19,-81,-124,-94,-16,9,10,-58,-101,-65,-11,2,9,-23,-23,-29,-5,7,39,26,16,8,17,7,20,7,11,4,7,3,19,19,5,4,10,4,-348,-217,-131,90,33,57,-85,-12,-175,-97,15,25,-61,3,-102,-59,0,7,-24,-15,-73,-38,15,18,19,37,17,0,12,5,7,21,4,-4,5,1,12,16,13,4,7,4,-490,-249,-241,32,15,17,-39,-58,-214,-100,-10,-40,-21,-33,-127,-34,-4,-11,-18,-25,-87,-66,-6,-29,18,4,1,-1,10,-1,10,4,-2,1,1,0,8,0,3,-2,9,-1,-494,-307,-187,-103,-60,-43,-72,-87,-190,-78,-32,-28,-48,-47,-133,-45,-22,-9,-24,-40,-57,-33,-10,-19,-13,-6,-24,-51,-2,-8,-7,-9,-15,-26,0,-3,-6,3,-9,-25,-2,-5,-489,-336,-153,-48,-39,-9,-31,-111,-162,-144,-23,-2,-23,-85,-119,-82,-15,0,-8,-26,-43,-62,-8,-2,-3,-3,-38,-13,4,2,-4,-9,-21,-9,0,2,1,6,-17,-4,4,0,-260,-188,-72,-19,-13,-6,9,-76,-183,-62,-13,66,-10,-44,-84,-70,0,17,19,-32,-99,8,-13,49,2,0,-19,-10,3,1,-2,1,-8,-8,0,2,4,-1,-11,-2,3,-1,-313,-181,-132,38,14,24,-51,-47,-222,-54,-2,52,-34,-20,-121,-27,-15,28,-17,-27,-101,-27,13,24,25,7,-2,7,-4,1,13,2,-3,4,-6,0,12,5,1,3,2,1,-372,-206,-166,87,40,47,-44,-102,-164,-93,-20,43,-12,-49,-90,-50,-30,25,-32,-53,-74,-43,10,18,22,11,32,4,10,2,13,-2,15,2,4,2,9,13,17,2,6,0
11,11033,San Roque,22719,310,188,122,17,8,9,64,113,82,36,7,-2,53,90,24,14,0,2,11,23,58,22,7,-4,4,1,7,3,2,0,2,0,2,3,1,0,2,1,5,0,1,0,-52,-15,-37,14,10,4,-32,-4,30,-26,-11,-10,-25,15,11,-2,-13,-2,-7,-19,19,-24,2,-8,3,1,5,1,2,1,2,0,4,0,2,1,1,1,1,1,0,0,109,57,52,-9,-1,-8,33,15,12,38,8,-6,5,1,14,26,8,-6,28,14,-2,12,0,0,2,-3,-7,3,-4,0,1,0,-3,3,-2,0,1,-3,-4,0,-2,0,-94,-50,-44,-11,-8,-3,-27,-48,-39,0,10,9,-18,-16,-27,5,-1,4,-9,-32,-12,-5,11,5,-10,0,-3,-2,-1,5,-6,0,-2,-1,-1,2,-4,0,-1,-1,0,3,562,286,276,457,235,222,108,65,126,135,90,21,54,31,61,74,50,11,54,34,65,61,40,10,93,57,112,107,60,22,57,19,60,54,32,11,36,38,52,53,28,11,456,234,222,446,230,216,52,50,134,116,76,14,24,15,70,73,39,8,28,35,64,43,37,6,73,70,122,101,57,15,35,28,67,60,29,7,38,42,55,41,28,8,851,425,426,683,339,344,185,88,196,194,122,49,109,26,92,99,65,26,76,62,104,95,57,23,128,90,137,145,114,55,80,35,60,67,58,30,48,55,77,78,56,25,851,433,418,642,321,321,180,117,163,193,151,34,94,52,88,98,79,20,86,65,75,95,72,14,115,100,123,169,109,20,56,47,62,81,61,13,59,53,61,88,48,7,506,255,251,409,184,225,87,72,146,124,52,21,48,20,81,70,24,12,39,52,65,54,28,9,86,75,117,79,34,13,42,30,55,32,15,8,44,45,62,47,19,5,79,24,55,50,29,21,50,19,-10,37,-28,2,3,10,-2,15,-10,2,47,9,-8,22,-18,0,11,4,17,16,-5,4,-4,3,11,15,2,0,15,1,6,1,-7,4,243,99,144,119,44,75,59,14,83,47,1,27,23,-7,23,41,-1,15,36,21,60,6,2,12,46,4,46,9,10,1,14,-7,17,8,8,2,32,11,29,1,2,-1,437,228,209,193,94,99,131,40,146,78,10,19,70,27,69,37,4,15,61,13,77,41,6,4,48,22,60,29,18,15,35,5,21,10,9,12,13,17,39,19,9,3,411,213,198,190,89,101,122,42,55,109,51,14,82,19,8,57,28,6,40,23,47,52,23,8,78,29,10,43,13,11,42,23,-5,18,5,3,36,6,15,25,8,8,234,112,122,64,46,18,81,-11,83,52,7,13,45,-12,39,17,10,5,36,1,44,35,-3,8,9,0,29,16,3,4,13,-2,16,7,4,4,-4,2,13,9,-1,0,264,132,132,183,87,96,22,2,116,77,31,16,9,-1,42,48,28,11,13,3,74,29,3,5,24,15,58,45,22,11,13,3,21,25,15,6,11,12,37,20,7,5,403,204,199,160,81,79,135,3,107,129,5,8,71,-14,71,62,9,-3,64,17,36,67,-4,11,46,4,38,48,12,3,26,-3,27,18,7,2,20,7,11,30,5,1,265,72,193,5,-18,23,103,18,119,68,-31,-20,55,-4,34,8,-6,-15,48,22,85,60,-25,-5,24,9,46,-20,-31,-31,18,-2,16,-23,-16,-14,6,11,30,3,-15,-17,517,266,251,193,111,82,141,63,104,137,35,24,112,31,31,58,16,11,29,32,73,79,19,13,44,26,42,42,29,-1,43,10,24,18,13,0,1,16,18,24,16,-1
11,11032,Sanlúcar de Barrameda,61648,-96,-76,-20,22,14,8,-22,-33,-23,-24,5,1,-28,-20,-12,-20,3,3,6,-13,-11,-4,2,-2,4,1,2,3,7,4,2,1,1,2,5,2,2,0,1,1,2,2,-160,-108,-52,3,2,1,-10,-69,-83,-19,9,9,-12,-43,-51,-7,2,2,2,-26,-32,-12,7,7,3,0,0,0,0,0,2,0,0,0,0,0,1,0,0,0,0,0,41,13,28,0,-2,2,21,-27,-4,23,40,-16,-1,-10,-11,14,27,-7,22,-17,7,9,13,-9,7,-6,-11,5,7,-3,2,-1,-7,2,5,-3,5,-5,-4,3,2,0,285,179,106,24,9,15,47,12,82,42,61,36,34,3,65,21,26,26,13,9,17,21,35,10,4,6,3,5,3,3,0,1,4,2,1,1,4,5,-1,3,2,2,317,152,165,102,48,54,68,34,70,72,52,10,44,9,31,30,28,4,24,25,39,42,24,6,20,16,24,22,13,7,10,7,13,10,2,6,10,9,11,12,11,1,226,115,111,110,58,52,51,-16,61,30,71,27,23,-14,33,23,34,12,28,-2,28,7,37,15,19,16,39,15,15,4,10,8,17,9,9,4,9,8,22,6,6,0,-15,-2,-13,68,37,31,-5,-31,-29,7,42,3,-9,-12,3,2,11,-1,4,-19,-32,5,31,4,11,12,23,17,2,1,5,8,13,11,-1,0,6,4,10,6,3,1,19,27,-8,108,47,61,-11,-63,18,4,48,11,-6,-21,9,-3,20,17,-5,-42,9,7,28,-6,25,6,37,18,13,4,16,2,13,3,5,2,9,4,24,15,8,2,76,29,47,87,36,51,29,-34,6,27,16,25,10,-16,0,11,10,10,19,-18,6,16,6,15,10,24,25,14,9,4,9,10,9,4,2,2,1,14,16,10,7,2,155,105,50,103,50,53,30,1,-6,61,53,14,27,-4,8,24,27,19,3,5,-14,37,26,-5,21,13,26,13,20,6,10,4,13,8,8,3,11,9,13,5,12,3,-36,-26,-10,4,-5,9,-10,-9,-42,-29,44,11,0,-8,-15,-14,20,-7,-10,-1,-27,-15,24,18,9,5,-5,-10,3,2,7,-1,0,-7,-3,-1,2,6,-5,-3,6,3,45,-11,56,86,26,60,20,-5,-39,4,34,23,-4,-8,-22,-3,7,13,24,3,-17,7,27,10,33,8,14,9,15,7,10,2,2,3,5,4,23,6,12,6,10,3,-3,-1,-2,38,20,18,13,-8,-7,-2,-19,7,15,-5,-10,-1,-5,1,-2,-3,3,-1,-14,6,14,11,2,2,2,1,8,5,1,0,4,-1,6,6,1,2,-2,2,-147,-69,-78,0,2,-2,-27,-30,-65,-46,19,-2,-8,-18,-28,-25,11,-4,-19,-12,-37,-21,8,2,9,7,-7,-6,-6,2,5,4,-2,-2,-4,0,4,3,-5,-4,-2,2,-29,-32,3,28,13,15,17,-33,-43,0,14,14,13,-17,-45,-6,13,9,4,-16,2,6,1,5,10,10,1,-5,4,6,7,11,-2,-6,1,2,3,-1,3,1,3,4,41,-10,51,36,19,17,29,-8,-38,-15,38,21,13,-16,-38,-11,19,16,16,8,0,-4,19,5,3,8,15,-10,7,10,1,-1,8,-5,6,8,2,9,7,-5,1,2,-89,-46,-43,20,6,14,4,-50,-103,-7,42,24,2,-30,-55,-2,24,14,2,-20,-48,-5,18,10,4,-2,-2,4,7,6,-1,-3,-1,7,1,3,5,1,-1,-3,6,3,-32,-31,-1,82,44,38,17,-11,-93,-8,63,-2,23,-5,-52,-29,38,-3,-6,-6,-41,21,25,1,15,17,16,14,15,4,11,7,10,6,8,1,4,10,6,8,7,3
11,11035,Tarifa,15344,89,43,46,11,5,6,-11,27,36,19,9,5,0,17,10,7,2,0,-11,10,26,12,7,5,3,1,2,3,0,2,1,0,0,3,0,1,2,1,2,0,0,1,64,47,17,7,6,1,-12,21,44,5,3,0,-9,27,26,1,-2,2,-3,-6,18,4,5,-2,3,0,2,2,0,0,3,0,2,1,0,0,0,0,0,1,0,0,69,27,42,-15,-9,-6,-3,-3,12,30,19,13,8,-15,5,10,12,6,-11,12,7,20,7,7,2,-2,-5,-3,-3,-4,2,-1,-3,-3,-3,-1,0,-1,-2,0,0,-3,280,156,124,25,18,7,34,69,84,70,13,3,10,50,35,48,9,1,24,19,49,22,4,2,5,5,6,6,3,0,3,2,6,3,3,1,2,3,0,3,0,-1,405,217,188,165,87,78,52,81,143,90,34,-1,20,53,75,46,17,3,32,28,68,44,17,-4,28,30,55,34,16,-1,12,16,32,18,7,0,16,14,23,16,9,-1,264,147,117,218,127,91,-8,36,123,43,46,8,-9,14,66,36,26,4,1,22,57,7,20,4,25,34,95,31,18,7,11,17,58,20,11,5,14,17,37,11,7,2,152,71,81,161,81,80,-12,-8,79,58,22,11,-15,0,38,37,7,5,3,-8,41,21,15,6,17,29,58,38,15,3,9,21,25,19,6,1,8,8,33,19,9,2,40,20,20,217,129,88,-30,22,33,-3,16,-1,-13,4,26,-1,6,-2,-17,18,7,-2,10,1,19,48,80,42,17,6,11,25,49,25,11,5,8,23,31,17,6,1,-34,-23,-11,11,-6,17,5,4,-12,-36,8,2,3,1,-12,-16,2,2,2,3,0,-20,6,0,11,14,-1,-15,0,0,6,-1,-2,-7,-2,-1,5,15,1,-8,2,1,-22,-6,-16,104,48,56,-40,12,20,-26,7,1,-26,5,9,-11,13,2,-14,7,11,-15,-6,-1,9,26,42,20,5,-2,2,14,18,9,5,-2,7,12,24,11,0,0,55,22,33,37,23,14,6,12,-1,24,17,-14,-3,5,-1,16,2,-3,9,7,0,8,15,-11,3,17,7,3,1,0,3,10,7,4,-3,0,0,7,0,-1,4,0,59,36,23,45,18,27,23,14,-13,27,1,10,7,1,4,16,2,6,16,13,-17,11,-1,4,6,9,6,14,2,6,1,2,-1,8,3,4,5,7,7,6,-1,2,91,49,42,32,10,22,-7,35,61,-4,4,-1,1,12,29,1,9,-2,-8,23,32,-5,-5,1,4,11,19,-4,-2,2,1,0,7,-3,2,2,3,11,12,-1,-4,0,-169,-82,-87,-228,-136,-92,-9,-28,-19,-103,-9,-6,2,-11,-2,-54,-6,-14,-11,-17,-17,-49,-3,8,-35,-14,-42,-104,-22,-13,-14,-3,-24,-64,-19,-12,-21,-11,-18,-40,-3,-1,74,36,38,71,36,35,23,3,44,16,-14,3,2,11,19,13,-10,0,21,-8,25,3,-4,3,11,15,29,2,7,4,2,9,12,3,6,3,9,6,17,-1,1,1,110,54,56,61,30,31,8,15,50,9,11,15,5,6,25,-4,10,10,3,9,25,13,1,5,9,4,37,4,2,4,2,-2,23,1,1,5,7,6,14,3,1,-1,112,38,74,59,31,28,29,-6,64,26,4,-8,22,-7,19,3,5,-5,7,1,45,23,-1,-3,20,6,33,10,-7,-5,10,3,17,5,-3,-2,10,3,16,5,-4,-3,27,0,27,6,-3,9,10,0,-3,-1,3,23,0,9,-12,4,-7,6,10,-9,9,-5,10,17,-4,11,-2,-3,4,-2,-5,9,-6,3,0,-4,1,2,4,-6,4,2
11,11039,Vejer de la Frontera,12731,57,37,20,39,24,15,32,-11,16,6,11,2,17,-7,9,6,7,5,15,-4,7,0,4,-3,7,1,14,10,6,1,4,1,7,7,4,1,3,0,7,3,2,0,-11,-15,4,50,26,24,9,-13,-15,11,4,-5,5,-7,-10,3,1,-5,4,-6,-5,8,3,0,9,4,12,15,9,1,4,1,9,6,5,1,5,3,3,9,4,0,-47,-31,-16,37,13,24,9,-13,-17,-21,8,-8,6,-7,-7,-14,2,-6,3,-6,-10,-7,6,-2,11,1,7,10,6,2,5,-2,3,5,2,0,6,3,4,5,4,2,3,26,-23,55,26,29,14,-29,4,14,-4,0,19,-4,0,12,-4,0,-5,-25,4,2,0,0,12,5,13,14,7,2,6,3,6,7,2,2,6,2,7,7,5,0,94,64,30,65,25,40,15,-13,29,41,11,9,14,4,12,20,5,7,1,-17,17,21,6,2,13,7,15,21,4,1,7,1,7,5,1,1,6,6,8,16,3,0,-15,-5,-10,55,23,32,1,-31,-14,19,8,-2,8,-17,-12,5,6,2,-7,-14,-2,14,2,-4,7,4,19,16,7,1,5,1,5,7,3,1,2,3,14,9,4,0,44,10,34,54,28,26,10,-7,11,18,15,-4,-1,-8,9,3,8,-1,11,1,2,15,7,-3,9,4,21,10,10,0,6,3,9,4,6,0,3,1,12,6,4,0,89,35,54,64,24,40,34,6,-12,36,24,-4,17,2,-14,13,14,-1,17,4,2,23,10,-3,11,7,6,14,20,5,5,1,-1,5,10,3,6,6,7,9,10,2,-18,-8,-10,20,3,17,-4,-19,-5,4,2,1,3,-9,0,-1,2,-4,-7,-10,-5,5,0,5,-1,5,4,6,5,1,-2,-1,1,1,5,-1,1,6,3,5,0,2,-97,-59,-38,-7,-5,-2,-1,-23,-18,-33,-4,-19,-6,-12,-9,-20,-3,-10,5,-11,-9,-13,-1,-9,7,5,-2,-18,1,-1,5,3,-3,-10,2,-2,2,2,1,-8,-1,1,-44,-10,-34,-46,-24,-22,-11,-13,5,-32,4,0,0,-3,1,-18,4,3,-11,-10,4,-14,0,-3,-12,-3,-2,-22,-2,-6,-8,-1,-1,-12,1,-4,-4,-2,-1,-10,-3,-2,5,-5,10,-7,1,-8,20,-8,2,-1,-7,-1,13,-14,-1,2,-1,-1,7,6,3,-3,-6,0,5,-1,0,-7,-7,2,2,-3,4,-1,-2,1,3,2,-4,-6,-5,1,58,15,43,-5,-8,3,25,-9,9,14,19,-1,4,-6,2,0,14,1,21,-3,7,14,5,-2,-4,-1,-4,0,4,-1,-4,1,-7,-1,3,-1,0,-2,3,1,1,0,25,10,15,11,4,7,-5,-8,22,4,4,2,-6,-10,6,13,1,2,1,2,16,-9,3,0,0,0,5,3,4,-1,-1,-1,-1,5,2,0,1,1,6,-2,2,-1,-80,-46,-34,1,2,-1,0,-11,-24,-20,-9,-13,-1,-12,-13,-9,-2,-7,1,1,-11,-11,-7,-6,1,-1,3,3,-3,-2,0,-2,1,4,0,-1,1,1,2,-1,-3,-1,-14,-17,3,-3,-1,-2,6,-15,-23,4,13,-3,-2,-6,-20,2,8,-2,8,-9,-3,2,5,-1,1,-1,-11,-1,8,0,0,0,-7,2,4,0,1,-1,-4,-3,4,0,0,-3,3,19,11,8,8,-5,-3,21,2,-17,2,-2,-6,16,-2,-6,6,-3,3,5,4,-11,1,3,5,6,5,-2,0,0,3,6,2,-1,1,3,2,0,3,-1,-74,-55,-19,-3,-1,-2,1,-19,-30,-16,-2,-4,-5,-4,-17,-22,-3,-2,6,-15,-13,6,1,-2,6,-1,-1,-4,-1,-2,3,-1,0,-2,-1,0,3,0,-1,-2,0,-2
11,11041,Villamartín,12105,-134,-56,-78,23,9,14,-44,-37,-32,-16,4,-4,-22,-19,-10,-7,4,0,-22,-18,-22,-9,0,-4,2,6,9,3,3,0,2,1,3,1,2,0,0,5,6,2,1,0,-25,-16,-9,17,9,8,12,-26,2,-2,-3,-8,6,-15,1,-6,0,-2,6,-11,1,4,-3,-6,5,4,3,2,3,0,4,1,2,0,2,0,1,3,1,2,1,0,3,11,-8,28,11,17,3,-5,-3,5,-3,5,5,2,0,4,-3,2,-2,-7,-3,1,0,3,7,1,9,7,-1,3,2,2,2,4,-2,2,5,-1,7,3,1,1,-34,-20,-14,22,8,14,5,-17,-7,-16,6,-4,3,-14,9,-13,1,-3,2,-3,-16,-3,5,-1,7,5,6,1,3,0,3,1,3,0,1,0,4,4,3,1,2,0,0,13,-13,14,7,7,14,-17,-23,19,3,3,11,-7,-7,13,2,2,3,-10,-16,6,1,1,3,3,1,3,4,0,1,2,1,1,2,0,2,1,0,2,2,0,-25,-15,-10,15,8,7,-17,2,8,-16,-3,-3,-10,3,3,-9,-2,-3,-7,-1,5,-7,-1,0,2,4,6,3,1,-2,1,2,1,3,1,-1,1,2,5,0,0,-1,-5,1,-6,29,11,18,4,-14,5,-3,9,-3,1,-2,13,-14,2,2,3,-12,-8,11,7,-5,3,7,12,3,3,0,2,4,4,0,1,0,1,3,8,3,2,0,4,-2,6,30,13,17,-10,1,6,-7,8,6,-12,6,2,-2,4,0,2,-5,4,-5,4,6,5,8,10,2,2,3,2,4,4,2,1,0,3,4,6,0,1,3,49,21,28,32,15,17,13,28,-4,10,6,-6,2,17,-10,7,8,-2,11,11,6,3,-2,-4,7,9,15,-1,2,0,3,3,7,0,2,0,4,6,8,-1,0,0,60,18,42,17,5,12,38,-4,14,11,7,-7,17,-4,2,1,1,1,21,0,12,10,6,-8,1,6,5,2,3,0,1,2,2,0,0,0,0,4,3,2,3,0,-126,-45,-81,-2,0,-2,-32,-18,-41,-18,-9,-3,-23,-3,-11,-1,-1,-2,-9,-15,-30,-17,-8,-1,-1,2,-1,0,0,-2,-3,1,3,0,0,-1,2,1,-4,0,0,-1,-30,-41,11,19,3,16,-5,-12,-8,-1,-1,-5,-9,-10,-11,-9,0,-2,4,-2,3,8,-1,-3,2,9,7,-2,1,1,0,3,1,-2,1,0,2,6,6,0,0,1,-48,-9,-39,11,4,7,-18,-1,-18,-14,9,-6,0,-3,-4,-2,3,0,-18,2,-14,-12,6,-6,3,3,0,4,3,-2,3,1,-1,0,2,-1,0,2,1,4,1,-1,-71,-43,-28,11,2,9,-27,-10,-33,-11,14,-5,-21,-5,-16,-11,8,2,-6,-5,-17,0,6,-7,1,2,6,-1,2,-1,0,0,2,-1,1,0,1,2,4,0,1,-1,-59,-6,-53,4,3,1,-16,-17,-17,-5,-3,2,1,-3,-7,-1,1,3,-17,-14,-10,-4,-4,-1,-2,1,2,1,1,1,0,0,0,1,1,1,-2,1,2,0,0,0,-53,-23,-30,-16,-6,-10,-7,-7,-26,-8,-6,-1,-6,-7,-9,3,-5,2,-1,0,-17,-11,-1,-3,1,-4,-7,-10,0,2,-1,-3,-2,-3,2,1,2,-1,-5,-7,-2,1,-52,-22,-30,12,5,7,-16,-18,-15,0,-1,1,0,-16,-13,5,0,3,-16,-2,-2,-5,-1,-2,0,4,-5,6,3,3,2,3,-5,2,1,2,-2,1,0,4,2,1,-87,-47,-40,4,4,0,-4,-19,-26,-28,2,-12,1,-15,-17,-20,6,-4,-5,-4,-9,-8,-4,-8,1,-2,2,0,3,0,2,-2,2,1,1,0,-1,0,0,-1,2,0
12,12004,Alcalà de Xivert,5150,416,290,126,367,261,106,40,108,136,55,56,19,16,92,100,36,34,11,24,16,36,19,22,8,24,108,121,41,50,23,11,89,93,24,33,11,13,19,28,17,17,12,339,211,128,318,202,116,39,86,82,50,60,21,21,65,63,20,30,11,18,21,19,30,30,10,28,85,90,45,53,15,15,66,64,23,26,7,13,19,26,22,27,8,201,72,129,219,106,113,20,11,22,35,75,37,3,-2,-3,18,35,22,17,13,25,17,40,15,23,25,38,27,73,33,7,12,22,11,35,19,16,13,16,16,38,14,260,102,158,261,133,128,26,23,45,28,101,35,11,1,14,7,46,23,15,22,31,21,55,12,32,28,46,39,82,33,12,16,27,18,41,19,20,12,19,21,41,14,297,172,125,273,161,112,32,57,68,48,82,12,23,42,31,18,51,8,9,15,37,30,31,4,21,53,66,41,75,17,16,31,39,24,38,13,5,22,27,17,37,4,306,179,127,300,170,130,41,76,82,32,58,15,30,40,52,28,25,3,11,36,30,4,33,12,43,67,70,35,71,13,25,36,43,23,36,6,18,31,27,12,35,7,369,185,184,336,154,182,54,47,66,65,108,30,20,20,38,33,56,18,34,27,28,32,52,12,60,55,61,56,76,27,23,20,34,22,39,15,37,35,27,34,37,12,409,253,156,356,197,159,74,74,113,67,66,15,44,56,73,30,38,11,30,18,40,37,28,4,74,59,98,50,52,22,42,35,54,26,28,11,32,24,44,24,24,11,155,90,65,218,117,101,2,47,34,24,33,14,9,23,22,8,19,8,-7,24,12,16,14,6,30,44,54,40,30,18,19,21,31,19,15,11,11,23,23,21,15,7,-8,-26,18,78,40,38,21,28,-24,2,-13,-25,7,10,-28,3,-10,-10,14,18,4,-1,-3,-15,30,31,31,13,-5,-25,18,9,18,7,-4,-10,12,22,13,6,-1,-15,-115,-112,-3,-187,-144,-43,-46,4,-99,-23,31,12,-24,-10,-88,-23,20,9,-22,14,-11,0,11,3,-49,-7,-105,-40,2,9,-27,-8,-86,-33,2,7,-22,1,-19,-7,0,2,30,9,21,152,83,69,24,12,9,-21,1,0,17,1,-4,-17,4,5,7,11,13,-4,-3,-5,27,29,31,22,22,17,17,17,12,11,13,10,10,12,19,11,9,7,-44,-20,-24,10,10,0,-20,-3,-16,-18,12,-1,-9,0,-11,-6,4,-1,-11,-3,-5,-12,8,0,-9,7,-8,-1,18,4,1,3,-7,-2,8,7,-10,4,-1,1,10,-3,-363,-217,-146,-273,-170,-103,-35,-33,-96,-64,-59,-78,-32,-18,-56,-37,-33,-42,-3,-15,-40,-27,-26,-36,-17,-21,-63,-46,-55,-71,-14,-12,-41,-32,-31,-40,-3,-9,-22,-14,-24,-31,14,3,11,48,27,21,-22,-8,31,-3,23,-5,-16,-6,23,-3,8,-2,-6,-2,8,0,15,-3,0,5,22,6,10,5,2,3,14,3,3,2,-2,2,8,3,7,3,-48,-14,-34,62,39,23,-7,-3,-7,-31,-6,9,-4,3,5,-21,-2,6,-3,-6,-12,-10,-4,3,6,8,10,-1,15,25,-1,8,9,0,8,15,7,0,1,-1,7,10,-8,9,-17,61,35,26,-10,8,-30,-11,33,1,2,9,-19,-10,24,2,-12,-1,-11,-1,9,-1,6,16,4,13,21,-1,3,5,4,7,14,0,3,11,0,6,7,-1,-32,7,-39,98,63,35,-18,7,-5,-11,-2,-6,-6,12,0,-3,3,-1,-12,-5,-5,-8,-5,-5,11,16,28,26,17,-1,4,11,17,18,12,0,7,5,11,8,5,-1
12,12005,"Alcora, l'",8935,164,87,77,42,22,20,16,73,46,16,2,3,7,38,27,7,4,-1,9,35,19,9,-2,4,13,9,16,3,0,0,9,3,9,1,0,0,4,6,7,2,0,0,282,163,119,89,44,45,32,121,77,37,9,5,25,71,37,24,4,1,7,50,40,13,5,4,5,24,37,18,5,0,2,14,16,12,0,0,3,10,21,6,5,0,241,139,102,95,52,43,50,85,64,28,10,3,30,43,45,17,5,0,20,42,19,11,5,3,17,25,39,9,4,0,9,11,24,5,2,0,8,14,15,4,2,0,137,84,53,95,60,35,23,46,19,41,-3,3,20,29,15,19,-2,2,3,17,4,22,-1,1,19,27,31,16,1,1,12,19,20,10,0,-1,7,8,11,6,1,2,185,99,86,111,63,48,39,59,41,40,2,3,26,26,30,11,2,3,13,33,11,29,0,0,14,32,34,28,2,1,9,17,21,13,2,1,5,15,13,15,0,0,189,82,107,111,58,53,20,49,56,34,27,2,4,19,32,15,14,2,16,30,24,19,13,0,11,38,32,20,9,1,3,20,17,14,4,0,8,18,15,6,5,1,240,142,98,109,58,51,44,75,56,61,0,3,23,43,33,37,4,2,21,32,23,24,-4,1,12,48,27,17,5,0,5,28,17,7,1,0,7,20,10,10,4,0,279,142,137,146,66,80,57,58,82,70,13,0,29,19,52,33,8,1,28,39,30,37,5,-1,24,47,41,23,8,4,12,16,27,9,2,1,12,31,14,14,6,3,1,3,-2,73,36,37,17,-2,1,-24,0,8,7,8,1,-23,4,4,10,-10,0,-1,-4,4,17,16,27,3,5,3,9,8,16,-2,4,1,8,8,11,5,1,2,-140,-86,-54,-16,-20,4,-36,-16,-55,-3,-24,-6,-16,-14,-31,-6,-15,-3,-20,-2,-24,3,-9,-3,-4,6,-9,-3,-4,-3,-3,1,-9,-5,-5,0,-1,5,0,2,1,-3,-220,-139,-81,-83,-52,-31,-32,-39,-75,-61,-16,6,-19,-31,-45,-35,-12,4,-13,-8,-30,-26,-4,2,-8,-8,-37,-21,-10,0,-1,-10,-23,-15,-4,0,-7,2,-14,-6,-6,0,-46,-40,-6,-5,-7,2,6,-14,-14,-25,-7,6,-1,-3,-12,-23,-2,4,7,-11,-2,-2,-5,2,-5,1,0,-4,1,1,-4,0,0,-4,1,0,-1,1,0,0,0,1,-30,6,-36,10,7,3,-7,-7,-13,-11,16,-9,-8,-1,6,-1,13,-4,1,-6,-19,-10,3,-5,2,3,4,0,1,0,1,1,3,1,1,0,1,2,1,-1,0,0,-70,-33,-37,-21,-8,-13,-16,-15,-24,9,-18,-6,-9,-8,-14,9,-7,-4,-7,-7,-10,0,-11,-2,-3,-2,-6,-3,-4,-3,-2,0,-3,0,-2,-1,-1,-2,-3,-3,-2,-2,-102,-48,-54,-97,-49,-48,-16,-1,-27,-40,-13,-2,-1,5,-16,-28,-7,2,-15,-6,-11,-12,-6,-4,-14,-5,-21,-40,-13,-4,-3,0,-16,-23,-6,-1,-11,-5,-5,-17,-7,-3,-86,-39,-47,-45,-24,-21,-10,-7,-25,-42,-2,-3,3,-2,-12,-25,0,-5,-13,-5,-13,-17,-2,2,-4,0,-18,-22,2,-4,0,0,-10,-13,1,-2,-4,0,-8,-9,1,-2,-16,-27,11,10,-4,14,2,-4,-6,-9,-8,7,2,-9,-7,-10,-6,2,0,5,1,1,-2,5,-2,5,-1,-2,2,5,-2,0,-2,-6,1,2,0,5,1,4,1,3,-101,-62,-39,-55,-24,-31,-33,-14,-28,-28,-18,21,-20,-9,-12,-21,-9,8,-13,-5,-16,-7,-9,13,-14,-3,-4,-12,-21,-1,-9,-1,-2,-5,-6,-1,-5,-2,-2,-7,-15,0
12,12011,Almenara,5001,68,38,30,59,40,19,20,15,28,6,4,-5,14,10,11,4,3,-3,6,5,17,2,1,-2,10,17,25,3,1,2,6,14,16,3,0,1,4,3,9,0,1,1,62,47,15,55,36,19,10,13,14,13,8,2,6,8,18,10,3,2,4,5,-4,3,5,0,8,16,13,7,7,2,7,9,10,5,3,2,1,7,3,2,4,0,97,60,37,63,39,24,30,23,16,22,-3,4,20,13,11,12,-1,2,10,10,5,10,-2,2,16,20,14,10,3,0,11,12,10,5,1,0,5,8,4,5,2,0,64,27,37,57,27,30,18,11,18,10,2,4,6,4,13,3,-1,1,12,7,5,7,3,3,7,14,17,11,5,3,1,7,11,6,1,1,6,7,6,5,4,2,51,34,17,66,36,30,-1,14,22,15,2,-2,2,8,13,7,3,1,-3,6,9,8,-1,-3,8,25,17,4,7,4,5,12,10,2,4,3,3,13,7,2,3,1,138,70,68,59,36,23,38,16,49,8,15,4,15,13,27,4,7,1,23,3,22,4,8,3,17,9,22,10,0,0,11,4,14,7,0,0,6,5,8,3,0,0,100,50,50,33,12,21,4,19,34,17,13,7,2,10,14,16,4,2,2,9,20,1,9,5,11,10,9,3,0,0,4,4,3,1,0,0,7,6,6,2,0,0,242,134,108,86,52,34,28,50,101,38,17,-1,13,23,53,26,12,-1,15,27,48,12,5,0,2,39,35,5,7,-2,0,21,21,8,4,-2,2,18,14,-3,3,0,170,101,69,23,4,19,30,15,43,45,33,2,21,12,21,31,18,1,9,3,22,14,15,1,9,7,8,-1,-1,1,3,3,1,-2,-1,1,6,4,7,1,0,0,75,38,37,-12,-7,-5,3,15,29,20,5,2,8,10,17,4,0,-2,-5,5,12,16,5,4,-5,0,4,-10,-3,2,0,0,1,-8,0,0,-5,0,3,-2,-3,2,84,33,51,10,-4,14,13,22,33,11,12,-8,8,15,19,-10,7,-4,5,7,14,21,5,-4,2,19,-7,-4,-2,2,0,14,-5,-12,-1,0,2,5,-2,8,-1,2,18,-3,21,-1,-11,10,6,-6,11,13,-4,-4,3,-8,-1,7,-5,-1,3,2,12,6,1,-3,4,-6,1,-3,0,1,-1,-6,0,-4,-1,1,5,0,1,1,1,0,9,3,6,-25,-16,-9,9,-3,2,-5,1,-4,6,-6,-1,-2,4,-3,3,3,3,-3,-3,-1,-2,-8,-9,-8,-4,3,0,-7,-7,-3,-2,1,-2,-1,-2,-5,-2,2,-46,-17,-29,-23,-16,-7,-21,-5,-1,-5,-4,-12,-10,-6,2,2,-3,-4,-11,1,-3,-7,-1,-8,-1,-5,-6,-3,-4,-4,2,-6,-3,-4,-3,-2,-3,1,-3,1,-1,-2,-69,-42,-27,-1,-6,5,-15,4,-31,-18,-8,-1,-14,0,-14,-10,-3,-3,-1,4,-17,-8,-5,2,-5,7,-5,0,0,0,-4,3,-2,-2,-1,-1,-1,4,-3,2,1,1,-82,-23,-59,14,9,5,-22,0,-17,-34,-6,-6,-12,2,3,-13,-2,-2,-10,-2,-20,-21,-4,-4,3,6,6,1,-2,0,2,3,5,1,-2,0,1,3,1,0,0,0,-29,0,-29,-5,1,-6,-5,0,-4,-6,-1,-12,1,1,5,-3,1,-4,-6,-1,-9,-3,-2,-8,1,-1,-7,-2,5,-2,2,0,-3,-1,3,0,-1,-1,-4,-1,2,-2,-1,8,-9,19,5,14,-10,7,10,0,-7,-3,1,4,5,-2,1,-2,-11,3,5,2,-8,-1,1,4,12,0,1,1,0,3,4,-4,1,1,1,1,8,4,0,0
12,12012,Altura,3144,39,16,23,19,9,10,10,9,7,5,9,-1,-1,6,-1,2,6,3,11,3,8,3,3,-4,4,4,8,2,1,0,0,3,3,2,1,0,4,1,5,0,0,0,33,27,6,27,15,12,8,18,1,5,4,-2,10,10,3,6,2,-3,-2,8,-2,-1,2,1,6,9,5,4,2,0,5,5,2,2,1,0,1,4,3,2,1,0,51,33,18,35,18,17,4,8,25,14,0,-1,3,4,21,6,1,-2,1,4,4,8,-1,1,6,4,17,6,1,1,5,1,10,2,0,0,1,3,7,4,1,1,28,21,7,61,29,32,-2,11,15,0,2,2,-2,10,6,2,3,1,0,1,9,-2,-1,1,15,16,23,6,0,0,7,8,10,3,0,0,8,8,13,3,0,0,86,55,31,62,38,24,13,30,6,21,8,8,5,20,7,13,4,5,8,10,-1,8,4,3,10,22,14,10,4,0,5,13,10,7,2,0,5,9,4,3,2,0,162,107,55,82,49,33,33,43,51,10,16,7,17,26,36,11,10,5,16,17,15,-1,6,2,15,23,26,13,3,0,9,12,16,9,2,0,6,11,10,4,1,0,148,90,58,92,48,44,20,23,47,40,14,4,12,12,36,26,4,0,8,11,11,14,10,4,17,25,26,19,4,1,6,13,14,13,2,0,11,12,12,6,2,1,151,79,72,103,61,42,21,36,47,30,10,6,6,22,25,20,4,2,15,14,22,10,6,4,22,34,27,15,3,0,10,21,20,7,2,0,12,13,7,8,1,0,114,73,41,64,35,29,10,23,56,18,10,-7,3,10,38,14,7,0,7,13,18,4,3,-7,7,17,16,18,3,1,3,6,10,12,2,1,4,11,6,6,1,0,12,0,12,0,-13,13,16,-5,-5,7,-7,5,8,-2,-10,5,-2,0,8,-3,5,2,-5,5,3,5,-4,1,-6,1,0,-1,-7,-1,-4,0,3,6,3,2,-2,1,-25,-5,-20,23,12,11,-2,3,-13,-5,1,-5,-1,5,-2,-6,3,-3,-1,-2,-11,1,-2,-2,5,9,5,1,0,2,2,5,3,1,0,1,3,4,2,0,0,1,-44,-33,-11,-6,-3,-3,-3,-1,-12,-35,3,2,5,-4,-14,-23,4,-2,-8,3,2,-12,-1,4,-1,1,1,-6,-1,0,2,-2,0,-3,0,0,-3,3,1,-3,-1,0,1,-8,9,-27,-20,-7,11,3,4,-8,-4,-3,1,-1,4,-3,-5,-1,10,4,0,-5,1,-2,-5,-2,-7,-9,-1,-3,-6,-3,-4,-6,-1,0,1,1,-3,-3,0,-3,-61,-25,-36,-13,-11,-2,-12,-11,-12,-13,-8,-6,-8,-4,-8,0,-4,-1,-4,-7,-4,-13,-4,-5,-1,-4,-1,-6,-1,-1,-3,-1,-3,-1,-2,-1,2,-3,2,-5,1,0,-45,-30,-15,0,2,-2,-16,1,-24,-2,-2,-1,-3,-3,-11,-7,-2,-3,-13,4,-13,5,0,2,0,3,-2,2,-1,-1,2,0,0,2,-1,0,-2,3,-2,0,0,-1,-29,-30,1,-12,-8,-4,-4,3,-12,-7,-2,-6,-3,-1,-10,-10,-3,-2,-1,4,-2,3,1,-4,-5,3,-3,-4,-3,0,-1,0,-2,-4,-2,1,-4,3,-1,0,-1,-1,-46,-24,-22,-26,-16,-10,-2,-12,-9,-23,-2,1,3,-4,-3,-19,3,-4,-5,-8,-6,-4,-5,5,-1,-3,-9,-13,-1,1,-1,0,-6,-8,-1,0,0,-3,-3,-5,0,1,-93,-56,-37,-44,-34,-10,-8,-6,-27,-29,-16,-8,-4,-3,-16,-13,-16,-4,-4,-3,-11,-16,0,-4,4,-3,-15,-19,-13,2,2,-2,-12,-9,-13,0,2,-1,-3,-10,0,2
12,12027,Benicarló,19540,655,413,242,525,353,172,62,179,187,140,49,28,27,122,121,94,29,16,35,57,66,46,20,12,39,152,190,116,21,5,25,104,129,79,14,1,14,48,61,37,7,4,760,428,332,645,380,265,160,126,222,142,66,36,90,75,145,68,29,19,70,51,77,74,37,17,127,153,200,107,34,21,70,88,137,57,17,10,57,65,63,50,17,11,620,317,303,544,294,250,117,100,164,102,87,43,54,27,93,71,43,25,63,73,71,31,44,18,113,139,148,85,35,20,55,64,93,48,16,15,58,75,55,37,19,5,844,412,432,555,295,260,173,178,230,155,61,39,95,60,117,82,30,27,78,118,113,73,31,12,106,154,146,95,35,14,57,71,87,51,20,6,49,83,59,44,15,8,752,374,378,522,281,241,180,140,205,97,78,46,101,48,122,40,38,24,79,92,83,57,40,22,131,111,135,78,40,22,73,47,85,48,16,10,58,64,50,30,24,12,815,469,346,609,352,257,135,218,216,128,86,25,57,123,138,86,48,12,78,95,78,42,38,13,119,172,166,82,49,16,57,97,109,50,27,7,62,75,57,32,22,9,953,488,465,570,318,252,208,196,308,162,56,15,89,108,170,84,25,9,119,88,138,78,31,6,118,158,156,96,30,8,57,96,93,49,14,8,61,62,63,47,16,0,1149,634,515,899,482,417,209,288,328,198,76,50,103,156,222,92,34,27,106,132,106,106,42,23,185,251,263,133,51,9,94,135,163,61,20,4,91,116,100,72,31,5,179,83,96,203,101,102,13,81,30,20,35,0,-1,49,14,6,16,-1,14,32,16,14,19,1,30,72,61,23,12,3,18,37,27,8,8,1,12,35,34,15,4,2,-245,-165,-80,-256,-186,-70,-29,1,-141,-109,34,-12,2,-1,-93,-77,7,-8,-31,2,-48,-32,27,-4,-18,23,-108,-98,-24,-32,-7,5,-73,-71,-22,-19,-11,18,-35,-27,-2,-13,134,80,54,237,152,85,2,56,8,28,11,32,-2,39,5,20,3,16,4,17,3,8,8,16,24,61,79,43,15,12,16,39,54,30,5,7,8,22,25,13,10,5,-111,-133,22,-71,-80,9,11,-18,-102,-37,9,20,-7,-38,-60,-42,7,10,18,20,-42,5,2,10,1,-7,-52,-22,-2,7,-4,-6,-53,-26,3,5,5,-1,1,4,-5,2,-281,-189,-92,-531,-302,-229,-17,-21,-99,-81,-30,-39,3,-40,-59,-62,-15,-20,-20,19,-40,-19,-15,-19,-65,-35,-155,-136,-77,-67,-26,-31,-75,-93,-42,-38,-39,-4,-80,-43,-35,-29,55,56,-1,-57,-43,-14,3,21,-22,16,12,21,12,24,2,-1,2,8,-9,-3,-24,17,10,13,-18,17,-12,-22,-17,-5,-14,1,-8,-12,-12,0,-4,16,-4,-10,-5,-5,-212,-147,-65,-221,-130,-91,-22,-28,-113,-59,-4,7,-12,-25,-75,-35,2,-4,-10,-3,-38,-24,-6,11,-31,-12,-81,-86,-16,-2,-17,-11,-49,-45,-9,-3,-14,-1,-32,-41,-7,1,40,11,29,66,37,29,21,16,-21,9,35,-26,3,6,-8,-2,22,-14,18,10,-13,11,13,-12,21,17,6,13,12,-12,13,4,5,13,7,-9,8,13,1,0,5,-3,-35,-23,-12,50,12,38,11,15,-52,-44,-1,29,7,-10,-25,-13,-5,18,4,25,-27,-31,4,11,21,29,8,-23,-2,9,9,2,8,-14,1,1,12,27,0,-9,-3,8,298,158,140,116,71,45,61,55,53,3,62,59,45,30,58,-10,21,14,16,25,-5,13,41,45,43,38,38,-33,21,2,29,20,42,-23,4,-4,14,18,-4,-10,17,6
12,12028,Benicasim/Benicàssim,11288,856,432,424,441,222,219,124,165,291,191,54,28,60,69,145,116,26,10,64,96,146,75,28,18,61,104,167,81,13,8,32,42,87,50,5,2,29,62,80,31,8,6,899,484,415,575,302,273,129,194,294,207,56,15,81,94,159,112,34,2,48,100,135,95,22,13,61,145,208,126,30,2,38,67,113,65,16,1,23,78,95,61,14,1,824,437,387,542,263,279,138,144,279,142,73,37,78,67,152,85,32,19,60,77,127,57,41,18,110,131,175,79,32,11,57,65,83,40,13,5,53,66,92,39,19,6,768,364,404,395,195,200,158,125,212,180,62,23,83,47,92,108,22,6,75,78,120,72,40,17,72,106,117,71,21,5,37,46,61,37,10,2,35,60,56,34,11,3,921,478,443,449,230,219,165,165,270,191,86,30,77,87,152,84,52,15,88,78,118,107,34,15,65,114,160,60,37,9,29,60,89,28,18,3,36,54,71,32,19,6,352,164,188,378,187,191,85,81,99,16,38,31,41,44,47,11,10,13,44,37,52,5,28,18,63,96,117,57,28,11,32,42,58,32,15,6,31,54,59,25,13,5,452,209,243,463,228,235,100,109,133,73,-5,35,39,38,71,54,-5,14,61,71,62,19,0,21,87,119,141,75,21,17,40,46,78,43,13,6,47,73,63,32,8,11,551,286,265,522,263,259,65,116,152,114,53,40,48,61,91,49,12,15,17,55,61,65,41,25,100,112,144,100,53,10,52,55,76,49,26,3,48,57,68,51,27,7,281,155,126,238,116,122,44,26,57,5,61,70,14,17,40,12,36,25,30,9,17,-7,25,45,43,52,67,40,21,8,19,20,29,28,11,4,24,32,38,12,10,4,161,69,92,164,58,106,37,23,-11,38,20,42,24,4,-8,9,14,23,13,19,-3,29,6,19,25,45,38,23,20,12,10,11,16,10,5,6,15,34,22,13,15,6,244,124,120,96,45,51,59,46,14,78,7,22,36,26,5,31,2,9,23,20,9,47,5,13,6,32,18,20,12,4,3,17,5,11,4,2,3,15,13,9,8,2,152,102,50,103,47,56,4,7,42,32,30,24,6,6,27,28,11,14,-2,1,15,4,19,10,7,19,28,18,20,5,3,4,12,10,11,4,4,15,16,8,9,1,116,58,58,62,31,31,1,22,53,-37,31,39,-8,19,27,-6,11,9,9,3,26,-31,20,30,7,17,13,1,16,7,5,7,9,2,6,2,2,10,4,-1,10,5,-90,-47,-43,18,0,18,-9,-22,12,-68,-34,12,7,-17,3,-29,-23,2,-16,-5,9,-39,-11,10,4,0,-1,-1,10,0,1,0,-3,-1,2,-1,3,0,2,0,8,1,-519,-271,-248,-529,-272,-257,-41,-61,-133,-167,-104,-22,-17,-24,-86,-96,-50,-4,-24,-37,-47,-71,-54,-18,-48,-39,-177,-154,-80,-33,-21,-16,-90,-101,-42,-4,-27,-23,-87,-53,-38,-29,-383,-242,-141,-425,-249,-176,-60,-40,-99,-150,-53,11,-34,-15,-47,-97,-36,-14,-26,-25,-52,-53,-17,25,-42,-15,-119,-138,-75,-40,-24,-11,-61,-92,-40,-23,-18,-4,-58,-46,-35,-17,-330,-219,-111,-440,-253,-187,5,-25,-66,-125,-117,-17,-1,-13,-58,-62,-84,-7,6,-12,-8,-63,-33,-10,-29,-7,-90,-176,-91,-52,-16,-3,-52,-104,-60,-21,-13,-4,-38,-72,-31,-31,223,121,102,160,79,81,56,2,46,45,10,53,15,9,31,34,9,17,41,-7,15,11,1,36,29,19,34,33,25,17,13,6,14,18,17,8,16,13,20,15,8,9
12,12021,Betxí,5339,26,11,15,23,13,10,5,4,22,-2,1,-2,2,4,7,-2,1,0,3,0,15,0,0,-2,1,9,7,6,0,0,1,5,5,2,0,0,0,4,2,4,0,0,35,11,24,32,15,17,6,9,13,3,3,2,4,2,1,2,4,-1,2,7,12,1,-1,3,3,7,14,6,1,1,1,3,9,2,0,0,2,4,5,4,1,1,22,18,4,53,30,23,-1,4,19,4,-1,-3,2,2,18,-2,-1,-1,-3,2,1,6,0,-2,7,16,19,8,3,0,6,10,10,2,2,0,1,6,9,6,1,0,41,20,21,51,19,32,16,8,9,2,7,0,9,-2,10,2,1,1,7,10,-1,0,6,-1,9,14,16,7,3,1,3,4,8,3,1,0,6,10,8,4,2,1,23,6,17,49,24,25,7,14,7,4,-2,-5,-1,4,7,-3,3,-3,8,10,0,7,-5,-2,11,15,15,9,-1,0,4,8,8,4,0,0,7,7,7,5,-1,0,70,53,17,62,36,26,17,29,7,17,-1,-2,15,14,14,11,-1,0,2,15,-7,6,0,-2,9,22,14,10,7,0,6,12,12,3,3,0,3,10,2,7,4,0,122,64,58,80,29,51,29,26,24,33,7,1,17,12,15,17,3,0,12,14,9,16,4,1,16,15,24,18,7,0,7,6,10,5,1,0,9,9,14,13,6,0,128,55,73,85,36,49,22,39,28,26,15,-1,2,17,18,10,9,-1,20,22,10,16,6,0,18,23,17,15,11,1,5,8,12,4,7,0,13,15,5,11,4,1,17,9,8,19,9,10,3,13,-2,8,-3,1,2,7,1,4,-4,1,1,6,-3,4,1,0,3,9,2,3,0,2,1,3,3,2,0,0,2,6,-1,1,0,2,14,-4,18,22,9,13,10,-1,6,1,-1,0,3,-2,0,0,-1,-3,7,1,6,1,0,3,7,4,7,-1,3,2,4,2,3,-1,1,0,3,2,4,0,2,2,-33,-24,-9,25,9,16,3,-16,-22,0,1,-1,-6,-13,-11,1,3,0,9,-3,-11,-1,-2,-1,7,7,3,8,0,0,2,2,1,4,0,0,5,5,2,4,0,0,-44,-22,-22,8,3,5,-21,2,-21,-10,9,0,-11,5,-11,-10,6,0,-10,-3,-10,0,3,0,1,3,3,-2,2,1,1,2,2,-2,0,0,0,1,1,0,2,1,-15,-2,-13,17,14,3,-7,-3,-13,0,2,3,-4,0,-6,3,0,2,-3,-3,-7,-3,2,1,3,4,1,5,2,0,4,2,3,2,1,0,-1,2,-2,3,1,0,-24,-12,-12,-38,-26,-12,-1,5,-3,-7,-15,-1,5,5,-7,-6,-8,0,-6,0,4,-1,-7,-1,-1,1,-11,-14,-11,-2,2,1,-9,-13,-5,-2,-3,0,-2,-1,-6,0,-21,-17,-4,-3,-3,0,5,-13,-1,-10,-2,-1,1,-5,-3,-9,0,-2,4,-8,2,-1,-2,1,4,0,-3,-2,0,-2,1,0,-4,-1,2,-1,3,0,1,-1,-2,-1,20,14,6,24,13,11,0,5,0,7,5,3,6,5,6,-3,2,-1,-6,0,-6,10,3,4,2,4,8,5,5,0,1,2,6,2,2,0,1,2,2,3,3,0,22,13,9,20,12,8,-7,12,-1,6,5,5,-1,7,-6,8,2,1,-6,5,5,-2,3,4,-2,9,3,1,8,0,-1,6,0,1,5,0,-1,3,3,0,3,0,-38,-22,-16,-23,-13,-10,-7,1,-21,-4,-4,-3,-8,7,-7,-6,-3,-4,1,-6,-14,2,-1,1,-4,-4,-6,-3,-5,-1,-4,0,-1,-4,-3,-1,0,-4,-5,1,-2,0
12,12032,Borriana/Burriana,26323,531,312,219,216,125,91,107,118,147,108,35,7,55,57,107,62,24,2,52,61,40,46,11,5,31,38,86,45,12,3,16,19,60,22,6,1,15,19,26,23,6,2,699,411,288,454,258,196,114,152,230,154,21,7,60,83,147,98,11,1,54,69,83,56,10,6,70,114,148,95,17,2,42,58,96,48,9,1,28,56,52,47,8,1,1196,674,522,703,404,299,244,263,383,216,35,36,128,134,233,129,22,16,116,129,150,87,13,20,142,182,228,110,21,15,72,100,151,61,14,4,70,82,77,49,7,11,894,467,427,608,318,290,129,254,269,154,48,33,66,109,164,93,15,16,63,145,105,61,33,17,108,174,176,105,27,12,52,83,104,58,12,6,56,91,72,47,15,6,1072,553,519,698,373,325,147,257,399,170,47,46,62,127,220,105,21,20,85,130,179,65,26,26,113,196,248,102,22,13,50,97,145,66,7,6,63,99,103,36,15,7,1122,624,498,725,409,316,198,272,338,188,69,41,127,117,214,106,31,19,71,155,124,82,38,22,134,218,217,101,38,8,76,112,144,51,16,5,58,106,73,50,22,3,1282,736,546,940,501,439,228,303,410,223,80,17,109,173,245,142,44,7,119,130,165,81,36,10,171,233,285,165,59,15,89,117,162,94,28,6,82,116,123,71,31,9,1076,633,443,964,542,422,81,328,333,213,65,45,35,180,234,127,36,18,46,148,99,86,29,27,152,295,290,162,44,15,83,149,183,94,23,7,69,146,107,68,21,8,144,107,37,369,217,152,-20,57,93,-5,1,19,1,41,70,0,-4,1,-21,16,23,-5,5,18,53,99,133,65,15,1,20,58,93,39,8,-1,33,41,40,26,7,2,-92,-118,26,81,9,72,-39,45,-86,-40,19,-1,-19,10,-79,-44,3,6,-20,35,-7,4,16,-7,9,65,-12,8,9,-5,14,25,-23,-13,3,-1,-5,40,11,21,6,-4,-81,-99,18,73,10,63,-24,41,-68,-39,-9,13,-21,16,-54,-45,-4,6,-3,25,-14,6,-5,7,31,44,-6,7,-1,-4,14,21,-20,-4,-2,0,17,23,14,11,1,-4,-56,-56,0,157,65,92,-34,11,-2,-19,-29,12,-20,-9,5,-13,-23,-1,-14,20,-7,-6,-6,13,23,51,38,27,11,5,14,19,20,7,1,2,9,32,18,20,10,3,-871,-543,-328,-831,-512,-319,-145,-82,-301,-220,-84,-34,-90,-40,-182,-163,-52,-12,-55,-42,-119,-57,-32,-22,-127,-56,-283,-230,-100,-38,-62,-34,-177,-168,-55,-18,-65,-22,-106,-62,-45,-20,-91,-82,-9,49,5,44,-15,25,-51,-82,11,21,-6,11,-34,-57,2,4,-9,14,-17,-25,9,17,12,24,11,-7,-4,12,0,12,0,-5,-7,5,12,12,11,-2,3,7,-19,-4,-15,156,77,79,-9,3,-66,25,17,15,-9,9,-36,16,5,12,0,-6,-30,9,12,3,26,36,32,44,14,5,17,19,12,24,2,3,9,17,20,20,12,2,-623,-396,-227,-508,-324,-184,-37,-35,-261,-216,-79,5,-21,-7,-160,-152,-57,-2,-16,-28,-101,-64,-22,7,-32,1,-191,-200,-79,-10,-15,5,-113,-145,-55,-3,-17,-4,-78,-55,-24,-7,-263,-159,-104,-259,-168,-91,-12,0,-105,-117,-50,15,0,1,-57,-93,-27,9,-12,-1,-48,-24,-23,6,-31,29,-97,-113,-52,3,-7,17,-59,-87,-34,0,-24,12,-38,-26,-18,3,-16,11,-27,-13,-24,11,2,12,-25,-34,-6,36,-3,17,-1,-19,-6,22,5,-5,-24,-15,0,14,-9,19,-10,-31,-2,15,-4,14,-2,-32,-6,4,-5,5,-8,1,4,11
12,12031,Borriol,3405,164,89,75,51,25,26,28,39,47,45,4,2,13,18,29,26,2,2,15,21,18,19,2,0,9,21,12,9,0,0,3,10,7,5,0,0,6,11,5,4,0,0,52,21,31,3,1,2,-1,10,20,20,6,0,-5,5,8,11,1,3,4,5,12,9,5,-3,0,0,2,1,0,0,0,0,0,1,0,0,0,0,2,0,0,0,100,57,43,2,2,0,23,14,19,45,1,-1,15,10,9,21,3,-1,8,4,10,24,-2,0,1,0,0,0,0,1,0,1,0,0,0,1,1,-1,0,0,0,0,128,84,44,26,11,15,21,28,28,31,15,5,13,16,19,21,11,3,8,12,9,10,4,2,10,7,2,3,4,0,4,3,0,2,2,0,6,4,2,1,2,0,71,41,30,24,14,10,13,-12,60,6,3,-2,8,1,27,5,1,-2,5,-13,33,1,2,0,5,2,7,6,3,1,4,1,5,2,2,0,1,1,2,4,1,1,132,70,62,36,15,21,32,16,47,35,-4,1,13,6,25,20,2,-1,19,10,22,15,-6,2,9,10,9,3,5,0,4,2,4,2,3,0,5,8,5,1,2,0,247,134,113,60,25,35,34,42,86,60,17,2,15,17,57,31,10,0,19,25,29,29,7,2,16,17,12,8,4,3,9,8,3,3,1,1,7,9,9,5,3,2,157,56,101,64,31,33,17,40,65,18,14,-3,5,15,28,6,7,-6,12,25,37,12,7,3,11,15,18,13,6,0,4,8,9,5,4,0,7,7,9,8,2,0,137,71,66,23,10,13,19,26,64,19,6,-1,6,11,37,13,2,1,13,15,27,6,4,-2,2,11,7,1,0,1,1,6,1,1,0,1,1,5,6,0,0,0,43,21,22,6,-1,7,22,10,9,0,0,1,15,5,3,3,-2,-3,7,5,6,-3,2,4,5,-1,0,-1,0,2,3,-2,0,0,-1,-1,2,1,0,-1,1,3,80,47,33,9,2,7,8,4,30,12,22,5,12,1,16,2,11,5,-4,3,14,10,11,0,-2,3,4,3,1,-1,-2,0,2,0,1,0,0,3,2,3,0,-1,35,26,9,3,4,-1,-6,17,10,6,-2,10,-1,8,14,3,-4,6,-5,9,-4,3,2,4,-6,4,2,-1,2,2,-3,2,1,2,1,1,-3,2,1,-3,1,1,0,4,-4,18,10,8,10,-5,3,-7,3,-8,4,-5,4,2,2,-5,6,0,-1,-9,1,-3,9,1,4,5,0,-1,3,1,3,3,0,0,6,0,1,2,0,-1,-61,-47,-14,-58,-39,-19,-17,-14,-10,-13,2,-7,-18,-4,-14,-7,1,-4,1,-10,4,-6,1,-3,-14,-7,-20,-6,-6,-4,-9,-5,-11,-8,-4,-1,-5,-2,-9,2,-2,-3,-38,-28,-10,-18,-15,-3,-6,-8,-6,-12,-12,2,-4,-3,3,-21,-7,2,-2,-5,-9,9,-5,0,1,1,-10,-8,0,-2,-1,0,-2,-7,-3,-2,2,1,-8,-1,3,0,-17,-1,-16,-27,-16,-11,-2,-3,-1,-5,1,-9,5,4,-6,-4,1,-1,-7,-7,5,-1,0,-8,-5,-3,-6,-10,-2,-1,-3,0,-5,-7,-1,0,-2,-3,-1,-3,-1,-1,80,42,38,-10,-5,-5,22,4,32,1,5,11,14,0,16,0,2,6,8,4,16,1,3,5,-9,0,3,-4,-2,0,-2,0,1,-4,-1,0,-7,0,2,0,-1,0,19,14,5,-7,-7,0,-1,-1,15,-3,6,4,2,1,6,4,0,4,-3,-2,9,-7,6,0,3,0,-2,-6,-1,-2,3,-1,-2,-3,-4,0,0,1,0,-3,3,-2
12,12052,Chert/Xert,913,-1,3,-4,11,8,3,-1,-5,-1,3,2,1,-1,-1,0,2,2,1,0,-4,-1,1,0,0,0,2,6,3,0,0,0,1,5,2,0,0,0,1,1,1,0,0,22,9,13,29,15,14,5,7,9,2,4,-5,2,3,5,1,1,-3,3,4,4,1,3,-2,5,5,12,3,3,1,2,2,7,2,1,1,3,3,5,1,2,0,17,13,4,29,19,10,3,13,-1,5,-1,-2,3,8,-2,4,1,-1,0,5,1,1,-2,-1,4,10,8,6,1,0,3,7,4,4,1,0,1,3,4,2,0,0,7,4,3,33,16,17,2,3,0,7,-4,-1,-1,2,2,4,-2,-1,3,1,-2,3,-2,0,5,8,13,8,-1,0,1,3,8,4,0,0,4,5,5,4,-1,0,20,10,10,36,17,19,7,2,12,0,4,-5,5,0,5,1,2,-3,2,2,7,-1,2,-2,8,7,10,5,5,1,5,2,3,3,3,1,3,5,7,2,2,0,11,9,2,33,22,11,-3,11,-2,-2,2,5,0,6,1,-3,2,3,-3,5,-3,1,0,2,2,16,9,5,1,0,2,9,8,2,1,0,0,7,1,3,0,0,9,11,-2,26,19,7,0,8,-1,3,0,0,3,5,1,1,0,1,-3,3,-2,2,0,-1,3,8,8,6,1,0,4,5,6,3,1,0,-1,3,2,3,0,0,15,6,9,21,8,13,6,-2,1,7,2,1,3,-3,0,2,2,1,3,1,1,5,0,0,1,10,1,7,0,2,1,5,0,1,0,1,0,5,1,6,0,1,-8,0,-8,3,4,-1,-1,-6,-1,-2,1,1,1,-3,1,0,0,1,-2,-3,-2,-2,1,0,1,0,1,0,1,0,1,0,1,1,1,0,0,0,0,-1,0,0,1,1,0,-3,-2,-1,-3,0,5,0,-3,0,-2,0,2,1,-2,0,-1,0,3,-1,-1,0,-6,2,3,-2,0,0,-4,0,3,-1,0,0,-2,2,0,-1,0,0,1,1,0,8,5,3,-1,3,-1,2,-1,-1,-1,3,-1,0,-2,1,0,0,0,2,1,-2,0,3,1,3,0,0,0,1,1,2,0,0,0,2,0,1,0,0,-2,1,-3,0,-1,1,-1,7,-1,-7,2,-1,0,4,1,-6,1,1,-1,3,-2,-1,1,-2,0,0,0,0,0,0,0,0,0,-1,0,0,0,0,0,1,0,0,-5,-4,-1,2,-1,3,0,-2,-1,-3,1,0,-1,-1,0,-3,1,0,1,-1,-1,0,0,0,0,1,-1,-1,2,1,-1,0,-1,-1,2,0,1,1,0,0,0,1,-11,-7,-4,-1,0,-1,-3,-1,-2,0,-2,-3,-3,0,-1,0,-2,-1,0,-1,-1,0,0,-2,0,0,1,0,0,-2,0,0,1,0,0,-1,0,0,0,0,0,-1,-17,-10,-7,-15,-10,-5,-3,-2,-12,-2,0,2,0,-2,-7,-1,-2,2,-3,0,-5,-1,2,0,0,-2,-7,-4,-2,0,0,-2,-3,-3,-2,0,0,0,-4,-1,0,0,-22,-12,-10,-17,-9,-8,-4,-3,-8,-4,0,-3,-3,-1,-5,-3,0,0,-1,-2,-3,-1,0,-3,-1,0,-6,-6,-3,-1,0,0,-2,-4,-2,-1,-1,0,-4,-2,-1,0,-1,-4,3,-1,-1,0,5,0,0,-3,2,-5,1,0,1,-3,1,-4,4,0,-1,0,1,-1,0,0,1,-2,1,-1,-1,0,1,-1,0,0,1,0,0,-1,1,-1,-3,0,-3,-3,-2,-1,1,-2,-1,-3,2,0,1,-2,0,-2,3,0,0,0,-1,-1,-1,0,-1,-1,3,-3,0,-1,-1,-1,4,-3,0,-1,0,0,-1,0,0,0
12,12053,Chilches/Xilxes,2228,27,20,7,28,16,12,3,6,17,5,4,-7,2,4,11,3,3,-3,1,2,6,2,1,-4,7,5,11,4,1,0,4,3,5,3,1,0,3,2,6,1,0,0,89,50,39,75,43,32,15,13,33,17,8,3,7,9,20,6,5,3,8,4,13,11,3,0,12,21,26,11,4,1,7,12,16,4,3,1,5,9,10,7,1,0,70,46,24,30,15,15,13,13,23,14,9,-3,11,11,8,11,7,-2,2,2,15,3,2,-1,8,8,10,3,1,0,5,2,7,0,1,0,3,6,3,3,0,0,63,37,26,23,8,15,5,2,39,10,5,2,0,3,23,4,4,1,5,-1,16,6,1,1,5,8,5,4,1,0,2,3,0,3,0,0,3,5,5,1,1,0,14,-3,17,12,5,7,-4,8,0,8,5,-1,-4,1,-3,4,0,-1,0,7,3,4,5,0,1,7,2,1,1,0,1,3,0,1,0,0,0,4,2,0,1,0,69,38,31,28,15,13,16,14,12,17,11,-1,11,7,5,10,6,-1,5,7,7,7,5,0,2,7,9,6,2,2,1,3,5,4,1,1,1,4,4,2,1,1,103,68,35,48,25,23,21,1,47,19,13,1,17,1,25,12,9,4,4,0,22,7,4,-3,9,7,24,6,1,0,6,1,14,4,0,0,3,6,10,2,1,0,102,58,44,56,31,25,23,8,35,19,11,1,10,3,25,10,9,0,13,5,10,9,2,1,16,15,17,6,1,0,7,11,10,3,0,0,9,4,7,3,1,0,35,24,11,30,14,16,11,15,-3,6,3,4,11,4,3,1,4,3,0,11,-6,5,-1,1,9,12,6,1,1,1,5,4,5,0,0,0,4,8,1,1,1,1,7,-6,13,-4,-13,9,-11,15,-1,-4,3,4,-4,9,-4,-6,0,0,-7,6,3,2,3,4,3,-4,-2,-5,2,2,1,-5,-5,-6,1,1,2,1,3,1,1,1,-39,-25,-14,-28,-19,-9,-2,3,-13,-16,0,-10,3,5,-10,-15,-1,-7,-5,-2,-3,-1,1,-3,-3,2,-9,-11,0,-6,-2,1,-6,-8,0,-3,-1,1,-3,-3,0,-3,31,32,-1,2,4,-2,6,6,11,3,8,-5,3,6,17,2,5,-2,3,0,-6,1,3,-3,1,0,2,1,-1,-1,3,1,0,0,0,0,-2,-1,2,1,-1,-1,52,40,12,-2,0,-2,12,9,17,10,-2,5,15,10,11,4,0,0,-3,-1,6,6,-2,5,-1,4,-3,-1,-1,0,1,3,-3,-1,0,0,-2,1,0,0,-1,0,-74,-31,-43,-21,-14,-7,-15,-15,-23,-14,-5,-2,-15,-4,-6,-7,0,0,0,-11,-17,-7,-5,-2,-2,-1,-11,-7,0,0,-3,0,-9,-4,1,1,1,-1,-2,-3,-1,-1,-90,-53,-37,-19,-10,-9,-18,-10,-16,-39,-4,-5,-11,-10,-13,-20,-1,0,-7,0,-3,-19,-3,-5,-2,-5,-3,-6,-2,-2,0,-1,-1,-5,-1,-2,-2,-4,-2,-1,-1,0,-55,-21,-34,9,5,4,-12,9,-20,-18,-17,3,0,4,-11,-9,-4,-1,-12,5,-9,-9,-13,4,2,3,3,-2,4,-1,3,2,1,-2,2,-1,-1,1,2,0,2,0,-3,-9,6,4,-7,11,1,11,-4,0,-7,-2,0,5,-3,-4,-5,-2,1,6,-1,4,-2,0,-1,8,-2,-3,1,0,-2,3,-3,-4,0,-1,1,5,1,1,1,1,36,-1,37,24,4,20,-5,16,12,13,6,-8,-6,3,5,2,1,-6,1,13,7,11,5,-2,0,8,7,4,4,0,1,-1,5,-2,1,0,-1,9,2,6,3,0
12,12050,"Coves de Vinromà, les",1836,-4,3,-7,17,12,5,-3,-5,5,0,2,-3,-4,-1,10,-2,0,0,1,-4,-5,2,2,-3,1,5,8,1,2,0,0,3,8,0,1,0,1,2,0,1,1,0,86,67,19,81,63,18,8,34,28,10,2,2,6,28,22,7,2,1,2,6,6,3,0,1,10,37,24,7,0,1,6,31,21,4,0,0,4,6,3,3,0,1,48,29,19,42,31,11,1,15,10,6,13,1,2,10,5,4,5,1,-1,5,5,2,8,0,4,17,13,6,0,1,4,15,6,5,0,0,0,2,7,1,0,1,58,22,36,55,24,31,21,17,7,10,1,3,5,10,-1,5,0,3,16,7,8,5,1,0,20,13,14,7,1,-1,7,8,6,2,0,0,13,5,8,5,1,-1,2,-10,12,-5,-9,4,6,5,-22,-1,6,4,2,2,-20,-4,4,2,4,3,-2,3,2,2,4,-1,-3,-4,-1,0,0,0,-4,-4,-1,0,4,-1,1,0,0,0,40,27,13,64,39,25,0,13,17,3,2,5,1,8,10,4,0,4,-1,5,7,-1,2,1,8,22,23,4,5,2,5,11,15,3,4,1,3,11,8,1,1,1,149,74,75,79,44,35,23,30,35,37,16,8,11,11,23,15,12,2,12,19,12,22,4,6,21,25,23,8,1,0,13,13,14,3,1,-1,8,12,9,5,0,1,118,80,38,87,69,18,-3,35,40,31,16,-2,-1,25,29,20,7,-1,-2,10,11,11,9,-1,-1,29,31,22,4,1,-1,21,28,16,3,1,0,8,3,6,1,0,-1,8,-9,29,12,17,3,-2,-2,-1,-1,0,-1,-1,4,5,0,1,4,-1,-6,-6,-1,-1,6,9,9,2,1,1,0,5,6,1,0,0,6,4,3,1,1,1,-4,-17,13,18,4,14,20,-5,-8,-12,-2,1,11,-3,-12,-11,-2,0,9,-2,4,-1,0,1,19,-1,2,-4,2,-1,12,0,-4,-4,0,0,7,-1,6,0,2,-1,27,11,16,7,-1,8,3,8,0,4,11,0,3,4,-2,1,4,0,0,4,2,3,7,0,4,2,-1,-3,4,1,4,-1,-2,-5,3,0,0,3,1,2,1,1,-24,-14,-10,-2,-4,2,2,3,-7,-4,-11,-6,0,0,-5,-2,-3,-3,2,3,-2,-2,-8,-3,3,-2,0,0,-2,-1,1,-2,-1,-1,-1,0,2,0,1,1,-1,-1,-81,-29,-52,-57,-28,-29,-16,-2,-36,-14,-6,-5,0,0,-22,-3,-4,1,-16,-2,-14,-11,-2,-6,-12,-3,-26,-15,-2,1,-4,0,-17,-7,-2,2,-8,-3,-9,-8,0,-1,-16,-6,-10,-1,-1,0,0,-2,2,-5,-1,-8,0,0,2,-5,-1,-1,0,-2,0,0,0,-7,1,-1,0,-1,0,0,0,-1,1,-1,0,0,1,0,-1,0,0,0,-21,-22,1,-2,-4,2,1,-2,-2,-19,3,-1,0,-5,-1,-17,2,-1,1,3,-1,-2,1,0,0,2,1,-5,1,-1,0,-1,-1,-2,1,-1,0,3,2,-3,0,0,10,3,7,8,5,3,6,2,-2,2,0,2,3,4,-3,-1,0,-1,3,-2,1,3,0,3,3,2,0,3,-1,1,2,2,-1,2,0,0,1,0,1,1,-1,1,-20,-1,-19,22,14,8,-12,1,-7,7,2,-8,-5,3,-2,8,1,-5,-7,-2,-5,-1,1,-3,3,5,3,9,2,0,2,2,4,5,1,0,1,3,-1,4,1,0,-3,0,-3,16,10,6,3,4,-11,8,0,-6,2,-1,-4,7,-1,-2,1,5,-7,1,1,-4,6,3,-2,6,2,1,4,1,-1,5,1,0,2,2,-1,1,1,1
12,12072,Lucena del Cid,1581,13,15,-2,15,14,1,-2,9,6,4,-3,-1,1,9,4,3,-1,0,-3,0,2,1,-2,-1,1,5,4,4,0,1,1,5,4,3,0,1,0,0,0,1,0,0,29,23,6,13,6,7,-8,21,9,-1,4,4,-5,15,7,2,1,3,-3,6,2,-3,3,1,3,4,2,3,1,0,1,3,1,1,0,0,2,1,1,2,1,0,53,22,31,19,9,10,8,8,18,15,2,2,3,2,8,7,2,0,5,6,10,8,0,2,1,8,5,5,0,0,0,4,3,2,0,0,1,4,2,3,0,0,12,2,10,15,8,7,3,-1,1,3,5,1,1,1,-2,-1,3,0,2,-2,3,4,2,1,1,3,8,2,1,0,1,2,3,1,1,0,0,1,5,1,0,0,4,8,-4,21,12,9,4,1,-3,2,2,-2,5,-2,0,3,2,0,-1,3,-3,-1,0,-2,8,2,7,1,3,0,5,0,5,0,2,0,3,2,2,1,1,0,11,4,7,22,9,13,0,6,0,2,2,-1,2,-2,2,-1,3,-1,-2,8,-2,3,-1,0,1,8,10,2,0,0,1,1,7,0,0,0,0,7,3,2,0,0,23,9,14,13,9,4,1,1,16,1,3,2,-3,1,10,2,-1,1,4,0,6,-1,4,1,2,5,2,2,1,1,2,5,0,1,0,1,0,0,2,1,1,0,12,8,4,19,12,7,0,-3,7,7,-1,2,0,0,6,6,-1,-2,0,-3,1,1,0,4,4,4,6,6,-1,0,3,3,4,4,-2,0,1,1,2,2,1,0,19,16,3,12,9,3,7,8,2,2,4,-2,7,6,1,3,1,0,0,2,1,-1,3,-2,1,6,3,0,1,0,1,5,2,0,1,0,0,1,1,0,0,0,-49,-35,-14,-7,-7,0,-12,-4,-19,-9,-2,-1,-11,-4,-11,-10,0,2,-1,0,-8,1,-2,-3,-1,-2,-2,0,-2,0,-1,-2,-1,-2,-1,0,0,0,-1,2,-1,0,-16,-8,-8,4,1,3,-9,0,-1,-7,-4,4,-6,0,-1,-3,-1,2,-3,0,0,-4,-3,2,1,1,1,1,0,0,0,0,0,1,0,0,1,1,1,0,0,0,-15,-10,-5,7,5,2,-1,-2,-2,-9,-6,4,-1,0,-1,-5,-4,1,0,-2,-1,-4,-2,3,4,0,2,0,1,0,3,1,1,0,0,0,1,-1,1,0,1,0,-33,-14,-19,6,3,3,-16,-3,-13,-2,1,-2,-5,-3,-7,-1,0,0,-11,0,-6,-1,1,-2,0,1,1,2,2,0,0,1,1,0,1,0,0,0,0,2,1,0,-26,-19,-7,-8,-7,-1,-8,-1,-8,-6,3,-6,-6,-1,-6,-7,3,-2,-2,0,-2,1,0,-4,0,0,-2,-5,0,-1,0,-1,-2,-4,0,0,0,1,0,-1,0,-1,-13,-2,-11,-11,-5,-6,-6,6,-15,2,-4,4,-4,3,-7,5,-1,2,-2,3,-8,-3,-3,2,-2,-1,-2,-2,-4,0,-1,-1,-2,0,-1,0,-1,0,0,-2,-3,0,-3,-3,0,2,1,1,0,-5,-3,3,3,-1,-3,-3,2,1,0,0,3,-2,-5,2,3,-1,-1,0,0,1,1,1,-1,0,0,1,0,1,0,0,0,0,1,0,-19,-7,-12,-6,-2,-4,-8,-2,-1,-6,-2,0,-2,1,-3,-2,-3,2,-6,-3,2,-4,1,-2,0,1,-5,-1,0,-1,0,1,-3,0,0,0,0,0,-2,-1,0,-1,2,-1,3,-4,-1,-3,7,-2,-4,-1,0,2,5,-1,-5,-3,2,1,2,-1,1,2,-2,1,-1,-1,-1,0,-1,0,-1,1,-1,0,0,0,0,-2,0,0,-1,0
12,12079,Montanejos,425,22,10,12,11,5,6,0,0,6,12,4,0,0,2,3,3,2,0,0,-2,3,9,2,0,0,2,4,5,0,0,0,2,2,1,0,0,0,0,2,4,0,0,14,3,11,21,8,13,10,8,6,2,-4,-5,4,2,3,1,-3,-2,6,6,3,1,-1,-3,6,5,6,4,0,0,2,2,2,2,0,0,4,3,4,2,0,0,25,15,10,13,6,7,2,12,10,-1,2,0,0,7,6,2,1,-1,2,5,4,-3,1,1,0,7,3,3,0,0,0,3,1,2,0,0,0,4,2,1,0,0,16,10,6,22,8,14,-1,2,9,3,0,2,-1,2,7,0,0,2,0,0,2,3,0,0,6,9,3,4,0,0,2,5,1,0,0,0,4,4,2,4,0,0,3,4,-1,11,5,6,0,2,8,0,-2,-4,1,1,3,2,-1,-2,-1,1,5,-2,-1,-2,1,3,6,1,0,0,0,1,3,1,0,0,1,2,3,0,0,0,21,13,8,15,9,6,2,10,3,2,2,3,2,6,3,1,1,1,0,4,0,1,1,2,1,8,6,0,0,0,0,6,3,0,0,0,1,2,3,0,0,0,110,53,57,33,16,17,6,16,28,29,21,9,4,8,14,15,11,1,2,8,14,14,10,8,9,6,11,6,1,0,6,2,4,4,0,0,3,4,7,2,1,0,2,-1,3,4,3,1,0,10,0,-3,0,-5,-2,6,0,-3,0,-2,2,4,0,0,0,-3,0,6,0,0,-2,0,-1,5,0,0,-1,0,1,1,0,0,-1,0,7,2,5,19,9,10,9,8,-5,-4,0,0,3,7,-7,-1,0,0,6,1,2,-3,0,0,6,6,4,2,1,0,2,5,0,2,0,0,4,1,4,0,1,0,11,-1,12,11,3,8,-1,12,-10,9,-3,4,-2,3,-5,3,-2,2,1,9,-5,6,-1,2,2,6,2,1,0,0,0,3,0,0,0,0,2,3,2,1,0,0,13,9,4,7,3,4,-2,2,8,4,9,-7,0,2,8,-1,5,-4,-2,0,0,5,4,-3,3,1,2,0,1,0,2,0,1,0,0,0,1,1,1,0,1,0,-4,1,-5,-2,-2,0,-1,-1,0,-1,3,-4,-1,-1,5,-1,1,-2,0,0,-5,0,2,-2,0,-1,1,-1,-1,0,0,-1,1,-1,-1,0,0,0,0,0,0,0,-11,-12,1,-4,-5,1,-2,2,-7,1,-5,0,-4,-1,-8,0,-1,2,2,3,1,1,-4,-2,-4,3,-2,0,-1,0,-3,0,-1,0,-1,0,-1,3,-1,0,0,0,-5,1,-6,-11,-4,-7,0,4,-8,1,-4,2,1,4,-5,2,-2,1,-1,0,-3,-1,-2,1,0,0,-4,-6,0,-1,0,1,-2,-3,0,0,0,-1,-2,-3,0,-1,-25,-11,-14,-5,-2,-3,-5,-4,-3,-4,-6,-3,-3,-2,-2,-2,-1,-1,-2,-2,-1,-2,-5,-2,-2,0,-1,-2,0,0,-1,0,-1,0,0,0,-1,0,0,-2,0,0,-8,3,-11,1,1,0,-3,2,-11,3,1,0,2,1,-6,6,0,0,-5,1,-5,-3,1,0,-1,1,0,1,0,0,0,1,0,0,0,0,-1,0,0,1,0,0,-19,-8,-11,3,2,1,-2,-2,-3,-6,-4,-3,-2,0,-1,-2,-3,-1,0,-2,-2,-4,-1,-2,0,0,1,1,0,0,0,0,1,0,0,0,0,0,0,1,0,0,41,23,18,9,8,1,7,8,5,11,4,5,6,6,5,4,2,0,1,2,0,7,2,5,2,1,4,2,0,0,2,1,4,1,0,0,0,0,0,1,0,0
12,12080,Morella,2719,16,9,7,28,15,13,-4,1,11,2,1,2,-3,5,7,0,0,-1,-1,-4,4,2,1,3,4,2,13,8,0,0,0,2,9,3,0,0,4,0,4,5,0,0,81,51,30,83,48,35,12,27,9,31,7,-6,5,19,11,13,4,-2,7,8,-2,18,3,-4,9,23,21,27,2,0,4,15,15,12,1,0,5,8,6,15,1,0,37,24,13,79,44,35,11,24,9,-4,-1,-4,10,11,1,2,0,0,1,13,8,-6,-1,-4,11,32,22,9,3,0,9,16,9,8,1,0,2,16,13,1,2,0,48,30,18,61,40,21,-7,23,22,9,6,-5,-5,18,5,8,4,-1,-2,5,17,1,2,-4,4,22,17,13,3,1,2,15,8,10,3,1,2,7,9,3,0,0,53,30,23,67,34,33,8,8,8,17,7,3,2,6,1,14,3,2,6,2,7,3,4,1,8,20,19,15,4,0,3,11,9,10,0,0,5,9,10,5,4,0,58,40,18,72,46,26,9,11,20,17,3,-2,6,4,17,12,1,0,3,7,3,5,2,-2,9,16,20,23,2,1,7,8,12,17,0,1,2,8,8,6,2,0,61,29,32,76,39,37,2,28,1,13,13,2,0,16,6,1,5,0,2,12,-5,12,8,2,9,28,21,14,3,0,4,16,13,5,0,0,5,12,8,9,3,0,10,12,-2,48,27,21,11,5,-13,5,7,-5,8,7,-5,1,2,-1,3,-2,-8,4,5,-4,6,16,11,9,6,0,3,7,7,7,3,0,3,9,4,2,3,0,3,6,-3,5,1,4,5,9,-6,-8,1,2,5,1,-1,-5,2,5,0,8,-5,-3,-1,-3,3,6,5,-7,-1,-1,1,1,6,-7,0,0,2,5,-1,0,-1,-1,29,14,15,25,11,14,2,13,-6,0,6,14,2,9,-5,-2,4,5,0,4,-1,2,2,9,5,10,3,5,0,2,3,5,0,2,0,1,2,5,3,3,0,1,-12,-7,-5,0,-3,3,0,4,-6,-11,-3,4,3,-2,-1,-7,-4,5,-3,6,-5,-4,1,-1,-1,4,-1,-3,1,0,1,0,-1,-2,-1,0,-2,4,0,-1,2,0,-37,-18,-19,-21,-11,-10,1,-6,-2,-14,-13,-3,1,-2,-5,-5,-5,-2,0,-4,3,-9,-8,-1,2,-3,-9,-9,-2,0,2,-2,-7,-4,0,0,0,-1,-2,-5,-2,0,3,-8,11,-5,-5,0,7,4,-9,3,1,-4,5,1,-11,2,-2,-2,2,3,2,1,3,-2,0,3,-6,-2,-1,0,1,2,-4,-2,-1,0,-1,1,-2,0,0,0,-15,-12,-3,-4,-5,1,1,-1,1,-9,-6,2,-1,0,-1,-4,-5,1,2,-1,2,-5,-1,1,2,0,-3,-1,-2,0,1,0,-2,-2,-2,0,1,0,-1,1,0,0,-53,-22,-31,-38,-22,-16,-4,-6,-23,-22,1,1,-2,-1,-15,-11,6,1,-2,-5,-8,-11,-5,0,-3,-4,-13,-15,-3,0,-1,-1,-10,-10,0,0,-2,-3,-3,-5,-3,0,-33,-7,-26,-9,-6,-3,-1,-3,-11,-10,-4,-6,6,1,-4,-4,-6,-2,-7,-4,-7,-6,2,-4,3,1,-9,-1,-3,-1,3,0,-5,-2,-3,0,0,1,-4,1,0,-1,-11,-1,-10,19,7,12,-6,-8,-3,7,1,-4,-1,-9,2,4,3,-3,-5,1,-5,3,-2,-1,2,4,6,6,1,0,1,0,2,3,1,0,1,4,4,3,0,0,3,-9,12,11,4,7,0,6,-10,1,0,4,-2,2,-8,-1,2,-3,2,4,-2,2,-2,7,3,3,2,1,2,0,2,2,0,0,0,0,1,1,2,1,2,0
12,12082,Nules,11444,98,53,45,50,31,19,-1,29,41,-1,-4,27,2,8,23,3,-2,13,-3,21,18,-4,-2,14,7,5,22,10,4,1,5,3,13,7,2,0,2,2,9,3,2,1,110,68,42,42,22,20,22,29,14,25,0,10,12,27,2,15,2,4,10,2,12,10,-2,6,7,15,9,6,0,2,3,9,4,4,0,2,4,6,5,2,0,0,133,77,56,131,74,57,12,32,52,33,10,-6,9,15,44,10,0,-2,3,17,8,23,10,-4,17,36,52,19,5,1,10,19,35,8,0,1,7,17,17,11,5,0,201,107,94,133,67,66,47,60,73,17,1,2,13,27,50,10,8,-2,34,33,23,7,-7,4,28,35,42,22,2,2,13,14,23,14,1,0,15,21,19,8,1,2,294,163,131,179,101,78,51,70,107,41,18,0,30,31,68,27,1,2,21,39,39,14,17,-2,20,58,67,24,6,1,9,29,46,13,1,1,11,29,21,11,5,0,342,174,168,173,94,79,56,86,111,56,13,5,20,41,60,30,6,5,36,45,51,26,7,0,28,51,60,24,6,0,12,28,37,12,3,0,16,23,23,12,3,0,278,152,126,197,99,98,62,66,108,40,5,-12,27,25,63,34,0,-3,35,41,45,6,5,-9,47,53,54,25,14,2,26,22,29,12,8,1,21,31,25,13,6,1,266,146,120,211,97,114,67,71,83,27,22,0,35,28,61,13,12,2,32,43,22,14,10,-2,48,56,64,29,11,2,22,21,33,15,4,0,26,35,31,14,7,2,207,114,93,144,73,71,32,62,57,36,13,5,14,32,49,12,1,3,18,30,8,24,12,2,36,39,37,18,9,4,17,17,26,9,2,1,19,22,11,9,7,3,159,93,66,107,46,61,16,29,33,42,24,0,1,23,21,27,8,2,15,6,12,15,16,-2,19,22,31,16,12,2,9,10,15,4,3,0,10,12,16,12,9,2,-124,-106,-18,-117,-85,-32,-6,-8,-68,-32,-13,0,-13,-23,-37,-15,-9,-7,7,15,-31,-17,-4,7,-10,-8,-51,-38,-8,-6,-9,-12,-27,-27,-8,-3,-1,4,-24,-11,0,-3,-49,-24,-25,-18,-21,3,-3,5,-28,-6,-15,-4,-1,3,-21,-5,-4,0,-2,2,-7,-1,-11,-4,-1,8,-17,-5,-4,-2,0,-1,-15,-4,-1,-2,-1,9,-2,-1,-3,0,-123,-88,-35,-51,-36,-15,-29,1,-36,-35,-18,-8,-17,0,-32,-30,-9,0,-12,1,-4,-5,-9,-8,-20,5,-7,-16,-13,-1,-10,0,-8,-13,-7,2,-10,5,1,-3,-6,-3,-121,-62,-59,-105,-56,-49,-8,2,-72,-32,-12,1,4,-1,-46,-17,2,-5,-12,3,-26,-15,-14,6,-13,-3,-57,-15,-12,-3,-3,-2,-36,-11,-1,-2,-10,-1,-21,-4,-11,-1,-15,-13,-2,-1,2,-3,3,11,-20,-14,1,4,4,14,-21,-9,2,-1,-1,-3,1,-5,-1,5,-3,7,-7,-5,2,4,1,6,-6,-4,3,2,-4,1,-1,-1,-1,2,-164,-62,-102,-86,-37,-49,-56,-18,-47,-23,-22,2,-22,-6,-17,-15,-6,3,-34,-12,-30,-8,-16,-1,-27,6,-15,-33,-18,0,-14,7,-2,-23,-6,0,-13,-1,-13,-10,-12,0,-17,-2,-15,-9,1,-10,2,8,-27,-8,2,4,9,10,-14,-6,-6,6,-7,-2,-13,-2,8,-2,7,7,-7,-13,-4,0,14,7,-9,-9,-4,1,-7,0,2,-4,0,-1,-24,2,-26,-16,-13,-3,-9,-3,-6,-4,-8,7,4,3,-3,3,-9,5,-13,-6,-3,-7,1,2,-6,2,-1,-16,1,4,-4,3,1,-12,-3,2,-2,-1,-2,-4,4,2
12,12084,Onda,19110,387,213,174,205,118,87,48,105,134,69,28,-4,23,49,87,37,16,-3,25,56,47,32,12,-1,21,49,85,40,9,0,11,29,49,22,6,0,10,20,36,18,3,0,493,296,197,285,155,130,72,154,159,84,11,9,33,92,101,64,1,3,39,62,58,20,10,6,47,88,103,33,12,0,22,48,59,20,4,0,25,40,44,13,8,0,518,255,263,297,147,150,91,122,192,77,24,2,42,60,90,45,8,0,49,62,102,32,16,2,58,78,95,49,15,1,29,38,48,26,6,0,29,40,47,23,9,1,608,290,318,362,166,196,133,163,196,82,17,8,60,64,109,41,1,6,73,99,87,41,16,2,82,99,118,51,6,2,46,38,59,18,2,0,36,61,59,33,4,2,649,365,284,416,215,201,88,192,264,72,22,7,53,98,155,40,14,-2,35,94,109,32,8,9,56,133,146,57,22,1,28,65,80,30,11,0,28,68,66,27,11,1,946,499,447,462,208,254,157,246,301,165,46,20,85,121,168,88,23,7,72,125,133,77,23,13,81,134,130,76,27,11,41,58,61,33,9,5,40,76,69,43,18,6,1547,831,716,1049,547,502,317,311,546,276,62,19,157,164,315,157,22,6,160,147,231,119,40,13,198,257,352,179,52,11,106,142,190,92,14,3,92,115,162,87,38,8,1247,755,492,799,433,366,172,354,448,197,62,4,86,187,302,137,27,8,86,167,146,60,35,-4,117,242,244,139,44,7,53,133,140,80,20,4,64,109,104,59,24,3,449,232,217,473,243,230,41,115,139,87,31,22,27,70,61,41,15,13,14,45,78,46,16,9,67,123,156,87,27,8,39,62,79,44,13,4,28,61,77,43,14,4,-10,-39,29,130,43,87,-7,24,-33,-30,16,14,6,8,-39,-18,-3,4,-13,16,6,-12,19,10,24,42,26,17,14,2,15,25,-2,1,1,1,9,17,28,16,13,1,-226,-142,-84,-72,-60,-12,-2,-30,-92,-78,-27,1,-6,-23,-56,-43,-20,2,4,-7,-36,-35,-7,-1,3,1,-34,-38,-14,7,7,-5,-26,-28,-11,2,-4,6,-8,-10,-3,5,-328,-208,-120,-243,-173,-70,-32,-60,-136,-98,-14,-1,-11,-47,-71,-75,-2,-2,-21,-13,-65,-23,-12,1,-24,-26,-107,-74,-15,-3,-15,-28,-64,-60,-8,-1,-9,2,-43,-14,-7,-2,-105,-77,-28,-92,-79,-13,-7,1,-49,-35,-29,11,7,1,-34,-40,-20,3,-14,0,-15,5,-9,8,-13,-1,-33,-33,-18,1,-6,-3,-29,-30,-12,-2,-7,2,-4,-3,-6,3,-73,-76,3,-146,-92,-54,-4,0,-32,-52,3,10,2,2,-34,-38,-11,5,-6,-2,2,-14,14,5,-10,-1,-63,-57,-14,-3,-5,-2,-33,-41,-9,-2,-5,1,-30,-16,-5,-1,-204,-144,-60,-116,-79,-37,-40,6,-62,-88,-36,8,-22,-4,-55,-60,-10,3,-18,10,-7,-28,-26,5,-15,9,-47,-55,-13,1,-6,6,-34,-42,-5,-1,-9,3,-13,-13,-8,2,-144,-80,-64,-150,-97,-53,-40,1,-54,-46,-1,-4,-18,-6,-22,-34,0,3,-22,7,-32,-12,-1,-7,-24,-14,-45,-56,-15,2,-18,-12,-18,-42,-10,3,-6,-2,-27,-14,-5,-1,-176,-117,-59,-161,-116,-45,-7,-16,-50,-68,-35,-2,-7,-13,-30,-45,-22,-5,0,-3,-20,-23,-13,3,-7,-6,-32,-87,-28,-2,-7,-12,-22,-57,-19,0,0,6,-10,-30,-9,-2,-14,-16,2,9,5,4,-11,-13,6,9,-12,-6,-2,-9,-3,4,-14,-5,-9,-4,9,5,2,-1,-17,10,-3,16,0,-1,-8,7,1,8,-4,-2,-9,3,-4,8,4,1
12,12085,Oropesa del Mar/Orpesa,3392,331,170,161,163,72,91,36,68,101,60,54,12,15,25,65,38,24,3,21,43,36,22,30,9,23,41,60,21,17,1,7,14,35,8,8,0,16,27,25,13,9,1,419,236,183,268,147,121,55,80,147,69,52,15,30,41,86,39,33,7,25,39,61,30,19,8,33,59,94,52,21,8,14,32,55,27,15,4,19,27,39,25,6,4,680,405,275,319,167,152,64,158,207,122,108,16,42,83,133,79,60,9,22,75,74,43,48,7,51,82,100,51,24,9,28,38,52,31,13,4,23,44,48,20,11,5,1050,616,434,367,199,168,132,198,346,230,103,39,60,119,222,139,53,25,72,79,124,91,50,14,55,95,112,71,26,7,21,52,64,43,14,5,34,43,48,28,12,2,999,623,376,655,393,262,132,215,293,226,99,29,69,127,208,156,48,16,63,88,85,70,51,13,84,168,183,145,57,16,42,96,112,99,35,9,42,72,71,46,22,7,1262,766,496,782,448,334,162,254,427,263,125,20,99,125,274,186,72,8,63,129,153,77,53,12,124,190,259,141,55,9,72,86,171,86,26,6,52,104,88,55,29,3,1346,763,583,919,485,434,213,272,420,276,128,34,112,134,254,169,72,22,101,138,166,107,56,12,192,205,268,185,47,15,102,94,145,112,20,9,90,111,123,73,27,6,1511,874,637,1119,623,496,246,325,476,309,102,33,125,173,299,183,61,18,121,152,177,126,41,15,205,278,341,199,67,15,108,140,208,116,38,5,97,138,133,83,29,10,-120,-112,-8,227,87,140,-33,38,-66,-68,-12,22,-16,12,-43,-60,-17,11,-17,26,-23,-8,5,11,70,80,47,-3,10,14,42,30,11,-16,4,10,28,50,36,13,6,4,-424,-284,-140,-141,-147,6,-66,-22,-199,-99,-17,-13,-37,-24,-134,-58,-23,-2,-29,2,-65,-41,6,-11,4,2,-84,-66,-4,2,2,-19,-72,-53,-10,3,2,21,-12,-13,6,-1,-746,-468,-278,-661,-424,-237,-133,-111,-291,-177,-24,-3,-78,-53,-164,-153,-15,-2,-55,-58,-127,-24,-9,-1,-93,-98,-231,-166,-51,-25,-53,-54,-134,-141,-31,-13,-40,-44,-97,-25,-20,-12,-235,-165,-70,-36,-35,-1,-45,-6,-62,-76,-24,-13,-35,-2,-40,-60,-14,-9,-10,-4,-22,-16,-10,-4,-10,5,-5,-28,4,-1,-4,-3,-9,-12,-4,-2,-6,8,4,-16,8,1,-49,-26,-23,-29,-34,5,-11,-18,-16,-11,23,-14,-1,-6,-29,-1,20,-10,-10,-12,13,-10,3,-4,7,3,-31,-22,9,0,7,-2,-30,-20,4,3,0,5,-1,-2,5,-3,-259,-140,-119,-203,-124,-79,-34,0,-136,-84,3,-13,-10,5,-78,-63,7,-1,-24,-5,-58,-21,-4,-12,-11,-17,-91,-77,-12,0,0,-6,-60,-52,-7,0,-11,-11,-31,-25,-5,0,-146,-92,-54,-81,-61,-20,-5,-20,-45,-54,-11,-12,10,-13,-33,-37,-13,-8,-15,-7,-12,-17,2,-4,-1,-13,-26,-27,-14,-1,7,-11,-23,-24,-12,1,-8,-2,-3,-3,-2,-2,-143,-121,-22,55,12,43,-24,-18,-4,-65,-38,7,-23,-10,-10,-51,-24,-3,-1,-8,6,-14,-14,10,19,10,16,-4,8,5,5,14,1,-8,0,-1,14,-4,15,4,8,6,-192,-136,-56,-117,-86,-31,-4,-38,-31,-77,-21,-28,-4,-24,-21,-68,-3,-21,0,-14,-10,-9,-18,-7,-5,-4,-34,-50,-20,-7,-8,-4,-21,-38,-9,-8,3,0,-13,-12,-11,1,-140,-75,-65,-61,-38,-23,-38,-3,-35,-50,-8,0,-22,-4,-20,-32,-3,8,-16,1,-15,-18,-5,-8,-16,-2,-2,-21,-18,-5,-13,-4,-2,-12,-10,1,-3,2,0,-9,-8,-6
12,12089,Peníscola/Peñíscola,4258,304,187,117,287,179,108,36,63,90,68,52,0,15,39,60,40,31,3,21,24,30,28,21,-3,23,75,83,66,33,7,13,46,60,36,20,4,10,29,23,30,13,3,352,215,137,339,200,139,12,114,131,30,44,19,5,63,88,26,21,10,7,51,43,4,23,9,29,87,114,45,49,12,17,47,73,31,23,7,12,40,41,14,26,5,246,128,118,271,149,122,13,51,36,53,85,13,-1,25,27,26,49,3,14,26,9,27,36,10,31,53,66,54,57,9,14,28,38,33,31,5,17,25,28,21,26,4,292,147,145,315,162,153,65,39,43,58,70,16,30,19,15,34,38,9,35,20,28,24,32,7,52,46,77,56,58,25,25,23,40,32,31,11,27,23,37,24,27,14,312,173,139,371,200,171,27,73,52,46,83,24,11,42,33,21,45,17,16,31,19,25,38,7,39,78,97,59,75,19,20,42,52,30,38,15,19,36,45,29,37,4,387,235,152,366,196,170,28,99,83,75,72,27,15,58,70,47,34,9,13,41,13,28,38,18,39,82,73,59,84,26,18,43,47,37,36,14,21,39,26,22,48,12,426,218,208,430,223,207,64,89,112,66,85,15,29,44,68,34,40,5,35,45,44,32,45,10,65,93,117,78,62,13,33,43,66,42,32,5,32,50,51,36,30,8,515,275,240,444,225,219,55,156,136,84,61,18,32,70,78,55,29,11,23,86,58,29,32,7,68,125,106,67,55,18,34,55,62,39,25,9,34,70,44,28,30,9,257,114,143,209,90,119,39,23,37,62,67,25,30,8,10,18,36,6,9,15,27,44,31,19,17,50,38,43,46,12,9,18,12,17,24,6,8,32,26,26,22,6,167,70,97,165,82,83,38,39,-3,33,52,13,16,18,3,9,21,2,22,21,-6,24,31,11,35,37,17,22,39,16,19,17,14,7,18,7,16,20,3,15,21,9,100,41,59,66,21,45,15,27,-16,6,42,23,11,0,-5,-6,22,17,4,27,-11,12,20,6,9,23,1,13,19,1,2,5,3,1,9,1,7,18,-2,12,10,0,110,75,35,112,60,52,-8,18,45,-6,43,19,0,20,24,-9,28,13,-8,-2,21,3,15,6,4,17,17,18,37,19,1,4,12,10,22,11,3,13,5,8,15,8,-146,-80,-66,-66,-47,-19,-40,-25,-55,-17,13,-24,-17,-23,-36,-6,15,-18,-23,-2,-19,-11,-2,-6,-18,0,-13,-17,-7,-14,-5,-6,-14,-12,-6,-8,-13,6,1,-5,-1,-6,-280,-184,-96,-219,-130,-89,-37,-20,-59,-94,-36,-32,-36,-16,-33,-58,-28,-12,-1,-4,-26,-36,-8,-20,-21,-9,-61,-79,-28,-21,-12,-4,-38,-50,-22,-4,-9,-5,-23,-29,-6,-17,-211,-105,-106,-160,-98,-62,-52,-1,-27,-33,-32,-67,-21,-3,-11,-17,-19,-34,-31,2,-16,-16,-13,-33,-3,-6,-24,-33,-38,-57,-7,-7,-8,-22,-25,-29,4,1,-16,-11,-13,-28,-133,-95,-38,-119,-90,-29,-7,-17,-26,-57,6,-40,-1,-17,-13,-48,2,-22,-6,0,-13,-9,4,-18,-7,3,-35,-41,-3,-40,-6,-3,-24,-38,-1,-20,-1,6,-11,-3,-2,-20,63,10,53,15,-1,16,26,23,-17,8,27,-8,13,12,-22,1,12,-9,13,11,5,7,15,1,20,15,-9,-9,6,-11,9,9,-3,-10,3,-12,11,6,-6,1,3,1,27,9,18,-12,-5,-7,-1,15,-13,24,15,-15,-8,10,4,10,0,-8,7,5,-17,14,15,-7,-2,21,-7,-13,9,-23,0,11,1,-6,0,-12,-2,10,-8,-7,9,-11
12,12096,Rossell,1111,36,35,1,69,61,8,-8,20,16,6,2,1,-5,20,11,8,2,0,-3,0,5,-2,0,1,1,23,27,15,3,0,0,23,21,15,2,0,1,0,6,0,1,0,45,29,16,39,27,12,11,5,12,15,3,-1,6,3,7,12,0,1,5,2,5,3,3,-2,2,7,16,13,1,0,1,4,9,12,1,0,1,3,7,1,0,0,5,15,-10,32,21,11,-8,2,-2,8,3,2,-2,3,2,8,3,2,-6,-1,-4,0,0,0,3,5,12,12,0,0,2,4,6,9,0,0,1,1,6,3,0,0,26,14,12,48,31,17,11,8,5,9,-1,-6,6,5,2,5,0,-4,5,3,3,4,-1,-2,11,10,16,9,2,0,6,7,11,5,2,0,5,3,5,4,0,0,-12,-7,-5,27,18,9,-7,8,-4,-7,0,-2,-2,5,-4,-3,0,-3,-5,3,0,-4,0,1,4,4,13,6,0,0,3,2,8,5,0,0,1,2,5,1,0,0,19,13,6,32,18,14,2,16,-4,6,2,-3,3,7,-1,4,1,-1,-1,9,-3,2,1,-2,1,15,10,4,2,0,1,7,7,2,1,0,0,8,3,2,1,0,-17,-10,-7,18,4,14,-6,-1,-4,-9,-2,3,-3,-5,-2,-6,-1,5,-3,4,-2,-3,-1,-2,2,8,3,4,0,1,1,1,1,0,0,1,1,7,2,4,0,0,-1,4,-5,17,11,6,-1,-4,6,-2,2,-1,-2,0,7,-1,4,-3,1,-4,-1,-1,-2,2,0,3,11,3,0,0,0,1,8,2,0,0,0,2,3,1,0,0,-10,-5,-5,15,7,8,8,-7,-2,-3,0,-5,4,-1,1,-2,-2,-4,4,-6,-3,-1,2,-1,8,0,7,1,0,-1,5,1,3,-1,0,-1,3,-1,4,2,0,0,11,9,2,8,3,5,2,6,1,9,1,-7,1,4,-1,5,2,-1,1,2,2,4,-1,-6,4,1,1,1,1,0,2,0,0,1,0,0,2,1,1,0,1,0,-16,-15,-1,2,1,1,0,-8,-2,-6,1,-1,0,-5,-6,-1,-1,-2,0,-3,4,-5,2,1,1,-2,2,1,0,0,1,-1,0,1,0,0,0,-1,2,0,0,0,-2,0,-2,0,-1,1,3,3,-3,-2,-4,1,1,2,-1,0,-4,2,2,1,-2,-2,0,-1,0,0,-1,0,1,0,0,0,-1,0,0,0,0,0,0,0,1,0,-56,-24,-32,-20,-14,-6,-7,-6,-15,-13,-9,-5,1,-3,-10,-10,-3,1,-8,-3,-5,-3,-6,-6,-1,-3,-11,-4,-2,1,0,-1,-8,-5,-1,1,-1,-2,-3,1,-1,0,-47,-33,-14,-38,-21,-17,-12,0,-17,-16,0,-2,-9,-1,-12,-9,-1,-1,-3,1,-5,-7,1,-1,-7,-2,-14,-14,-1,0,-5,-1,-7,-8,0,0,-2,-1,-7,-6,-1,0,-6,-3,-3,1,1,0,3,4,-5,0,-2,-8,2,2,0,-3,-2,-3,1,2,-5,3,0,-5,1,1,0,-1,0,0,1,0,1,-1,0,0,0,1,-1,0,0,0,-11,-5,-6,-9,-5,-4,2,1,-9,-3,-2,1,2,1,-6,-1,-1,0,0,0,-3,-2,-1,1,-2,0,-4,-4,0,1,-2,0,-1,-2,0,0,0,0,-3,-2,0,1,-4,-3,-1,-3,-2,-1,2,-1,0,-5,3,-2,1,-2,0,-4,2,1,1,1,0,-1,1,-3,1,1,-4,-1,0,0,1,0,-2,-1,0,0,0,1,-2,0,0,0,-14,-10,-4,-4,-3,-1,2,0,-11,1,3,-9,2,-1,-7,0,1,-5,0,1,-4,1,2,-4,0,0,0,0,-1,-3,0,0,0,0,-1,-2,0,0,0,0,0,-1
12,12902,Sant Joan de Moró,1741,52,46,6,23,15,8,0,16,19,7,6,1,4,14,18,3,4,2,-4,2,1,4,2,-1,1,4,12,3,2,0,0,3,8,3,1,0,1,1,4,0,1,0,52,44,8,52,40,12,8,18,25,0,-5,0,2,13,23,4,-3,0,6,5,2,-4,-2,0,10,13,18,6,0,0,5,8,17,5,0,0,5,5,1,1,0,0,55,40,15,43,24,19,19,2,22,14,-1,-5,8,5,17,9,0,-3,11,-3,5,5,-1,-2,15,6,12,7,2,1,5,6,7,4,1,1,10,0,5,3,1,0,33,33,0,20,18,2,-7,11,19,5,4,-1,1,8,17,1,3,0,-8,3,2,4,1,-1,0,8,9,2,1,0,0,8,8,1,1,0,0,0,1,1,0,0,152,76,76,67,32,35,40,30,39,19,14,6,22,15,18,11,9,-1,18,15,21,8,5,7,26,10,14,5,7,3,11,4,8,3,5,0,15,6,6,2,2,3,203,122,81,41,21,20,33,42,75,37,10,-2,20,21,47,25,7,-2,13,21,28,12,3,0,11,10,10,8,0,1,5,4,7,4,0,0,6,6,3,4,0,1,197,112,85,59,33,26,22,56,81,14,14,4,7,31,52,7,7,2,15,25,29,7,7,2,17,18,12,2,7,1,10,12,5,0,4,1,7,6,7,2,3,0,196,117,79,38,23,15,20,53,75,34,5,7,8,34,43,26,-1,5,12,19,32,8,6,2,9,13,8,7,0,0,5,11,3,5,-2,0,4,2,5,2,2,0,124,62,62,24,8,16,19,36,37,14,14,3,8,21,25,5,4,0,11,15,12,9,10,3,10,6,7,-1,2,0,5,5,1,-3,0,0,5,1,6,2,2,0,-21,-21,0,11,5,6,-5,-5,8,-21,5,-2,-5,-6,0,-11,3,-2,0,1,8,-10,2,0,1,-1,6,4,1,0,0,-1,3,2,1,0,1,0,3,2,0,0,-7,-12,5,-27,-21,-6,-15,14,-2,-10,3,2,-2,4,-6,-10,1,3,-13,10,4,0,2,-1,-2,-3,-12,-7,-2,-1,-2,-2,-9,-6,-1,-1,0,-1,-3,-1,-1,0,48,27,21,12,7,5,11,10,-3,7,12,5,11,6,-3,1,5,3,0,4,0,6,7,2,4,2,2,1,1,0,2,0,2,1,1,0,2,2,0,0,0,0,-13,-8,-5,-2,-3,1,-2,5,-10,-6,2,-2,-3,4,-9,-3,4,-1,1,1,-1,-3,-2,-1,2,2,-3,-4,0,0,2,0,-2,-3,0,0,0,2,-1,-1,0,0,23,7,16,5,-2,7,10,-2,-12,12,13,2,5,-1,-9,1,10,1,5,-1,-3,11,3,1,3,3,-6,2,3,0,0,1,-4,0,1,0,3,2,-2,2,2,0,-22,-8,-14,1,0,1,-13,-6,-5,-2,-2,7,-8,-3,1,-2,2,4,-5,-3,-6,0,-4,3,0,0,1,0,0,0,0,0,1,-1,0,0,0,0,0,1,0,0,-4,-5,1,0,2,-2,-19,3,3,10,0,-4,-10,0,3,6,-3,-5,-9,3,0,4,3,1,-2,-1,2,1,-2,0,-1,-1,2,1,-1,0,-1,0,0,0,-1,0,41,24,17,-11,-8,-3,33,9,6,-3,2,-6,23,7,1,-5,2,-5,10,2,5,2,0,-1,5,3,-7,-11,-2,-1,2,2,-4,-7,-2,0,3,1,-3,-4,0,-1,-11,-4,-7,-1,4,-5,-12,3,-6,1,5,0,-9,2,-1,1,2,2,-3,1,-5,0,3,-2,-3,0,2,0,0,0,1,2,2,-1,0,0,-4,-2,0,1,0,0
12,12099,Sant Jordi/San Jorge,572,29,16,13,23,12,11,3,3,6,5,8,3,0,3,3,4,3,2,3,0,3,1,5,1,3,2,7,4,5,1,0,2,4,4,1,0,3,0,3,0,4,1,36,18,18,33,19,14,1,13,9,8,7,-3,-2,10,3,4,4,-1,3,3,6,4,3,-2,4,11,9,6,3,0,2,8,5,3,1,0,2,3,4,3,2,0,29,24,5,35,20,15,-2,6,8,0,13,3,2,2,7,3,7,3,-4,4,1,-3,6,0,3,3,15,4,5,4,3,1,8,3,2,3,0,2,7,1,3,1,12,4,8,30,14,16,3,0,2,1,6,1,1,0,2,-1,3,0,2,0,0,2,3,1,6,6,7,4,6,1,5,2,3,1,3,0,1,4,4,3,3,1,47,27,20,40,19,21,2,6,15,8,15,3,2,6,4,6,8,2,0,0,11,2,7,1,3,5,11,5,12,4,1,4,4,3,5,2,2,1,7,2,7,2,60,35,25,50,28,22,8,16,9,17,6,2,6,8,7,11,2,0,2,8,2,6,4,2,5,15,7,10,8,4,5,9,3,6,4,1,0,6,4,4,4,3,144,82,62,97,51,46,7,30,22,22,42,21,6,15,16,13,22,10,1,15,6,9,20,11,9,22,14,16,25,11,6,10,8,10,11,6,3,12,6,6,14,5,43,22,21,47,31,16,10,11,-14,9,22,3,8,5,-10,7,10,0,2,6,-4,2,12,3,6,14,5,4,14,3,4,10,5,3,7,1,2,4,0,1,7,2,65,34,31,23,10,13,5,13,13,13,13,7,2,7,10,4,5,5,3,6,3,9,8,2,3,3,1,6,4,6,1,1,1,2,2,3,2,2,0,4,2,3,43,21,22,28,12,16,6,4,4,13,17,0,2,1,3,5,10,1,4,3,1,8,7,-1,0,4,3,9,10,2,0,1,1,3,6,1,0,3,2,6,4,1,33,21,12,17,10,7,6,0,13,3,5,6,4,-2,10,1,5,2,2,2,3,2,0,4,2,3,4,3,2,2,1,1,4,2,1,0,1,2,0,1,1,2,11,5,6,22,9,13,2,-4,-4,0,13,5,-1,-2,1,-2,6,3,3,-2,-5,2,7,2,2,0,2,6,9,3,1,0,1,2,3,2,1,0,1,4,6,1,6,-12,18,-1,-4,3,0,6,-5,-3,2,5,1,0,-10,-2,-3,2,-1,6,5,-1,5,3,0,0,-3,0,1,0,1,0,-3,-1,0,-1,-1,0,0,1,1,1,21,7,14,25,9,16,10,8,10,0,-2,-4,6,3,5,-1,-4,-2,4,5,5,1,2,-2,6,6,6,4,3,0,2,2,2,1,2,0,4,4,4,3,1,0,-81,-48,-33,-57,-42,-15,-15,-10,-23,-19,-6,-10,-11,-6,-17,-10,-2,-3,-4,-4,-6,-9,-4,-7,-10,-8,-16,-17,-3,-3,-9,-6,-10,-11,-5,-1,-1,-2,-6,-6,2,-2,-30,-16,-14,-11,-2,-9,-9,-2,-13,-8,1,1,-7,-1,-5,-5,0,2,-2,-1,-8,-3,1,-1,-4,2,-10,-3,2,2,-3,1,-3,-1,2,2,-1,1,-7,-2,0,0,21,13,8,6,4,2,7,-4,0,11,3,3,4,-5,0,8,3,2,3,1,0,3,0,1,0,-2,1,4,2,1,0,-2,0,2,2,2,0,0,1,2,0,-1,-9,-1,-8,-25,-9,-16,-1,-3,-1,-3,1,-2,3,2,-4,-3,2,-1,-4,-5,3,0,-1,-1,-6,2,-5,-10,-4,-2,-1,2,-4,-4,0,-2,-5,0,-1,-6,-4,0
12,12104,Segorbe,7768,112,64,48,113,48,65,25,43,21,23,1,-2,9,27,15,10,2,1,16,16,6,13,-1,-3,31,21,37,17,3,4,13,10,17,5,1,2,18,11,20,12,2,2,179,77,102,161,63,98,39,44,57,29,10,-2,13,19,31,6,3,5,26,25,26,23,7,-7,33,42,49,29,6,1,12,11,26,12,1,1,21,31,23,17,5,0,147,38,109,75,22,53,46,16,36,13,12,22,14,4,4,3,3,9,32,12,32,10,9,13,24,25,16,5,5,-1,4,9,8,1,0,-1,20,16,8,4,5,0,137,86,51,115,59,56,28,28,33,7,28,10,20,10,27,7,17,3,8,18,6,0,11,7,30,25,37,14,6,1,22,11,16,6,3,0,8,14,21,8,3,1,161,80,81,104,56,48,29,12,46,31,22,22,14,3,20,24,11,9,15,9,26,7,11,13,13,28,28,26,6,2,8,15,17,14,2,0,5,13,11,12,4,2,309,174,135,125,65,60,47,47,81,65,32,29,23,22,52,44,16,14,24,25,29,21,16,15,27,28,36,27,4,2,14,8,18,19,5,1,13,20,18,8,-1,1,232,111,121,116,50,66,51,61,43,31,28,12,30,20,31,13,11,3,21,41,12,18,17,9,35,35,17,17,7,3,21,14,5,5,3,1,14,21,12,12,4,2,249,137,112,130,61,69,45,64,51,42,36,9,21,31,36,24,21,3,24,33,15,18,15,6,25,42,32,19,11,1,15,20,16,8,3,-1,10,22,16,11,8,2,120,68,52,44,16,28,39,22,9,40,16,-7,28,15,-2,20,11,-4,11,7,11,20,5,-3,7,29,0,9,-1,-1,5,12,-5,6,0,-2,2,17,5,3,-1,1,43,12,31,26,9,17,-2,10,10,1,16,11,-8,-2,7,10,7,2,6,12,3,-9,9,9,5,7,0,2,9,3,4,2,0,-1,3,1,1,5,0,3,6,2,97,66,31,23,18,5,47,11,9,18,-1,10,38,7,10,10,1,1,9,4,-1,8,-2,9,8,3,4,1,1,6,12,0,4,-1,1,2,-4,3,0,2,0,4,-18,-27,9,33,18,15,5,-8,-16,-7,4,10,-11,-7,-11,-5,6,5,16,-1,-5,-2,-2,5,8,9,9,1,4,1,5,2,4,3,3,1,3,7,5,-2,1,0,3,20,-17,6,5,1,0,2,-8,6,0,2,8,9,-12,6,4,4,-8,-7,4,0,-4,-2,2,0,-2,4,2,-1,1,4,-2,2,0,0,1,-4,0,2,2,-1,16,26,-10,-16,-6,-10,6,18,-2,-5,-4,-1,12,11,5,-2,-4,2,-6,7,-7,-3,0,-3,3,2,-7,-7,-8,0,5,0,-4,-5,-4,1,-2,2,-3,-2,-4,-1,-87,-38,-49,-90,-52,-38,-1,-14,-27,-30,-27,11,3,-9,-14,-17,-14,11,-4,-5,-13,-13,-13,0,-12,-7,-20,-31,-16,-5,-3,-6,-11,-20,-11,-2,-9,-1,-9,-11,-5,-3,-91,-35,-56,-135,-82,-53,9,-15,-49,-4,-28,-7,4,1,-26,-1,-12,-1,5,-16,-23,-3,-16,-6,-17,-6,-48,-31,-29,-4,-11,-3,-27,-22,-16,-3,-6,-3,-21,-9,-13,-1,8,-8,16,34,22,12,21,3,-21,8,-3,4,8,-3,-1,-4,-3,-3,13,6,-20,12,0,7,7,15,6,7,0,-1,4,7,7,3,1,0,3,8,-1,4,-1,-1,-111,-80,-31,-40,-39,-1,-9,-9,-32,-54,-2,-14,-12,-2,-22,-33,-3,-10,3,-7,-10,-21,1,-4,-4,3,-12,-27,-1,-1,-4,0,-12,-20,0,-3,0,3,0,-7,-1,2
12,12117,Torreblanca,4610,233,149,84,196,129,67,9,70,92,49,6,7,4,43,65,34,1,1,5,27,27,15,5,6,7,61,81,35,8,2,2,39,58,23,4,1,5,22,23,12,4,1,249,189,60,280,205,75,6,91,110,30,12,-1,4,72,79,24,8,1,2,19,31,6,4,-2,12,98,118,43,7,2,8,73,88,29,7,0,4,25,30,14,0,2,231,142,89,282,171,111,33,83,59,34,14,6,23,48,34,24,8,5,10,35,25,10,6,1,30,93,109,37,10,3,16,61,64,22,5,3,14,32,45,15,5,0,278,138,140,293,163,130,32,89,77,51,14,13,12,49,38,29,7,3,20,40,39,22,7,10,42,91,92,51,9,8,22,49,52,31,6,3,20,42,40,20,3,5,209,115,94,281,151,130,16,68,64,42,18,2,17,36,33,23,8,-2,-1,32,31,19,10,4,32,94,86,52,14,3,21,44,53,24,8,1,11,50,33,28,6,2,237,120,117,292,154,138,42,85,44,42,15,11,11,51,26,22,8,5,31,34,18,20,7,6,30,101,83,56,15,6,12,56,45,30,7,3,18,45,38,26,8,3,191,130,61,302,163,139,41,56,62,27,7,-2,20,27,49,28,7,-2,21,29,13,-1,0,0,59,84,89,49,15,4,32,41,46,34,8,1,27,43,43,15,7,3,290,177,113,353,192,161,42,99,63,45,32,4,24,53,42,40,14,1,18,46,21,5,18,3,65,112,79,61,29,4,31,59,44,39,16,1,34,53,35,22,13,3,-67,-24,-43,37,25,12,-25,-16,-31,-3,6,5,-2,3,-17,-10,2,1,-23,-19,-14,7,4,4,8,9,12,5,1,1,9,6,12,-3,0,0,-1,3,0,8,1,1,-332,-217,-115,-347,-221,-126,-33,-65,-111,-82,-30,-12,-18,-39,-74,-59,-20,-7,-15,-26,-37,-23,-10,-5,-37,-61,-121,-80,-37,-11,-20,-39,-80,-52,-26,-4,-17,-22,-41,-28,-11,-7,-40,-36,-4,-5,-16,11,-13,15,-28,-14,0,3,-8,0,-21,-8,-1,4,-5,15,-7,-6,1,-1,-10,10,-2,-4,1,0,-6,1,-7,-4,-1,1,-4,9,5,0,2,-1,36,9,27,25,2,23,-11,16,7,13,11,0,-11,0,7,9,5,-1,0,16,0,4,6,1,3,10,2,6,3,0,-1,0,-1,1,2,0,4,10,3,5,1,0,19,-2,21,26,10,16,10,-9,-7,7,10,5,0,-4,-15,12,2,0,10,-5,8,-5,8,5,15,2,5,3,1,-1,7,2,-3,5,-1,-1,8,0,8,-2,2,0,-200,-126,-74,-192,-119,-73,-7,-20,-69,-82,-27,3,-5,-7,-46,-52,-19,2,-2,-13,-23,-30,-8,1,1,-8,-80,-78,-25,-2,4,-6,-51,-52,-13,-1,-3,-2,-29,-26,-12,-1,-82,-49,-33,-71,-44,-27,5,-15,-33,-34,-17,12,7,-9,-10,-25,-15,4,-2,-6,-23,-9,-2,8,-5,-4,-22,-23,-16,-2,-2,-3,-13,-15,-11,-1,-3,-1,-9,-8,-5,-1,10,12,-2,15,2,13,-20,12,-10,0,6,19,-11,5,4,-5,6,11,-9,7,-14,5,0,8,-2,5,-5,3,8,2,0,2,0,-4,2,0,-2,3,-5,7,6,2,41,-1,42,50,15,35,18,11,10,-14,6,13,5,4,1,-13,-3,6,13,7,9,-1,9,7,19,14,9,-2,5,4,9,9,0,-3,-1,0,10,5,9,1,6,4,90,59,31,11,10,1,9,23,11,15,21,8,6,18,-1,18,10,5,3,5,12,-3,11,3,1,14,-1,-2,-3,-2,4,9,-1,1,-4,-2,-3,5,0,-3,1,0
12,12124,Vall d'Alba,1933,51,36,15,26,18,8,9,13,14,14,4,-1,5,11,15,3,3,-1,4,2,-1,11,1,0,2,11,8,5,0,0,0,10,6,2,0,0,2,1,2,3,0,0,-1,-2,1,3,1,2,-1,4,2,-5,5,-3,-4,1,2,-4,3,2,3,3,0,-1,2,-5,0,0,0,1,1,1,0,0,0,0,0,1,0,0,0,1,1,0,11,4,7,-2,-1,-1,-4,2,5,4,-2,3,1,2,0,3,-2,0,-5,0,5,1,0,3,0,0,0,0,-2,0,0,0,0,0,-1,0,0,0,0,0,-1,0,34,22,12,9,5,4,6,9,-6,12,12,1,5,9,-2,4,7,-1,1,0,-4,8,5,2,1,4,2,2,0,0,0,4,1,0,0,0,1,0,1,2,0,0,60,22,38,59,34,25,18,6,14,13,4,3,9,0,2,7,1,3,9,6,12,6,3,0,15,10,19,10,4,0,10,4,11,6,2,0,5,6,8,4,2,0,125,69,56,72,34,38,28,33,38,25,2,-1,16,20,17,15,1,1,12,13,21,10,1,-2,16,25,17,10,4,0,6,15,7,4,2,0,10,10,10,6,2,0,285,167,118,108,64,44,32,51,90,56,35,19,16,32,57,32,19,10,16,19,33,24,16,9,11,25,44,17,8,2,5,17,26,12,3,0,6,8,18,5,5,2,162,96,66,105,61,44,25,51,23,38,14,12,13,28,17,19,16,3,12,23,6,19,-2,9,14,42,27,15,5,2,7,22,16,10,5,1,7,20,11,5,0,1,59,36,23,25,15,10,14,18,14,10,4,-6,10,12,1,6,4,-3,4,6,13,4,0,-3,3,14,2,5,0,0,3,7,1,3,0,0,0,7,1,2,0,0,16,4,12,28,7,21,5,3,21,-8,-5,0,-6,4,13,-7,0,0,11,-1,8,-1,-5,0,5,17,4,1,1,0,0,9,-2,-3,2,1,5,8,6,4,-1,-1,67,18,49,9,-2,11,20,9,7,13,10,5,11,-1,-8,7,5,2,9,10,15,6,5,3,8,3,-7,0,4,1,6,-3,-4,-2,0,1,2,6,-3,2,4,0,2,2,0,4,-3,7,7,10,-1,0,-9,-3,2,3,1,3,-5,-2,5,7,-2,-3,-4,-1,3,6,-7,1,-1,1,2,0,-7,1,0,0,1,6,0,0,-1,1,6,8,-2,12,4,8,-3,-5,4,2,6,6,-3,-5,9,3,0,5,0,0,-5,-1,6,1,4,7,2,1,0,-1,0,3,2,0,-1,0,4,4,0,1,1,-1,-85,-34,-51,-77,-42,-35,-6,-15,-23,-23,-9,-10,-4,-1,-6,-18,-1,-4,-2,-14,-17,-5,-8,-6,-9,-15,-18,-19,-16,0,-6,-5,-7,-15,-9,0,-3,-10,-11,-4,-7,0,-26,-9,-17,-39,-22,-17,-19,-1,-4,-12,14,-1,-6,4,-6,-3,4,-2,-13,-5,2,-9,10,1,-8,-6,-16,-10,1,0,-5,-2,-9,-7,0,0,-3,-4,-7,-3,1,0,-39,-22,-17,-22,-13,-9,-11,-7,-15,-11,6,1,-5,-3,-16,-5,8,-1,-6,-4,1,-6,-2,2,-2,2,-12,-7,-3,-1,0,0,-9,-5,0,0,-2,2,-3,-2,-3,-1,-78,-36,-42,-61,-36,-25,-2,0,-27,-32,-10,-10,4,6,-21,-20,-2,-3,-6,-6,-6,-12,-8,-7,4,3,-23,-32,-5,-9,4,3,-19,-18,-2,-4,0,0,-4,-14,-3,-5,47,21,26,36,21,15,24,2,4,20,-10,3,15,-1,-4,9,-6,4,9,3,8,11,-4,-1,6,5,11,10,0,2,6,2,7,3,-1,2,0,3,4,7,1,0
12,12126,"Vall d'Uixó, la",28972,59,17,42,40,14,26,32,31,14,-6,-5,-7,3,16,15,-3,-9,-6,29,15,-1,-3,4,-1,8,6,16,9,0,1,1,0,11,2,0,0,7,6,5,7,0,1,56,55,1,5,3,2,-7,27,18,3,7,6,-5,25,24,8,4,0,-2,2,-6,-5,3,6,2,0,1,0,2,0,1,0,1,0,1,0,1,0,0,0,1,0,193,81,112,10,0,10,50,36,100,14,-15,0,20,4,44,17,-7,-2,30,32,56,-3,-8,2,-1,7,2,-1,1,2,-1,0,0,0,1,0,0,7,2,-1,0,2,75,43,32,64,25,39,0,38,23,6,17,-11,-1,12,17,3,15,-3,1,26,6,3,2,-8,13,8,19,13,7,2,5,3,7,6,3,1,8,5,12,7,4,1,308,187,121,250,125,125,66,100,102,7,7,23,47,46,74,6,4,12,19,54,28,1,3,11,53,77,80,29,6,4,21,36,47,16,3,2,32,41,33,13,3,2,460,222,238,319,121,198,112,95,140,91,2,14,70,33,85,41,-12,2,42,62,55,50,14,12,75,73,93,55,9,12,36,26,38,17,1,3,39,47,55,38,8,9,557,272,285,383,166,217,97,135,171,100,49,8,39,69,86,54,26,4,58,66,85,46,23,4,67,112,101,63,30,8,31,56,37,25,13,3,36,56,64,38,17,5,579,299,280,455,215,240,90,170,172,93,31,12,34,67,121,42,21,7,56,103,51,51,10,5,76,128,128,76,31,12,33,56,72,34,17,1,43,72,56,42,14,11,199,92,107,222,112,110,47,69,63,6,1,4,24,38,22,11,-6,-1,23,31,41,-5,7,5,35,67,66,27,17,1,19,33,36,11,9,0,16,34,30,16,8,1,192,68,124,231,102,129,36,60,60,16,12,3,19,20,19,-4,3,7,17,40,41,20,9,-4,37,66,70,34,14,5,13,27,40,12,5,3,24,39,30,22,9,2,-42,-24,-18,136,70,66,-19,-13,-48,25,26,-10,-8,-13,-23,20,5,-6,-11,0,-25,5,21,-4,20,44,29,25,10,5,10,23,17,16,1,2,10,21,12,9,9,3,-48,-39,-9,96,41,55,15,-6,-23,-34,8,-4,9,-10,-13,-22,-2,3,6,4,-10,-12,10,-7,23,29,27,5,8,3,13,7,15,1,0,4,10,22,12,4,8,-1,-111,-58,-53,19,4,15,-5,-22,-57,-36,9,6,-9,-6,-31,-25,10,6,4,-16,-26,-11,-1,0,3,13,6,-5,2,-2,0,7,3,-5,1,-2,3,6,3,0,1,0,-138,-67,-71,0,-5,5,-12,-41,-37,-57,-6,16,-10,-20,-14,-28,-9,13,-2,-21,-23,-29,3,3,7,8,-7,-9,-2,-1,4,3,-6,-8,1,0,3,5,-1,-1,-3,-1,-166,-70,-96,2,3,-1,-20,-38,-39,-53,-9,-8,-2,-13,-22,-23,-9,-2,-18,-25,-17,-30,0,-6,4,12,6,-14,4,-10,6,6,2,-10,1,-2,-2,6,4,-4,3,-8,-203,-135,-68,-170,-102,-68,-10,-26,-62,-85,-8,-13,-13,-8,-49,-51,-8,-7,3,-18,-13,-34,0,-6,-25,-7,-54,-61,-16,-7,-13,-3,-33,-38,-12,-4,-12,-4,-21,-23,-4,-3,-92,-76,-16,64,13,51,8,-28,-49,-19,-2,-6,11,-13,-38,-30,-2,-5,-3,-15,-11,11,0,-1,5,23,14,11,4,2,3,7,-1,1,1,0,2,16,15,10,3,2,-111,-83,-28,12,-4,16,11,-40,-47,-26,-20,2,1,-24,-34,-18,-15,1,10,-16,-13,-8,-5,1,5,6,0,-8,2,2,8,3,-5,-12,-1,1,-3,3,5,4,3,1
12,12128,Vilafamés,1453,20,13,7,18,9,9,1,10,0,13,-1,-4,-2,8,2,9,-2,-3,3,2,-2,4,1,-1,4,5,4,3,1,0,3,2,1,2,0,0,1,3,3,1,1,0,55,27,28,22,12,10,10,10,29,0,4,1,5,5,17,-1,0,0,5,5,12,1,4,1,1,3,11,5,1,0,0,2,6,3,0,0,1,1,5,2,1,0,-19,-11,-8,7,4,3,-8,4,-1,-9,-4,0,-4,0,3,-7,-3,0,-4,4,-4,-2,-1,0,2,2,3,0,-1,1,1,0,3,0,0,0,1,2,0,0,-1,1,35,32,3,8,5,3,12,5,9,7,6,-3,9,8,4,6,6,-1,3,-3,5,1,0,-2,2,3,2,1,-1,1,1,2,1,1,0,0,1,1,1,0,-1,1,79,49,30,38,24,14,13,20,9,10,17,9,5,13,10,4,11,5,8,7,-1,6,6,4,1,18,10,7,1,0,1,11,7,5,0,0,0,7,3,2,1,0,33,12,21,31,14,17,14,-5,14,6,4,1,8,-8,5,5,2,0,6,3,9,1,2,1,10,4,14,3,0,0,5,2,6,1,0,0,5,2,8,2,0,0,56,16,40,20,7,13,8,11,2,24,8,2,-3,3,-5,16,3,1,11,8,7,8,5,1,3,8,2,6,1,0,0,6,0,2,-1,0,3,2,2,4,2,0,53,18,35,39,13,26,6,8,22,1,21,-5,1,4,5,-5,13,0,5,4,17,6,8,-5,4,13,13,7,2,0,1,6,3,1,2,0,3,7,10,6,0,0,24,23,1,19,11,8,-5,5,7,5,6,2,1,4,11,4,3,-2,-6,1,-4,1,3,4,5,2,5,4,3,0,4,0,3,3,1,0,1,2,2,1,2,0,-21,-16,-5,-6,-4,-2,-5,4,-14,-2,-9,7,-2,5,-11,-4,-7,4,-3,-1,-3,2,-2,3,1,0,-2,-4,-2,1,1,0,-3,-2,-1,1,0,0,1,-2,-1,0,-40,-13,-27,-31,-17,-14,-20,1,-15,-9,5,-2,-8,0,-3,-5,4,-1,-12,1,-12,-4,1,-1,-8,-4,-8,-9,-1,-1,-4,-4,-4,-6,1,0,-4,0,-4,-3,-2,-1,-19,-18,-1,-16,-10,-6,1,-5,5,-13,-2,-2,-1,0,-4,-5,-6,0,2,-5,9,-8,4,-2,0,-1,-6,-5,-2,-2,0,0,-4,-3,-2,-1,0,-1,-2,-2,0,-1,-8,-11,3,-12,-11,-1,5,3,-6,-2,-6,-3,0,1,-6,-1,-5,0,5,2,0,-1,-1,-3,-3,-1,-6,-3,1,0,-2,-2,-4,-2,-1,0,-1,1,-2,-1,2,0,-6,5,-11,-5,1,-6,0,-1,-3,-8,7,0,1,0,2,-2,5,0,-1,-1,-5,-6,2,0,-2,1,-5,0,0,1,1,1,-3,1,1,0,-3,0,-2,-1,-1,1,-45,-16,-29,-3,2,-5,-4,-7,-5,-14,-6,-10,-1,-4,0,-5,-1,-6,-3,-3,-5,-9,-5,-4,-2,3,-1,-3,0,0,-1,2,2,-2,1,0,-1,1,-3,-1,-1,0,-10,-8,-2,-5,-2,-3,-5,4,-5,3,-1,-6,-2,2,-4,2,-2,-4,-3,2,-1,1,1,-2,-4,2,1,0,-3,-1,-2,1,2,0,-2,-1,-2,1,-1,0,-1,0,-29,-10,-19,-7,-4,-3,-6,-1,-2,-7,-4,-8,-2,0,-2,-3,1,-4,-4,-1,0,-4,-5,-4,-1,-1,-1,-4,-1,1,-1,0,-1,-3,0,1,0,-1,0,-1,-1,0,18,12,6,0,0,0,4,5,10,0,7,-9,0,5,5,-3,7,-3,4,0,5,3,0,-6,-1,-1,1,-1,2,0,-1,0,0,0,1,0,0,-1,1,-1,1,0
12,12135,Vila-real,40933,666,363,303,339,179,160,95,207,222,86,20,29,49,107,137,45,5,16,46,100,85,41,15,13,43,72,145,49,21,5,21,36,85,24,10,2,22,36,60,25,11,3,1015,561,454,630,342,288,161,304,330,146,26,44,98,171,193,71,9,17,63,133,137,75,17,27,112,159,228,101,25,2,54,91,131,52,11,1,58,68,97,49,14,1,860,417,443,534,269,265,127,242,307,79,37,61,58,121,156,34,10,34,69,121,151,45,27,27,121,122,171,71,38,8,62,56,96,36,13,5,59,66,75,35,25,3,897,471,426,560,264,296,113,269,314,120,33,43,61,134,172,72,3,23,52,135,142,48,30,20,88,134,207,86,31,10,40,68,96,44,6,6,48,66,111,42,25,4,903,470,433,692,358,334,140,270,317,121,21,28,78,109,191,72,9,7,62,161,126,49,12,21,124,214,212,115,20,4,69,95,115,65,11,0,55,119,97,50,9,4,1204,634,570,763,361,402,252,332,383,159,60,27,139,160,220,85,25,12,113,172,163,74,35,15,143,210,237,118,41,10,67,92,129,54,15,2,76,118,108,64,26,8,1337,717,620,985,478,507,268,332,401,219,83,37,160,174,217,110,42,18,108,158,184,109,41,19,169,275,302,167,58,8,88,124,163,73,24,3,81,151,139,94,34,5,1447,776,671,1029,559,470,269,396,378,203,76,124,142,200,259,113,25,37,127,196,119,90,51,87,173,310,280,169,71,22,97,166,168,90,30,8,76,144,112,79,41,14,167,38,129,197,65,132,16,80,88,-30,-12,16,-3,34,16,-23,-8,17,19,46,72,-7,-4,-1,67,67,33,26,0,-4,34,25,-7,6,1,2,33,42,40,20,-1,-6,-135,-119,-16,101,7,94,12,-9,-82,-38,-25,24,35,-44,-60,-26,-23,12,-23,35,-22,-12,-2,12,52,45,15,14,-15,-12,38,-2,-11,-2,-9,-7,14,47,26,16,-6,-5,-387,-292,-95,-235,-178,-57,6,-14,-179,-151,-56,22,11,-23,-129,-117,-35,5,-5,9,-50,-34,-21,17,7,17,-110,-118,-25,-8,6,-5,-81,-81,-18,-1,1,22,-29,-37,-7,-7,21,-12,33,87,15,72,-43,10,-38,9,18,52,-5,-8,-37,3,15,14,-38,18,-1,6,3,38,1,43,4,3,19,8,4,8,-8,-4,7,3,-3,35,12,7,12,5,-212,-172,-40,-225,-163,-62,9,-67,-119,-61,0,27,36,-71,-81,-63,-3,11,-27,4,-38,2,3,16,-6,-21,-96,-55,-29,-20,7,-25,-61,-49,-24,-10,-13,4,-35,-6,-5,-10,-550,-313,-237,-603,-323,-280,-86,-52,-154,-200,-74,14,-21,-40,-89,-123,-44,7,-65,-12,-65,-77,-30,7,-87,-50,-175,-188,-83,-22,-45,-32,-94,-111,-40,-1,-42,-18,-81,-77,-43,-21,-153,-100,-53,-216,-123,-93,16,-24,-104,-102,-11,63,11,1,-50,-76,-20,29,5,-25,-54,-26,9,34,-16,-1,-93,-95,-19,6,1,4,-54,-65,-13,2,-17,-5,-39,-30,-6,4,-211,-179,-32,-263,-176,-87,-2,-29,-107,-85,-19,19,-9,-22,-79,-69,-7,4,7,-7,-28,-16,-12,15,-23,-24,-100,-94,-20,-11,-15,-18,-60,-69,-10,-7,-8,-6,-40,-25,-10,-4,214,147,67,84,51,33,67,37,64,1,3,39,68,14,31,2,8,22,-1,23,33,-1,-5,17,25,23,7,-17,35,7,25,15,-1,-17,21,7,0,8,8,0,14,0,222,130,92,148,72,76,68,26,65,31,-14,35,53,13,49,6,-2,9,15,13,16,25,-12,26,37,38,50,19,-1,-1,24,11,33,5,-4,-1,13,27,17,14,3,0
12,12138,Vinaròs,22268,557,286,271,436,235,201,63,154,177,90,42,26,39,77,97,39,19,11,24,77,80,51,23,15,56,108,146,91,25,8,33,58,83,45,12,4,23,50,63,46,13,4,611,362,249,460,250,210,79,161,196,94,45,30,46,98,116,52,31,14,33,63,80,42,14,16,69,140,145,78,23,1,36,80,79,41,10,1,33,60,66,37,13,0,389,249,140,297,159,138,67,94,90,72,36,32,57,56,56,46,20,15,10,38,34,26,16,17,50,83,79,64,17,0,25,44,47,34,5,1,25,39,32,30,12,-1,456,239,217,400,197,203,93,106,76,91,42,46,49,55,41,48,20,23,44,51,35,43,22,23,101,94,90,67,34,10,48,46,43,34,17,7,53,48,47,33,17,3,697,345,352,545,290,255,116,123,192,118,93,60,45,69,89,73,40,30,71,54,103,45,53,30,105,120,134,84,66,35,54,65,74,40,38,18,51,55,60,44,28,17,954,538,416,537,288,249,118,211,250,173,141,43,57,124,151,106,67,25,61,87,99,67,74,18,79,137,140,85,71,19,40,75,78,46,35,12,39,62,62,39,36,7,819,440,379,512,258,254,124,171,203,202,91,20,54,84,112,120,53,10,70,87,91,82,38,10,80,153,102,95,48,34,43,80,48,45,24,18,37,73,54,50,24,16,865,447,418,504,258,246,163,177,209,152,111,40,88,80,112,76,63,25,75,97,97,76,48,15,119,154,71,93,43,16,73,69,37,46,24,7,46,85,34,47,19,9,249,159,90,196,105,91,37,68,49,52,18,27,24,46,44,32,2,14,13,22,5,20,16,13,32,71,39,44,3,4,16,35,19,24,4,4,16,36,20,20,-1,0,31,22,9,24,-8,32,37,20,-39,14,-6,8,16,2,-23,12,-1,14,21,18,-16,2,-5,-6,30,32,-33,-4,-5,3,20,11,-24,-10,-5,-1,10,21,-9,6,0,4,197,73,124,80,-5,85,68,41,31,29,16,6,12,23,14,-9,11,14,56,18,17,38,5,-8,32,21,23,-1,-2,4,12,5,-14,-15,0,4,20,16,37,14,-2,0,74,31,43,-65,-55,-10,59,3,-5,23,-1,-4,52,-3,-22,17,-7,-7,7,6,17,6,6,3,5,-14,-15,-46,0,5,10,-10,-11,-42,-5,3,-5,-4,-4,-4,5,2,238,129,109,21,14,7,52,31,10,49,51,42,40,16,14,25,19,12,12,15,-4,24,32,30,5,25,-4,-14,2,5,10,11,6,-11,-2,-1,-5,14,-10,-3,4,6,-415,-236,-179,-456,-270,-186,-67,-42,-134,-97,-7,-73,-35,-38,-79,-54,-4,-25,-32,-4,-55,-43,-3,-48,-63,-24,-123,-111,-56,-80,-32,-21,-81,-69,-32,-35,-31,-3,-42,-42,-24,-45,-171,-93,-78,-215,-116,-99,49,30,-35,-98,-25,-91,18,21,-9,-62,-24,-37,31,9,-26,-36,-1,-54,25,27,-69,-67,-31,-103,13,18,-31,-41,-26,-50,12,9,-38,-26,-5,-53,109,58,51,104,52,52,45,-11,22,9,21,13,20,1,4,-1,23,7,25,-12,18,10,-2,6,37,6,11,20,14,7,16,10,3,7,11,0,21,-4,8,13,3,7,131,90,41,60,26,34,10,9,-13,14,92,10,21,11,11,-19,46,14,-11,-2,-24,33,46,-4,8,26,-9,0,27,3,4,12,9,-22,11,9,4,14,-18,22,16,-6,273,89,184,215,78,137,67,19,64,15,54,56,18,8,10,-5,24,37,49,11,54,20,30,19,57,31,72,-5,26,29,16,16,29,-10,8,16,41,15,43,5,18,13
12,12140,Viver,1265,2,-6,8,4,1,3,-4,1,-1,-1,9,-2,-4,1,-6,-1,5,-1,0,0,5,0,4,-1,0,2,2,0,0,0,0,1,0,0,0,0,0,1,2,0,0,0,27,12,15,17,10,7,6,-1,16,6,2,-1,2,-1,10,2,1,-1,4,0,6,4,1,0,2,3,9,3,0,0,2,0,6,2,0,0,0,3,3,1,0,0,97,56,41,67,43,24,7,20,31,10,9,19,3,12,20,6,5,9,4,8,11,4,4,10,6,20,29,10,2,0,2,14,20,6,1,0,4,6,9,4,1,0,40,27,13,43,30,13,2,19,0,13,2,4,2,9,2,9,2,3,0,10,-2,4,0,1,5,19,14,5,0,0,4,11,12,3,0,0,1,8,2,2,0,0,27,6,21,25,10,15,4,8,4,-2,6,4,-1,2,2,0,1,0,5,6,2,-2,5,4,2,9,11,2,0,0,-1,5,6,-1,0,0,3,4,5,3,0,0,77,53,24,53,35,18,14,9,-2,29,14,12,8,10,3,18,8,6,6,-1,-5,11,6,6,9,16,9,17,1,0,4,12,6,12,1,0,5,4,3,5,0,0,108,53,55,61,34,27,23,11,45,12,9,6,12,5,21,11,1,2,11,6,24,1,8,4,13,11,23,10,2,1,7,6,13,7,0,0,6,5,10,3,2,1,94,59,35,42,27,15,17,18,33,25,0,0,11,12,19,12,2,2,6,6,14,13,-2,-2,5,15,13,9,0,0,1,12,9,5,0,0,4,3,4,4,0,0,44,29,15,16,10,6,3,12,11,5,8,6,2,5,11,2,4,5,1,7,0,3,4,1,1,7,8,-3,2,0,1,4,5,-2,1,0,0,3,3,-1,1,0,-39,-27,-12,-26,-23,-3,-5,-3,-22,-5,-1,-2,-2,-2,-12,-9,0,-1,-3,-1,-10,4,-1,-1,-3,-6,-8,-9,0,0,-3,-5,-7,-8,0,0,0,-1,-1,-1,0,0,-15,-5,-10,-1,-4,3,3,1,-10,-4,0,-5,3,1,-7,-1,1,-1,0,0,-3,-3,-1,-4,5,3,-4,-3,-2,-1,3,1,-3,-3,-2,0,2,2,-1,0,0,-1,-3,2,-5,-9,-6,-3,-4,-3,-10,8,7,-3,-1,-1,-7,7,4,-2,-3,-2,-3,1,3,-1,-3,-1,-6,1,-1,0,-2,-1,-4,0,0,0,-1,0,-2,1,-1,0,-24,-14,-10,-16,-11,-5,-5,-12,-7,2,-1,-1,-5,-12,-5,5,1,2,0,0,-2,-3,-2,-3,-4,-4,-6,-3,0,1,-3,-4,-3,-2,1,0,-1,0,-3,-1,-1,1,-28,-16,-12,-21,-15,-6,-3,-3,-6,-11,-8,0,-2,-5,-7,-1,-3,-1,-1,2,1,-10,-5,1,-3,0,-11,-6,-3,1,-3,0,-9,-2,-3,1,0,0,-2,-4,0,0,-18,-13,-5,-5,-5,0,-4,-5,4,-6,-3,-4,0,-4,2,-12,2,-1,-4,-1,2,6,-5,-3,1,2,0,-3,-5,0,-1,1,2,-3,-4,0,2,1,-2,0,-1,0,-13,-9,-4,-6,-4,-2,2,-3,-9,0,0,-3,-1,1,-2,-4,-1,-2,3,-4,-7,4,1,-1,-1,-2,-3,1,-1,0,-1,-1,-2,-1,1,0,0,-1,-1,2,-2,0,-24,-9,-15,-25,-11,-14,-2,1,0,-3,-13,-6,2,2,0,-3,-6,-3,-4,-1,0,0,-7,-3,-3,2,-9,-7,-8,0,0,3,-5,-6,-3,0,-3,-1,-4,-1,-5,0,28,12,16,-1,0,-1,7,-2,8,3,1,12,0,-1,3,5,1,5,7,-1,5,-2,0,7,-1,0,2,1,-3,0,0,0,1,1,-2,0,-1,0,1,0,-1,0
13,13005,Alcázar de San Juan,26104,281,124,157,184,93,91,50,51,149,22,9,-5,27,24,56,13,5,-4,23,27,93,9,4,-1,28,45,66,34,6,2,12,23,32,17,5,1,16,22,34,17,1,1,196,110,86,226,126,100,17,54,72,28,22,1,8,22,54,19,7,-1,9,32,18,9,15,2,29,67,80,40,9,0,13,34,51,24,3,0,16,33,29,16,6,0,631,290,341,244,127,117,95,154,181,82,37,80,44,71,84,37,25,30,51,83,97,45,12,50,49,86,65,31,10,3,23,46,37,15,4,2,26,40,28,16,6,1,526,299,227,277,156,121,134,108,191,56,31,0,66,60,106,46,12,6,68,48,85,10,19,-6,68,75,82,38,9,3,29,41,50,29,5,1,39,34,32,9,4,2,437,235,202,264,138,126,90,108,165,42,8,26,39,60,96,29,2,7,51,48,69,13,6,19,47,88,86,34,7,2,15,49,51,20,3,0,32,39,35,14,4,2,714,394,320,455,257,198,95,179,249,140,28,11,46,101,137,81,19,2,49,78,112,59,9,9,71,138,138,81,18,6,34,77,81,47,15,2,37,61,57,34,3,4,544,329,215,483,285,198,92,137,139,137,26,14,47,80,87,97,17,5,45,57,52,40,9,9,83,130,162,84,17,2,46,72,104,51,9,0,37,58,58,33,8,2,829,451,378,628,366,262,129,200,288,132,60,7,78,97,155,81,27,9,51,103,133,51,33,-2,103,177,197,108,31,8,60,101,122,69,11,3,43,76,75,39,20,5,332,216,116,378,228,150,70,45,145,72,1,-3,41,27,104,44,-1,0,29,18,41,28,2,-3,73,81,126,72,16,2,43,44,83,40,11,2,30,37,43,32,5,0,293,145,148,228,117,111,65,47,85,67,9,6,24,28,29,33,11,8,41,19,56,34,-2,-2,40,60,59,46,10,5,25,26,30,27,4,1,15,34,29,19,6,4,149,40,109,130,39,91,29,52,30,9,14,4,16,18,7,-2,0,-3,13,34,23,11,14,7,32,51,31,9,3,-1,15,18,9,-1,-2,-2,17,33,22,10,5,1,335,97,238,137,57,80,78,55,90,59,23,26,41,19,2,17,3,11,37,36,88,42,20,15,40,43,20,20,8,4,25,13,7,8,1,2,15,30,13,12,7,2,-86,-62,-24,-25,-27,2,-11,-24,-33,-22,-1,5,-13,-6,-30,-11,-7,4,2,-18,-3,-11,6,1,-9,9,-11,-16,-1,1,0,-3,-10,-8,-6,-1,-9,12,-1,-8,5,2,-22,-32,10,-31,-24,-7,26,-18,-13,30,-19,-26,11,-11,-17,8,-13,-8,15,-7,4,22,-6,-18,4,-3,-26,-6,-1,-1,0,-6,-13,-7,0,1,4,3,-13,1,-1,-2,-146,-91,-55,-8,3,-11,-41,-15,-17,-39,-23,-6,-22,-8,-9,-28,-15,-7,-19,-7,-8,-11,-8,1,-8,7,-3,-4,-3,1,3,2,4,-6,-1,0,-11,5,-7,2,-2,1,-46,-30,-16,3,-9,12,50,-27,-45,-50,27,-4,35,-8,-23,-46,16,-6,15,-19,-22,-4,11,2,-3,5,2,3,3,-8,2,5,-1,-8,-2,-5,-5,0,3,11,5,-3,87,39,48,126,62,64,7,33,8,-9,38,11,4,28,-8,-12,30,1,3,5,16,3,8,10,17,36,32,14,15,9,15,22,12,5,5,3,2,14,20,9,10,6,-28,17,-45,86,35,51,-14,-5,-31,-5,13,7,13,2,-1,-4,2,6,-27,-7,-30,-1,11,1,9,20,22,11,14,8,4,10,15,1,3,2,5,10,7,10,11,6
13,13013,Almagro,8255,75,50,25,50,32,18,0,7,36,13,10,7,-3,7,25,10,6,4,3,0,11,3,4,3,1,14,28,7,0,0,0,6,19,7,0,0,1,8,9,0,0,0,46,29,17,51,28,23,5,29,15,5,3,-11,0,14,13,4,0,-3,5,15,2,1,3,-8,12,17,17,3,1,0,7,10,9,1,0,0,5,7,8,2,1,0,76,36,40,59,26,33,20,9,1,17,11,13,10,4,2,3,6,6,10,5,-1,14,5,7,24,10,13,8,2,0,10,4,8,2,1,0,14,6,5,6,1,0,82,38,44,37,21,16,29,13,11,19,5,3,13,6,8,9,2,1,16,7,3,10,3,2,14,6,9,5,1,2,9,3,5,3,0,1,5,3,4,2,1,1,-8,-9,1,44,25,19,-8,0,7,0,3,-8,-8,1,0,4,-4,-2,0,-1,7,-4,7,-6,4,16,15,8,1,0,2,7,10,6,0,0,2,9,5,2,1,0,32,23,9,45,29,16,-5,4,14,3,7,8,3,1,8,2,1,5,-8,3,6,1,6,3,7,11,10,13,1,0,5,2,9,9,1,0,2,9,1,4,0,0,51,50,1,53,34,19,17,2,17,3,10,3,12,9,15,7,6,2,5,-7,2,-4,4,1,7,17,19,8,2,0,3,11,13,6,1,0,4,6,6,2,1,0,155,90,65,96,50,46,29,48,24,41,11,2,14,27,20,23,10,-4,15,21,4,18,1,6,19,32,23,18,4,0,8,16,13,9,4,0,11,16,10,9,0,0,150,70,80,50,25,25,41,36,30,9,15,10,18,14,14,8,11,1,23,22,16,1,4,9,15,17,9,8,1,0,8,7,4,6,0,0,7,10,5,2,1,0,-49,-47,-2,-46,-32,-14,-3,-5,-39,-21,7,9,-1,-3,-33,-19,3,4,-2,-2,-6,-2,4,5,-8,0,-14,-17,-5,-2,-4,2,-12,-16,-1,-1,-4,-2,-2,-1,-4,-1,44,27,17,31,14,17,9,13,-15,22,14,4,10,10,-9,10,4,2,-1,3,-6,12,10,2,10,7,8,4,2,0,4,3,6,1,0,0,6,4,2,3,2,0,-10,-10,0,23,13,10,-3,-11,10,0,-6,-2,-6,-2,3,0,-2,-4,3,-9,7,0,-4,2,6,3,4,6,3,0,3,3,1,3,2,0,3,0,3,3,1,0,19,17,2,20,10,10,13,2,1,7,-8,0,10,4,9,-3,-5,0,3,-2,-8,10,-3,0,5,5,2,5,1,0,2,4,1,2,-1,0,3,1,1,3,2,0,-95,-41,-54,4,4,0,-27,-8,-33,-15,-3,-8,-4,-4,-16,-10,-4,-2,-23,-4,-17,-5,1,-6,-2,1,4,1,0,0,0,1,3,1,-1,0,-2,0,1,0,1,0,-34,-22,-12,10,5,5,7,-17,-9,-16,-1,1,5,-13,-9,-6,-2,0,2,-4,0,-10,1,1,3,1,3,1,2,0,1,0,2,1,1,0,2,1,1,0,1,0,-121,-73,-48,-29,-15,-14,-24,-17,-32,-34,-14,4,-20,-7,-16,-22,-6,1,-4,-10,-16,-12,-8,3,-8,-4,-8,-9,-1,2,-5,-3,-5,-4,1,1,-3,-1,-3,-5,-2,1,26,5,21,23,10,13,20,3,7,1,-5,-8,4,-1,3,-1,-1,-4,16,4,4,2,-4,-4,7,8,4,1,-1,0,2,3,1,2,0,0,5,5,3,-1,-1,0,-36,-31,-5,1,2,-1,-19,1,-17,-4,1,0,-15,-1,-11,-4,0,-1,-4,2,-6,0,1,1,-4,4,2,-2,-1,2,-3,5,1,0,-1,0,-1,-1,1,-2,0,2
13,13019,Argamasilla de Alba,6681,-12,0,-12,30,23,7,-14,-5,-3,8,-3,4,-8,-2,5,6,-1,1,-6,-3,-8,2,-2,3,0,3,16,11,0,0,0,2,13,8,0,0,0,1,3,3,0,0,87,57,30,69,43,26,20,29,9,25,4,0,14,19,7,15,1,1,6,10,2,10,3,-1,10,17,21,17,2,1,5,13,13,12,0,0,5,4,8,5,2,1,23,8,15,76,47,29,4,2,3,11,-3,5,2,-5,8,0,-2,4,2,7,-5,11,-1,1,16,19,20,18,1,1,11,10,16,8,1,1,5,9,4,10,0,0,89,45,44,115,58,57,9,42,18,14,7,1,0,17,8,12,5,4,9,25,10,2,2,-3,16,38,39,22,0,0,5,18,21,14,0,0,11,20,18,8,0,0,-4,-9,5,43,10,33,1,7,7,-17,-4,4,-2,0,4,-7,-4,1,3,7,3,-10,0,3,9,23,20,-6,-4,0,3,8,4,-2,-4,0,6,15,16,-4,0,0,265,191,74,283,193,90,44,64,122,42,-1,-6,24,44,93,31,-2,0,20,20,29,11,1,-6,44,78,115,41,5,0,25,51,84,29,4,0,19,27,31,12,1,0,94,74,20,158,102,56,20,49,19,-6,10,8,15,44,14,-7,7,2,5,5,5,1,3,6,28,57,52,14,6,0,18,40,34,6,4,0,10,17,18,8,2,0,243,164,79,259,162,97,35,55,89,41,15,1,19,44,67,22,7,3,16,11,22,19,8,-2,40,68,95,39,15,0,20,45,68,19,9,0,20,23,27,20,6,0,16,16,0,83,55,28,1,6,4,-2,1,2,2,5,9,0,-1,0,-1,1,-5,-2,2,2,9,20,37,15,-1,0,6,8,30,11,-1,0,3,12,7,4,0,0,0,-5,5,-8,-15,7,24,11,-43,16,-5,-3,14,-2,-29,15,1,-3,10,13,-14,1,-6,0,15,8,-24,-6,-5,1,8,-2,-15,-6,-2,0,7,10,-9,0,-3,1,-123,-104,-19,-44,-57,13,-28,8,-51,-34,-10,-7,-11,-1,-47,-37,-6,-1,-17,9,-4,3,-4,-6,-13,9,-27,-8,-6,0,-5,0,-30,-20,-2,0,-8,9,3,12,-4,0,-32,-8,-24,-59,-40,-19,-19,1,1,-12,-3,0,-5,-1,5,-7,-2,2,-14,2,-4,-5,-1,-2,-23,0,-14,-15,-8,0,-6,-5,-13,-10,-6,0,-17,5,-1,-5,-2,0,-119,-87,-32,-47,-54,7,-17,-17,-35,-38,-11,-2,-6,-10,-31,-33,-6,-3,-11,-7,-4,-5,-5,1,-1,0,-22,-20,-5,0,-2,-3,-21,-24,-5,0,1,3,-1,4,0,0,-45,-22,-23,19,14,5,-6,-2,-18,-14,-3,-1,-9,2,-8,-3,-2,0,3,-4,-10,-11,-1,-1,8,4,4,2,1,0,4,4,2,3,1,0,4,0,2,-1,0,0,-77,-40,-37,-52,-25,-27,-8,14,-51,-39,5,1,3,15,-28,-30,-3,2,-11,-1,-23,-9,8,-1,-9,14,-27,-33,0,0,-1,12,-13,-20,-5,0,-8,2,-14,-13,5,0,-108,-64,-44,-136,-86,-50,12,-21,-50,-44,-19,13,2,-10,-29,-24,-10,6,10,-11,-21,-20,-9,7,-4,-18,-50,-46,-17,-1,-6,-15,-29,-27,-7,-2,2,-3,-21,-19,-10,1,-43,-14,-29,-14,-3,-11,-7,-6,-17,-12,4,-5,-2,-5,-4,-8,7,-3,-5,-1,-13,-4,-3,-2,3,-6,0,-4,-5,-3,2,-4,3,-4,0,-1,1,-2,-3,0,-5,-2,3,6,-3,52,26,26,-4,-2,-1,14,0,-3,1,2,-2,5,1,-2,-5,-4,1,9,-1,-1,8,10,11,21,1,1,5,7,2,11,0,1,3,3,9,10,1,0
13,13020,Argamasilla de Calatrava,5536,18,14,4,11,6,5,-1,-2,17,6,4,-7,-3,-3,14,6,4,-5,2,1,3,0,0,-2,1,3,4,3,0,0,1,2,1,2,0,0,0,1,3,1,0,0,23,7,16,25,9,16,8,-4,1,17,3,-6,2,-2,-1,9,1,-4,6,-2,2,8,2,-2,3,5,10,4,2,0,1,1,5,2,0,0,2,4,5,2,2,0,1,1,0,10,4,6,-9,-9,1,4,12,2,-9,2,-2,2,5,3,0,-11,3,2,7,-1,3,1,5,0,1,0,2,0,3,-1,0,0,1,1,2,1,1,0,-97,-57,-40,4,2,2,-12,-24,-36,-12,-6,-8,-10,-13,-21,-8,-4,-2,-2,-11,-15,-4,-2,-6,0,0,2,1,1,0,0,0,1,0,1,0,0,0,1,1,0,0,-2,2,-4,10,5,5,13,-17,-2,-4,6,1,15,-15,-5,0,5,2,-2,-2,3,-4,1,-1,1,7,0,1,0,1,1,2,0,1,0,1,0,5,0,0,0,0,140,78,62,46,17,29,10,35,48,26,16,2,6,9,37,17,8,1,4,26,11,9,8,1,3,17,17,6,1,2,1,3,7,4,1,1,2,14,10,2,0,1,104,69,35,26,10,16,27,12,21,24,14,0,16,14,10,15,7,1,11,-2,11,9,7,-1,2,8,11,5,0,0,2,2,4,2,0,0,0,6,7,3,0,0,121,89,32,21,17,4,24,15,39,31,14,-5,16,10,34,17,12,0,8,5,5,14,2,-5,6,10,3,-1,2,0,4,7,6,-2,2,0,2,3,-3,1,0,0,81,37,44,27,11,16,17,5,5,20,17,16,7,4,-3,14,7,7,10,1,8,6,10,9,9,8,5,3,1,0,3,3,2,1,1,0,6,5,3,2,0,0,55,44,11,10,7,3,8,5,22,0,12,7,2,4,19,3,8,5,6,1,3,-3,4,2,2,4,0,0,2,1,1,1,2,0,1,1,1,3,-2,0,1,0,19,-3,22,-9,-11,2,-6,18,9,0,0,-8,-5,8,0,-4,-1,-2,-1,10,9,4,1,-6,0,6,-3,-6,-6,0,-1,3,-3,-4,-6,0,1,3,0,-2,0,0,84,29,55,14,7,7,2,20,53,8,0,-5,1,13,19,-1,-3,-2,1,7,34,9,3,-3,1,5,2,4,2,0,0,3,1,3,0,0,1,2,1,1,2,0,0,1,-1,-6,-3,-3,-11,15,-2,0,4,-8,-9,6,2,0,1,-1,-2,9,-4,0,3,-7,0,0,-4,-1,-1,0,0,0,-2,-1,0,0,0,0,-2,0,-1,0,1,0,1,-1,-1,0,12,5,-19,8,9,-12,4,2,-9,6,8,-8,8,3,-10,2,1,-4,1,-1,-2,2,0,-1,0,-2,-1,2,0,0,1,1,-1,0,0,-1,2,10,-8,4,3,1,-3,12,8,4,-16,-3,3,12,3,7,-12,-2,-6,0,5,-3,-4,-1,1,3,-2,3,-1,0,0,4,-3,3,-1,0,1,-1,1,0,0,0,12,15,-3,-4,-1,-3,5,3,0,16,-2,-13,1,-1,2,13,4,-6,4,4,-2,3,-6,-7,-1,-1,-1,0,-1,0,-1,-1,1,0,0,0,0,0,-2,0,-1,0,-70,-34,-36,-17,-6,-11,-5,1,-40,-11,-2,-10,-3,0,-16,-7,-3,-4,-2,1,-24,-4,1,-6,-3,-1,-6,-5,-1,-1,0,0,-2,-3,-1,0,-3,-1,-4,-2,0,-1,-8,-8,0,6,7,-1,8,-12,-8,-3,2,6,0,-5,-5,-1,-2,5,8,-7,-3,-2,4,1,1,3,2,0,0,0,2,3,2,0,0,0,-1,0,0,0,0,0
13,13027,Calzada de Calatrava,4754,-42,-22,-20,11,6,5,-17,3,-28,-1,6,-8,-11,2,-11,-3,3,-3,-6,1,-17,2,3,-5,1,4,2,2,1,0,0,3,2,0,0,0,1,1,0,2,1,0,-2,-6,4,19,10,9,0,-1,2,0,3,-5,-2,-1,0,-1,3,-4,2,0,2,1,0,-1,5,8,4,2,0,0,4,4,2,0,0,0,1,4,2,2,0,0,44,22,22,48,31,17,-2,17,8,6,5,11,-3,12,7,4,2,1,1,5,1,2,3,10,5,12,22,7,2,0,3,7,15,6,0,0,2,5,7,1,2,0,40,30,10,47,25,22,14,2,11,2,9,2,3,3,12,0,6,7,11,-1,-1,2,3,-5,11,11,18,5,0,2,5,4,13,3,0,0,6,7,5,2,0,2,10,18,-8,48,32,16,-6,13,-1,8,3,-3,-6,12,6,5,2,0,0,1,-7,3,1,-3,0,15,14,18,0,1,0,8,12,11,1,0,0,7,2,7,-1,1,-15,-4,-11,27,19,8,-5,-5,-3,-6,7,-3,-7,-3,6,0,2,-2,2,-2,-9,-6,5,-1,6,9,10,0,3,-1,3,6,9,0,1,0,3,3,1,0,2,-1,6,12,-6,69,39,30,12,1,-4,-3,2,-4,9,2,-2,-1,2,0,3,-1,-2,-2,0,-4,20,13,20,11,4,0,11,6,13,6,2,0,9,7,7,5,2,0,38,18,20,53,32,21,23,23,-14,5,4,-3,10,12,-10,6,3,-4,13,11,-4,-1,1,1,7,21,11,12,2,0,4,11,7,9,1,0,3,10,4,3,1,0,20,9,11,21,15,6,15,9,-11,12,-2,-4,13,4,-13,7,-1,-1,2,5,2,5,-1,-3,4,4,9,3,1,0,3,3,5,2,1,1,1,1,4,1,0,-1,-46,-20,-26,-30,-19,-11,1,-20,-22,-3,-5,4,-2,-7,-16,4,0,2,3,-13,-6,-7,-5,2,-5,-4,-9,-9,-2,-1,-4,-2,-7,-5,-1,0,-1,-2,-2,-4,-1,-1,1,-2,3,10,6,4,-2,-2,-11,3,13,-2,0,-4,-7,-1,6,2,-2,2,-4,4,7,-4,4,4,-1,3,0,0,3,3,-1,1,0,0,1,1,0,2,0,0,21,12,9,16,9,7,8,0,2,9,5,-3,6,1,3,2,0,-1,2,-1,-1,7,5,-2,2,4,6,4,0,0,1,3,4,1,0,0,1,1,2,3,0,0,-83,-42,-41,6,2,4,-10,-16,-31,-15,-7,-4,-9,-3,-15,-10,-3,-1,-1,-13,-16,-5,-4,-3,1,3,1,0,0,0,0,1,1,0,0,0,1,2,0,0,0,0,-40,-9,-31,6,3,3,-4,-4,-19,-9,2,-7,1,-2,-9,-3,4,-1,-5,-2,-10,-6,-2,-6,0,2,1,2,1,0,0,1,0,1,1,0,0,1,1,1,0,0,-5,3,-8,5,1,4,-4,-13,-6,-1,9,12,1,-3,-6,-1,7,6,-5,-10,0,0,2,6,-1,2,1,2,1,0,-1,1,0,1,0,0,0,1,1,1,1,0,-2,3,-5,9,3,6,7,-9,-2,-1,-6,8,0,-2,0,0,-3,6,7,-7,-2,-1,-3,2,7,0,0,2,0,0,5,0,-2,0,0,0,2,0,2,2,0,0,-83,-36,-47,5,3,2,-8,-11,-40,-17,-4,-1,1,-6,-17,-12,-1,-1,-9,-5,-23,-5,-3,0,2,2,0,0,1,0,2,1,0,0,0,0,0,1,0,0,1,0,-53,-33,-20,5,2,3,-2,-15,-28,-5,-5,3,-4,-4,-20,0,-4,0,2,-11,-8,-5,-1,3,2,1,2,0,0,0,2,1,0,-1,0,0,0,0,2,1,0,0
13,13034,Ciudad Real,61138,369,137,232,254,101,153,116,-13,168,75,-7,37,54,-26,77,33,-7,14,62,13,91,42,0,23,39,72,95,35,6,7,20,22,45,10,0,4,19,50,50,25,6,3,424,149,275,297,124,173,132,25,164,68,10,22,71,-3,42,27,2,11,61,28,122,41,8,11,61,76,111,35,8,4,29,27,47,16,3,1,32,49,64,19,5,3,530,214,316,382,160,222,200,85,171,54,-19,36,110,22,66,18,-9,7,90,63,105,36,-10,29,102,106,94,57,11,4,54,35,41,20,5,1,48,71,53,37,6,3,1163,516,647,391,179,212,266,98,337,223,86,135,148,50,121,99,39,58,118,48,216,124,47,77,105,109,90,56,22,4,58,49,38,22,9,1,47,60,52,34,13,3,1352,599,753,555,252,303,367,162,385,291,76,61,167,67,188,127,28,28,200,95,197,164,48,33,129,146,156,78,30,10,68,62,61,42,15,3,61,84,95,36,15,7,1051,404,647,630,254,376,205,249,325,176,25,52,99,57,145,64,5,24,106,192,180,112,20,28,107,222,169,89,29,9,49,81,79,33,9,1,58,141,90,56,20,8,1131,502,629,718,327,391,277,140,363,263,26,43,149,60,161,108,-1,22,128,80,202,155,27,21,142,184,216,138,28,5,68,76,113,56,10,1,74,108,103,82,18,4,789,360,429,689,333,356,136,203,275,109,12,35,77,85,123,71,-5,6,59,118,152,38,17,29,108,213,213,116,25,5,67,82,110,57,13,1,41,131,103,59,12,4,1130,486,644,507,238,269,240,274,315,178,30,70,130,109,131,66,3,37,110,165,184,112,27,33,101,152,148,77,19,-2,47,66,69,44,7,1,54,86,79,33,12,-3,167,55,112,192,77,115,36,22,102,-9,-18,28,33,21,48,-39,-21,8,3,1,54,30,3,20,66,61,42,6,8,5,28,25,23,-2,-3,2,38,36,19,8,11,3,-24,-91,67,-28,-43,15,73,-46,-85,35,-27,26,25,-60,-70,18,-11,8,48,14,-15,17,-16,18,19,10,-22,-35,-11,2,13,-5,-31,-24,-1,1,6,15,9,-11,-10,1,16,39,-23,-52,-27,-25,-14,-20,1,82,-38,29,12,2,2,52,-34,10,-26,-22,-1,30,-4,19,11,4,-21,-22,-23,-10,15,-5,-13,-10,-13,-4,-4,9,-8,-12,-10,-6,-132,-120,-12,68,43,25,-73,17,-59,-33,-4,21,-43,-6,-52,-9,-5,-5,-30,23,-7,-24,1,26,12,41,24,-10,-7,1,5,18,10,5,1,0,7,23,14,-15,-8,1,217,54,163,114,33,81,-6,38,34,30,41,59,-23,-7,0,22,27,21,17,45,34,8,14,38,24,39,4,15,17,6,5,10,5,2,6,2,19,29,-1,13,11,4,-335,-177,-158,-23,-26,3,-64,-34,-203,-29,-46,41,-31,-6,-88,-37,-31,13,-33,-28,-115,8,-15,28,-21,44,-17,-28,1,-6,-3,21,-12,-26,-7,-1,-18,23,-5,-2,8,-5,11,24,-13,87,24,63,35,-38,-139,54,43,56,3,-12,-56,33,32,26,32,-26,-83,21,11,30,31,34,-14,12,7,8,13,10,-4,1,-1,0,18,24,-10,11,8,8,0,-70,70,93,23,70,-23,41,-101,-18,-3,110,-1,-2,-57,-34,-2,38,-22,43,-44,16,-1,72,23,36,1,-1,12,14,15,15,-6,-14,3,5,8,21,7,13,9,9,-586,-251,-335,-370,-166,-204,-38,8,-202,-290,-99,20,-15,40,-92,-168,-33,14,-23,-32,-110,-122,-66,6,-12,61,-137,-205,-58,-26,-9,61,-67,-116,-31,-8,-3,0,-70,-89,-27,-18
13,13037,Cózar,1320,-11,-6,-5,4,1,3,-3,-4,-5,-3,-2,5,-2,-2,-3,-2,-1,3,-1,-2,-2,-1,-1,2,0,0,3,0,1,0,0,0,1,0,0,0,0,0,2,0,1,0,0,3,-3,10,6,4,0,0,-2,0,2,1,0,2,0,0,1,0,0,-2,-2,0,1,1,1,1,7,1,0,0,0,1,5,0,0,0,1,0,2,1,0,0,34,25,9,53,36,17,-2,6,22,1,4,2,0,6,14,2,2,1,-2,0,8,-1,2,1,3,15,26,8,1,0,1,11,17,6,1,0,2,4,9,2,0,0,27,26,1,40,26,14,9,13,1,1,7,-2,2,10,11,-1,5,-1,7,3,-10,2,2,-1,10,13,12,5,0,0,3,10,12,1,0,0,7,3,0,4,0,0,67,39,28,75,45,30,3,25,27,12,7,-7,3,17,9,10,2,-2,0,8,18,2,5,-5,6,24,32,12,1,0,2,16,18,9,0,0,4,8,14,3,1,0,3,1,2,38,21,17,1,5,-17,8,2,3,1,5,-14,6,0,2,0,0,-3,2,2,1,5,12,10,9,1,0,1,9,5,5,0,0,4,3,5,4,1,0,-15,-6,-9,16,9,7,1,1,-19,0,-2,6,1,3,-8,0,-1,1,0,-2,-11,0,-1,5,7,7,-1,4,-1,0,4,7,-2,1,-1,0,3,0,1,3,0,0,16,14,2,46,28,18,7,8,0,1,4,-3,5,5,0,3,2,-1,2,3,0,-2,2,-2,12,14,11,6,2,0,7,7,7,5,2,0,5,7,4,1,0,0,1,7,-6,28,18,10,-2,11,-1,-2,2,-7,1,9,0,-1,1,-3,-3,2,-1,-1,1,-4,0,14,9,4,1,0,0,10,5,3,0,0,0,4,4,1,1,0,5,-4,9,14,7,7,1,0,-6,11,-1,1,-3,2,-4,4,-2,0,4,-2,-2,7,1,1,2,2,4,6,0,0,1,2,2,2,0,0,1,0,2,4,0,0,-17,-3,-14,8,6,2,0,-1,-5,-10,0,0,0,0,-2,-2,0,1,0,-1,-3,-8,0,-1,3,2,1,2,0,0,2,2,0,2,0,0,1,0,1,0,0,0,3,4,-1,13,9,4,2,-4,0,8,0,-4,2,-2,3,2,0,-2,0,-2,-3,6,0,-2,2,2,4,5,0,0,2,1,3,3,0,0,0,1,1,2,0,0,23,13,10,7,4,3,14,3,-1,7,3,-4,9,3,-2,4,1,-2,5,0,1,3,2,-2,4,1,1,0,1,0,2,1,1,0,0,0,2,0,0,0,1,0,-16,-6,-10,6,4,2,-2,-1,-2,-6,0,-3,0,1,0,-5,-1,-1,-2,-2,-2,-1,1,-2,1,3,3,-1,0,0,1,1,2,0,0,0,0,2,1,-1,0,0,13,-1,14,5,2,3,-1,6,0,2,3,2,-3,3,-1,-1,1,-1,2,3,1,3,2,3,1,2,1,1,0,0,0,2,0,0,0,0,1,0,1,1,0,0,-10,-8,-2,8,4,4,3,0,-8,0,-2,-2,-1,0,-4,-1,0,-1,4,0,-4,1,-2,-1,0,3,1,4,0,0,0,2,0,2,0,0,0,1,1,2,0,0,-28,-12,-16,3,2,1,-5,-1,-4,-12,0,-6,-3,0,0,-8,1,-2,-2,-1,-4,-4,-1,-4,0,0,3,0,0,0,0,0,2,0,0,0,0,0,1,0,0,0,-18,-4,-14,4,4,0,-3,-3,-3,-4,3,-8,-2,1,-1,0,1,-3,-1,-4,-2,-4,2,-5,0,2,0,1,1,0,0,1,1,1,1,0,0,1,-1,0,0,0
13,13044,Fuente el Fresno,3460,-4,-3,-1,3,2,1,-6,1,0,-3,5,-1,-5,-1,3,-2,2,0,-1,2,-3,-1,3,-1,0,1,0,1,1,0,0,0,0,1,1,0,0,1,0,0,0,0,10,12,-2,27,20,7,10,2,-7,8,2,-3,5,2,1,3,1,1,5,0,-8,5,1,-4,7,5,6,9,0,0,4,4,6,6,0,0,3,1,0,3,0,0,-12,5,-17,7,5,2,-5,3,-4,-2,-3,-1,-1,5,2,0,-1,1,-4,-2,-6,-2,-2,-2,0,3,2,1,1,0,0,3,1,0,1,0,0,0,1,1,0,0,-26,-10,-16,21,11,10,-10,0,-11,-6,4,-3,-7,-3,-2,-2,6,-2,-3,3,-9,-4,-2,-1,5,5,10,1,0,0,3,1,6,1,0,0,2,4,4,0,0,0,0,0,0,24,11,13,-10,-1,-2,0,14,-1,-3,-1,-2,-2,9,0,-7,0,0,2,5,-1,1,7,15,1,0,0,0,4,7,0,0,0,1,3,8,1,0,0,105,54,51,45,27,18,29,17,29,13,12,4,17,1,16,11,7,2,12,16,13,2,5,2,10,12,13,6,4,0,6,5,9,4,3,0,4,7,4,2,1,0,8,17,-9,45,33,12,-6,7,3,5,3,-3,-6,10,5,7,2,0,0,-3,-2,-2,1,-3,9,15,14,6,1,0,4,14,9,6,0,0,5,1,5,0,1,0,-6,2,-8,57,35,22,0,11,-11,-1,3,-9,-2,3,-4,1,5,-2,2,8,-7,-2,-2,-7,5,27,17,2,4,0,4,12,12,3,3,0,1,15,5,-1,1,0,71,53,18,83,47,36,5,32,11,14,4,4,5,21,12,8,3,3,0,11,-1,6,1,1,15,28,25,13,1,0,10,18,11,6,1,0,5,10,14,7,0,0,8,-3,11,61,28,33,7,0,5,-1,-2,-1,-2,-5,9,-4,-3,2,9,5,-4,3,1,-3,14,13,23,6,3,1,7,2,13,1,3,1,7,11,10,5,0,0,14,-2,16,22,7,15,9,4,-8,2,5,0,4,0,-12,1,3,0,5,4,4,1,2,0,3,5,7,4,1,0,1,-1,3,1,1,0,2,6,4,3,0,0,-16,-1,-15,-6,-2,-4,-1,6,-11,-3,-6,-1,-5,6,-1,2,-2,0,4,0,-10,-5,-4,-1,1,2,-8,1,-3,0,0,1,-4,3,-2,0,1,1,-4,-2,-1,0,-62,-37,-25,-13,-9,-4,-2,-8,-24,-15,-7,-5,-1,-5,-19,-4,-3,-4,-1,-3,-5,-11,-4,-1,4,-4,-6,-4,-3,0,0,-2,-3,-2,-2,0,4,-2,-3,-2,-1,0,-78,-41,-37,-33,-24,-9,-11,-16,-28,-17,-1,-4,-4,-8,-15,-8,-3,-3,-7,-8,-13,-9,2,-1,-3,-6,-12,-11,-1,0,0,-5,-10,-6,-3,0,-3,-1,-2,-5,2,0,-60,-22,-38,-21,-6,-15,-17,-10,-11,-21,0,1,-5,3,-5,-12,-2,0,-12,-13,-6,-9,2,1,-6,8,-5,-16,-2,0,-2,9,-1,-10,-2,0,-4,-1,-4,-6,0,0,-49,-32,-17,-9,-6,-3,-2,3,-24,-12,-3,-11,-5,3,-13,-8,-4,-6,3,0,-11,-4,1,-5,5,2,-2,-11,1,-3,2,2,0,-8,-1,-1,3,0,-2,-3,2,-2,-32,-18,-14,1,-7,8,-11,-9,-12,-5,6,0,0,-13,-3,-7,4,1,-11,4,-9,2,2,-1,6,-5,1,-1,0,0,4,-9,0,-1,-1,0,2,4,1,0,1,0,-45,-32,-13,-8,-10,2,-5,-16,-17,-8,-3,3,0,-12,-11,-8,-4,3,-5,-4,-6,0,1,0,2,-4,0,-7,0,0,2,-5,0,-6,-1,0,0,1,0,-1,1,0
13,13045,Granátula de Calatrava,1005,22,7,15,6,5,1,3,0,11,-4,3,9,2,0,4,-2,0,3,1,0,7,-2,3,6,0,1,5,0,0,0,0,1,4,0,0,0,0,0,1,0,0,0,10,8,2,10,8,2,1,4,5,3,1,-4,2,4,2,3,1,-4,-1,0,3,0,0,0,5,3,1,1,0,0,4,3,0,1,0,0,1,0,1,0,0,0,21,24,-3,21,17,4,5,12,1,6,7,-10,0,12,2,5,6,-1,5,0,-1,1,1,-9,1,12,5,1,2,0,0,12,3,1,1,0,1,0,2,0,1,0,5,6,-1,14,12,2,-3,7,-2,1,-1,2,0,3,-1,4,-1,0,-3,4,-1,-3,0,2,0,6,2,5,0,0,0,4,2,5,0,0,0,2,0,0,0,0,16,11,5,4,3,1,-2,1,-2,0,7,12,0,4,1,-2,5,3,-2,-3,-3,2,2,9,0,2,2,0,0,0,0,1,2,0,0,0,0,1,0,0,0,0,14,3,11,12,5,7,0,-2,-1,3,4,11,0,-1,-1,-1,2,5,0,-1,0,4,2,6,3,3,5,1,0,0,0,2,3,0,0,0,3,1,2,1,0,0,-10,-5,-5,10,7,3,0,-7,-5,-1,-1,4,1,-3,-3,-1,-1,2,-1,-4,-2,0,0,2,4,3,3,0,0,0,3,1,3,0,0,0,1,2,0,0,0,0,-13,-6,-7,1,-1,2,-5,0,-3,-5,3,-2,-4,-1,0,-4,2,2,-1,1,-3,-1,1,-4,1,-1,0,0,0,0,0,-1,-1,0,0,0,1,0,1,0,0,0,-10,-3,-7,-1,0,-1,-4,-3,0,-2,3,-4,-2,-2,1,0,2,-2,-2,-1,-1,-2,1,-2,0,0,-1,0,0,0,0,0,0,0,0,0,0,0,-1,0,0,0,-10,-3,-7,-4,-4,0,6,-7,-2,2,-6,-1,2,-2,0,1,-2,0,4,-5,-2,1,-4,-1,1,-1,-2,1,-3,0,-1,1,-3,0,-1,0,2,-2,1,1,-2,0,-21,-12,-9,0,-2,2,-7,1,-9,0,-1,-5,-5,3,-7,0,-1,-2,-2,-2,-2,0,0,-3,2,0,-2,0,0,0,1,0,-3,0,0,0,1,0,1,0,0,0,-17,-8,-9,5,3,2,-2,1,0,-8,0,-8,0,-1,3,-5,0,-5,-2,2,-3,-3,0,-3,2,2,1,0,0,0,1,1,1,0,0,0,1,1,0,0,0,0,10,4,6,3,1,2,9,3,4,-4,3,-5,3,1,3,-4,4,-3,6,2,1,0,-1,-2,2,0,0,1,0,0,0,0,0,1,0,0,2,0,0,0,0,0,-19,-8,-11,0,1,-1,-5,-3,-5,-1,0,-5,-4,-2,-3,1,2,-2,-1,-1,-2,-2,-2,-3,0,1,0,0,-1,0,0,1,0,0,0,0,0,0,0,0,-1,0,5,1,4,-5,-3,-2,1,1,4,0,0,-1,0,0,3,-1,0,-1,1,1,1,1,0,0,-2,0,-1,-3,0,1,0,0,-1,-2,0,0,-2,0,0,-1,0,1,-17,-4,-13,-7,-2,-5,-5,-2,-3,-9,5,-3,1,1,-3,-4,3,-2,-6,-3,0,-5,2,-1,-4,-1,-1,-1,0,0,0,0,0,-2,0,0,-4,-1,-1,1,0,0,-20,-6,-14,0,0,0,-3,-1,-9,1,-2,-5,-1,1,-4,1,-2,-1,-2,-2,-5,0,0,-4,0,0,-1,1,0,0,0,0,0,0,0,0,0,0,-1,1,0,0,-17,-11,-6,-2,-2,0,0,-1,-3,-10,0,-3,-1,1,-1,-9,1,-2,1,-2,-2,-1,-1,-1,1,2,-1,-4,0,0,0,1,0,-3,0,0,1,1,-1,-1,0,0
13,13047,Herencia,7041,68,41,27,66,43,23,17,6,12,21,10,3,5,2,14,14,4,3,12,4,-2,7,6,0,20,12,15,17,2,0,11,10,9,12,1,0,9,2,6,5,1,0,53,53,0,87,60,27,7,11,19,12,4,0,5,21,15,9,3,0,2,-10,4,3,1,0,8,28,30,19,2,0,4,24,17,13,2,0,4,4,13,6,0,0,232,145,87,248,158,90,19,90,67,37,13,3,11,55,44,26,5,3,8,35,23,11,8,0,22,93,85,41,4,1,12,61,53,30,2,0,10,32,32,11,2,1,164,111,53,244,149,95,24,67,43,35,-2,0,12,41,36,22,0,1,12,26,7,13,-2,-1,32,86,70,50,6,0,14,53,47,33,2,0,18,33,23,17,4,0,287,163,124,241,137,104,42,97,91,35,11,4,18,56,57,20,7,2,24,41,34,15,4,2,33,86,88,30,0,0,16,47,55,17,0,0,17,39,33,13,0,0,354,197,157,313,173,140,74,108,82,42,35,6,39,58,46,25,20,4,35,50,36,17,15,2,67,115,78,43,7,1,38,63,40,26,4,0,29,52,38,17,3,1,294,167,127,283,162,121,47,67,72,49,33,21,31,33,41,34,15,11,16,34,31,15,18,10,42,88,93,45,11,2,22,43,61,29,6,0,20,45,32,16,5,2,396,237,159,398,241,157,47,138,82,89,21,9,24,83,61,49,12,2,23,55,21,40,9,7,57,142,104,79,13,0,33,84,68,45,9,0,24,58,36,34,4,0,145,57,88,92,41,51,29,28,42,17,18,8,8,10,13,6,11,7,21,18,29,11,7,1,19,26,24,16,4,0,6,10,13,9,2,0,13,16,11,7,2,0,91,43,48,78,28,50,14,16,24,3,22,9,5,4,12,2,9,10,9,12,12,1,13,-1,12,26,22,7,8,1,3,7,11,2,4,1,9,19,11,5,4,0,-280,-161,-119,-271,-164,-107,-36,-65,-82,-86,-18,0,-24,-41,-39,-53,-9,1,-12,-24,-43,-33,-9,-1,-34,-50,-82,-76,-29,-1,-21,-36,-46,-46,-15,-1,-13,-14,-36,-30,-14,0,108,48,60,90,38,52,44,14,21,14,11,5,21,4,8,9,6,1,23,10,13,5,5,4,23,20,19,16,9,1,10,8,7,9,4,0,13,12,12,7,5,1,5,-2,7,11,0,11,-3,0,-16,11,0,10,11,0,-15,1,-1,1,-14,0,-1,10,1,9,-4,4,9,3,-1,-2,0,1,0,1,-2,0,-4,3,9,2,1,-2,-169,-107,-62,-136,-106,-30,-17,-21,-54,-66,-16,0,-7,-13,-38,-42,-12,2,-10,-8,-16,-24,-4,-2,-11,-9,-50,-56,-10,-2,-9,-7,-42,-41,-9,0,-2,-2,-8,-15,-1,-2,-98,-68,-30,-85,-60,-25,-3,16,-55,-49,-16,4,-4,10,-30,-32,-11,-4,1,6,-25,-17,-5,8,-2,7,-43,-35,-14,-1,1,1,-27,-26,-11,0,-3,6,-16,-9,-3,-1,-57,-18,-39,-45,-26,-19,-17,11,-41,-17,-6,10,-4,16,-29,-6,-5,9,-13,-5,-12,-11,-1,1,-5,11,-32,-15,-9,3,-2,9,-21,-9,-6,2,-3,2,-11,-6,-3,1,-151,-71,-80,-74,-39,-35,-17,-7,-58,-44,-21,-1,-10,4,-22,-35,-8,3,-7,-11,-36,-9,-13,-4,-10,9,-38,-19,-14,-2,-6,5,-15,-16,-6,-1,-4,4,-23,-3,-8,-1,-28,-10,-18,-25,-10,-15,3,-4,-22,-16,8,6,5,-3,-19,-2,2,8,-2,-1,-3,-14,6,-2,4,-4,-10,-16,-1,-1,3,-2,-7,-4,-2,0,1,-2,-3,-12,1,-1
13,13052,Malagón,8059,31,21,10,25,12,13,3,6,-4,7,16,1,-1,0,5,3,8,4,4,6,-9,4,8,-3,3,8,7,7,0,0,2,6,1,3,0,0,1,2,6,4,0,0,22,3,19,51,28,23,-4,6,1,-1,14,6,-9,8,0,-2,6,1,5,-2,1,1,8,5,7,14,20,9,0,0,3,8,12,5,0,0,4,6,8,4,0,0,68,55,13,150,89,61,14,21,7,25,3,-6,6,26,2,19,-1,1,8,-5,5,6,4,-7,16,49,48,31,2,1,9,34,25,19,1,0,7,15,23,12,1,1,16,13,3,82,44,38,0,-3,10,0,7,-1,-2,-2,9,1,3,1,2,-1,1,-1,4,-2,13,20,28,16,2,1,6,8,16,10,1,1,7,12,12,6,1,0,79,40,39,130,65,65,12,34,34,-5,4,-4,3,14,20,2,1,-2,9,20,14,-7,3,-2,19,42,48,17,2,0,7,20,24,12,0,0,12,22,24,5,2,0,62,36,26,98,54,44,14,27,6,-6,24,-6,2,18,4,-3,13,0,12,9,2,-3,11,-6,13,36,25,18,5,0,9,20,12,9,3,0,4,16,13,9,2,0,34,17,17,96,45,51,21,-3,2,20,7,-11,16,3,-2,6,0,-3,5,-6,4,14,7,-8,15,28,34,20,0,-1,5,10,22,8,0,0,10,18,12,12,0,-1,362,196,166,256,134,122,60,99,107,55,27,8,32,44,61,38,18,0,28,55,46,17,9,8,45,83,64,48,11,2,18,39,40,30,6,0,27,44,24,18,5,2,101,51,50,32,17,15,36,15,26,12,13,-3,23,6,4,10,10,0,13,9,22,2,3,-3,9,6,10,4,1,0,7,5,4,0,0,0,2,1,6,4,1,0,49,21,28,20,1,19,17,7,0,0,14,5,16,-5,-2,0,4,2,1,12,2,0,10,3,7,6,8,-1,0,1,3,-1,-2,2,0,0,4,7,10,-3,0,1,7,-15,22,31,5,26,-2,12,8,-9,3,-7,-8,1,6,-13,1,-1,6,11,2,4,2,-6,6,12,5,-1,4,2,1,4,2,-3,0,1,5,8,3,2,4,1,54,30,24,18,8,10,28,-1,0,11,17,-7,16,-2,4,2,9,-2,12,1,-4,9,8,-5,14,0,-1,3,0,1,9,-2,1,-1,1,0,5,2,-2,4,-1,1,-9,-13,4,-55,-44,-11,3,-5,-16,5,2,-4,0,-1,-13,3,-3,0,3,-4,-3,2,5,-4,-10,-8,-24,-15,0,1,-7,-5,-21,-9,-2,0,-3,-3,-3,-6,2,1,-113,-46,-67,-110,-63,-47,-18,-9,-40,-42,8,-10,-3,-8,-14,-28,6,1,-15,-1,-26,-14,2,-11,-14,-15,-34,-37,-9,-1,-6,-8,-21,-20,-7,-1,-8,-7,-13,-17,-2,0,-105,-45,-60,-1,2,-3,-28,-7,-52,-13,-1,-4,-11,0,-28,-10,1,2,-17,-7,-24,-3,-2,-6,-5,12,-10,0,1,0,-2,8,-4,-1,0,0,-3,4,-6,1,1,0,-84,-42,-42,-13,-5,-8,-7,-14,-32,-28,-3,1,-2,-12,-22,-14,-1,8,-5,-2,-10,-14,-2,-7,4,2,-9,-8,-2,0,2,-3,-3,0,-1,0,2,5,-6,-8,-1,0,-30,-20,-10,3,-2,5,6,-12,-18,-9,9,-6,0,-1,-10,-13,8,-4,6,-11,-8,4,1,-2,5,5,-8,1,-1,-1,2,-1,-3,-1,0,-1,3,6,-5,2,-1,0,-23,-3,-20,-15,-4,-11,-4,8,-4,-23,-2,0,-3,2,-2,-9,1,5,-1,6,-2,-14,-3,-5,-2,8,0,-9,-8,-4,1,3,-1,-3,-2,-2,-3,5,1,-6,-6,-2
13,13053,Manzanares,18222,86,37,49,121,54,67,29,9,28,12,11,-5,5,5,4,13,8,2,24,4,24,-1,3,-7,16,26,46,23,7,2,7,10,21,11,3,1,9,16,25,12,4,1,110,71,39,141,77,64,21,27,51,23,-6,-5,12,12,33,18,-7,3,9,15,18,5,1,-8,32,40,45,17,4,2,19,21,23,12,1,1,13,19,22,5,3,1,155,86,69,103,52,51,33,32,37,35,9,14,17,17,26,23,4,4,16,15,11,12,5,10,19,24,32,21,6,1,9,13,16,11,3,0,10,11,16,10,3,1,107,57,50,91,50,41,33,43,25,-1,-3,6,16,24,26,-7,-3,-1,17,19,-1,6,0,7,7,34,28,9,11,1,5,18,14,6,6,1,2,16,14,3,5,0,95,61,34,125,66,59,-6,34,32,16,22,-2,6,21,18,4,10,4,-12,13,14,12,12,-6,19,35,41,18,10,1,9,20,24,10,3,0,10,15,17,8,7,1,208,117,91,186,107,79,43,57,55,27,11,13,18,36,30,20,5,5,25,21,25,7,6,8,28,52,63,35,7,0,17,34,33,21,2,0,11,18,30,14,5,0,208,84,124,174,90,84,43,48,62,13,23,13,13,19,35,-5,12,7,30,29,27,18,11,6,38,58,44,24,6,2,18,40,20,8,3,1,20,18,24,16,3,1,174,86,88,203,100,103,32,91,30,-13,6,20,27,53,-1,-11,2,8,5,38,31,-2,4,12,54,64,52,19,10,3,35,34,17,8,5,1,19,30,35,11,5,2,127,70,57,85,49,36,18,30,44,5,20,5,8,9,35,3,14,0,10,21,9,2,6,5,14,24,29,13,4,1,10,14,17,7,1,0,4,10,12,6,3,1,20,-2,22,67,23,44,18,29,-38,18,-12,2,-3,26,-25,4,-9,5,21,3,-13,14,-3,-3,30,25,1,9,0,2,13,9,-2,1,0,2,17,16,3,8,0,0,-33,-29,-4,-54,-41,-13,17,-4,-10,-28,-27,17,11,8,-20,-18,-14,4,6,-12,10,-10,-13,13,-4,3,-26,-23,-7,3,-4,0,-21,-12,-4,0,0,3,-5,-11,-3,3,-26,2,-28,48,22,26,-18,12,2,-11,-1,-12,0,9,0,-1,-1,-5,-18,3,2,-10,0,-7,15,15,1,13,2,1,10,8,-6,10,1,-1,5,7,7,3,1,2,-111,-52,-59,34,22,12,-10,-17,-71,-4,15,-26,-5,-8,-30,4,3,-16,-5,-9,-41,-8,12,-10,14,13,6,0,0,-1,9,8,6,-1,-1,0,5,5,0,1,1,-1,-235,-107,-128,-99,-54,-45,-51,-11,-91,-40,-15,-23,-11,-5,-46,-27,-7,-8,-40,-6,-45,-13,-8,-15,-30,-8,-28,-21,-4,-9,-10,-9,-20,-13,0,-3,-20,1,-8,-8,-4,-6,-252,-161,-91,-95,-52,-43,-28,-32,-93,-66,-26,-10,-25,-20,-54,-41,-12,-9,-3,-12,-39,-25,-14,-1,-7,-12,-46,-26,-7,1,-2,-6,-25,-14,-5,-1,-5,-6,-21,-12,-2,2,-125,-64,-61,-1,-5,4,3,-15,-67,-21,-32,10,1,6,-34,-20,-20,5,2,-21,-33,-1,-12,5,11,3,-11,4,-11,3,5,1,-4,2,-10,1,6,2,-7,2,-1,2,-194,-124,-70,-39,-27,-12,-19,-19,-81,-47,-10,-16,-11,-9,-58,-26,-7,-10,-8,-10,-23,-21,-3,-6,-10,11,-19,-17,-2,-2,-6,3,-8,-14,-1,-1,-4,8,-11,-3,-1,-1,-157,-74,-83,5,-1,6,-33,-22,-56,-39,-13,-1,-17,-7,-33,-14,-10,0,-16,-15,-23,-25,-3,-1,-5,13,-2,-7,-1,4,-1,11,-3,-8,-3,1,-4,2,1,1,2,3
13,13057,Montiel,1721,3,-2,5,3,1,2,-1,-2,0,3,0,3,-1,-1,-2,-1,-1,4,0,-1,2,4,1,-1,0,0,1,0,1,1,0,0,0,0,0,1,0,0,1,0,1,0,6,6,0,16,13,3,-2,4,-3,0,3,4,-1,5,0,-2,2,2,-1,-1,-3,2,1,2,0,10,5,0,1,0,0,8,4,0,1,0,0,2,1,0,0,0,24,21,3,25,16,9,5,8,6,6,-1,-1,1,9,5,5,0,0,4,-1,1,1,-1,-1,3,11,5,5,1,0,1,8,4,2,1,0,2,3,1,3,0,0,8,5,3,11,7,4,7,0,0,-3,1,3,5,-1,4,-5,1,1,2,1,-4,2,0,2,0,5,3,3,0,0,0,4,3,0,0,0,0,1,0,3,0,0,18,18,0,44,30,14,-2,15,5,2,-1,-2,-3,10,8,4,-2,1,1,5,-3,-2,1,-3,3,21,14,5,1,0,3,14,10,3,0,0,0,7,4,2,1,0,8,3,5,22,10,12,-1,10,-4,0,3,1,1,3,-1,-2,3,-1,-2,7,-3,2,0,2,6,4,6,5,1,0,5,0,2,3,0,0,1,4,4,2,1,0,-2,-3,1,12,4,8,-3,0,-10,4,5,1,-2,-1,-5,-1,4,2,-1,1,-5,5,1,-1,-1,4,2,5,2,0,-2,1,3,0,2,0,1,3,-1,5,0,0,-8,-4,-4,33,20,13,1,2,-1,2,0,-11,-3,4,2,0,2,-8,4,-2,-3,2,-2,-3,5,12,10,5,1,0,1,7,8,3,1,0,4,5,2,2,0,0,-15,-8,-7,1,0,1,-1,-3,-11,0,-1,1,0,-2,-8,0,0,2,-1,-1,-3,0,-1,-1,0,0,0,0,1,0,0,0,0,0,0,0,0,0,0,0,1,0,1,11,-10,-4,0,-4,-1,2,-8,-1,6,1,0,2,-4,5,6,1,-1,0,-4,-6,0,0,1,0,-4,0,-1,0,0,-1,-1,2,0,0,1,1,-3,-2,-1,0,-13,-6,-7,6,4,2,0,-9,5,-5,0,-5,-2,-3,6,-2,-1,-4,2,-6,-1,-3,1,-1,1,1,0,3,1,0,1,1,0,2,0,0,0,0,0,1,1,0,-5,0,-5,-11,-6,-5,2,-4,-6,0,3,-1,3,1,-3,-4,1,1,-1,-5,-3,4,2,-2,-1,-1,-5,-1,-3,0,-1,-1,-2,-1,-1,0,0,0,-3,0,-2,0,-21,-10,-11,-10,-6,-4,0,-5,-12,4,-5,-2,0,-4,-5,1,-1,0,0,-1,-7,3,-4,-2,-1,0,-5,-2,-2,0,-1,0,-2,-2,-1,0,0,0,-3,0,-1,0,-12,-8,-4,-13,-11,-2,0,-1,-2,-7,5,-7,0,1,-2,-7,4,-4,0,-2,0,0,1,-3,0,-1,-5,-6,-1,0,0,0,-4,-6,-1,0,0,-1,-1,0,0,0,-15,-5,-10,-5,-2,-3,-4,-1,-3,-6,-4,2,-2,-2,2,-2,-4,2,-2,1,-5,-4,0,0,-1,0,-3,0,-1,0,0,0,-1,0,-1,0,-1,0,-2,0,0,0,-34,-12,-22,-8,-4,-4,-7,-3,-5,-12,-5,-3,-4,1,-4,-3,-4,1,-3,-4,-1,-9,-1,-4,-1,-1,-1,-5,0,0,0,0,0,-4,0,0,-1,-1,-1,-1,0,0,-26,-20,-6,3,1,2,-6,-7,-8,-4,-3,3,-4,-5,-4,-4,-2,0,-2,-2,-4,0,-1,3,0,1,0,2,0,0,0,1,0,0,0,0,0,0,0,2,0,0,-24,-9,-15,-10,-6,-4,2,-10,-15,-6,2,3,1,-3,-9,-4,3,3,1,-7,-6,-2,-1,0,-1,-1,-4,-4,0,0,-1,1,-3,-3,0,0,0,-2,-1,-1,0,0
13,13061,Pedro Muñoz,7192,-13,0,-13,32,21,11,-2,-4,-9,2,-1,-1,-1,3,-3,0,-1,1,-1,-7,-6,2,0,-2,3,10,10,7,1,1,2,7,7,4,1,0,1,3,3,3,0,1,104,79,25,123,90,33,9,42,47,6,-2,1,8,33,27,9,1,0,1,9,20,-3,-3,1,16,48,39,19,0,0,12,37,26,14,0,0,4,11,13,5,0,0,148,103,45,219,142,77,16,70,42,17,10,-7,9,45,28,18,5,-2,7,25,14,-1,5,-5,26,99,59,32,2,0,16,61,39,24,1,0,10,38,20,8,1,0,189,127,62,203,132,71,16,74,54,39,9,-4,8,45,40,26,8,0,8,29,14,13,1,-4,20,73,66,38,3,1,11,45,46,26,3,0,9,28,20,12,0,1,336,222,114,369,248,121,25,142,106,53,6,1,17,87,75,39,3,0,8,55,31,14,3,1,28,156,120,58,4,1,15,100,88,41,4,0,13,56,32,17,0,1,234,163,71,270,176,94,21,111,55,42,10,-5,8,72,50,26,6,-1,13,39,5,16,4,-4,20,123,77,43,6,0,8,84,55,25,3,0,12,39,22,18,3,0,125,63,62,207,108,99,32,32,41,10,8,-4,16,18,23,3,4,-2,16,14,18,7,4,-2,32,80,56,32,3,0,14,42,29,21,1,0,18,38,27,11,2,0,325,210,115,433,277,156,40,114,82,73,20,-8,15,73,54,49,17,-1,25,41,28,24,3,-7,47,161,127,74,18,0,21,105,86,51,12,0,26,56,41,23,6,0,23,11,12,44,30,14,4,20,-25,0,12,8,3,11,-14,0,6,3,1,9,-11,0,6,5,2,23,9,7,2,0,2,15,7,4,1,0,0,8,2,3,1,0,3,23,-20,47,28,19,3,6,-12,3,8,-4,9,8,-1,1,6,0,-6,-2,-11,2,2,-4,11,22,9,5,-1,1,9,10,5,3,0,1,2,12,4,2,-1,0,-57,-51,-6,46,20,26,-10,1,-14,-33,3,-3,-11,-4,-14,-14,-3,-4,1,5,0,-19,6,1,7,21,11,3,3,0,4,9,6,1,0,0,3,12,5,2,3,0,24,3,21,49,19,30,-1,17,7,1,7,-6,-3,-4,8,2,2,-1,2,21,-1,-1,5,-5,8,16,10,10,1,3,6,3,3,6,0,1,2,13,7,4,1,2,-35,-21,-14,50,26,24,7,-6,-21,-8,-1,-8,-2,-3,-12,-4,1,-3,9,-3,-9,-4,-2,-5,10,13,15,7,2,0,3,7,9,4,1,0,7,6,6,3,1,0,0,4,-4,30,14,16,-3,11,-8,3,8,-10,0,10,-4,4,1,-5,-3,1,-4,-1,7,-5,5,14,10,3,-2,-1,3,8,2,2,-1,0,2,6,8,1,-1,-1,12,-2,14,40,18,22,10,-2,9,-5,5,-9,9,-8,-1,2,-1,-5,1,6,10,-7,6,-4,4,13,12,10,1,0,1,4,6,6,1,0,3,9,6,4,0,0,-105,-47,-58,-28,-18,-10,-7,-19,-39,-20,-7,-10,-7,-2,-22,-13,6,-7,0,-17,-17,-7,-13,-3,-2,2,-10,-16,-1,-2,0,0,-8,-9,0,-1,-2,2,-2,-7,-1,-1,4,-6,10,31,12,19,2,3,-23,8,3,8,5,-5,-13,0,-1,6,-3,8,-10,8,4,2,8,9,6,4,3,1,4,2,2,2,1,1,4,7,4,2,2,0,15,-3,18,68,28,40,3,4,0,-6,4,4,3,3,-6,-4,-3,2,0,1,6,-2,7,2,11,11,20,17,5,0,5,6,8,7,1,0,6,5,12,10,4,0
13,13066,Pozuelo de Calatrava,2522,36,19,17,23,9,14,12,4,13,7,1,-1,6,4,5,4,0,0,6,0,8,3,1,-1,2,6,10,5,0,0,2,3,3,1,0,0,0,3,7,4,0,0,30,25,5,31,20,11,5,7,10,6,4,-3,4,5,10,5,3,-2,1,2,0,1,1,-1,8,5,14,3,0,0,5,4,10,1,0,0,3,1,4,2,0,0,23,22,1,21,15,6,0,8,12,6,-2,-1,1,5,7,9,-1,1,-1,3,5,-3,-1,-2,1,8,8,4,0,0,0,5,6,4,0,0,1,3,2,0,0,0,72,28,44,56,28,28,23,19,8,11,6,3,9,3,6,7,0,2,14,16,2,4,6,1,16,14,19,7,0,0,6,6,13,4,-1,0,10,8,6,3,1,0,23,28,-5,38,28,10,-2,10,13,4,0,-5,-1,12,15,3,1,-4,-1,-2,-2,1,-1,-1,2,16,13,6,0,0,2,14,9,2,0,0,0,2,4,4,0,0,25,5,20,28,16,12,8,8,6,-4,6,0,2,7,1,-10,4,1,6,1,5,6,2,-1,9,8,6,5,0,0,5,7,4,0,0,0,4,1,2,5,0,0,60,27,33,46,33,13,20,0,9,16,14,2,5,0,3,11,8,1,15,0,6,5,6,1,18,10,7,11,0,0,12,9,4,8,0,0,6,1,3,3,0,0,39,26,13,26,17,9,20,12,6,-2,1,2,11,4,8,1,-1,2,9,8,-2,-3,2,0,11,6,5,3,0,0,7,4,4,2,-1,0,4,2,1,1,1,0,44,31,13,24,12,12,12,1,16,11,4,-3,9,-2,17,6,3,-3,3,3,-1,5,1,0,12,0,5,4,0,1,6,0,2,3,0,0,6,0,3,1,0,1,100,57,43,23,9,14,6,15,51,20,4,0,4,7,27,15,3,0,2,8,24,5,1,0,9,0,5,7,2,0,5,-2,2,4,0,0,4,2,3,3,2,0,115,71,44,24,13,11,8,18,54,15,9,10,4,14,24,14,7,8,4,4,30,1,2,2,4,8,8,3,1,0,3,5,3,1,1,0,1,3,5,2,0,0,78,33,45,19,7,12,23,18,6,17,13,0,7,10,1,7,10,-2,16,8,5,10,3,2,9,3,2,5,-1,1,5,2,-1,2,-1,0,4,1,3,3,0,1,-25,-10,-15,12,5,7,-20,4,-7,4,-5,1,-6,0,-2,1,-5,2,-14,4,-5,3,0,-1,-1,5,5,1,0,1,0,1,3,0,0,1,-1,4,2,1,0,0,-7,-8,1,6,-1,7,3,6,2,-18,1,-1,2,6,0,-15,0,0,1,0,2,-3,1,-1,5,5,-1,-2,0,-1,1,3,-2,-2,0,-1,4,2,1,0,0,0,38,20,18,6,3,3,6,14,-6,8,11,3,-2,4,-1,5,6,5,8,10,-5,3,5,-2,1,1,1,2,1,0,0,0,1,1,1,0,1,1,0,1,0,0,12,9,3,15,7,8,-12,5,5,9,3,1,-9,8,-1,7,0,3,-3,-3,6,2,3,-2,2,3,4,3,2,0,1,1,3,1,0,0,1,2,1,2,2,0,29,25,4,16,11,5,11,6,7,6,-3,1,11,5,7,2,-1,0,0,1,0,4,-2,1,3,3,6,4,0,0,2,1,4,3,1,0,1,2,2,1,-1,0,59,33,26,11,8,3,19,12,9,5,14,1,11,12,1,3,7,0,8,0,8,2,7,1,-1,6,4,-1,3,0,0,6,2,-1,1,0,-1,0,2,0,2,0
13,13072,Retuerta del Bullaque,1049,5,-3,8,10,6,4,4,-5,9,-5,0,1,3,-5,3,-4,1,0,1,0,6,-1,-1,1,3,2,4,1,0,0,2,1,2,1,0,0,1,1,2,0,0,0,19,14,5,5,4,1,-2,7,2,6,6,1,0,4,3,2,5,1,-2,3,-1,4,1,0,1,2,2,0,0,0,1,2,1,0,0,0,0,0,1,0,0,0,12,9,3,17,14,3,-1,7,5,-1,1,2,1,3,3,0,2,1,-2,4,2,-1,-1,1,0,7,10,0,0,0,0,5,9,0,0,0,0,2,1,0,0,0,10,6,4,13,6,7,-4,1,8,-1,3,1,-2,-1,3,2,3,-1,-2,2,5,-3,0,2,0,2,7,1,1,0,0,0,3,0,1,0,0,2,4,1,0,0,34,20,14,44,28,16,5,16,-2,15,4,-4,1,10,-1,10,2,-1,4,6,-1,5,2,-3,4,18,12,10,0,0,1,9,9,9,0,0,3,9,3,1,0,0,37,25,12,35,24,11,7,15,11,-1,6,-1,8,9,5,1,3,-1,-1,6,6,-2,3,0,5,17,7,4,2,0,3,11,5,4,1,0,2,6,2,0,1,0,29,23,6,82,55,27,4,7,5,13,-4,1,-2,6,7,10,-2,1,6,1,-2,3,-2,0,12,24,31,12,1,0,5,15,23,9,1,0,7,9,8,3,0,0,13,13,0,66,47,19,-14,11,5,3,6,2,-5,10,3,0,4,1,-9,1,2,3,2,1,6,27,17,13,2,0,4,18,12,10,2,0,2,9,5,3,0,0,25,26,-1,30,22,8,4,5,11,1,2,0,6,3,9,4,2,2,-2,2,2,-3,0,-2,5,10,16,-2,1,0,4,7,12,-2,1,0,1,3,4,0,0,0,10,0,10,19,12,7,8,4,-5,3,0,-2,4,0,-4,-1,0,0,4,4,-1,4,0,-2,4,7,1,6,1,0,3,3,2,4,0,0,1,4,-1,2,1,0,-28,-27,-1,12,0,12,-9,1,-22,4,-1,-2,-5,0,-19,0,-2,-1,-4,1,-3,4,1,-1,5,4,2,0,0,0,3,2,-1,-4,0,0,2,2,3,4,0,0,-29,-13,-16,7,5,2,-2,-4,0,-17,-4,0,0,-2,1,-7,-3,-1,-2,-2,-1,-10,-1,1,2,2,4,-1,0,0,1,0,4,0,0,0,1,2,0,-1,0,0,-32,-20,-12,-18,-12,-6,-7,-5,-6,-12,1,-3,-5,-2,-3,-8,0,-2,-2,-3,-3,-4,1,-1,-2,-4,-7,-4,-1,0,-2,-2,-6,-1,-1,0,0,-2,-1,-3,0,0,-36,-17,-19,-16,-9,-7,4,-1,-16,-15,-10,2,5,0,-10,-7,-6,1,-1,-1,-6,-8,-4,1,0,-1,-6,-9,-1,1,0,-1,-5,-4,0,1,0,0,-1,-5,-1,0,-14,-8,-6,2,-1,3,-8,1,-2,-1,-1,-4,-4,1,-2,-2,0,-2,-4,0,0,1,-1,-2,0,0,0,2,-1,0,0,0,-1,0,-1,0,0,0,1,2,0,0,-7,-10,3,-5,-4,-1,-1,0,-3,4,-2,-5,-5,1,-4,2,0,-3,4,-1,1,2,-2,-2,0,0,1,-4,-2,0,0,0,1,-3,-2,0,0,0,0,-1,0,0,-5,-3,-2,4,1,3,0,5,2,-2,-3,-8,2,2,2,-3,-2,-5,-2,3,0,1,-1,-3,0,1,1,2,0,0,0,0,0,1,0,0,0,1,1,1,0,0,5,8,-3,8,7,1,-2,-3,0,7,3,0,-1,0,1,6,1,1,-1,-3,-1,1,2,-1,0,2,3,2,1,0,0,1,3,2,1,0,0,1,0,0,0,0
13,13078,Socuéllamos,11228,176,146,30,223,170,53,5,55,75,46,2,-9,1,39,69,36,4,-4,4,16,6,10,-2,-5,15,62,89,54,1,2,9,41,75,43,1,1,6,21,14,11,0,1,210,148,62,280,186,94,26,72,87,25,1,-4,9,53,60,24,1,0,17,19,27,1,0,-4,31,92,90,54,11,0,13,58,69,40,5,0,18,34,21,14,6,0,363,228,135,426,273,153,46,133,121,47,3,9,26,87,73,33,1,5,20,46,48,14,2,4,61,135,152,69,6,1,31,94,99,43,3,1,30,41,53,26,3,0,124,85,39,319,194,125,33,41,43,8,2,-4,16,32,35,2,1,-1,17,9,8,6,1,-3,51,110,109,40,6,1,24,68,76,22,3,0,27,42,33,18,3,1,274,157,117,431,272,159,26,106,84,34,13,9,7,63,47,26,10,4,19,43,37,8,3,5,37,171,145,62,12,1,16,105,97,45,7,0,21,66,48,17,5,1,130,40,90,262,146,116,33,40,36,24,-7,4,4,13,20,14,-7,-2,29,27,16,10,0,6,33,96,96,29,3,2,17,44,63,21,1,0,16,52,33,8,2,2,121,110,11,434,270,164,-10,78,42,13,12,-13,-2,62,27,21,6,-4,-8,16,15,-8,6,-9,40,159,156,67,9,1,18,96,105,47,4,0,22,63,51,20,5,1,263,184,79,491,317,174,35,126,41,59,12,-15,27,76,49,28,10,-9,8,50,-8,31,2,-6,46,182,147,88,26,0,28,115,104,51,18,0,18,67,43,37,8,0,29,19,10,97,45,52,22,29,-18,-4,-5,7,11,24,-17,-2,-3,8,11,5,-1,-2,-2,-1,21,53,8,7,7,1,11,29,1,1,2,1,10,24,7,6,5,0,23,15,8,54,19,35,13,33,-36,-8,10,10,12,22,-26,-6,8,6,1,11,-10,-2,2,4,15,39,-6,-2,6,2,6,23,-8,-6,3,1,9,16,2,4,3,1,84,41,43,88,31,57,40,32,-8,22,2,-12,25,4,1,12,4,-6,15,28,-9,10,-2,-6,27,30,13,17,0,-1,17,3,5,8,0,-2,10,27,8,9,0,1,100,69,31,135,73,62,27,44,-10,40,-7,6,16,30,1,29,-8,2,11,14,-11,11,1,4,22,34,42,28,4,3,11,19,29,17,-5,1,11,15,13,11,9,2,-43,-29,-14,25,1,24,-21,4,-19,4,-1,-14,-2,-2,-19,1,-2,-7,-19,6,0,3,1,-7,7,21,-11,6,1,0,2,9,-11,0,0,0,5,12,0,6,1,0,-171,-113,-58,-94,-67,-27,-12,-25,-73,-50,-17,5,-12,-14,-43,-33,-10,-1,0,-11,-30,-17,-7,6,-8,-4,-35,-40,-8,1,-7,-8,-24,-23,-6,1,-1,4,-11,-17,-2,0,21,23,-2,60,30,30,15,4,4,-9,5,-2,13,4,4,-8,3,3,2,0,0,-1,2,-5,10,18,22,6,2,1,6,7,14,0,1,1,4,11,8,6,1,0,-51,-15,-36,48,30,18,-24,4,-38,-6,21,-9,-8,6,-23,-2,13,-4,-16,-2,-15,-4,8,-5,2,18,11,7,6,2,3,7,9,8,2,0,-1,11,2,-1,4,2,-150,-88,-62,-42,-34,-8,-3,-30,-55,-45,-9,-16,-9,-16,-21,-33,-6,-7,6,-14,-34,-12,-3,-9,4,-1,-7,-29,-9,-2,2,-2,-1,-25,-8,0,2,1,-6,-4,-1,-2,-461,-295,-166,-420,-265,-155,-52,-55,-174,-141,-38,-4,-38,-30,-116,-93,-20,0,-14,-25,-58,-48,-18,-4,-56,-38,-153,-122,-41,-12,-39,-27,-98,-79,-20,-3,-17,-11,-55,-43,-21,-9
13,13079,"Solana, La",14960,49,33,16,66,42,24,18,15,8,13,0,-4,10,8,9,8,0,-2,8,7,-1,5,0,-2,13,17,25,10,0,1,6,9,18,8,0,1,7,8,7,2,0,0,178,102,76,147,92,55,14,32,68,16,14,33,6,22,45,16,6,7,8,10,23,0,8,26,21,34,72,17,2,0,12,18,49,12,1,0,9,16,23,5,1,0,5,-1,6,68,38,30,3,16,-14,0,7,-6,-2,12,-8,-3,0,-1,5,4,-6,3,7,-5,14,27,23,2,2,0,6,19,14,-2,1,0,8,8,9,4,1,0,-45,-4,-41,21,8,13,-2,-26,-25,-10,13,5,-1,-6,-3,-6,7,5,-1,-20,-22,-4,6,0,1,4,15,0,1,0,0,0,8,0,0,0,1,4,7,0,1,0,211,138,73,203,127,76,46,58,49,41,12,1,26,40,33,28,9,-1,20,18,16,13,3,2,35,57,66,40,3,1,16,45,37,26,2,0,19,12,29,14,1,1,185,99,86,234,129,105,30,72,30,39,11,-5,15,37,13,25,7,0,15,35,17,14,4,-5,29,79,73,42,8,0,13,47,39,27,3,0,16,32,34,15,5,0,143,67,76,139,75,64,47,46,50,-6,6,1,22,25,29,-10,1,1,25,21,21,4,5,0,32,53,46,9,-3,0,17,28,27,5,-2,0,15,25,19,4,-1,0,331,222,109,324,205,119,25,127,108,56,6,3,8,92,70,40,6,4,17,35,38,16,0,-1,38,114,111,48,10,2,19,77,68,34,5,1,19,37,43,14,5,1,115,119,-4,139,102,37,18,45,21,17,15,1,24,47,19,15,12,4,-6,-2,2,2,3,-3,17,65,30,22,4,0,16,49,23,10,4,0,1,16,7,12,0,0,-209,-159,-50,-152,-116,-36,-23,-37,-97,-55,1,4,-16,-33,-61,-47,0,1,-7,-4,-36,-8,1,3,-4,-31,-60,-51,-7,-1,-2,-29,-40,-39,-6,-1,-2,-2,-20,-12,-1,0,-97,-82,-15,-72,-64,-8,-14,-5,-70,-14,0,5,-4,-11,-57,-11,-3,2,-10,6,-13,-3,3,3,-5,-4,-47,-15,-2,1,-4,-7,-36,-13,-4,0,-1,3,-11,-2,2,1,-40,-31,-9,-28,-26,-2,-1,4,-35,-8,-11,10,-5,4,-14,-11,-11,6,4,0,-21,3,0,4,-1,7,-20,-10,-6,0,-3,4,-14,-11,-3,0,2,3,-6,1,-3,0,-77,-35,-42,-52,-34,-18,-5,-19,-43,-20,0,12,-2,-8,-21,-8,-2,7,-3,-11,-22,-12,2,5,-3,-15,-15,-17,-3,0,0,-9,-9,-13,-3,0,-3,-6,-6,-4,0,0,-53,-44,-9,-58,-39,-19,-18,-19,-24,-6,-6,19,-12,-14,-22,3,-3,4,-6,-5,-2,-9,-3,15,-12,-15,-23,-8,-1,0,-8,-12,-17,-2,0,0,-4,-3,-6,-6,-1,0,-62,-55,-7,-38,-34,-4,16,-10,-68,-12,-4,15,12,-10,-44,-17,-5,8,4,0,-24,5,1,7,1,2,-26,-11,-4,0,2,-3,-19,-10,-4,0,-1,5,-7,-1,0,0,-120,-38,-82,-23,-1,-22,-17,-22,-50,-23,-2,-6,-10,-6,-9,-9,-1,-3,-7,-16,-41,-14,-1,-3,1,5,-17,-8,-3,-2,4,6,-9,-1,-1,0,-3,-1,-8,-7,-2,-2,-150,-99,-51,-66,-40,-26,-21,-25,-62,-39,-9,7,-12,-17,-37,-27,-6,3,-9,-8,-25,-12,-3,4,-7,-5,-28,-18,-8,-1,0,-1,-18,-16,-4,-1,-7,-4,-10,-2,-4,0,-83,-40,-43,-16,-20,4,-19,-17,-34,-28,0,17,-5,-4,-15,-17,-1,3,-14,-13,-19,-11,1,14,-4,4,-2,-14,-4,3,-4,0,-3,-10,-5,2,0,4,1,-4,1,1
13,13082,Tomelloso,29255,326,195,131,323,192,131,45,85,108,77,6,0,24,56,63,41,4,2,21,29,45,36,2,-2,27,88,129,70,5,0,13,57,74,42,2,0,14,31,55,28,3,0,620,383,237,638,382,256,66,155,251,105,29,8,32,91,170,69,14,4,34,64,81,36,15,4,73,179,258,114,10,1,41,101,165,70,3,1,32,78,93,44,7,0,589,358,231,692,402,290,96,189,215,66,25,-3,43,122,135,42,15,2,53,67,80,24,10,-5,112,223,226,104,21,3,53,136,140,59,13,1,59,87,86,45,8,2,713,408,305,686,379,307,90,250,214,112,19,24,50,132,129,72,9,12,40,118,85,40,10,12,76,266,228,95,14,5,39,146,130,54,6,2,37,120,98,41,8,3,393,266,127,554,336,218,4,171,157,41,15,3,11,100,118,24,9,1,-7,71,39,17,6,2,52,194,213,72,14,2,29,111,140,41,9,1,23,83,73,31,5,1,1156,667,489,1052,612,440,187,374,349,186,38,17,92,217,228,104,19,10,95,157,121,82,19,7,157,361,327,167,31,3,81,217,199,94,16,3,76,144,128,73,15,0,1278,744,534,1005,549,456,198,350,448,198,60,4,112,200,261,125,30,4,86,150,187,73,30,0,136,312,343,166,35,0,77,165,195,94,16,-1,59,147,148,72,19,1,1663,974,689,1575,948,627,252,570,461,292,84,2,113,332,307,171,48,4,139,238,154,121,36,-2,197,569,467,273,55,6,91,338,316,163,32,4,106,231,151,110,23,2,398,220,178,443,225,218,55,122,117,29,54,22,27,83,52,16,31,12,28,39,65,13,23,10,78,141,133,60,27,1,44,73,61,29,16,0,34,68,72,31,11,1,430,200,230,388,158,230,102,95,112,67,33,18,52,27,54,40,10,17,50,68,58,27,23,1,88,116,90,55,29,4,44,39,31,26,12,3,44,77,59,29,17,1,137,45,92,185,55,130,9,49,-22,24,34,35,23,17,-25,-11,16,17,-14,32,3,35,18,18,37,66,20,25,20,9,22,24,-7,-1,10,3,15,42,27,26,10,6,48,-22,70,139,45,94,10,46,-23,-6,1,8,-7,11,-20,-10,-8,6,17,35,-3,4,9,2,22,76,18,9,8,2,5,31,15,-7,-1,1,17,45,3,16,9,1,-236,-133,-103,-79,-73,-6,-12,-7,-97,-96,-12,-6,-15,0,-38,-61,-12,-4,3,-7,-59,-35,0,-2,7,16,-35,-50,-19,0,7,-3,-29,-36,-14,1,0,19,-6,-14,-5,-1,-134,-101,-33,-96,-73,-23,6,-30,-54,-50,-10,-2,3,-15,-41,-42,-10,0,3,-15,-13,-8,0,-2,14,-8,-45,-43,-17,0,9,-6,-31,-33,-12,-1,5,-2,-14,-10,-5,1,-199,-104,-95,-111,-95,-16,-20,28,-132,-50,-22,2,-5,23,-65,-34,-22,-2,-15,5,-67,-16,0,4,-11,40,-69,-55,-23,3,-6,26,-41,-49,-28,1,-5,14,-28,-6,5,2,-1138,-757,-381,-876,-582,-294,-114,-80,-410,-375,-149,-12,-78,-56,-266,-262,-88,-5,-36,-24,-144,-113,-61,-7,-31,-32,-354,-308,-131,-23,-19,-19,-230,-218,-85,-12,-12,-13,-124,-90,-46,-11,70,46,24,133,58,75,39,-1,4,-10,7,27,41,-3,17,-20,-3,10,-2,2,-13,10,10,17,34,33,31,14,12,2,19,14,19,2,1,1,15,19,12,12,11,1,-922,-590,-332,-844,-537,-307,-127,-34,-330,-343,-91,2,-73,-20,-203,-236,-59,2,-54,-14,-127,-107,-32,0,-110,-11,-297,-331,-92,-6,-59,-7,-179,-227,-64,-3,-51,-4,-118,-104,-28,-3
13,13087,Valdepeñas,26370,75,32,43,161,70,91,-8,12,39,33,8,-10,1,2,17,14,3,-4,-9,10,22,19,5,-6,14,39,71,30,5,0,10,12,28,17,2,0,4,27,43,13,3,0,315,159,156,282,139,143,76,46,77,80,18,13,38,14,29,52,12,10,38,32,48,28,6,3,52,68,102,50,7,1,22,32,51,28,5,0,30,36,51,22,2,1,73,56,17,183,103,80,34,17,5,-4,21,-3,16,14,17,-6,11,2,18,3,-12,2,10,-5,31,57,50,33,6,3,15,29,30,22,2,2,16,28,20,11,4,1,369,209,160,181,114,67,55,50,135,79,24,27,29,35,70,46,12,18,26,15,65,33,12,9,23,35,81,36,5,1,11,25,53,22,2,1,12,10,28,14,3,0,390,204,186,297,164,133,65,71,149,72,32,-6,39,34,64,44,19,-2,26,37,85,28,13,-4,38,97,104,42,13,3,22,50,55,28,7,2,16,47,49,14,6,1,456,231,225,267,135,132,98,99,126,70,37,16,54,40,63,48,17,6,44,59,63,22,20,10,35,89,90,43,8,0,13,33,56,28,5,-1,22,56,34,15,3,1,447,261,186,333,181,152,83,75,167,64,34,15,34,30,108,54,16,11,49,45,59,10,18,4,55,85,108,51,27,3,26,29,76,31,16,1,29,56,32,20,11,2,392,254,138,495,301,194,41,126,114,66,38,12,29,91,80,36,18,3,12,35,34,30,20,9,65,164,159,85,17,2,39,99,106,49,6,0,26,65,53,36,11,2,685,418,267,396,241,155,123,136,225,129,37,23,64,86,157,67,17,22,59,50,68,62,20,1,63,111,139,58,23,-3,36,66,91,32,15,-1,27,45,48,26,8,-2,178,122,56,165,89,76,47,54,31,20,15,17,19,34,14,24,20,10,28,20,17,-4,-5,7,46,49,40,23,2,2,21,25,23,15,3,0,25,24,17,8,-1,2,-224,-169,-55,-124,-98,-26,-18,-45,-99,-60,-21,14,-15,-22,-86,-43,-13,9,-3,-23,-13,-17,-8,5,6,-7,-67,-42,-15,-1,1,-4,-56,-35,-5,0,5,-3,-11,-7,-10,-1,46,32,14,77,33,44,-2,-3,56,15,9,-30,9,-19,37,16,4,-13,-11,16,19,-1,5,-17,7,27,43,1,-3,1,0,7,32,-2,-5,1,7,20,11,3,2,0,-333,-225,-108,-304,-203,-101,-55,-45,-80,-86,-52,-19,-23,-15,-68,-75,-33,-9,-32,-30,-12,-11,-19,-10,-30,-37,-95,-103,-34,-7,-10,-14,-71,-80,-24,-4,-20,-23,-24,-23,-10,-3,-187,-123,-64,-95,-71,-24,4,-25,-69,-77,-25,6,8,-4,-49,-62,-18,5,-4,-21,-20,-15,-7,1,-10,6,-34,-49,-11,3,-6,0,-20,-38,-10,3,-4,6,-14,-11,-1,0,-169,-113,-56,-105,-76,-29,-9,-48,-81,-40,17,-6,-6,-35,-58,-22,15,-5,-3,-13,-23,-18,2,-1,-6,0,-53,-40,-7,0,-1,-4,-33,-32,-6,-1,-5,4,-20,-8,-1,1,-154,-90,-64,-95,-64,-31,-11,-51,-40,-49,3,-9,-9,-19,-28,-41,7,2,-2,-32,-12,-8,-4,-11,-7,-9,-39,-30,-7,-6,-9,-4,-24,-21,-3,-3,2,-5,-15,-9,-4,-3,-41,-33,-8,-25,-31,6,-11,-13,-21,-2,-30,30,-14,-6,-11,-6,-11,12,3,-7,-10,4,-19,18,5,20,-28,-15,-14,4,1,8,-20,-11,-11,1,4,12,-8,-4,-3,3,-9,-38,29,44,-10,54,13,2,-50,-28,37,16,18,2,-32,-36,3,6,-5,0,-18,8,34,10,9,20,9,-7,10,1,4,4,1,-17,-2,0,5,16,8,10,12,1
13,13092,Villanueva de la Fuente,2748,-17,-6,-11,11,4,7,-13,4,-10,2,1,-2,-4,2,-3,-2,1,0,-9,2,-7,4,0,-2,0,3,2,6,0,0,0,1,2,1,0,0,0,2,0,5,0,0,7,9,-2,20,11,9,2,-1,0,5,-2,4,3,-2,4,5,-1,1,-1,1,-4,0,-1,3,5,6,4,5,0,0,4,1,3,3,0,0,1,5,1,2,0,0,-10,-1,-9,21,10,11,-14,2,-6,-5,8,5,-4,-1,-1,-4,5,4,-10,3,-5,-1,3,1,3,7,6,4,1,0,2,3,3,2,0,0,1,4,3,2,1,0,6,6,0,23,8,15,3,8,-2,5,4,-11,0,8,-1,2,1,-4,3,0,-1,3,3,-7,1,10,4,6,1,1,0,4,1,2,0,1,1,6,3,4,1,0,14,13,1,41,27,14,3,5,-6,-2,2,13,6,5,0,-3,-1,7,-3,0,-6,1,3,6,9,15,6,9,2,0,7,12,3,4,1,0,2,3,3,5,1,0,-14,-5,-9,28,16,12,2,-6,-5,-1,2,-6,-3,0,-2,1,1,-2,5,-6,-3,-2,1,-4,4,9,9,5,1,0,1,6,6,2,1,0,3,3,3,3,0,0,-6,4,-10,25,12,13,-1,-5,-4,-3,10,1,1,-1,0,-2,6,3,-2,-4,-4,-1,4,-2,3,5,9,5,2,1,2,3,4,3,1,0,1,2,5,2,1,1,24,18,6,45,29,16,1,14,9,1,0,-2,1,11,5,2,1,-3,0,3,4,-1,-1,1,10,12,17,5,1,0,5,7,13,3,1,0,5,5,4,2,0,0,-47,-19,-28,5,4,1,-9,-8,-19,-3,-3,-6,0,-6,-5,-3,-3,-2,-9,-2,-14,0,0,-4,2,1,0,0,0,2,2,1,0,0,0,1,0,0,0,0,0,1,-16,-3,-13,6,4,2,-3,-13,0,5,2,-6,0,-4,1,1,1,0,-3,-9,-1,4,1,-6,2,1,1,2,0,0,1,1,0,2,0,0,1,0,1,0,0,0,13,2,11,9,5,4,1,-1,14,-2,13,-13,0,-1,7,-3,6,-7,1,0,7,1,7,-6,1,2,5,0,1,0,0,1,3,0,1,0,1,1,2,0,0,0,-50,-23,-27,-20,-16,-4,-16,-6,-23,-4,0,0,-7,-2,-16,1,2,0,-9,-4,-7,-5,-2,0,-5,-2,-7,-2,-4,0,-5,-1,-7,-1,-2,0,0,-1,0,-1,-2,0,-34,-22,-12,-16,-14,-2,-3,-8,-10,-7,1,-6,-4,-4,-9,-5,1,0,1,-4,-1,-2,0,-6,0,-3,-7,-2,-4,0,0,-1,-7,-3,-3,0,0,-2,0,1,-1,0,-16,-12,-4,-7,-4,-3,-3,-12,1,-8,3,3,-4,-5,0,-6,2,0,1,-7,1,-2,1,3,1,0,-5,-1,-2,0,1,0,-3,-1,-1,0,0,0,-2,0,-1,0,-26,-9,-17,-9,-7,-2,3,-5,-11,1,-9,-4,4,-3,-8,-1,-3,2,-1,-2,-3,2,-6,-6,0,0,-4,-3,-2,0,0,0,-3,-3,-1,0,0,0,-1,0,-1,0,-12,-8,-4,0,-2,2,0,-5,-2,-9,-1,4,-1,-3,0,-6,1,1,1,-2,-2,-3,-2,3,1,-1,0,-1,1,0,0,-1,-1,-1,1,0,1,0,1,0,0,0,-48,-20,-28,0,-1,1,-10,-12,-13,-9,-2,-1,-5,-7,-1,-6,0,-1,-5,-5,-12,-3,-2,0,1,0,0,0,-1,0,0,0,0,0,-1,0,1,0,0,0,0,0,-30,-21,-9,6,5,1,-5,2,-10,-11,-4,-3,-5,-1,-5,-7,-2,-2,0,3,-5,-4,-2,-1,4,1,-1,3,-1,0,3,1,0,1,0,0,1,0,-1,2,-1,0
13,13096,Villarrubia de los Ojos,9608,60,38,22,51,37,14,17,24,16,6,-4,-3,5,11,18,2,0,-1,12,13,-2,4,-4,-2,2,21,20,5,1,0,0,16,15,4,1,0,2,5,5,1,0,0,129,90,39,141,90,51,16,32,52,34,0,-8,5,24,43,18,2,-4,11,8,9,16,-2,-4,14,37,54,28,3,2,6,25,36,18,2,1,8,12,18,10,1,1,156,91,65,194,117,77,18,65,46,26,-1,2,4,33,37,18,-4,3,14,32,9,8,3,-1,22,63,79,25,4,1,7,35,54,18,2,1,15,28,25,7,2,0,87,63,24,141,87,54,1,32,26,17,11,-2,0,26,15,14,8,0,1,6,11,3,3,-2,14,42,59,24,2,0,5,30,35,16,1,0,9,12,24,8,1,0,181,100,81,212,118,94,30,63,56,26,12,-8,12,34,34,16,7,-4,18,29,22,10,5,-4,29,73,78,25,4,0,13,41,45,16,2,0,16,32,33,9,2,0,219,128,91,254,147,107,33,84,48,37,8,4,13,47,30,23,7,4,20,37,18,14,1,0,36,88,83,38,6,1,15,51,52,23,4,1,21,37,31,15,2,0,276,153,123,307,164,143,65,97,41,60,11,-2,28,59,21,37,7,-1,37,38,20,23,4,-1,55,109,73,57,7,2,17,58,44,37,4,2,38,51,29,20,3,0,445,306,139,464,304,160,59,134,161,67,19,0,22,94,123,49,10,3,37,40,38,18,9,-3,51,163,164,66,15,1,20,104,122,47,8,0,31,59,42,19,7,1,82,14,68,128,54,74,14,35,-3,17,19,-2,4,0,-4,4,8,0,10,35,1,13,11,-2,21,44,34,24,4,0,11,12,18,10,2,0,10,32,16,14,2,0,-76,-54,-22,-37,-34,-3,10,-17,-45,-39,2,5,3,-4,-29,-30,2,1,7,-13,-16,-9,0,4,10,3,-30,-22,-3,1,5,5,-24,-18,-2,0,5,-2,-6,-4,-1,1,22,25,-3,69,40,29,15,18,-10,7,-9,-3,14,15,-7,5,-5,0,1,3,-3,2,-4,-3,8,22,22,10,3,1,6,14,11,5,1,0,2,8,11,5,2,1,10,-13,23,74,34,40,15,11,-7,-17,0,2,-2,1,-1,-10,-3,-1,17,10,-6,-7,3,3,26,20,10,6,6,0,7,10,8,4,2,0,19,10,2,2,4,0,18,20,-2,28,18,10,-2,1,10,-9,10,0,2,6,6,-4,4,0,-4,-5,4,-5,6,0,1,10,3,3,5,0,1,5,4,1,3,0,0,5,-1,2,2,0,-23,-3,-20,20,10,10,-4,2,-22,1,-1,-5,-5,5,-3,-2,0,-3,1,-3,-19,3,-1,-2,0,10,2,0,-1,0,0,5,2,0,-2,0,0,5,0,0,1,0,-115,-67,-48,-78,-63,-15,-5,-9,-70,-18,-8,-9,3,-4,-47,-14,-4,-4,-8,-5,-23,-4,-4,-5,-13,0,-29,-30,-8,-2,-2,-2,-29,-25,-5,-1,-11,2,0,-5,-3,-1,-65,-39,-26,20,6,14,-19,-15,-22,-12,1,0,-7,-1,-19,-10,-2,-1,-12,-14,-3,-2,3,1,5,9,5,-3,3,1,2,7,2,-4,-1,0,3,2,3,1,4,1,-64,-36,-28,35,23,12,-12,7,-34,-30,-3,6,0,10,-17,-25,-4,1,-12,-3,-17,-5,1,5,7,16,4,4,3,0,5,12,4,2,1,-1,2,4,0,2,2,1,-693,-414,-279,-657,-407,-250,-79,-59,-236,-227,-85,-8,-35,-25,-132,-164,-54,-2,-44,-34,-104,-63,-31,-6,-90,-35,-230,-227,-70,-7,-45,-16,-133,-165,-46,-2,-45,-19,-97,-62,-24,-5
13,13097,Villarta de San Juan,2915,-18,-4,-14,8,7,1,-12,-4,-1,-3,1,-1,-3,-3,0,-1,1,0,-9,-1,-1,-2,0,-1,0,4,3,1,0,0,0,4,2,1,0,0,0,0,1,0,0,0,7,3,4,13,7,6,6,-4,5,1,-2,2,4,1,1,-1,-1,0,2,-5,4,2,-1,2,6,1,5,1,0,0,4,1,1,1,0,0,2,0,4,0,0,0,46,45,1,61,40,21,4,6,8,16,7,3,7,7,8,15,5,3,-3,-1,0,1,2,0,10,9,23,15,2,0,7,5,15,12,1,0,3,4,8,3,1,0,27,22,5,45,31,14,7,9,7,0,6,-1,1,7,8,3,2,1,6,2,-1,-3,4,-2,14,10,11,8,2,0,9,10,6,6,0,0,5,0,5,2,2,0,-3,-7,4,21,11,10,6,-4,-11,-4,8,2,7,-8,-4,-6,4,0,-1,4,-7,2,4,2,1,10,4,7,0,0,1,4,4,3,0,0,0,6,0,4,0,0,26,20,6,66,40,26,-9,24,7,7,-2,-2,-8,14,8,6,-1,0,-1,10,-1,1,-1,-2,10,23,21,12,0,0,6,9,16,9,0,0,4,14,5,3,0,0,67,56,11,64,33,31,16,22,19,10,0,-3,16,13,13,10,1,0,0,9,6,0,-1,-3,12,22,20,8,1,0,7,11,10,4,1,0,5,11,10,4,0,0,62,42,20,73,43,30,22,12,4,14,11,0,13,11,6,5,7,0,9,1,-2,9,4,0,20,18,13,19,3,0,10,11,10,10,2,0,10,7,3,9,1,0,-16,-15,-1,7,1,6,-1,-4,-10,-1,-2,3,-1,-7,-6,-1,0,0,0,3,-4,0,-2,3,2,2,3,0,0,0,1,0,0,0,0,0,1,2,3,0,0,0,-73,-43,-30,-31,-23,-8,-7,-16,-33,-16,2,-2,-5,-9,-19,-12,1,1,-2,-7,-14,-4,1,-3,4,-9,-17,-5,-4,0,3,-6,-13,-5,-2,0,1,-3,-4,0,-2,0,35,13,22,4,1,3,12,-3,15,8,2,1,6,-2,8,4,-1,-1,6,-1,7,4,3,2,1,1,1,0,1,0,0,2,0,-1,0,0,1,-1,1,1,1,0,-27,-16,-11,16,7,9,-9,4,-15,2,-3,-3,-8,2,-3,1,-3,-3,-1,2,-12,1,0,0,1,4,8,3,0,0,0,2,3,2,0,0,1,2,5,1,0,0,-36,-16,-20,-9,-3,-6,-3,-6,0,-5,-12,-5,-3,-1,-3,-1,-4,-1,0,-5,3,-4,-8,-4,-4,1,-1,0,-5,0,-2,0,1,0,-2,0,-2,1,-2,0,-3,0,-33,-22,-11,-14,-8,-6,-4,4,-19,-7,-4,-3,-2,1,-13,-5,-1,-1,-2,3,-6,-2,-3,-2,-1,0,-1,-10,-2,0,-1,0,-2,-4,-1,0,0,0,1,-6,-1,0,-42,-27,-15,-10,-13,3,-12,-5,-12,-10,-2,0,-7,-3,-11,-5,-2,2,-5,-2,-1,-5,0,-2,1,2,-8,-5,0,0,0,0,-8,-5,0,0,1,2,0,0,0,0,-35,-23,-12,0,-1,1,-4,-6,-15,-8,1,-4,-6,-2,-8,-4,-1,-2,2,-4,-7,-4,2,-2,0,0,-1,0,1,0,0,0,-2,0,1,0,0,0,1,0,0,0,-36,-22,-14,-9,-8,-1,1,-12,-15,-16,0,6,3,-8,-6,-15,0,3,-2,-4,-9,-1,0,3,3,-4,0,-8,0,0,3,-2,-2,-7,0,0,0,-2,2,-1,0,0,-18,-12,-6,-2,-1,-1,4,-6,-15,0,0,-1,-1,-4,-11,3,0,0,5,-2,-4,-3,0,-1,0,0,0,-1,-1,0,1,0,0,-1,-1,0,-1,0,0,0,0,0
14,14002,Aguilar de la Frontera,13416,-5,5,-10,14,5,9,-1,0,-1,-1,5,-7,-4,0,5,0,4,0,3,0,-6,-1,1,-7,2,0,7,1,0,4,0,0,4,0,0,1,2,0,3,1,0,3,27,11,16,25,13,12,20,-5,5,1,5,1,12,-3,-4,3,1,3,8,-2,9,-2,4,-2,5,7,4,7,0,0,2,2,4,5,0,0,3,5,0,2,0,0,19,21,-2,45,31,14,10,10,-4,2,6,-5,4,8,7,0,7,-3,6,2,-11,2,-1,-2,7,16,17,4,2,-1,4,10,14,1,2,0,3,6,3,3,0,-1,-23,9,-32,23,18,5,1,-14,-19,4,4,-1,1,3,-1,1,3,2,0,-17,-18,3,1,-3,2,10,10,1,0,0,1,10,7,0,0,0,1,0,3,1,0,0,44,27,17,44,25,19,9,9,23,9,-8,1,9,7,12,3,-5,1,0,2,11,6,-3,0,6,13,16,8,1,0,4,9,7,5,0,0,2,4,9,3,1,0,36,34,2,45,28,17,8,9,1,1,20,-1,10,17,2,-3,7,1,-2,-8,-1,4,13,-2,6,15,18,5,1,0,4,10,11,2,1,0,2,5,7,3,0,0,-12,0,-12,14,8,6,1,-14,-1,-4,7,-1,2,-15,9,1,5,-1,-1,1,-10,-5,2,0,-3,0,10,0,5,2,-2,-1,8,1,1,1,-1,1,2,-1,4,1,40,21,19,65,30,35,16,5,20,15,-1,-17,6,1,7,8,0,-3,10,4,13,7,-1,-14,14,24,17,10,0,0,6,9,9,5,1,0,8,15,8,5,-1,0,17,24,-7,31,15,16,9,10,-12,1,-2,9,8,11,-1,1,0,3,1,-1,-11,0,-2,6,8,12,3,2,3,3,5,7,0,0,1,2,3,5,3,2,2,1,-87,-54,-33,-9,-16,7,-13,-10,-46,-7,2,-13,-11,-7,-20,-6,-5,-3,-2,-3,-26,-1,7,-10,5,2,-15,0,-1,-1,-1,1,-12,-2,-2,0,6,1,-3,2,1,-1,-39,-6,-33,9,13,-4,4,-18,-1,-3,0,-22,5,-4,-2,-2,4,-8,-1,-14,1,-1,-4,-14,1,1,6,1,1,-1,1,4,5,1,2,0,0,-3,1,0,-1,-1,29,23,6,20,11,9,-1,8,-9,-1,-2,30,-1,10,-1,-2,4,12,0,-2,-8,1,-6,18,3,14,4,2,-5,1,3,6,1,2,-1,0,0,8,3,0,-4,1,-34,-28,-6,-12,-15,3,-4,-18,-16,-9,7,4,0,-13,-12,-6,2,-1,-4,-5,-4,-3,5,5,4,-9,-4,-1,-2,0,2,-7,-6,-2,-2,0,2,-2,2,1,0,0,-4,12,-16,6,0,6,5,4,-15,9,-3,-1,5,7,-11,10,-2,4,0,-3,-4,-1,-1,-5,1,3,1,-1,1,1,-1,1,0,0,0,0,2,2,1,-1,1,1,-78,-45,-33,-7,-8,1,-12,-8,-42,-17,-8,11,-12,-8,-15,-10,-5,7,0,0,-27,-7,-3,4,-2,7,-10,-1,2,-2,-1,2,-5,-2,0,-1,-1,5,-5,1,2,-1,-20,-19,-1,-5,1,-6,4,4,-27,-17,6,11,3,4,-21,-14,4,4,1,0,-6,-3,2,7,4,0,-7,0,-2,0,3,3,-5,1,-1,0,1,-3,-2,-1,-1,0,-23,-24,1,-13,-5,-8,1,-15,-11,-12,8,4,-1,-9,-2,-14,3,-2,2,-6,-9,2,5,6,-2,-5,-4,-3,1,0,-1,-3,-1,-1,1,0,-1,-2,-3,-2,0,0,1,-13,14,-9,-7,-2,15,-7,-40,13,5,12,7,-4,-21,-1,1,2,8,-3,-19,14,4,10,0,-6,-2,0,-1,0,0,-3,-1,-2,-1,0,0,-3,-1,2,0,0
14,14004,Almedinilla,2555,15,14,1,2,1,1,3,1,6,4,1,1,5,2,4,2,1,0,-2,-1,2,2,0,1,1,1,0,0,0,0,0,1,0,0,0,0,1,0,0,0,0,0,-13,-2,-11,2,1,1,-2,-5,-1,4,-4,-5,1,-1,-1,3,-2,-2,-3,-4,0,1,-2,-3,0,0,0,2,0,0,0,0,0,1,0,0,0,0,0,1,0,0,-4,2,-6,24,17,7,-9,-3,7,3,1,-2,-8,1,9,3,-2,-1,-1,-4,-2,0,3,-1,1,1,15,7,0,0,1,1,10,5,0,0,0,0,5,2,0,0,14,19,-5,19,18,1,0,2,8,10,1,-8,-1,7,3,9,1,-1,1,-5,5,1,0,-7,1,4,7,7,0,0,0,4,7,7,0,0,1,0,0,0,0,0,-20,-6,-14,22,17,5,-6,-3,-7,-2,2,-3,-6,2,0,-2,2,-1,0,-5,-7,0,0,-2,1,6,7,6,2,0,0,5,6,4,2,0,1,1,1,2,0,0,27,18,9,21,18,3,8,8,6,5,7,-8,2,8,-1,6,5,-3,6,0,7,-1,2,-5,0,10,10,1,0,0,0,10,7,1,0,0,0,0,3,0,0,0,29,20,9,15,11,4,1,1,15,4,8,0,-1,0,10,5,5,1,2,1,5,-1,3,-1,0,3,4,4,3,1,0,2,4,2,2,1,0,1,0,2,1,0,-16,-2,-14,4,1,3,2,-4,-2,-6,-2,-4,2,-2,6,-4,0,-4,0,-2,-8,-2,-2,0,1,2,2,-1,0,0,0,1,2,-2,0,0,1,1,0,1,0,0,19,16,3,22,10,12,6,5,5,11,-2,-7,3,3,6,4,0,0,3,2,-1,7,-2,-7,7,3,5,5,1,1,3,2,2,1,1,1,4,1,3,4,0,0,10,2,8,8,8,0,3,6,-1,8,4,-10,3,2,-5,7,1,-5,0,4,4,1,3,-5,-1,2,3,4,0,0,0,1,3,4,0,0,-1,1,0,0,0,0,-15,-10,-5,0,-1,1,-7,8,-14,-8,5,1,-4,7,-8,-7,1,1,-3,1,-6,-1,4,0,-2,5,-3,-3,2,1,-2,4,-1,-3,0,1,0,1,-2,0,2,0,21,3,18,7,2,5,13,-3,6,-1,2,5,6,0,0,-4,1,0,7,-3,6,3,1,5,4,0,1,1,1,0,2,-1,0,0,1,0,2,1,1,1,0,0,-11,-6,-5,-1,-1,0,1,-1,-4,2,-3,-6,-2,-1,0,0,-2,-1,3,0,-4,2,-1,-5,0,-1,-2,2,0,0,0,-1,-1,1,0,0,0,0,-1,1,0,0,-14,-5,-9,3,2,1,-4,-5,-5,2,2,-4,1,0,-4,0,2,-4,-5,-5,-1,2,0,0,0,2,0,1,0,0,0,1,0,1,0,0,0,1,0,0,0,0,11,3,8,3,4,-1,12,-1,-10,2,2,6,4,-3,-7,3,2,3,8,2,-3,-1,0,3,0,-2,0,2,1,2,0,-1,1,1,1,2,0,-1,-1,1,0,0,3,8,-5,9,8,1,-5,0,2,-2,1,6,-2,2,4,3,-1,2,-3,-2,-2,-5,2,4,4,0,2,1,1,1,4,0,1,2,0,1,0,0,1,-1,1,0,19,19,0,15,7,8,0,6,-3,11,10,-5,1,0,5,8,7,-2,-1,6,-8,3,3,-3,2,3,2,4,4,0,1,0,1,3,2,0,1,3,1,1,2,0,-13,-9,-4,1,1,0,-2,-6,-2,-3,5,-5,0,-5,-3,-4,5,-2,-2,-1,1,1,0,-3,-1,1,-2,0,4,-1,0,0,-2,0,3,0,-1,1,0,0,1,-1
14,14005,Almodóvar del Río,7144,-17,-2,-15,3,2,1,-15,-10,-6,11,11,-10,-15,-7,5,9,9,-4,0,-3,-11,2,2,-6,0,0,0,1,2,0,0,0,0,1,1,0,0,0,0,0,1,0,74,31,43,5,1,4,2,17,14,18,19,3,2,2,8,8,12,-1,0,15,6,10,7,4,3,1,0,1,0,0,0,1,0,0,0,0,3,0,0,1,0,0,92,42,50,11,8,3,2,-13,1,46,51,5,-2,3,-4,13,30,4,4,-16,5,33,21,1,4,4,2,1,0,0,2,6,-1,1,0,0,2,-2,3,0,0,0,127,76,51,5,4,1,26,10,18,42,26,4,8,8,10,29,16,5,18,2,8,13,10,-1,1,0,1,1,2,0,1,0,0,1,2,0,0,0,1,0,0,0,38,39,-1,10,5,5,14,14,1,13,14,-15,12,11,6,8,6,-4,2,3,-5,5,8,-11,0,2,3,3,2,0,0,1,2,2,0,0,0,1,1,1,2,0,83,49,34,10,5,5,23,5,4,24,13,12,11,11,2,13,2,8,12,-6,2,11,11,4,2,3,0,2,2,1,1,1,0,1,1,1,1,2,0,1,1,0,108,87,21,17,12,5,24,14,29,27,8,5,23,14,26,15,4,6,1,0,3,12,4,-1,7,3,4,1,1,0,6,2,4,0,0,0,1,1,0,1,1,0,-20,-12,-8,9,4,5,-10,-5,9,-10,-1,-9,-5,-5,4,-3,-2,-2,-5,0,5,-7,1,-7,0,2,2,1,2,2,-1,1,1,0,2,1,1,1,1,1,0,1,28,8,20,-2,-6,4,11,3,9,5,8,-9,3,2,4,-2,6,-5,8,1,5,7,2,-4,1,2,-2,-3,1,-1,-1,1,-2,-3,0,-1,2,1,0,0,1,0,54,13,41,11,6,5,24,4,6,19,2,-6,7,-1,-6,10,2,-2,17,5,12,9,0,-4,3,0,4,2,1,0,1,0,1,2,1,0,2,0,3,0,0,0,38,28,10,5,3,2,11,4,18,7,-8,0,9,-1,12,11,-5,-1,2,5,6,-4,-3,1,0,0,5,-1,0,0,0,0,3,0,0,0,0,0,2,-1,0,0,20,42,-22,12,6,6,-4,16,-5,-5,13,1,2,13,13,-3,13,1,-6,3,-18,-2,0,0,2,2,1,6,0,0,0,2,0,3,0,0,2,0,1,3,0,0,-26,-2,-24,0,3,-3,-12,-10,-22,12,10,-4,-3,1,-9,5,5,-2,-9,-11,-13,7,5,-2,2,0,1,-4,2,-1,4,0,0,-2,1,0,-2,0,1,-2,1,-1,-19,-23,4,-18,-13,-5,1,0,-14,-6,3,0,-3,-2,-15,-1,-2,2,4,2,1,-5,5,-2,-8,1,-6,-4,-2,0,-6,0,-2,-3,-2,0,-2,1,-4,-1,0,0,-26,-16,-10,7,0,7,-11,2,-3,0,-14,2,-11,-1,-1,5,-8,1,0,3,-2,-5,-6,1,5,0,-2,0,1,2,2,0,-2,-1,-1,1,3,0,0,1,2,1,-30,-9,-21,3,3,0,1,-11,-15,2,-1,-8,3,-6,-8,1,-1,-1,-2,-5,-7,1,0,-7,1,0,0,-1,-1,2,0,-1,1,0,0,1,1,1,-1,-1,-1,1,43,35,8,5,4,1,18,-11,-1,17,1,15,9,-6,9,11,1,10,9,-5,-10,6,0,5,1,-1,-1,2,4,0,1,-1,-1,3,2,0,0,0,0,-1,2,0,9,-12,21,5,2,3,9,-11,1,3,8,0,4,-11,-9,2,3,-3,5,0,10,1,5,3,-2,2,1,3,1,0,-1,1,1,1,0,0,-1,1,0,2,1,0
14,14007,Baena,19712,-80,-34,-46,24,7,17,-12,-16,-23,-16,10,-23,-9,-6,-10,-9,8,-9,-3,-10,-13,-7,2,-14,2,6,10,3,3,0,0,1,3,1,2,0,2,5,7,2,1,0,52,34,18,48,28,20,6,16,20,6,14,-13,3,14,11,3,11,-10,3,2,9,3,3,-3,7,19,15,3,4,0,5,13,6,1,3,0,2,6,9,2,1,0,-7,7,-14,71,43,28,-11,6,18,-15,-8,4,-6,3,19,-6,-5,1,-5,3,-1,-9,-3,3,8,31,23,9,0,0,2,20,14,7,0,0,6,11,9,2,0,0,332,272,60,204,171,33,46,95,116,54,29,-10,23,98,93,39,22,-4,23,-3,23,15,7,-6,11,80,78,27,7,1,7,72,65,21,6,0,4,8,13,6,1,1,325,271,54,355,285,70,-3,142,121,66,9,-9,-2,122,111,38,8,-3,-1,20,10,28,1,-6,9,140,156,46,3,1,6,115,131,32,1,0,3,25,25,14,2,1,144,97,47,285,226,59,1,79,29,20,18,-3,-3,48,35,14,3,1,4,31,-6,6,15,-4,18,122,108,27,9,0,9,99,94,20,4,0,9,23,14,7,5,0,645,599,46,764,703,61,33,298,259,36,7,10,15,291,249,30,3,10,18,7,10,6,4,0,32,344,320,59,7,1,19,333,297,50,4,0,13,11,23,9,3,1,15,-105,120,259,176,83,11,26,-112,-30,21,101,-6,-1,-123,-28,15,39,17,27,11,-2,6,62,29,129,86,15,1,-1,15,97,58,6,0,0,14,32,28,9,1,-1,-255,-253,-2,31,20,11,15,-79,-180,-9,3,-8,10,-69,-179,-22,4,4,5,-10,-1,13,-1,-12,8,12,1,6,2,2,9,10,-4,3,1,1,-1,2,5,3,1,1,-79,-114,35,10,-1,11,25,-46,-81,-8,18,12,11,-53,-82,-10,6,12,14,7,1,2,12,0,5,9,-3,-1,0,0,2,6,-7,-1,-1,0,3,3,4,0,1,0,216,149,67,80,64,16,20,42,26,43,51,38,13,32,33,35,31,8,7,10,-7,8,20,30,6,34,29,9,3,-1,1,26,27,7,3,0,5,8,2,2,0,-1,-28,12,-40,65,45,20,-11,15,-19,-19,1,5,-3,19,0,-8,1,7,-8,-4,-19,-11,0,-2,5,31,19,9,0,1,2,26,15,4,-2,0,3,5,4,5,2,1,26,23,3,79,65,14,11,8,-22,7,8,14,6,11,-13,7,6,8,5,-3,-9,0,2,6,1,28,31,16,3,0,0,25,25,13,2,0,1,3,6,3,1,0,41,89,-48,184,176,8,-4,104,-19,-32,1,-10,1,112,1,-23,4,-5,-5,-8,-20,-9,-3,-5,-1,132,48,5,1,-1,-1,125,47,5,1,-1,0,7,1,0,0,0,91,122,-31,206,187,19,-17,112,-2,-12,9,1,-11,105,29,-8,7,-1,-6,7,-31,-4,2,2,5,119,61,12,7,1,4,110,60,9,3,0,1,9,1,3,4,1,102,97,5,92,118,-26,10,121,-55,-27,12,34,0,130,-33,-26,14,9,10,-9,-22,-1,-2,25,4,129,-1,-36,-4,0,2,134,7,-26,2,-1,2,-5,-8,-10,-6,1,-248,-123,-125,-39,-13,-26,-32,76,-145,-107,-24,-15,-13,81,-98,-69,-20,-3,-19,-5,-47,-38,-4,-12,-1,94,-40,-69,-23,-1,-1,90,-31,-55,-17,0,0,4,-9,-14,-6,-1,-319,-217,-102,-162,-128,-34,-30,-7,-161,-110,-15,2,-13,14,-123,-85,-9,0,-17,-21,-38,-25,-6,2,-3,30,-108,-64,-17,0,0,35,-97,-54,-12,0,-3,-5,-11,-10,-5,0
14,14012,Bujalance,8156,-23,-12,-11,9,4,5,-10,3,-8,-5,2,-7,-3,1,-11,1,2,-2,-7,2,3,-6,0,-5,0,4,3,1,1,0,0,2,1,0,1,0,0,2,2,1,0,0,-39,-28,-11,3,1,2,-9,-7,-21,-7,5,2,-5,-8,-9,-5,2,-2,-4,1,-12,-2,3,4,0,0,3,0,0,0,0,0,1,0,0,0,0,0,2,0,0,0,-20,5,-25,15,8,7,-6,2,-17,1,1,-2,0,4,0,2,1,-2,-6,-2,-17,-1,0,0,1,6,6,2,0,0,0,4,3,1,0,0,1,2,3,1,0,0,-49,-29,-20,12,7,5,1,-15,-36,-2,-1,4,1,-10,-22,-1,0,3,0,-5,-14,-1,-1,1,3,2,3,3,1,0,1,2,2,1,1,0,2,0,1,2,0,0,-42,-4,-38,19,9,10,-7,-14,-20,-6,6,1,1,-1,-6,0,2,3,-8,-13,-14,-6,4,-2,5,6,5,3,0,0,2,5,1,1,0,0,3,1,4,2,0,0,-13,-10,-3,15,9,6,12,-9,1,-4,3,-13,8,-12,4,-3,0,-4,4,3,-3,-1,3,-9,3,3,8,1,0,0,1,3,5,0,0,0,2,0,3,1,0,0,51,26,25,9,5,4,19,7,-6,23,8,-1,11,6,-7,14,4,-1,8,1,1,9,4,0,4,1,3,1,0,0,3,1,0,1,0,0,1,0,3,0,0,0,74,47,27,46,22,24,20,16,27,12,3,-5,9,10,12,11,5,-1,11,6,15,1,-2,-4,10,14,13,7,2,0,3,7,5,6,1,0,7,7,8,1,1,0,-37,-14,-23,17,12,5,-9,-6,-15,2,5,-13,-4,-2,-7,1,1,-3,-5,-4,-8,1,4,-10,1,5,7,4,0,0,1,3,5,3,0,0,0,2,2,1,0,0,27,26,1,14,7,7,-1,4,10,11,4,-1,5,4,10,5,4,-1,-6,0,0,6,0,0,2,6,7,-2,0,0,1,3,3,-1,1,0,1,3,4,-1,-1,0,15,14,1,14,10,4,-2,5,-7,13,7,-2,0,6,-3,6,4,0,-2,-1,-4,7,3,-2,3,1,2,8,-1,1,2,2,1,5,0,0,1,-1,1,3,-1,1,-23,-17,-6,13,7,6,2,0,-17,-1,0,-8,1,1,-13,-3,3,-4,1,-1,-4,2,-3,-4,4,1,10,0,-2,0,3,1,5,-1,-1,0,1,0,5,1,-1,0,-84,-31,-53,3,2,1,-16,-7,-34,-9,-2,-12,-3,0,-18,-2,-1,-5,-13,-7,-16,-7,-1,-7,5,3,-2,-2,-1,0,5,2,-2,-2,-1,0,0,1,0,0,0,0,-25,-29,4,-6,-5,-1,6,-2,-8,-18,0,-2,3,-5,-8,-14,-2,-1,3,3,0,-4,2,-1,7,0,-4,-7,-2,0,4,0,-1,-6,-2,0,3,0,-3,-1,0,0,-57,-33,-24,-2,-4,2,-8,-9,-24,-17,4,-3,-5,-5,-12,-12,4,-2,-3,-4,-12,-5,0,-1,5,2,-3,-5,-1,-1,1,0,-2,-3,0,0,4,2,-1,-2,-1,-1,-31,-8,-23,9,7,2,10,-8,-4,-19,-4,-4,4,-1,1,-8,-2,-2,6,-7,-5,-11,-2,-2,4,1,2,2,0,0,3,1,1,2,0,0,1,0,1,0,0,0,-2,-2,0,4,2,2,-2,0,-15,16,3,-3,1,-6,-9,11,4,-3,-3,6,-6,5,-1,0,2,1,0,0,0,1,1,0,-1,0,1,1,1,1,1,0,-1,0,-31,-24,-7,2,-4,6,-9,-6,-20,-4,-4,15,-10,-3,-10,2,-7,5,1,-3,-10,-6,3,10,4,0,-3,-1,0,2,1,-1,-3,-1,-1,1,3,1,0,0,1,1
14,14013,Cabra,20744,-49,-44,-5,23,8,15,0,-22,-10,-5,-5,-8,-3,-18,-8,-5,-4,-5,3,-4,-2,0,-1,-3,7,2,9,3,2,0,3,1,3,0,1,0,4,1,6,3,1,0,-5,-6,1,44,18,26,-10,-3,-9,-10,12,14,-15,2,-8,-6,9,12,5,-5,-1,-4,3,2,13,10,12,6,2,0,4,6,4,2,1,0,9,4,8,4,1,0,98,55,43,57,35,22,46,-6,4,25,20,4,30,-9,-4,16,9,10,16,3,8,9,11,-6,10,11,19,12,4,-1,7,7,10,8,2,0,3,4,9,4,2,-1,9,28,-19,45,19,26,1,-5,1,5,17,-11,-6,9,18,3,7,-3,7,-14,-17,2,10,-8,7,10,13,5,6,1,3,5,7,1,1,1,4,5,6,4,5,0,138,77,61,78,40,38,37,26,12,27,26,10,21,17,8,13,12,7,16,9,4,14,14,3,9,22,31,6,8,2,7,12,14,3,3,1,2,10,17,3,5,1,37,34,3,42,23,19,25,-13,-10,11,20,1,14,1,-4,2,13,4,11,-14,-6,9,7,-3,8,12,11,3,6,2,4,7,7,1,3,1,4,5,4,2,3,1,174,99,75,81,32,49,38,14,40,56,21,3,23,23,11,27,10,4,15,-9,29,29,11,-1,14,21,27,10,6,1,6,12,8,4,1,1,8,9,19,6,5,0,126,83,43,127,65,62,31,21,23,17,3,34,15,19,15,19,1,16,16,2,8,-2,2,18,29,36,46,12,3,1,16,18,20,8,3,0,13,18,26,4,0,1,71,40,31,85,41,44,43,-8,7,19,-2,11,17,-10,12,12,0,11,26,2,-5,7,-2,0,12,25,28,13,6,-1,6,9,15,9,1,0,6,16,13,4,5,-1,-57,-32,-25,42,11,31,10,-27,-47,-4,2,12,0,-11,-22,-8,0,7,10,-16,-25,4,2,5,13,6,11,8,3,1,6,-1,4,1,1,0,7,7,7,7,2,1,-14,17,-31,61,36,25,12,-7,-15,-3,0,2,13,-4,-3,-4,5,11,-1,-3,-12,1,-5,-9,22,11,15,9,2,1,11,6,10,5,2,1,11,5,5,4,0,0,-82,-29,-53,29,13,16,-18,-10,-43,-18,9,4,-10,5,-32,-2,4,11,-8,-15,-11,-16,5,-7,5,5,7,4,5,3,4,-2,6,2,0,3,1,7,1,2,5,0,-46,-26,-20,15,6,9,6,-12,-42,9,-2,-6,4,-6,-28,1,-2,3,2,-6,-14,8,0,-9,5,5,1,0,2,0,2,6,-1,-2,-1,1,3,-1,2,2,3,-1,-86,-52,-34,-38,-31,-7,-15,-13,-47,-41,11,17,-7,-3,-35,-22,5,9,-8,-10,-12,-19,6,8,2,5,-20,-19,-5,-1,-1,1,-15,-12,-5,1,3,4,-5,-7,0,-2,-68,-58,-10,39,16,23,13,-16,-79,-6,6,17,-1,-16,-43,-5,2,6,14,0,-36,-1,4,11,9,8,10,8,5,-1,6,0,5,4,2,-1,3,8,5,4,3,0,-75,-13,-62,14,1,13,12,-36,-17,-33,0,6,7,-9,-5,-17,7,8,5,-27,-12,-16,-7,-2,10,7,-2,0,-1,0,4,2,-3,-2,1,-1,6,5,1,2,-2,1,-93,-40,-53,23,7,16,-12,-17,-61,-9,0,8,-4,-8,-20,-13,0,5,-8,-9,-41,4,0,3,3,13,-2,4,4,0,0,4,0,0,2,0,3,9,-2,4,2,0,-50,-45,-5,49,10,39,-4,3,-48,-21,-11,27,-3,9,-43,-14,-10,13,-1,-6,-5,-7,-1,14,10,21,15,-3,-1,4,2,6,3,-4,-1,1,8,15,12,1,0,3
14,14017,"Carlota, La",10336,112,56,56,31,16,15,22,0,38,32,16,0,14,4,15,15,8,-2,8,-4,23,17,8,2,3,7,8,7,6,0,1,3,6,2,4,0,2,4,2,5,2,0,79,42,37,21,8,13,14,4,-4,40,23,0,13,-8,-1,23,10,3,1,12,-3,17,13,-3,5,4,8,2,1,1,3,1,3,1,0,0,2,3,5,1,1,1,196,98,98,23,5,18,18,40,46,36,41,17,5,15,24,21,27,9,13,25,22,15,14,8,8,4,6,3,0,2,0,1,2,2,0,0,8,3,4,1,0,2,162,94,68,28,15,13,26,41,53,13,25,2,17,24,27,5,19,1,9,17,26,8,6,1,8,4,13,2,1,0,5,3,6,1,0,0,3,1,7,1,1,0,217,103,114,28,16,12,48,27,49,36,37,20,28,13,25,15,17,8,20,14,24,21,20,12,3,5,10,2,5,3,1,4,7,0,3,1,2,1,3,2,2,2,341,184,157,27,8,19,60,66,126,43,23,16,29,40,61,25,15,11,31,26,65,18,8,5,1,7,12,2,3,2,0,2,3,2,1,0,1,5,9,0,2,2,342,160,182,42,19,23,48,63,120,62,36,7,20,19,62,32,14,7,28,44,58,30,22,0,6,15,16,3,1,1,2,7,10,-1,0,1,4,8,6,4,1,0,423,220,203,51,21,30,78,78,129,84,45,3,42,37,76,40,26,-1,36,41,53,44,19,4,11,13,10,10,4,2,6,4,7,2,2,1,5,9,3,8,2,1,283,149,134,38,21,17,40,64,86,41,33,15,32,32,41,24,22,0,8,32,45,17,11,15,12,9,9,6,3,-1,9,3,3,3,2,1,3,6,6,3,1,-2,160,88,72,6,1,5,27,36,33,22,20,24,16,19,14,11,13,14,11,17,19,11,7,10,2,8,-4,0,-1,1,1,2,-3,1,1,-1,1,6,-1,-1,-2,2,113,69,44,7,-2,9,3,13,31,21,23,20,6,7,26,11,11,6,-3,6,5,10,12,14,8,2,1,-1,-2,-1,1,-2,-1,1,-1,0,7,4,2,-2,-1,-1,79,38,41,15,6,9,-2,12,47,5,8,3,-3,14,13,8,3,1,1,-2,34,-3,5,2,0,6,3,4,2,0,0,0,0,5,1,0,0,6,3,-1,1,0,10,6,4,9,1,8,1,3,-8,-8,8,15,-7,-6,4,-2,7,12,8,9,-12,-6,1,3,2,5,-2,-1,5,-1,-1,0,-1,-1,4,-1,3,5,-1,0,1,0,-56,-19,-37,29,14,15,-13,-7,-14,-21,18,-13,10,-7,0,-25,11,-7,-23,0,-14,4,7,-6,9,7,8,3,4,-3,6,2,6,-1,3,-2,3,5,2,4,1,-1,15,-6,21,-8,-6,-2,9,-3,0,-11,10,8,8,4,-8,-13,1,2,1,-7,8,2,9,6,-5,1,-6,-1,2,0,0,2,-5,-2,-1,0,-5,-1,-1,1,3,0,-62,-58,-4,7,-3,10,-21,24,-29,-21,-13,0,-19,5,-22,-11,-3,-3,-2,19,-7,-10,-10,3,8,3,-5,-1,0,2,4,1,-6,-3,1,0,4,2,1,2,-1,2,44,16,28,17,9,8,36,-26,-9,21,7,15,26,-18,-8,13,1,4,10,-8,-1,8,6,11,13,1,1,2,-1,-1,7,-3,0,5,1,-2,6,4,1,-3,-2,1,10,-13,23,19,9,10,8,2,-2,-22,2,16,13,-7,-11,-20,-1,8,-5,9,9,-2,3,8,7,4,6,1,1,0,6,-1,4,-1,0,1,1,5,2,2,1,-1
14,14019,Castro del Río,8023,10,15,-5,19,8,11,6,4,1,6,-7,-3,3,6,1,5,-2,-1,3,-2,0,1,-5,-2,3,9,5,2,0,0,0,5,2,1,0,0,3,4,3,1,0,0,12,10,2,10,7,3,5,-4,1,5,1,3,4,0,3,1,1,0,1,-4,-2,4,0,3,1,3,3,3,0,0,1,2,3,1,0,0,0,1,0,2,0,0,-8,15,-23,5,7,-2,0,-1,-14,5,9,-7,8,5,-3,4,6,-5,-8,-6,-11,1,3,-2,2,1,1,1,0,0,2,2,2,1,0,0,0,-1,-1,0,0,0,-9,4,-13,23,11,12,5,-2,0,3,-5,-8,1,-2,6,4,-3,-1,4,0,-6,-1,-2,-7,5,7,6,3,1,0,1,3,5,1,0,0,4,4,1,2,1,0,30,10,20,26,14,12,9,1,5,4,11,0,2,2,-2,1,7,1,7,-1,7,3,4,-1,3,8,12,1,2,0,1,3,9,0,1,0,2,5,3,1,1,0,30,29,1,43,27,16,-4,2,23,8,2,1,-3,5,18,8,1,1,-1,-3,5,0,1,0,4,17,18,5,-1,0,1,12,11,3,0,0,3,5,7,2,-1,0,-10,3,-13,4,3,1,0,-5,-18,-2,10,4,1,1,-12,4,7,1,-1,-6,-6,-6,3,3,2,3,-1,0,0,0,1,3,-1,0,0,0,1,0,0,0,0,0,49,16,33,51,24,27,14,3,5,11,5,9,5,-6,7,8,3,-1,9,9,-2,3,2,10,11,14,11,12,1,0,6,5,4,8,1,0,5,9,7,4,0,0,71,43,28,44,27,17,26,20,18,10,1,-5,14,13,11,5,-1,1,12,7,7,5,2,-6,10,15,15,3,1,0,6,9,10,2,0,0,4,6,5,1,1,0,0,11,-11,6,3,3,-10,-3,5,1,7,2,-1,2,4,0,3,3,-9,-5,1,1,4,-1,3,-1,2,-1,1,2,2,-1,3,-2,0,1,1,0,-1,1,1,1,-8,-8,0,2,1,1,-2,-1,-5,-9,5,3,-1,-2,-8,-1,3,1,-1,1,3,-8,2,2,1,-3,-1,5,-1,0,-3,1,-2,5,0,0,4,-4,1,0,-1,0,16,6,10,6,-3,9,9,-5,-3,11,2,0,3,0,-3,3,2,1,6,-5,0,8,0,-1,3,4,1,-4,0,0,2,2,-3,-4,0,0,1,2,4,0,0,0,21,13,8,-2,0,-2,6,-4,-6,-4,-1,33,7,-1,3,-1,-1,9,-1,-3,-9,-3,0,24,-1,0,0,1,-2,0,0,0,2,0,-2,0,-1,0,-2,1,0,0,-9,-17,8,-21,-14,-7,8,-10,-21,-2,7,11,2,-11,-11,0,0,5,6,1,-10,-2,7,6,1,-2,-12,-6,-1,-1,0,-4,-6,-2,-1,-1,1,2,-6,-4,0,0,-43,-30,-13,-3,-3,0,-3,-5,-30,-2,-5,5,-3,-5,-15,-5,-1,1,0,0,-15,3,-4,4,2,4,-8,-1,-1,1,1,2,-5,-2,0,1,1,2,-3,1,-1,0,-21,-10,-11,-4,-1,-3,-6,3,-21,-7,2,9,-2,2,-8,-10,3,6,-4,1,-13,3,-1,3,-3,0,1,-4,1,1,-1,0,3,-3,0,0,-2,0,-2,-1,1,1,-8,6,-14,3,2,1,4,-1,-10,-1,0,4,6,3,-1,-3,2,3,-2,-4,-9,2,-2,1,3,2,2,-3,-1,0,2,0,3,-2,-1,0,1,2,-1,-1,0,0,9,12,-3,11,12,-1,2,-12,-7,1,-1,28,3,-2,5,-1,5,3,-1,-10,-12,2,-6,25,3,0,7,3,-3,1,4,2,4,2,0,0,-1,-2,3,1,-3,1
14,14021,Córdoba,311708,-1416,-859,-557,303,118,185,-119,-482,-518,-78,-134,-65,-72,-290,-328,-34,-98,-29,-47,-192,-190,-44,-36,-36,53,73,87,44,25,18,26,25,30,20,5,9,27,48,57,24,20,9,-702,-410,-292,725,329,396,92,-361,-275,0,-88,-64,34,-164,-202,9,-61,-21,58,-197,-73,-9,-27,-43,146,148,233,145,38,10,75,53,99,78,18,4,71,95,134,67,20,6,-348,-303,-45,867,375,492,286,-209,-257,32,-131,-68,136,-142,-191,4,-91,-22,150,-67,-66,28,-40,-46,221,179,211,159,61,20,104,70,100,58,28,7,117,109,111,101,33,13,538,168,370,1009,452,557,360,40,80,146,-41,-55,148,21,8,32,-34,-11,212,19,72,114,-7,-44,226,235,284,150,72,27,103,104,130,63,33,11,123,131,154,87,39,16,385,44,341,1167,463,704,205,-5,70,240,-13,-148,114,-26,-45,71,-22,-66,91,21,115,169,9,-82,166,239,391,234,84,23,81,92,152,84,30,10,85,147,239,150,54,13,-460,-303,-157,1025,462,563,104,-91,-297,62,-97,-109,47,-51,-208,41,-66,-48,57,-40,-89,21,-31,-61,193,222,310,204,63,15,94,93,143,94,21,8,99,129,167,110,42,7,-186,-215,29,1017,467,550,224,-72,-240,67,-67,-109,78,-58,-161,1,-14,-54,146,-14,-79,66,-53,-55,232,239,284,154,55,24,106,114,124,69,26,12,126,125,160,85,29,12,417,97,320,1442,640,802,304,210,-78,148,-72,-135,147,67,-112,56,-35,-50,157,143,34,92,-37,-85,334,329,392,226,80,21,173,125,169,95,37,10,161,204,223,131,43,11,1806,952,854,1582,798,784,487,274,424,566,-5,2,230,118,278,296,-7,-4,257,156,146,270,2,6,251,346,498,323,81,28,120,156,276,172,29,15,131,190,222,151,52,13,-235,-340,105,998,437,561,205,24,-238,-88,-49,-120,73,-25,-209,-105,-29,-53,132,49,-29,17,-20,-67,214,250,278,146,44,17,111,100,129,45,19,9,103,150,149,101,25,8,-137,-159,22,854,387,467,194,139,-271,-36,-96,-111,87,64,-190,-51,-62,-25,107,75,-81,15,-34,-86,142,231,239,138,40,15,73,115,110,49,9,7,69,116,129,89,31,8,273,37,236,692,280,412,210,10,9,78,-2,-54,112,-4,-70,17,-7,-21,98,14,79,61,5,-33,105,187,189,71,70,14,50,80,68,23,22,5,55,107,121,48,48,9,-266,-230,-36,579,239,340,69,52,-158,-21,-119,-118,20,26,-112,-37,-75,-67,49,26,-46,16,-44,-51,98,127,192,63,40,14,46,59,74,15,16,5,52,68,118,48,24,9,-2478,-1272,-1206,-1690,-923,-767,-243,-253,-773,-675,-341,-224,-121,-133,-445,-344,-153,-104,-122,-120,-328,-331,-188,-120,-205,-98,-573,-569,-224,-71,-110,-70,-313,-320,-111,-27,-95,-28,-260,-249,-113,-44,-786,-475,-311,-400,-251,-149,163,-69,-459,-163,-120,-182,117,-73,-335,-105,-44,-47,46,4,-124,-58,-76,-135,-47,41,-250,-131,-62,0,-22,12,-164,-72,-25,-1,-25,29,-86,-59,-37,1,-359,-230,-129,427,144,283,50,-17,-315,5,52,-169,5,-13,-175,-31,21,-54,45,-4,-140,36,31,-115,83,124,69,22,60,21,41,56,4,-12,23,8,42,68,65,34,37,13,-470,-230,-240,507,214,293,80,-26,-216,-116,-72,-150,40,-31,-95,-63,-62,-38,40,5,-121,-53,-10,-112,121,141,102,57,41,15,54,54,56,23,6,7,67,87,46,34,35,8,-684,-465,-219,263,76,187,30,-55,-361,-85,-24,-215,-4,-37,-273,-91,-26,-51,34,-18,-88,6,2,-164,45,132,6,19,39,0,22,65,-24,-12,10,4,23,67,30,31,29,-4
14,14022,Doña Mencía,4955,-6,-9,3,5,2,3,-1,-2,-13,5,5,1,-4,0,-10,2,3,0,3,-2,-3,3,2,1,0,1,2,1,1,0,0,1,1,0,0,0,0,0,1,1,1,0,28,19,9,22,15,7,11,2,11,4,1,-1,6,0,6,6,2,-1,5,2,5,-2,-1,0,11,2,7,2,0,0,6,1,6,2,0,0,5,1,1,0,0,0,11,-1,12,-1,-2,1,5,-1,1,-5,9,0,5,-3,-2,-5,3,-1,0,2,3,0,6,1,0,0,2,-2,-1,0,0,0,1,-2,-1,0,0,0,1,0,0,0,-16,-6,-10,-2,1,-3,-4,-5,-7,3,-5,2,-2,-3,-3,3,-3,1,-2,-2,-4,0,-2,1,-1,0,0,0,-1,0,1,0,1,0,-1,0,-2,0,-1,0,0,0,-9,-11,2,13,5,8,0,2,-11,-4,3,-1,1,1,-11,-3,0,0,-1,1,0,-1,3,-1,4,4,2,3,0,0,3,2,-1,2,-1,0,1,2,3,1,1,0,-4,1,-5,0,-1,1,5,-2,-3,5,-4,-6,3,2,-2,1,-2,-2,2,-4,-1,4,-2,-4,1,0,0,0,-2,0,1,0,0,-1,-1,0,0,0,0,1,-1,0,-2,2,-4,14,12,2,-2,7,-6,-4,4,0,-3,6,2,-4,1,1,1,1,-8,0,3,-1,2,2,8,3,-1,0,0,2,9,2,-1,0,2,0,-1,1,0,0,28,20,8,15,11,4,15,4,4,6,4,-6,9,0,6,4,4,-3,6,4,-2,2,0,-3,1,3,4,6,1,0,0,2,4,5,0,0,1,1,0,1,1,0,-5,-5,0,8,5,3,-1,9,-11,-4,5,-2,-1,5,-5,-3,1,-2,0,4,-6,-1,4,0,0,1,3,2,2,0,0,1,2,1,1,0,0,0,1,1,1,0,-11,3,-14,5,5,0,-5,0,-9,-3,2,5,-2,4,-1,-1,2,1,-3,-4,-8,-2,0,4,0,1,1,1,2,0,1,1,1,0,2,0,-1,0,0,1,0,0,-7,-4,-3,4,2,2,2,1,-9,1,6,-8,0,2,-7,-1,4,-2,2,-1,-2,2,2,-6,0,2,0,-2,4,0,-1,1,0,-1,3,0,1,1,0,-1,1,0,-20,-9,-11,3,2,1,-6,-3,-8,2,0,-6,-2,-3,1,0,0,-4,-4,0,-9,2,0,-2,-1,2,1,2,0,-1,0,2,1,0,0,-1,-1,0,0,2,0,0,8,11,-3,-1,-2,1,7,0,-6,6,4,-3,2,1,0,2,3,1,5,-1,-6,4,1,-4,-1,2,0,-4,1,1,-1,2,0,-4,1,0,0,0,0,0,0,1,-9,-7,-2,-1,-3,2,-1,-2,-9,-4,-1,9,2,0,-9,-2,-1,3,-3,-2,0,-2,0,6,2,2,-4,-1,-1,1,0,0,-2,-1,-1,1,2,2,-2,0,0,0,-31,-23,-8,-3,-2,-1,-4,-2,-5,-13,-7,-2,-1,-3,-4,-8,-6,-1,-3,1,-1,-5,-1,-1,-1,1,1,-3,-1,0,0,0,1,-2,-1,0,-1,1,0,-1,0,0,-51,-25,-26,-10,-3,-7,-6,-12,-14,-5,-4,-8,-1,-8,-7,-2,-3,-3,-5,-4,-7,-3,-1,-5,-2,-2,-3,-2,0,-1,0,0,-2,0,0,-1,-2,-2,-1,-2,0,0,-53,-16,-37,0,0,0,-11,-11,-20,-3,-5,-3,-4,1,-9,-3,-1,1,-7,-12,-11,0,-4,-4,0,1,-2,3,-2,0,0,0,-1,2,-1,0,0,1,-1,1,-1,0,-19,-15,-4,-3,-2,-1,7,-8,-11,-2,-3,-2,1,-5,-5,-2,-3,0,6,-3,-6,0,0,-2,0,0,-1,-2,0,0,0,0,0,-2,0,0,0,0,-1,0,0,0
14,14026,Espiel,2415,38,17,21,10,5,5,-7,4,15,2,13,8,-4,4,6,1,9,1,-3,0,9,1,4,7,3,0,1,2,4,0,2,0,0,1,2,0,1,0,1,1,2,0,-24,-3,-21,5,2,3,-8,-4,-10,-5,6,-1,-4,-4,-2,0,5,2,-4,0,-8,-5,1,-3,4,0,1,0,0,0,2,0,0,0,0,0,2,0,1,0,0,0,3,-1,4,6,3,3,4,-9,3,-4,6,1,0,-3,0,-4,5,-1,4,-6,3,0,1,2,3,0,2,1,0,0,1,0,1,1,0,0,2,0,1,0,0,0,-44,-14,-30,2,0,2,-21,-3,-8,-4,4,-12,-8,-4,0,-1,3,-4,-13,1,-8,-3,1,-8,0,1,1,0,0,0,0,-1,1,0,0,0,0,2,0,0,0,0,21,10,11,17,11,6,5,0,4,6,0,6,-1,0,5,3,0,2,6,0,-1,3,0,4,0,7,4,2,2,1,0,3,3,2,1,1,0,4,1,0,1,0,49,32,17,21,14,7,0,11,16,10,4,7,2,7,12,6,2,3,-2,4,4,4,2,4,3,9,3,2,3,1,1,6,3,1,2,1,2,3,0,1,1,0,43,28,15,15,8,7,4,3,13,-1,7,16,5,4,7,0,3,9,-1,-1,6,-1,4,7,2,5,6,2,0,0,2,2,3,1,0,0,0,3,3,1,0,0,40,15,25,20,10,10,4,18,-11,2,5,20,-1,6,-5,4,6,5,5,12,-6,-2,-1,15,4,9,4,3,0,0,2,3,3,2,0,0,2,6,1,1,0,0,42,25,17,7,5,2,12,3,2,4,6,11,4,3,3,1,3,8,8,0,-1,3,3,3,6,0,1,-1,0,0,5,0,0,-1,0,0,1,0,1,0,0,0,28,19,9,1,-1,2,2,2,6,7,1,8,3,3,1,7,-1,5,-1,-1,5,0,2,3,5,1,-3,-2,0,0,3,0,-2,-1,-1,0,2,1,-1,-1,1,0,-4,-13,9,5,2,3,-6,-2,5,-4,0,3,-6,-5,-1,-5,2,1,0,3,6,1,-2,2,2,0,2,0,0,1,1,0,1,0,0,0,1,0,1,0,0,1,5,8,-3,2,-1,3,12,4,-9,-2,0,-1,4,5,-3,-4,2,2,8,-1,-6,2,-2,-3,0,2,0,0,-1,0,-1,1,-1,0,-1,0,1,1,1,0,0,0,6,11,-5,-4,-1,-3,0,8,6,-1,-2,-6,2,5,6,0,-1,-2,-2,3,0,-1,-1,-4,0,1,-3,-1,0,-1,0,1,-1,-1,0,0,0,0,-2,0,0,-1,-27,-20,-7,-11,-8,-3,-8,-7,-9,0,-2,0,-5,-5,-7,-3,-1,2,-3,-2,-2,3,-1,-2,-3,-1,-4,-3,0,0,-3,-1,-2,-2,0,0,0,0,-2,-1,0,0,76,26,50,4,2,2,4,-4,3,11,10,53,-1,-1,0,5,5,19,5,-3,3,6,5,34,0,0,1,1,1,0,0,0,0,1,1,0,0,0,1,0,0,0,9,-5,14,-6,-2,-4,-6,2,-15,-9,-11,47,-6,0,-5,-7,-3,16,0,2,-10,-2,-8,31,-3,1,-3,0,-1,0,-2,0,0,0,0,0,-1,1,-3,0,-1,0,24,20,4,8,2,6,-14,-9,-14,0,14,49,-2,-2,-6,2,7,22,-12,-7,-8,-2,7,27,2,2,1,2,0,1,0,1,0,0,0,1,2,1,1,2,0,0,11,10,1,-4,-2,-2,0,3,-1,-2,2,8,0,2,3,-1,2,4,0,1,-4,-1,0,4,-2,0,-1,-1,0,0,-1,0,0,-1,0,0,-1,0,-1,0,0,0
14,14027,Fernán-Núñez,9491,-16,-16,0,13,7,6,7,-5,-24,2,7,-3,-1,-7,-11,2,4,-2,8,2,-13,0,3,-1,3,1,5,2,2,0,3,1,1,1,1,0,0,0,4,1,1,0,-17,-3,-14,6,3,3,3,-6,-12,-4,4,0,1,2,-4,-3,1,1,2,-8,-8,-1,3,-1,2,0,1,1,2,0,1,0,0,1,1,0,1,0,1,0,1,0,-8,1,-9,5,3,2,-3,2,-15,6,4,0,-5,9,-7,3,2,-1,2,-7,-8,3,2,1,0,2,0,3,0,0,0,2,-1,2,0,0,0,0,1,1,0,0,-44,-11,-33,8,4,4,-8,-5,-30,-6,9,-3,4,-3,-13,-4,7,-1,-12,-2,-17,-2,2,-2,3,0,3,0,2,0,1,-1,3,0,1,0,2,1,0,0,1,0,30,14,16,6,4,2,7,2,5,0,14,1,0,6,1,-1,6,3,7,-4,4,1,8,-2,0,3,1,0,0,2,0,3,0,0,0,1,0,0,1,0,0,1,36,26,10,16,6,10,-3,7,14,10,4,5,-1,5,10,8,0,5,-2,2,4,2,4,0,0,8,4,4,1,-1,0,4,1,2,0,-1,0,4,3,2,1,0,32,23,9,11,6,5,20,-6,3,-3,14,6,10,-1,7,-6,8,5,10,-5,-4,3,6,1,4,2,1,1,1,2,2,1,1,0,0,2,2,1,0,1,1,0,18,14,4,11,6,5,9,-8,3,13,10,-9,11,-5,-2,8,4,-3,-2,-3,5,5,6,-6,2,6,3,1,0,0,1,4,1,0,0,0,1,2,2,1,0,0,84,43,41,30,17,13,22,3,25,24,4,3,6,4,14,15,2,1,16,-1,11,9,2,2,7,2,11,5,2,3,4,0,7,2,2,2,3,2,4,3,0,1,14,11,3,-4,-4,0,10,7,-9,3,8,-3,9,1,-9,4,4,3,1,6,0,-1,4,-6,0,2,-4,-1,-1,0,1,1,-6,0,0,0,-1,1,2,-1,-1,0,50,20,30,13,6,7,17,14,10,15,-4,-2,10,3,-2,12,-3,-2,7,11,12,3,-1,0,11,0,1,1,-2,2,8,-1,-1,1,-2,1,3,1,2,0,0,1,31,38,-7,7,2,5,18,10,16,0,-7,-10,7,13,12,3,-2,1,11,-3,4,-3,-5,-11,3,2,0,2,0,0,2,1,-1,0,0,0,1,1,1,2,0,0,31,7,24,9,1,8,17,-7,6,9,8,-4,4,0,-5,7,5,-4,13,-7,11,2,3,0,1,-1,2,1,4,1,-1,-1,1,0,1,1,2,0,1,1,3,0,-59,-32,-27,4,1,3,-17,-4,-22,-22,0,4,-12,-3,-8,-10,-1,2,-5,-1,-14,-12,1,2,-2,2,0,2,1,-1,-1,1,-1,2,0,0,-1,1,1,0,1,-1,-63,-34,-29,-13,-8,-5,0,-2,-39,-15,-3,-5,2,2,-26,-10,1,-3,-2,-4,-13,-5,-4,-2,1,1,-6,-5,-2,-2,0,1,-5,-3,0,-1,1,0,-1,-2,-2,-1,7,6,1,15,10,5,-4,8,-7,7,-1,1,4,4,-1,-1,-3,1,-8,4,-6,8,2,0,2,3,5,2,3,0,1,3,4,1,1,0,1,0,1,1,2,0,-34,-23,-11,7,3,4,-3,4,-22,-9,3,-10,-2,-2,-14,-6,2,-3,-1,6,-8,-3,1,-7,0,1,3,-1,3,0,0,0,2,-1,2,0,0,1,1,0,1,0,-9,3,-12,10,1,9,17,-9,-8,0,3,-12,11,-6,-2,1,4,-3,6,-3,-6,-1,-1,-9,8,-1,0,1,1,0,4,-1,-2,0,0,0,4,0,2,1,1,0
14,14030,Fuente Palmera,9849,-38,-18,-20,13,6,7,-14,-13,-2,-19,8,1,-4,-9,5,-14,6,-1,-10,-4,-7,-5,2,2,1,4,5,1,1,0,1,1,3,0,1,0,0,3,2,1,0,0,-3,9,-12,19,12,7,-3,8,-20,3,7,1,3,10,-9,0,2,2,-6,-2,-11,3,5,-1,2,3,1,12,1,0,2,1,1,8,0,0,0,2,0,4,1,0,47,5,42,14,6,8,9,3,13,14,10,-2,-4,-4,2,6,7,-1,13,7,11,8,3,-1,3,3,2,7,-1,0,1,2,1,2,0,0,2,1,1,5,-1,0,58,29,29,30,19,11,-2,2,15,23,10,7,0,-2,9,15,4,0,-2,4,6,8,6,7,5,12,6,6,1,0,2,9,4,4,0,0,3,3,2,2,1,0,72,41,31,42,22,20,12,30,12,-1,17,0,3,18,6,0,10,3,9,12,6,-1,7,-3,8,13,10,10,1,0,5,6,5,6,0,0,3,7,5,4,1,0,96,39,57,32,15,17,27,6,11,34,16,1,7,4,-1,17,9,1,20,2,12,17,7,0,3,6,10,7,5,0,0,4,3,3,4,0,3,2,7,4,1,0,77,48,29,48,26,22,35,-7,12,19,6,8,19,0,5,18,3,4,16,-7,7,1,3,4,11,11,13,10,2,1,7,4,5,10,0,0,4,7,8,0,2,1,191,114,77,127,64,63,34,58,50,47,10,-11,19,28,34,29,4,-1,15,30,16,18,6,-10,16,45,36,23,7,0,7,22,22,11,2,0,9,23,14,12,5,0,21,-1,22,32,5,27,-2,8,-1,5,12,0,-3,0,6,-5,3,0,1,8,-7,10,9,0,9,7,8,5,3,0,1,-1,4,0,1,0,8,8,4,5,2,0,8,16,-8,25,11,14,-1,-6,6,9,2,-2,-6,-1,12,6,5,0,5,-5,-6,3,-3,-2,6,8,7,3,1,0,2,4,2,2,1,0,4,4,5,1,0,0,116,57,59,32,17,15,32,24,29,5,20,6,20,14,13,2,6,2,12,10,16,3,14,4,6,10,11,3,2,0,4,7,4,1,1,0,2,3,7,2,1,0,57,32,25,32,19,13,17,20,15,5,-6,9,6,5,15,8,-3,3,11,15,0,-3,-3,6,13,8,5,5,1,0,8,3,4,3,1,0,5,5,1,2,0,0,1,0,1,27,13,14,-2,10,-4,3,6,-11,-6,2,6,-1,2,-3,4,8,-10,4,4,-8,8,8,9,2,-1,1,5,5,4,-1,-1,1,3,3,5,3,0,0,-48,-21,-27,3,0,3,-9,4,-20,-12,-5,-7,-4,5,-8,-11,-2,-3,-5,-1,-12,-1,-3,-4,3,3,-1,0,0,-2,-1,1,0,1,-1,0,4,2,-1,-1,1,-2,-76,-42,-34,-6,-5,-1,-10,-18,-37,-8,-10,3,-4,-20,-13,-5,-10,7,-6,2,-24,-3,0,-4,2,-2,0,-2,-2,-2,0,-1,-1,-1,-1,-1,2,-1,1,-1,-1,-1,3,8,-5,-8,-4,-4,7,3,-32,19,6,0,9,2,-23,13,3,2,-2,1,-9,6,3,-2,-1,-5,0,-2,1,-1,0,-3,0,-1,1,-1,-1,-2,0,-1,0,0,-14,1,-15,11,8,3,-14,11,-19,-10,14,-1,2,-1,-7,-4,8,1,-16,12,-12,-6,6,-2,5,5,-3,2,2,0,4,1,-1,2,1,1,1,4,-2,0,1,-1,14,2,12,24,11,13,11,-10,-4,0,0,15,5,-4,-4,3,0,3,6,-6,0,-3,0,12,8,6,3,3,2,0,5,1,2,1,1,0,3,5,1,2,1,0
14,14035,Hinojosa del Duque,7992,-3,-6,3,10,5,5,8,-3,-15,-3,0,8,5,-4,-9,-2,-1,4,3,1,-6,-1,1,4,4,2,3,0,1,0,2,0,2,0,1,0,2,2,1,0,0,0,-12,-1,-11,7,5,2,0,-6,-9,-5,7,1,-1,2,-6,-1,2,3,1,-8,-3,-4,5,-2,1,2,2,1,0,1,1,1,2,1,0,0,0,1,0,0,0,1,-24,-11,-13,7,4,3,-10,0,-15,1,1,-1,-3,-2,-9,4,-1,0,-7,2,-6,-3,2,-1,2,0,2,3,0,0,2,0,0,2,0,0,0,0,2,1,0,0,-29,-13,-16,5,3,2,-3,-9,-7,-4,-4,0,0,-5,-7,0,-1,0,-3,-4,0,-4,-3,0,0,2,1,0,0,2,0,1,1,0,0,1,0,1,0,0,0,1,-16,-13,-3,19,10,9,-6,0,-10,-2,1,3,-9,-1,0,-3,1,1,3,1,-10,1,0,2,2,5,6,2,0,4,1,2,3,2,0,2,1,3,3,0,0,2,-18,-2,-16,22,13,9,-5,6,-16,5,-1,-6,-9,8,-7,5,-1,2,4,-2,-9,0,0,-8,3,9,8,2,0,0,3,3,5,2,0,0,0,6,3,0,0,0,-21,-5,-16,12,7,5,9,-6,-22,-3,10,-11,7,-1,-7,-4,4,-6,2,-5,-15,1,6,-5,5,5,-4,3,2,1,2,4,-3,3,0,1,3,1,-1,0,2,0,7,6,1,19,12,7,4,-1,-7,3,3,4,5,-3,-3,3,0,4,-1,2,-4,0,3,0,1,7,3,4,1,3,1,4,4,3,0,0,0,3,-1,1,1,3,-24,-6,-18,11,8,3,-7,-6,-22,-6,6,9,-2,-4,-9,-1,4,6,-5,-2,-13,-5,2,3,2,2,2,4,-1,1,1,0,3,3,0,1,1,2,-1,1,-1,0,24,12,12,15,8,7,3,4,3,5,-1,9,2,7,-1,1,-1,3,1,-3,4,4,0,6,1,5,6,2,0,1,0,5,2,0,0,1,1,0,4,2,0,0,12,0,12,-5,-7,2,-4,-1,-9,16,11,0,-5,-7,-2,9,4,1,1,6,-7,7,7,-1,-1,-1,-1,-3,0,1,-1,-2,-1,-3,0,0,0,1,0,0,0,1,-23,-6,-17,0,2,-2,-6,-11,4,-18,9,-1,-3,-6,3,-2,7,-5,-3,-5,1,-16,2,4,0,1,1,-3,2,-1,0,0,1,0,1,0,0,1,0,-3,1,-1,-40,-13,-27,-6,-4,-2,5,-21,-16,4,-3,-9,-2,-1,-12,5,-1,-2,7,-20,-4,-1,-2,-7,1,2,-8,-2,-1,2,0,0,-3,-1,-1,1,1,2,-5,-1,0,1,-13,-11,-2,-10,-6,-4,-3,-3,-13,-9,0,15,2,-6,-6,-8,-2,9,-5,3,-7,-1,2,6,0,-4,1,-3,-3,-1,1,-2,-1,-2,-2,0,-1,-2,2,-1,-1,-1,-52,-25,-27,-15,-10,-5,-19,-10,-22,-6,-9,14,-14,-5,-6,-2,-1,4,-5,-5,-16,-4,-8,10,-3,-2,-8,-4,0,2,-3,-1,-4,-3,0,1,0,-1,-4,-1,0,1,-24,-6,-18,-5,-4,-1,-3,-17,-17,12,-4,6,0,-5,-10,8,-3,2,-3,-12,-7,4,-1,4,-1,0,0,-5,0,0,-1,0,-1,-3,0,0,0,0,1,-2,0,0,-17,-7,-10,2,0,2,-5,-5,-31,4,5,11,-3,0,-18,-1,5,7,-2,-5,-13,5,0,4,1,0,-1,0,1,1,1,0,-1,-1,0,1,0,0,0,1,1,0,-16,-11,-5,3,1,2,-6,-9,-12,-8,13,9,-4,-9,-3,-2,8,4,-2,0,-9,-6,5,5,0,1,1,1,0,0,0,1,-1,1,0,0,0,0,2,0,0,0
14,14038,Lucena,35837,391,212,179,167,108,59,31,122,129,5,21,74,22,79,65,4,11,25,9,43,64,1,10,49,27,55,63,17,4,1,13,41,41,10,3,0,14,14,22,7,1,1,440,248,192,287,162,125,82,117,112,73,19,35,44,76,66,41,9,11,38,41,46,32,10,24,59,70,106,39,11,2,33,40,63,21,4,1,26,30,43,18,7,1,701,384,317,347,202,145,109,171,189,114,50,63,55,84,119,49,37,34,54,87,70,65,13,29,68,95,100,62,14,7,30,57,68,36,7,4,38,38,32,26,7,3,433,194,239,233,120,113,65,100,136,63,20,44,24,52,58,40,0,22,41,48,78,23,20,22,38,69,81,35,8,1,19,37,44,17,3,0,19,32,37,18,5,1,420,222,198,334,196,138,63,94,152,32,11,57,45,40,86,20,-1,25,18,54,66,12,12,32,47,81,111,68,18,2,29,40,71,45,7,1,18,41,40,23,11,1,349,201,148,315,209,106,27,98,117,50,31,21,1,63,80,34,16,4,26,35,37,16,15,17,35,90,115,55,13,6,17,62,83,38,5,3,18,28,32,17,8,3,387,176,211,342,182,160,82,62,114,52,23,43,40,29,50,32,13,12,42,33,64,20,10,31,65,88,110,49,22,3,29,50,62,26,12,2,36,38,48,23,10,1,661,315,346,535,271,264,163,198,152,100,32,6,70,89,77,43,24,5,93,109,75,57,8,1,128,162,151,74,17,1,65,77,75,38,15,0,63,85,76,36,2,1,219,108,111,258,122,136,22,68,89,8,12,9,22,28,49,4,1,0,0,40,40,4,11,9,44,74,86,35,11,4,21,33,52,11,2,1,23,41,34,24,9,3,-207,-125,-82,-96,-81,-15,13,-61,-136,-51,0,24,-9,-13,-80,-34,1,6,22,-48,-56,-17,-1,18,37,-13,-63,-43,-14,-2,15,-5,-49,-34,-7,-2,22,-8,-14,-9,-7,0,78,-4,82,32,-2,34,12,47,-5,0,-6,9,-7,16,-8,-9,-6,5,19,31,3,9,0,4,5,45,-4,-13,-6,-2,-3,19,-7,-12,-1,1,8,26,3,-1,-5,-3,-110,-52,-58,99,51,48,-37,-34,-32,-16,-5,17,-15,-26,-2,-10,0,4,-22,-8,-30,-6,-5,13,18,35,16,21,5,0,12,10,16,6,4,0,6,25,0,15,1,0,-3,-13,10,-40,-41,1,13,1,10,-38,-3,12,20,11,-16,-38,2,11,-7,-10,26,0,-5,1,-1,20,-25,-25,-5,-5,-5,8,-23,-14,-4,-3,4,12,-2,-11,-1,-2,-161,-83,-78,-134,-78,-56,11,-15,-77,-76,-30,19,9,-2,-27,-54,-13,-1,2,-13,-50,-22,-17,20,-3,-11,-42,-61,-17,-2,0,-6,-25,-40,-7,-1,-3,-5,-17,-21,-10,-1,-197,-57,-140,-104,-47,-57,-61,-18,-67,-35,-31,0,-11,-16,-22,-13,-10,5,-50,-2,-45,-22,-21,-5,-27,3,-52,-22,-12,-1,-19,4,-28,-5,-3,0,-8,-1,-24,-17,-9,-1,-155,-82,-73,-53,-39,-14,-48,-20,-44,-67,-7,35,-25,-6,-32,-34,-2,17,-23,-14,-12,-33,-5,18,-8,12,-21,-35,-2,0,-3,8,-13,-27,-4,0,-5,4,-8,-8,2,0,-21,-10,-11,60,27,33,-4,-10,-32,0,32,-13,-6,-1,-14,-7,14,-5,2,-9,-18,7,18,-8,18,19,1,4,11,2,9,11,5,-5,3,0,9,8,-4,9,8,2,-133,-79,-54,-119,-63,-56,-4,-20,-48,-55,-21,3,-18,-3,-31,-24,-11,2,14,-17,-17,-31,-10,1,-7,11,-49,-51,-22,-1,-8,8,-24,-26,-13,-1,1,3,-25,-25,-9,0
14,14042,Montilla,22910,-26,-3,-23,21,11,10,-11,6,-21,-9,11,1,-5,10,3,-7,-1,-3,-6,-4,-24,-2,12,4,0,8,6,4,3,0,0,5,3,2,1,0,0,3,3,2,2,0,31,15,16,33,16,17,15,6,-11,16,-1,3,5,6,-2,3,0,3,10,0,-9,13,-1,0,6,7,9,6,3,2,4,6,2,2,1,1,2,1,7,4,2,1,39,13,26,62,28,34,5,21,0,13,3,-4,-9,8,8,2,2,1,14,13,-8,11,1,-5,12,15,21,11,1,2,2,8,10,6,1,1,10,7,11,5,0,1,-1,-28,27,33,14,19,-14,19,-30,-17,11,33,-10,6,-24,-8,0,11,-4,13,-6,-9,11,22,4,7,14,5,3,0,0,4,6,3,1,0,4,3,8,2,2,0,125,62,63,87,40,47,32,31,2,27,18,9,14,19,4,13,8,1,18,12,-2,14,10,8,10,29,31,9,4,3,6,9,17,5,2,1,4,20,14,4,2,2,113,66,47,77,39,38,36,21,13,30,9,6,17,15,1,25,6,3,19,6,12,5,3,3,22,27,18,6,4,0,13,15,7,2,2,0,9,12,11,4,2,0,73,30,43,86,34,52,34,18,-21,24,13,3,14,4,-10,10,7,4,20,14,-11,14,6,-1,36,23,7,11,5,1,12,6,5,6,3,0,24,17,2,5,2,1,119,76,43,134,78,56,26,36,21,21,11,6,16,30,16,13,3,0,10,6,5,8,8,6,30,44,35,19,4,0,14,28,22,11,1,0,16,16,13,8,3,0,24,-17,41,26,-4,30,18,-3,-10,-16,18,18,-4,-3,-11,-11,5,6,22,0,1,-5,13,12,8,7,12,-6,6,-1,1,-4,7,-7,0,-1,7,11,5,1,6,0,73,39,34,34,7,27,40,-14,15,20,12,-2,24,-7,5,6,11,1,16,-7,10,14,1,-3,23,5,6,-3,0,2,9,2,0,-6,-1,2,14,3,6,3,1,0,-40,-36,-4,-3,-12,9,19,-3,-54,7,-10,-3,9,-5,-33,2,-9,-2,10,2,-21,5,-1,-1,8,9,-17,-6,-1,4,3,-1,-10,-3,-3,2,5,10,-7,-3,2,2,-38,-27,-11,12,1,11,3,1,-2,-21,-7,-10,0,-4,-6,-9,-1,-4,3,5,4,-12,-6,-6,3,8,-2,3,1,-1,0,2,-4,4,2,-1,3,6,2,-1,-1,0,-59,-32,-27,-32,-17,-15,-7,-16,-44,-7,1,15,-11,-9,-14,-7,1,7,4,-7,-30,0,0,8,-6,-7,-11,-6,-4,1,-8,-4,-1,-4,-1,0,2,-3,-10,-2,-3,1,-49,-35,-14,-25,-11,-14,-9,-7,-22,-10,-12,10,-4,-4,-24,-1,-11,6,-5,-3,2,-9,-1,4,-9,5,-9,-11,-4,-1,-3,0,-4,-7,-1,0,-6,5,-5,-4,-3,-1,-36,6,-42,-15,3,-18,-6,-18,-6,13,-11,-5,8,1,-4,8,-3,-4,-14,-19,-2,5,-8,-1,-12,-9,8,-3,3,-3,-2,-1,6,-2,2,-1,-10,-8,2,-1,1,-2,-89,-37,-52,19,5,14,-5,-30,-29,-25,-7,7,-3,-12,-12,-11,-1,1,-2,-18,-17,-14,-6,6,10,1,2,4,1,0,6,0,-4,3,0,0,4,1,6,1,1,0,-112,-67,-45,-44,-21,-23,-23,-27,-58,-15,3,12,-18,-15,-28,-8,1,3,-5,-12,-30,-7,2,9,-6,-5,-21,-8,-4,0,0,-2,-11,-6,-2,0,-6,-3,-10,-2,-2,0,-70,-12,-58,0,-1,1,-4,-43,-40,11,-6,12,2,-23,-4,1,-2,11,-6,-20,-36,10,-4,1,5,-4,2,-2,-3,0,2,-3,4,-4,-1,0,3,-1,-2,2,-2,0
14,14043,Montoro,9481,-38,-19,-19,7,2,5,5,-9,-21,-2,-1,-5,3,-9,-8,-1,-1,-1,2,0,-13,-1,0,-4,2,2,3,0,0,0,0,1,1,0,0,0,2,1,2,0,0,0,29,19,10,12,8,4,16,8,-3,3,5,1,7,5,1,4,0,2,9,3,-4,-1,5,-1,4,3,4,1,0,0,1,3,3,1,0,0,3,0,1,0,0,0,0,8,-8,23,19,4,0,11,-12,-2,1,1,-1,8,-7,1,-1,8,1,3,-5,-3,2,-7,6,6,5,4,0,1,3,6,5,3,0,1,3,0,0,1,0,0,9,24,-15,44,33,11,-5,8,-10,19,10,-14,10,8,-10,13,3,-1,-15,0,0,6,7,-13,7,12,5,16,2,1,7,9,3,10,2,1,0,3,2,6,0,0,90,57,33,80,50,30,7,21,20,19,9,15,7,9,16,14,6,6,0,12,4,5,3,9,7,21,33,15,3,0,2,11,23,11,3,0,5,10,10,4,0,0,115,71,44,103,70,33,19,37,39,18,-4,4,3,31,24,13,-5,3,16,6,15,5,1,1,8,40,41,11,3,0,4,31,26,8,1,0,4,9,15,3,2,0,33,15,18,66,29,37,27,2,-12,-2,14,1,3,5,-9,3,8,4,24,-3,-3,-5,6,-3,31,8,20,2,3,1,8,8,9,1,1,1,23,0,11,1,2,0,101,59,42,114,71,43,25,27,24,4,7,13,15,21,15,3,1,4,10,6,9,1,6,9,16,39,37,16,5,1,9,24,24,12,2,0,7,15,13,4,3,1,-25,-1,-24,15,9,6,-3,6,-23,-3,0,-3,-2,8,-8,-2,0,3,-1,-2,-15,-1,0,-6,0,10,3,1,0,1,-1,6,1,2,0,1,1,4,2,-1,0,0,-12,4,-16,7,6,1,-5,6,-6,-6,9,-11,1,5,-4,1,5,-5,-6,1,-2,-7,4,-6,2,0,0,3,1,0,2,1,1,1,0,0,0,-1,-1,2,1,0,3,-9,12,9,0,9,5,0,-1,-3,2,0,3,-2,-3,-9,0,3,2,2,2,6,2,-3,4,6,4,-5,0,-1,2,3,0,-5,0,0,2,3,4,0,0,-1,-41,-19,-22,2,-6,8,1,-6,-21,-10,10,-16,-4,-2,-12,-4,5,-3,5,-4,-9,-6,5,-13,4,0,-2,0,0,0,1,-2,-4,-1,0,0,3,2,2,1,0,0,-71,-57,-14,-12,-11,-1,-7,2,-42,-14,-9,-1,0,-4,-30,-14,-7,0,-7,6,-12,0,-2,-1,1,6,-11,-5,-3,0,6,1,-9,-7,-2,0,-5,5,-2,2,-1,0,-45,-35,-10,3,-1,4,6,0,-33,-6,-8,-4,-1,3,-23,-6,-4,-4,7,-3,-10,0,-4,0,7,5,-8,-2,1,0,4,3,-5,-3,0,0,3,2,-3,1,1,0,-69,-51,-18,9,2,7,-8,-10,-25,-7,-7,-13,-10,-8,-15,-5,-4,-9,2,-2,-10,-2,-3,-4,3,1,3,0,1,0,0,1,0,0,1,0,3,0,3,0,0,0,28,9,19,17,7,10,20,-9,-2,0,3,16,5,-7,0,-4,5,10,15,-2,-2,4,-2,6,3,4,1,3,2,4,1,1,0,2,1,2,2,3,1,1,1,2,-91,-47,-44,4,2,2,-18,-19,-16,-25,-1,-10,-15,-10,-7,-13,1,-3,-3,-9,-9,-12,-2,-7,3,-1,0,2,1,0,0,-1,1,1,1,0,3,0,-1,1,0,0,-67,-26,-41,11,6,5,4,2,-33,-10,-6,-16,1,4,-17,1,-9,-4,3,-2,-16,-11,3,-12,1,10,0,1,-2,0,0,5,1,1,-1,0,1,5,-1,0,-1,0
14,14049,Palma del Río,19243,81,37,44,28,18,10,43,-14,23,8,13,5,29,-11,3,3,10,2,14,-3,20,5,3,3,7,4,8,2,4,2,6,3,4,1,3,0,1,1,4,1,1,2,43,20,23,54,34,20,-5,-24,22,17,13,22,-4,-17,19,11,8,4,-1,-7,3,6,5,18,5,11,23,8,6,1,2,7,15,6,4,0,3,4,8,2,2,1,281,145,136,181,112,69,46,54,77,52,31,16,25,17,48,37,10,9,21,37,29,15,21,7,27,49,53,40,6,6,16,29,35,26,3,3,11,20,18,14,3,3,261,150,111,161,84,77,62,41,88,55,13,1,29,28,46,37,7,2,33,13,42,18,6,-1,25,41,55,29,5,4,9,25,25,19,3,1,16,16,30,10,2,3,273,178,95,227,138,89,27,61,97,68,19,1,7,45,74,32,15,2,20,16,23,36,4,-1,23,65,90,39,8,1,14,39,61,18,4,1,9,26,29,21,4,0,246,129,117,162,90,72,63,53,54,45,18,12,24,41,31,20,11,3,39,12,23,25,7,9,29,54,41,29,4,4,13,24,26,22,3,2,16,30,15,7,1,2,278,159,119,173,84,89,93,62,45,37,14,23,63,32,26,23,4,8,30,30,19,14,10,15,58,48,35,21,7,3,30,21,18,9,3,2,28,27,17,12,4,1,541,309,232,560,330,230,73,168,149,114,31,-1,40,103,72,68,20,1,33,65,77,46,11,-2,62,192,152,117,24,5,37,118,86,70,13,3,25,74,66,47,11,2,107,63,44,167,100,67,30,25,23,21,4,-4,14,13,8,21,2,0,16,12,15,0,2,-4,37,48,41,32,7,1,21,27,24,24,3,0,16,21,17,8,4,1,-33,-24,-9,-55,-59,4,8,-8,-15,-16,0,-6,8,-5,-11,-12,2,-3,0,-3,-4,-4,-2,-3,16,-19,-23,-26,-5,2,5,-15,-25,-19,-4,0,11,-4,2,-7,-1,2,-129,-93,-36,-83,-48,-35,-22,-20,-48,-23,-4,-12,-24,-14,-35,-13,0,-5,2,-6,-13,-10,-4,-7,-22,-7,-27,-16,-5,-8,-13,-9,-13,-8,-3,-3,-9,2,-14,-8,-2,-5,44,35,9,100,56,44,9,-8,-18,22,9,25,10,-4,3,11,3,9,-1,-4,-21,11,6,16,27,22,23,21,6,-1,13,10,17,11,3,0,14,12,6,10,3,-1,21,10,11,94,47,47,4,-2,-9,20,9,0,3,7,-14,0,10,1,1,-9,5,20,-1,-1,19,22,15,22,10,4,15,14,1,8,5,3,4,8,14,14,5,1,-8,-1,-7,57,23,34,9,14,-34,6,-6,-1,3,8,-14,2,-4,3,6,6,-20,4,-2,-4,9,23,7,10,3,3,2,13,4,1,1,1,7,10,3,9,2,2,56,40,16,97,48,49,14,25,3,7,9,-5,17,17,-2,-6,15,-2,-3,8,5,13,-6,-3,14,26,26,12,16,3,6,13,12,6,9,2,8,13,14,6,7,1,-47,-39,-8,-3,-6,3,15,-5,-16,-38,-11,6,3,8,-19,-33,-6,5,12,-13,3,-5,-5,1,10,8,-7,-8,-3,-3,4,5,-6,-7,-2,-1,6,3,-1,-1,-1,-2,-2,-9,7,96,47,49,22,-21,-20,8,8,4,11,-7,-23,10,4,-1,11,-14,3,-2,4,5,19,26,12,23,14,1,9,10,4,13,11,0,10,16,8,10,3,1,-6,14,-20,86,42,44,-5,-8,-29,7,23,2,6,-6,-5,-2,19,0,-11,-2,-24,9,4,2,16,22,15,19,10,0,11,6,4,12,8,-1,5,16,11,7,2,1
14,14052,Peñarroya-Pueblonuevo,13352,-190,-92,-98,20,9,11,-25,-60,-63,-33,-8,0,-12,-30,-29,-22,-1,1,-13,-30,-34,-11,-7,-1,7,1,2,4,4,2,4,0,0,2,1,2,3,1,2,2,3,0,-136,-65,-71,17,8,9,-34,-42,-30,-12,-2,-14,-18,-27,-15,-3,2,-3,-16,-15,-15,-9,-4,-11,3,3,3,6,1,1,2,1,1,2,1,1,1,2,2,4,0,0,10,9,1,34,12,22,2,4,0,-2,15,-12,0,-3,8,-2,10,-5,2,7,-8,0,5,-7,8,8,4,4,9,1,3,-1,2,2,6,0,5,9,2,2,3,1,-73,-31,-42,34,17,17,-21,-19,-35,-9,12,3,-11,-12,-16,-8,14,5,-10,-7,-19,-1,-2,-2,5,10,6,2,8,3,2,5,2,1,5,2,3,5,4,1,3,1,-106,-50,-56,21,11,10,-11,-40,-56,-6,4,-2,1,-20,-33,-5,4,0,-12,-20,-23,-1,0,-2,6,3,3,6,1,1,5,1,0,3,1,1,1,2,3,3,0,0,-34,-15,-19,28,10,18,12,-14,-23,-13,-5,6,8,-14,-4,-9,-6,8,4,0,-19,-4,1,-2,9,4,2,7,3,2,4,0,2,3,0,1,5,4,0,4,3,1,-58,-14,-44,23,14,9,3,-10,-56,-6,14,-5,2,2,-25,0,6,0,1,-12,-31,-6,8,-5,6,5,2,5,1,4,5,3,2,1,1,2,1,2,0,4,0,2,12,17,-5,14,6,8,-1,3,-14,-2,3,21,-9,17,-8,-1,2,13,8,-14,-6,-1,1,8,0,7,2,3,3,-1,0,4,0,0,2,0,0,3,2,3,1,-1,86,54,32,36,20,16,21,14,2,13,15,13,4,12,7,9,9,5,17,2,-5,4,6,8,5,8,14,8,3,-2,3,5,6,5,2,-1,2,3,8,3,1,-1,3,15,-12,16,11,5,6,-3,-11,18,-7,-1,11,0,2,8,-6,0,-5,-3,-13,10,-1,-1,5,2,5,2,1,0,5,1,2,2,1,0,0,1,3,0,0,0,50,38,12,17,5,12,18,-8,-7,16,14,15,11,1,-2,12,5,11,7,-9,-5,4,9,4,5,3,2,4,1,1,0,2,1,1,0,0,5,1,1,3,1,1,-19,-27,8,7,3,4,4,-2,-15,-10,-7,6,-2,-5,-12,-8,-5,4,6,3,-3,-2,-2,2,-1,4,-3,1,2,3,0,3,-1,-1,1,1,-1,1,-2,2,1,2,17,4,13,6,1,5,17,7,-1,2,-3,-3,7,0,-4,4,-2,0,10,7,3,-2,-1,-3,1,1,4,-1,0,1,0,0,1,0,0,0,1,1,3,-1,0,1,-79,-28,-51,-4,-4,0,-17,-3,-32,-25,1,-2,-15,3,-11,-14,3,4,-2,-6,-21,-11,-2,-6,0,1,-2,-3,0,0,0,0,-2,-2,-1,1,0,1,0,-1,1,-1,-97,-61,-36,-7,-6,-1,-16,-44,-58,10,-7,19,-10,-27,-35,8,-5,8,-6,-17,-23,2,-2,11,2,-2,-2,-2,-1,-2,0,-2,-1,-1,-1,-1,2,0,-1,-1,0,-1,-67,-20,-47,-19,-13,-6,9,-25,-54,5,-16,15,12,-13,-28,5,-1,4,-3,-12,-26,0,-15,11,-1,-2,-15,0,-4,3,-1,-2,-8,-3,0,1,0,0,-7,3,-4,2,-73,-52,-21,-15,-11,-4,3,-16,-51,-18,8,3,-2,-13,-23,-15,3,1,5,-3,-28,-3,5,2,-3,-2,-5,-3,0,-3,-2,-1,-2,-4,-1,-1,-1,-1,-3,1,1,-2,-71,-47,-24,6,5,1,-6,-33,-36,-21,1,23,-9,-14,-15,-21,4,7,3,-19,-21,0,-3,16,3,3,-6,6,0,0,0,1,-3,5,1,1,3,2,-3,1,-1,-1
14,14053,Posadas,7167,-8,-9,1,7,3,4,-3,-7,-11,-9,10,12,-5,-4,-8,-6,4,9,2,-3,-3,-3,6,3,1,0,0,0,5,1,0,0,0,0,2,1,1,0,0,0,3,0,-22,-9,-13,5,3,2,6,-3,-24,1,-2,-1,4,0,-15,4,-1,-1,2,-3,-9,-3,-1,0,0,3,2,0,0,0,0,2,1,0,0,0,0,1,1,0,0,0,-22,-8,-14,6,4,2,7,-19,-13,3,10,-9,9,-8,-12,0,8,-4,-2,-11,-1,3,2,-5,0,0,1,2,3,0,0,0,0,2,2,0,0,0,1,0,1,0,125,65,60,35,20,15,34,20,33,31,10,-2,19,9,15,15,4,0,15,11,18,16,6,-2,4,7,15,6,3,0,2,6,7,4,1,0,2,1,8,2,2,0,78,51,27,33,15,18,21,2,21,16,13,1,12,3,15,11,6,3,9,-1,6,5,7,-2,8,4,10,6,3,2,4,1,5,2,1,2,4,3,5,4,2,0,70,36,34,18,10,8,11,7,6,20,15,5,6,7,2,5,10,2,5,0,4,15,5,3,2,-1,2,6,8,1,1,-2,2,3,6,0,1,1,0,3,2,1,27,24,3,10,5,5,7,-8,12,13,0,3,5,-6,16,7,-1,1,2,-2,-4,6,1,2,3,2,2,0,2,1,1,2,0,0,1,1,2,0,2,0,1,0,-54,-32,-22,22,8,14,-5,-14,-31,-6,-1,1,-6,-5,-14,-6,-3,1,1,-9,-17,0,2,0,2,6,6,1,4,3,0,2,2,1,1,2,2,4,4,0,3,1,-38,-24,-14,17,10,7,-7,-15,-2,1,1,-14,-8,-10,-4,0,3,-4,1,-5,2,1,-2,-10,1,1,4,9,2,0,1,1,1,5,2,0,0,0,3,4,0,0,18,21,-3,6,3,3,2,-24,10,-5,6,26,8,-10,13,-8,1,15,-6,-14,-3,3,5,11,0,4,0,1,1,0,0,2,0,0,1,0,0,2,0,1,0,0,14,15,-1,8,2,6,-2,-9,-6,3,12,15,0,-3,0,6,4,9,-2,-6,-6,-3,8,6,2,0,2,2,1,1,1,0,1,0,0,0,1,0,1,2,1,1,-26,-2,-24,-6,-3,-3,-3,-1,-6,-6,2,-9,-4,2,3,2,0,-4,1,-3,-9,-8,2,-5,1,0,1,-11,2,1,1,-1,2,-6,0,1,0,1,-1,-5,2,0,-4,2,-6,-2,-2,0,-13,4,-4,-2,8,4,-4,5,1,-6,5,1,-9,-1,-5,4,3,3,-1,0,1,-3,1,0,-1,0,2,-3,0,0,0,0,-1,0,1,0,23,21,2,2,0,2,-4,0,3,8,8,6,-2,3,5,3,5,6,-2,-3,-2,5,3,0,0,1,-2,2,1,0,0,1,-1,-1,1,0,0,0,-1,3,0,0,0,2,-2,7,5,2,-10,3,-1,-3,8,3,-6,7,1,-3,5,-2,-4,-4,-2,0,3,5,2,3,-1,0,2,0,2,1,-1,0,2,0,0,2,0,0,0,0,-71,-32,-39,-2,-2,0,-10,-15,-30,-17,3,-1,-6,-13,-11,-7,2,2,-4,-2,-19,-10,1,-3,0,0,0,-3,2,-1,0,-1,0,-1,1,-1,0,1,0,-2,1,0,-31,-14,-17,6,4,2,5,-9,-17,0,-5,-1,2,-4,-13,4,-5,3,3,-5,-4,-4,0,-4,1,3,-1,1,1,0,1,2,0,1,0,0,0,1,-1,0,1,0,-64,-30,-34,-1,-1,0,-10,-14,-14,-12,0,-14,-5,-6,-7,-8,-1,-3,-5,-8,-7,-4,1,-11,1,0,-3,-1,0,2,1,0,-1,-2,0,1,0,0,-2,1,0,1
14,14054,Pozoblanco,16218,94,53,41,19,12,7,-19,29,43,20,2,15,-13,22,30,6,3,2,-6,7,13,14,-1,13,2,3,10,1,2,1,0,2,7,1,1,1,2,1,3,0,1,0,97,56,41,77,58,19,19,-3,51,28,1,3,-2,2,42,16,0,0,21,-5,9,12,1,3,5,16,39,16,1,0,0,10,34,13,1,0,5,6,5,3,0,0,150,75,75,137,64,73,35,34,53,0,13,8,22,19,14,7,4,3,13,15,39,-7,9,5,28,40,43,17,4,3,11,18,20,12,0,1,17,22,23,5,4,2,133,86,47,134,76,58,16,42,18,25,2,24,16,25,15,13,1,14,0,17,3,12,1,10,25,44,40,18,5,1,16,25,26,6,3,0,9,19,14,12,2,1,203,114,89,160,104,56,10,37,80,29,19,22,6,20,37,21,10,17,4,17,43,8,9,5,17,50,67,18,4,4,11,31,43,15,1,3,6,19,24,3,3,1,220,122,98,127,69,58,44,39,56,48,12,13,32,21,35,21,4,3,12,18,21,27,8,10,16,36,35,29,5,5,10,21,18,17,2,0,6,15,17,12,3,5,133,95,38,144,69,75,13,18,38,36,21,9,7,22,27,21,13,5,6,-4,11,15,8,4,26,36,37,30,11,4,12,23,16,13,4,1,14,13,21,17,7,3,246,148,98,219,132,87,45,65,74,59,14,-11,33,33,51,31,10,-10,12,32,23,28,4,-1,27,63,70,42,12,3,16,36,46,24,7,3,11,27,24,18,5,0,40,11,29,66,28,38,11,-4,12,10,15,-2,-9,2,2,8,7,1,20,-6,10,2,8,-3,16,10,25,10,5,-2,4,0,12,7,4,-1,12,10,13,3,1,-1,80,51,29,13,-6,19,32,2,26,-7,21,-1,28,-4,9,-1,11,1,4,6,17,-6,10,-2,12,13,-15,-11,10,3,7,5,-16,-6,1,2,5,8,1,-5,9,1,-96,-45,-51,-95,-63,-32,-10,-12,-21,-35,-13,-7,-8,-8,-1,-16,-10,-4,-2,-4,-20,-19,-3,-3,-13,-1,-21,-31,-21,-8,-12,-5,-11,-20,-13,-2,-1,4,-10,-11,-8,-6,54,30,24,41,20,21,24,-13,-14,36,2,18,20,-4,-15,20,-1,9,4,-9,1,16,3,9,8,18,3,7,3,1,6,10,0,1,2,0,2,8,3,6,1,1,-115,-72,-43,-19,-17,-2,5,-39,-37,-13,-6,-21,-2,-22,-22,-15,-3,-7,7,-17,-15,2,-3,-14,0,-3,-10,-8,3,-2,-1,-4,-5,-7,0,-1,1,1,-5,-1,3,-1,-29,-4,-25,-23,-19,-4,9,13,-17,-13,-1,-19,2,16,-6,-6,0,-9,7,-3,-11,-7,-1,-10,-1,-3,-9,-11,-2,2,-3,0,-5,-11,-1,0,2,-3,-4,0,-1,2,-135,-83,-52,-53,-47,-6,-29,-16,-32,-39,-1,-14,-11,-11,-24,-24,-2,-11,-18,-5,-8,-15,1,-3,0,-4,-19,-19,-9,-2,-3,-3,-18,-13,-7,-3,3,-1,-1,-6,-2,1,-92,-39,-53,-29,-11,-18,11,-40,-40,3,-20,-5,1,-15,-11,-2,-5,-5,10,-25,-29,5,-15,0,2,-8,-15,-3,-3,-2,3,-7,-4,-1,-1,-1,-1,-1,-11,-2,-2,-1,10,-21,31,-13,-5,-8,3,-10,1,6,15,-8,-7,-15,-8,5,5,-4,10,5,9,1,10,-4,0,4,-7,-2,-7,-2,-2,1,-1,-2,-3,1,2,3,-6,0,-4,-3,-52,-48,-4,-15,-9,-6,9,-17,-17,-5,-1,-21,-4,-12,-20,-6,3,-5,13,-5,3,1,-4,-16,-7,6,-6,-10,0,1,-6,0,1,-6,0,1,-1,6,-7,-4,0,0
14,14055,Priego de Córdoba,22208,79,43,36,31,19,12,14,25,-12,18,20,9,12,9,-9,16,8,4,2,16,-3,2,12,5,1,16,8,4,2,0,1,9,4,3,2,0,0,7,4,1,0,0,71,62,9,102,59,43,12,-9,18,20,19,7,15,-3,25,5,11,5,-3,-6,-7,15,8,2,16,18,45,15,2,3,10,13,25,6,1,1,6,5,20,9,1,2,159,96,63,118,55,63,61,51,20,21,20,-15,27,21,24,17,17,-9,34,30,-4,4,3,-6,28,29,37,17,6,1,8,13,20,11,3,0,20,16,17,6,3,1,133,65,68,80,46,34,39,13,22,18,28,16,17,5,14,2,16,13,22,8,8,16,12,3,14,23,21,11,10,1,9,14,12,4,6,1,5,9,9,7,4,0,129,73,56,99,63,36,39,30,12,19,25,0,26,14,8,10,13,1,13,16,4,9,12,-1,21,24,28,15,10,0,17,15,17,10,4,0,4,9,11,5,6,0,103,63,40,65,37,28,18,19,26,-1,19,22,9,13,25,-1,9,10,9,6,1,0,10,12,8,25,18,4,7,3,4,14,11,3,3,2,4,11,7,1,4,1,11,17,-6,47,20,27,-3,-14,-11,-11,48,0,8,-10,-1,-11,27,2,-11,-4,-10,0,21,-2,9,6,9,9,11,3,4,2,5,4,5,0,5,4,4,5,6,3,232,103,129,130,81,49,71,35,55,46,22,3,24,10,24,32,11,1,47,25,31,14,11,2,12,24,41,28,19,5,11,11,28,19,9,3,1,13,13,9,10,2,105,54,51,74,34,40,46,-2,25,23,11,-4,18,3,2,21,1,5,28,-5,23,2,10,-9,22,23,20,7,0,1,9,12,8,5,-1,0,13,11,12,2,1,1,23,13,10,44,17,27,4,12,-9,4,4,10,0,14,8,-6,-2,1,4,-2,-17,10,6,9,11,8,5,10,5,1,4,8,-1,3,2,0,7,0,6,7,3,1,-41,-8,-33,32,16,16,-3,-18,-20,-8,-9,14,0,-7,3,-4,-9,7,-3,-11,-23,-4,0,7,8,12,3,6,2,1,4,6,1,3,2,0,4,6,2,3,0,1,-25,-17,-8,21,5,16,-5,6,-42,15,10,-11,-10,-7,-22,12,11,-1,5,13,-20,3,-1,-10,6,5,5,0,5,0,3,-1,1,-2,4,0,3,6,4,2,1,0,-79,-48,-31,0,-6,6,-19,-5,-44,-22,-4,17,-11,-4,-18,-16,-5,7,-8,-1,-26,-6,1,10,1,2,-2,-5,2,2,0,-1,-1,-4,-1,1,1,3,-1,-1,3,1,-119,-64,-55,-9,-14,5,6,-27,-65,-18,7,-23,-1,-16,-35,-17,11,-7,7,-11,-30,-1,-4,-16,3,-1,-12,-4,5,-1,-2,0,-12,-5,3,1,5,-1,0,1,2,-2,-150,-103,-47,-53,-46,-7,-12,-36,-68,-32,7,-10,-6,-29,-40,-26,-1,-2,-6,-7,-28,-6,8,-8,5,1,-36,-25,3,0,2,2,-28,-18,-2,-2,3,-1,-8,-7,5,2,-90,-76,-14,-9,-8,-1,-11,-28,-71,-1,16,5,-8,-15,-55,-12,10,2,-3,-13,-16,11,6,3,-5,4,-10,-3,3,2,1,1,-10,-3,3,0,-6,3,0,0,0,2,-212,-119,-93,-119,-69,-50,-13,-41,-62,-47,-32,-20,-12,-16,-33,-29,-19,-9,-1,-25,-29,-18,-13,-11,-10,-7,-23,-39,-21,-20,-6,-4,-12,-25,-12,-10,-4,-3,-11,-14,-9,-10,-59,-50,-9,-1,-16,15,12,-32,-27,-21,1,8,9,-19,-15,-16,-10,2,3,-13,-12,-5,11,6,9,9,-3,-10,-4,-3,5,2,-5,-12,-5,-2,4,7,2,2,1,-1
14,14056,Puente Genil,27825,39,33,6,126,67,59,33,-5,21,1,6,-20,15,3,14,2,9,-9,18,-8,7,-1,-3,-11,33,26,37,15,8,3,15,14,22,9,5,0,18,12,15,6,3,3,-7,-4,-3,32,15,17,4,-11,-17,2,9,5,8,-8,-2,-4,1,0,-4,-3,-15,6,8,5,13,3,9,3,2,0,7,1,5,2,0,0,6,2,4,1,2,0,155,86,69,184,109,75,41,2,47,30,22,10,22,14,19,15,12,-1,19,-12,28,15,10,11,49,29,55,35,10,1,28,17,30,22,6,1,21,12,25,13,4,0,149,102,47,109,60,49,68,5,9,21,28,16,38,12,8,14,20,9,30,-7,1,7,8,7,15,23,32,21,9,8,6,12,17,13,7,5,9,11,15,8,2,3,51,39,12,161,106,55,-8,38,-15,9,18,12,-11,40,-6,-2,12,8,3,-2,-9,11,6,4,17,44,47,28,22,2,10,32,35,16,12,1,7,12,12,12,10,1,79,40,39,105,62,43,23,4,23,14,15,-3,18,-10,19,5,12,-5,5,14,4,9,3,2,15,30,28,20,9,-1,8,17,22,10,5,-1,7,13,6,10,4,0,77,58,19,114,70,44,12,-2,16,43,8,-1,10,6,16,23,4,-1,2,-8,0,20,4,0,18,29,31,27,7,2,12,17,20,14,6,1,6,12,11,13,1,1,108,76,32,266,160,106,34,56,-8,20,8,-1,18,37,3,11,9,2,16,19,-11,9,-1,-3,43,86,86,31,13,3,21,52,58,18,8,1,22,34,28,13,5,2,207,116,91,187,103,84,86,6,58,32,18,3,52,1,33,16,13,0,34,5,25,16,5,3,53,27,55,33,10,1,27,17,35,17,4,1,26,10,20,16,6,0,138,70,68,129,69,60,45,7,19,22,38,4,18,5,12,10,25,-4,27,2,7,12,13,8,39,32,26,16,6,4,20,20,17,4,4,1,19,12,9,12,2,3,38,46,-8,113,67,46,25,10,1,6,6,-15,18,16,3,0,8,-2,7,-6,-2,6,-2,-13,29,41,32,5,3,0,20,23,19,3,2,0,9,18,13,2,1,0,-165,-108,-57,14,-23,37,-21,-26,-58,-38,-5,-15,-1,-26,-39,-23,-10,-9,-20,0,-19,-15,5,-6,4,19,20,-13,-13,-4,6,-4,-2,-9,-13,-2,-2,23,22,-4,0,-2,-133,-79,-54,44,26,18,-19,-8,-85,-2,-16,3,-20,6,-48,-5,-7,2,1,-14,-37,3,-9,1,12,23,1,5,1,1,5,17,2,1,1,1,7,6,-1,4,0,0,-180,-118,-62,-52,-31,-21,-34,-2,-82,-43,-15,-8,-12,2,-58,-37,-9,-5,-22,-4,-24,-6,-6,-3,-9,19,-18,-37,-7,-2,-5,19,-13,-28,-4,-1,-4,0,-5,-9,-3,-1,-15,19,-34,45,34,11,-27,5,-28,16,5,10,-10,13,-1,8,3,6,-17,-8,-27,8,2,4,1,34,-2,3,4,0,-3,34,1,0,1,1,4,0,-3,3,3,-1,-121,-83,-38,48,5,43,-12,4,-49,-31,-15,-23,-1,-4,-39,-17,-13,-13,-11,8,-10,-14,-2,-10,23,16,9,-5,-1,-2,15,6,-9,-4,-4,-3,8,10,18,-1,3,1,147,91,56,291,185,106,19,95,19,15,4,-1,7,71,17,-9,2,2,12,24,2,24,2,-3,44,135,83,25,6,-4,22,97,55,10,2,-2,22,38,28,15,4,-2,95,87,8,269,175,94,23,42,18,14,-2,1,13,31,20,11,10,1,10,11,-2,3,-12,0,40,103,74,39,9,3,17,82,47,22,3,2,23,21,27,17,6,1
14,14057,"Rambla, La",7266,21,8,13,9,1,8,2,12,-8,0,6,9,2,6,-1,-1,1,1,0,6,-7,1,5,8,2,4,1,0,0,1,1,0,0,0,0,0,1,4,1,0,0,1,29,17,12,21,7,14,4,-2,18,5,2,2,2,1,9,4,0,2,2,-3,9,1,2,0,1,7,9,3,1,0,0,2,3,2,0,0,1,5,6,1,1,0,10,9,1,14,5,9,1,-2,-13,9,4,12,0,1,-2,4,2,4,1,-3,-11,5,2,8,4,3,2,1,1,3,2,1,0,0,1,1,2,2,2,1,0,2,7,-3,10,4,1,3,-3,-10,10,-5,-5,20,0,-5,4,-6,-2,5,-3,-5,6,1,-3,15,0,1,1,0,0,2,0,1,0,0,0,0,0,0,1,0,0,2,31,14,17,12,4,8,7,2,7,-2,8,10,1,0,2,1,6,5,6,2,5,-3,2,5,1,4,4,1,2,0,0,1,1,1,1,0,1,3,3,0,1,0,-8,-8,0,10,2,8,-2,1,-14,-2,6,3,3,0,-12,0,2,-1,-5,1,-2,-2,4,4,0,2,3,1,2,2,0,0,0,0,1,1,0,2,3,1,1,1,9,3,6,6,3,3,-4,9,-1,-1,9,-2,-1,2,1,-3,5,0,-3,7,-2,2,4,-2,3,1,1,0,1,0,2,0,0,0,1,0,1,1,1,0,0,0,118,72,46,27,16,11,24,7,42,22,1,20,15,6,21,18,0,10,9,1,21,4,1,10,6,8,7,2,1,2,3,4,5,2,1,1,3,4,2,0,0,1,19,21,-2,13,7,6,-1,7,9,-7,10,2,1,6,12,1,6,-3,-2,1,-3,-8,4,5,1,5,3,2,1,1,0,3,1,2,1,0,1,2,2,0,0,1,-9,0,-9,-2,-3,1,-9,-8,-3,3,3,5,-6,-3,6,4,-1,1,-3,-5,-9,-1,4,4,2,-3,0,-2,1,-1,0,-2,0,-1,0,0,2,-1,0,-1,1,-1,43,19,24,-2,-8,6,15,6,1,-1,9,15,7,4,-1,-3,7,6,8,2,2,2,2,9,2,0,0,-4,0,0,-1,0,-2,-4,-1,0,3,0,2,0,1,0,-10,-16,6,5,3,2,-9,6,-10,-17,7,13,-11,3,0,-15,4,3,2,3,-10,-2,3,10,2,1,1,0,0,1,0,1,1,0,0,1,2,0,0,0,0,0,-20,-6,-14,16,4,12,-1,-5,-5,-7,-7,5,1,2,1,-4,-6,0,-2,-7,-6,-3,-1,5,-1,6,11,1,-1,0,1,0,3,1,-1,0,-2,6,8,0,0,0,-27,-10,-17,-10,-4,-6,-9,-10,-8,-4,4,-1,-7,-5,1,-4,4,1,-2,-5,-9,0,0,-2,-3,-4,-3,-1,1,0,-2,0,-2,-1,1,0,-1,-4,-1,0,0,0,-10,-12,2,1,1,0,-5,-3,4,-12,4,-2,-5,-1,5,-12,1,-1,0,-2,-1,0,3,-1,1,0,-2,2,0,0,1,1,-1,0,0,0,0,-1,-1,2,0,0,44,1,43,12,-3,15,14,8,2,4,4,7,-1,2,-5,-2,1,4,15,6,7,6,3,3,8,-1,3,0,3,-1,-2,0,1,-3,1,0,10,-1,2,3,2,-1,-25,-11,-14,1,5,-4,5,2,-14,-7,-9,1,5,1,-5,-7,-6,0,0,1,-9,0,-3,1,1,2,-3,-1,0,0,3,1,0,-1,0,0,-2,1,-3,0,0,0,8,-13,21,15,4,11,3,3,5,1,-4,-2,-6,3,-3,-3,-4,-1,9,0,8,4,0,-1,4,3,5,3,1,-1,0,1,2,1,1,-1,4,2,3,2,0,0
14,14066,Villa del Río,7181,41,21,20,7,1,6,13,2,9,9,0,4,6,0,2,9,1,2,7,2,7,0,-1,2,1,2,3,0,1,0,0,1,0,0,0,0,1,1,3,0,1,0,13,8,5,9,2,7,11,-4,-3,4,3,0,8,-4,-1,1,1,2,3,0,-2,3,2,-2,3,0,2,2,2,0,2,0,0,0,0,0,1,0,2,2,2,0,-1,3,-4,12,7,5,1,-3,-4,7,-1,-3,1,-3,-1,8,-2,-2,0,0,-3,-1,1,-1,4,4,2,2,0,0,2,3,1,1,0,0,2,1,1,1,0,0,25,17,8,11,4,7,12,4,-9,6,9,3,12,5,-8,3,3,2,0,-1,-1,3,6,1,3,3,3,1,0,1,2,1,1,0,0,0,1,2,2,1,0,1,23,9,14,19,13,6,6,6,-1,-1,4,11,2,5,2,-1,0,3,4,1,-3,0,4,8,0,7,8,3,1,0,0,4,6,2,1,0,0,3,2,1,0,0,-30,-23,-7,12,6,6,-7,-10,-3,-7,0,-6,-4,-7,-5,-6,2,-6,-3,-3,2,-1,-2,0,0,4,5,2,0,1,0,2,3,1,0,0,0,2,2,1,0,1,-5,-11,6,16,8,8,-3,-7,-6,3,12,-6,-1,-3,-11,2,4,-3,-2,-4,5,1,8,-3,4,4,5,1,2,0,2,1,3,0,2,0,2,3,2,1,0,0,-55,-22,-33,10,5,5,-15,-5,-24,-6,-2,-2,-5,-2,-9,-2,-3,-2,-10,-3,-15,-4,1,0,2,4,3,1,0,0,1,2,2,0,0,0,1,2,1,1,0,0,19,6,13,27,13,14,6,10,6,0,2,-5,-3,6,5,0,1,-3,9,4,1,0,1,-2,5,5,8,4,3,2,1,2,5,3,2,0,4,3,3,1,1,2,-10,-7,-3,-1,0,-1,3,-5,4,-10,-1,-1,-1,-5,3,-4,0,1,4,0,1,-6,-1,-2,5,-1,-4,-1,0,0,4,-1,-3,0,0,0,1,0,-1,-1,0,0,-31,-22,-9,1,0,1,0,-10,-13,-8,3,-1,0,-4,-6,-10,0,-1,0,-6,-7,2,3,0,3,1,0,-1,-1,-1,3,0,-2,0,-1,0,0,1,2,-1,0,-1,-25,-19,-6,-6,-8,2,2,-3,-18,-5,4,-4,-1,1,-16,-3,1,-1,3,-4,-2,-2,3,-3,0,0,-5,-2,1,-1,-2,1,-5,-2,-1,0,2,-1,0,0,2,-1,-10,-12,2,1,1,0,-4,13,-9,-3,-5,0,-2,6,-9,-3,-2,-1,-2,7,0,0,-3,1,-1,3,3,-1,-3,0,1,1,2,-1,-2,0,-2,2,1,0,-1,0,-48,-15,-33,-15,-6,-9,-9,-10,-23,-6,2,1,-1,-2,-9,-3,1,1,-8,-8,-14,-3,1,0,-4,-2,-6,-2,-1,0,0,-1,-3,-1,-1,0,-4,-1,-3,-1,0,0,-10,-3,-7,2,1,1,9,-7,-7,-3,4,-7,7,-4,-2,-3,1,-3,2,-3,-5,0,3,-4,0,0,0,0,1,0,0,-1,0,0,1,0,0,1,0,0,0,0,-103,-55,-48,-17,-9,-8,-36,-12,-29,-23,1,-7,-17,-7,-15,-15,1,-3,-19,-5,-14,-8,0,-4,-8,-1,-4,-3,-1,0,-4,0,-2,-2,-1,0,-4,-1,-2,-1,0,0,-56,-32,-24,1,-1,2,-7,-11,-27,-12,3,-3,-7,-6,-12,-8,4,-1,0,-5,-15,-4,-1,-2,0,1,-2,1,1,0,0,1,-2,0,0,0,0,0,0,1,1,0,-15,2,-17,-2,-3,1,-1,-7,3,0,-2,-7,5,-2,1,2,-4,-1,-6,-5,2,-2,2,-6,1,-1,-1,-1,0,0,1,0,-3,-1,0,0,0,-1,2,0,0,0
15,15001,Abegondo,5480,128,60,68,18,11,7,17,21,33,20,22,13,7,9,17,7,12,7,10,12,16,13,10,6,2,2,4,2,5,3,1,1,2,2,3,2,1,1,2,0,2,1,73,37,36,29,12,17,2,15,15,9,25,7,2,4,11,6,13,1,0,11,4,3,12,6,1,5,10,2,8,3,0,0,6,1,4,1,1,5,4,1,4,2,43,26,17,7,8,-1,-2,11,4,11,20,-2,-4,8,3,5,12,1,2,3,1,6,8,-3,-1,1,3,1,3,0,-1,1,4,1,3,0,0,0,-1,0,0,0,20,9,11,-4,-3,-1,-7,3,4,20,-2,2,1,2,5,7,-5,-1,-8,1,-1,13,3,3,0,0,-1,0,0,-3,0,0,-1,0,-1,-1,0,0,0,0,1,-2,51,18,33,21,9,12,14,9,20,1,12,-2,5,-1,7,1,9,-3,9,10,13,0,3,1,6,3,6,1,4,1,4,0,2,0,3,0,2,3,4,1,1,1,54,26,28,10,4,6,8,-3,15,17,14,3,3,-3,2,8,9,7,5,0,13,9,5,-4,-2,3,3,3,3,0,-1,0,2,1,2,0,-1,3,1,2,1,0,58,37,21,14,10,4,18,12,1,13,20,-7,12,9,-2,8,14,-5,6,3,3,5,6,-2,5,0,1,1,3,4,5,0,0,1,2,2,0,0,1,0,1,2,54,16,38,6,5,1,25,-4,-2,25,13,-1,11,-8,-2,13,7,-3,14,4,0,12,6,2,2,1,2,2,1,-2,2,2,0,1,1,-1,0,-1,2,1,0,-1,38,26,12,15,9,6,9,-2,0,29,10,-7,3,2,5,14,4,-3,6,-4,-5,15,6,-4,0,2,5,2,2,3,0,2,2,1,2,1,0,0,3,1,0,2,3,-3,6,10,4,6,0,1,-10,5,1,4,0,-1,-11,-1,3,5,0,2,1,6,-2,-1,2,-1,-1,3,7,0,1,0,-2,1,3,1,1,-1,1,2,4,-1,10,-1,11,8,5,3,4,3,2,-7,6,5,1,3,-2,-8,3,4,3,0,4,1,3,1,0,1,2,-1,5,1,0,0,1,0,2,2,0,1,1,-1,3,-1,37,22,15,3,4,-1,15,-5,3,-2,18,3,4,-2,10,-3,6,6,11,-3,-7,1,12,-3,2,0,-2,-1,2,2,1,0,1,-2,2,2,1,0,-3,1,0,0,7,6,1,8,5,3,5,6,-21,13,14,-7,4,1,-12,9,9,-2,1,5,-9,4,5,-5,0,5,-1,1,5,-2,0,2,0,0,4,-1,0,3,-1,1,1,-1,-29,-3,-26,-2,-1,-1,-20,5,-9,-9,5,-2,-6,3,-2,-8,6,3,-14,2,-7,-1,-1,-5,0,-1,-4,-1,4,0,1,-1,-4,0,3,0,-1,0,0,-1,1,0,44,25,19,3,1,2,11,13,3,1,11,2,6,10,-8,7,10,0,5,3,11,-6,1,2,0,2,-1,-2,4,0,0,0,0,-1,2,0,0,2,-1,-1,2,0,7,-2,9,5,2,3,2,-6,6,1,13,-5,-2,-4,2,-7,10,0,4,-2,4,8,3,-5,-2,3,0,2,1,0,-1,1,0,1,0,0,-1,2,0,1,1,0,-39,-16,-23,0,-3,3,-8,-1,-20,-4,0,-6,-3,4,-7,-7,-3,0,-5,-5,-13,3,3,-6,1,-2,-2,2,0,0,0,0,-3,1,-1,0,1,-2,1,1,1,0,18,3,15,10,2,8,0,-5,15,5,3,0,0,-4,6,3,-1,-1,0,-1,9,2,4,1,1,-1,2,2,4,2,0,0,1,-1,1,1,1,-1,1,3,3,1
15,15002,Ames,15318,1107,505,602,153,60,93,152,155,479,185,56,42,67,67,216,87,26,25,85,88,263,98,30,17,26,29,40,18,26,12,10,9,10,8,14,7,16,20,30,10,12,5,855,382,473,131,56,75,102,90,413,157,49,32,51,34,182,72,23,11,51,56,231,85,26,21,30,21,32,31,13,4,14,8,13,12,7,2,16,13,19,19,6,2,689,321,368,199,92,107,42,65,324,126,68,39,18,23,157,60,36,15,24,42,167,66,32,24,45,31,46,34,32,9,23,14,17,16,18,3,22,17,29,18,14,6,674,312,362,156,81,75,54,100,300,112,56,40,22,44,159,41,28,12,32,56,141,71,28,28,19,30,43,27,22,11,7,13,26,13,12,8,12,17,17,14,10,3,804,394,410,192,64,128,97,84,357,134,54,59,25,37,184,89,22,21,72,47,173,45,32,38,50,34,59,22,14,12,17,10,21,5,6,5,33,24,38,17,8,7,874,411,463,240,124,116,96,148,422,105,51,33,52,73,194,50,17,10,44,75,228,55,34,23,58,56,57,34,19,12,32,30,25,18,13,3,26,26,32,16,6,9,1166,563,603,238,108,130,144,151,578,115,118,35,90,61,287,48,53,16,54,90,291,67,65,19,54,50,56,35,30,11,29,16,29,17,14,3,25,34,27,18,16,8,1039,502,537,260,130,130,52,150,559,145,65,41,7,58,313,65,28,19,45,92,246,80,37,22,42,59,68,48,27,14,24,30,33,26,9,9,18,29,35,22,18,5,856,372,484,195,77,118,105,115,412,132,37,42,52,33,176,70,16,16,53,82,236,62,21,26,45,45,55,35,10,4,19,20,19,11,7,0,26,25,36,24,3,4,701,338,363,52,14,38,83,68,342,102,51,38,42,23,146,69,29,17,41,45,196,33,22,21,19,12,10,5,5,-2,2,3,-5,9,5,-1,17,9,15,-4,0,-1,754,326,428,30,9,21,83,70,434,78,48,17,39,24,197,39,21,-4,44,46,237,39,27,21,21,28,-1,-18,3,-7,14,12,-5,-11,2,-6,7,16,4,-7,1,-1,259,96,163,-20,-17,-3,-13,45,142,60,0,24,-5,7,83,31,-22,2,-8,38,59,29,22,22,-4,9,-7,-2,-13,-3,-5,4,0,-3,-11,-1,1,5,-7,1,-2,-2,197,68,129,15,-2,17,-15,12,97,76,5,35,-11,15,22,47,-3,12,-4,-3,75,29,8,23,-5,16,-1,-6,2,8,-4,12,-9,-4,3,1,-1,4,8,-2,-1,7,98,28,70,-86,-68,-18,2,0,120,-18,-7,9,-13,-5,50,-11,3,4,15,5,70,-7,-10,5,-1,-8,-23,-39,-17,1,-7,-8,-21,-27,-7,0,6,0,-2,-12,-10,1,99,10,89,13,5,8,-21,33,65,-29,11,29,-10,-1,37,-29,0,11,-11,34,28,0,11,18,12,-2,3,-6,2,4,12,0,-5,-3,-4,5,0,-2,8,-3,6,-1,169,83,86,-43,-12,-31,22,22,102,-3,17,5,2,3,64,9,7,-3,20,19,38,-12,10,8,29,-7,-30,-19,-12,-7,19,-2,-12,-12,-6,0,10,-5,-18,-7,-6,-7,104,26,78,167,77,90,48,-6,68,-23,3,7,17,-18,27,-6,-2,4,31,12,41,-17,5,3,47,33,39,14,18,14,29,10,19,4,7,6,18,23,20,10,11,8,301,133,168,197,80,117,11,36,124,68,18,35,32,12,17,51,3,14,-21,24,107,17,15,21,58,42,30,30,16,18,38,18,5,7,2,7,20,24,25,23,14,11
15,15004,Ares,4662,143,70,73,28,11,17,16,26,19,41,25,14,7,4,13,24,14,8,9,22,6,17,11,6,5,1,8,7,4,3,2,0,5,4,0,0,3,1,3,3,4,3,41,22,19,29,9,20,10,5,11,9,9,-4,2,6,5,4,4,0,8,-1,6,5,5,-4,9,6,4,6,2,1,2,1,1,2,1,1,7,5,3,4,1,0,169,81,88,6,4,2,7,29,32,48,28,27,4,14,12,22,15,14,3,15,20,26,13,13,3,-1,0,1,0,3,3,-1,1,0,-1,2,0,0,-1,1,1,1,92,50,42,21,13,8,19,7,26,0,21,19,10,3,17,1,11,9,9,4,9,-1,10,10,8,5,5,3,0,0,3,2,3,3,1,1,5,3,2,0,-1,-1,56,33,23,24,18,6,-1,3,2,12,36,6,4,0,-5,8,20,6,-5,3,7,4,16,0,3,3,5,6,6,-1,2,1,4,5,4,0,1,2,1,1,2,-1,131,51,80,38,13,25,16,16,29,32,32,9,4,8,12,13,15,0,12,8,17,19,17,9,12,1,13,7,2,3,1,1,6,4,1,0,11,0,7,3,1,3,198,113,85,68,41,27,32,14,14,65,39,30,16,3,14,42,20,15,16,11,0,23,19,15,18,8,21,10,8,1,12,2,12,8,4,1,6,6,9,2,4,0,98,50,48,53,27,26,11,20,13,27,20,5,12,12,1,12,9,3,-1,8,12,15,11,2,9,6,8,15,9,3,6,3,4,7,6,0,3,3,4,8,3,3,-19,-23,4,15,5,10,6,-1,-13,-8,1,-3,-6,-4,-7,-6,4,-3,12,3,-6,-2,-3,0,6,0,6,1,1,1,2,-1,3,1,0,0,4,1,3,0,1,1,44,27,17,12,7,5,13,-4,-13,30,13,8,9,4,-10,19,5,3,4,-8,-3,11,8,5,8,3,1,3,-3,0,2,3,1,1,-1,1,6,0,0,2,-2,-1,117,64,53,-28,-20,-8,-2,27,30,22,27,10,2,13,22,7,16,3,-4,14,8,15,11,7,-13,4,-2,-15,-3,1,-9,3,-3,-8,-4,1,-4,1,1,-7,1,0,73,22,51,-1,3,-4,20,12,35,-3,13,-7,7,1,21,-6,1,-4,13,11,14,3,12,-3,-3,-2,5,1,0,-2,-1,1,3,1,0,-1,-2,-3,2,0,0,-1,-20,1,-21,-43,-31,-12,-8,-5,2,-11,-1,3,-6,4,1,-6,1,5,-2,-9,1,-5,-2,-2,-16,-6,-1,-20,-1,1,-16,0,-1,-14,-1,1,0,-6,0,-6,0,0,-29,-7,-22,-14,-6,-8,-17,1,-5,-14,2,4,-10,2,2,-4,1,3,-7,-1,-7,-10,1,1,-1,2,-6,-6,-4,1,-1,2,-3,-3,-1,0,0,0,-3,-3,-3,1,32,13,19,3,4,-1,15,-7,2,16,3,1,5,-5,-5,12,6,-1,10,-2,7,4,-3,2,2,2,3,-4,2,-3,1,1,2,-3,3,-1,1,1,1,-1,-1,-2,-19,-18,-1,-7,-4,-3,0,2,-13,-20,12,2,0,-3,-6,-16,5,3,0,5,-7,-4,7,-1,2,-1,-7,-3,2,0,1,0,-5,-1,0,1,1,-1,-2,-2,2,-1,26,19,7,24,10,14,-1,4,-6,4,16,9,3,4,-12,8,12,3,-4,0,6,-4,4,6,6,2,8,3,0,5,2,2,1,4,-1,2,4,0,7,-1,1,3,48,29,19,25,11,14,10,2,8,16,8,2,12,-5,5,6,2,8,-2,7,3,10,6,-6,3,1,5,6,3,4,2,1,0,2,1,3,1,0,5,4,2,1
15,15005,Arteixo,21679,580,295,285,242,146,96,80,128,222,79,46,21,31,64,119,51,18,16,49,64,103,28,28,5,29,66,90,23,24,6,13,45,55,16,12,4,16,21,35,7,12,2,656,316,340,241,98,143,98,136,246,90,53,31,63,36,130,46,29,10,35,100,116,44,24,21,60,63,62,34,19,3,33,25,18,13,8,1,27,38,44,21,11,2,764,390,374,278,133,145,93,124,327,98,65,40,44,65,168,58,31,15,49,59,159,40,34,25,64,47,69,46,30,21,30,27,30,23,12,10,34,20,39,23,18,11,875,456,419,321,162,159,108,164,356,132,73,28,67,73,185,87,39,1,41,91,171,45,34,27,74,57,88,60,25,13,39,28,39,38,12,5,35,29,49,22,13,8,790,381,409,225,96,129,103,126,331,120,70,29,64,46,155,64,35,12,39,80,176,56,35,17,50,46,64,23,31,11,26,18,27,9,13,3,24,28,37,14,18,8,622,291,331,226,114,112,27,114,311,80,42,52,11,46,160,35,21,19,16,68,151,45,21,33,47,51,64,36,20,8,28,22,33,16,11,4,19,29,31,20,9,4,859,461,398,252,132,120,121,137,326,159,67,41,54,62,187,101,38,13,67,75,139,58,29,28,44,54,55,60,25,11,21,24,36,33,12,5,23,30,19,27,13,6,1065,554,511,419,219,200,160,155,431,179,95,42,71,68,224,119,58,18,89,87,207,60,37,24,84,60,126,92,44,6,43,24,70,58,21,-1,41,36,56,34,23,7,644,333,311,209,105,104,98,92,320,89,28,-1,31,45,180,49,15,3,67,47,140,40,13,-4,58,46,54,40,10,-4,29,24,28,17,3,1,29,22,26,23,7,-5,378,166,212,104,43,61,22,86,171,25,48,17,-6,42,84,11,19,4,28,44,87,14,29,13,22,31,21,12,18,-1,9,16,6,3,7,1,13,15,15,9,11,-2,84,38,46,60,20,40,7,10,45,-3,7,12,7,6,19,-8,6,6,0,4,26,5,1,6,20,20,21,-11,3,3,16,6,4,-11,0,1,4,14,17,0,3,2,58,-11,69,4,-1,5,-20,47,75,-12,-40,10,-20,18,30,-18,-11,-7,0,29,45,6,-29,17,-6,15,7,-12,2,-3,-2,7,2,-6,3,-5,-4,8,5,-6,-1,2,210,117,93,-2,-23,21,-12,33,107,65,24,-4,10,18,59,18,15,0,-22,15,48,47,9,-4,17,3,4,-13,-4,-10,4,1,-8,-14,-3,-4,13,2,12,1,-1,-6,-158,-102,-56,-112,-69,-43,-71,-1,1,-76,-17,11,-21,-6,-4,-55,-17,6,-50,5,5,-21,0,5,-13,-7,-47,-30,-12,-4,-9,-4,-30,-17,-10,0,-4,-3,-17,-13,-2,-4,56,36,20,-26,-12,-14,-7,39,78,-56,-32,32,-1,17,49,-25,-10,6,-6,22,29,-31,-22,26,-4,4,-11,-20,-6,7,-3,5,-2,-8,-5,-1,-1,-1,-9,-12,-1,8,230,80,150,81,30,51,13,56,91,20,18,24,-2,17,53,0,4,4,15,39,38,20,14,20,8,36,4,1,12,16,3,16,1,-5,2,11,5,20,3,6,10,5,228,100,128,112,46,66,43,40,58,25,34,20,28,13,30,15,3,7,15,27,28,10,31,13,32,28,17,11,10,7,12,15,8,6,-2,4,20,13,9,5,12,3,338,167,171,157,72,85,26,52,98,78,38,43,13,26,39,43,20,22,13,26,59,35,18,21,31,29,25,28,22,16,17,17,7,12,7,9,14,12,18,16,15,7
15,15006,Arzúa,6896,1,-8,9,14,5,9,-1,-5,-5,1,9,3,0,-2,-8,-4,7,1,-1,-3,3,5,2,2,4,3,3,4,0,0,2,2,1,0,0,0,2,1,2,4,0,0,-8,0,-8,24,14,10,-5,-3,-3,-3,9,-2,-3,-5,3,-1,7,1,-2,2,-6,-2,2,-3,9,1,9,3,2,0,6,1,3,3,1,0,3,0,6,0,1,0,5,-8,13,17,7,10,-1,0,-8,-10,17,7,-1,-4,-7,-6,6,4,0,4,-1,-4,11,3,2,5,1,3,4,2,0,1,0,2,2,2,2,4,1,1,2,0,-50,-29,-21,7,5,2,-11,-14,-38,1,9,3,-10,-7,-20,1,6,1,-1,-7,-18,0,3,2,2,0,-1,4,2,0,2,0,-1,2,2,0,0,0,0,2,0,0,-6,-4,-2,11,8,3,-1,1,-13,-9,10,4,-3,-1,-4,-2,4,3,2,2,-9,-7,6,1,0,0,3,2,4,2,0,0,3,1,3,1,0,0,0,1,1,1,-27,-1,-26,18,10,8,-12,-11,-6,-5,5,2,-1,-1,0,-4,3,3,-11,-10,-6,-1,2,-1,3,2,8,3,2,0,2,2,3,2,1,0,1,0,5,1,1,0,25,25,0,22,12,10,17,5,-20,9,14,-1,8,4,-7,9,7,3,9,1,-13,0,7,-4,9,1,5,4,1,2,3,0,4,3,1,1,6,1,1,1,0,1,-3,4,-7,27,20,7,7,-11,-17,4,11,4,3,-2,-6,4,5,1,4,-9,-11,0,6,3,5,5,7,9,1,0,3,5,4,7,1,0,2,0,3,2,0,0,59,37,22,25,16,9,11,2,13,19,9,5,4,7,3,13,5,5,7,-5,10,6,4,0,2,3,7,9,3,1,2,2,4,7,1,0,0,1,3,2,2,1,-8,-12,4,17,7,10,2,-12,-18,1,10,7,1,-9,-10,-1,11,-5,1,-3,-8,2,-1,12,4,4,4,0,5,0,1,2,1,0,3,0,3,2,3,0,2,0,-8,-11,3,11,7,4,-1,3,-17,9,6,-8,-4,2,-8,0,3,-3,3,1,-9,9,3,-5,-1,2,3,2,3,1,-1,2,3,1,2,0,0,0,0,1,1,1,28,23,5,26,16,10,4,3,13,4,6,-5,1,5,2,9,8,-2,3,-2,11,-5,-2,-3,3,7,3,7,4,2,1,5,3,4,2,1,2,2,0,3,2,1,9,2,7,-8,-7,-1,13,-10,-1,-15,4,18,9,-5,-4,-8,5,5,4,-5,3,-7,-1,13,0,-1,-1,-6,1,-1,0,-1,-1,-5,1,-1,0,0,0,-1,0,0,55,46,9,12,7,5,4,-3,21,10,13,10,3,5,16,9,11,2,1,-8,5,1,2,8,3,3,1,4,1,0,2,2,0,2,1,0,1,1,1,2,0,0,12,0,12,4,2,2,5,3,-5,7,1,1,4,-1,-6,5,-2,0,1,4,1,2,3,1,1,1,0,1,0,1,0,1,-1,2,0,0,1,0,1,-1,0,1,38,21,17,17,12,5,7,7,-10,10,7,16,6,9,-8,1,4,7,1,-2,-2,9,3,9,4,3,3,5,1,1,4,3,0,5,0,0,0,0,3,0,1,1,-16,-4,-12,8,7,1,-8,4,-20,-8,2,15,-4,-3,-2,-4,-4,13,-4,7,-18,-4,6,2,2,3,-4,0,5,2,1,3,-1,1,2,1,1,0,-3,-1,3,1,-21,-14,-7,5,3,2,6,-7,-22,7,-4,2,-1,-1,-13,0,-2,5,7,-6,-9,7,-2,-3,2,3,-6,3,2,1,1,2,-4,2,2,0,1,1,-2,1,0,1
15,15007,"Baña, A",5429,-28,-26,-2,23,9,14,2,-24,-9,-1,3,0,1,-18,-10,0,2,-2,1,-6,1,-1,1,2,3,2,6,3,5,3,1,0,2,2,3,0,2,2,4,1,2,3,-16,-14,-2,12,6,6,1,-13,-13,3,5,1,0,-6,-10,3,2,-3,1,-7,-3,0,3,4,1,2,2,3,2,2,1,2,1,2,0,0,0,0,1,1,2,2,-12,-6,-6,21,9,12,10,-9,-17,0,-1,1,6,-10,-5,2,-1,1,4,1,-12,-2,0,0,7,-1,11,-1,0,2,4,0,5,1,-2,1,3,-1,6,-2,2,1,-68,-16,-52,7,6,1,-15,-13,-38,-1,-2,1,-1,-1,-19,2,-1,4,-14,-12,-19,-3,-1,-3,0,-1,1,2,4,1,0,-1,1,1,3,2,0,0,0,1,1,-1,-29,-26,-3,14,7,7,1,-5,-24,-6,8,-3,2,-6,-20,-6,5,-1,-1,1,-4,0,3,-2,5,-1,3,0,5,2,2,-1,0,2,3,1,3,0,3,-2,2,1,-41,-26,-15,4,5,-1,-1,-16,-15,3,-3,-11,-3,-11,-11,5,-2,-5,2,-5,-4,-2,-1,-6,3,0,0,1,1,-2,2,0,0,1,1,0,1,0,0,0,0,-2,95,47,48,9,7,2,7,7,28,18,31,7,3,-1,10,9,23,5,4,8,18,9,8,2,-1,0,0,3,6,1,-1,1,-1,2,5,1,0,-1,1,1,1,0,-84,-42,-42,4,4,0,-5,-10,-35,-19,-4,-9,-4,-2,-14,-13,-2,-6,-1,-8,-21,-6,-2,-3,1,0,-1,-1,3,2,1,1,0,-1,1,2,0,-1,-1,0,2,0,-59,-29,-30,2,1,1,-2,-11,-26,-9,-1,-8,1,-5,-14,-3,0,-7,-3,-6,-12,-6,-1,-1,1,1,1,0,0,-1,1,0,1,0,0,-1,0,1,0,0,0,0,-52,-33,-19,-19,-13,-6,7,-4,-29,-11,-14,-1,0,-2,-16,-8,-6,0,7,-2,-13,-3,-8,-1,0,-1,-2,-4,-7,-5,0,-1,-2,-4,-4,-2,0,0,0,0,-3,-3,-40,-8,-32,-5,-4,-1,0,-3,-19,-11,6,-7,2,5,-9,-7,5,0,-2,-8,-10,-4,1,-7,0,0,-1,0,-1,-3,0,0,-1,0,-1,-2,0,0,0,0,0,-1,-28,-11,-17,2,3,-1,-8,-7,-15,8,1,-5,-5,-3,-11,6,3,0,-3,-4,-4,2,-2,-5,-1,3,1,-1,1,-1,0,3,0,-2,2,0,-1,0,1,1,-1,-1,-52,-28,-24,-18,-11,-7,2,-3,-24,-13,-9,-3,0,1,-13,-9,-4,-2,2,-4,-11,-4,-5,-1,1,0,-5,-6,-3,-5,1,0,-3,-4,-2,-3,0,0,-2,-2,-1,-2,-35,-15,-20,-10,-5,-5,-1,-7,-13,2,-1,-14,0,-5,-11,4,1,-4,-1,-2,-2,-2,-2,-10,0,-1,-3,0,-3,-3,0,-1,-2,0,-1,-1,0,0,-1,0,-2,-2,7,11,-4,-4,-3,-1,-4,-5,-4,-1,7,11,-3,-2,2,0,4,9,-1,-3,-6,-1,3,2,0,0,0,-1,-1,-2,-1,0,0,-1,0,-1,1,0,0,0,-1,-1,-5,11,-16,9,3,6,5,1,-2,0,-2,-5,9,3,-1,5,-4,0,-4,-2,-1,-5,2,-5,4,1,2,-1,0,3,2,0,2,-1,-1,1,2,1,0,0,1,2,-45,-17,-28,-1,0,-1,-2,-2,-21,-12,1,-7,0,-1,-5,-9,1,-3,-2,-1,-16,-3,0,-4,2,-2,-1,-3,2,0,0,0,1,-3,2,-1,2,-2,-2,0,0,1,19,4,15,4,3,1,-1,0,-1,7,1,13,-3,0,0,2,-3,8,2,0,-1,5,4,5,0,2,0,1,-1,2,0,1,0,1,-1,2,0,1,0,0,0,0
15,15008,Bergondo,5941,108,73,35,41,19,22,12,9,17,38,26,3,13,9,7,23,15,5,-1,0,10,15,11,-2,6,7,8,5,6,8,3,2,3,3,4,4,3,5,5,2,2,4,103,70,33,34,17,17,9,17,20,32,21,2,12,11,8,19,20,-1,-3,6,12,13,1,3,7,5,5,8,7,2,4,4,2,2,5,0,3,1,3,6,2,2,103,30,73,35,17,18,29,-7,21,27,16,17,10,-6,4,18,1,4,19,-1,17,9,15,13,4,1,8,5,13,4,2,-1,6,3,5,2,2,2,2,2,8,2,94,36,58,33,13,20,17,9,5,34,27,-1,6,-4,3,9,17,3,11,13,2,25,10,-4,6,4,5,5,9,4,3,1,0,2,6,1,3,3,5,3,3,3,113,32,81,41,18,23,38,14,0,30,24,9,16,3,-6,12,5,4,22,11,6,18,19,5,8,8,8,6,5,6,5,2,2,3,3,3,3,6,6,3,2,3,77,11,66,36,12,24,17,-7,1,35,26,4,5,-10,-10,17,10,-2,12,3,11,18,16,6,5,5,11,4,7,4,3,0,2,3,2,2,2,5,9,1,5,2,47,30,17,55,27,28,4,9,-10,21,17,8,6,9,-11,9,13,7,-2,0,1,12,4,1,10,13,12,9,6,4,3,8,6,1,7,2,7,5,6,8,-1,2,180,89,91,46,16,30,33,23,48,46,20,5,14,10,24,27,19,-6,19,13,24,19,1,11,7,10,18,3,5,3,2,3,5,2,3,1,5,7,13,1,2,2,60,21,39,39,6,33,8,2,-5,18,17,19,3,2,-7,6,4,10,5,0,2,12,13,9,12,6,8,5,8,0,3,1,-1,0,3,0,9,5,9,5,5,0,91,41,50,31,13,18,27,14,-2,22,23,8,18,1,-1,10,8,7,9,13,-1,12,15,1,4,8,5,3,6,5,3,3,2,0,3,2,1,5,3,3,3,3,15,-1,16,23,12,11,11,13,-27,9,8,3,0,-3,-8,5,2,4,11,16,-19,4,6,-1,9,2,10,3,1,-2,5,-2,4,2,2,1,4,4,6,1,-1,-3,22,12,10,7,6,1,36,-4,-14,19,7,-18,24,-6,-7,9,7,-14,12,2,-7,10,0,-4,4,3,-6,5,2,-1,4,1,-2,2,1,0,0,2,-4,3,1,-1,70,35,35,1,2,-1,14,4,1,28,10,10,4,0,2,17,7,4,10,4,-1,11,3,6,-2,2,5,-3,0,-1,0,1,3,0,-1,-1,-2,1,2,-3,1,0,12,15,-3,-26,-12,-14,5,5,-22,2,14,8,5,0,-12,3,12,8,0,5,-10,-1,2,0,-8,-2,-13,-4,-1,2,-4,-2,-3,-4,0,1,-4,0,-10,0,-1,1,35,22,13,5,3,2,7,-6,-2,16,12,10,2,-2,-2,10,6,7,5,-4,0,6,6,3,1,-3,-1,0,4,4,0,0,0,-1,1,3,1,-3,-1,1,3,1,15,27,-12,0,1,-1,6,-18,-20,26,6,17,7,-4,1,14,1,10,-1,-14,-21,12,5,7,2,-2,-2,2,0,0,1,-2,-1,3,0,0,1,0,-1,-1,0,0,44,26,18,14,5,9,5,-6,-1,19,19,3,3,-1,-6,21,8,1,2,-5,5,-2,11,2,0,3,2,2,5,1,-1,2,1,1,1,1,1,1,1,1,4,0,30,15,15,1,1,0,3,14,-18,11,13,4,1,10,-12,7,2,6,2,4,-6,4,11,-2,-2,2,-2,-2,1,3,-1,4,-3,0,0,1,-1,-2,1,-2,1,2
15,15009,Betanzos,12315,80,36,44,70,35,35,10,12,31,8,15,6,17,-4,15,-1,9,-1,-7,16,16,9,6,7,8,16,14,14,11,7,4,7,7,8,7,2,4,9,7,6,4,5,168,83,85,96,46,50,18,42,46,23,20,20,14,11,25,16,10,7,4,31,21,7,10,13,17,18,27,16,13,4,12,7,9,8,7,3,5,11,18,8,6,1,137,56,81,109,46,63,41,14,36,9,19,17,20,5,10,7,11,3,21,9,26,2,8,14,31,20,20,18,9,10,15,5,9,9,5,3,16,15,11,9,4,7,133,25,108,109,39,70,15,11,28,23,29,23,6,-3,7,3,7,4,9,14,21,20,22,19,23,27,29,18,11,-1,8,13,10,6,1,1,15,14,19,12,10,-2,137,89,48,115,68,47,8,29,11,40,26,25,7,11,19,27,13,12,1,18,-8,13,13,13,17,18,29,29,12,10,12,3,18,24,6,5,5,15,11,5,6,5,215,80,135,87,37,50,38,20,46,24,22,60,20,14,22,-1,16,7,18,6,24,25,6,53,15,17,21,16,11,7,6,6,8,7,7,3,9,11,13,9,4,4,226,111,115,108,47,61,27,57,50,37,34,17,8,20,30,27,18,6,19,37,20,10,16,11,11,25,26,24,12,8,5,9,13,16,3,1,6,16,13,8,9,7,254,134,120,185,97,88,49,49,89,42,12,9,19,21,46,23,12,11,30,28,43,19,0,-2,29,49,57,38,10,-1,12,20,33,27,4,-1,17,29,24,11,6,0,194,83,111,145,68,77,25,41,48,45,23,9,5,21,22,26,12,1,20,20,26,19,11,8,27,42,44,23,6,1,13,18,24,11,2,0,14,24,20,12,4,1,21,7,14,-1,-5,4,3,2,21,-7,-7,17,1,5,18,-7,-5,2,2,-3,3,0,-2,15,8,5,-2,-7,0,-4,3,2,-2,-6,0,-2,5,3,0,-1,0,-2,-85,-57,-28,-99,-67,-32,-28,-7,-24,-54,1,18,-7,-3,-22,-46,5,7,-21,-4,-2,-8,-4,11,-12,-9,-36,-35,-5,-3,-7,-1,-29,-28,-2,-1,-5,-8,-7,-7,-3,-2,77,5,72,24,-6,30,53,15,37,-14,-20,2,13,-3,6,-6,-12,3,40,18,31,-8,-8,-1,21,8,-2,-7,-2,5,9,-2,-5,-8,-2,1,12,10,3,1,0,4,-77,-20,-57,-31,-2,-29,-15,-29,-56,-1,-12,33,-3,-8,-26,6,-6,15,-12,-21,-30,-7,-6,18,0,-1,-24,-5,-2,0,4,3,-8,0,-2,0,-4,-4,-16,-5,0,0,-37,-22,-15,-6,-7,1,4,-19,-10,-11,0,9,3,-9,-6,-3,-4,4,1,-10,-4,-8,4,5,0,-1,-12,3,5,-1,0,-3,-6,2,2,-2,0,2,-6,1,3,1,-44,-8,-36,-32,-13,-19,-27,1,-28,-3,-5,11,-7,-4,1,-9,-5,12,-20,5,-29,6,0,-1,-9,0,-7,-14,-3,-1,-4,-3,-1,-7,0,2,-5,3,-6,-7,-3,-3,-133,-99,-34,-24,-21,-3,-38,-10,-18,-39,-11,-16,-22,-11,-11,-34,-3,-16,-16,1,-7,-5,-8,0,3,2,-15,-8,-4,-2,2,-2,-8,-9,-2,-2,1,4,-7,1,-2,0,32,22,10,39,13,26,2,24,20,-17,6,-5,10,12,6,-14,6,1,-8,12,14,-3,0,-6,7,15,9,3,6,-1,1,7,1,1,2,1,6,8,8,2,4,-2,38,22,16,85,45,40,12,-9,11,22,6,0,0,-4,13,11,5,0,12,-5,-2,11,1,0,16,11,22,20,7,8,7,4,16,8,4,5,9,7,6,12,3,3
15,15011,Boiro,17915,48,-2,50,39,21,18,5,-2,26,19,2,1,3,-12,5,5,-3,2,2,10,21,14,5,-1,6,6,5,11,6,5,4,3,3,7,2,2,2,3,2,4,4,3,-39,-11,-28,34,18,16,10,-24,-23,-4,0,4,5,-5,-14,0,0,4,5,-19,-9,-4,0,0,6,4,7,13,3,0,4,2,4,5,3,0,2,2,3,8,0,0,120,61,59,51,20,31,36,14,53,10,6,2,22,-7,40,6,1,-1,14,21,13,4,5,3,19,10,3,7,10,2,14,0,4,-1,3,0,5,10,-1,8,7,2,74,30,44,64,32,32,18,2,8,31,-1,12,13,4,-4,11,1,3,5,-2,12,20,-2,9,9,13,17,8,9,8,4,6,10,3,5,4,5,7,7,5,4,4,102,53,49,81,44,37,15,7,20,30,18,7,3,8,3,19,13,5,12,-1,17,11,5,2,20,15,13,15,11,7,10,9,5,6,9,5,10,6,8,9,2,2,111,60,51,60,35,25,-7,7,60,20,23,2,-1,4,37,13,3,4,-6,3,23,7,20,-2,12,12,18,9,7,1,6,8,11,8,1,1,6,4,7,1,6,0,34,26,8,74,35,39,3,-4,5,-2,23,8,0,-2,17,-7,12,4,3,-2,-12,5,11,4,19,12,10,14,14,4,9,6,4,5,11,0,10,6,6,9,3,4,164,110,54,105,59,46,40,36,55,18,10,-3,33,23,32,15,5,-1,7,13,23,3,5,-2,25,26,21,22,4,2,12,21,13,12,-1,0,13,5,8,10,5,2,152,66,86,53,33,20,30,17,68,16,20,-6,14,2,22,18,14,-6,16,15,46,-2,6,0,14,26,13,4,-3,-2,6,17,8,5,-3,-1,8,9,5,-1,0,-1,151,74,77,20,10,10,28,20,32,41,27,2,11,13,22,11,18,0,17,7,10,30,9,2,6,1,5,-1,6,3,4,3,1,-2,3,1,2,-2,4,1,3,2,30,0,30,-25,-23,-2,20,6,18,-9,-7,0,4,1,-3,1,-3,1,16,5,21,-10,-4,-1,3,-7,-10,-4,-2,-5,2,-6,-10,-7,0,-2,1,-1,0,3,-2,-3,105,53,52,11,2,9,11,12,39,33,13,1,13,7,21,12,5,-3,-2,5,18,21,8,4,0,8,-2,0,0,6,0,5,-4,-1,-2,4,0,3,2,1,2,2,56,61,-5,6,2,4,-12,4,23,32,8,7,-8,6,35,18,5,9,-4,-2,-12,14,3,-2,4,6,-7,4,2,-3,3,4,-4,1,0,-2,1,2,-3,3,2,-1,-52,-46,-6,-22,-14,-8,2,-17,-39,-33,21,11,2,-13,-31,-21,12,4,0,-4,-8,-12,9,7,1,1,-13,-12,-1,2,1,1,-8,-7,-3,2,0,0,-5,-5,2,0,-46,-26,-20,-39,-32,-7,0,2,-29,-26,13,-4,7,-4,-9,-25,8,-3,-7,6,-20,-1,5,-1,-1,-3,-23,-13,1,0,-1,-4,-17,-12,2,0,0,1,-6,-1,-1,0,-21,0,-21,-15,-12,-3,9,-11,15,-26,-2,-8,9,-10,7,-7,-1,-1,0,-1,8,-19,-1,-7,-1,-2,-4,-13,4,0,-1,-4,-5,-9,3,3,0,2,1,-4,1,-3,41,36,5,35,19,16,10,17,-7,9,4,0,8,5,-3,17,6,-4,2,12,-4,-8,-2,4,10,7,5,5,5,2,5,7,2,2,3,0,5,0,3,3,2,2,1,-12,13,12,-1,13,6,-2,-15,-17,26,0,-3,3,-12,-12,15,-2,9,-5,-3,-5,11,2,-1,4,3,-12,12,6,0,-1,1,-8,5,2,-1,5,2,-4,7,4
15,15012,Boqueixón,4245,5,3,2,12,5,7,-1,1,-4,6,1,2,-1,1,-2,6,0,-1,0,0,-2,0,1,3,3,0,5,3,0,1,1,0,2,2,0,0,2,0,3,1,0,1,-8,1,-9,12,6,6,-1,-2,-3,-2,-1,2,3,-5,0,2,0,2,-4,3,-3,-4,-1,0,1,3,1,3,2,2,1,0,1,2,1,1,0,3,0,1,1,1,42,23,19,9,5,4,12,7,5,11,11,-3,7,1,5,4,6,0,5,6,0,7,5,-3,1,3,-1,2,4,0,0,1,0,1,3,0,1,2,-1,1,1,0,75,39,36,11,5,6,3,23,11,10,19,7,6,11,5,5,8,3,-3,12,6,5,11,4,3,1,-1,2,3,3,2,0,0,2,1,0,1,1,-1,0,2,3,68,33,35,6,4,2,11,8,21,9,10,8,10,1,8,5,6,2,1,7,13,4,4,6,0,-1,2,3,0,2,0,0,2,1,0,1,0,-1,0,2,0,1,58,32,26,10,4,6,9,12,20,0,5,11,7,9,7,2,1,6,2,3,13,-2,4,5,1,2,1,2,0,3,1,1,0,1,0,1,0,1,1,1,0,2,60,23,37,4,1,3,11,-6,24,16,9,7,2,-2,7,10,0,6,9,-4,17,6,9,1,0,2,3,-1,-1,1,0,2,0,-1,-1,1,0,0,3,0,0,0,26,13,13,9,4,5,19,4,-17,7,4,6,12,-2,-8,3,6,1,7,6,-9,4,-2,5,0,3,2,3,1,0,-1,2,1,2,1,0,1,1,1,1,0,0,22,1,21,10,5,5,4,-1,0,0,12,6,1,-5,5,-4,3,4,3,4,-5,4,9,2,0,1,3,-1,4,2,0,1,3,-1,1,1,0,0,0,0,3,1,13,26,-13,6,5,1,-10,1,5,-1,8,8,0,1,7,-1,10,5,-10,0,-2,0,-2,3,4,1,1,1,0,-1,3,1,0,1,0,0,1,0,1,0,0,-1,23,19,4,4,-1,5,-1,-1,-12,10,11,12,1,0,-3,4,6,9,-2,-1,-9,6,5,3,0,2,0,-1,0,3,0,1,0,-1,-1,0,0,1,0,0,1,3,6,0,6,5,0,5,1,10,4,-9,0,0,-2,-1,-1,3,1,-1,3,11,5,-12,-1,1,1,2,2,2,-1,-1,1,0,1,1,-1,-2,0,2,1,1,0,1,-6,3,-9,4,3,1,0,-5,-10,-10,5,10,5,0,-9,-2,2,6,-5,-5,-1,-8,3,4,0,1,-2,3,1,1,0,1,-2,3,0,1,0,0,0,0,1,0,-9,3,-12,2,1,1,-4,4,-7,-14,6,4,-5,1,0,-5,7,4,1,3,-7,-9,-1,0,0,0,3,-1,0,0,0,-2,3,0,0,0,0,2,0,-1,0,0,-4,-3,-1,3,1,2,-7,5,-6,6,1,-1,-1,3,-3,-1,-1,-1,-6,2,-3,7,2,0,-1,4,1,-1,-1,1,0,1,0,-1,-1,2,-1,3,1,0,0,-1,-3,-3,0,2,-2,4,-8,-2,0,-7,-1,17,-3,-3,-4,-2,0,11,-5,1,4,-5,-1,6,0,0,1,0,-1,2,0,0,0,-1,-2,1,0,0,1,1,1,1,-9,6,-15,19,7,12,-1,2,-11,-3,11,1,2,3,-2,-1,5,3,-3,-1,-9,-2,6,-2,3,2,2,4,5,3,0,0,1,2,2,2,3,2,1,2,3,1,3,-6,9,4,4,0,4,10,-12,0,-5,10,2,6,-5,-1,-3,-2,2,4,-7,1,-2,12,3,0,-1,1,-1,2,2,1,1,0,0,0,1,-1,-2,1,-1,2
15,15013,Brión,6275,64,32,32,15,6,9,31,-3,9,17,12,-2,12,1,4,12,5,-1,19,-4,5,5,7,-1,2,0,2,2,7,2,1,0,1,1,2,1,1,0,1,1,5,1,144,67,77,18,11,7,47,10,37,44,5,-1,24,0,20,20,2,-1,23,10,17,24,3,0,3,2,4,4,2,3,1,1,2,3,1,3,2,1,2,1,1,0,80,37,43,22,12,10,14,7,32,21,3,4,6,5,9,11,6,0,8,2,23,10,-3,4,5,2,3,5,6,1,3,2,1,2,3,1,2,0,2,3,3,0,152,69,83,10,4,6,26,-4,81,34,9,2,14,-8,42,18,4,-1,12,4,39,16,5,3,3,-1,1,3,1,3,2,0,-1,1,1,1,1,-1,2,2,0,2,161,79,82,26,9,17,35,15,75,30,-1,-1,18,11,34,15,-2,1,17,4,41,15,1,-2,10,1,9,4,1,1,6,0,1,3,-1,0,4,1,8,1,2,1,127,77,50,31,17,14,20,6,59,39,7,-4,22,1,24,30,1,1,-2,5,35,9,6,-5,4,10,13,4,-1,0,1,8,6,2,-1,0,3,2,7,2,0,0,108,56,52,49,24,25,18,7,49,20,15,4,10,5,21,11,6,4,8,2,28,9,9,0,12,5,15,6,5,5,8,3,4,3,1,5,4,2,11,3,4,0,39,14,25,39,23,16,-8,3,19,18,0,7,-6,-1,6,6,1,6,-2,4,13,12,-1,1,10,2,12,10,1,3,5,2,7,6,-1,3,5,0,5,4,2,0,110,55,55,20,10,10,18,27,28,21,14,1,3,14,20,13,8,1,15,13,8,8,6,0,5,7,4,0,5,-1,2,2,5,0,1,0,3,5,-1,0,4,-1,169,102,67,-1,-2,1,18,38,61,34,11,2,15,15,43,16,4,5,3,23,18,18,7,-3,2,2,-4,-5,1,3,1,1,-1,-5,0,2,1,1,-3,0,1,1,109,61,48,8,4,4,16,8,41,49,6,-12,5,5,20,29,9,-7,11,3,21,20,-3,-5,5,-2,4,3,-2,-1,2,0,1,1,0,-1,3,-2,3,2,-2,0,87,45,42,4,3,1,12,23,47,4,4,-6,10,3,29,1,1,0,2,20,18,3,3,-6,0,2,0,0,0,2,1,0,0,0,0,2,-1,2,0,0,0,0,82,42,40,-6,1,-7,9,5,47,14,8,-3,7,-2,25,4,5,2,2,7,22,10,3,-5,-5,1,-2,-3,1,2,-2,0,-1,-2,1,5,-3,1,-1,-1,0,-3,106,46,60,-8,0,-8,22,12,29,22,7,7,8,6,10,12,4,3,14,6,19,10,3,4,0,-1,-5,-5,1,0,1,-1,2,-3,1,0,-1,0,-7,-2,0,0,45,6,39,-7,-3,-4,12,3,17,7,6,1,3,-1,4,5,0,-6,9,4,13,2,6,7,0,3,-8,-4,3,-1,0,0,-2,-3,3,-1,0,3,-6,-1,0,0,60,37,23,11,3,8,14,2,18,13,2,11,5,1,14,7,3,6,9,1,4,6,-1,5,2,0,3,-1,3,3,0,0,3,-2,1,1,2,0,0,1,2,2,129,49,80,15,5,10,30,5,42,33,13,0,15,2,19,10,6,-2,15,3,23,23,7,2,3,0,7,-2,3,3,2,-1,4,-2,0,1,1,1,3,0,3,2,66,18,48,33,12,21,7,21,21,11,5,-1,3,6,9,-5,0,5,4,15,12,16,5,-6,8,10,1,7,6,1,3,3,2,1,3,0,5,7,-1,6,3,1
15,15014,Cabana de Bergantiños,5785,-39,-16,-23,22,11,11,-6,-21,-9,-2,4,-4,-4,-4,-5,-3,2,-1,-2,-17,-4,1,2,-3,6,2,7,5,2,0,3,1,3,3,1,0,3,1,4,2,1,0,-50,-29,-21,11,6,5,-4,-20,-24,3,-1,-4,0,-12,-12,0,0,-5,-4,-8,-12,3,-1,1,3,0,3,4,0,1,2,0,2,2,0,0,1,0,1,2,0,1,-73,-43,-30,-5,-1,-4,-7,-26,-26,-4,-4,-1,-1,-12,-17,-6,-2,-1,-6,-14,-9,2,-2,0,2,-8,0,1,-2,2,2,-4,0,1,-1,1,0,-4,0,0,-1,1,-15,-11,-4,23,14,9,8,-22,-13,0,11,1,4,-10,-11,-6,10,2,4,-12,-2,6,1,-1,8,0,2,6,6,1,5,0,1,2,5,1,3,0,1,4,1,0,-40,-18,-22,9,3,6,2,-15,-17,-6,3,-7,0,-8,-10,1,1,-2,2,-7,-7,-7,2,-5,4,-4,8,-4,3,1,1,-2,3,-2,1,1,3,-2,5,-2,2,0,-60,-32,-28,16,5,11,5,-16,-39,-1,-3,-5,1,-9,-17,-2,-2,-3,4,-7,-22,1,-1,-2,2,1,2,7,3,1,0,0,0,3,2,0,2,1,2,4,1,1,-60,-30,-30,9,6,3,-2,-27,-44,-3,23,-8,1,-14,-25,-5,14,-2,-3,-13,-19,2,9,-6,0,0,-3,4,8,-1,0,1,0,1,4,0,0,-1,-3,3,4,-1,-7,9,-16,13,6,7,1,-9,-12,12,3,-2,2,-5,0,6,3,3,-1,-4,-12,6,0,-5,0,-1,1,8,5,0,2,0,-2,3,3,0,-2,-1,3,5,2,0,-4,5,-9,12,7,5,8,-12,-9,-3,14,-5,2,-5,-4,3,7,2,6,-7,-5,-6,7,-7,0,3,1,4,2,2,0,1,1,2,1,2,0,2,0,2,1,0,-28,-30,2,2,-1,3,-5,2,-14,-9,7,-9,-6,-1,-11,-8,2,-5,1,3,-3,-1,5,-4,1,-4,3,-3,5,-1,-1,-2,1,-1,2,0,2,-2,2,-2,3,-1,0,3,-3,13,5,8,6,-4,-22,6,13,2,4,1,-15,5,9,0,2,-5,-7,1,4,2,7,1,-1,-1,6,1,2,0,-1,1,3,0,5,1,0,-2,3,1,-30,-17,-13,6,1,5,6,-4,-26,-6,7,-7,3,-4,-11,-6,4,-4,3,0,-15,0,3,-3,0,0,-1,-1,5,2,0,0,-1,-1,1,1,0,0,0,0,4,1,17,11,6,-6,-5,-1,2,13,-7,7,6,-4,3,8,-3,4,0,0,-1,5,-4,3,6,-4,-2,1,-4,-3,2,0,0,0,-4,-2,1,0,-2,1,0,-1,1,0,-37,-10,-27,-13,-13,0,-12,1,-26,-4,8,-3,-6,7,-9,-7,5,0,-6,-6,-17,3,3,-3,-1,-4,-7,-3,1,1,-3,-2,-7,-2,0,1,2,-2,0,-1,1,0,-40,-29,-11,-11,-8,-3,-6,-8,-21,-4,4,-4,-3,-5,-17,-6,4,-2,-3,-3,-4,2,0,-2,-3,-1,-3,-5,1,0,-1,-1,-2,-4,0,0,-2,0,-1,-1,1,0,-38,-20,-18,7,4,3,-6,-4,-21,-8,3,0,-4,0,-12,-8,2,3,-2,-4,-9,0,1,-3,0,-1,-3,1,8,2,-1,-1,-2,1,6,1,1,0,-1,0,2,1,-40,-26,-14,2,2,0,1,-4,-5,-18,-2,-7,0,-4,-4,-11,-5,1,1,0,-1,-7,3,-8,0,0,1,-1,0,2,0,0,0,0,0,2,0,0,1,-1,0,0,38,25,13,19,7,12,14,1,-10,7,22,4,6,0,-5,3,13,8,8,1,-5,4,9,-4,4,1,4,-1,11,0,1,0,2,-2,5,1,3,1,2,1,6,-1
15,15015,Cabanas,3271,39,14,25,20,8,12,1,2,9,6,5,13,5,-1,-3,5,1,6,-4,3,12,1,4,7,4,6,4,2,0,2,3,1,2,1,0,1,1,5,2,1,0,1,63,40,23,8,5,3,8,0,21,11,12,11,8,-1,14,4,9,6,0,1,7,7,3,5,3,1,1,1,2,0,1,0,1,1,2,0,2,1,0,0,0,0,-3,10,-13,11,5,6,-3,-9,-2,-3,13,1,2,-1,3,1,3,2,-5,-8,-5,-4,10,-1,6,1,3,2,-1,0,3,1,1,1,-2,1,3,0,2,1,1,-1,44,20,24,5,3,2,2,11,6,11,7,7,1,2,4,6,3,4,1,9,2,5,4,3,-1,0,0,0,1,5,0,0,0,0,0,3,-1,0,0,0,1,2,5,6,-1,11,7,4,9,-4,-3,-2,6,0,3,0,-4,1,6,0,6,-4,1,-3,0,0,4,0,1,3,4,-1,2,0,1,2,2,0,2,0,0,1,2,-1,-10,-20,10,6,3,3,6,-5,-13,6,-4,1,0,-3,-11,-1,-2,-1,6,-2,-2,7,-2,2,1,2,0,2,1,0,0,1,0,1,1,0,1,1,0,1,0,0,-32,-15,-17,3,1,2,-5,-4,-9,-5,-3,-5,1,-3,-5,-4,-1,-4,-6,-1,-4,-1,-2,-1,0,0,1,-1,3,0,0,0,0,-1,2,0,0,0,1,0,1,0,32,27,5,5,3,2,5,4,-10,12,19,3,0,4,1,7,13,4,5,0,-11,5,6,-1,-1,0,2,0,4,0,-1,0,2,0,2,0,0,0,0,0,2,0,61,39,22,15,11,4,6,3,10,20,11,9,-1,5,10,10,8,5,7,-2,0,10,3,4,0,1,4,6,4,0,1,0,3,3,4,0,-1,1,1,3,0,0,64,29,35,6,6,0,21,6,7,13,5,9,10,2,4,6,2,2,11,4,3,7,3,7,3,-1,1,2,1,0,2,1,2,1,0,0,1,-2,-1,1,1,0,1,1,0,0,0,0,1,1,0,-6,6,1,2,3,0,-5,2,0,-1,-2,0,-1,4,1,1,1,1,-1,0,-2,0,0,1,-1,1,-1,1,1,0,0,-1,-1,-12,-12,0,4,3,1,-14,-3,-31,6,0,31,-10,0,-8,1,-1,6,-4,-3,-23,5,1,25,1,0,1,1,1,0,0,0,2,0,1,0,1,0,-1,1,0,0,29,5,24,11,6,5,18,-2,-7,6,11,4,8,1,-9,1,3,0,10,-3,2,5,8,4,5,-1,-1,2,5,1,2,0,1,0,2,1,3,-1,-2,2,3,0,37,29,8,7,4,3,7,-2,6,4,-1,25,12,-2,5,5,0,10,-5,0,1,-1,-1,15,3,0,3,-1,1,1,3,0,1,-1,0,1,0,0,2,0,1,0,39,11,28,-5,-3,-2,1,-1,-5,0,19,26,-4,1,-5,-1,9,11,5,-2,0,1,10,15,0,0,-2,-1,-1,-1,0,0,0,-1,-1,-1,0,0,-2,0,0,0,-3,6,-9,0,-2,2,-1,11,-23,4,-1,6,4,4,-9,9,-2,0,-5,7,-14,-5,1,6,-1,1,2,-1,0,-1,1,-1,1,-1,0,-2,-2,2,1,0,0,1,90,24,66,-3,-2,-1,4,-1,5,7,1,74,4,-2,2,5,0,15,0,1,3,2,1,59,-1,-1,1,-1,0,-1,0,0,0,0,-1,-1,-1,-1,1,-1,1,0,44,20,24,10,3,7,3,-5,-2,-1,5,44,2,1,-1,0,0,18,1,-6,-1,-1,5,26,3,3,4,0,0,0,2,2,1,-1,-1,0,1,1,3,1,1,0
15,15016,Camariñas,7063,-79,-41,-38,72,38,34,-19,-41,-30,-1,8,5,-11,-25,-12,1,1,5,-8,-16,-18,-2,7,0,14,4,8,22,18,6,7,2,3,15,7,4,7,2,5,7,11,2,-66,-29,-37,43,23,20,-10,-28,-20,-5,-5,1,-3,-13,-13,-2,-1,3,-7,-15,-7,-3,-4,-2,12,3,12,10,2,2,7,1,3,9,1,2,5,2,9,1,1,0,-32,-23,-9,2,-6,8,10,-28,-22,-10,16,0,5,-19,-12,-9,8,1,5,-9,-10,-1,8,-1,13,-19,2,-9,11,3,7,-12,-1,-6,4,1,6,-7,3,-3,7,2,29,16,13,44,19,25,-2,-9,4,10,23,-1,0,1,2,1,13,-3,-2,-10,2,9,10,2,8,-2,12,10,18,-4,4,-3,7,4,10,-3,4,1,5,6,8,-1,19,29,-10,71,51,20,12,-5,-3,14,4,-6,9,5,-2,16,3,-2,3,-10,-1,-2,1,-4,16,2,20,22,7,4,12,2,13,16,4,4,4,0,7,6,3,0,-71,-36,-35,19,15,4,-4,-30,-22,-3,-3,-10,-1,-15,-9,0,-1,-9,-3,-15,-13,-3,-2,-1,14,-5,2,9,1,-4,9,-3,3,6,3,-3,5,-2,-1,3,-2,-1,8,14,-6,46,27,19,16,-4,-26,21,5,-5,9,5,-19,9,5,3,7,-9,-7,12,0,-8,6,7,3,12,12,4,2,6,-1,5,8,5,4,1,4,7,4,-1,-11,-1,-10,55,33,22,-2,-14,-14,7,13,1,1,-11,-10,6,16,-1,-3,-3,-4,1,-3,2,7,3,14,23,9,-2,4,1,7,12,10,-1,3,2,7,11,-1,-1,45,25,20,33,13,20,12,7,12,1,13,0,5,4,7,-4,8,5,7,3,5,5,5,-5,5,1,9,6,7,4,2,0,5,1,3,1,3,1,4,5,4,3,29,24,5,8,4,4,2,4,5,12,11,-4,3,5,11,6,5,-3,-1,-1,-6,6,6,-1,4,-3,-1,3,6,-1,4,-2,-1,1,2,0,0,-1,0,2,4,-1,-5,8,-13,-1,0,-1,6,-9,-13,6,11,-7,1,-2,2,2,8,-3,5,-7,-15,4,3,-4,1,-1,-6,0,4,1,0,0,-3,-1,3,1,1,-1,-3,1,1,0,-41,-21,-20,-32,-27,-5,-7,-3,-5,-23,6,-10,1,3,-7,-12,-2,-6,-8,-6,2,-11,8,-4,-4,0,-13,-20,6,-2,-2,1,-9,-15,0,-3,-2,-1,-4,-5,6,1,-96,-57,-39,-18,-13,-5,-18,-3,-35,-21,-3,-16,-11,-3,-16,-18,-2,-7,-7,0,-19,-3,-1,-9,-1,-8,-9,-1,4,-4,-2,-5,-6,-1,2,-1,1,-3,-3,0,2,-3,-45,-30,-15,-9,-15,6,-5,-11,-9,-11,-8,-2,-3,-1,-9,-5,-9,-4,-2,-10,0,-6,1,2,2,0,-2,-7,-6,2,1,1,-6,-5,-8,1,1,-1,4,-2,2,1,-112,-59,-53,-33,-14,-19,-20,-17,-44,-28,7,-6,-10,-9,-28,-14,4,-1,-10,-8,-16,-14,3,-5,-1,-3,-15,-16,4,-2,-1,0,-9,-7,3,0,0,-3,-6,-9,1,-2,-47,-39,-8,-8,-5,-3,-3,-4,-26,-3,-1,-10,-7,-10,-15,0,-3,-5,4,6,-11,-3,2,-5,-1,-4,-3,0,4,-4,-1,-3,-1,1,1,-2,0,-1,-2,-1,3,-2,-31,7,-38,0,2,-2,-4,-11,-17,1,-3,3,3,-2,-2,3,-1,6,-7,-9,-15,-2,-2,-3,-2,-3,-2,-2,1,8,1,-1,2,-4,0,4,-3,-2,-4,2,1,4,-51,-16,-35,-2,0,-2,-5,-10,-15,-19,11,-14,-4,-1,-10,-10,7,1,-1,-9,-5,-9,4,-15,-1,-2,-9,-1,10,1,-1,-2,-5,1,6,1,0,0,-4,-2,4,0
15,15017,Cambre,17074,689,358,331,116,47,69,51,114,273,123,83,42,45,47,135,65,41,24,6,67,138,58,42,18,18,25,39,12,16,6,11,11,13,5,5,2,7,14,26,7,11,4,573,275,298,82,31,51,70,42,256,87,67,52,23,12,130,46,38,25,47,30,126,41,29,27,13,17,20,9,13,9,5,5,8,2,5,6,8,12,12,7,8,3,542,261,281,124,51,73,52,65,229,106,51,38,23,28,111,66,19,15,29,37,118,40,32,23,23,28,27,23,15,5,11,14,7,13,1,4,12,14,20,10,14,1,543,295,248,125,54,71,27,54,288,51,58,55,25,13,164,31,31,23,2,41,124,20,27,32,38,16,31,19,15,3,23,5,10,5,7,3,15,11,21,14,8,0,497,236,261,148,63,85,31,55,247,65,39,39,31,14,129,24,18,15,0,41,118,41,21,24,20,31,43,15,26,9,12,6,25,5,11,4,8,25,18,10,15,5,560,270,290,155,63,92,57,97,219,82,80,28,25,43,119,33,38,12,32,54,100,49,42,16,35,18,38,22,25,17,16,5,12,9,12,9,19,13,26,13,13,8,325,171,154,172,90,82,28,62,136,1,47,45,-1,23,103,-8,24,25,29,39,33,9,23,20,40,33,36,30,18,12,21,15,20,18,7,7,19,18,16,12,11,5,364,178,186,189,90,99,24,46,162,43,34,53,17,30,92,14,4,21,7,16,70,29,30,32,36,33,46,40,26,6,22,10,22,18,13,4,14,23,24,22,13,2,304,105,199,145,63,82,93,27,106,42,10,18,48,0,45,15,-3,-3,45,27,61,27,13,21,30,31,39,21,18,5,14,13,20,10,5,0,16,18,19,11,13,5,284,125,159,94,44,50,65,43,76,27,19,46,37,18,46,11,-1,11,28,25,30,16,20,35,22,15,19,13,11,12,13,10,6,4,5,6,9,5,13,9,6,6,1,23,-22,1,5,-4,1,18,25,-29,11,-21,8,0,25,-13,12,-12,-7,18,0,-16,-1,-9,0,6,-2,-5,8,-7,1,0,2,1,3,-2,-1,6,-4,-6,5,-5,142,62,80,20,13,7,-6,17,129,-22,4,21,-8,16,56,-16,2,15,2,1,73,-6,2,6,6,3,-1,9,6,-3,3,3,-3,4,7,-1,3,0,2,5,-1,-2,66,12,54,-67,-41,-26,1,1,36,6,20,5,0,2,19,-15,12,-1,1,-1,17,21,8,6,1,-6,-39,-13,-9,1,-4,-7,-16,-10,-2,0,5,1,-23,-3,-7,1,11,32,-21,-79,-36,-43,10,14,12,-10,-2,-9,21,14,6,-5,4,-6,-11,0,6,-5,-6,-3,-1,-5,-23,-33,-8,-10,0,0,-12,-21,1,-4,-1,-5,-11,-12,-9,-6,60,-6,66,34,15,19,18,-9,9,-11,18,28,-1,-7,-7,-17,8,15,19,-2,16,6,10,13,14,13,4,-3,1,3,8,7,-2,-3,3,1,6,6,6,0,-2,2,25,15,10,67,27,40,-1,-13,40,-46,4,40,-1,6,19,-27,8,7,0,-19,21,-19,-4,33,21,5,10,6,9,13,12,3,5,-2,2,5,9,2,5,8,7,8,177,47,130,98,39,59,35,31,47,12,21,26,17,13,5,-10,9,11,18,18,42,22,12,15,20,17,11,14,20,15,12,8,4,1,7,7,8,9,7,13,13,8,195,96,99,153,67,86,17,19,63,43,23,27,16,2,31,19,9,19,1,17,32,24,14,8,30,36,17,27,20,21,21,12,8,11,4,11,9,24,9,16,16,10
15,15019,Carballo,27980,151,75,76,230,107,123,41,9,-1,57,36,7,28,6,-10,21,23,6,13,3,9,36,13,1,49,20,42,63,43,6,21,7,14,32,26,3,28,13,28,31,17,3,63,31,32,151,75,76,35,-15,4,6,32,1,17,-16,9,0,22,0,18,1,-5,6,10,1,37,18,33,31,21,8,18,10,16,13,14,3,19,8,17,18,7,5,305,155,150,265,133,132,98,47,74,34,40,2,58,14,26,24,23,3,40,33,48,10,17,-1,68,43,62,45,30,14,44,19,28,20,14,5,24,24,34,25,16,9,343,169,174,269,131,138,87,38,80,74,45,20,46,18,28,36,32,10,41,20,52,38,13,10,61,24,62,61,41,16,32,7,29,31,22,8,29,17,33,30,19,8,229,94,135,258,132,126,46,31,25,40,70,18,12,8,12,17,46,0,34,23,13,23,24,18,56,36,40,50,62,13,27,19,19,27,36,3,29,17,21,23,26,10,307,160,147,211,104,107,74,45,54,41,60,21,48,23,35,16,29,2,26,22,19,25,31,19,42,34,40,41,34,19,24,16,17,22,15,10,18,18,23,19,19,9,173,125,48,237,130,107,5,0,70,25,36,33,1,4,39,31,27,20,4,-4,31,-6,9,13,53,30,51,50,46,5,28,15,23,27,33,3,25,15,28,23,13,2,537,311,226,356,208,148,82,94,137,131,58,34,53,41,79,86,37,19,29,53,58,45,21,15,57,48,77,93,61,17,34,27,42,59,38,7,23,21,35,34,23,10,341,144,197,53,-2,55,56,77,151,30,14,1,17,39,71,6,-2,7,39,38,80,24,16,-6,12,25,19,-11,5,1,6,11,1,-18,-7,3,6,14,18,7,12,-2,139,68,71,4,-1,5,40,1,51,0,35,12,14,-13,40,4,16,8,26,14,11,-4,19,4,8,-5,-13,-6,16,3,1,-11,-3,-2,10,3,7,6,-10,-4,6,0,157,67,90,34,8,26,27,19,84,13,3,11,11,-1,47,8,3,-3,16,20,37,5,0,14,6,12,4,-1,13,-1,2,3,-2,-4,9,-1,4,9,6,3,4,0,47,50,-3,30,14,16,-5,16,24,1,13,3,-5,8,28,3,14,3,0,8,-4,-2,-1,0,14,3,2,-1,10,1,5,1,3,-2,6,1,9,2,-1,1,4,0,56,50,6,-23,-25,2,-16,-20,52,-3,-3,43,2,-7,34,5,-12,25,-18,-13,18,-8,9,18,-3,-6,-11,-13,5,4,-1,-4,-8,-11,-3,2,-2,-2,-3,-2,8,2,-22,-35,13,-16,-16,0,-6,7,-13,-24,20,1,-18,-6,-19,-8,14,6,12,13,6,-16,6,-5,-5,-2,-19,-11,16,5,-5,-4,-16,-6,12,3,0,2,-3,-5,4,2,30,34,-4,-14,-18,4,1,-6,18,-9,13,17,4,-9,13,-4,15,16,-3,3,5,-5,-2,1,5,-3,-16,-13,8,5,3,-5,-11,-11,1,5,2,2,-5,-2,7,0,32,22,10,7,6,1,1,-8,3,-29,26,42,-4,-7,22,-19,10,22,5,-1,-19,-10,16,20,-4,8,-16,-8,15,10,-2,6,-7,-7,8,7,-2,2,-9,-1,7,3,31,17,14,6,9,-3,-12,18,-18,5,7,24,-5,13,-16,3,4,19,-7,5,-2,2,3,5,-8,2,-7,-7,17,8,-3,5,-4,-1,5,6,-5,-3,-3,-6,12,2,140,79,61,99,36,63,-5,-8,69,-1,36,46,2,-1,33,-5,19,27,-7,-7,36,4,17,19,13,12,18,2,31,23,0,6,10,-3,12,11,13,6,8,5,19,12
15,15901,Cariño,5110,-28,-20,-8,25,13,12,-5,-8,-11,-6,1,4,1,-4,-13,-4,-1,3,-6,-4,2,-2,2,1,3,3,5,7,4,3,2,3,2,3,1,2,1,0,3,4,3,1,-64,-24,-40,23,15,8,-15,-24,-30,-3,7,0,-6,-7,-12,-3,6,-2,-9,-17,-18,0,1,2,3,1,5,3,9,1,3,1,2,2,7,0,0,0,3,1,2,1,-22,-2,-20,29,15,14,-4,-9,-8,10,-5,-7,-3,-4,1,5,-1,-1,-1,-5,-9,5,-4,-6,5,3,7,6,6,2,1,1,4,5,3,1,4,2,3,1,3,1,21,20,1,53,34,19,10,-7,-2,11,16,-7,2,-3,-1,11,11,0,8,-4,-1,0,5,-7,10,3,12,14,13,1,4,3,10,8,8,1,6,0,2,6,5,0,11,-5,16,50,29,21,12,-10,-12,3,8,8,5,-12,-13,8,4,2,7,2,1,-5,4,6,11,2,18,8,8,2,5,1,12,6,4,1,6,1,6,2,4,1,-44,-18,-26,22,14,8,-5,-1,-23,-7,0,-6,-1,-1,-6,-6,-3,-2,-4,0,-17,-1,3,-4,3,3,4,8,4,0,3,1,3,6,1,0,0,2,1,2,3,0,6,-3,9,34,18,16,2,2,-8,9,4,-1,-2,0,-13,9,4,1,4,2,5,0,0,-2,6,4,4,11,5,4,4,0,1,9,2,2,2,4,3,2,3,2,-22,-10,-12,42,20,22,-1,-10,-10,-5,1,3,-2,-2,-3,-1,-2,0,1,-8,-7,-4,3,3,9,6,8,7,9,3,2,3,4,5,5,1,7,3,4,2,4,2,29,25,4,35,20,15,11,1,0,9,12,-4,3,5,7,9,2,-1,8,-4,-7,0,10,-3,6,3,13,3,6,4,3,1,7,4,3,2,3,2,6,-1,3,2,-35,-18,-17,5,1,4,-4,-7,-27,-3,16,-8,-4,-1,-15,-1,9,-5,0,-6,-12,-2,7,-3,2,3,-1,0,2,-1,1,1,-1,0,1,-1,1,2,0,0,1,0,-30,-16,-14,-1,-4,3,7,-6,-12,-16,5,-7,2,-6,-5,-11,6,-1,5,0,-7,-5,-1,-6,3,1,-4,-5,3,1,1,0,-3,-5,2,1,2,1,-1,0,1,0,-51,-12,-39,1,4,-3,-4,-5,-17,-8,-9,-8,-1,-1,-3,0,-4,-5,-3,-4,-14,-8,-5,-3,-3,1,-1,1,3,-1,1,0,0,-1,3,0,-4,1,-1,2,0,-1,0,9,-9,9,2,7,-3,3,-15,8,15,-8,0,6,-4,1,6,1,-3,-3,-11,7,9,-9,1,-1,0,1,6,1,0,-1,-1,1,1,2,1,0,1,0,5,-1,-51,-37,-14,-22,-22,0,5,-7,-31,-18,-2,2,6,-5,-22,-16,0,0,-1,-2,-9,-2,-2,2,2,-2,-17,-7,1,1,1,0,-13,-10,1,-1,1,-2,-4,3,0,2,-34,-9,-25,-2,-1,-1,-7,-5,-9,-9,6,-7,-2,-6,-3,-3,2,4,-5,1,-6,-6,4,-11,-1,1,-1,-2,1,0,0,0,0,-1,0,0,-1,1,-1,-1,1,0,-45,-24,-21,-10,-9,-1,2,-1,-15,-12,-6,-12,4,1,-12,-7,-7,-3,-2,-2,-3,-5,1,-9,-1,1,-3,-3,-5,1,0,1,-2,-4,-4,0,-1,0,-1,1,-1,1,-20,-8,-12,20,10,10,4,-3,-25,1,7,-5,2,0,-11,-3,4,0,2,-3,-14,4,3,-5,3,0,2,4,7,4,1,0,1,1,5,2,2,0,1,3,2,2,5,11,-6,13,9,4,-3,2,7,4,-6,0,-2,-2,4,9,-2,3,-1,4,3,-5,-4,-3,2,2,3,5,-2,3,1,0,1,5,-1,3,1,2,2,0,-1,0
15,15020,Carnota,5864,3,3,0,49,26,23,0,-18,-13,6,28,1,4,-13,-8,-1,20,1,-4,-5,-5,7,8,0,8,1,3,9,18,9,4,0,1,3,12,5,4,1,2,6,6,4,-52,-27,-25,27,14,13,-15,-17,-26,-10,8,7,-4,-11,-17,-5,6,3,-11,-6,-9,-5,2,4,0,4,2,4,10,6,0,1,2,1,7,2,0,3,0,3,3,4,-61,-46,-15,4,-8,12,-4,-12,-29,-8,-3,-2,-6,-6,-22,-7,-5,1,2,-6,-7,-1,2,-3,6,-8,-2,3,2,3,2,-6,-4,0,0,0,4,-2,2,3,2,3,-21,0,-21,41,24,17,-11,-7,-29,15,2,12,-5,0,-12,7,4,7,-6,-7,-17,8,-2,5,5,3,11,11,8,3,2,1,7,5,6,3,3,2,4,6,2,0,12,12,0,27,15,12,2,-6,-11,9,15,2,-3,-4,1,7,11,0,5,-2,-12,2,4,2,4,3,9,3,7,0,4,0,4,2,5,0,0,3,5,1,2,0,-45,-25,-20,19,7,12,-9,4,-21,-13,3,-7,-3,1,-15,-6,3,-5,-6,3,-6,-7,0,-2,2,2,6,0,7,2,1,2,1,-1,3,1,1,0,5,1,4,1,-37,-26,-11,11,3,8,-1,-9,-22,-10,11,-7,-4,-7,-14,-7,4,2,3,-2,-8,-3,7,-9,1,-3,0,2,10,1,-2,-3,1,0,4,3,3,0,-1,2,6,-2,-12,-4,-8,31,13,18,4,3,-22,6,9,-9,2,5,-14,1,3,0,2,-2,-8,5,6,-9,7,3,1,11,8,1,2,1,-1,7,2,2,5,2,2,4,6,-1,15,11,4,11,2,9,2,-2,-8,0,22,0,-1,-1,1,1,11,-1,3,-1,-9,-1,11,1,0,-3,2,3,9,0,0,-3,2,1,3,-1,0,0,0,2,6,1,1,6,-5,-3,-5,2,8,-9,9,10,-2,-15,2,-3,6,8,1,-8,6,-6,3,2,-3,-7,3,-2,-2,-1,-2,1,0,-2,-1,0,0,-2,3,0,-1,-1,-2,3,-17,-6,-11,-8,-6,-2,0,-2,-17,5,4,-7,-2,-2,-11,5,5,-1,2,0,-6,0,-1,-6,-2,0,-2,0,-4,0,-2,0,-2,0,-2,0,0,0,0,0,-2,0,-99,-44,-55,-6,-4,-2,-3,-4,-52,-9,-4,-23,4,-2,-32,-3,-3,-6,-7,-2,-20,-6,-1,-17,5,1,-7,-5,1,-2,3,0,-4,-3,1,-1,2,1,-3,-2,0,-1,-17,-4,-13,-2,0,-2,3,-2,-17,-8,6,1,3,0,-8,-1,0,2,0,-2,-9,-7,6,-1,0,-1,-4,-4,7,0,0,1,-3,-1,2,1,0,-2,-1,-3,5,-1,-21,3,-24,-9,-6,-3,5,3,-19,2,-3,-8,8,2,-6,2,-2,-2,-3,1,-13,0,-1,-6,0,-2,-6,-3,-1,3,0,-1,-3,-2,-2,2,0,-1,-3,-1,1,1,-36,-24,-12,-13,-7,-6,3,-9,-13,-10,-4,-4,2,-6,-9,-8,-1,-3,1,-3,-4,-2,-3,-1,0,-1,-6,-2,-3,-1,0,0,-3,-1,-2,-1,0,-1,-3,-1,-1,0,-55,-21,-34,-9,-8,-1,-9,-12,-21,-11,10,-10,-3,-2,-9,-8,5,-2,-6,-10,-12,-3,5,-8,-1,-1,-9,-3,6,-1,0,-1,-7,-4,5,-1,-1,0,-2,1,1,0,-59,-32,-27,-3,-7,4,-6,-4,-24,-17,10,-17,-2,-4,-17,-9,5,-4,-4,0,-7,-8,5,-13,3,3,-6,-6,5,-3,3,0,-4,-5,0,-1,0,3,-2,-1,5,-2,12,0,12,13,4,9,2,-2,-7,5,17,-2,-2,-2,-3,2,8,-3,4,0,-4,3,9,1,1,3,2,-1,6,2,1,1,1,-1,3,-1,0,2,1,0,3,3
15,15021,Carral,5290,15,11,4,20,12,8,3,2,-11,8,14,2,2,0,-4,4,11,0,1,2,-7,4,3,2,3,4,3,3,5,2,2,1,2,2,4,1,1,3,1,1,1,1,34,19,15,12,7,5,9,-4,17,5,6,1,6,-4,5,3,7,2,3,0,12,2,-1,-1,4,1,4,1,1,1,3,1,1,0,1,1,1,0,3,1,0,0,72,58,14,44,23,21,27,-2,16,21,9,-1,20,3,15,17,2,0,7,-5,1,4,7,-1,12,3,9,10,6,3,7,1,5,7,1,2,5,2,4,3,5,1,89,24,65,28,13,15,9,8,32,16,16,7,-4,-3,10,11,10,0,13,11,22,5,6,7,7,1,7,6,3,4,4,1,3,3,1,1,3,0,4,3,2,3,80,34,46,15,6,9,15,9,23,15,11,7,5,8,6,7,8,2,10,1,17,8,3,5,1,5,3,2,2,2,0,3,1,0,1,1,1,2,2,2,1,1,87,45,42,44,24,20,27,19,22,15,3,1,15,4,11,13,1,-2,12,15,11,2,2,3,10,8,8,15,2,1,7,3,4,9,1,0,3,5,4,6,1,1,69,30,39,33,11,22,14,-6,24,26,11,-2,4,-5,16,12,5,-2,10,-1,8,14,6,0,13,3,8,8,2,-1,2,2,3,2,2,0,11,1,5,6,0,-1,90,42,48,28,17,11,4,19,34,20,4,7,0,6,17,13,1,5,4,13,17,7,3,2,2,7,3,9,2,5,1,5,4,4,2,1,1,2,-1,5,0,4,124,75,49,11,9,2,15,17,66,19,11,-6,17,7,42,8,5,-3,-2,10,24,11,6,-3,2,5,2,-2,3,1,2,1,2,1,2,1,0,4,0,-3,1,0,121,77,44,20,10,10,16,24,64,4,11,-1,18,14,33,-3,8,1,-2,10,31,7,3,-2,7,12,2,0,1,-2,4,4,2,0,0,0,3,8,0,0,1,-2,135,81,54,17,10,7,-2,25,71,26,8,2,-2,14,40,20,3,1,0,11,31,6,5,1,6,4,4,3,-1,1,3,2,3,1,0,1,3,2,1,2,-1,0,94,47,47,18,9,9,16,1,40,16,13,8,14,-3,20,9,5,3,2,4,20,7,8,5,6,6,3,4,0,-1,4,2,1,3,0,-1,2,4,2,1,0,0,-7,-9,2,9,1,8,-7,5,17,-12,1,-10,-6,-1,6,-3,0,-5,-1,6,11,-9,1,-5,1,3,3,0,0,2,0,-1,3,0,-1,0,1,4,0,0,1,2,-8,-6,-2,8,4,4,4,3,-23,14,-8,-2,-1,4,-12,8,-7,-1,5,-1,-11,6,-1,-1,1,7,1,-3,1,1,2,2,1,-1,0,0,-1,5,0,-2,1,1,58,22,36,17,12,5,7,19,8,3,11,8,4,11,3,0,5,-2,3,8,5,3,6,10,6,6,-1,3,2,1,3,5,0,3,0,1,3,1,-1,0,2,0,27,11,16,6,1,5,0,1,12,-2,4,10,6,1,-1,-3,-1,6,-6,0,13,1,5,4,3,2,2,0,-1,0,2,2,-1,-1,-1,0,1,0,3,1,0,0,56,20,36,20,6,14,13,8,4,19,16,2,1,3,10,0,8,0,12,5,-6,19,8,2,9,4,3,6,-1,-1,4,1,3,0,-1,-1,5,3,0,6,0,0,86,46,40,21,12,9,1,20,41,-3,16,7,2,10,23,1,7,3,-1,10,18,-4,9,4,0,15,1,-4,4,4,0,10,1,-2,1,2,0,5,0,-2,3,2
15,15022,Cedeira,7553,50,29,21,30,14,16,5,7,9,3,17,10,6,2,8,-3,8,8,-1,5,1,6,9,2,4,2,6,3,6,9,4,0,2,0,3,5,0,2,4,3,3,4,-21,-16,-5,34,17,17,-8,-7,-14,-7,12,3,-6,-7,-4,-6,5,2,-2,0,-10,-1,7,1,6,5,9,5,9,0,3,1,7,2,4,0,3,4,2,3,5,0,-59,-31,-28,19,7,12,2,-23,-34,-9,5,1,2,-7,-21,-2,1,-3,0,-16,-13,-7,4,4,1,4,1,4,6,2,1,3,0,1,1,0,0,1,1,3,5,2,20,32,-12,42,29,13,-5,3,-3,-4,26,0,-1,10,2,-2,16,2,-4,-7,-5,-2,10,-2,6,6,9,4,12,3,3,6,4,3,8,3,3,0,5,1,4,0,14,8,6,35,17,18,5,-1,-19,15,6,9,3,1,-12,9,3,4,2,-2,-7,6,3,5,3,14,3,8,3,4,1,7,0,6,1,2,2,7,3,2,2,2,66,37,29,56,25,31,21,1,19,7,12,3,17,-1,9,2,8,0,4,2,10,5,4,3,17,13,10,9,4,1,10,4,3,4,2,0,7,9,7,5,2,1,78,58,20,92,55,37,18,3,6,21,15,14,7,7,12,13,9,9,11,-4,-6,8,6,5,18,19,25,23,6,1,9,11,15,16,4,0,9,8,10,7,2,1,54,30,24,96,57,39,10,12,6,16,10,2,14,7,1,3,7,0,-4,5,5,13,3,2,17,24,21,26,7,1,11,14,11,15,5,1,6,10,10,11,2,0,46,31,15,36,16,20,3,19,2,1,19,-1,2,17,-1,2,6,3,1,2,3,-1,13,-4,7,8,12,0,6,3,4,6,2,0,3,1,3,2,10,0,3,2,36,35,1,32,17,15,1,13,-4,5,11,10,4,10,5,2,7,7,-3,3,-9,3,4,3,2,9,12,2,3,4,0,3,6,3,3,2,2,6,6,-1,0,2,-10,-18,8,-18,-21,3,17,-11,-20,-5,19,-11,4,-9,-15,-6,8,-2,13,-2,-5,1,11,-9,7,-1,-10,-8,-2,-4,2,-4,-7,-9,-2,-1,5,3,-3,1,0,-3,-41,-16,-25,2,11,-9,-8,11,-4,-26,-11,-1,-5,7,-6,-9,-4,2,-3,4,2,-17,-7,-3,0,10,2,-7,-4,2,5,7,2,-3,-1,2,-5,3,0,-4,-3,0,32,8,24,9,0,9,21,3,1,11,0,-6,6,-1,2,2,1,-2,15,4,-1,9,-1,-4,7,-5,5,1,1,-1,-1,-5,4,-1,2,0,8,0,1,2,-1,-1,-32,-1,-31,8,8,0,-8,5,-33,-4,14,-5,-9,7,-10,4,6,2,1,-2,-23,-8,8,-7,-1,8,0,0,4,-3,-1,3,3,1,3,-1,0,5,-3,-1,1,-2,-3,0,-3,14,5,9,11,5,-10,1,-5,-6,6,6,-10,7,-6,-3,5,-1,0,-6,1,-3,5,2,0,5,0,1,1,4,-2,3,-1,0,4,-2,2,2,1,1,44,24,20,30,22,8,8,14,-9,21,13,-2,4,8,-2,8,8,-3,4,6,-7,13,5,1,3,6,7,6,6,2,3,4,7,3,3,2,0,2,0,3,3,0,-21,-26,5,18,3,15,3,4,-8,-13,4,-9,-7,-1,-6,-5,0,-5,10,5,-2,-8,4,-4,6,9,1,3,0,-2,3,3,-3,2,-1,-2,3,6,4,1,1,0,-42,-21,-21,-13,-16,3,-14,6,-26,-24,11,1,-8,1,-17,-12,6,5,-6,5,-9,-12,5,-4,0,6,-6,-10,-6,1,-2,3,-9,-7,-3,0,2,3,3,-3,-3,1
15,15023,Cee,7352,-12,-5,-7,56,29,27,5,-24,-1,0,5,2,7,-16,0,2,1,1,-2,-8,-1,-2,4,1,9,3,12,13,12,6,5,0,6,8,7,3,4,3,6,5,5,3,-27,-1,-26,40,20,20,0,-18,-6,-21,14,6,1,-6,3,-14,9,7,-1,-12,-9,-7,5,-1,8,5,13,6,5,3,4,2,6,2,3,3,4,3,7,4,2,0,89,31,58,31,10,21,26,1,23,25,10,2,1,-4,15,15,2,-1,25,5,8,10,8,3,11,2,-2,9,9,2,5,1,-6,5,5,0,6,1,4,4,4,2,97,50,47,46,25,21,19,0,48,1,13,14,6,2,17,8,11,6,13,-2,31,-7,2,8,12,1,17,5,10,1,6,1,7,4,6,1,6,0,10,1,4,0,110,50,60,63,32,31,34,7,6,38,26,-5,10,3,-1,23,17,0,24,4,7,15,9,-5,11,-1,12,24,14,0,4,1,3,15,9,0,7,-2,9,9,5,0,46,28,18,33,20,13,11,-11,12,17,6,9,7,-2,7,5,7,3,4,-9,5,12,-1,6,12,1,11,8,0,-2,9,0,4,4,3,-1,3,1,7,4,-3,-1,112,62,50,47,23,24,27,19,-10,21,32,18,20,2,4,12,13,9,7,17,-14,9,19,9,13,3,1,10,12,5,7,1,3,5,5,2,6,2,-2,5,7,3,73,35,38,39,19,20,14,11,19,19,16,-1,7,3,1,11,11,2,7,8,18,8,5,-3,0,7,3,13,12,2,1,2,1,7,4,1,-1,5,2,6,8,1,43,35,8,21,11,10,7,-9,26,11,3,4,0,3,15,6,5,4,7,-12,11,5,-2,0,10,-2,10,3,0,0,3,0,5,2,0,1,7,-2,5,1,0,-1,121,42,79,49,18,31,25,-2,26,41,27,5,3,1,0,25,14,-1,22,-3,26,16,13,6,12,1,9,13,12,2,5,1,1,6,5,0,7,0,8,7,7,2,85,40,45,-4,-5,1,15,6,40,-2,12,12,9,-1,21,-7,6,10,6,7,19,5,6,2,2,-2,2,-5,-4,3,-1,-3,1,-6,-1,5,3,1,1,1,-3,-2,-2,0,-2,3,-5,8,4,-13,4,-12,13,0,9,-6,9,-14,1,1,-5,-7,-5,2,12,-1,4,2,1,-1,-3,-1,2,-1,-2,-1,-2,-1,2,3,3,0,-1,0,16,-3,19,-11,-10,-1,-2,7,10,-9,15,-7,-1,-2,0,-7,9,-1,-1,9,10,-2,6,-6,2,-1,-2,-9,2,-3,3,-1,-5,-8,3,-2,-1,0,3,-1,-1,-1,-29,-15,-14,-15,-5,-10,-11,-7,-6,-9,1,-2,-9,2,-5,-5,0,2,-2,-9,-1,-4,1,-4,-1,-2,-5,-5,0,-2,2,-1,-2,-4,-1,1,-3,-1,-3,-1,1,-3,-2,-4,2,-8,-4,-4,11,-1,-14,-6,13,-2,8,-3,-14,-5,12,1,3,2,0,-1,1,-3,0,0,-10,-1,0,3,2,-1,-6,0,-2,3,-2,1,-4,-1,2,0,-11,7,-18,5,4,1,13,-5,-2,-9,-2,-3,9,3,5,-11,0,1,4,-8,-7,2,-2,-4,2,1,-5,-4,6,5,2,3,-3,-4,4,2,0,-2,-2,0,2,3,-74,-49,-25,1,1,0,-10,-9,-33,-9,-3,-9,-6,-8,-17,-9,-3,-5,-4,-1,-16,0,0,-4,3,-3,2,-3,3,-1,2,-2,-1,-1,3,0,1,-1,3,-2,0,-1,50,25,25,40,19,21,17,5,19,11,-5,4,6,7,13,1,-2,1,11,-2,6,10,-3,3,10,3,3,10,7,7,4,1,1,6,4,3,6,2,2,4,3,4
15,15024,Cerceda,5513,-19,-14,-5,32,17,15,-15,14,-24,4,5,-5,-11,5,-13,4,3,-3,-4,9,-11,0,2,-2,4,7,4,7,8,2,2,2,3,4,5,1,2,5,1,3,3,1,22,13,9,28,14,14,-6,7,2,5,13,0,-5,2,8,3,6,-1,-1,5,-6,2,7,1,8,3,3,8,5,0,5,1,1,4,3,0,3,2,2,4,2,0,88,50,38,25,13,12,10,36,23,11,3,3,6,22,12,3,1,5,4,14,11,8,2,-2,3,4,4,6,8,-1,1,1,2,3,5,0,2,3,2,3,3,-1,82,42,40,44,27,17,21,25,4,9,12,8,16,13,3,-3,4,8,5,12,1,12,8,0,13,3,10,2,13,3,7,2,7,3,5,3,6,1,3,-1,8,0,48,5,43,43,19,24,15,20,6,4,12,-9,4,11,-12,-2,7,-3,11,9,18,6,5,-6,11,3,9,9,14,-4,3,0,2,4,11,-2,8,3,7,5,3,-2,16,10,6,22,12,10,7,-13,-12,18,10,6,3,-1,-5,5,5,3,4,-12,-7,13,5,3,2,-2,4,6,8,4,1,-1,1,4,4,3,1,-1,3,2,4,1,119,51,68,26,17,9,2,36,21,40,17,3,0,23,-4,17,13,2,2,13,25,23,4,1,3,1,0,6,14,2,2,2,-2,4,10,1,1,-1,2,2,4,1,41,22,19,41,32,9,17,15,4,11,1,-7,9,11,1,2,0,-1,8,4,3,9,1,-6,5,11,10,7,7,1,4,11,8,5,4,0,1,0,2,2,3,1,31,32,-1,39,23,16,24,8,-1,-14,8,3,15,2,10,-4,3,3,9,6,-11,-10,5,0,4,7,15,4,5,3,2,3,10,3,3,2,2,4,5,1,2,1,-35,-26,-9,1,-4,5,-10,11,-36,-15,8,6,-9,4,-21,-6,5,1,-1,7,-15,-9,3,5,1,0,-4,-3,5,2,0,-1,-3,-3,3,0,1,1,-1,0,2,2,-60,-32,-28,-5,-4,-1,-11,-7,-36,-19,11,2,-8,-4,-19,-7,5,2,-3,-3,-17,-12,6,0,-4,2,-7,-4,8,0,-3,0,-4,-2,5,0,-1,2,-3,-2,3,0,-40,-9,-31,8,6,2,-3,-2,-33,1,-3,-2,0,-1,-12,7,-3,-1,-3,-1,-21,-6,0,-1,1,0,1,-1,5,2,0,0,0,0,4,2,1,0,1,-1,1,0,-5,-10,5,-9,-7,-2,6,3,-7,0,0,-7,2,-1,-3,-3,0,-5,4,4,-4,3,0,-2,-2,-3,-1,-3,0,0,-2,-1,-1,-2,-1,0,0,-2,0,-1,1,0,-50,-22,-28,0,-2,2,-6,-5,-9,-9,-2,-16,-4,-1,-5,-5,3,-8,-2,-4,-4,-4,-5,-8,2,0,-2,0,1,-1,1,0,-1,-2,1,-1,1,0,-1,2,0,0,-14,0,-14,20,16,4,-12,-4,-12,4,-1,11,-10,-2,-3,10,-1,6,-2,-2,-9,-6,0,5,2,1,1,8,7,1,0,1,2,8,4,1,2,0,-1,0,3,0,1,8,-7,2,7,-5,-1,-2,-5,6,7,-4,0,5,-10,9,6,-1,-1,-7,5,-3,1,-3,-2,1,1,2,1,-1,0,2,1,3,2,-1,-2,-1,0,-1,-1,0,17,26,-9,4,1,3,-1,4,4,12,-3,-1,1,5,5,12,-1,3,-2,-1,-1,0,-2,-4,-2,1,-4,2,6,1,-2,1,-4,2,3,1,0,0,0,0,3,0,69,41,28,27,16,11,7,9,23,12,16,0,8,4,15,1,11,0,-1,5,8,11,5,0,4,4,4,4,4,7,5,2,2,2,0,5,-1,2,2,2,4,2
15,15028,Corcubión,1929,47,28,19,19,13,6,7,2,14,7,9,6,5,1,7,4,4,5,2,1,7,3,5,1,4,2,3,5,2,2,3,1,2,3,1,2,1,1,1,2,1,0,13,1,12,15,5,10,12,-7,9,-2,-3,3,5,-4,0,1,-1,0,7,-3,9,-3,-2,3,3,1,4,5,1,1,0,1,1,3,0,0,3,0,3,2,1,1,-54,-27,-27,10,5,5,-12,-7,-8,-18,-5,-5,-5,-6,1,-12,-2,-2,-7,-1,-9,-6,-3,-3,1,2,5,1,0,0,0,2,4,-1,0,0,1,0,1,2,0,0,-12,2,-14,8,6,2,-3,-7,-4,3,3,-3,-1,-1,0,4,1,-2,-2,-6,-4,-1,2,-1,0,2,3,1,1,1,0,1,3,2,0,0,0,1,0,-1,1,1,-16,-7,-9,18,4,14,-13,4,-9,0,-1,2,-8,5,-3,-1,-1,0,-5,-1,-6,1,0,2,2,4,2,4,4,2,-1,1,1,1,1,1,3,3,1,3,3,1,-26,-18,-8,-3,-3,0,-2,-7,-3,-10,0,-3,1,-5,-3,-9,1,-3,-3,-2,0,-1,-1,0,0,-1,0,-2,1,-1,0,0,0,-3,1,-1,0,-1,0,1,0,0,-1,1,-2,11,4,7,-7,-1,-5,7,7,0,-3,0,-2,2,4,1,-4,-1,-3,5,3,-1,0,2,1,4,6,-2,0,0,1,2,2,-1,0,2,0,2,4,-1,-55,-32,-23,2,0,2,-10,-3,-19,-21,-4,2,-5,1,-11,-10,-5,-3,-5,-4,-8,-11,1,5,1,0,2,-2,0,0,-1,1,0,0,-1,0,2,-1,2,-2,1,0,0,-1,1,7,2,5,0,2,-6,11,-1,-7,1,-1,-6,4,2,-1,-1,3,0,7,-3,-6,1,2,3,1,0,0,1,1,1,-1,0,0,0,1,2,2,0,0,-4,-5,1,-4,-1,-3,-6,7,5,-6,0,-1,-5,2,2,-3,0,1,-1,5,3,-3,0,-2,-3,-2,1,-2,1,1,-1,0,0,-1,0,1,-2,-2,1,-1,1,0,-30,-12,-18,-5,-3,-2,-7,-5,-15,-2,0,-1,-1,0,-9,0,0,-1,-6,-5,-6,-2,0,0,-2,1,-4,0,0,0,-1,1,-3,0,0,0,-1,0,-1,0,0,0,-2,0,-2,-3,-1,-2,6,-3,1,-3,-1,-3,6,-5,1,-1,0,-3,0,2,0,-2,-1,0,-1,0,0,-3,1,0,0,0,0,-2,0,1,-1,0,0,-1,1,-1,-6,-3,-3,2,1,1,2,0,5,-8,-4,-2,1,-3,4,-5,1,-2,1,3,1,-3,-5,0,1,1,1,-1,2,-2,1,0,0,0,2,-2,0,1,1,-1,0,0,-8,4,-12,-9,-1,-8,2,1,-5,-1,0,-2,0,4,-1,0,1,1,2,-3,-4,-1,-1,-3,-2,-3,-2,-3,0,1,0,-1,-1,-1,0,2,-2,-2,-1,-2,0,-1,-6,-2,-4,3,3,0,-1,-2,5,2,-6,-5,1,-2,3,0,-4,-1,-2,0,2,2,-2,-4,-2,0,1,1,3,0,0,0,0,0,2,1,-2,0,1,1,1,-1,-37,-31,-6,-5,-3,-2,-7,4,-21,-14,1,4,-4,-1,-14,-6,-3,1,-3,5,-7,-8,4,3,-1,0,-2,-3,-1,2,-1,0,-1,-1,-1,1,0,0,-1,-2,0,1,-4,4,-8,2,1,1,-6,-2,2,4,3,-6,-4,0,-3,9,0,1,-2,-2,5,-5,3,-7,0,0,0,-1,2,1,0,0,0,0,0,1,0,0,0,-1,2,0,1,-3,4,3,-1,4,4,0,-3,-4,1,3,2,0,-5,-1,1,0,2,0,2,-3,0,3,2,0,-2,0,2,1,0,0,-2,-1,1,1,2,0,0,1,1,0
15,15029,Coristanco,8218,2,-6,8,56,30,26,14,-21,-11,8,10,4,3,-9,-10,4,5,1,11,-12,-1,4,5,3,11,6,15,14,8,2,6,2,8,9,4,1,5,4,7,5,4,1,-44,-26,-18,36,20,16,-13,-15,-29,-2,13,2,-2,-7,-22,-4,8,0,-11,-8,-7,2,5,2,7,0,10,10,7,1,2,0,5,6,6,0,5,0,5,4,1,1,-63,-39,-24,28,13,15,8,-26,-46,2,0,2,3,-16,-28,0,1,3,5,-10,-18,2,-1,-1,8,1,4,6,5,3,3,-1,0,4,4,2,5,2,4,2,1,1,-33,-16,-17,21,10,11,0,-18,-24,4,10,-6,-3,-14,-9,2,5,2,3,-4,-15,2,5,-8,4,5,2,3,8,-2,2,2,1,1,4,0,2,3,1,2,4,-2,-70,-30,-40,39,23,16,-4,-30,-45,-3,15,-2,-4,-13,-21,-1,10,1,0,-17,-24,-2,5,-3,7,-1,2,17,12,0,3,-1,1,11,8,0,4,0,1,6,4,0,-21,-23,2,27,15,12,-10,0,-6,-10,10,-5,-7,-6,-12,-3,7,-1,-3,6,6,-7,3,-4,4,-1,7,5,11,1,4,-1,2,3,7,0,0,0,5,2,4,1,-9,-11,2,30,20,10,14,-15,-19,-5,15,-2,12,-7,-17,-7,9,-2,2,-8,-2,2,6,0,1,4,6,4,14,0,0,3,4,3,10,0,1,1,2,1,4,0,-82,-19,-63,48,27,21,-8,-27,-41,4,4,-11,-5,-11,-10,7,6,-5,-3,-16,-31,-3,-2,-6,6,4,6,23,6,3,2,2,5,12,5,1,4,2,1,11,1,2,-31,-15,-16,15,10,5,11,1,-52,3,11,-4,7,-6,-26,1,7,2,4,7,-26,2,4,-6,3,4,2,3,1,2,2,3,1,2,1,1,1,1,1,1,0,1,-69,-30,-39,-4,-3,-1,-3,-24,-32,2,-3,-9,-3,-11,-10,0,0,-5,0,-13,-22,2,-3,-4,-2,-2,-1,-3,2,0,-2,-2,1,-2,2,0,0,0,-2,-1,0,0,-14,-15,1,2,-1,3,6,2,-42,2,21,-8,1,1,-24,-3,7,-1,5,1,-18,5,14,-7,-2,0,1,-2,5,0,-1,0,0,-3,3,0,-1,0,1,1,2,0,-48,-40,-8,-7,-3,-4,0,-29,-9,-19,5,-2,-3,-7,-22,-9,3,-2,3,-22,13,-10,2,0,1,-4,-4,-3,3,0,1,0,-4,-2,2,0,0,-4,0,-1,1,0,-17,-20,3,-9,-7,-2,12,0,-32,5,3,-9,-1,0,-16,-1,3,-5,13,0,-16,6,0,-4,0,0,-2,-5,-3,1,0,0,-2,-4,-2,1,0,0,0,-1,-1,0,-82,-20,-62,-12,-6,-6,-12,-7,-42,-11,-5,-7,1,-1,-12,-3,-3,-4,-13,-6,-30,-8,-2,-3,1,-4,-5,-2,-1,-1,0,-2,-2,-1,0,-1,1,-2,-3,-1,-1,0,-89,-41,-48,-12,-3,-9,-7,-17,-25,-17,-7,-16,0,-9,-13,-3,-4,-12,-7,-8,-12,-14,-3,-4,-2,-3,-4,-3,0,0,-1,-1,-1,0,0,0,-1,-2,-3,-3,0,0,-45,-29,-16,-12,-6,-6,2,-17,-24,2,-2,-8,-3,-6,-18,3,-4,-2,5,-11,-6,-1,2,-6,1,-2,-3,-4,-2,-3,0,-1,-2,-1,-1,-1,1,-1,-1,-3,-1,-2,-47,-25,-22,3,3,0,-11,-2,-17,-3,-3,-11,-9,-4,-7,-2,1,-5,-2,2,-10,-1,-4,-6,1,0,-5,2,6,-1,1,0,-3,1,4,0,0,0,-2,1,2,-1,-49,-25,-24,4,6,-2,7,-8,-27,-19,6,-11,3,-3,-16,-9,5,-6,4,-5,-11,-10,1,-5,-3,-2,-3,0,10,1,-2,-1,0,1,6,2,-1,-1,-3,-1,4,-1
15,15030,"Coruña, A",243402,-412,-311,-101,1543,743,800,81,-33,-198,-114,-155,5,18,-62,-95,-73,-97,-6,63,29,-103,-41,-58,11,221,289,486,242,194,103,107,130,240,122,89,52,114,159,246,120,105,51,526,270,256,1466,697,769,371,149,64,10,-135,43,208,84,16,22,-79,12,163,65,48,-12,-56,31,296,317,444,246,107,45,147,141,231,111,47,15,149,176,213,135,60,30,1258,609,649,2011,1054,957,380,354,193,209,-39,149,209,198,111,65,-28,37,171,156,82,144,-11,112,360,397,517,341,228,135,189,217,281,182,107,57,171,180,236,159,121,78,140,-10,150,2228,1117,1111,282,37,-199,82,-126,54,101,27,-94,28,-68,6,181,10,-105,54,-58,48,375,404,620,359,285,162,182,214,318,192,132,67,193,190,302,167,153,95,478,141,337,1968,904,1064,228,244,24,-77,-54,139,118,104,-13,-50,-62,61,110,140,37,-27,8,78,291,444,577,282,225,131,135,207,259,152,88,56,156,237,318,130,137,75,1196,491,705,1845,890,955,311,427,378,112,-84,55,158,153,144,73,-71,20,153,274,234,39,-13,35,338,427,506,304,169,81,179,191,254,148,80,27,159,236,252,156,89,54,1645,612,1033,2368,1135,1233,417,466,791,147,-153,-36,201,170,334,66,-124,-41,216,296,457,81,-29,5,423,534,744,377,179,86,211,248,371,186,75,33,212,286,373,191,104,53,1539,732,807,2538,1339,1199,193,544,552,175,74,-13,58,322,295,67,12,-45,135,222,257,108,62,32,434,685,756,413,174,60,216,357,432,223,84,19,218,328,324,190,90,41,691,190,501,1086,444,642,26,521,179,105,-75,-91,3,220,-7,33,-66,0,23,301,186,72,-9,-91,177,464,231,125,61,12,91,202,99,30,11,7,86,262,132,95,50,5,-285,-240,-45,-86,-106,20,-3,166,-103,-125,-120,-109,3,62,-113,-88,-50,-59,-6,104,10,-37,-70,-50,129,101,-208,-86,-5,-31,68,40,-125,-68,-11,-16,61,61,-83,-18,6,-15,541,124,417,1035,514,521,47,302,305,-41,-67,-34,2,79,92,-6,-53,1,45,223,213,-35,-14,-35,203,294,246,158,89,26,102,128,148,79,31,15,101,166,98,79,58,11,1275,631,644,1233,631,602,319,343,318,208,96,-82,158,124,182,132,31,-26,161,219,136,76,65,-56,281,327,258,200,104,39,139,157,156,117,47,12,142,170,102,83,57,27,234,99,135,317,153,164,136,195,89,-103,-99,8,68,44,109,-75,-48,4,68,151,-20,-28,-51,4,135,121,-14,-7,18,53,82,39,4,-30,19,33,53,82,-18,23,-1,20,-233,-260,27,-180,-135,-45,59,89,11,-222,-84,-116,35,38,-101,-133,-57,-50,24,51,112,-89,-27,-66,42,50,-136,-105,-44,-1,27,27,-116,-55,-31,4,15,23,-20,-50,-13,-5,492,168,324,815,395,420,46,249,205,80,4,-107,-29,146,71,71,-36,-46,75,103,134,9,40,-61,148,237,161,112,88,47,62,115,83,53,39,30,86,122,78,59,49,17,781,347,434,290,77,213,149,376,131,137,-12,-51,122,164,54,10,-19,-19,27,212,77,127,7,-32,125,237,-48,-55,-19,23,55,119,-45,-50,-21,10,70,118,-3,-5,2,13,559,247,312,425,112,313,143,388,137,-110,-6,-30,81,169,45,-60,-12,-1,62,219,92,-50,6,-29,207,296,-85,-85,43,15,109,114,-56,-71,-10,10,98,182,-29,-14,53,5,2090,886,1204,2154,993,1161,353,551,744,153,139,100,155,243,347,15,46,60,198,308,397,138,93,40,385,535,529,346,227,97,179,251,259,161,91,41,206,284,270,185,136,56
15,15031,Culleredo,19867,1069,527,542,112,53,59,118,157,493,145,80,63,54,70,256,77,36,24,64,87,237,68,44,39,13,21,32,20,14,11,10,9,12,8,6,7,3,12,20,12,8,4,525,224,301,135,60,75,14,96,247,87,43,37,-7,31,121,37,22,21,21,65,126,50,21,16,30,27,43,19,10,6,14,9,21,9,4,3,16,18,22,10,6,3,658,310,348,208,109,99,66,89,306,91,48,42,38,34,143,40,30,17,28,55,163,51,18,25,56,37,60,31,15,3,33,16,29,17,6,5,23,21,31,14,9,-2,684,323,361,221,103,118,38,101,275,93,120,51,3,55,118,55,61,25,35,46,157,38,59,26,39,41,51,34,27,25,19,19,23,15,12,12,20,22,28,19,15,13,902,421,481,176,78,98,84,122,380,132,112,69,24,53,202,71,52,15,60,69,178,61,60,54,38,40,35,24,23,16,19,19,15,9,12,4,19,21,20,15,11,12,657,296,361,154,64,90,95,74,288,83,80,25,52,35,143,20,27,12,43,39,145,63,53,13,34,32,36,20,14,15,15,10,13,12,4,8,19,22,23,8,10,7,243,111,132,194,82,112,10,53,133,18,29,4,-4,24,61,22,15,-3,14,29,72,-4,14,7,46,49,44,33,14,7,20,21,9,21,7,3,26,28,35,12,7,4,690,367,323,271,134,137,105,69,261,138,65,37,83,30,128,79,30,10,22,39,133,59,35,27,63,46,77,51,28,4,40,21,38,26,6,3,23,25,39,25,22,1,467,194,273,153,55,98,54,62,182,87,30,51,17,23,86,27,15,19,37,39,96,60,15,32,26,26,72,17,6,3,16,9,21,3,2,3,10,17,51,14,4,0,343,155,188,92,49,43,18,44,137,32,20,80,-4,20,79,18,4,27,22,24,58,14,16,53,23,13,33,8,4,10,14,8,11,7,4,5,9,5,22,1,0,5,325,114,211,23,-2,25,53,59,119,40,8,43,24,26,43,16,-5,10,29,33,76,24,13,33,2,24,-35,8,17,7,-2,11,-17,3,2,1,4,13,-18,5,15,6,157,83,74,20,24,-4,40,10,66,39,-20,19,21,18,31,13,1,-2,19,-8,35,26,-21,21,21,9,-4,-6,-1,1,15,2,7,-3,2,1,6,7,-11,-3,-3,0,-45,-30,-15,19,-3,22,-41,-10,11,-45,-10,45,-26,-22,9,-16,0,18,-15,12,2,-29,-10,27,12,32,-20,-12,-5,9,1,7,-10,-6,-2,5,11,25,-10,-6,-3,4,58,14,44,-3,-3,0,19,3,68,-63,10,23,-3,6,31,-36,0,16,22,-3,37,-27,10,7,9,6,-7,-6,-6,2,4,3,-4,-3,-4,1,5,3,-3,-3,-2,1,130,75,55,-18,-22,4,54,-12,68,2,-16,29,48,-11,49,-22,-4,7,6,-1,19,24,-12,22,-3,-8,-5,-10,2,4,-6,-5,-7,-9,2,3,3,-3,2,-1,0,1,81,42,39,11,16,-5,9,-44,101,4,-14,20,6,-17,33,20,-6,1,3,-27,68,-16,-8,19,18,-8,10,-12,-1,1,10,-4,6,-2,4,0,8,-4,4,-10,-5,1,271,105,166,63,24,39,47,49,86,57,23,15,25,17,49,13,4,0,22,32,37,44,19,15,22,28,14,-5,10,-5,17,9,1,-8,6,-1,5,19,13,3,4,-4,291,54,237,281,120,161,74,44,60,34,27,44,26,14,5,6,-9,7,48,30,55,28,36,37,59,55,56,47,40,22,29,27,24,16,14,9,30,28,32,31,26,13
15,15032,Curtis,4444,4,-1,5,12,4,8,2,9,-9,3,-4,4,-1,3,-6,4,-3,3,3,6,-3,-1,-1,1,1,3,3,1,2,1,0,2,1,0,1,0,1,1,2,1,1,1,39,10,29,20,8,12,-2,11,9,5,11,5,-4,6,-2,1,7,2,2,5,11,4,4,3,2,3,8,3,1,3,1,1,0,2,1,3,1,2,8,1,0,0,4,-7,11,7,1,6,9,13,7,-15,4,-15,3,2,3,-10,1,-7,6,11,4,-5,3,-8,2,2,4,-1,0,0,1,0,1,0,0,-1,1,2,3,-1,0,1,15,21,-6,9,5,4,7,-9,-2,11,9,0,8,-6,-4,12,7,5,-1,-3,2,-1,2,-5,4,2,0,2,1,0,1,0,0,2,1,1,3,2,0,0,0,-1,-7,8,-15,7,3,4,-1,0,-14,-3,10,2,1,-2,-4,0,9,3,-2,2,-10,-3,1,-1,0,2,3,1,2,-1,0,0,1,1,2,-1,0,2,2,0,0,0,-49,-16,-33,25,20,5,-10,3,-10,-19,-3,-11,-3,1,0,-15,1,-2,-7,2,-10,-4,-4,-9,2,11,9,4,-1,0,2,7,9,3,-1,0,0,4,0,1,0,0,-16,-10,-6,6,1,5,3,-10,-15,5,5,-4,2,-1,-14,3,3,-4,1,-9,-1,2,2,0,1,2,5,-1,2,-3,1,0,1,0,1,-2,0,2,4,-1,1,-1,27,29,-2,17,8,9,0,0,13,6,2,5,5,0,10,7,2,5,-5,0,3,-1,0,0,4,7,4,0,3,-1,4,1,2,1,1,-1,0,6,2,-1,2,0,13,0,13,32,14,18,11,-3,9,-4,0,4,-2,0,5,-2,-3,4,13,-3,4,-2,3,0,11,6,11,4,-2,2,4,5,3,3,-2,1,7,1,8,1,0,1,17,11,6,8,2,6,5,-1,8,-5,5,4,7,-4,11,-7,1,1,-2,3,-3,2,4,3,3,1,3,-2,0,3,1,1,2,-2,-1,1,2,0,1,0,1,2,33,23,10,13,6,7,7,4,20,-2,12,-9,6,1,10,-3,7,1,1,3,10,1,5,-10,1,3,4,1,3,1,0,1,3,1,0,1,1,2,1,0,3,0,-8,-5,-3,3,3,0,7,-1,-10,-1,-5,1,3,2,-8,-2,-3,2,4,-3,-2,1,-2,-1,6,-1,0,1,-3,0,5,0,-1,0,-1,0,1,-1,1,1,-2,0,-14,-14,0,-10,-5,-5,-2,6,-9,-8,3,-1,0,0,-9,-4,1,1,-2,6,0,-4,2,-2,-3,-1,-2,-5,0,1,-1,-1,-1,-3,0,1,-2,0,-1,-2,0,0,-33,-18,-15,9,4,5,-5,-6,-11,-7,-4,1,-3,-2,-1,-4,-6,-1,-2,-4,-10,-3,2,2,1,3,1,2,1,1,1,1,0,1,0,1,0,2,1,1,1,0,2,3,-1,2,0,2,-1,6,-9,11,-5,-1,-1,3,-6,6,1,0,0,3,-3,5,-6,-1,0,3,0,0,-1,0,-1,0,0,0,0,1,1,3,0,0,-1,-1,7,-4,11,2,-2,4,1,5,3,9,-8,-1,1,-2,5,5,-5,-6,0,7,-2,4,-3,5,-1,8,-3,-1,-1,0,-1,4,-2,-1,-1,-1,0,4,-1,0,0,1,11,-2,13,8,-3,11,7,7,6,-8,1,-3,5,-2,-1,-2,-4,0,2,9,7,-6,5,-3,4,5,-2,1,0,0,1,0,-3,0,-1,0,3,5,1,1,1,0,42,25,17,10,4,6,11,2,6,8,13,1,5,3,4,7,4,4,6,-1,2,1,9,-3,1,2,4,2,1,0,0,0,2,1,1,0,1,2,2,1,0,0
15,15034,Dumbría,4611,-27,-11,-16,8,6,2,-4,-12,-5,-8,-3,4,-1,-6,-1,-5,-2,3,-3,-6,-4,-3,-1,1,2,0,1,1,1,3,2,0,1,1,0,2,0,0,0,0,1,1,-7,-7,0,12,3,9,0,-1,-12,3,2,0,1,0,-7,-1,0,-1,-1,-1,-5,4,2,1,3,0,2,1,3,3,1,0,0,1,1,0,2,0,2,0,2,3,-91,-48,-43,-27,-14,-13,-4,-20,-26,-22,-5,-12,1,-10,-19,-13,-1,-6,-5,-10,-7,-9,-4,-6,1,-2,-9,-13,0,-4,1,-1,-6,-7,0,-1,0,-1,-3,-6,0,-3,-49,-25,-24,12,8,4,-8,-7,-28,-12,4,2,-3,-3,-9,-14,1,3,-5,-4,-19,2,3,-1,2,-1,1,3,4,2,2,-1,1,2,1,2,0,0,0,1,3,0,-49,-28,-21,6,1,5,-10,-7,-21,-8,-4,1,-6,-1,-12,-7,-4,2,-4,-6,-9,-1,0,-1,0,-1,2,0,2,3,0,-1,1,-2,0,3,0,0,1,2,2,0,-54,-42,-12,-3,-2,-1,-3,-3,-29,-16,-2,-1,-4,-4,-20,-12,-1,-1,1,1,-9,-4,-1,0,-1,-5,-3,0,3,3,0,-1,-2,0,0,1,-1,-4,-1,0,3,2,-45,-23,-22,-1,3,-4,3,-9,-25,-7,-6,1,0,-4,-13,-5,0,0,3,-5,-12,-2,-6,1,5,0,-1,-1,-3,-1,3,1,-1,-1,1,0,2,-1,0,0,-4,-1,-51,-22,-29,-9,-3,-6,-1,-14,-27,-1,0,-8,1,-7,-8,-3,-2,-2,-2,-7,-19,2,2,-6,-1,-3,0,2,-1,-6,0,1,-1,1,-1,-3,-1,-4,1,1,0,-3,-23,-18,-5,-2,-4,2,5,-4,-5,-12,-7,-1,0,-3,-1,-6,-7,-1,5,-1,-4,-6,0,0,2,1,3,-2,-5,-1,1,0,3,-2,-5,-1,1,1,0,0,0,0,-2,7,-9,-6,-2,-4,6,-3,-12,6,-1,3,3,2,-5,2,1,3,3,-5,-7,4,-2,0,1,-3,-1,0,-2,0,1,-2,0,-1,0,0,0,-1,-1,1,-2,0,-22,-13,-9,-16,-8,-8,-3,0,-14,7,-3,-7,-1,-1,-8,4,-3,-3,-2,1,-6,3,0,-4,-3,-1,-2,0,-5,-5,-2,0,0,0,-5,-1,-1,-1,-2,0,0,-4,-56,-17,-39,-7,-3,-4,-1,-2,-20,-13,-7,-13,1,1,-4,-6,-3,-6,-2,-3,-16,-7,-4,-7,-1,0,1,-1,-3,-3,-1,0,1,0,-2,-1,0,0,0,-1,-1,-2,2,5,-3,-7,-6,-1,6,-5,-2,8,-1,-3,3,-1,-3,7,-1,0,3,-4,1,1,0,-3,1,-1,-3,-1,-1,-2,1,-1,-3,0,-2,-1,0,0,0,-1,1,-1,-30,-15,-15,-12,-7,-5,-4,-10,-24,10,8,-8,-1,-6,-16,9,3,-3,-3,-4,-8,1,5,-5,0,-5,-1,-2,-1,-3,0,-3,-2,-1,0,-1,0,-2,1,-1,-1,-2,-27,-17,-10,-16,-12,-4,-6,-3,0,-9,-8,0,-2,1,-5,-2,-7,-1,-4,-4,5,-7,-1,1,1,-1,-4,-2,-8,-2,1,0,-5,-1,-6,-1,0,-1,1,-1,-2,-1,7,0,7,-1,-2,1,6,6,-5,4,0,-3,3,2,0,-2,1,-4,3,4,-5,6,-1,1,0,1,1,-2,1,-2,0,0,2,-3,1,-2,0,1,-1,1,0,0,8,9,-1,8,5,3,14,3,-7,-6,7,-3,11,5,-3,-9,6,-1,3,-2,-4,3,1,-2,2,3,-5,1,6,1,1,3,-4,0,4,1,1,0,-1,1,2,0,18,19,-1,14,8,6,-2,-1,2,0,15,4,0,-1,-1,9,8,5,-2,0,3,-9,7,-1,3,-1,3,1,7,1,1,0,0,2,5,0,2,-1,3,-1,2,1
15,15035,Fene,14875,-49,-23,-26,48,21,27,-5,-7,-38,-11,9,5,4,-13,-11,-6,3,2,-9,6,-27,-5,6,3,7,9,13,6,12,1,4,3,3,3,7,1,3,6,10,3,5,0,-12,-20,8,34,11,23,1,18,-23,-1,-11,4,-1,0,-19,0,-4,4,2,18,-4,-1,-7,0,9,12,6,5,2,0,3,1,3,3,1,0,6,11,3,2,1,0,-53,-48,-5,22,6,16,12,0,-36,-11,-13,-5,2,12,-31,-14,-12,-5,10,-12,-5,3,-1,0,1,3,10,-1,5,4,1,2,3,-1,0,1,0,1,7,0,5,3,-13,-15,2,30,14,16,16,-10,-24,-15,0,21,11,-12,-15,-7,-2,10,5,2,-9,-8,2,11,4,11,5,6,3,1,3,3,5,2,1,0,1,8,0,4,2,1,-58,-27,-31,27,12,15,2,-4,-65,11,-7,2,3,-5,-34,9,-1,-1,-1,1,-31,2,-6,3,7,4,7,6,0,3,3,2,1,6,-1,1,4,2,6,0,1,2,43,7,36,27,10,17,22,27,-47,14,0,22,18,14,-31,2,-4,8,4,13,-16,12,4,14,3,10,4,2,6,2,1,3,3,0,2,1,2,7,1,2,4,1,-113,-68,-45,24,11,13,7,-25,-60,-13,-22,2,0,-14,-35,-5,-12,-1,7,-11,-25,-8,-10,3,4,2,6,6,3,3,0,0,3,4,1,3,4,2,3,2,2,0,-1,-30,29,45,29,16,23,2,-9,-16,2,-2,11,4,-7,-25,-2,-8,12,-2,-2,9,4,6,9,4,8,11,10,3,6,3,6,8,6,0,3,1,2,3,4,3,48,30,18,71,45,26,20,8,5,-2,-13,26,5,13,10,2,-3,4,15,-5,-5,-4,-10,22,8,16,26,18,4,-1,3,8,20,13,2,-1,5,8,6,5,2,0,1,-2,3,11,9,2,-2,4,-4,-17,17,-2,4,0,-2,-16,10,-1,-6,4,-2,-1,7,-1,4,0,0,7,-1,1,5,-1,1,3,-1,2,-1,1,-1,4,0,-1,-92,-63,-29,-7,-9,2,-8,-7,-58,-16,-2,-1,-8,-4,-34,-7,-6,-5,0,-3,-24,-9,4,4,1,-2,-1,-3,1,-3,1,-3,-2,-3,0,-2,0,1,1,0,1,-1,-60,-15,-45,-10,-4,-6,2,-10,-39,1,-11,0,-1,-4,-13,0,2,2,3,-6,-26,1,-13,-2,4,-5,-3,-10,3,0,3,-2,0,-8,3,0,1,-3,-3,-2,0,0,-77,-52,-25,0,2,-2,-6,9,-44,-41,3,-3,1,-3,-21,-30,2,-5,-7,12,-23,-11,1,2,1,2,-2,1,-2,-1,1,1,0,1,-1,-1,0,1,-2,0,-1,0,-40,-37,-3,-1,-2,1,3,-7,-28,1,-1,-9,-2,-1,-23,-7,2,-5,5,-6,-5,8,-3,-4,-1,0,-1,-2,1,1,-1,-1,0,-2,1,1,0,1,-1,0,0,0,-37,-12,-25,16,3,13,-3,-12,-13,-22,15,-4,6,0,-3,-17,4,0,-9,-12,-10,-5,11,-4,5,1,2,1,5,1,2,0,0,0,0,1,3,1,2,1,5,0,-74,-36,-38,-3,-7,4,1,2,-17,-40,-3,-10,-4,2,-5,-27,3,-2,5,0,-12,-13,-6,-8,3,2,-1,-6,-2,1,2,0,-3,-5,-2,1,1,2,2,-1,0,0,-57,-26,-31,9,4,5,-7,-21,-37,0,4,5,-4,-3,-28,8,-1,2,-3,-18,-9,-8,5,3,2,-1,-1,6,1,2,1,1,-1,1,1,1,1,-2,0,5,0,1,0,-8,8,18,5,13,16,-10,-14,4,-7,9,2,-5,-6,9,-9,1,14,-5,-8,-5,2,8,8,1,-1,4,0,6,4,0,-3,2,-1,3,4,1,2,2,1,3
15,15036,Ferrol,81991,-225,-116,-109,201,90,111,33,-46,-55,-61,-65,-40,0,-21,-23,-35,-28,-17,33,-25,-32,-26,-37,-23,25,42,68,31,17,16,13,14,30,15,8,9,12,28,38,16,9,7,-176,-100,-76,283,122,161,48,-42,-188,28,-25,7,30,-13,-99,12,-24,-3,18,-29,-89,16,-1,10,40,113,71,35,13,6,16,56,27,13,6,3,24,57,44,22,7,3,-535,-255,-280,245,122,123,0,-93,-262,-86,-25,-50,-6,-53,-119,-26,-16,-19,6,-40,-143,-60,-9,-31,47,62,59,29,25,22,22,28,30,18,13,11,25,34,29,11,12,11,-432,-216,-216,254,122,132,63,-81,-263,-18,-57,-67,40,-52,-148,-9,-24,-15,23,-29,-115,-9,-33,-52,40,67,74,38,23,8,21,28,33,24,10,6,19,39,41,14,13,2,-494,-326,-168,190,89,101,57,-110,-343,-25,-27,-38,-3,-46,-217,-24,-22,-13,60,-64,-126,-1,-5,-25,39,44,51,25,19,10,18,24,23,13,6,5,21,20,28,12,13,5,-427,-215,-212,272,124,148,21,-41,-285,-37,-15,-48,14,-30,-143,-17,-12,-11,7,-11,-142,-20,-3,-37,51,58,84,45,24,9,26,19,35,32,10,2,25,39,49,13,14,7,-518,-233,-285,346,193,153,6,-64,-276,-59,-36,-82,14,-33,-137,-27,-22,-25,-8,-31,-139,-32,-14,-57,56,87,81,76,27,15,33,44,53,44,9,8,23,43,28,32,18,7,-171,-28,-143,461,265,196,67,12,-170,-6,-36,-38,38,37,-90,0,-8,-3,29,-25,-80,-6,-28,-35,61,118,148,86,35,12,34,58,90,57,19,6,27,60,58,29,16,6,-161,-11,-150,317,169,148,37,48,-157,-23,-26,-45,30,40,-64,0,-4,-20,7,8,-93,-23,-22,-25,73,88,88,52,10,3,30,47,53,31,5,1,43,41,35,21,5,2,-163,-59,-104,227,113,114,103,9,-180,9,-35,-45,47,-5,-69,-8,-17,0,56,14,-111,17,-18,-45,67,58,42,35,18,3,45,29,22,5,10,0,22,29,20,30,8,3,-355,-153,-202,100,27,73,32,-15,-190,-83,-35,-46,30,9,-99,-49,-18,-18,2,-24,-91,-34,-17,-28,56,44,-1,-10,-4,10,34,20,-13,-16,-8,5,22,24,12,6,4,5,-369,-106,-263,118,64,54,-30,-6,-175,-37,-40,-73,-18,-1,-53,11,-8,-31,-12,-5,-122,-48,-32,-42,17,36,38,15,11,-3,9,14,21,13,7,-1,8,22,17,2,4,-2,-447,-220,-227,-100,-61,-39,-44,-96,-205,-77,-11,-4,-32,-40,-78,-45,-25,5,-12,-56,-127,-32,14,-9,14,-18,-55,-38,-7,3,11,-16,-27,-25,-5,0,3,-2,-28,-13,-2,3,-228,-122,-106,-31,-26,-5,25,3,-139,-33,-29,-51,21,-13,-83,-20,-19,-10,4,16,-56,-13,-10,-41,4,4,-33,-16,6,2,0,0,-25,-10,6,1,4,4,-8,-6,0,1,-133,-90,-43,137,65,72,59,28,-141,-7,15,-83,18,2,-70,-26,11,-27,41,26,-71,19,4,-56,33,32,30,21,14,7,19,7,18,10,7,4,14,25,12,11,7,3,-454,-215,-239,-4,-9,5,-40,-66,-201,-69,-7,-70,-16,-20,-143,-21,3,-14,-24,-46,-58,-48,-10,-56,6,13,-2,-18,-6,1,0,7,-5,-8,-5,3,6,6,3,-10,-1,-2,-280,-137,-143,10,-17,27,-5,25,-150,-55,-13,-78,8,8,-82,-38,1,-28,-13,17,-68,-17,-14,-50,21,16,-28,-17,4,10,6,-1,-15,-16,1,5,15,17,-13,-1,3,5,-174,-76,-98,78,8,70,31,13,-144,-6,-49,-30,23,6,-55,-23,-38,4,8,7,-89,17,-11,-34,47,29,-16,-8,8,9,25,16,-21,-27,2,6,22,13,5,19,6,3
15,15037,Fisterra,5295,-37,-17,-20,23,15,8,-9,-22,-11,-2,10,-4,-3,-12,-8,-1,8,-2,-6,-10,-3,-1,2,-2,3,2,3,7,6,1,2,1,1,4,5,1,1,1,2,3,1,0,-3,-8,5,23,10,13,-3,-12,-13,9,6,10,-3,-8,-9,4,2,6,0,-4,-4,5,4,4,1,3,4,6,4,5,0,0,0,4,3,3,1,3,4,2,1,2,-4,4,-8,18,12,6,11,-7,-16,3,6,0,9,-4,-7,4,2,1,2,-3,-9,-1,4,-1,5,2,1,3,8,-1,3,1,1,4,4,-1,2,1,0,-1,4,0,-7,11,-18,26,17,9,1,-13,-6,3,13,-5,1,-1,-2,6,7,0,0,-12,-4,-3,6,-5,1,1,5,5,9,4,0,1,3,4,6,3,1,0,2,1,3,1,-20,-7,-13,37,23,14,-8,-10,-20,-1,9,10,-6,-7,-2,-2,7,2,-2,-3,-18,1,2,8,6,3,10,9,6,3,3,2,8,4,6,0,3,1,2,5,0,3,-33,-15,-18,18,9,9,-9,-18,-8,-1,5,-2,-8,-8,-4,3,3,0,-1,-10,-4,-4,2,-2,3,4,5,5,2,-1,0,2,2,4,1,0,3,2,3,1,1,-1,-5,-6,1,21,13,8,-6,-13,-12,-4,20,8,-3,-4,-8,-4,9,3,-3,-9,-4,0,11,5,4,-1,0,3,13,2,3,0,-1,2,8,1,1,-1,1,1,5,1,25,8,17,21,10,11,10,2,6,2,1,2,3,-2,5,0,-3,3,7,4,1,2,4,-1,7,3,8,0,4,0,2,1,5,-1,2,1,5,2,3,1,2,-1,48,37,11,27,16,11,22,-3,4,11,15,2,15,-3,9,5,9,1,7,0,-5,6,6,1,5,2,8,4,5,3,3,1,5,2,3,2,2,1,3,2,2,1,3,0,3,19,9,10,13,-5,-15,1,6,4,3,0,-9,-1,6,2,10,-5,-6,2,0,2,0,4,3,3,6,3,0,2,0,1,4,2,0,2,3,2,2,1,2,-6,8,7,3,4,-2,-1,-12,5,8,6,-3,-2,-6,2,3,2,1,1,-6,3,5,4,0,-1,2,3,2,1,0,0,1,1,1,0,0,-1,1,2,1,1,51,31,20,4,-2,6,12,-2,17,17,6,1,5,-5,7,16,5,3,7,3,10,1,1,-2,2,0,3,-3,3,-1,1,-1,-1,-2,1,0,1,1,4,-1,2,-1,-10,-2,-8,-1,-2,1,-3,-3,-19,6,10,-2,1,0,-13,6,6,-2,-4,-3,-6,0,4,0,0,2,-1,-1,0,-1,0,0,-1,-1,1,-1,0,2,0,0,-1,0,-63,-39,-24,-9,-7,-2,-11,-5,-25,-15,4,-12,-6,-5,-13,-13,1,-5,-5,0,-12,-2,3,-7,-2,0,-1,-7,1,0,0,-1,0,-7,1,0,-2,1,-1,0,0,0,-17,-15,-2,6,4,2,-3,-1,-6,-13,-4,9,-3,0,-5,-9,-1,3,0,-1,-1,-4,-3,6,1,-1,7,-2,1,-1,1,0,4,-3,2,-1,0,-1,3,1,-1,0,-19,-1,-18,-16,-7,-9,-4,6,-10,2,4,-18,-5,9,-5,-1,9,-9,1,-3,-5,3,-5,-9,-4,-2,-4,-3,1,-5,-2,0,-2,-1,1,-4,-2,-2,-2,-2,0,-1,20,26,-6,14,9,5,6,-3,-3,3,7,10,4,1,2,11,6,2,2,-4,-5,-8,1,8,1,1,6,-1,5,2,0,1,4,1,3,0,1,0,2,-2,2,2,-17,-8,-9,11,9,2,-1,-4,-18,5,1,0,-6,-2,-9,6,3,0,5,-2,-9,-1,-2,0,-1,2,3,3,5,-2,0,1,4,4,1,-2,-1,1,-1,-1,4,0
15,15041,"Laracha, A",10669,70,52,18,86,46,40,8,-17,40,19,21,-3,10,-3,23,10,15,-4,-2,-14,17,9,6,1,11,6,30,17,17,5,3,5,15,10,11,2,8,1,15,7,6,3,60,25,35,60,32,28,12,13,4,17,4,8,-4,6,-1,14,5,3,16,7,5,3,-1,5,15,7,14,12,7,4,9,4,5,8,3,2,6,3,9,4,4,2,99,47,52,68,39,29,12,13,23,5,38,7,3,-8,20,5,22,4,9,21,3,0,16,3,17,2,20,9,16,3,8,-1,12,6,11,2,9,3,8,3,5,1,100,36,64,85,46,39,25,2,29,17,24,2,12,-3,9,6,12,-2,13,5,20,11,12,4,15,11,24,14,15,4,9,8,12,9,7,0,6,3,12,5,8,4,78,45,33,40,20,20,21,19,20,7,15,-6,19,7,0,7,7,2,2,12,20,0,8,-8,6,12,5,3,8,6,5,4,1,1,6,3,1,8,4,2,2,3,78,46,32,55,23,32,19,1,10,3,38,6,16,3,2,1,16,8,3,-2,8,2,22,-2,3,7,6,8,25,6,-1,5,0,4,13,2,4,2,6,4,12,4,105,78,27,47,25,22,4,12,15,37,34,1,6,8,19,21,18,2,-2,4,-4,16,16,-1,6,7,10,4,18,2,4,4,5,3,7,2,2,3,5,1,11,0,252,148,104,123,78,45,51,38,42,73,35,6,24,22,32,47,17,1,27,16,10,26,18,5,21,19,21,37,22,2,11,12,16,24,11,3,10,7,5,13,11,-1,102,39,63,21,3,18,6,20,45,18,7,7,10,5,18,7,1,-1,-4,15,27,11,6,8,4,7,-1,5,4,2,0,2,-4,2,2,1,4,5,3,3,2,1,110,58,52,-1,-1,0,10,13,40,18,24,5,6,4,23,5,13,7,4,9,17,13,11,-2,-4,-1,0,3,1,0,0,-1,-2,1,1,0,-4,0,2,2,0,0,151,99,52,28,13,15,21,33,54,34,13,-1,19,17,38,17,10,0,2,16,16,17,3,-1,5,5,6,5,8,-1,4,3,2,2,3,-1,1,2,4,3,5,0,63,36,27,14,8,6,8,12,12,12,17,4,12,1,15,-2,5,7,-4,11,-3,14,12,-3,1,9,-2,-5,2,9,2,1,1,-3,0,7,-1,8,-3,-2,2,2,80,30,50,11,5,6,24,3,28,16,0,10,5,1,13,8,2,2,19,2,15,8,-2,8,7,1,0,-3,1,5,5,0,0,-3,0,3,2,1,0,0,1,2,129,72,57,9,5,4,37,1,32,29,8,21,22,2,23,14,3,6,15,-1,9,15,5,15,7,2,0,-2,1,1,5,2,0,-2,-1,1,2,0,0,0,2,0,18,13,5,-3,-2,-1,-5,-4,13,-2,11,7,-1,-8,2,9,9,4,-4,4,11,-11,2,3,-1,-1,-4,1,-3,5,0,-2,-3,2,-1,2,-1,1,-1,-1,-2,3,-41,-10,-31,2,-8,10,-30,-1,-16,0,-3,5,-13,1,-6,7,-3,2,-17,-2,-10,-7,0,3,1,3,-1,-5,1,1,1,0,-4,-5,-1,0,0,3,3,0,2,1,52,17,35,1,-1,2,14,1,3,25,-1,6,13,5,4,-6,-1,1,1,-4,-1,31,0,5,0,3,-5,-1,-1,5,0,1,-3,-1,0,2,0,2,-2,0,-1,3,69,47,22,12,10,2,9,3,18,8,0,33,6,0,15,17,-3,13,3,3,3,-9,3,20,2,-2,2,-8,6,12,2,-2,3,-3,4,6,0,0,-1,-5,2,6
15,15040,Laxe,3541,31,20,11,44,21,23,8,-5,7,1,14,5,7,-3,8,0,6,1,1,-2,-1,1,8,4,6,3,13,7,8,7,3,0,9,2,4,3,3,3,4,5,4,4,8,2,6,23,12,11,-6,-3,0,1,12,4,-4,-4,-1,1,7,3,-2,1,1,0,5,1,1,5,3,3,9,2,0,3,2,0,6,1,1,2,1,3,3,1,3,8,-5,17,12,5,-3,-8,-6,4,7,8,0,-2,-6,1,6,7,-3,-6,0,3,1,1,1,1,4,-2,8,3,1,0,2,-2,5,4,0,1,2,0,3,-1,39,25,14,42,26,16,-4,6,0,6,22,10,0,6,0,3,10,6,-4,0,0,3,12,4,1,3,10,9,12,7,1,2,7,6,6,4,0,1,3,3,6,3,5,6,-1,54,29,25,-3,-2,-17,7,15,5,-4,4,-8,5,6,3,1,-6,-9,2,9,2,3,10,8,14,11,8,0,6,7,8,4,4,3,4,1,6,7,4,-32,-16,-16,23,12,11,-9,-5,-12,-13,13,-6,-3,-3,-5,-10,9,-4,-6,-2,-7,-3,4,-2,1,2,3,10,8,-1,0,1,1,5,7,-2,1,1,2,5,1,1,-21,-11,-10,29,16,13,0,-16,-15,-9,10,6,3,-9,-9,-4,5,2,-3,-7,-6,-5,5,4,7,1,7,6,7,0,4,1,5,2,4,0,3,0,2,4,3,0,-8,-5,-3,22,17,5,-3,-11,-7,9,2,1,-2,-5,-5,4,2,0,-1,-6,-2,5,0,1,3,1,9,4,6,-1,3,1,7,2,4,0,0,0,2,2,2,-1,-15,-10,-5,16,4,12,-2,3,-13,-4,0,4,-3,4,-8,-5,1,3,1,-1,-5,1,-1,1,2,1,5,1,2,5,1,0,0,0,1,2,1,1,5,1,1,3,14,8,6,14,5,9,1,6,-5,5,6,2,0,4,-1,4,2,-1,1,2,-4,1,4,3,0,4,0,1,6,3,0,2,-1,1,3,0,0,2,1,0,3,3,-25,-22,-3,-2,-2,0,3,-12,-28,-4,15,1,-1,-7,-19,-2,7,0,4,-5,-9,-2,8,1,2,0,-7,1,1,1,1,1,-6,1,1,0,1,-1,-1,0,0,1,-31,-19,-12,-18,-7,-11,-1,-3,-9,-1,-6,-10,-2,-2,-8,-1,-5,-2,1,-1,-1,0,-1,-8,-1,0,-5,-5,-3,-4,0,-1,-3,-2,0,-1,-1,1,-2,-3,-3,-3,-7,-9,2,9,8,1,7,-5,1,-3,3,-9,4,-2,-3,-5,1,-3,3,-3,4,2,2,-6,5,-1,1,3,1,-1,5,0,3,1,0,-2,0,-1,-2,2,1,1,-18,-9,-9,-6,-3,-3,-7,0,-13,-3,0,4,0,-1,-11,0,0,3,-7,1,-2,-3,0,1,-3,0,-2,-3,2,0,0,0,-1,-3,0,1,-3,0,-1,0,2,-1,1,-1,2,3,1,2,6,-5,-12,9,6,-2,2,0,-3,0,5,-4,4,-5,-9,9,1,2,0,-1,-2,1,4,1,0,-1,-2,1,2,1,0,0,0,0,2,0,-13,6,-19,-5,3,-8,-4,-1,-4,3,3,-10,1,0,2,2,4,-3,-5,-1,-6,1,-1,-7,-3,-2,-1,0,2,-1,0,0,1,1,1,0,-3,-2,-2,-1,1,-1,-47,-21,-26,7,2,5,-5,-4,-20,-6,1,-11,-3,-4,-7,-1,0,-5,-2,0,-13,-5,1,-6,-1,1,3,3,3,-2,0,1,0,1,1,-1,-1,0,3,2,2,-1,7,-6,13,12,5,7,4,-6,-4,6,5,2,-2,-5,-4,2,4,-1,6,-1,0,4,1,3,3,0,3,4,1,1,1,0,0,2,0,2,2,0,3,2,1,-1
15,15042,Lousame,4219,-56,-29,-27,15,10,5,-1,-35,-25,-2,7,2,0,-22,-10,-1,4,2,-1,-13,-15,-1,3,0,1,2,0,5,6,1,0,1,0,3,5,1,1,1,0,2,1,0,-25,-8,-17,6,4,2,16,-25,-8,-2,1,-6,8,-15,-2,0,3,-2,8,-10,-6,-2,-2,-4,3,0,0,1,2,0,2,0,0,0,2,0,1,0,0,1,0,0,-14,4,-18,12,8,4,5,-15,-3,-12,8,3,5,0,2,-11,6,2,0,-15,-5,-1,2,1,7,-1,-2,-6,9,5,3,1,-1,-4,6,3,4,-2,-1,-2,3,2,22,4,18,11,8,3,14,-5,4,10,4,-4,4,-5,0,6,2,-3,10,0,4,4,2,-1,5,1,2,1,2,0,4,0,2,1,1,0,1,1,0,0,1,0,4,5,-1,10,4,6,16,-3,-1,4,-4,-8,8,3,-4,3,0,-5,8,-6,3,1,-4,-3,1,1,0,5,0,3,0,0,0,2,0,2,1,1,0,3,0,1,2,5,-3,6,4,2,21,-9,-12,1,4,-3,10,-4,-6,1,4,-1,11,-5,-6,0,0,-2,4,1,-1,2,1,-1,2,0,1,0,1,0,2,1,-2,2,0,-1,-14,-6,-8,2,2,0,5,-10,-10,3,1,-4,3,-3,-8,2,-1,0,2,-7,-2,1,2,-4,2,1,0,0,1,-2,2,0,1,-1,1,-1,0,1,-1,1,0,-1,-9,-7,-2,10,8,2,21,-8,-8,-8,8,-11,11,-7,0,-6,3,-6,10,-1,-8,-2,5,-5,-1,0,-1,5,7,0,0,0,2,3,3,0,-1,0,-3,2,4,0,27,8,19,10,5,5,19,-1,-2,1,6,0,9,2,-7,0,4,0,10,-3,5,1,2,0,1,0,-1,1,5,3,0,1,-2,2,2,2,1,-1,1,-1,3,1,25,23,2,5,3,2,25,-7,1,-2,11,-4,9,1,4,1,9,-1,16,-8,-3,-3,2,-3,1,-2,1,1,3,1,0,-1,1,1,2,0,1,-1,0,0,1,1,2,20,-18,6,5,1,-7,-5,-10,9,7,5,2,-3,-2,12,5,3,-9,-2,-8,-3,2,2,0,1,2,1,-1,3,0,0,2,1,0,2,0,1,0,0,-1,1,14,9,5,-3,-4,1,8,0,14,-3,0,-7,5,-2,7,-1,0,-2,3,2,7,-2,0,-5,1,-1,-2,-1,2,-2,1,-1,-2,-1,1,-2,0,0,0,0,1,0,-13,-8,-5,-4,-2,-2,7,-4,-8,-6,0,-5,-3,2,-3,0,-1,-3,10,-6,-5,-6,1,-2,0,-1,-2,-1,1,-1,0,-1,-1,-1,1,0,0,0,-1,0,0,-1,9,20,-11,3,2,1,12,-6,-8,11,1,-3,12,-6,0,6,3,1,0,0,-8,5,-2,-4,0,1,-1,1,2,0,0,0,-1,0,2,1,0,1,0,1,0,-1,-27,-17,-10,-3,-2,-1,-11,-10,-13,-1,4,3,-7,-5,-8,-3,5,1,-4,-5,-5,2,-1,2,0,-3,-2,1,3,-2,0,-2,-1,0,2,-1,0,-1,-1,1,1,-1,-17,-12,-5,0,2,-2,-2,-2,1,-10,1,-5,1,-3,0,-7,0,-3,-3,1,1,-3,1,-2,0,0,-1,-1,2,0,0,0,1,0,1,0,0,0,-2,-1,1,0,-33,-15,-18,-2,0,-2,-6,-10,-16,-2,4,-2,-2,-6,-11,5,1,-2,-4,-4,-5,-7,3,0,0,-1,-2,-4,5,0,0,-1,-1,-1,2,1,0,0,-1,-3,3,-1,-30,-14,-16,-3,-4,1,-10,-2,-16,-4,3,-2,-5,2,-8,-3,-1,0,-5,-4,-8,-1,4,-2,2,-2,-2,0,-1,0,1,-1,-1,-1,-1,-1,1,-1,-1,1,0,1
15,15043,Malpica de Bergantiños,7325,-40,-18,-22,25,13,12,-5,-19,-6,-12,6,-5,2,-7,-7,-7,5,-5,-7,-12,1,-5,1,0,6,2,4,6,5,2,4,1,1,2,4,1,2,1,3,4,1,1,-37,-12,-25,17,9,8,-8,-28,-22,4,11,3,-4,-9,-11,1,9,2,-4,-19,-11,3,2,1,4,1,4,3,2,1,2,1,2,2,2,0,2,0,2,1,0,1,-72,-47,-25,26,15,11,-7,-16,-36,-10,1,-5,-5,-9,-20,-12,-1,-1,-2,-7,-16,2,2,-4,10,2,6,3,3,1,6,2,4,0,2,0,4,0,2,3,1,1,3,11,-8,43,24,19,3,-11,0,-1,17,-5,4,-5,2,5,7,-1,-1,-6,-2,-6,10,-4,5,8,13,9,6,2,2,4,6,7,3,2,3,4,7,2,3,0,-47,-31,-16,49,30,19,-17,-21,-26,-12,23,8,-6,-10,-13,-12,9,4,-11,-11,-13,0,14,4,4,6,19,5,10,5,3,4,16,2,2,3,1,2,3,3,8,2,-136,-63,-73,6,1,5,-5,-32,-56,-21,-11,-9,-2,-10,-31,-11,-7,-2,-3,-22,-25,-10,-4,-7,1,3,3,-1,0,0,0,2,0,-1,0,0,1,1,3,0,0,0,-78,-41,-37,23,13,10,-1,-8,-46,-8,-9,-4,-1,-5,-21,-5,-7,0,0,-3,-25,-3,-2,-4,6,3,8,3,2,1,3,1,4,3,1,1,3,2,4,0,1,0,-50,-24,-26,46,21,25,-5,-13,-30,1,4,-7,1,-5,-21,1,1,-2,-6,-8,-9,0,3,-5,11,8,12,10,4,1,6,3,4,6,1,1,5,5,8,4,3,0,-14,-7,-7,22,11,11,5,-8,-24,15,4,-4,3,-1,-13,3,3,-2,2,-7,-11,12,1,-2,3,7,4,5,0,3,2,4,3,1,0,1,1,3,1,4,0,2,29,23,6,16,7,9,9,1,15,-3,5,3,4,0,13,0,4,2,5,1,2,-3,1,1,7,4,2,1,2,0,3,2,2,-1,1,0,4,2,0,2,1,0,-17,-15,-2,7,2,5,-3,-7,-21,-7,18,1,1,-8,-11,-7,12,-4,-4,1,-10,0,6,5,3,1,2,-2,1,2,2,0,1,-2,0,1,1,1,1,0,1,1,-12,7,-19,1,0,1,2,2,-2,-6,0,-7,2,5,2,1,-1,-2,0,-3,-4,-7,1,-5,0,0,3,-3,1,0,0,0,2,-2,0,0,0,0,1,-1,1,0,-38,-11,-27,2,4,-2,2,-3,-32,-12,9,-3,-1,-1,-10,-3,6,-1,3,-2,-22,-9,3,-2,0,0,-1,-1,3,1,0,0,1,0,2,1,0,0,-2,-1,1,0,-47,-23,-24,-4,-2,-2,-10,-11,-14,-7,-2,-3,-1,-6,-13,-3,0,1,-9,-5,-1,-4,-2,-4,-1,-2,-1,-1,0,1,0,0,-2,0,0,0,-1,-2,1,-1,0,1,-10,-1,-9,12,7,5,1,-4,-4,8,0,-11,0,-1,-4,5,3,-4,1,-3,0,3,-3,-7,2,1,1,5,3,0,1,0,1,2,3,0,1,1,0,3,0,0,-9,5,-14,2,1,1,11,7,-18,2,-15,0,9,0,-7,4,-6,5,2,7,-11,-2,-9,-5,2,4,-2,0,-3,0,1,1,-1,1,-2,1,1,3,-1,-1,-1,-1,-28,-19,-9,1,-2,3,-6,-5,-15,-15,7,5,-6,2,-7,-11,2,0,0,-7,-8,-4,5,5,0,-1,4,-2,-1,1,-1,0,2,-2,-1,0,1,-1,2,0,0,1,-28,-23,-5,8,1,7,3,1,-26,2,5,-14,1,-2,-17,2,2,-9,2,3,-9,0,3,-5,1,0,1,0,4,1,0,0,0,-1,3,-1,1,0,1,1,1,2
15,15045,Mazaricos,6349,-86,-54,-32,8,4,4,-17,-16,-39,-6,-5,-5,-13,-8,-24,-6,-2,-1,-4,-8,-15,0,-3,-4,2,1,1,2,0,0,1,0,1,2,0,0,1,1,0,0,0,0,-38,-28,-10,10,4,6,4,-21,-27,1,3,2,-3,-9,-20,1,1,2,7,-12,-7,0,2,0,5,0,1,0,1,2,2,0,1,0,0,1,3,0,0,0,1,1,-68,-35,-33,-21,-19,-2,-3,-9,-26,-16,-10,-2,1,-3,-17,-10,-3,-1,-4,-6,-9,-6,-7,-1,4,-4,-9,-7,-5,0,1,-3,-8,-5,-4,0,3,-1,-1,-2,-1,0,-68,-39,-29,23,12,11,-12,-19,-21,-11,4,-5,-8,-11,-9,-10,2,0,-4,-8,-12,-1,2,-5,5,2,4,3,5,2,3,2,1,0,4,2,2,0,3,3,1,0,-78,-34,-44,10,6,4,-15,-6,-27,-28,0,-2,-7,-3,-11,-10,-3,-1,-8,-3,-16,-18,3,-1,0,1,0,3,4,2,0,1,0,3,2,0,0,0,0,0,2,2,-84,-47,-37,4,0,4,-9,-17,-41,-8,-4,-4,-7,-8,-20,-6,-3,-3,-2,-9,-21,-2,-1,-1,3,-1,-3,5,1,-1,0,-2,-1,4,0,-1,3,1,-2,1,1,0,-72,-38,-34,10,3,7,-8,-21,-39,-6,2,2,-8,-9,-21,-4,4,0,0,-12,-18,-2,-2,2,3,-1,2,3,3,0,0,-1,0,2,3,-1,3,0,2,1,0,1,-42,-14,-28,16,12,4,0,-9,-28,-5,5,-5,1,-1,-13,-3,3,0,-1,-8,-15,-2,2,-5,4,0,1,6,3,1,4,1,1,4,2,0,0,-1,0,2,1,1,-38,-5,-33,10,10,0,-5,-7,-24,-4,4,0,4,-3,-5,-1,2,0,-9,-4,-19,-3,2,0,0,0,2,3,4,1,1,0,3,2,2,2,-1,0,-1,1,2,-1,-28,-3,-25,9,8,1,-6,1,-23,-1,5,-4,-1,3,-11,0,5,1,-5,-2,-12,-1,0,-5,1,-1,1,6,3,-1,0,-1,1,5,3,0,1,0,0,1,0,-1,-55,-19,-36,3,2,1,-6,-6,-34,-7,1,-2,-2,-5,-14,0,3,0,-4,-1,-20,-7,-2,-2,3,0,-2,-3,4,1,3,-1,-2,-2,4,0,0,1,0,-1,0,1,-22,-12,-10,-11,-4,-7,8,-7,-13,-10,12,-11,3,-6,-8,-3,8,-5,5,-1,-5,-7,4,-6,0,-1,-1,-6,0,-3,0,0,-1,-2,2,-3,0,-1,0,-4,-2,0,-47,-16,-31,-9,-4,-5,-3,-9,-18,-11,1,-6,-2,-1,-9,-4,1,-1,-1,-8,-9,-7,0,-5,0,-4,-5,-2,1,1,0,-1,-2,-2,0,1,0,-3,-3,0,1,0,-27,-8,-19,-3,0,-3,3,-7,-18,-1,2,-7,1,-2,-7,-1,4,-4,2,-5,-11,0,-2,-3,0,-5,-3,-1,4,2,0,-1,-2,-1,3,1,0,-4,-1,0,1,1,-43,-23,-20,-2,-2,0,-4,-1,-25,-14,-4,3,-3,0,-15,-4,-3,2,-1,-1,-10,-10,-1,1,-2,-4,2,0,-1,2,-1,-3,1,1,-1,1,-1,-1,1,-1,0,1,-32,-19,-13,-17,-13,-4,0,-2,-16,-3,-5,-6,-3,-6,-6,0,-3,-2,3,4,-10,-3,-2,-4,-3,-1,-5,-6,-2,0,-3,-2,-2,-4,-2,0,0,1,-3,-2,0,0,-29,-12,-17,-10,-5,-5,-2,-5,-7,-7,-6,-1,-1,-4,-4,1,-3,-1,-1,-1,-3,-8,-3,0,-1,-3,-3,-3,-1,1,-1,-1,-1,-2,-1,1,0,-2,-2,-1,0,0,-11,-7,-4,-6,-6,0,5,4,-17,2,4,-9,4,-1,-11,3,1,-3,1,5,-6,-1,3,-6,0,-1,-2,-3,0,0,0,0,-2,-2,-2,0,0,-1,0,-1,2,0
15,15046,Melide,8430,62,10,52,11,4,7,16,18,-20,25,17,5,1,4,-18,10,8,3,15,14,-2,15,9,2,4,0,3,1,3,0,0,0,1,1,2,0,4,0,2,0,1,0,-40,-4,-36,14,9,5,-15,-9,-11,-8,1,1,-4,4,-4,-3,-1,4,-11,-13,-7,-5,2,-3,3,1,1,5,4,0,3,0,0,3,3,0,0,1,1,2,1,0,21,4,17,31,14,17,-11,0,6,-6,21,8,-8,-3,0,-3,12,3,-3,3,6,-3,9,5,3,8,8,3,5,4,1,4,5,0,3,1,2,4,3,3,2,3,-10,-3,-7,5,3,2,-8,1,-2,-12,5,4,-2,-8,6,-7,0,8,-6,9,-8,-5,5,-4,1,1,0,3,-1,1,0,0,1,2,-1,1,1,1,-1,1,0,0,91,38,53,29,18,11,18,14,18,30,8,-1,7,3,8,12,5,0,11,11,10,18,3,-1,4,2,8,8,6,1,3,2,5,4,3,1,1,0,3,4,3,0,80,36,44,23,14,9,23,-2,29,-5,21,11,17,2,9,-6,9,3,6,-4,20,1,12,8,5,3,5,3,6,1,4,2,2,1,4,1,1,1,3,2,2,0,30,11,19,31,14,17,-5,1,-7,8,26,4,-9,2,-2,-1,13,6,4,-1,-5,9,13,-2,7,3,7,4,8,1,4,2,3,0,4,0,3,1,4,4,4,1,20,16,4,17,4,13,-1,-2,-8,6,16,12,-1,-4,6,0,9,8,0,2,-14,6,7,4,2,3,3,4,6,-1,0,0,1,1,3,-1,2,3,2,3,3,0,0,-7,7,25,12,13,4,3,5,-17,11,-7,1,-2,-1,-9,1,0,3,5,6,-8,10,-7,10,3,5,5,1,0,3,2,2,4,0,0,7,1,3,1,1,0,27,37,-10,17,8,9,15,6,4,-2,4,1,13,6,1,6,5,7,2,0,3,-8,-1,-6,4,3,6,-1,2,3,2,2,1,0,1,2,2,1,5,-1,1,1,50,27,23,25,12,13,28,14,6,5,-2,-5,15,3,2,0,0,6,13,11,4,5,-2,-11,7,8,4,5,1,0,4,1,4,1,1,1,3,7,0,4,0,-1,117,82,35,49,33,16,18,12,39,25,13,7,13,5,31,24,5,1,5,7,8,1,8,6,12,9,11,12,3,1,7,4,7,10,2,2,5,5,4,2,1,-1,31,1,30,5,-3,8,8,14,-5,10,7,-2,2,2,0,-1,1,-2,6,12,-5,11,6,0,0,6,1,-1,-1,0,-1,0,1,-1,-2,0,1,6,0,0,1,0,65,35,30,7,4,3,7,-1,10,19,19,9,-2,1,6,14,12,3,9,-2,4,5,7,6,3,1,0,5,-1,-1,0,1,0,4,0,-1,3,0,0,1,-1,0,37,27,10,7,7,0,-1,8,11,12,0,-2,2,0,7,9,-1,3,-3,8,4,3,1,-5,1,5,1,-4,1,2,1,3,2,-1,1,1,0,2,-1,-3,0,1,-21,-25,4,10,0,10,-10,-14,-10,-7,9,10,-14,-7,-8,0,-3,8,4,-7,-2,-7,12,2,4,0,1,-3,6,2,0,-1,-2,-2,2,3,4,1,3,-1,4,-1,57,26,31,10,8,2,14,5,10,6,18,-7,5,5,1,1,13,-3,9,0,9,5,5,-4,-1,0,-1,3,6,1,-1,0,3,2,3,1,0,0,-4,1,3,0,34,28,6,7,2,5,1,7,5,0,16,5,2,8,7,-3,7,7,-1,-1,-2,3,9,-2,3,4,-4,2,3,-1,1,3,0,-1,-1,0,2,1,-4,3,4,-1
15,15048,Miño,4888,140,59,81,62,15,47,22,23,37,39,20,0,10,15,17,9,9,0,12,8,20,30,11,0,11,14,22,6,6,3,4,2,3,1,3,2,7,12,19,5,3,1,76,38,38,54,19,35,3,4,30,12,24,0,-6,6,19,6,11,-1,9,-2,11,6,13,1,10,9,22,9,2,1,6,2,6,3,1,0,4,7,16,6,1,1,96,46,50,42,15,27,-3,10,31,4,37,18,0,6,12,1,22,8,-3,4,19,3,15,10,12,9,9,10,2,0,6,4,0,4,2,-1,6,5,9,6,0,1,21,27,-6,12,3,9,-2,18,-9,3,12,-5,2,14,-3,1,9,0,-4,4,-6,2,3,-5,3,5,0,4,-1,0,0,1,-2,3,0,1,3,4,2,1,-1,-1,73,43,30,33,11,22,-5,16,18,14,15,15,3,6,10,11,5,7,-8,10,8,3,10,8,3,8,9,3,3,7,1,2,0,3,0,5,2,6,9,0,3,2,76,52,24,37,16,21,8,-1,19,13,19,14,8,1,2,12,17,11,0,-2,17,1,2,3,7,10,8,6,2,3,3,4,4,2,2,1,4,6,4,4,0,2,80,95,-15,41,24,17,4,-2,11,15,29,21,13,9,20,13,23,16,-9,-11,-9,2,6,5,9,5,3,7,12,4,6,4,2,4,6,2,3,1,1,3,6,2,94,102,-8,46,31,15,24,-1,30,14,15,4,18,6,38,21,11,1,6,-7,-8,-7,4,3,3,11,11,9,6,4,2,6,9,6,4,2,1,5,2,3,2,2,170,117,53,27,18,9,23,33,47,31,14,7,12,22,33,20,12,7,11,11,14,11,2,0,4,10,6,1,2,0,3,6,3,0,2,1,1,4,3,1,0,-1,131,90,41,21,10,11,19,-5,51,35,18,5,13,0,36,22,9,5,6,-5,15,13,9,0,4,2,9,-1,2,3,2,1,3,1,2,0,2,1,6,-2,0,3,133,94,39,20,10,10,11,3,57,19,18,10,15,0,40,16,11,5,-4,3,17,3,7,5,6,1,1,5,5,2,5,1,-1,3,2,0,1,0,2,2,3,2,13,11,2,16,11,5,-16,-9,2,2,23,6,-5,-4,9,-1,12,1,-11,-5,-7,3,11,5,3,3,1,2,3,4,2,1,1,2,2,3,1,2,0,0,1,1,-28,-7,-21,-48,-22,-26,-9,7,-8,2,3,-22,-7,-1,-4,14,-1,-9,-2,8,-4,-12,4,-13,-1,-2,-14,-13,-4,-15,-2,-1,-7,-3,-3,-6,1,-1,-7,-10,-1,-9,67,52,15,-23,-12,-11,21,16,35,5,-7,-8,13,14,23,6,-4,-1,8,2,12,-1,-3,-7,-5,4,-3,-6,-8,-5,-2,1,-1,-4,-5,-1,-3,3,-2,-2,-3,-4,61,51,10,-4,-5,1,11,6,34,7,6,-7,18,8,15,13,-1,-4,-7,-2,19,-6,7,-3,3,2,-2,-5,0,-2,3,2,-2,-4,-3,-1,0,0,0,-1,3,-1,28,10,18,-8,-8,0,-8,4,36,-12,-1,5,-11,2,24,-9,1,1,3,2,12,-3,-2,4,-2,-4,0,-4,1,1,-2,-3,1,-3,-2,1,0,-1,-1,-1,3,0,67,40,27,14,4,10,12,-7,24,23,8,5,5,-5,13,14,11,0,7,-2,11,9,-3,5,4,4,-2,0,4,3,2,2,-2,-3,3,1,2,2,0,3,1,2,141,70,71,50,25,25,19,19,38,37,16,4,11,8,17,15,11,5,8,11,21,22,5,-1,12,9,10,10,5,3,8,4,3,3,4,2,4,5,7,7,1,1
15,15051,Mugardos,6056,14,6,8,21,9,12,12,-3,8,-7,-1,3,2,4,1,-2,0,-1,10,-7,7,-5,-1,4,7,0,6,6,1,1,2,0,2,3,1,1,5,0,4,3,0,0,-7,-2,-5,8,5,3,0,-8,-3,10,-3,-3,-1,-4,-6,8,1,0,1,-4,3,2,-4,-3,0,1,3,1,3,0,0,1,1,1,2,0,0,0,2,0,1,0,-50,-30,-20,7,2,5,-5,-13,-10,-11,-4,-10,-4,-1,-13,-4,-4,-3,-1,-12,3,-7,0,-7,1,1,0,1,3,1,1,0,-1,1,1,0,0,1,1,0,2,1,-82,-43,-39,6,2,4,-7,-17,-42,-2,-9,-4,-7,-4,-24,1,-7,-2,0,-13,-18,-3,-2,-2,4,0,0,-2,2,2,1,1,0,-1,0,1,3,-1,0,-1,2,1,30,29,1,4,2,2,3,1,7,15,10,-7,-1,6,12,3,10,0,4,-5,-5,12,0,-7,3,-2,-1,2,2,0,2,-1,-1,0,2,0,1,-1,0,2,0,0,53,43,10,18,9,9,9,15,25,6,0,-6,7,5,22,4,2,0,2,10,3,2,-2,-6,1,3,7,1,3,3,0,2,4,0,2,1,1,1,3,1,1,2,29,9,20,6,3,3,4,-7,9,11,8,1,6,-7,2,2,4,-2,-2,0,7,9,4,3,1,-2,5,1,1,0,0,0,1,1,1,0,1,-2,4,0,0,0,-1,6,-7,13,10,3,13,-18,-10,5,9,2,10,-8,-9,6,3,4,3,-10,-1,-1,6,-2,1,1,2,4,4,1,1,1,2,3,1,2,0,0,0,1,3,-1,-31,-15,-16,5,4,1,-12,7,-5,-17,14,-17,-11,5,6,-13,4,-5,-1,2,-11,-4,10,-12,0,1,4,2,1,-2,0,1,3,1,1,-1,0,0,1,1,0,-1,-17,-13,-4,1,-2,3,10,1,-20,-14,0,4,4,2,-6,-12,2,-4,6,-1,-14,-2,-2,8,4,0,-4,-2,4,-1,2,0,-2,-3,2,-1,2,0,-2,1,2,0,-14,-18,4,3,-1,4,6,-6,4,-9,3,-10,0,-7,-6,0,3,-5,6,1,10,-9,0,-5,3,0,2,-2,-1,0,1,-1,0,-1,1,-1,2,1,2,-1,-2,1,16,14,2,2,1,1,-5,2,5,-4,15,3,-4,9,-1,3,3,3,-1,-7,6,-7,12,0,1,0,1,-1,0,1,0,0,0,0,0,1,1,0,1,-1,0,0,48,20,28,-1,-5,4,13,4,16,7,11,-4,9,4,3,-3,6,1,4,0,13,10,5,-5,0,1,-2,1,1,-1,0,0,-1,-3,0,0,0,1,-1,4,1,-1,-18,-21,3,4,2,2,5,-10,-12,3,1,-3,2,-10,-11,-1,-1,0,3,0,-1,4,2,-3,0,1,0,-1,5,-1,1,-1,1,-2,3,0,-1,2,-1,1,2,-1,1,18,-17,1,2,-1,-1,2,-5,6,2,-2,5,2,-1,8,2,2,-6,0,-4,-2,0,-4,0,2,-1,-3,2,1,0,2,0,-2,1,1,0,0,-1,-1,1,0,12,14,-2,-3,-1,-2,22,-4,0,3,-2,-6,11,4,0,4,2,-5,11,-8,0,-1,-4,-1,1,1,-2,0,-2,-1,0,1,-1,0,-1,0,1,0,-1,0,-1,-1,0,6,-6,-8,-2,-6,-2,4,-5,7,1,-8,1,4,1,0,-1,0,-3,0,-6,7,2,-8,-4,-2,0,-4,2,0,-1,-1,1,-2,1,0,-3,-1,-1,-2,1,0,62,21,41,5,0,5,10,9,14,8,21,0,-1,2,4,3,13,2,11,7,10,5,8,-2,0,1,2,-2,4,0,0,0,0,-2,2,0,0,1,2,0,2,0
15,15053,Muros,10670,-103,-58,-45,46,23,23,-11,-45,-50,-10,11,3,-4,-20,-32,-7,4,2,-7,-25,-18,-3,7,1,6,2,8,12,12,6,3,1,4,7,6,2,3,1,4,5,6,4,-73,-47,-26,29,11,18,-12,-31,-17,-11,6,-7,-6,-21,-14,-8,4,-1,-6,-10,-3,-3,2,-6,9,2,9,4,4,1,3,0,4,1,3,0,6,2,5,3,1,1,-77,-24,-53,1,3,-2,-14,-27,-29,-23,14,2,-3,-12,-6,-16,7,5,-11,-15,-23,-7,7,-3,2,-6,-3,-2,5,5,0,-3,0,-3,5,4,2,-3,-3,1,0,1,-11,13,-24,45,23,22,-2,-9,-22,-6,23,3,5,1,-8,3,7,4,-7,-10,-14,-9,16,-1,5,3,9,7,14,7,3,2,2,4,7,5,2,1,7,3,7,2,-17,-14,-3,39,16,23,-4,-1,-35,4,18,6,-1,-1,-20,-5,12,5,-3,0,-15,9,6,1,5,8,2,9,11,3,1,2,1,4,7,0,4,6,1,5,4,3,-32,-4,-28,40,26,14,-25,-16,-23,11,11,11,-11,-13,-7,11,8,8,-14,-3,-16,0,3,3,4,5,1,14,11,4,1,3,0,11,6,4,3,2,1,3,5,0,-35,-18,-17,37,19,18,11,-17,-42,-2,18,3,9,-10,-31,5,7,4,2,-7,-11,-7,11,-1,4,0,6,9,14,3,2,-1,3,3,9,2,2,1,3,6,5,1,-41,-2,-39,55,37,18,-17,-3,-58,9,26,1,-6,-1,-19,5,18,1,-11,-2,-39,4,8,0,8,4,8,11,17,6,4,3,3,12,11,3,4,1,5,-1,6,3,36,26,10,39,18,21,13,-7,-2,7,29,-3,12,0,-8,5,14,4,1,-7,6,2,15,-7,8,-2,0,10,17,5,5,-2,-1,2,7,6,3,0,1,8,10,-1,-23,-16,-7,28,19,9,6,-3,-32,-1,18,-11,-8,-2,-12,-2,15,-7,14,-1,-20,1,3,-4,7,2,3,3,13,0,4,1,2,5,8,-1,3,1,1,-2,5,1,-51,-45,-6,12,4,8,-5,-27,-33,-9,17,11,-10,-14,-16,-15,5,6,5,-13,-17,6,12,5,1,-5,2,2,11,1,0,-4,0,3,4,1,1,-1,2,-1,7,0,-39,-16,-23,-13,-7,-6,6,-6,-16,-6,3,-15,-4,-2,-2,-7,4,-2,10,-4,-14,1,-1,-13,4,-1,-1,-6,-5,-4,1,1,2,-7,-2,-2,3,-2,-3,1,-3,-2,-24,-2,-22,-15,-14,-1,-3,-1,-9,-10,0,-1,0,2,2,-5,0,-1,-3,-3,-11,-5,0,0,-3,-2,2,-5,-10,3,-1,-1,1,-6,-6,-1,-2,-1,1,1,-4,4,-87,-37,-50,-21,-5,-16,-13,-1,-42,-20,-2,-7,-6,4,-22,-6,-3,-3,-7,-5,-20,-14,1,-4,-4,0,-9,-3,-3,-2,-1,0,-5,0,0,1,-3,0,-4,-3,-3,-3,-52,-16,-36,-13,-14,1,-3,-8,-35,-10,25,-19,-1,0,-17,-1,12,-8,-2,-8,-18,-9,13,-11,-2,-2,-6,-5,9,-7,-1,-2,-6,-2,2,-5,-1,0,0,-3,7,-2,-66,-24,-42,1,1,0,-24,-3,-48,-2,22,-9,-7,-10,-21,1,17,-2,-17,7,-27,-3,5,-7,-5,2,-4,2,9,-3,-1,0,-6,0,8,0,-4,2,2,2,1,-3,33,14,19,17,11,6,21,-6,-19,6,13,19,13,-3,-11,-3,7,12,8,-3,-8,9,6,7,4,1,-3,0,4,10,2,1,-1,0,3,5,2,0,-2,0,1,5,-28,-9,-19,30,19,11,7,-9,-14,-2,9,-16,1,0,-12,-2,8,-3,6,-9,-2,0,1,-13,6,0,5,-1,11,7,5,1,0,0,8,5,1,-1,5,-1,3,2
15,15052,Muxía,6422,-9,-6,-3,46,24,22,4,-27,-6,-1,11,7,1,-14,-6,0,6,4,3,-13,0,-1,5,3,4,2,7,7,15,9,1,0,4,4,8,5,3,2,3,3,7,4,-45,-24,-21,31,16,15,-5,-9,-27,-5,3,0,-2,-4,-15,-3,-1,2,-3,-5,-12,-2,4,-2,8,6,2,5,9,1,5,2,1,2,5,1,3,4,1,3,4,0,-68,-30,-38,38,18,20,1,-43,-34,-13,19,2,5,-20,-18,-11,11,3,-4,-23,-16,-2,8,-1,13,-6,-2,6,19,6,6,-5,0,2,9,5,7,-1,-2,4,10,1,-30,-4,-26,20,18,2,-6,-21,-11,4,7,-4,1,-8,2,-2,5,-3,-7,-13,-13,6,2,-1,7,-2,4,3,7,0,5,1,7,1,4,-1,2,-3,-3,2,3,1,-35,-7,-28,37,30,7,-12,-16,-11,-7,15,-2,-2,-9,-4,-4,13,-1,-10,-7,-7,-3,2,-1,6,3,9,7,12,0,4,2,9,5,11,-1,2,1,0,2,1,1,-4,-8,4,53,29,24,4,-13,-9,7,5,1,0,-5,-10,-2,7,2,4,-8,1,9,-2,-1,7,-2,15,13,12,7,2,1,8,5,9,3,5,-3,7,8,3,4,-9,10,-19,35,22,13,-2,-18,-22,16,15,3,3,-7,-19,20,13,1,-5,-11,-3,-4,2,2,6,0,8,11,6,4,5,-1,2,9,5,2,1,1,6,2,1,2,-30,-23,-7,12,8,4,3,0,-27,-4,-2,-3,0,-7,-13,-4,-3,0,3,7,-14,0,1,-3,6,1,0,6,0,-2,3,1,-1,4,0,0,3,0,1,2,0,-2,-31,-11,-20,-4,-5,1,4,-27,4,-10,5,-8,2,-17,11,-5,1,-3,2,-10,-7,-5,4,-5,-1,-2,1,-4,2,0,0,-3,1,-4,1,0,-1,1,0,0,1,0,-32,-25,-7,-3,-1,-2,-8,3,-14,-1,-4,-8,-6,0,-11,-4,-2,-2,-2,3,-3,3,-2,-6,-3,1,0,1,1,-2,-2,0,0,1,1,0,-1,1,0,0,0,-2,-16,-7,-9,-9,-8,-1,0,-10,-5,-7,9,-3,-5,-10,10,-2,5,-4,5,0,-15,-5,4,1,3,-7,-1,-2,0,-2,0,-7,1,-1,1,-2,3,0,-2,-1,-1,0,-45,-16,-29,-8,-4,-4,-5,-5,-16,-9,-6,-4,-3,-2,-9,-3,-2,3,-2,-3,-7,-6,-4,-7,1,-4,-4,-1,-1,1,1,-3,-4,0,1,1,0,-1,0,-1,-2,0,-7,0,-7,10,11,-1,12,-5,-8,-1,-4,-1,11,-1,-2,-2,-5,-2,1,-4,-6,1,1,1,5,5,4,-3,0,-1,7,4,3,-2,0,-1,-2,1,1,-1,0,0,-44,-20,-24,-16,-10,-6,1,-7,-24,-6,-1,-8,3,-2,-12,-7,1,-4,-2,-5,-12,1,-2,-4,-1,-3,-3,-4,-3,-3,0,-2,-2,-3,-3,-1,-1,-1,-1,-1,0,-2,16,12,4,-6,-1,-5,5,-7,-4,13,0,8,2,-6,1,14,-4,5,3,-1,-5,-1,4,3,1,0,-3,-1,-4,0,0,1,-2,2,-3,1,1,-1,-1,-3,-1,-1,-31,-11,-20,-1,-5,4,-7,-4,-19,-10,0,8,-5,-1,-8,-2,-1,5,-2,-3,-11,-8,1,3,2,-1,-3,0,-1,2,0,-1,-2,-2,-1,1,2,0,-1,2,0,1,-24,-9,-15,4,6,-2,-11,-7,-1,-10,7,-3,-8,0,2,-7,5,-1,-3,-7,-3,-3,2,-2,0,-3,9,-4,2,-1,0,0,6,-2,2,-1,0,-3,3,-2,0,0,-53,-36,-17,10,3,7,-11,-4,-24,-12,7,-7,-8,-3,-15,-5,3,-7,-3,-1,-9,-7,4,0,0,-1,0,2,10,-1,-1,-1,0,0,7,-2,1,0,0,2,3,1
15,15054,Narón,31108,-785,-383,-402,7,2,5,-166,-166,-226,-138,-46,-30,-85,-75,-102,-78,-25,-10,-81,-91,-124,-60,-21,-20,2,0,1,1,2,0,0,0,0,0,2,0,2,0,1,1,0,0,-12,-1,-11,33,19,14,11,6,7,-6,-23,-10,-1,0,6,7,-13,-2,12,6,1,-13,-10,-8,7,12,8,5,1,0,5,7,3,4,0,0,2,5,5,1,1,0,633,295,338,74,28,46,104,118,240,103,23,26,55,47,104,50,14,13,49,71,136,53,9,13,21,5,21,9,11,5,10,1,3,6,5,2,11,4,18,3,6,3,490,236,254,74,26,48,69,95,210,61,-1,36,37,33,106,32,-2,19,32,62,104,29,1,17,20,13,13,17,6,5,5,3,5,6,5,2,15,10,8,11,1,3,535,291,244,74,42,32,61,97,216,68,38,43,56,35,135,42,17,3,5,62,81,26,21,40,8,18,13,14,19,1,5,5,10,12,10,0,3,13,3,2,9,1,626,291,335,105,56,49,54,107,271,74,26,74,17,31,136,53,6,34,37,76,135,21,20,40,28,15,28,15,8,8,9,5,19,12,6,3,19,10,9,3,2,5,623,342,281,122,64,58,43,123,249,64,47,82,40,58,142,25,40,27,3,65,107,39,7,55,27,16,34,26,12,5,16,6,14,15,8,4,11,10,20,11,4,1,728,368,360,148,85,63,84,138,356,49,23,65,33,53,214,39,0,22,51,85,142,10,23,43,33,32,41,16,20,3,10,17,31,14,8,3,23,15,10,2,12,0,679,320,359,169,107,62,48,125,250,125,66,54,2,42,141,72,32,28,46,83,109,53,34,26,23,33,48,43,16,3,12,16,29,36,9,4,11,17,19,7,7,-1,602,279,323,111,50,61,60,96,269,114,5,39,32,45,123,60,2,5,28,51,146,54,3,34,33,16,27,18,8,6,12,7,15,6,4,5,21,9,12,12,4,1,647,311,336,93,46,47,58,85,315,81,31,60,28,18,170,44,18,24,30,67,145,37,13,36,17,15,29,18,12,1,8,7,19,7,4,0,9,8,10,11,8,1,325,137,188,92,41,51,16,70,126,38,49,25,23,20,59,-2,29,9,-7,50,67,40,20,16,16,21,16,16,11,11,11,6,7,8,3,6,5,15,9,8,8,5,205,59,146,28,10,18,12,78,86,7,14,13,-7,32,33,-17,13,7,19,46,53,24,1,6,9,11,11,2,-2,-3,4,7,0,1,1,-2,5,4,11,1,-3,-1,239,109,130,10,4,6,14,15,142,-3,30,34,8,0,88,-19,23,9,6,15,54,16,7,25,3,4,1,-5,1,5,3,-1,1,-3,1,3,0,5,0,-2,0,2,76,43,33,40,21,19,-20,56,10,0,-5,18,0,42,-22,3,0,12,-20,14,32,-3,-5,6,15,15,-4,4,7,0,7,8,-1,3,3,0,8,7,-3,1,4,0,-119,-119,0,-34,-36,2,-43,-14,13,-90,-24,38,-31,-4,1,-75,-29,18,-12,-10,12,-15,5,20,12,-7,-15,-24,-9,7,4,-5,-8,-24,-9,5,8,-2,-7,0,0,2,-106,-68,-38,40,28,12,-36,-21,12,-59,-23,19,-22,-17,3,-37,-9,14,-14,-4,9,-22,-14,5,2,11,10,-2,8,11,4,4,7,1,6,6,-2,7,3,-3,2,5,-65,-47,-18,77,33,44,-16,9,-33,-52,9,10,-15,7,-23,-29,6,0,-1,2,-10,-23,3,10,28,22,4,9,10,1,14,10,4,3,-1,2,14,12,0,6,11,-1
15,15055,Neda,6192,62,31,31,17,9,8,24,-2,9,15,10,7,14,0,1,10,3,4,10,-2,8,5,7,3,1,3,3,3,3,4,1,1,2,2,1,2,0,2,1,1,2,2,-20,-9,-11,12,6,6,-1,-3,-18,1,-1,2,-3,0,-6,2,-3,1,2,-3,-12,-1,2,1,2,2,5,0,3,0,1,2,2,0,1,0,1,0,3,0,2,0,-92,-42,-50,7,2,5,-9,-20,-42,-11,-5,-4,-3,-5,-31,-3,-2,1,-6,-15,-11,-8,-3,-5,2,0,1,2,1,1,0,0,1,-1,1,1,2,0,0,3,0,0,-43,-12,-31,1,3,-2,-2,-13,-28,-2,9,-7,-4,2,-11,0,5,-4,2,-15,-17,-2,4,-3,1,-1,0,1,1,-1,1,1,0,2,0,-1,0,-2,0,-1,1,0,5,-5,10,14,6,8,8,7,-19,2,-1,9,2,1,-4,-4,-3,4,6,6,-15,6,2,5,3,1,3,4,3,0,1,0,2,2,1,0,2,1,1,2,2,0,-58,-31,-27,24,12,12,-5,0,-31,-11,3,-9,-5,1,-16,-10,5,-3,0,-1,-15,-1,-2,-6,2,4,7,3,4,4,2,2,4,0,2,2,0,2,3,3,2,2,19,8,11,21,8,13,12,-6,-23,19,9,9,10,-6,-12,11,5,3,2,0,-11,8,4,6,5,3,6,2,3,2,2,0,2,1,2,1,3,3,4,1,1,1,-7,-2,-5,12,6,6,11,-7,-16,2,0,3,9,-3,-16,6,1,1,2,-4,0,-4,-1,2,1,0,2,4,0,4,1,1,2,1,0,1,0,-1,0,3,0,3,13,6,7,12,5,7,18,0,-1,14,-2,-13,9,-3,2,7,-5,0,9,3,-3,7,3,-13,4,1,4,1,1,1,2,0,1,1,0,1,2,1,3,0,1,0,19,12,7,3,1,2,11,-3,2,16,2,-6,8,-2,-2,11,5,-6,3,-1,4,5,-3,0,-1,0,0,0,5,-1,0,-1,-1,1,3,-1,-1,1,1,-1,2,0,2,-2,4,3,2,1,3,1,-7,-6,13,-3,2,-4,-3,-3,5,1,1,5,-4,-3,8,-4,-1,0,0,0,3,1,0,0,-1,0,2,1,-1,0,1,0,1,0,13,10,3,3,0,3,4,-3,-2,-2,6,5,1,-2,1,3,2,6,3,-1,-3,-5,4,-1,-1,0,5,0,-1,-1,-1,0,3,-1,-1,0,0,0,2,1,0,-1,39,33,6,-5,-3,-2,5,5,1,20,1,4,5,8,0,15,3,0,0,-3,1,5,-2,4,-2,0,-3,-1,0,0,0,0,-2,-2,0,0,-2,0,-1,1,0,0,-46,-11,-35,2,0,2,-8,0,-15,-16,1,-4,-2,5,-3,-8,4,-5,-6,-5,-12,-8,-3,1,0,0,0,-3,1,3,0,0,1,-3,1,0,0,0,-1,0,0,3,-22,-22,0,1,0,1,-7,-4,1,-7,2,-3,-7,-4,-5,-6,-1,3,0,0,6,-1,3,-6,0,1,0,0,1,-1,0,1,-1,0,0,0,0,0,1,0,1,-1,-14,3,-17,-8,-6,-2,-16,-9,-11,16,2,0,-3,-8,0,11,0,1,-13,-1,-11,5,2,-1,-2,-2,-2,-3,2,-1,-1,-3,-1,-2,1,0,-1,1,-1,-1,1,-1,13,7,6,3,2,1,8,-1,16,-7,3,-6,9,-5,10,-3,0,-3,-1,4,6,-4,3,-3,0,0,-1,4,0,0,0,0,-1,3,0,0,0,0,0,1,0,0,-15,-25,10,0,-2,2,2,1,-5,-8,5,-10,0,-4,-3,-11,-2,-5,2,5,-2,3,7,-5,-1,-1,0,-2,2,2,-1,-1,0,-1,0,1,0,0,0,-1,2,1
15,15056,Negreira,6594,13,13,0,29,12,17,-7,-6,8,-2,13,7,-2,-1,5,0,9,2,-5,-5,3,-2,4,5,8,1,8,3,6,3,3,1,2,0,5,1,5,0,6,3,1,2,62,34,28,51,24,27,17,15,21,2,3,3,5,6,15,4,3,1,12,9,6,-2,0,2,20,6,9,7,3,4,10,3,3,5,1,1,10,3,6,2,2,3,42,10,32,47,26,21,22,4,9,-5,13,-2,7,0,-2,-4,6,3,15,4,11,-1,7,-5,10,0,11,5,11,9,5,-1,6,5,4,7,5,1,5,0,7,2,88,41,47,68,40,28,3,14,32,20,8,5,4,1,17,10,-1,6,-1,13,15,10,9,-1,13,5,12,16,9,11,7,2,7,11,3,9,6,3,5,5,6,2,102,67,35,66,32,34,19,-18,50,21,12,16,12,-7,26,12,9,14,7,-11,24,9,3,2,9,7,14,12,15,9,5,2,6,8,5,6,4,5,8,4,10,3,57,25,32,4,-3,7,17,7,21,-3,7,6,7,2,20,-5,-1,2,10,5,1,2,8,4,12,0,-4,-1,1,-4,5,1,-2,-4,0,-3,7,-1,-2,3,1,-1,16,2,14,31,13,18,4,-1,2,6,2,4,1,-5,1,3,1,3,3,4,1,3,1,1,6,1,7,6,7,3,2,-1,6,1,2,3,4,2,1,5,5,0,124,60,64,50,28,22,18,24,32,27,18,6,6,12,12,17,7,7,12,12,20,10,11,-1,12,11,8,9,5,4,10,5,3,4,2,4,2,6,5,5,3,0,96,50,46,42,26,16,12,18,21,26,19,-3,6,3,13,12,14,0,6,15,8,14,5,-3,5,7,8,9,11,1,4,3,4,6,7,1,1,4,4,3,4,0,109,69,40,-2,-1,-1,32,12,37,20,9,-5,19,9,11,19,7,2,13,3,26,1,2,-7,2,1,-1,-4,1,-2,1,0,-1,0,1,-2,1,1,0,-4,0,0,69,27,42,-6,-9,3,2,6,33,14,7,0,-2,0,17,7,1,-4,4,6,16,7,6,4,7,-1,-7,-2,0,-5,5,-2,-5,-4,-1,-4,2,1,-2,2,1,-1,65,32,33,7,0,7,18,24,34,-21,13,-3,15,6,23,-20,8,0,3,18,11,-1,5,-3,3,5,1,-5,1,0,5,0,-1,-5,1,-1,-2,5,2,0,0,1,37,17,20,-6,-7,1,13,4,7,4,14,-5,8,2,10,-12,9,-2,5,2,-3,16,5,-3,4,2,-2,-8,3,-5,2,-1,-1,-8,2,-1,2,3,-1,0,1,-4,-27,-18,-9,-5,-10,5,-20,-3,-16,2,12,-1,-9,0,-14,3,7,-5,-11,-3,-2,-1,5,4,2,-3,-7,-1,4,0,1,-3,-3,-4,1,-2,1,0,-4,3,3,2,-48,-25,-23,-13,-7,-6,-2,-14,-15,-3,2,-15,2,-10,-8,-6,1,-3,-4,-4,-7,3,1,-12,-2,-5,-5,-5,5,-1,0,-4,-2,-4,3,0,-2,-1,-3,-1,2,-1,-1,2,-3,2,10,-8,-8,7,-18,3,9,5,-13,2,2,-4,4,8,5,5,-20,7,5,-3,-3,2,-4,0,6,0,0,3,1,-2,5,2,-3,-1,-5,2,1,-2,20,7,13,32,16,16,-1,12,-4,0,3,4,0,8,-7,-2,4,1,-1,4,3,2,-1,3,11,4,4,8,1,3,7,3,1,6,0,-1,4,1,3,2,1,4,44,24,20,33,16,17,12,10,15,-4,10,-2,2,8,5,-2,10,0,10,2,10,-2,0,-2,9,8,5,3,2,4,4,4,2,3,0,2,5,4,3,0,2,2
15,15057,Noia,14420,-1,-18,17,78,38,40,11,-48,-29,36,6,18,14,-28,-31,12,6,6,-3,-20,2,24,0,12,20,9,12,21,10,4,11,5,3,9,7,2,9,4,9,12,3,2,-18,-12,-6,46,28,18,-2,-46,-7,14,13,6,2,-26,-10,12,6,1,-4,-20,3,2,7,5,14,4,7,13,4,1,8,2,5,9,2,1,6,2,2,4,2,0,91,40,51,54,25,29,27,-6,33,13,27,-8,11,0,18,2,8,-3,16,-6,15,11,19,-5,17,3,19,-4,12,4,12,2,11,-7,4,1,5,1,8,3,8,3,26,-2,28,57,15,42,-5,8,-14,13,11,8,-4,-1,-6,1,1,8,-1,9,-8,12,10,0,12,10,6,12,9,5,4,4,4,-5,3,3,8,6,2,17,6,2,163,58,105,88,36,52,15,39,22,29,34,21,0,12,7,11,17,9,15,27,15,18,17,12,16,8,19,22,12,10,7,3,8,8,6,3,9,5,11,14,6,7,77,64,13,48,28,20,7,16,-8,21,35,10,7,10,11,13,23,3,0,6,-19,8,12,7,11,8,3,4,14,8,8,4,4,0,9,3,3,4,-1,4,5,5,119,66,53,83,41,42,51,-21,-1,43,23,26,19,-11,5,25,15,14,32,-10,-6,18,8,12,19,3,20,22,11,7,6,2,13,11,5,3,13,1,7,11,6,4,79,19,60,70,39,31,-4,8,-12,37,21,24,-7,6,-14,20,7,8,3,2,2,17,14,16,12,6,15,21,13,1,4,1,12,12,8,2,8,5,3,9,5,-1,108,80,28,38,25,13,12,22,13,36,19,10,12,15,9,22,16,5,0,7,4,14,3,5,5,12,5,10,11,-5,3,7,2,9,6,-2,2,5,3,1,5,-3,9,1,8,20,9,11,-28,-21,-2,1,5,52,-18,-13,7,6,-2,26,-10,-8,-9,-5,7,26,4,-2,8,0,1,7,1,0,2,0,3,3,3,-2,6,0,-2,4,18,5,13,11,12,-1,7,-8,-18,-1,3,37,-3,-2,-5,-3,3,15,10,-6,-13,2,0,22,2,7,-2,2,2,0,4,2,-1,4,2,1,-2,5,-1,-2,0,-1,-28,-1,-27,5,2,3,-2,-3,-16,-24,4,13,-4,0,2,-12,2,9,2,-3,-18,-12,2,4,5,1,2,-7,0,2,3,0,2,-5,0,0,2,1,0,-2,0,2,19,20,-1,8,-4,12,3,2,-22,20,15,4,-2,-4,-1,7,17,5,5,6,-21,13,-2,-1,4,1,2,-9,8,1,0,-1,-1,-10,6,1,4,2,3,1,2,0,-34,-40,6,-42,-25,-17,0,-3,-17,-20,3,2,-8,3,-8,-28,2,2,8,-6,-9,8,1,0,-1,-5,-20,-15,-2,1,0,-4,-9,-12,-1,1,-1,-1,-11,-3,-1,0,0,-5,5,0,-3,3,22,-12,-19,-4,22,-7,9,-5,-19,0,11,-2,13,-7,0,-4,11,-5,0,0,-14,-1,10,5,-2,-1,-7,-2,5,4,2,1,-7,1,5,1,-78,-35,-43,5,9,-4,-14,-14,-48,-23,13,7,-5,-15,-23,-5,10,2,-9,1,-25,-18,3,5,0,-2,-3,-2,8,2,1,-1,-3,3,7,1,-1,-1,0,-5,1,1,26,-2,28,21,8,13,13,12,-29,-5,32,6,4,4,-24,-7,15,8,9,8,-5,2,17,-2,5,3,-8,7,12,1,3,0,-9,4,7,2,2,3,1,3,5,-1,94,46,48,29,17,12,17,2,22,-4,26,28,10,-4,27,-4,7,8,7,6,-5,0,19,20,4,3,-1,-5,22,5,1,-1,4,-2,11,3,3,4,-5,-3,11,2
15,15058,Oleiros,25166,863,420,443,303,141,162,176,87,244,162,112,75,82,35,126,76,58,38,94,52,118,86,54,37,60,62,68,54,36,22,28,26,30,28,18,11,32,36,38,26,18,11,463,190,273,245,98,147,116,46,122,115,33,32,65,15,39,50,4,15,51,31,83,65,29,17,73,39,66,29,26,10,40,12,19,10,10,5,33,27,47,19,16,5,806,373,433,311,141,170,84,114,204,162,125,86,30,41,97,95,67,34,54,73,107,67,58,52,64,63,67,49,34,27,29,27,29,24,15,14,35,36,38,25,19,13,944,474,470,263,114,149,177,94,309,164,91,96,101,38,153,95,38,42,76,56,156,69,53,54,50,48,61,56,24,21,29,19,17,28,6,13,21,29,44,28,18,8,976,460,516,291,117,174,128,93,397,162,83,93,79,46,166,81,39,38,49,47,231,81,44,55,42,51,70,54,31,40,20,21,27,19,14,13,22,30,43,35,17,27,758,364,394,252,108,144,169,53,176,181,106,58,88,24,76,82,60,29,81,29,100,99,46,29,37,49,77,28,37,21,20,18,33,11,10,16,17,31,44,17,27,5,568,219,349,278,119,159,137,55,159,95,64,42,57,23,42,39,30,21,80,32,117,56,34,21,50,55,76,43,28,21,32,20,23,18,11,13,18,35,53,25,17,8,667,340,327,331,138,193,182,38,232,128,25,52,105,-1,109,76,21,28,77,39,123,52,4,24,68,62,94,56,36,12,29,22,31,23,24,8,39,40,63,33,12,4,747,293,454,269,92,177,133,54,250,132,51,113,60,-2,116,66,26,22,73,56,134,66,25,91,40,73,70,43,26,12,22,21,22,6,12,6,18,52,48,37,14,6,152,127,25,68,33,35,68,-23,47,45,-4,13,38,-4,43,33,5,11,30,-19,4,12,-9,2,36,4,6,19,5,-6,20,4,-1,8,2,-2,16,0,7,11,3,-4,518,282,236,85,45,40,146,29,89,148,24,60,79,24,50,79,14,23,67,5,39,69,10,37,32,15,22,-3,8,9,24,6,7,-3,5,5,8,9,15,0,3,4,339,159,180,-13,-16,3,89,10,43,118,23,54,66,14,-3,54,8,22,23,-4,46,64,15,32,8,3,-7,-9,3,-16,4,4,-4,-11,1,-11,4,-1,-3,2,2,-5,137,52,85,-39,-16,-23,16,-37,32,24,12,79,12,-31,8,30,10,15,4,-6,24,-6,2,64,1,-4,-28,-4,-5,0,-1,-3,-9,-1,-4,2,2,-1,-19,-3,-1,-2,102,21,81,-106,-62,-44,61,-23,-7,29,-9,39,38,-29,-15,16,-5,6,23,6,8,13,-4,33,4,-7,-40,-44,-15,-6,8,-4,-24,-26,-10,-7,-4,-3,-16,-18,-5,1,191,87,104,3,2,1,40,-6,37,86,0,25,14,-5,5,49,-1,21,26,-1,32,37,1,4,10,3,-27,5,11,-4,12,-2,-12,-5,6,1,-2,5,-15,10,5,-5,332,124,208,101,49,52,105,26,58,85,2,47,52,18,-3,48,-5,14,53,8,61,37,7,33,19,22,9,20,9,20,13,10,7,8,1,10,6,12,2,12,8,10,263,65,198,65,32,33,53,-18,12,76,32,98,10,-14,-1,30,7,35,43,-4,13,46,25,63,8,22,3,9,22,-3,4,8,5,4,13,-3,4,14,-2,5,9,0,538,266,272,242,115,127,155,28,57,186,49,55,81,-8,27,105,39,21,74,36,30,81,10,34,50,48,15,55,50,23,28,23,3,26,22,12,22,25,12,29,28,11
15,15059,Ordes,11946,23,6,17,89,35,54,3,9,8,1,3,0,2,-2,1,-1,4,3,1,11,7,2,-1,-3,13,25,18,17,14,2,5,6,4,8,10,2,8,19,14,9,4,0,93,35,58,125,49,76,25,8,22,17,12,7,20,1,-8,14,4,4,5,7,30,3,8,3,27,25,37,22,12,2,15,8,6,12,7,1,12,17,31,10,5,1,167,98,69,136,70,66,60,37,24,19,17,12,29,25,19,10,10,4,31,12,5,9,7,8,34,23,24,24,16,13,19,15,13,11,9,2,15,8,11,13,7,11,75,36,39,100,45,55,8,13,23,-5,20,17,5,6,14,1,10,1,3,7,9,-6,10,16,13,24,11,20,21,10,7,9,4,12,10,3,6,15,7,8,11,7,20,15,5,90,33,57,1,-18,-21,17,23,19,-1,-9,-8,16,8,8,2,-9,-13,1,15,11,18,13,25,11,12,9,8,1,8,7,4,3,10,12,17,4,8,6,53,38,15,86,38,48,23,4,26,-8,11,-4,19,-2,20,1,5,-3,4,6,6,-9,6,-1,19,22,23,11,9,2,12,8,10,5,3,0,7,14,13,6,6,2,120,81,39,108,49,59,27,10,40,4,15,25,15,6,24,12,9,16,12,4,16,-8,6,9,25,21,29,16,12,5,12,7,13,5,8,4,13,14,16,11,4,1,198,106,92,117,57,60,41,33,48,16,25,35,19,17,37,6,16,11,22,16,11,10,9,24,28,27,24,19,18,1,14,15,15,5,8,0,14,12,9,14,10,1,221,144,77,107,77,30,18,23,82,50,24,18,8,18,50,31,17,18,10,5,32,19,7,0,5,21,36,28,12,5,4,16,21,25,7,4,1,5,15,3,5,1,123,56,67,-12,-17,5,18,25,36,31,4,2,11,11,5,24,2,0,7,14,31,7,2,2,2,7,-10,-4,-5,-2,0,1,-9,-5,-3,-1,2,6,-1,1,-2,-1,111,43,68,53,27,26,35,24,22,22,6,0,19,9,2,12,1,-1,16,15,20,10,5,1,15,15,12,8,1,1,8,6,4,6,1,1,7,9,8,2,0,0,10,-18,28,11,-8,19,18,1,-3,-12,-4,8,8,-4,-11,-9,-9,6,10,5,8,-3,5,2,10,6,-7,0,1,0,5,-2,-5,-2,-4,0,5,8,-2,2,5,0,3,-8,11,12,4,8,-8,0,-4,-12,14,11,-4,-3,-8,-8,9,5,-4,3,4,-4,5,6,6,4,-1,-3,4,0,4,-3,0,0,1,0,2,7,-1,-3,3,0,-26,-18,-8,14,9,5,-1,-19,-8,-9,9,1,1,-13,-4,-7,2,1,-2,-6,-4,-2,7,0,5,1,-3,3,8,-1,2,0,2,3,2,-1,3,1,-5,0,6,0,-21,-20,-1,-19,-13,-6,11,-12,-2,-13,-5,3,9,-2,-3,-19,0,0,2,-10,1,6,-5,3,3,-3,-4,-10,0,-6,1,-3,-6,-5,2,-2,2,0,2,-5,-2,-4,12,17,-5,33,14,19,-12,4,-3,-5,19,9,-3,6,-1,1,7,6,-9,-2,-2,-6,12,3,3,2,12,3,12,1,3,0,5,-1,5,2,0,2,7,4,7,-1,-84,-48,-36,-36,-30,-6,-7,-6,-11,-40,-19,-3,-1,4,-15,-26,-13,-1,-6,-10,4,-14,-6,-2,7,6,-10,-29,-11,0,3,7,-8,-22,-12,1,4,-1,-2,-7,1,-1,41,15,26,41,13,28,6,24,-4,2,2,11,6,10,4,-4,-3,3,0,14,-8,6,5,8,11,10,7,1,5,7,6,4,1,-2,0,4,5,6,6,3,5,3
15,15060,Oroso,4904,292,135,157,70,18,52,46,60,140,30,20,-5,19,24,66,14,14,-4,27,36,74,16,6,-1,8,15,26,12,8,1,2,1,7,2,5,1,6,14,19,10,3,0,121,56,65,44,15,29,-3,31,60,16,16,1,-9,12,31,11,9,2,6,19,29,5,7,-1,7,13,14,4,5,0,3,1,5,3,3,0,4,12,9,1,2,0,203,112,91,50,26,24,40,12,92,29,6,15,19,13,48,20,1,7,21,-1,44,9,5,8,7,7,15,5,7,9,6,4,7,1,4,4,1,3,8,4,3,5,194,94,100,43,20,23,17,46,92,9,15,6,3,20,45,10,8,1,14,26,47,-1,7,5,6,4,8,6,8,9,2,3,5,2,3,4,4,1,3,4,5,5,150,71,79,35,17,18,-6,0,131,5,9,8,-3,2,65,-3,8,2,-3,-2,66,8,1,6,4,7,15,3,3,1,0,3,6,3,3,1,4,4,9,0,0,0,155,100,55,25,14,11,11,37,68,15,6,14,5,17,46,11,5,11,6,20,22,4,1,3,3,8,9,4,0,1,0,4,7,2,-1,2,3,4,2,2,1,-1,16,7,9,47,19,28,-29,18,25,-9,11,0,-9,0,16,2,-1,0,-20,18,9,-11,12,0,8,13,11,5,8,2,4,7,2,1,4,1,4,6,9,4,4,1,199,107,92,92,62,30,17,41,79,34,13,12,5,32,38,19,6,4,12,9,41,15,7,8,16,26,26,18,4,1,9,19,18,12,3,0,7,7,8,6,1,1,101,38,63,76,40,36,4,40,46,0,13,-5,-6,18,20,-2,10,-4,10,22,26,2,3,-1,10,22,20,14,10,-1,7,12,12,5,4,-1,3,10,8,9,6,0,28,20,8,36,18,18,-9,6,32,5,3,-5,-6,3,24,4,1,-4,-3,3,8,1,2,-1,2,10,14,6,5,-1,2,4,8,3,1,0,0,6,6,3,4,-1,93,49,44,36,15,21,-6,31,33,11,8,10,2,14,17,4,4,5,-8,17,16,7,4,5,6,10,9,7,4,-2,4,3,3,4,1,-1,2,7,6,3,3,-1,82,26,56,25,13,12,-2,6,44,25,-2,14,-1,0,20,11,-4,3,-1,6,24,14,2,11,2,1,8,11,2,1,1,3,3,5,1,0,1,-2,5,6,1,1,83,44,39,10,3,7,10,13,62,-13,5,4,5,10,29,-11,3,4,5,3,33,-2,2,0,2,5,1,-3,3,2,0,3,0,-4,3,1,2,2,1,1,0,1,-74,-39,-35,-68,-49,-19,-19,-10,-15,-22,-11,4,-7,-8,1,-16,-7,-2,-12,-2,-16,-6,-4,6,3,-8,-13,-26,-17,-8,1,-7,-8,-19,-13,-4,2,-1,-5,-7,-4,-4,-58,-27,-31,-24,-2,-22,-21,-3,-10,-33,0,9,-12,0,-3,-14,-2,3,-9,-3,-7,-19,2,6,2,1,-12,-10,-2,-3,6,3,-4,-4,-2,-1,-4,-2,-8,-6,0,-2,-34,-25,-9,5,-1,6,-8,-11,-13,-12,-1,4,-9,-4,-11,-2,-3,2,1,-7,-2,-10,2,2,4,3,-13,2,5,2,1,1,-7,2,1,1,3,2,-6,0,4,1,3,-9,12,1,-4,5,9,-5,6,-6,-12,8,8,-3,-2,-4,-8,-1,1,-2,8,-2,-4,9,8,-1,-6,-1,1,0,6,-3,-5,-2,0,0,2,2,-1,1,1,0,-4,14,-18,21,17,4,-19,1,34,-25,5,2,-3,-2,23,-5,3,-3,-16,3,11,-20,2,5,2,7,8,0,3,1,5,7,6,-3,1,1,-3,0,2,3,2,0
15,15061,Ortigueira,8603,-46,-35,-11,14,6,8,-4,-22,-3,-20,7,-3,-3,-4,-13,-16,4,-2,-1,-18,10,-4,3,-1,0,3,2,0,3,4,0,1,0,0,2,1,0,2,2,0,1,3,-7,3,-10,16,9,7,6,0,-3,-2,2,-11,3,0,2,-2,2,-3,3,0,-5,0,0,-8,4,2,2,4,3,0,3,1,2,1,1,0,1,1,0,3,2,0,-41,-19,-22,11,5,6,-7,-16,-30,-7,17,3,-3,-4,-20,-4,8,4,-4,-12,-10,-3,9,-1,1,0,-3,-1,10,4,0,0,-5,1,6,3,1,0,2,-2,4,1,-43,-12,-31,42,24,18,-2,-13,-39,10,-1,4,-3,1,-17,2,-1,8,1,-14,-22,8,0,-4,5,3,8,9,10,7,2,2,5,5,6,4,3,1,3,4,4,3,-19,6,-25,26,15,11,-4,0,-14,8,12,-21,5,4,-8,1,10,-6,-9,-4,-6,7,2,-15,2,6,5,5,3,5,1,3,3,3,2,3,1,3,2,2,1,2,-179,-97,-82,-8,-4,-4,-14,-30,-67,-24,-15,-28,-10,-12,-37,-16,-6,-15,-4,-18,-30,-8,-9,-13,0,-2,-1,0,-1,-4,0,0,0,0,0,-4,0,-2,-1,0,-1,0,-38,-23,-15,39,24,15,-3,-9,-32,-7,11,2,-6,-6,-12,-3,3,1,3,-3,-20,-4,8,1,3,8,1,10,11,5,3,2,2,7,5,4,0,6,-1,3,6,1,-14,-6,-8,27,18,9,7,5,-10,-14,6,-11,7,5,-11,-11,4,-2,0,0,1,-3,2,-9,2,4,9,4,5,3,1,4,6,2,3,2,1,0,3,2,2,1,-49,-16,-33,45,27,18,5,-4,-33,-7,11,-20,4,0,-15,-5,7,-6,1,-4,-18,-2,4,-14,11,9,12,6,6,1,6,6,7,3,3,2,5,3,5,3,3,-1,-157,-83,-74,-8,-4,-4,-16,-14,-60,-20,-16,-29,-10,-3,-32,-11,-10,-16,-6,-11,-28,-9,-6,-13,-2,0,-3,-1,-1,-1,0,0,-2,-1,0,-1,-2,0,-1,0,-1,0,-17,-8,-9,29,16,13,13,6,-31,27,-10,-23,2,2,-11,14,-7,-10,11,4,-20,13,-3,-13,5,6,7,8,4,-2,3,4,5,3,2,-2,2,2,2,5,2,0,-69,-30,-39,-6,-4,-2,-7,2,-15,-10,-9,-26,0,3,-9,-7,-3,-10,-7,-1,-6,-3,-6,-16,2,5,3,-4,-7,-5,1,3,1,-1,-5,-3,1,2,2,-3,-2,-2,-46,-28,-18,15,2,13,10,-3,-34,-8,7,-16,4,-6,-21,-1,4,-8,6,3,-13,-7,3,-8,1,2,-2,3,6,5,0,0,-3,1,3,1,1,2,1,2,3,4,-12,-3,-9,-3,-2,-1,2,-1,-5,-5,8,-10,0,0,0,-4,3,-2,2,-1,-5,-1,5,-8,-1,2,2,-3,0,-3,0,3,1,-4,0,-2,-1,-1,1,1,0,-1,-11,6,-17,6,11,-5,0,1,-18,10,9,-12,6,2,-8,11,6,-11,-6,-1,-10,-1,3,-1,5,1,-3,5,3,-5,5,1,-1,4,3,-1,0,0,-2,1,0,-4,-15,-6,-9,20,16,4,3,-12,-4,-3,6,-5,-1,-2,-1,0,3,-2,4,-10,-3,-3,3,-3,4,1,6,-1,9,0,2,1,5,1,6,1,2,0,1,-2,3,-1,-31,-12,-19,15,12,3,7,2,-25,1,2,-16,1,1,-11,-1,2,-3,6,1,-14,2,0,-13,4,3,3,7,-1,-1,1,3,4,5,-1,1,3,0,-1,2,0,-2,-32,-23,-9,15,8,7,-6,-5,-15,-13,11,0,-4,1,-8,-12,5,-2,-2,-6,-7,-1,6,2,1,0,3,-1,9,3,0,0,2,-1,4,3,1,0,1,0,5,0
15,15062,Outes,8739,-48,-32,-16,29,16,13,-2,-25,-26,-2,9,1,-2,-15,-16,-3,5,0,0,-10,-10,1,4,1,6,4,3,8,7,1,4,1,2,3,5,1,2,3,1,5,2,0,-66,-30,-36,12,6,6,-12,-23,-20,-11,-3,3,-3,-11,-8,-7,-3,2,-9,-12,-12,-4,0,1,1,1,2,2,4,2,1,0,2,1,0,2,0,1,0,1,4,0,-96,-66,-30,-15,-14,-1,-3,-22,-25,-29,-8,-7,-2,-19,-20,-13,-7,-4,-1,-3,-5,-16,-1,-3,3,-6,-11,-7,3,3,2,-6,-10,-2,0,2,1,0,-1,-5,3,1,-75,-30,-45,7,3,4,0,-32,-30,-9,-7,3,1,-16,-15,-4,0,2,-1,-16,-15,-5,-7,1,11,-10,4,1,0,1,5,-5,-1,2,1,1,6,-5,5,-1,-1,0,-88,-35,-53,35,24,11,-6,-19,-62,11,-2,-6,-7,-10,-23,8,-2,-2,1,-9,-39,3,0,-4,9,3,1,16,5,1,6,3,4,7,4,0,3,0,-3,9,1,1,-46,-32,-14,37,16,21,-7,-12,-29,-10,12,-3,-4,-6,-21,-12,9,0,-3,-6,-8,2,3,-3,6,3,7,5,15,0,2,0,2,3,9,0,4,3,5,2,6,0,-27,-11,-16,45,22,23,-14,-20,-30,7,14,8,-10,-8,-16,4,7,4,-4,-12,-14,3,7,4,8,2,1,13,11,6,2,1,0,3,8,4,6,1,1,10,3,2,-64,-14,-50,27,16,11,4,-19,-62,10,7,-5,10,-2,-35,3,8,1,-6,-17,-27,7,-1,-6,2,4,0,9,9,2,3,4,0,-1,7,2,-1,0,0,10,2,0,-30,-7,-23,-3,1,-4,-3,-6,-9,-5,2,-11,-6,-2,-3,5,1,-5,3,-4,-6,-10,1,-6,-5,0,2,-2,1,1,-2,0,0,1,1,1,-3,0,2,-3,0,0,-51,-25,-26,3,0,3,2,-3,-40,0,1,-10,3,-3,-19,-3,2,-5,-1,0,-21,3,-1,-5,5,1,-3,0,0,0,2,1,-3,0,1,-1,3,0,0,0,-1,1,-43,-29,-14,0,-8,8,1,-14,-10,-2,-2,-11,2,-8,-9,-4,-6,1,-1,-6,-1,2,4,-12,-2,-5,3,3,2,-1,-1,-5,1,1,-4,0,-1,0,2,2,6,-1,-24,-16,-8,8,2,6,4,10,-26,0,1,-17,2,8,-17,-5,4,-10,2,2,-9,5,-3,-7,8,1,-5,-1,6,-1,6,0,-5,-2,4,-1,2,1,0,1,2,0,-31,-14,-17,2,-4,6,-10,-7,-17,-10,16,-5,-10,-5,-4,-3,9,-1,0,-2,-13,-7,7,-4,0,-4,-5,1,10,-1,0,-2,-4,-1,6,-3,0,-2,-1,2,4,2,-87,-35,-52,-12,-4,-8,-5,-12,-23,-19,-8,-17,6,-6,-14,-10,-7,-5,-11,-6,-9,-9,-1,-12,-1,-3,-4,-1,-4,1,0,0,-1,-1,-4,2,-1,-3,-3,0,0,-1,-40,-22,-18,-1,-4,3,-9,-10,-6,-19,12,-4,-8,-3,-5,-8,3,-1,-1,-7,-1,-11,9,-3,-1,-1,-1,-2,3,2,-1,-1,-2,-2,1,1,0,0,1,0,2,1,-22,-7,-15,-3,-1,-2,-12,1,-18,-5,10,6,-11,0,-10,1,7,7,-1,1,-8,-6,3,-1,-2,1,-5,-3,2,4,-3,1,-4,1,2,2,1,0,-1,-4,0,2,-8,1,-9,5,5,0,4,-3,-26,4,19,-9,1,-5,-7,2,7,0,3,2,-19,2,12,-9,-1,0,-3,-2,10,1,0,1,0,-2,5,1,-1,-1,-3,0,5,0,-14,7,-21,-3,1,-4,-5,3,-19,7,16,-16,2,3,-8,10,5,-5,-7,0,-11,-3,11,-11,-3,-2,-6,3,9,-4,-1,-2,-2,2,4,0,-2,0,-4,1,5,-4
15,15064,Paderne,2755,41,12,29,8,3,5,6,1,4,16,7,7,1,2,-2,8,0,3,5,-1,6,8,7,4,1,0,0,2,3,2,0,0,0,1,1,1,1,0,0,1,2,1,18,15,3,10,6,4,7,-7,6,7,3,1,5,0,2,7,1,0,2,-7,4,0,2,1,2,2,1,3,2,0,2,1,0,2,1,0,0,1,1,1,1,0,3,12,-9,5,4,1,-1,5,-1,4,1,-4,0,6,3,4,2,-2,-1,-1,-4,0,-1,-2,0,1,1,2,1,0,0,1,1,1,1,0,0,0,0,1,0,0,47,34,13,24,12,12,3,3,15,12,2,11,3,2,13,7,3,5,0,1,2,5,-1,6,5,2,6,2,4,5,3,0,3,1,3,2,2,2,3,1,1,3,53,27,26,12,4,8,14,1,19,3,15,0,9,-1,7,1,8,2,5,2,12,2,7,-2,2,0,2,1,3,4,0,0,0,1,1,2,2,0,2,0,2,2,53,34,19,5,4,1,8,8,6,14,11,8,5,5,7,11,7,0,3,3,-1,3,4,8,0,1,-1,0,4,1,0,1,0,0,2,1,0,0,-1,0,2,0,14,9,5,4,2,2,3,0,14,-1,3,-6,0,2,5,-1,1,1,3,-2,9,0,2,-7,0,0,-1,1,4,0,0,0,-1,1,2,0,0,0,0,0,2,0,45,22,23,7,4,3,8,9,8,9,4,7,9,1,3,6,1,2,-1,8,5,3,3,5,1,1,1,0,3,1,1,0,1,0,1,1,0,1,0,0,2,0,-22,-9,-13,5,4,1,4,-2,-19,6,-2,-9,1,0,-7,4,-4,-3,3,-2,-12,2,2,-6,0,1,2,1,1,0,0,1,2,1,0,0,0,0,0,0,1,0,-1,7,-8,1,1,0,6,-2,-4,5,2,-8,0,-3,-1,9,3,0,6,1,-3,-4,-1,-8,0,0,0,1,1,-1,0,0,0,0,1,0,0,0,0,1,0,-1,11,4,7,7,5,2,1,0,0,3,4,3,1,-1,-4,3,3,2,0,1,4,0,1,1,2,0,1,2,1,1,1,0,1,1,1,1,1,0,0,1,0,0,4,16,-12,-2,-1,-1,-4,7,-8,9,5,-3,1,6,1,4,7,-1,-5,1,-9,5,-2,-2,-1,1,0,-1,1,-2,-1,1,0,-1,1,-1,0,0,0,0,0,-1,-18,-14,-4,1,0,1,-8,2,-3,-12,0,1,-9,-1,5,-8,-2,1,1,3,-8,-4,2,0,2,0,-1,-2,-1,3,1,0,0,-2,-1,2,1,0,-1,0,0,1,-1,-8,7,3,0,3,2,0,-4,3,-1,-2,0,-1,-3,0,-1,-3,2,1,-1,3,0,1,1,0,0,-1,2,1,0,0,0,-1,1,0,1,0,0,0,1,1,-1,-5,4,-2,-1,-1,7,-4,11,-4,-3,-4,4,-2,3,-3,-3,-2,3,-2,8,-1,0,-2,0,0,0,0,-1,-1,0,0,0,0,-1,0,0,0,0,0,0,-1,2,9,-7,-4,0,-4,2,-9,-9,14,-1,6,1,-1,-5,7,0,7,1,-8,-4,7,-1,-1,-1,-1,1,-1,-1,-1,0,0,0,0,0,0,-1,-1,1,-1,-1,-1,-8,-2,-6,-1,-3,2,-7,-1,-3,-1,7,-1,-2,-2,1,-2,4,-1,-5,1,-4,1,3,0,-1,1,0,-2,0,0,-1,0,0,-2,-1,0,0,1,0,0,1,0,10,3,7,1,-1,2,3,-1,-3,-2,10,5,1,-3,1,-4,5,3,2,2,-4,2,5,2,0,0,-1,0,1,1,0,0,-1,0,0,0,0,0,0,0,1,1
15,15065,Padrón,9548,72,52,20,44,27,17,19,11,19,6,11,3,17,6,10,7,8,3,2,5,9,-1,3,0,7,3,12,10,9,2,5,2,5,7,5,2,2,1,7,3,4,0,10,-18,28,30,18,12,5,-9,1,13,-5,3,-3,-14,-2,4,-4,0,8,5,3,9,-1,3,7,4,5,9,3,2,4,1,3,7,1,2,3,3,2,2,2,0,1,-4,5,41,26,15,0,17,-26,-3,2,8,-5,12,-17,3,1,3,5,5,-9,-6,1,5,9,12,2,8,5,5,5,7,4,6,3,1,4,5,-2,2,2,4,26,2,24,42,21,21,-18,1,4,15,17,7,-9,-6,4,4,7,3,-9,7,0,11,10,4,0,5,8,5,16,8,0,2,3,3,9,4,0,3,5,2,7,4,10,10,0,47,25,22,11,3,0,-10,-7,10,0,0,4,-4,-1,10,11,3,-4,-6,-6,0,11,3,11,12,7,1,3,1,7,6,5,2,8,2,4,6,2,-1,60,33,27,45,18,27,10,18,18,-5,8,11,3,14,3,0,5,6,7,4,15,-5,3,5,5,13,16,4,2,5,2,4,8,3,0,1,3,9,8,1,2,4,51,53,-2,54,31,23,23,2,23,5,11,-12,19,1,26,7,6,-6,4,1,-3,-2,5,-6,9,8,17,11,5,3,7,1,13,8,1,1,2,7,4,3,4,2,5,10,-5,56,37,19,-12,1,19,14,2,-6,-9,5,16,12,-4,-4,-3,-4,3,2,6,-2,6,11,23,8,5,2,4,8,14,5,3,2,2,3,9,3,2,0,-7,-10,3,24,8,16,2,-14,-19,11,8,0,3,-7,-19,7,7,-4,-1,-7,0,4,1,4,5,4,10,6,0,-1,2,1,5,2,0,-2,3,3,5,4,0,1,37,6,31,25,7,18,4,15,-2,10,9,-3,-4,10,2,0,2,-5,8,5,-4,10,7,2,4,7,9,3,3,-1,0,1,5,1,2,-2,4,6,4,2,1,1,-28,-29,1,12,4,8,11,-5,-8,-37,1,8,12,-5,-21,-21,-1,7,-1,0,13,-16,2,1,3,6,5,-1,-3,2,1,3,2,-1,-2,1,2,3,3,0,-1,1,-40,-9,-31,25,14,11,7,-10,-24,1,-3,-11,0,-1,-14,9,-4,0,7,-9,-10,-8,1,-11,5,8,1,4,3,4,2,3,2,2,2,3,3,5,-1,2,1,1,-49,-12,-37,7,8,-1,-14,4,-20,-16,6,-12,2,2,-8,-16,12,-5,-16,2,-12,0,-6,-7,2,2,-1,-2,5,1,3,2,0,-1,3,1,-1,0,-1,-1,2,0,-1,7,-8,12,3,9,10,14,-20,-3,-4,1,9,5,-9,4,-2,1,1,9,-11,-7,-2,0,4,2,5,1,0,-1,1,0,1,1,1,-1,3,2,4,0,-1,0,-51,-6,-45,6,5,1,-11,-2,-33,1,4,-9,8,4,-17,3,1,-5,-19,-6,-16,-2,3,-4,3,3,-3,1,5,-3,2,2,0,0,3,-2,1,1,-3,1,2,-1,-46,-45,-1,5,-2,7,-12,0,-23,6,-5,-5,-15,-2,-21,3,-2,-4,3,2,-2,3,-3,-1,2,5,4,-2,-2,-2,0,2,-1,0,-2,-1,2,3,5,-2,0,-1,-88,-53,-35,8,0,8,-7,-17,-33,-22,-5,-12,2,-13,-25,-13,-7,-3,-9,-4,-8,-9,2,-9,0,1,-3,4,6,0,-2,0,-3,2,4,-1,2,1,0,2,2,1,-32,-15,-17,10,7,3,-12,0,2,-8,-6,-7,-11,2,9,-7,-6,-2,-1,-2,-7,-1,0,-5,3,7,0,2,-1,-1,1,5,1,1,0,-1,2,2,-1,1,-1,0
15,15066,"Pino, O",4990,51,24,27,11,5,6,13,0,5,17,14,1,10,-4,4,11,4,-1,3,4,1,6,10,2,1,1,1,2,5,1,0,0,0,1,3,1,1,1,1,1,2,0,99,58,41,8,4,4,13,17,5,14,40,10,7,12,6,5,20,8,6,5,-1,9,20,2,2,2,1,0,2,1,1,1,0,0,2,0,1,1,1,0,0,1,-33,-24,-9,2,1,1,-5,-10,-13,-11,9,-3,-5,-6,-11,-3,4,-3,0,-4,-2,-8,5,0,0,-1,2,0,2,-1,0,0,0,0,2,-1,0,-1,2,0,0,0,14,0,14,3,0,3,4,6,2,5,-3,1,1,2,-4,5,-6,2,3,4,6,0,3,-1,1,-1,1,2,-2,2,0,0,0,1,-3,2,1,-1,1,1,1,0,-8,1,-9,-3,-1,-2,1,-1,-19,9,5,3,2,-2,-9,7,3,2,-1,1,-10,2,2,1,-1,1,-2,0,1,0,-1,0,0,-1,2,0,0,1,-2,1,-1,0,23,8,15,-2,0,-2,11,6,0,5,6,-3,6,5,-9,3,8,-3,5,1,9,2,-2,0,3,0,-1,0,-4,0,2,0,0,-1,-1,0,1,0,-1,1,-3,0,-8,-9,1,7,4,3,7,-9,-4,-7,3,0,4,-9,-1,-4,3,-2,3,0,-3,-3,0,2,4,1,1,1,1,-1,3,0,0,0,1,0,1,1,1,1,0,-1,3,-10,13,-3,-2,-1,4,1,1,0,1,-7,0,-2,-1,-3,0,-5,4,3,2,3,1,-2,-1,-1,1,-2,0,0,-1,-1,1,-1,0,0,0,0,0,-1,0,0,-35,-7,-28,3,2,1,-12,-5,-9,-2,3,-9,-4,-2,0,0,3,-4,-8,-3,-9,-2,0,-5,0,0,0,0,3,0,0,0,0,0,2,0,0,0,0,0,1,0,61,39,22,7,1,6,11,6,24,14,5,2,5,8,13,8,4,1,6,-2,11,6,1,1,0,2,3,-1,2,1,0,0,1,-1,1,0,0,2,2,0,1,1,86,50,36,5,4,1,13,1,37,9,22,2,5,2,27,0,12,1,8,-1,10,9,10,1,0,-1,3,-1,4,0,0,0,3,-2,2,1,0,-1,0,1,2,-1,67,37,30,2,2,0,11,-1,29,24,2,-4,1,-4,22,13,1,0,10,3,7,11,1,-4,0,0,1,1,0,0,0,0,1,1,0,0,0,0,0,0,0,0,12,-1,13,7,1,6,-4,3,3,3,13,-4,-3,-1,2,-2,7,-3,-1,4,1,5,6,-1,0,3,0,0,2,2,0,1,0,0,0,0,0,2,0,0,2,2,-2,-7,5,2,0,2,-9,3,-1,-1,0,5,-10,-1,2,2,0,1,1,4,-3,-3,0,4,1,0,0,1,-1,1,1,0,-1,1,-1,0,0,0,1,0,0,1,45,26,19,3,2,1,11,12,-8,25,4,-2,3,6,-3,13,2,4,8,6,-5,12,2,-6,1,1,0,-2,1,2,1,0,0,-1,1,1,0,1,0,-1,0,1,-23,-7,-16,7,5,2,-7,-4,-1,-12,4,-5,-4,-2,3,-1,1,-6,-3,-2,-4,-11,3,1,3,0,3,-1,2,0,1,0,2,1,1,0,2,0,1,-2,1,0,16,12,4,-3,-5,2,1,0,10,-6,5,5,-1,4,1,-1,6,3,2,-4,9,-5,-1,2,-1,1,-2,-4,0,3,0,1,-2,-4,-1,1,-1,0,0,0,1,2,45,26,19,9,4,5,8,6,7,10,10,4,7,3,2,3,7,4,1,3,5,7,3,0,2,1,0,2,0,4,1,0,-1,2,-1,3,1,1,1,0,1,1
15,15067,"Pobra do Caramiñal, A",10066,14,7,7,8,2,6,-2,-5,5,-1,13,2,-4,0,3,-1,7,0,2,-5,2,0,6,2,1,3,1,1,2,0,1,0,0,1,0,0,0,3,1,0,2,0,1,-3,4,22,8,14,2,-12,-12,2,10,11,-1,-9,-4,0,6,6,3,-3,-8,2,4,5,6,3,4,3,3,3,3,1,0,1,1,2,3,2,4,2,2,1,28,12,16,-22,-9,-13,6,16,-8,11,-5,7,8,6,-2,3,-4,0,-2,10,-6,8,-1,7,3,1,-7,-9,-10,0,2,0,-1,-6,-5,1,1,1,-6,-3,-5,-1,-44,-20,-24,-20,-10,-10,1,-10,-16,-14,-3,-4,0,3,-9,-12,-2,-1,1,-13,-7,-2,-1,-3,0,1,-5,-6,-6,-4,0,3,-5,-3,-4,-1,0,-2,0,-3,-2,-3,-12,-7,-5,14,1,13,-7,-11,12,-13,3,6,-3,-10,9,-11,3,5,-4,-1,3,-2,0,1,0,3,5,-1,6,1,0,-2,1,-3,4,1,0,5,4,2,2,0,39,34,5,6,6,0,16,13,-13,6,2,13,11,15,-5,10,1,3,5,-2,-8,-4,1,10,9,7,-3,-2,-5,0,4,5,0,0,-3,0,5,2,-3,-2,-2,0,-22,-16,-6,15,4,11,4,-23,-17,8,5,0,-1,-13,-9,6,0,0,5,-10,-8,2,5,0,6,0,7,3,-1,0,2,-2,3,2,-1,0,4,2,4,1,0,0,-10,1,-11,18,14,4,-1,6,-14,14,-15,-2,0,2,-6,10,-8,2,-1,4,-8,4,-7,-4,4,6,1,8,-3,2,2,4,4,3,0,1,2,2,-3,5,-3,1,-37,3,-40,-3,-6,3,-4,-8,-8,2,-8,-10,-1,2,6,2,-4,-2,-3,-10,-14,0,-4,-8,0,3,-2,2,-5,-1,0,1,-4,1,-3,-1,0,2,2,1,-2,0,-27,-28,1,9,3,6,1,-1,-18,-1,-9,3,-3,-4,-3,-13,1,-1,4,3,-15,12,-10,4,1,4,1,1,-1,2,0,1,0,0,0,1,1,3,1,1,-1,1,-94,-43,-51,-2,0,-2,-5,-15,-49,-15,-1,-11,-9,-9,-26,-6,2,2,4,-6,-23,-9,-3,-13,0,0,-1,-4,1,1,0,-1,0,-2,0,2,0,1,-1,-2,1,-1,-79,-46,-33,-10,-11,1,-1,-11,-34,-11,-9,-12,0,-8,-25,-7,-7,0,-1,-3,-9,-4,-2,-12,3,3,-10,-4,0,-2,0,1,-8,-3,-1,0,3,2,-2,-1,1,-2,10,27,-17,9,7,2,-12,-7,6,-3,14,7,-2,7,12,-1,9,-1,-10,-14,-6,-2,5,8,-1,-1,2,0,6,2,0,1,0,-1,6,0,-1,-2,2,1,0,2,48,38,10,1,4,-3,11,2,9,-8,16,16,11,2,5,-6,10,14,0,0,4,-2,6,2,2,-1,-3,4,0,-1,3,0,-3,5,0,-1,-1,-1,0,-1,0,0,-7,-18,11,-11,-8,-3,-3,4,-9,1,-1,6,-4,-2,-6,-5,-5,8,1,6,-3,6,4,-2,-2,-2,-4,-1,2,-4,0,-2,-2,-2,1,-3,-2,0,-2,1,1,-1,-48,-26,-22,16,3,13,1,-4,-37,-5,4,-6,7,-1,-16,-12,2,-5,-6,-3,-21,7,2,-1,0,3,-1,0,5,9,0,1,-3,-1,2,4,0,2,2,1,3,5,-26,-8,-18,6,4,2,-12,-11,-12,-3,3,9,-6,0,-6,-1,-1,4,-6,-11,-6,-2,4,5,3,0,0,-1,0,4,2,0,0,0,0,2,1,0,0,-1,0,2,11,-7,18,9,8,1,14,0,-17,5,-4,10,4,-4,-11,-1,-3,6,10,4,-6,6,-1,4,2,1,2,-4,2,6,1,0,2,-1,3,3,1,1,0,-3,-1,3
15,15068,Ponteceso,7370,-4,-19,15,26,13,13,0,-4,-15,8,3,5,-4,-7,-16,5,2,2,4,3,1,3,1,3,6,3,4,5,5,3,1,3,0,4,4,1,5,0,4,1,1,2,-34,-11,-23,20,8,12,1,-12,-14,-7,1,-4,2,2,-12,-5,-1,2,-1,-14,-2,-2,2,-6,6,3,4,3,1,2,2,2,1,2,0,0,4,1,3,1,1,2,-81,-49,-32,26,16,10,-5,-12,-45,-16,-2,-2,-2,-8,-26,-13,1,-2,-3,-4,-19,-3,-3,0,2,3,3,9,3,6,1,0,3,7,2,3,1,3,0,2,1,3,-34,-15,-19,31,16,15,6,-16,-25,4,-1,3,1,-10,-10,4,-1,3,5,-6,-15,0,0,0,3,3,4,12,6,3,1,1,2,7,3,2,2,2,2,5,3,1,-50,-22,-28,26,14,12,2,-8,-27,-11,2,-9,3,-4,-14,-6,0,-2,-1,-4,-13,-5,2,-7,4,1,5,3,10,2,1,0,2,1,6,3,3,1,3,2,4,-1,-35,-7,-28,15,9,6,-5,-10,-29,-11,21,-2,-4,4,-13,-9,14,0,-1,-14,-16,-2,7,-2,4,1,1,3,6,0,3,1,1,0,4,0,1,0,0,3,2,0,-18,4,-22,23,15,8,6,-7,-20,-4,5,-1,6,-6,-6,-1,8,2,0,-1,-14,-3,-3,-3,2,1,1,9,7,1,1,2,0,5,5,1,1,-1,1,4,2,0,-61,-34,-27,48,24,24,-10,-20,-31,-15,11,3,-8,-10,-18,-6,5,4,-2,-10,-13,-9,6,-1,5,10,14,10,6,1,2,5,7,6,3,1,3,5,7,4,3,0,-25,-13,-12,11,9,2,4,-4,-27,6,5,-11,6,-8,-20,8,5,-6,-2,4,-7,-2,0,-5,4,7,3,-2,-1,-1,4,5,2,-1,-2,0,0,2,1,-1,1,-1,-17,-11,-6,1,-1,2,9,-3,-21,6,5,-11,7,-1,-15,0,2,-3,2,-2,-6,6,3,-8,0,0,3,-2,2,-2,0,0,0,-2,2,-1,0,0,3,0,0,-1,-29,-13,-16,-7,-4,-3,-1,-4,-10,-9,-3,-5,-2,-1,-1,-6,-2,-3,1,-3,-9,-3,-1,-2,1,0,-2,-6,0,0,2,0,-1,-4,0,-1,-1,0,-1,-2,0,1,-20,12,-32,11,8,3,-2,-7,-12,0,6,-1,-2,3,-1,3,5,6,0,-10,-11,-3,1,-7,4,2,-1,1,5,0,4,2,0,0,3,-1,0,0,-1,1,2,1,-10,-9,-1,-6,-7,1,14,14,-22,-7,3,-10,-1,8,-11,-5,3,-3,15,6,-11,-2,0,-7,4,-1,-4,-6,3,-2,0,-1,-3,-4,1,0,4,0,-1,-2,2,-2,-6,-6,0,-16,-10,-6,0,-5,-9,-7,15,-2,-1,0,-3,-8,6,-1,1,-5,-6,1,9,-1,-3,-1,-7,-5,1,-1,-2,0,-3,-5,1,-1,-1,-1,-4,0,0,0,-25,-11,-14,-5,-5,0,-6,-4,-7,-6,4,-3,-3,-7,0,-5,3,2,-3,3,-7,-1,1,-5,-2,-3,0,-3,2,1,-2,-3,0,-1,1,0,0,0,0,-2,1,1,-35,-27,-8,-3,-1,-2,1,-13,-28,-2,6,1,-2,-10,-19,-2,2,3,3,-3,-9,0,4,-2,-1,3,-6,-1,2,0,0,1,-3,-1,1,1,-1,2,-3,0,1,-1,-42,-11,-31,0,3,-3,0,-12,-17,0,3,-17,1,-3,-15,9,1,-6,-1,-9,-2,-9,2,-11,0,-2,-1,2,4,-3,0,0,-2,3,3,-1,0,-2,1,-1,1,-2,10,15,-5,2,2,0,12,1,6,4,5,-20,6,2,6,3,3,-6,6,-1,0,1,2,-14,1,-1,-2,2,1,0,0,0,0,0,2,0,1,-1,-2,2,-1,0
15,15069,Pontedeume,8857,-4,-24,20,78,23,55,-6,-12,-14,6,7,15,-9,-2,-11,1,-3,1,3,-10,-3,5,10,14,17,11,25,15,8,1,6,1,8,5,3,0,11,10,17,10,5,1,-18,-9,-9,44,19,25,0,-22,-24,2,19,8,1,-11,-12,1,14,1,-1,-11,-12,1,5,7,7,4,19,8,4,1,3,1,7,5,3,0,4,3,12,3,1,1,-46,-30,-16,36,18,18,8,-18,-37,-19,4,16,2,-7,-12,-15,2,0,6,-11,-25,-4,2,16,13,4,9,1,6,3,7,3,5,0,2,1,6,1,4,1,4,2,-31,-24,-7,17,11,6,-16,-10,-10,3,-9,12,-9,-1,-6,-2,-6,1,-7,-9,-4,5,-3,11,3,2,3,6,2,1,3,1,1,5,1,0,0,1,2,1,1,1,4,5,-1,29,15,14,-12,-10,2,-14,18,16,-3,-8,10,-7,6,7,-9,-2,-8,-7,12,9,3,5,9,-1,6,6,3,2,5,-2,4,3,0,3,4,1,2,3,18,12,6,45,25,20,3,11,-12,-4,18,2,-1,10,-4,-2,8,-1,4,1,-8,-2,10,3,11,5,9,5,12,2,4,4,7,2,5,2,7,1,2,3,7,0,60,42,18,46,31,15,22,-2,-1,23,13,0,14,3,-2,14,12,0,8,-5,1,9,1,0,9,5,9,15,8,-1,4,3,6,11,6,0,5,2,3,4,2,-1,-31,-3,-28,53,33,20,-7,2,-3,1,-16,-2,2,6,-2,3,-7,-3,-9,-4,-1,-2,-9,1,12,8,22,9,1,1,11,4,10,7,0,1,1,4,12,2,1,0,-80,-35,-45,29,17,12,-6,-16,-38,-12,3,-9,0,-6,-22,-4,-1,-2,-6,-10,-16,-8,4,-7,3,7,5,7,7,0,0,5,5,4,3,0,3,2,0,3,4,0,-30,-37,7,8,3,5,-1,3,-29,-23,1,10,-1,-7,-25,-13,4,0,0,10,-4,-10,-3,10,6,3,2,-4,0,1,4,2,0,-3,0,0,2,1,2,-1,0,1,-58,-26,-32,18,10,8,2,-4,-38,4,-17,-2,1,4,-12,-1,-14,-2,1,-8,-26,5,-3,0,2,3,4,6,4,0,0,2,2,4,2,0,2,1,2,2,2,0,11,-9,20,12,4,8,4,11,-18,-1,8,9,5,3,-21,1,3,1,-1,8,3,-2,5,8,0,3,1,4,2,2,0,1,0,0,2,1,0,2,1,4,0,1,10,12,-2,22,14,8,-8,5,-8,-4,2,22,-2,3,7,-4,4,6,-6,2,-15,0,-2,16,6,0,1,3,4,7,4,-1,1,3,2,5,2,1,0,0,2,2,-61,-47,-14,-2,-1,-1,0,-20,-28,-8,-2,-3,-2,-9,-20,-10,-4,-4,2,-11,-8,2,2,1,0,-2,0,-1,0,1,2,0,0,-2,-1,0,-2,-2,0,1,1,1,-38,-21,-17,7,2,5,9,-21,-28,-13,-1,15,-3,-9,-6,-1,-1,-2,12,-12,-22,-12,0,17,2,1,2,0,-1,2,0,1,2,-1,-1,1,2,0,0,1,0,1,-44,-30,-14,-1,-2,1,11,-4,-40,-8,-9,4,2,-2,-19,-7,-5,1,9,-2,-21,-1,-4,3,2,2,-7,2,0,0,-1,2,-2,-1,1,-1,3,0,-5,3,-1,1,-57,-39,-18,12,2,10,3,-5,-32,-20,-3,-2,2,-5,-15,-17,-6,0,1,0,-17,-3,3,-2,10,3,-5,1,0,3,4,2,-1,-4,0,1,6,1,-4,5,0,2,-6,-11,5,18,4,14,6,-3,-23,-1,1,18,4,-5,-5,-3,-2,4,2,2,-18,2,3,14,3,0,3,5,4,4,1,-2,0,2,1,2,2,2,3,3,3,2
15,15070,"Pontes de García Rodríguez, As",12457,18,7,11,12,4,8,6,51,-8,-19,-17,3,6,16,-4,-8,-5,1,0,35,-4,-11,-12,2,2,5,2,2,1,0,1,0,1,1,1,0,1,5,1,1,0,0,-7,3,-10,37,12,25,-6,47,-19,-17,-14,1,-5,44,-16,-10,-13,3,-1,3,-3,-7,-1,-2,7,9,10,6,3,2,4,1,2,2,1,2,3,8,8,4,2,0,-161,-99,-62,10,3,7,-3,-27,-61,-20,-37,-10,1,-23,-43,-9,-19,-4,-4,-4,-18,-11,-18,-6,5,5,-2,0,2,0,2,1,-1,0,1,0,3,4,-1,0,1,0,-154,-78,-76,17,7,10,-4,-23,-53,-38,-30,-5,-3,-15,-30,-15,-14,0,-1,-8,-23,-23,-16,-5,2,4,7,4,0,0,0,0,5,2,0,0,2,4,2,2,0,0,-120,-53,-67,32,12,20,-13,-3,-60,-24,-18,-2,-9,13,-33,-10,-11,-2,-4,-16,-27,-14,-7,0,4,13,6,7,1,1,3,4,2,2,1,0,1,9,4,5,0,1,-27,-21,-6,40,14,26,-1,11,-40,2,-7,3,2,-7,-28,4,2,2,-3,18,-12,-2,-9,1,1,16,13,5,5,0,0,5,4,2,3,0,1,11,9,3,2,0,-95,-71,-24,27,10,17,-6,15,-56,-21,-36,8,-7,3,-38,-7,-27,3,1,12,-18,-14,-9,5,5,8,4,4,4,1,4,1,-1,2,4,0,1,7,5,2,0,1,-108,-44,-64,58,30,28,8,-2,-54,-25,-33,-3,2,0,-21,-3,-20,-2,6,-2,-33,-22,-13,-1,16,9,21,10,2,0,7,4,11,8,0,0,9,5,10,2,2,0,43,20,23,86,43,43,17,35,-7,1,-10,3,12,9,4,-2,-5,2,5,26,-11,3,-5,1,13,23,27,12,9,2,6,11,14,6,5,1,7,12,13,6,4,1,-30,-16,-14,28,14,14,26,-2,-38,-12,-19,13,13,10,-30,-1,-17,7,13,-12,-8,-11,-2,6,9,13,-1,5,2,0,6,7,-3,3,1,0,3,6,2,2,1,0,-123,-72,-51,25,7,18,-2,-2,-80,-20,-20,-1,-1,-4,-36,-20,-12,-1,-1,2,-44,0,-8,0,8,7,4,5,1,0,2,3,0,2,0,0,6,4,4,3,1,0,-65,-26,-39,9,10,-1,13,-4,-48,-14,-12,-3,10,-1,-27,-5,-9,6,3,-3,-21,-9,-3,-9,3,5,-3,2,0,2,3,3,-1,2,1,2,0,2,-2,0,-1,0,-137,-89,-48,8,3,5,-4,-13,-79,-15,-16,-11,-4,-7,-51,-13,-9,-6,0,-6,-28,-2,-7,-5,3,2,0,-2,4,1,1,0,0,0,2,0,2,2,0,-2,2,1,-136,-69,-67,0,-4,4,-4,-8,-62,-30,-25,-7,-2,0,-29,-18,-15,-5,-2,-8,-33,-12,-10,-2,3,1,-1,-2,-1,0,1,-1,-3,-1,0,0,2,2,2,-1,-1,0,-98,-56,-42,-5,-5,0,2,-12,-57,-17,-8,-5,5,-8,-37,-9,-4,-1,-3,-4,-20,-8,-4,-4,2,0,-7,-1,1,0,1,2,-6,-1,0,-1,1,-2,-1,0,1,1,-148,-74,-74,-37,-17,-20,1,-9,-80,-17,-20,-20,1,-10,-37,-6,-7,-13,0,1,-43,-11,-13,-7,0,2,-23,-9,-5,-3,-2,1,-9,-4,-2,-1,2,1,-14,-5,-3,-2,-54,-33,-21,21,8,13,-2,1,-21,-7,-20,-6,-1,3,-15,-7,-9,-3,-1,-2,-6,0,-11,-3,10,6,1,1,4,-1,6,3,-1,0,1,-1,4,3,2,1,3,0,-49,-47,-2,16,1,15,0,-3,-19,-12,-11,-5,1,-4,-26,-7,-5,-7,-1,1,7,-5,-6,2,5,8,-1,2,-1,3,2,3,-6,2,-1,1,3,5,5,0,0,2
15,15071,Porto do Son,10376,-96,-36,-60,21,10,11,-10,-67,-31,8,9,-1,1,-31,-16,4,4,4,-11,-36,-15,4,5,-5,5,2,4,6,4,0,3,0,1,4,2,0,2,2,3,2,2,0,-95,-47,-48,29,20,9,-12,-34,-40,-11,-1,3,-1,-21,-25,-4,5,-1,-11,-13,-15,-7,-6,4,9,4,3,7,5,0,7,1,2,4,5,0,2,3,1,3,0,0,-27,-3,-24,-11,-7,-4,8,-16,-6,-2,-7,2,8,-7,-1,4,-6,0,0,-9,-5,-6,-1,2,1,-4,3,-6,-6,1,0,-2,1,-3,-3,0,1,-2,2,-3,-3,1,-130,-66,-64,-45,-24,-21,-19,-27,-59,-16,-1,-5,-9,-6,-29,-15,-5,-1,-10,-21,-30,-1,4,-4,-1,-12,-11,-8,-8,-5,-1,-8,-6,-6,-2,-1,0,-4,-5,-2,-6,-4,-64,-54,-10,-8,-3,-5,-24,-16,-18,-4,-4,0,-14,-12,-20,-2,-4,-2,-10,-4,2,-2,0,2,1,-2,-2,1,-5,-2,0,-1,-1,2,-2,-1,1,-1,-1,-1,-3,-1,41,25,16,-18,-11,-7,4,2,-6,24,15,4,9,1,-7,17,8,-2,-5,1,1,7,7,6,2,2,-5,-7,-5,-5,1,1,-2,-7,-2,-2,1,1,-3,0,-3,-3,-102,-53,-49,-11,-13,2,-16,-24,-46,-8,-7,1,-13,-19,-15,-6,-8,8,-3,-5,-31,-2,1,-7,1,-2,-3,-6,-3,3,0,-1,-4,-6,-4,2,1,-1,1,0,1,1,-60,-16,-44,12,11,1,-15,-14,-20,-15,6,-6,-7,-9,-3,-6,5,2,-8,-5,-17,-9,1,-8,-1,4,9,-1,2,-1,-1,2,9,2,-2,1,0,2,0,-3,4,-2,62,63,-1,43,27,16,17,-5,14,33,9,0,13,2,19,23,6,1,4,-7,-5,10,3,-1,10,4,14,10,1,4,7,3,7,7,1,2,3,1,7,3,0,2,56,32,24,-20,-14,-6,30,10,-10,13,14,3,19,3,-6,10,9,0,11,7,-4,3,5,3,-2,0,-10,-4,-3,0,-3,-1,-7,-3,-1,1,1,1,-3,-1,-2,-1,-13,-8,-5,-9,-5,-4,2,1,-25,6,4,2,2,2,-8,-8,6,0,0,-1,-17,14,-2,2,4,-3,-2,-6,-6,2,2,1,-4,-5,-2,1,2,-4,2,-1,-4,1,-72,-22,-50,-16,-3,-13,-13,-22,-4,-4,-3,-20,0,-12,-3,2,1,-7,-13,-10,-1,-6,-4,-13,-4,-3,0,-2,-5,-2,-1,-2,0,3,-4,1,-3,-1,0,-5,-1,-3,-13,-16,3,-5,-5,0,-2,-2,1,1,-1,-8,-8,-3,2,-4,2,-5,6,1,-1,5,-3,-3,0,2,3,0,-3,-7,-3,0,2,0,0,-4,3,2,1,0,-3,-3,18,-2,20,-12,-14,2,11,10,-25,8,6,5,-1,8,-19,7,-3,3,12,2,-6,1,9,2,-4,-1,-6,-7,4,2,-3,-1,-3,-7,-1,1,-1,0,-3,0,5,1,-59,-34,-25,-8,-8,0,-13,2,-44,-9,1,2,0,4,-24,-13,2,-2,-13,-2,-20,4,-1,4,-1,0,-7,-5,2,3,-1,1,-6,-2,-1,1,0,-1,-1,-3,3,2,19,2,17,1,-6,7,12,-13,-3,10,16,-3,4,-9,0,-2,11,-1,8,-4,-3,12,5,-2,1,-1,-7,0,6,2,-1,-3,-4,-2,4,0,2,2,-3,2,2,2,-30,-19,-11,25,15,10,-5,-9,-22,-7,9,5,-5,-11,-7,-8,8,6,0,2,-15,1,1,-1,4,1,3,4,3,10,1,0,0,3,3,8,3,1,3,1,0,2,7,2,5,19,10,9,-2,9,0,-15,10,6,-2,5,0,-12,5,6,0,4,0,-3,5,0,0,6,1,3,8,1,0,3,-1,3,4,1,0,3,2,0,4,0
15,15072,Rianxo,12147,-113,-49,-64,40,20,20,-27,-33,-56,-9,11,7,-11,-11,-28,-6,1,8,-16,-22,-28,-3,10,-1,6,0,9,6,11,8,2,0,4,4,4,6,4,0,5,2,7,2,-8,-17,9,17,6,11,-6,-14,-1,7,-1,7,-7,-16,-3,9,-3,3,1,2,2,-2,2,4,5,1,4,1,1,4,3,0,1,0,0,1,2,1,3,1,1,3,-54,-28,-26,38,9,29,-17,-13,-38,-7,21,0,-10,-6,-15,-9,11,1,-7,-7,-23,2,10,-1,7,7,1,8,10,5,3,1,-2,1,3,3,4,6,3,7,7,2,32,21,11,36,16,20,4,2,-2,9,12,10,10,0,-5,5,4,7,-6,2,3,4,8,3,4,5,4,8,8,5,1,2,3,3,3,3,3,3,1,5,5,2,-4,3,-7,35,11,24,7,0,-21,5,16,-9,7,-3,-10,5,8,-5,0,3,-11,0,8,-4,5,3,6,5,13,3,1,1,2,2,5,0,4,2,4,3,8,3,-194,-110,-84,-12,-1,-11,-28,-34,-76,-23,-15,-17,-19,-21,-41,-13,-8,-8,-9,-13,-35,-10,-7,-9,-3,-1,0,0,-3,-5,-1,-1,2,2,-1,-2,-2,0,-2,-2,-2,-3,32,28,4,41,26,15,3,5,-8,14,17,2,8,6,-6,8,10,2,-5,-1,-2,6,7,0,2,8,11,7,11,1,0,6,6,3,9,1,2,2,5,4,2,0,79,37,42,68,47,21,22,14,8,21,14,1,3,17,2,9,6,0,19,-3,6,12,8,1,10,20,17,10,6,4,5,17,12,8,3,1,5,3,5,2,3,3,21,10,11,46,23,23,7,-3,0,7,13,-3,-2,-3,1,3,6,6,9,0,-1,4,7,-9,10,2,5,9,15,3,6,-1,4,2,9,2,4,3,1,7,6,1,60,52,8,18,11,7,16,4,-6,15,26,0,8,1,8,15,19,-2,8,3,-14,0,7,2,7,0,-3,-2,15,0,4,1,-4,1,9,-1,3,-1,1,-3,6,1,-15,-14,-1,29,11,18,9,11,-39,8,1,-5,7,12,-30,-2,-1,-1,2,-1,-9,10,2,-4,4,5,7,4,4,5,4,1,1,0,2,3,0,4,6,4,2,2,-12,-13,1,15,4,11,-7,6,-14,2,20,-16,-7,7,-13,-3,10,-6,0,-1,-1,5,10,-10,-3,5,1,-1,9,4,0,1,0,-3,4,2,-3,4,1,2,5,2,-4,-1,-3,-1,-3,2,0,-4,0,-2,20,-13,-5,-9,12,2,15,-10,5,5,-12,-4,5,-3,0,0,-2,-3,8,-4,0,-2,-1,-2,5,-3,0,2,-1,-1,3,-1,-32,-13,-19,-3,-5,2,-4,-5,-15,-5,9,-13,-3,4,-8,-4,5,-6,-1,-9,-7,-1,4,-7,1,-1,-3,-2,1,1,1,0,-5,-2,0,1,0,-1,2,0,1,0,-65,-40,-25,-27,-23,-4,-10,-7,-20,-14,-2,-12,-4,-1,-9,-14,-5,-6,-6,-6,-11,0,3,-6,1,-4,-11,-7,-4,-2,1,0,-11,-8,-3,-2,0,-4,0,1,-1,0,3,20,-17,11,3,8,-1,-1,-11,4,10,0,-2,7,-3,10,9,-1,1,-8,-8,-6,1,1,1,2,0,-3,5,5,1,1,-3,-3,5,2,0,1,3,0,0,3,-55,-30,-25,-4,1,-5,-9,-8,-31,-1,4,-7,-4,-5,-15,3,1,-6,-5,-3,-16,-4,3,-1,-2,1,-8,2,4,-2,-1,1,-2,1,3,-2,-1,0,-6,1,1,0,-22,-6,-16,7,2,5,-2,1,-17,-6,7,-5,-4,-2,-8,0,5,2,2,3,-9,-6,2,-7,3,-1,-5,0,6,3,-2,0,-5,1,4,3,5,-1,0,-1,2,0
15,15073,Ribeira,26451,-34,-60,26,106,71,35,2,-12,-32,-11,17,0,-7,-24,-29,-9,6,3,9,12,-3,-2,11,-3,19,12,27,20,19,7,12,9,20,12,10,6,7,3,7,8,9,1,-69,-28,-41,60,31,29,-9,-44,7,-31,9,2,1,-18,4,-16,2,1,-10,-26,3,-15,7,1,8,15,18,6,9,4,2,8,11,3,5,2,6,7,7,3,4,2,65,19,46,67,32,35,18,-16,8,11,17,15,13,-8,-6,0,9,6,5,-8,14,11,8,9,22,7,4,10,15,7,11,7,4,0,6,4,11,0,0,10,9,3,57,46,11,109,47,62,-1,-1,27,-11,20,14,1,2,25,-1,9,4,-2,-3,2,-10,11,10,22,20,24,3,27,11,12,8,12,0,13,1,10,12,12,3,14,10,265,142,123,228,131,97,37,32,82,44,49,23,23,12,59,16,18,16,14,20,23,28,31,7,27,37,75,33,30,26,13,19,52,19,11,17,14,18,23,14,19,9,162,100,62,202,125,77,43,3,66,41,0,2,15,12,35,27,6,1,28,-9,31,14,-6,1,46,34,65,40,10,5,26,18,41,29,8,2,20,16,24,11,2,3,167,115,52,180,120,60,46,9,29,33,34,8,36,24,-1,27,19,3,10,-15,30,6,15,5,27,43,51,39,15,3,14,33,36,24,10,2,13,10,15,15,5,1,199,116,83,211,136,75,23,35,55,36,21,24,4,22,39,24,12,9,19,13,16,12,9,15,27,49,61,42,19,11,7,38,44,31,9,5,20,11,17,11,10,6,143,110,33,140,74,66,19,30,56,13,23,6,15,20,45,6,21,8,4,10,11,7,2,-2,26,37,50,21,2,2,12,21,33,8,0,0,14,16,17,13,2,2,109,82,27,113,66,47,22,19,17,11,33,2,14,7,21,19,11,1,8,12,-4,-8,22,1,31,24,21,24,15,-6,16,9,13,16,12,-2,15,15,8,8,3,-4,228,139,89,103,50,53,59,37,52,27,23,28,33,29,35,16,16,9,26,8,17,11,7,19,23,21,26,15,14,2,12,10,11,7,9,0,11,11,15,8,5,2,71,-10,81,72,30,42,11,14,-16,14,23,19,-15,2,-6,-3,12,2,26,12,-10,17,11,17,23,21,17,-7,16,-1,9,13,11,-13,11,-2,14,8,6,6,5,1,91,62,29,8,6,2,21,6,1,31,16,16,17,2,-2,19,14,14,4,4,3,12,2,2,0,16,-5,-5,7,-5,-2,9,-6,0,4,2,2,7,1,-5,3,-7,-152,-61,-91,-69,-31,-38,-8,-37,-45,-32,-5,-17,-8,-14,-13,-6,3,-17,0,-23,-32,-26,-8,0,5,-15,-22,-17,-3,-18,4,-10,-11,-7,4,-11,1,-5,-11,-10,-7,-7,-150,-114,-36,-60,-37,-23,-21,-27,-47,-66,-4,12,-24,-17,-29,-50,1,1,3,-10,-18,-16,-5,11,5,-5,-22,-30,-7,-1,4,-3,-11,-25,1,-3,1,-2,-11,-5,-8,2,-40,-27,-13,-40,-38,-2,-3,0,-30,-12,-8,11,-11,4,-10,-17,-2,9,8,-4,-20,5,-6,2,4,8,-6,-25,-9,-15,0,1,-6,-21,-8,-5,4,7,0,-4,-1,-10,-37,-25,-12,4,-6,10,-4,-12,-33,-31,22,15,0,-2,-31,-24,17,12,-4,-10,-2,-7,5,3,0,4,-6,-29,21,11,2,4,-15,-24,16,9,-2,0,9,-5,5,2,15,20,-5,58,25,33,6,2,-3,-11,16,5,7,1,12,-11,10,2,-1,1,-15,0,6,3,12,13,8,-2,7,18,13,3,0,-5,2,11,-1,10,8,3,5,7
15,15074,Rois,5238,3,-1,4,11,7,4,0,-11,-5,4,13,2,1,-5,-7,2,5,3,-1,-6,2,2,8,-1,3,0,1,1,6,0,2,0,1,1,3,0,1,0,0,0,3,0,-17,0,-17,12,8,4,-10,0,-12,3,3,-1,-2,0,-1,2,2,-1,-8,0,-11,1,1,0,0,2,0,7,1,2,0,1,0,5,1,1,0,1,0,2,0,1,-7,-10,3,11,5,6,3,-3,-10,6,2,-1,0,-2,-6,2,0,-2,3,-1,-4,4,2,1,2,1,4,2,1,1,1,1,1,2,0,0,1,0,3,0,1,1,32,23,9,35,21,14,12,-4,7,14,3,-3,4,2,-1,9,3,2,8,-6,8,5,0,-5,6,0,8,14,4,2,4,2,3,7,3,1,2,-2,5,7,1,1,36,20,16,7,5,2,6,0,23,6,2,-3,8,-1,11,3,1,-3,-2,1,12,3,1,0,0,0,2,0,3,2,0,0,1,1,2,1,0,0,1,-1,1,1,-15,-6,-9,5,3,2,0,-2,-10,2,2,-2,0,-3,-4,0,2,0,0,1,-6,2,0,-2,-2,0,4,1,1,1,-1,0,1,1,1,1,-1,0,3,0,0,0,-11,-8,-3,5,3,2,-3,0,-16,9,-10,8,-5,0,-6,5,-5,3,2,0,-10,4,-5,5,0,1,-1,0,2,3,0,0,-1,0,2,2,0,1,0,0,0,1,8,5,3,21,11,10,-4,0,6,4,4,0,-2,6,1,1,0,1,-2,-6,5,3,4,-1,4,2,3,4,7,1,2,1,3,2,3,0,2,1,0,2,4,1,10,0,10,14,9,5,2,-3,5,2,3,0,2,-2,-1,-1,3,-1,0,-1,6,3,0,1,1,3,7,1,1,1,0,1,5,1,1,1,1,2,2,0,0,0,-27,-9,-18,5,3,2,-7,-4,-21,-2,8,-2,1,-3,-8,-4,7,-1,-8,-1,-13,2,1,-1,0,1,1,0,1,2,0,0,1,0,1,1,0,1,0,0,0,1,-7,9,-16,9,5,4,7,3,-10,3,3,-11,4,2,-1,4,4,-3,3,1,-9,-1,-1,-8,5,4,0,0,0,0,2,3,0,0,0,0,3,1,0,0,0,0,-4,-4,0,2,1,1,6,-4,-10,-2,1,4,2,-3,-2,-5,0,4,4,-1,-8,3,1,0,3,1,-3,0,2,-1,2,0,-2,0,1,0,1,1,-1,0,1,-1,-20,-6,-14,4,1,3,0,4,-30,0,5,4,-2,1,-17,8,1,3,2,3,-13,-8,4,1,0,-1,-2,2,4,1,0,-1,-2,2,1,1,0,0,0,0,3,0,-26,-16,-10,-1,-1,0,0,-11,-4,-5,-3,-4,-3,-4,-4,-2,-1,-2,3,-7,0,-3,-2,-2,1,-2,1,0,-1,0,0,-1,1,0,-1,0,1,-1,0,0,0,0,-23,-10,-13,-2,-1,-1,-11,-2,-3,-8,0,3,-8,2,0,-4,1,1,-3,-4,-3,-4,-1,2,0,0,-2,0,0,0,0,0,-1,0,0,0,0,0,-1,0,0,0,-14,-6,-8,8,2,6,-4,-11,-1,8,2,-8,-3,-4,-3,3,2,-1,-1,-7,2,5,0,-7,1,0,1,1,2,3,0,0,-1,1,1,1,1,0,2,0,1,2,-15,-7,-8,-1,-1,0,-10,1,-6,-2,4,3,-2,-1,-3,-3,3,1,-8,2,-3,1,1,2,0,-1,-2,0,1,1,0,-1,0,0,0,0,0,0,-2,0,1,1,-30,-11,-19,-6,-3,-3,-9,-2,-11,-1,2,-10,-2,2,-6,3,-4,-4,-7,-4,-5,-4,6,-6,0,-1,1,-3,-1,-2,0,-1,0,1,-2,-1,0,0,1,-4,1,-1
15,15075,Sada,10621,358,160,198,121,54,67,42,57,56,78,80,35,23,20,14,49,40,11,19,37,42,29,40,24,14,28,23,20,18,15,7,8,9,12,9,8,7,20,14,8,9,7,345,167,178,136,68,68,69,34,74,86,54,26,31,19,34,45,24,15,38,15,40,41,30,11,37,25,31,28,6,7,23,11,13,12,3,5,14,14,18,16,3,2,342,178,164,158,73,85,7,59,88,78,76,31,-8,30,43,53,38,19,15,29,45,25,38,12,25,34,34,20,29,15,9,13,15,10,15,11,16,21,19,10,14,4,556,296,260,154,73,81,62,72,143,118,107,55,30,39,82,63,51,30,32,33,61,55,56,25,27,33,28,15,32,16,13,13,13,8,16,9,14,20,15,7,16,7,440,215,225,112,47,65,12,29,144,96,96,53,7,14,61,60,43,24,5,15,83,36,53,29,11,18,25,13,28,16,5,4,10,7,11,9,6,14,15,6,17,7,372,235,137,161,92,69,50,36,122,48,71,40,25,31,86,35,30,26,25,5,36,13,41,14,32,15,31,33,32,14,22,6,21,19,15,7,10,9,10,14,17,7,472,228,244,162,73,89,51,49,110,123,89,39,38,18,48,52,55,15,13,31,62,71,34,24,16,15,41,29,38,19,7,7,16,12,20,9,9,8,25,17,18,10,460,241,219,253,115,138,115,61,134,65,63,18,72,24,69,19,39,15,43,37,65,46,24,3,40,70,68,34,25,11,20,29,28,13,15,6,20,41,40,21,10,5,456,222,234,144,75,69,72,63,111,118,54,42,37,34,42,73,26,8,35,29,69,45,28,34,35,40,30,24,15,1,21,23,13,11,6,1,14,17,17,13,9,0,254,130,124,75,36,39,56,14,54,60,42,23,34,10,24,34,14,10,22,4,30,26,28,13,12,11,4,20,18,9,7,3,4,9,8,5,5,8,0,11,10,4,81,29,52,-52,-38,-14,48,6,3,33,-10,-4,22,-7,3,15,-1,-5,26,13,0,18,-9,1,16,2,-20,-20,-10,-22,8,-7,-11,-12,-4,-12,8,9,-9,-8,-6,-10,141,68,73,29,9,20,14,4,28,33,35,25,5,10,21,18,8,5,9,-6,7,15,27,20,20,6,-3,-1,5,-1,11,5,-2,-3,-3,-1,9,1,-1,2,8,0,167,116,51,54,31,23,9,15,66,29,24,25,26,11,30,17,13,17,-17,4,36,12,11,8,19,17,16,1,4,-4,12,10,9,-2,2,-1,7,7,7,3,2,-3,125,68,57,17,11,6,52,5,16,6,20,24,29,-5,11,6,13,9,23,10,5,0,7,15,17,7,-3,-5,0,0,13,1,-4,-2,3,0,4,6,1,-3,-3,0,19,-26,45,40,8,32,16,-23,-16,-6,18,30,-7,-14,-17,-13,3,17,23,-9,1,7,15,13,19,8,9,-7,8,0,5,4,0,-8,1,4,14,4,9,1,7,-4,142,61,81,36,16,20,57,-9,27,41,12,14,31,-6,12,26,-2,-2,26,-3,15,15,14,16,18,10,-6,11,2,-1,9,5,2,4,-3,-2,9,5,-8,7,5,1,180,75,105,104,37,67,33,17,55,11,44,21,1,11,26,2,21,16,32,6,29,9,23,5,20,18,24,8,22,12,8,9,10,1,5,4,12,9,14,7,17,8,293,133,160,180,83,97,27,7,75,54,76,43,17,1,38,19,28,23,10,6,37,35,48,20,38,20,34,34,38,14,19,7,16,15,18,7,19,13,18,19,20,7
15,15077,Santa Comba,10960,34,9,25,97,47,50,2,-18,12,27,12,1,-5,-9,5,15,5,0,7,-9,7,12,7,1,23,6,27,30,10,0,10,2,13,17,5,0,13,4,14,13,5,0,33,22,11,77,42,35,16,0,4,-3,10,1,13,0,1,-2,6,0,3,0,3,-1,4,1,21,8,21,9,10,5,11,2,13,5,6,2,10,6,8,4,4,3,-36,-23,-13,79,39,40,6,-22,-48,-8,33,2,5,-16,-26,-7,21,-1,1,-6,-22,-1,12,3,25,11,10,8,24,0,14,6,1,2,16,-1,11,5,9,6,8,1,-28,-29,1,90,45,45,-14,-21,-41,7,25,14,-14,-16,-26,3,15,8,0,-5,-15,4,10,6,14,9,21,13,23,7,8,4,10,7,12,3,6,5,11,6,11,4,44,44,0,103,60,43,21,7,-22,32,13,-7,14,5,-4,24,6,-1,7,2,-18,8,7,-6,25,15,12,30,20,0,12,9,6,20,13,0,13,6,6,10,7,0,22,3,19,76,37,39,18,-16,6,7,19,-7,7,-13,2,4,11,-5,11,-3,4,3,8,-2,14,7,23,10,23,-2,5,1,9,7,15,0,9,6,14,3,8,-2,57,27,30,94,50,44,5,11,-1,8,22,9,2,6,-4,-4,14,11,3,5,3,12,8,-2,15,10,16,28,16,6,9,3,9,11,12,5,6,7,7,17,4,1,90,51,39,114,63,51,24,14,1,25,29,-5,9,8,-7,17,23,0,15,6,8,8,6,-5,24,13,21,27,28,-1,11,5,12,15,19,0,13,8,9,12,9,-1,-36,-26,-10,21,5,16,3,-11,-30,-5,8,1,-3,3,-17,-6,3,-4,6,-14,-13,1,5,5,2,2,5,0,10,2,-1,3,6,-4,1,0,3,-1,-1,4,9,2,-7,0,-7,9,2,7,6,-5,-22,0,15,-3,4,-11,-8,5,9,1,2,6,-14,-5,6,-4,3,-2,-10,2,13,3,1,-4,-5,2,5,3,2,2,-5,0,8,0,-22,-3,-19,-11,-4,-7,12,-2,-27,-2,-2,-1,4,0,-18,0,6,4,8,-2,-9,-2,-8,-5,1,1,-8,-11,0,6,1,1,-8,-6,2,6,0,0,0,-5,-2,0,-54,-29,-25,-19,-14,-5,2,-2,-24,-27,-5,2,-2,0,-7,-16,-4,-1,4,-2,-17,-11,-1,3,2,2,-10,-9,-5,0,0,1,-5,-4,-5,-2,2,1,-5,-5,0,2,-79,-41,-38,-24,-21,-3,-5,-19,-41,-20,15,-4,-2,-16,-10,-19,9,0,-3,-3,-31,-1,6,-4,-4,-4,-16,-11,7,4,-2,-4,-7,-12,2,2,-2,0,-9,1,5,2,-63,-29,-34,-36,-27,-9,-8,-4,-44,-16,4,4,-3,0,-18,-10,-3,4,-5,-4,-26,-6,7,0,-9,3,-19,-11,0,0,-4,-1,-12,-9,-2,1,-5,4,-7,-2,2,-1,-15,5,-20,-26,-14,-12,7,-5,-19,-6,11,-4,10,0,-15,1,8,-2,-3,-5,-4,-7,3,-2,-3,-5,-20,-6,5,3,0,-3,-12,-4,4,1,-3,-2,-8,-2,1,2,-32,-12,-20,3,7,-4,-12,-4,-8,-16,19,-11,-9,-2,6,-9,6,-4,-3,-2,-14,-7,13,-7,2,1,-8,3,5,0,1,-1,2,1,1,3,1,2,-10,2,4,-3,19,19,0,40,25,15,3,-7,5,-15,23,13,3,-2,3,-10,14,12,0,-5,2,-5,9,1,5,2,1,1,21,10,2,2,2,0,12,7,3,0,-1,1,9,3,42,31,11,45,19,26,23,1,-5,9,14,0,6,6,0,9,10,2,17,-5,-5,0,4,-2,18,5,5,1,9,6,9,3,-2,-2,7,4,9,2,7,3,2,2
15,15078,Santiago de Compostela,93745,-1127,-556,-571,135,73,62,-137,-170,-441,-258,-112,13,-57,-89,-210,-139,-58,7,-80,-81,-231,-119,-54,6,16,21,26,27,23,20,12,9,14,17,11,9,4,12,12,10,12,11,-430,-245,-185,432,222,210,4,-66,-281,-97,8,12,-5,-30,-149,-68,2,8,9,-36,-132,-29,6,4,81,94,116,69,39,29,41,51,54,36,24,13,40,43,62,33,15,16,127,76,51,816,421,395,92,93,-107,-22,40,45,71,70,-69,-29,15,20,21,23,-38,7,25,25,159,182,224,141,79,25,82,96,118,71,40,10,77,86,106,70,39,15,245,98,147,656,318,338,61,80,66,-35,7,49,24,60,2,-44,16,31,37,20,64,9,-9,18,104,166,171,102,73,34,53,75,82,44,43,17,51,91,89,58,30,17,637,213,424,715,355,360,148,128,154,131,42,32,53,57,10,57,28,7,95,71,144,74,14,25,105,180,208,125,63,26,52,94,92,69,33,10,53,86,116,56,30,16,510,209,301,705,329,376,150,74,108,82,4,89,69,30,23,59,-14,36,81,44,85,23,18,53,106,188,237,101,40,22,49,85,114,53,13,9,57,103,123,48,27,13,608,227,381,705,317,388,194,137,92,143,1,43,96,36,23,70,-3,9,98,101,69,73,4,34,112,207,197,106,64,10,57,78,98,49,29,3,55,129,99,57,35,7,733,333,400,692,309,383,143,172,137,180,32,76,71,74,60,93,20,21,72,98,77,87,12,55,93,202,189,123,50,32,38,89,92,50,27,11,55,113,97,73,23,21,909,402,507,742,354,388,118,194,163,224,46,139,64,80,77,95,39,36,54,114,86,129,7,103,85,222,216,135,61,17,45,91,103,71,33,8,40,131,113,64,28,9,192,34,158,-82,-60,-22,41,83,93,-8,-48,36,13,11,35,-11,-40,28,28,72,58,3,-8,8,24,49,-54,-65,-32,-14,2,4,-9,-44,-21,2,22,45,-45,-21,-11,-16,297,63,234,233,72,161,18,138,59,71,-26,35,22,46,9,34,-53,4,-4,92,50,37,27,31,55,112,40,3,19,-2,32,26,15,-4,-3,2,23,86,25,7,22,-4,633,255,378,322,141,181,133,63,141,172,3,118,50,18,64,82,6,35,83,45,77,90,-3,83,74,131,58,6,47,2,29,37,36,16,25,-3,45,94,22,-10,22,5,407,164,243,132,66,66,70,97,29,134,9,72,53,10,-9,78,-3,40,17,87,38,56,12,32,19,114,-2,-16,-3,12,8,45,5,4,-7,8,11,69,-7,-20,4,4,142,-24,166,25,-29,54,50,107,-78,-6,12,45,30,7,-69,0,-2,10,20,100,-9,-6,14,35,20,117,-77,-45,9,-6,15,32,-49,-26,2,-7,5,85,-28,-19,7,1,-6,6,-12,104,17,87,-41,125,-90,5,-13,22,-30,37,-27,13,2,12,-11,88,-63,-8,-15,10,14,159,-30,-36,-1,-6,9,58,-29,-25,1,0,5,101,-1,-11,-2,-6,394,67,327,112,20,92,73,206,87,-25,25,28,43,62,-5,-36,5,-4,30,144,92,11,20,32,30,131,-20,-35,0,-1,2,48,-7,-26,0,-2,28,83,-13,-9,0,1,524,206,318,243,104,139,53,161,31,174,28,79,18,48,8,100,19,19,35,113,23,74,9,60,58,130,-29,27,21,28,35,49,-20,8,15,15,23,81,-9,19,6,13,597,341,256,357,179,178,95,225,3,103,38,121,52,113,38,34,34,66,43,112,-35,69,4,55,90,153,12,45,33,15,56,73,15,0,19,10,34,80,-3,45,14,5
15,15082,Teo,14071,418,204,214,47,20,27,62,41,178,87,40,4,27,12,95,44,24,2,35,29,83,43,16,2,3,12,12,7,10,2,2,4,5,2,6,1,1,8,7,5,4,1,370,187,183,71,39,32,61,34,153,84,13,17,39,11,70,47,8,8,22,23,83,37,5,9,19,12,8,15,8,7,13,5,5,6,5,3,6,7,3,9,3,4,438,218,220,71,36,35,87,56,163,78,25,21,41,26,83,34,20,9,46,30,80,44,5,12,16,8,17,8,13,6,7,6,9,1,9,2,9,2,8,7,4,4,401,188,213,91,37,54,69,27,196,67,22,21,19,14,110,23,16,8,50,13,86,44,6,13,30,12,13,19,9,8,13,6,6,5,3,4,17,6,7,14,6,4,342,167,175,72,30,42,72,24,160,36,21,25,43,-4,75,25,7,16,29,28,85,11,14,9,17,13,14,8,13,7,6,5,8,2,5,4,11,8,6,6,8,3,285,129,156,58,31,27,36,25,92,68,23,24,16,0,36,47,15,8,20,25,56,21,8,16,6,11,14,12,12,3,3,7,5,8,6,2,3,4,9,4,6,1,242,113,129,48,32,16,28,6,106,51,11,25,5,3,48,27,6,15,23,3,58,24,5,10,10,4,11,14,3,5,7,3,7,8,2,5,3,1,4,6,1,0,186,98,88,65,34,31,43,2,78,21,4,32,21,1,30,23,4,16,22,1,48,-2,0,16,21,12,15,8,7,1,11,5,7,7,5,-1,10,7,8,1,2,2,81,43,38,66,38,28,-5,0,40,7,11,28,2,4,22,3,5,8,-7,-4,18,4,6,20,14,15,17,13,5,1,5,11,11,9,2,0,9,4,6,4,3,1,178,126,52,28,20,8,27,22,-7,67,25,40,13,14,15,32,26,21,14,8,-22,35,-1,19,-3,2,3,15,11,0,-2,-1,1,13,9,0,-1,3,2,2,2,0,214,111,103,25,8,17,58,14,44,44,-2,41,38,10,20,14,2,20,20,4,24,30,-4,21,3,8,3,6,-2,6,1,2,2,1,-1,2,2,6,1,5,-1,4,89,58,31,15,2,13,8,8,9,12,18,28,15,-1,14,12,7,7,-7,9,-5,0,11,21,4,7,1,-1,4,0,2,4,-3,-1,1,-1,2,3,4,0,3,1,-10,-1,-9,10,5,5,5,0,-49,10,-7,24,-10,5,-20,9,3,6,15,-5,-29,1,-10,18,2,3,-4,6,2,0,0,1,-3,5,1,0,2,2,-1,1,1,0,97,41,56,4,3,1,10,8,-9,47,-3,45,1,7,-3,22,6,11,9,1,-6,25,-9,34,2,2,0,-2,1,1,0,0,1,2,-1,1,2,2,-1,-4,2,0,37,26,11,9,1,8,3,-4,16,-13,5,32,9,-2,-1,1,11,9,-6,-2,17,-14,-6,23,2,5,-3,1,-3,7,1,2,-2,1,-4,3,1,3,-1,0,1,4,-11,-44,33,-5,-6,1,13,-17,-29,12,-12,18,1,-4,-26,0,-7,-6,12,-13,-3,12,-5,24,-3,4,-3,-5,-2,2,-1,3,-3,-4,-2,-1,-2,1,0,-1,0,3,12,10,2,22,15,7,0,-22,7,-15,-2,38,10,-10,5,1,-5,8,-10,-12,2,-16,3,30,5,-1,0,9,4,3,2,1,1,4,3,3,3,-2,-1,5,1,0,130,81,49,53,20,33,42,-15,25,29,17,37,25,3,9,10,13,19,17,-18,16,19,4,18,21,3,8,8,7,4,13,1,-1,3,0,2,8,2,9,5,7,2
15,15084,Tordoia,5106,-21,-11,-10,18,11,7,2,-14,-6,-7,6,-2,2,-7,-4,-4,4,-1,0,-7,-2,-3,2,-1,3,0,4,1,6,3,3,0,2,1,4,1,0,0,2,0,2,2,-46,-17,-29,15,7,8,-10,-8,-24,-5,1,0,-3,-5,-6,-2,-1,0,-7,-3,-18,-3,2,0,3,0,3,4,4,1,1,0,2,3,0,1,2,0,1,1,4,0,-31,-21,-10,11,1,10,-3,-13,-10,-8,2,0,-3,-9,-9,-1,-1,2,0,-4,-1,-7,3,-2,2,-4,1,4,4,4,0,-3,-1,2,0,3,2,-1,2,2,4,1,-63,-30,-33,11,4,7,-14,-16,-16,-9,-4,-4,-8,-5,-9,-3,-1,-4,-6,-11,-7,-6,-3,0,3,1,4,0,1,2,2,3,1,-2,1,-1,1,-2,3,2,0,3,-62,-25,-37,-10,-2,-8,-12,-3,-25,-12,-4,-8,-2,-3,-12,-5,-3,-1,-10,0,-13,-7,-1,-7,0,-4,-2,-3,0,-1,0,-1,1,-1,0,-1,0,-3,-3,-2,0,0,-10,-6,-4,25,14,11,3,0,-9,-5,4,-3,3,-1,-6,-5,3,0,0,1,-3,0,1,-3,6,-1,-1,8,7,6,5,-1,0,2,5,3,1,0,-1,6,2,3,-46,-24,-22,7,-1,8,-10,-11,-18,-11,5,0,-6,-8,-9,-6,6,0,-4,-3,-9,-5,-1,0,-4,-1,3,3,3,3,-2,-1,-2,2,1,1,-2,0,5,1,2,2,-23,-12,-11,6,3,3,-6,-5,-11,-6,6,0,-2,-1,-7,-7,4,1,-4,-4,-4,1,2,-1,2,0,-3,3,5,-1,1,0,-1,0,4,-1,1,0,-2,3,1,0,-16,-19,3,3,1,2,-2,4,-8,-9,0,-2,-2,-2,-5,-9,0,-2,0,6,-3,0,0,0,-3,2,-1,2,2,1,-1,1,-1,0,1,1,-2,1,0,2,1,0,-33,-23,-10,0,-4,4,-1,0,-28,10,0,-9,0,-2,-17,-1,1,-1,-1,2,-11,11,-1,-8,-2,-3,2,1,2,0,-2,-3,0,0,1,0,0,0,2,1,1,0,-53,-17,-36,-3,3,-6,-11,-8,-20,-4,-1,-6,-4,-5,-11,1,3,1,-7,-3,-9,-5,-4,-7,0,2,1,-4,-1,-1,0,1,2,-1,1,0,0,1,-1,-3,-2,-1,-57,-21,-36,-25,-9,-16,2,-3,-13,-18,-14,-8,0,-2,-5,-9,-4,0,2,-1,-8,-9,-10,-8,1,0,-3,-7,-13,-3,1,1,-2,-3,-5,-1,0,-1,-1,-4,-8,-2,-5,3,-8,-5,-5,0,5,3,-5,7,-8,-4,0,5,0,8,-8,0,5,-2,-5,-1,0,-4,0,0,0,0,-4,-1,0,0,-1,0,-4,0,0,0,1,0,0,-1,-59,-28,-31,-7,-4,-3,-2,-10,-13,-16,-10,-8,1,-5,-11,-9,1,-3,-3,-5,-2,-7,-11,-5,0,-4,0,-1,-1,-1,0,-3,-1,0,0,0,0,-1,1,-1,-1,-1,-6,-5,-1,-3,-5,2,6,-2,-1,1,1,-10,7,-2,-4,1,-1,-5,-1,0,3,0,2,-5,0,-2,3,-2,0,-2,0,-1,0,-2,0,-2,0,-1,3,0,0,0,-33,-17,-16,-4,-4,0,4,-5,-17,-12,-3,0,2,-5,-7,-5,-1,-1,2,0,-10,-7,-2,1,0,-2,1,-2,0,-1,0,-2,0,-1,-1,0,0,0,1,-1,1,-1,-30,-18,-12,-1,2,-3,2,-6,-20,-5,3,-3,-3,-5,-11,0,1,1,5,-1,-9,-5,2,-4,0,0,-1,-1,1,0,0,0,1,-1,1,1,0,0,-2,0,0,-1,-27,-13,-14,16,8,8,4,-4,-28,5,4,-6,5,-2,-15,5,0,-5,-1,-2,-13,0,4,-1,4,1,-4,2,7,6,3,2,-2,1,2,2,1,-1,-2,1,5,4
15,15086,Trazo,3864,16,9,7,23,10,13,3,-5,-5,12,9,2,1,-1,1,1,6,1,2,-4,-6,11,3,1,4,0,2,9,6,2,2,0,1,2,4,1,2,0,1,7,2,1,-39,-17,-22,18,9,9,-11,-3,-18,-6,3,-4,-5,0,-11,-1,1,0,-6,-3,-7,-5,2,-4,0,3,3,5,3,2,0,2,1,3,1,2,0,1,2,2,2,0,-33,-18,-15,21,11,10,-10,-14,-12,-4,9,-2,-4,-8,-14,2,5,0,-6,-6,2,-6,4,-2,3,-2,6,-1,10,3,1,0,0,2,6,1,2,-2,6,-3,4,2,-19,0,-19,23,14,9,-9,-1,-5,-6,6,-2,-3,-3,-2,4,4,2,-6,2,-3,-10,2,-4,4,1,5,5,4,3,3,0,2,4,3,2,1,1,3,1,1,1,-20,-11,-9,18,7,11,-11,-1,-10,3,3,0,-2,0,-11,1,0,2,-9,-1,1,2,3,-2,1,1,2,5,5,4,1,-1,-1,3,2,3,0,2,3,2,3,1,-40,-19,-21,8,5,3,-8,-1,-26,-5,3,-2,-2,-1,-14,-4,2,0,-6,0,-12,-1,1,-2,1,0,1,0,4,2,1,0,1,-1,3,1,0,0,0,1,1,1,23,3,20,13,8,5,4,3,-2,6,8,2,4,-2,-2,1,3,-1,0,5,0,5,5,3,0,0,1,4,5,3,0,0,1,3,3,1,0,0,0,1,2,2,-9,6,-15,21,15,6,6,-3,-18,14,-3,-5,2,0,-6,9,0,1,4,-3,-12,5,-3,-6,1,2,3,10,3,2,2,1,2,7,1,2,-1,1,1,3,2,0,2,2,0,9,6,3,-2,0,-3,2,4,2,-1,0,-3,4,1,2,-1,0,0,-2,3,0,-1,2,1,1,4,2,0,2,1,1,1,1,-1,0,0,0,3,1,12,2,10,5,4,1,7,0,1,1,-1,-1,-2,-1,6,1,-2,-3,9,1,-5,0,1,2,0,-1,1,2,1,2,0,0,1,1,0,2,0,-1,0,1,1,0,11,1,10,-4,-4,0,7,-3,7,0,1,-5,4,1,0,-5,2,-5,3,-4,7,5,-1,0,0,0,0,0,-4,0,0,0,0,-3,-1,0,0,0,0,3,-3,0,-32,-15,-17,-7,-4,-3,-5,-5,-16,-11,1,1,-3,-3,-6,-5,0,0,-2,-2,-10,-6,1,1,-1,-1,-1,-3,-1,0,-1,-1,0,0,0,-2,0,0,-1,-3,-1,2,-25,-15,-10,2,0,2,-1,-11,1,-6,-2,-6,2,-6,-4,-4,-2,-1,-3,-5,5,-2,0,-5,0,0,1,-1,2,0,0,0,0,-1,0,1,0,0,1,0,2,-1,-20,-8,-12,-2,-3,1,3,-2,-20,1,0,-2,1,-2,-6,1,1,-3,2,0,-14,0,-1,1,0,0,0,-3,0,1,0,0,0,-3,0,0,0,0,0,0,0,1,-6,-8,2,-3,-4,1,-2,0,-1,-4,3,-4,-2,-2,-3,-3,0,1,0,2,2,-1,3,-5,0,0,0,0,-1,-2,0,0,-1,-1,-1,-1,0,0,1,1,0,-1,-26,-18,-8,-5,-4,-1,1,-2,-8,-8,-4,-4,-1,0,-4,-5,-5,-2,2,-2,-4,-3,1,-2,-1,0,1,-1,-4,0,0,0,0,0,-3,-1,-1,0,1,-1,-1,1,-10,1,-11,9,6,3,-1,-3,-16,3,3,3,0,0,-5,0,2,2,-1,-3,-11,3,1,1,0,0,-1,1,5,4,0,0,0,1,3,2,0,0,-1,0,2,2,-11,-17,6,6,2,4,2,0,-12,2,-3,-3,1,-2,-12,1,-3,-3,1,2,0,1,0,0,1,1,0,3,1,0,1,0,-2,3,0,0,0,1,2,0,1,0
15,15088,Val do Dubra,5079,-7,-4,-3,13,9,4,-6,-2,-1,-3,2,2,-4,1,-3,-1,0,3,-2,-3,2,-2,2,-1,1,1,2,4,2,2,0,1,1,3,2,2,1,0,1,1,0,0,-20,-8,-12,4,2,2,4,-12,-6,-3,-2,-2,1,-4,-2,-3,0,-1,3,-8,-4,0,-2,-1,0,1,1,0,1,1,0,1,1,0,0,0,0,0,0,0,1,1,-17,-4,-13,18,6,12,-5,1,-15,1,6,-6,0,3,-9,-2,5,-1,-5,-2,-6,3,1,-5,8,1,0,2,8,-1,5,1,-2,-1,4,-1,3,0,2,3,4,0,-12,-12,0,38,20,18,-2,-5,-9,-5,10,1,-2,-4,-9,-2,6,0,0,-1,0,-3,4,1,5,3,7,10,9,3,3,1,6,5,4,1,2,2,1,5,5,2,-33,-22,-11,18,10,8,-3,1,-15,3,-8,-11,0,1,-9,-4,-6,-3,-3,0,-6,7,-2,-8,4,-2,8,3,3,2,3,0,3,1,2,1,1,-2,5,2,1,1,-16,-11,-5,23,12,11,-1,5,-23,-2,4,-1,0,2,-14,-2,2,0,-1,3,-9,0,2,-1,7,3,5,4,6,-2,4,2,1,3,3,-1,3,1,4,1,3,-1,-19,-18,-1,16,13,3,-1,-1,-32,2,8,6,1,-2,-18,-1,2,3,-2,1,-14,3,6,3,4,2,0,1,8,1,4,2,1,1,4,1,0,0,-1,0,4,0,-24,-13,-11,21,14,7,-9,2,-16,-2,4,-2,-2,1,-13,-2,2,1,-7,1,-3,0,2,-3,1,1,3,7,9,0,1,1,1,4,7,0,0,0,2,3,2,0,-11,-3,-8,16,9,7,5,-6,-8,-5,4,-2,5,-3,-8,-1,2,2,0,-3,0,-4,2,-4,1,3,5,5,4,-2,2,1,2,2,2,0,-1,2,3,3,2,-2,7,6,1,7,1,6,9,-3,-7,11,1,-5,4,-3,-4,7,1,0,5,0,-3,4,0,-5,2,1,3,1,3,-3,0,-1,0,2,1,-1,2,2,3,-1,2,-2,-22,-10,-12,4,1,3,-5,-3,-19,-1,7,-3,-3,-4,-3,-2,4,-3,-2,1,-16,1,3,0,0,0,-1,2,2,1,-1,-1,1,0,1,1,1,1,-2,2,1,0,-8,3,-11,13,9,4,0,-1,-3,-14,6,3,1,-1,5,-8,6,0,-1,0,-8,-6,0,3,6,0,1,0,3,3,4,1,0,0,3,1,2,-1,1,0,0,2,-7,-10,3,-9,-6,-3,6,0,6,-8,-5,-7,-5,3,2,-3,-6,-2,11,-3,4,-5,1,-5,0,-2,-1,-1,-2,-3,-1,-1,-1,0,-1,-2,1,-1,0,-1,-1,-1,-10,0,-10,-2,-1,-1,-4,3,3,-11,-1,2,2,1,-1,-5,1,3,-6,2,4,-6,-2,-1,0,1,-4,0,2,0,0,1,-4,0,1,1,0,0,0,0,1,-1,-32,-21,-11,1,0,1,-5,-2,-15,-8,2,-1,0,-3,-10,-5,-1,0,-5,1,-5,-3,3,-1,1,1,0,-4,1,2,2,1,-1,-3,1,0,-1,0,1,-1,0,2,-4,-11,7,1,-2,3,1,2,-2,-3,5,-5,-3,-3,-1,-4,-1,2,4,5,-1,1,6,-7,0,1,-3,-1,4,0,0,-1,-1,-1,1,0,0,2,-2,0,3,0,4,1,3,9,5,4,2,1,-8,3,8,-7,1,0,-4,1,3,-2,1,1,-4,2,5,-5,2,1,-2,2,3,2,1,1,-2,0,1,3,1,0,0,2,2,-1,41,20,21,22,12,10,5,11,3,1,10,9,-1,4,1,4,7,3,6,7,2,-3,3,6,2,5,-3,3,8,6,1,2,-3,4,6,2,1,3,0,-1,2,4
15,15087,Valdoviño,6765,85,34,51,19,10,9,12,7,10,11,37,8,6,1,0,4,17,5,6,6,10,7,20,3,5,1,5,0,6,2,4,0,1,0,4,1,1,1,4,0,2,1,82,50,32,11,8,3,10,15,10,20,13,14,7,10,6,10,9,7,3,5,4,10,4,7,4,0,4,2,1,0,3,0,3,2,0,0,1,0,1,0,1,0,77,33,44,13,4,9,6,-1,-7,27,31,22,1,-1,-2,10,18,7,5,0,-5,17,13,15,3,1,2,2,4,1,0,-1,2,1,2,0,3,2,0,1,2,1,23,12,11,5,1,4,-12,4,-7,10,22,8,-12,5,3,4,10,3,0,-1,-10,6,12,5,1,0,1,0,3,0,0,0,1,0,0,0,1,0,0,0,3,0,75,35,40,9,5,4,7,9,19,21,12,11,10,1,4,4,13,5,-3,8,15,17,-1,6,1,2,2,0,4,0,0,1,1,0,3,0,1,1,1,0,1,0,49,11,38,11,7,4,15,-8,7,21,7,6,7,-4,-3,7,2,2,8,-4,10,14,5,4,4,1,0,5,1,0,2,0,1,3,1,0,2,1,-1,2,0,0,138,74,64,14,9,5,33,5,28,30,26,14,21,6,13,16,12,6,12,-1,15,14,14,8,1,3,2,4,2,2,2,1,2,2,1,1,-1,2,0,2,1,1,58,41,17,24,13,11,4,7,-8,18,24,11,-2,3,2,16,13,7,6,4,-10,2,11,4,1,3,9,5,2,4,0,2,5,3,2,1,1,1,4,2,0,3,53,31,22,16,10,6,22,-5,3,7,9,16,16,-2,0,8,2,6,6,-3,3,-1,7,10,5,0,1,6,4,1,4,0,1,4,2,0,1,0,0,2,2,1,55,20,35,6,3,3,-1,8,8,15,24,-2,-5,1,6,7,10,0,4,7,2,8,14,-2,0,0,2,0,3,1,0,0,1,0,1,1,0,0,1,0,2,0,17,18,-1,15,6,9,-3,5,-15,20,8,2,-2,4,-1,9,3,6,-1,1,-14,11,5,-4,0,5,6,2,1,-1,0,2,1,2,0,0,0,3,5,0,1,-1,0,2,-2,8,4,4,19,-6,-20,2,6,1,17,-1,-12,-4,0,2,2,-5,-8,6,6,-1,1,3,2,0,0,2,1,2,1,-1,0,1,0,1,1,1,0,1,13,4,9,1,2,-1,6,3,-13,11,7,-2,6,-1,-12,9,4,-2,0,4,-1,2,3,0,0,1,-2,1,1,0,0,1,0,0,1,0,0,0,-2,1,0,0,46,29,17,-15,-12,-3,11,4,-1,12,12,8,3,-1,0,13,5,8,8,5,-1,-1,7,0,-2,0,-2,-6,-3,-1,-2,-1,-2,-4,-3,0,0,1,0,-2,0,-1,29,18,11,8,3,5,6,3,-6,-5,20,10,9,-5,-5,-2,13,8,-3,8,-1,-3,7,2,0,0,2,-1,5,2,0,-1,0,0,2,2,0,1,2,-1,3,0,-27,-8,-19,3,2,1,2,-4,-9,-17,-6,3,4,-2,2,-11,-6,2,-2,-2,-11,-6,0,1,1,0,0,0,1,1,0,0,1,0,0,1,1,0,-1,0,1,0,18,3,15,3,3,0,-2,1,-2,10,6,5,-8,2,-4,8,-1,5,6,-1,2,2,7,0,0,0,-1,-1,1,3,0,0,-1,2,0,1,0,0,0,-3,1,2,87,44,43,8,4,4,24,6,9,31,14,2,17,3,-4,11,11,5,7,3,13,20,3,-3,4,1,2,1,0,0,3,1,0,0,0,0,1,0,2,1,0,0
15,15089,Vedra,5088,49,29,20,8,4,4,4,7,-8,17,14,12,3,-2,-5,14,10,8,1,9,-3,3,4,4,0,1,1,1,2,3,0,1,0,0,0,3,0,0,1,1,2,0,-30,-8,-22,8,3,5,-7,-9,-11,-2,2,-1,-3,1,-2,-4,0,1,-4,-10,-9,2,2,-2,2,0,0,3,2,1,1,0,0,1,1,0,1,0,0,2,1,1,-10,2,-12,23,16,7,-5,-8,2,6,-2,-1,2,-2,-2,3,1,1,-7,-6,4,3,-3,-2,4,5,6,5,2,1,2,4,4,2,3,1,2,1,2,3,-1,0,41,10,31,11,6,5,11,2,-14,26,14,3,4,-1,-14,15,6,0,7,3,0,11,8,3,7,1,-1,4,1,-1,6,1,-1,2,-1,-1,1,0,0,2,2,0,-2,-1,-1,11,1,10,4,4,-18,10,1,0,1,1,-3,1,3,-2,3,3,-15,9,-2,2,2,4,0,4,0,1,1,-1,1,0,0,0,1,5,-1,4,0,1,35,19,16,31,15,16,4,-9,12,16,7,6,6,-3,8,5,2,3,-2,-6,4,11,5,3,2,8,13,6,0,2,2,3,8,0,0,2,0,5,5,6,0,0,13,8,5,17,6,11,13,-3,-27,12,17,1,2,2,-14,6,10,1,11,-5,-13,6,7,0,1,4,6,5,2,-1,0,1,1,3,0,1,1,3,5,2,2,-2,-13,2,-15,10,7,3,-13,2,-6,-4,7,-1,-5,6,-4,2,5,-1,-8,-4,-2,-6,2,0,-1,6,1,2,2,0,-1,6,1,1,1,-1,0,0,0,1,1,1,16,10,6,4,8,-4,-2,0,9,5,7,-3,-2,1,8,1,2,-1,0,-1,1,4,5,-2,5,-1,-1,1,1,-1,3,0,2,3,0,0,2,-1,-3,-2,1,-1,-52,-17,-35,1,3,-2,0,-14,-22,-9,-8,2,5,-5,-16,-2,-1,2,-5,-9,-6,-7,-7,0,0,-1,3,-1,-2,2,0,0,1,0,1,1,0,-1,2,-1,-3,1,-1,-4,3,5,1,4,15,-3,-20,11,4,-2,9,-4,-15,6,4,-1,6,1,-5,5,0,-1,2,0,2,1,-1,1,2,0,0,0,-1,0,0,0,2,1,0,1,21,17,4,16,9,7,10,0,-2,3,14,-4,9,-2,1,1,8,-2,1,2,-3,2,6,-2,5,-1,1,4,5,2,4,0,1,0,3,1,1,-1,0,4,2,1,-28,-11,-17,-4,-2,-2,-2,-3,-20,6,-6,-1,-2,0,-11,6,-2,-1,0,-3,-9,0,-4,0,0,1,-1,-1,-1,-2,0,0,-1,0,0,-1,0,1,0,-1,-1,-1,67,38,29,-7,-4,-3,10,11,17,10,10,11,7,4,9,6,3,8,3,7,8,4,7,3,0,1,-3,-6,1,0,-1,0,-2,-3,2,0,1,1,-1,-3,-1,0,11,14,-3,-1,-2,1,7,-2,-6,3,7,0,3,1,-3,10,1,3,4,-3,-3,-7,6,-3,4,0,-2,0,-1,-2,1,1,-2,0,-1,-1,3,-1,0,0,0,-1,-12,0,-12,0,-3,3,-7,-2,3,1,-8,0,0,2,6,-3,-3,-2,-7,-4,-3,4,-5,2,0,0,0,-2,0,2,0,0,0,-2,-2,1,0,0,0,0,2,1,74,34,40,-9,-6,-3,20,6,29,-2,14,7,6,1,15,-3,11,3,14,5,14,1,3,4,0,-1,-1,-4,-1,-2,0,-2,0,-3,0,-1,0,1,-1,-1,-1,-1,7,3,4,15,8,7,3,0,-6,1,10,-1,-1,2,-10,3,7,2,4,-2,4,-2,3,-3,1,1,5,2,2,4,0,1,2,2,1,2,1,0,3,0,1,2
15,15092,Vimianzo,8937,-41,-16,-25,68,37,31,-13,-12,-24,-5,7,3,-6,-2,-17,1,2,4,-7,-10,-7,-6,5,-1,10,6,18,10,11,9,6,4,10,7,4,4,4,2,8,3,7,5,-32,-17,-15,30,23,7,3,-11,-23,-2,-1,3,2,-4,-12,-4,0,2,1,-7,-11,2,-1,1,3,5,7,8,5,2,1,4,6,7,4,1,2,1,1,1,1,1,-26,-8,-18,79,44,35,-2,-34,-19,5,1,16,-2,-7,-14,5,-1,7,0,-27,-5,0,2,9,21,-2,2,23,13,17,14,1,-3,15,6,8,7,-3,5,8,7,9,-28,-24,-4,59,28,31,6,-14,-30,-7,23,-7,2,-11,-13,-11,12,-4,4,-3,-17,4,11,-3,16,2,6,14,21,-1,8,-1,5,6,10,-1,8,3,1,8,11,0,-15,-2,-13,78,53,25,-8,-9,-19,11,12,-2,-7,-1,-4,7,7,-5,-1,-8,-15,4,5,3,9,7,20,21,17,3,8,4,14,13,13,0,1,3,6,8,4,3,20,24,-4,64,40,24,19,-10,-18,9,15,2,13,-3,-9,8,13,-2,6,-7,-9,1,2,4,17,4,11,16,9,3,9,3,6,10,7,1,8,1,5,6,2,2,-6,-7,1,58,33,25,-15,-7,-16,22,18,-6,-11,-5,-13,13,10,1,-4,-2,-3,9,8,-7,6,2,15,20,14,0,1,3,8,11,9,0,5,-1,7,9,5,0,4,19,-15,52,33,19,11,-8,-13,2,22,-7,11,-2,-8,3,21,-5,0,-6,-5,-1,1,-2,22,-1,5,8,17,1,12,0,3,5,13,0,10,-1,2,3,4,1,-24,-6,-18,15,-2,17,7,-3,-13,-20,8,-3,9,-3,-8,-10,3,3,-2,0,-5,-10,5,-6,2,-3,8,2,5,1,0,-1,-2,1,-1,1,2,-2,10,1,6,0,-13,-6,-7,-1,-1,0,-5,-5,3,-8,12,-8,2,0,-5,-4,6,-4,-7,-5,8,-4,6,-4,-6,5,2,2,-1,-3,-4,4,0,-1,0,0,-2,1,2,3,-1,-3,-22,-12,-10,-8,-10,2,-8,-5,-9,-10,2,10,-5,-4,-5,-11,3,10,-3,-1,-4,1,-1,0,2,2,-7,-6,-2,3,-2,1,-3,-7,-1,2,4,1,-4,1,-1,1,66,-3,69,-24,-13,-11,-12,-6,-32,-29,12,132,-9,-5,-20,-18,10,38,-3,-1,-12,-11,2,94,-7,-2,-13,-7,1,4,-5,-2,-9,-3,2,4,-2,0,-4,-4,-1,0,11,-1,12,-14,-8,-6,7,-4,-38,-2,8,40,3,-1,-21,1,3,13,4,-3,-17,-3,5,27,-2,-1,-9,-7,6,-1,-1,-1,-5,-3,3,-1,-1,0,-4,-4,3,0,-62,-38,-24,-15,-13,-2,-6,-12,-27,-13,8,-14,-7,-5,-19,-5,3,-6,1,-7,-8,-8,5,-8,-1,-2,-10,-6,4,-1,0,-3,-9,-3,1,0,-1,1,-1,-3,3,-1,-46,-18,-28,-21,-12,-9,2,-2,-24,-15,-4,-5,1,0,-7,-10,-4,0,1,-2,-17,-5,0,-5,1,-5,-10,-4,-3,0,0,-1,-6,-2,-4,1,1,-4,-4,-2,1,-1,-50,-32,-18,-19,-16,-3,-8,-10,-27,-16,10,1,-8,-7,-10,-14,3,4,0,-3,-17,-2,7,-3,3,-1,-9,-10,-3,1,1,-2,-6,-8,-2,1,2,1,-3,-2,-1,0,-41,-16,-25,-10,-5,-5,-10,1,-12,-20,-5,4,-5,5,-6,-10,-3,3,-5,-4,-6,-10,-2,1,-1,-1,-5,-7,2,0,-1,0,-1,-3,-1,0,0,-1,-4,-4,3,0,-66,-37,-29,-20,-13,-7,-12,-7,-28,-13,0,-5,-3,-8,-14,-11,2,-2,-9,1,-14,-2,-2,-3,-6,0,-5,-5,-2,-1,-3,-1,-4,-5,1,0,-3,1,-1,0,-3,-1
15,15093,Zas,6226,-27,-19,-8,34,22,12,-3,-24,-6,1,5,0,-4,-15,-5,3,3,-1,1,-9,-1,-2,2,1,3,1,9,11,8,1,1,0,6,9,6,0,2,1,3,2,2,1,-28,-2,-26,22,12,10,-1,-7,-17,-1,-3,-1,2,-1,-7,2,-1,2,-3,-6,-10,-3,-2,-3,6,4,5,4,0,1,5,1,2,2,0,1,1,3,3,2,0,0,-44,-20,-24,16,3,13,6,-23,-12,-10,5,-8,6,-11,-8,-4,1,-2,0,-12,-4,-6,4,-6,8,-3,1,2,6,2,1,-3,1,0,3,1,7,0,0,2,3,1,-20,-8,-12,54,31,23,-4,-13,-10,-4,10,5,-1,-3,-3,-5,2,4,-3,-10,-7,1,8,1,8,7,11,12,9,7,6,4,6,8,4,3,2,3,5,4,5,4,-24,-6,-18,42,20,22,-6,-9,7,-1,-3,-11,-4,-4,9,-3,-1,-2,-2,-5,-2,2,-2,-9,4,3,18,9,7,1,2,1,9,4,4,0,2,2,9,5,3,1,-65,-37,-28,18,7,11,7,-19,-40,-9,1,-5,2,-11,-23,-3,1,-4,5,-8,-17,-6,0,-1,5,-1,4,5,4,1,2,-2,1,3,3,0,3,1,3,2,1,1,-55,-23,-32,28,18,10,-1,-8,-28,-14,0,-4,3,-2,-16,-6,-1,-1,-4,-6,-12,-8,1,-3,1,10,10,2,5,0,3,4,5,3,3,0,-2,6,5,-1,2,0,-28,-9,-19,42,28,14,8,2,-21,-9,2,-10,6,2,-7,-6,1,-4,2,0,-14,-3,1,-6,6,10,14,5,5,1,4,7,11,4,2,0,2,3,3,1,3,1,-36,-12,-24,15,11,4,-5,-15,-24,8,5,-4,-2,-6,-13,3,6,1,-3,-9,-11,5,-1,-5,2,4,3,4,2,-1,2,2,2,2,2,0,0,2,1,2,0,-1,-43,-19,-24,1,4,-3,-3,-8,-23,-14,5,1,-4,-1,-9,-11,6,1,1,-7,-14,-3,-1,0,-1,-1,1,0,2,0,0,0,2,0,2,0,-1,-1,-1,0,0,0,-52,-28,-24,-4,-2,-2,-3,-3,-32,-11,-3,-4,2,-3,-16,-10,0,-2,-5,0,-16,-1,-3,-2,3,-1,0,-2,-2,-2,3,-2,0,-1,-1,-1,0,1,0,-1,-1,-1,-36,-10,-26,-7,-4,-3,0,-5,-25,0,2,-6,2,-2,-17,5,1,1,-2,-3,-8,-5,1,-7,1,-1,-1,-7,1,0,2,-2,-1,-5,1,1,-1,1,0,-2,0,-1,-23,-20,-3,-3,2,-5,8,-9,-24,6,2,-8,1,-6,-18,1,1,-1,7,-3,-6,5,1,-7,-2,0,-2,2,-1,-1,-2,0,-1,3,1,0,0,0,-1,-1,-2,-1,-5,-4,-1,-6,-6,0,3,6,-9,-2,-2,0,6,1,-5,-1,-3,-2,-3,5,-4,-1,1,2,-1,-1,-3,-3,0,2,0,-1,-1,-3,-2,1,-1,0,-2,0,2,1,-60,-31,-29,-7,-3,-4,-2,-20,-32,-11,5,-1,-4,-10,-14,-9,2,3,2,-10,-18,-2,3,-4,0,-2,-5,-1,1,0,0,-1,-2,-1,0,1,0,-1,-3,0,1,-1,-49,-20,-29,0,0,0,-1,-11,-20,1,-10,-8,-4,1,-11,1,-3,-4,3,-12,-9,0,-7,-4,3,-1,0,1,-2,-1,1,0,1,0,-2,0,2,-1,-1,1,0,-1,-31,-2,-29,-1,-1,0,0,-4,-16,-7,-2,1,-1,1,-3,1,2,0,1,-5,-13,-8,-4,1,-1,1,-1,-2,4,-2,-1,0,-1,-2,4,-1,0,1,0,0,0,-1,-24,-17,-7,-2,-4,2,-3,8,-22,-1,-1,-4,-3,5,-15,-3,0,-1,0,3,-7,2,-1,-3,-1,0,-2,-1,-2,4,-1,0,-1,-2,-1,1,0,0,-1,1,-1,3
16,16007,"Alberca de Záncara, La",1774,19,12,7,6,4,2,3,4,0,4,5,1,2,3,1,3,3,0,1,1,-1,1,2,1,2,2,1,1,0,0,1,1,1,1,0,0,1,1,0,0,0,0,10,14,-4,22,15,7,-5,8,-1,10,1,-3,-2,6,5,5,1,-1,-3,2,-6,5,0,-2,1,10,9,2,0,0,0,7,7,1,0,0,1,3,2,1,0,0,19,14,5,43,29,14,2,11,7,1,0,-1,2,8,3,1,1,-1,0,3,4,0,-1,0,4,18,14,7,0,0,1,14,9,5,0,0,3,4,5,2,0,0,54,41,13,73,43,30,3,26,20,4,0,0,1,22,13,6,-1,-1,2,4,7,-2,1,1,8,28,27,10,0,0,3,17,16,7,0,0,5,11,11,3,0,0,154,109,45,182,122,60,20,63,72,-2,1,-1,13,45,50,-1,2,0,7,18,22,-1,-1,-1,20,71,72,12,4,1,13,47,51,7,3,1,7,24,21,5,1,0,104,69,35,159,105,54,19,31,37,13,4,0,14,20,22,10,2,1,5,11,15,3,2,-1,22,57,53,23,4,0,13,40,34,15,3,0,9,17,19,8,1,0,-55,-23,-32,50,24,26,-7,-8,-23,-13,-3,-4,-5,-9,-4,-5,-1,-1,-2,1,-19,-8,-2,-3,9,18,14,6,1,0,2,8,10,3,0,0,7,10,4,3,1,0,51,35,16,145,84,61,7,25,-4,21,0,2,7,16,-4,16,0,1,0,9,0,5,0,1,30,51,35,25,2,0,17,29,22,14,1,0,13,22,13,11,1,0,43,20,23,83,42,41,6,21,-2,19,-1,0,2,9,-1,12,-3,1,4,12,-1,7,2,-1,9,35,16,20,3,0,2,19,9,10,2,0,7,16,7,10,1,0,54,35,19,90,51,39,4,21,24,5,2,-1,-2,16,17,2,2,1,6,5,7,3,0,-2,8,36,24,17,4,1,3,21,18,7,2,0,5,15,6,10,2,1,-4,0,-4,38,19,19,2,10,-14,-4,1,0,3,7,-4,-5,-1,0,-1,3,-10,1,2,0,7,16,8,4,2,0,4,8,6,1,0,0,3,8,2,3,2,0,22,10,12,56,27,29,12,6,-7,3,3,5,2,8,-5,6,-1,0,10,-2,-2,-3,4,5,25,14,10,7,0,-1,7,9,5,6,0,0,18,5,5,1,0,-1,-56,-37,-19,-19,-19,0,-4,-9,-23,-8,-6,-6,-1,-6,-18,-6,-4,-2,-3,-3,-5,-2,-2,-4,5,0,-15,-6,-3,0,3,-1,-13,-5,-3,0,2,1,-2,-1,0,0,-28,-11,-17,7,3,4,-2,-4,-13,-2,-1,-6,-4,-1,-7,2,0,-1,2,-3,-6,-4,-1,-5,2,2,3,0,0,0,1,0,2,0,0,0,1,2,1,0,0,0,-106,-57,-49,-104,-60,-44,-3,-6,-49,-27,-19,-2,-1,-2,-25,-22,-9,2,-2,-4,-24,-5,-10,-4,0,-3,-48,-32,-20,-1,0,-2,-26,-22,-10,0,0,-1,-22,-10,-10,-1,-36,-18,-18,-17,-15,-2,-3,-4,-21,-10,-2,4,-2,1,-15,-6,2,2,-1,-5,-6,-4,-4,2,2,-1,-10,-9,0,0,1,0,-9,-7,0,0,1,-1,-1,-2,0,0,7,0,7,21,8,13,5,3,4,-3,-2,-1,2,0,0,-2,-1,1,3,3,4,-1,-1,-2,4,6,5,2,3,0,1,2,3,0,1,0,3,4,2,2,2,0,16,8,8,28,13,15,0,12,3,4,0,-2,-1,5,5,2,-2,0,1,7,-2,2,2,-2,5,5,8,8,2,0,3,2,5,3,0,0,2,3,3,5,2,0
16,16064,Casas de Haro,890,10,10,0,19,13,6,2,1,8,2,0,-2,1,4,4,1,0,0,1,-3,4,1,0,-2,0,7,10,2,0,0,0,5,6,2,0,0,0,2,4,0,0,0,13,7,6,15,8,7,2,6,4,-1,3,-1,-1,3,4,-1,2,0,3,3,0,0,1,-1,3,5,6,1,0,0,0,2,5,1,0,0,3,3,1,0,0,0,-26,-10,-16,2,1,1,-6,-6,-4,-6,0,-3,-2,-4,1,-4,1,-2,-4,-2,-5,-2,-1,-1,0,0,2,0,0,0,0,0,1,0,0,0,0,0,1,0,0,0,-4,-1,-3,9,4,5,4,0,-12,3,4,-2,3,0,-8,1,4,0,1,0,-4,2,0,-2,0,3,3,2,1,0,0,2,1,1,0,0,0,1,2,1,1,0,34,16,18,26,10,16,6,6,9,7,5,0,2,2,4,5,2,0,4,4,5,2,3,0,6,5,11,4,0,0,3,2,4,1,0,0,3,3,7,3,0,0,21,4,17,24,12,12,7,7,1,-1,2,3,1,3,-3,0,0,2,6,4,4,-1,2,1,7,11,4,1,0,1,2,6,2,1,0,1,5,5,2,0,0,0,15,8,7,16,8,8,-1,8,5,2,2,-2,-1,3,4,1,1,-1,0,5,1,1,1,-1,1,6,6,2,1,0,0,4,3,1,0,0,1,2,3,1,1,0,5,4,1,24,16,8,5,-3,-1,5,0,-1,4,-1,-2,3,1,-1,1,-2,1,2,-1,0,6,6,6,4,2,0,5,3,3,3,2,0,1,3,3,1,0,0,4,-4,8,27,13,14,-3,8,-2,-3,4,0,-1,2,-1,-4,1,-1,-2,6,-1,1,3,1,6,8,9,4,0,0,4,2,6,1,0,0,2,6,3,3,0,0,-2,5,-7,7,6,1,2,-2,-4,0,2,-2,1,1,0,2,1,-2,1,-3,-4,-2,1,0,2,2,0,2,1,0,2,2,0,2,0,0,0,0,0,0,1,0,-13,-3,-10,-12,-5,-7,-6,1,-6,-3,0,0,-2,1,-3,-1,1,1,-4,0,-3,-2,-1,-1,-4,0,-7,-2,1,0,-1,-1,-3,-1,1,0,-3,1,-4,-1,0,0,7,9,-2,6,3,3,2,-1,2,8,-3,-2,2,0,3,6,-1,-1,0,-1,-1,2,-2,-1,2,1,2,2,-1,0,1,0,1,1,0,0,1,1,1,1,-1,0,-4,-8,4,8,2,6,1,2,-1,0,1,-7,1,1,-4,0,-2,-4,0,1,3,0,3,-3,1,1,2,3,1,0,0,1,0,1,0,0,1,0,2,2,1,0,-14,-4,-10,-25,-15,-10,-4,-6,-3,-5,3,2,-2,-4,2,-1,2,0,-2,-2,-5,-4,1,2,-5,-4,-5,-10,-1,0,-4,-3,-2,-5,-1,0,-1,-1,-3,-5,0,0,14,10,4,2,0,2,8,3,-2,-1,4,1,7,3,-5,-1,4,2,1,0,3,0,0,-1,3,6,-3,-2,-2,-1,4,2,-3,-2,0,-1,-1,4,0,0,-2,0,10,7,3,0,0,0,0,-1,3,5,0,3,1,-1,2,4,0,1,-1,0,1,1,0,2,1,1,-3,2,-2,1,1,0,-3,2,0,0,0,1,0,0,-2,1,3,1,2,8,5,3,4,1,3,1,-2,-4,0,2,-1,4,-3,-1,4,-1,4,-3,1,-3,1,1,5,2,-1,0,0,1,3,2,-1,0,1,0,2,0,0,0,2,-1,3,6,4,2,2,0,0,-5,7,-2,2,0,-1,-3,2,-1,0,0,1,-2,5,-1,2,2,-1,1,2,0,2,2,0,0,0,0,0,0,-1,1,2,0
16,16066,Casasimarro,3057,15,8,7,6,3,3,0,-16,10,11,1,10,-2,-2,5,5,0,2,2,-14,5,6,1,8,0,1,5,0,0,0,0,1,2,0,0,0,0,0,3,0,0,0,12,9,3,17,10,7,3,11,3,-2,-1,-3,3,4,2,3,-2,-2,0,7,1,-5,1,-1,1,10,5,0,0,0,1,4,4,0,0,0,0,6,1,0,0,0,22,7,15,4,1,3,4,3,6,4,7,-2,-1,3,0,1,3,2,5,0,6,3,4,-4,2,2,0,0,1,-1,0,1,0,0,0,0,2,1,0,0,1,-1,21,7,14,14,9,5,1,3,7,0,5,4,0,2,1,-2,4,2,1,1,6,2,1,2,3,1,7,1,1,1,2,0,5,1,0,1,1,1,2,0,1,0,27,8,19,14,6,8,2,6,9,11,0,-2,0,6,4,2,-1,-3,2,0,5,9,1,1,0,6,3,5,0,0,0,3,1,2,0,0,0,3,2,3,0,0,42,30,12,29,22,7,6,9,22,6,-1,1,6,2,17,8,-3,0,0,7,5,-2,2,1,4,9,12,4,0,0,4,4,10,4,0,0,0,5,2,0,0,0,57,35,22,46,26,20,9,23,9,7,6,3,8,14,4,4,3,2,1,9,5,3,3,1,6,20,16,3,1,0,4,12,8,2,0,0,2,8,8,1,1,0,91,70,21,100,59,41,4,61,18,11,8,-13,1,45,11,9,7,-4,3,16,7,2,1,-9,7,51,19,19,4,0,4,31,11,11,2,0,3,20,8,8,2,0,166,89,77,83,38,45,37,25,66,25,7,1,20,11,37,16,1,2,17,14,29,9,6,-1,18,13,37,12,3,-1,10,7,18,3,0,-1,8,6,19,9,3,0,45,26,19,52,26,26,24,4,13,3,4,-6,11,2,13,1,2,-5,13,2,0,2,2,-1,17,15,14,3,-1,0,7,7,10,-1,0,0,10,8,4,4,-1,0,-20,-24,4,6,-2,8,3,-5,-15,-6,11,-8,-3,-7,-13,-1,5,-4,6,2,-2,-5,6,-4,3,-4,5,-1,2,0,1,-4,2,-2,1,0,2,0,3,1,1,0,-16,-12,-4,2,0,2,0,-6,-11,-1,-3,4,1,-3,-13,1,1,1,-1,-3,2,-2,-4,3,1,2,-3,2,-2,2,1,-1,-3,3,-1,1,0,3,0,-1,-1,1,-89,-51,-38,-10,-10,0,-22,-19,-25,-15,-1,-6,-8,-8,-16,-11,-3,-3,-14,-11,-9,-4,2,-3,5,-1,-9,-3,-3,0,4,-2,-6,-3,-3,0,1,1,-3,0,0,0,-4,-10,6,-40,-28,-12,9,5,-25,1,3,2,7,-3,-15,-1,1,1,2,8,-10,2,2,1,-8,-5,-18,-8,-2,0,-5,-4,-14,-4,-1,0,-3,-1,-4,-4,-1,0,-36,-19,-17,-6,-4,-2,-13,-14,-5,-8,-6,9,-8,-8,3,-4,-4,2,-5,-6,-8,-4,-2,7,1,-4,-2,0,-2,-1,1,-4,0,-1,-1,0,0,0,-2,1,-1,-1,-14,3,-17,-9,-6,-3,2,-4,-6,-10,2,-2,2,-2,5,-8,1,1,0,-2,-11,-2,1,-3,-1,2,-7,-7,0,0,0,2,-2,-8,-1,0,-1,0,-5,1,1,0,-33,-23,-10,-12,-13,1,-9,-7,-4,-11,0,-2,-7,-5,-8,-4,1,0,-2,-2,4,-7,-1,-2,-3,3,-4,-7,0,-1,-4,0,-4,-5,0,0,1,3,0,-2,0,-1,33,21,12,14,9,5,0,8,21,0,2,1,0,2,10,0,6,2,0,6,11,0,-4,-1,3,3,5,3,-2,0,0,3,3,2,0,0,3,0,2,1,-2,0
16,16078,Cuenca,45100,257,128,129,162,87,75,45,-25,123,78,0,38,18,-4,53,44,1,15,27,-21,70,34,-1,23,23,32,56,36,11,2,14,18,34,13,5,1,9,14,22,23,6,1,239,79,160,259,124,135,64,31,57,81,-4,7,30,12,10,29,-5,4,34,19,47,52,1,3,31,75,86,55,10,1,16,39,44,20,4,1,15,36,42,35,6,0,483,243,240,406,217,189,171,51,175,92,-27,16,88,23,93,40,-8,5,83,28,82,52,-19,11,89,114,109,68,14,6,51,59,62,34,6,3,38,55,47,34,8,3,880,394,486,414,205,209,229,167,273,115,59,31,127,73,123,31,25,12,102,94,150,84,34,19,105,124,101,57,18,4,61,60,48,23,11,1,44,64,53,34,7,3,1575,738,837,562,281,281,254,310,540,308,97,76,137,128,261,149,33,32,117,182,279,159,64,44,88,182,168,87,30,5,45,82,83,48,19,2,43,100,85,39,11,3,853,378,475,387,192,195,169,190,279,103,52,46,96,94,104,40,20,16,73,96,175,63,32,30,88,121,95,54,23,3,51,60,43,24,11,1,37,61,52,30,12,2,1463,793,670,913,472,441,267,382,468,253,62,30,122,199,266,156,30,14,145,183,202,97,32,16,152,256,281,179,37,5,70,120,156,102,19,3,82,136,125,77,18,2,1690,931,759,1038,561,477,288,433,477,353,77,40,150,238,266,210,48,5,138,195,211,143,29,35,165,307,300,195,51,9,78,163,175,110,26,3,87,144,125,85,25,6,1139,605,534,847,412,435,190,199,367,227,62,75,93,102,199,113,39,46,97,97,168,114,23,29,121,231,288,163,37,1,60,110,144,75,18,1,61,121,144,88,19,0,523,241,282,563,252,311,117,155,82,50,30,72,69,87,30,7,2,32,48,68,52,43,28,40,97,179,167,80,25,7,45,76,75,42,6,3,52,103,92,38,19,4,177,36,141,424,186,238,60,86,-26,35,-5,31,45,26,-19,-3,-26,12,15,60,-7,38,21,19,88,170,70,56,31,2,54,60,42,22,7,-2,34,110,28,34,24,4,149,17,132,168,65,103,44,27,-21,8,33,57,16,-3,-39,10,12,23,28,30,18,-2,21,34,52,72,9,12,9,7,24,19,11,1,3,3,28,53,-2,11,6,4,73,28,45,15,-14,29,41,-1,-60,-12,26,63,23,17,-59,-14,14,36,18,-18,-1,2,12,27,33,35,-32,-10,-14,-1,15,18,-44,-4,-3,1,18,17,12,-6,-11,-2,-123,-125,2,8,-13,21,-8,-15,-40,-29,-10,-20,-7,2,-61,-36,-3,-17,-1,-17,21,7,-7,-3,31,12,-16,-15,-4,-2,12,8,-19,-15,2,-2,19,4,3,0,-6,0,-133,-60,-73,154,50,104,32,-50,-87,-74,-7,46,33,-40,-40,-52,9,17,-1,-10,-47,-22,-16,29,54,41,11,23,12,4,23,8,5,8,-1,0,31,33,6,15,13,4,-14,-16,2,105,42,63,22,-31,-77,26,-9,42,22,-13,-73,21,3,15,0,-18,-4,5,-12,27,21,43,17,13,5,2,11,18,7,4,-2,2,10,25,10,9,7,0,-76,-53,-23,69,5,64,41,-42,-24,-89,-41,78,31,-2,-23,-69,-20,35,10,-40,-1,-20,-21,43,50,38,15,-23,-21,0,28,14,2,-25,-15,-3,22,24,13,2,-6,3,165,55,110,268,135,133,74,32,-28,16,14,57,43,19,-7,-8,-12,18,31,13,-21,24,26,39,58,68,60,45,17,16,34,36,36,20,3,4,24,32,24,25,14,12
16,16086,Fuente de Pedro Naharro,1215,0,4,-4,12,9,3,-2,-1,6,-3,2,-1,1,-1,6,-2,2,-1,-3,0,0,-1,0,0,1,4,6,1,0,0,0,3,5,1,0,0,1,1,1,0,0,0,34,28,6,37,32,5,-1,12,14,4,7,-2,-1,6,17,3,4,-1,0,6,-3,1,3,-1,3,8,20,5,1,0,2,7,19,4,0,0,1,1,1,1,1,0,27,15,12,29,18,11,1,14,6,3,3,0,0,9,2,1,3,0,1,5,4,2,0,0,3,15,9,2,0,0,2,9,5,2,0,0,1,6,4,0,0,0,22,11,11,38,25,13,5,0,13,0,3,-2,3,1,7,-1,0,-1,2,-1,6,1,3,-1,1,10,21,6,0,0,0,6,15,4,0,0,1,4,6,2,0,0,33,22,11,42,25,17,0,17,11,4,-1,1,-1,14,5,2,1,1,1,3,6,2,-2,0,5,16,15,5,0,0,1,13,8,3,0,0,4,3,7,2,0,0,22,19,3,52,33,19,1,11,12,1,0,-3,-3,8,14,-1,0,0,4,3,-2,2,0,-3,8,18,20,6,0,0,3,11,15,4,0,0,5,7,5,2,0,0,-7,-3,-4,41,25,16,-2,-6,-4,4,4,-1,-2,-6,-1,2,4,0,0,0,-3,2,0,-1,3,14,14,7,3,0,0,8,9,6,2,0,3,6,5,1,1,0,24,25,-1,56,40,16,7,16,-7,8,2,-2,5,9,1,9,3,-2,2,7,-8,-1,-1,0,6,22,8,16,4,0,4,12,7,14,3,0,2,10,1,2,1,0,36,18,18,33,23,10,3,3,12,12,5,2,1,1,10,5,1,0,2,2,2,7,4,2,2,12,11,6,2,0,1,8,9,4,1,0,1,4,2,2,1,0,9,5,4,13,9,4,7,0,-1,1,3,-1,4,4,-6,1,2,0,3,-4,5,0,1,-1,1,7,4,0,1,0,0,5,3,0,1,0,1,2,1,0,0,0,23,9,14,7,1,6,5,3,8,5,3,-1,5,-1,1,2,2,0,0,4,7,3,1,-1,0,2,3,1,1,0,0,0,0,0,1,0,0,2,3,1,0,0,19,12,7,11,6,5,2,11,-5,10,-4,3,2,6,-6,5,0,3,0,5,1,5,-4,0,0,4,2,3,0,0,0,2,2,1,0,0,0,2,0,2,0,0,-1,-1,0,3,1,2,-2,2,2,-2,4,-5,-1,0,3,-3,1,-1,-1,2,-1,1,3,-4,0,1,0,2,0,0,0,1,0,0,0,0,0,0,0,2,0,0,-38,-24,-14,-29,-22,-7,6,-5,-14,-17,-6,-2,5,-2,-10,-11,-5,-1,1,-3,-4,-6,-1,-1,0,-1,-13,-10,-5,0,1,-1,-8,-9,-5,0,-1,0,-5,-1,0,0,-37,-25,-12,-4,-6,2,-12,-7,-10,-5,1,-3,-8,-6,-4,-6,0,0,-4,-1,-6,1,1,-3,2,-3,-4,2,-1,0,1,-3,-2,-1,-1,0,1,0,-2,3,0,0,14,6,8,-7,-6,-1,-2,5,8,8,-2,-3,0,4,2,4,-2,-2,-2,1,6,4,0,-1,0,0,-5,0,-2,0,0,0,-4,0,-2,0,0,0,-1,0,0,0,-29,-7,-22,-9,-2,-7,-17,2,-2,-11,3,-4,-4,2,0,-9,5,-1,-13,0,-2,-2,-2,-3,-8,4,1,-6,1,-1,-1,3,2,-6,1,-1,-7,1,-1,0,0,0,6,8,-2,8,4,4,-4,13,1,-4,0,1,-2,8,0,1,2,0,-2,5,1,-5,-2,1,1,11,1,-6,0,0,1,7,-2,-3,1,0,0,4,3,-3,-1,0
16,16113,Iniesta,3814,168,98,70,206,129,77,-4,77,53,32,13,2,-8,50,28,19,10,1,4,27,25,13,3,1,8,84,66,40,7,1,4,53,37,28,7,0,4,31,29,12,0,1,48,36,12,83,49,34,22,20,14,3,-6,-6,15,5,16,5,-2,-3,7,15,-2,-2,-4,-3,21,31,22,9,0,0,12,15,15,7,0,0,9,16,7,2,0,0,-11,-25,14,70,28,42,14,-5,-10,-1,1,-8,-2,-2,-14,-2,0,-5,16,-3,4,1,1,-3,16,19,23,8,3,1,3,10,11,2,2,0,13,9,12,6,1,1,88,39,49,115,60,55,28,30,19,12,0,-1,12,15,7,6,0,-1,16,15,12,6,0,0,29,32,33,17,1,1,14,17,19,8,1,0,15,15,14,9,0,1,254,173,81,278,184,94,24,75,98,49,8,-2,11,54,69,32,7,-1,13,21,29,17,1,-1,15,98,94,60,7,0,6,60,69,40,6,0,9,38,25,20,1,0,-12,-25,13,83,45,38,17,-9,-4,-17,5,-3,10,-4,-16,-16,1,0,7,-5,12,-1,4,-3,22,17,23,11,9,0,13,11,10,5,5,0,9,6,13,6,4,0,24,23,1,106,61,45,13,14,9,-10,-1,4,12,10,8,-5,1,2,1,4,1,-5,-2,2,31,33,25,13,4,0,18,17,16,6,4,0,13,16,9,7,0,0,130,72,58,208,125,83,15,62,9,35,5,4,12,35,1,20,1,2,3,27,8,15,4,2,35,69,52,47,3,0,20,42,28,32,2,0,15,27,24,15,1,0,35,25,10,60,32,28,5,9,8,9,1,1,8,6,5,0,2,3,-3,3,3,9,-1,-2,7,27,16,9,-1,0,6,13,8,4,0,0,1,14,8,5,-1,0,4,-13,17,-5,-15,10,12,0,-2,-5,5,-3,8,-1,-5,-4,-5,-2,4,1,3,-1,10,-1,10,1,-12,-5,2,-1,8,-3,-9,-11,0,0,2,4,-3,6,2,-1,-130,-83,-47,-97,-61,-36,11,-15,-59,-56,-6,-7,-2,-17,-20,-33,-7,-4,13,2,-39,-23,1,-3,-2,-6,-33,-49,-5,-4,-3,-8,-12,-30,-6,-2,1,2,-21,-19,1,-2,-31,-19,-12,-27,-15,-12,-3,16,-21,-21,-5,0,-1,16,-15,-18,-3,0,-2,0,-6,-3,-2,0,-5,14,-18,-13,-8,0,0,8,-12,-9,-4,0,-5,6,-6,-4,-4,0,-37,-13,-24,-45,-30,-15,-4,-7,-14,-9,-5,2,2,4,-7,-11,-3,2,-6,-11,-7,2,-2,0,-6,6,-19,-16,-10,-1,-4,4,-10,-14,-7,0,-2,2,-9,-2,-3,-1,-106,-65,-41,-104,-64,-40,-4,-10,-29,-40,-21,-3,-5,-4,-19,-22,-14,-1,1,-6,-10,-18,-7,-2,-13,-11,-29,-35,-18,0,-7,-5,-21,-20,-12,0,-6,-6,-8,-15,-6,0,-51,-20,-31,-18,-10,-8,-18,-9,-19,-1,-3,-3,-12,-2,-5,-2,0,-1,-6,-7,-14,1,-3,-2,-8,-3,-10,4,-1,0,-5,-1,-6,2,0,0,-3,-2,-4,2,-1,0,-27,-15,-12,4,-3,7,-2,13,-25,-12,-7,6,-1,1,-12,-2,-7,6,-1,12,-13,-10,0,0,3,12,0,-10,-2,0,0,5,-4,-3,-2,0,3,7,4,-7,0,0,16,22,-6,11,14,-3,21,-7,-9,6,0,2,10,4,-10,11,4,0,11,-11,1,-5,-4,2,13,1,-4,-3,2,2,8,8,-7,1,3,1,5,-7,3,-4,-1,1,20,21,-1,25,19,6,-2,-3,8,0,16,1,-4,5,10,1,11,-2,2,-8,-2,-1,5,3,4,12,3,5,1,0,-2,9,6,4,2,0,6,3,-3,1,-1,0
16,16133,Mota del Cuervo,5445,132,94,38,123,87,36,0,34,39,45,9,5,-4,31,31,26,6,3,4,3,8,19,3,2,3,39,35,38,7,0,1,31,27,22,5,0,2,8,8,16,2,0,42,36,6,76,53,23,0,14,20,8,-2,3,2,12,14,8,-2,3,-2,2,6,0,0,0,1,19,36,20,0,0,1,13,27,12,0,0,0,6,9,8,0,0,60,52,8,81,48,33,3,24,10,20,1,1,3,16,11,16,3,2,0,8,-1,4,-2,-1,9,25,26,19,2,0,4,16,16,11,1,0,5,9,10,8,1,0,138,65,73,106,58,48,41,44,21,22,10,2,18,21,10,18,4,-2,23,23,11,4,6,4,21,37,29,15,4,0,8,23,16,9,2,0,13,14,13,6,2,0,95,49,46,118,71,47,10,23,15,33,5,9,3,8,9,23,3,3,7,15,6,10,2,6,14,34,40,20,4,6,9,21,22,15,2,2,5,13,18,5,2,4,133,71,62,127,64,63,29,42,35,18,11,-4,17,25,17,9,4,-1,12,17,18,9,7,-3,26,44,29,24,5,-2,14,22,15,11,3,-1,12,22,14,13,2,-1,129,71,58,150,88,62,10,35,43,20,10,6,11,18,23,8,7,2,-1,17,20,12,3,4,14,54,44,28,7,1,10,28,31,15,4,0,4,26,13,13,3,1,138,98,40,188,107,81,29,44,20,34,4,4,9,35,19,26,3,3,20,9,1,8,1,1,28,59,51,39,9,0,15,30,36,21,4,0,13,29,15,18,5,0,71,36,35,70,32,38,12,35,7,6,3,6,6,18,12,-2,-1,3,6,17,-5,8,4,3,12,22,15,14,7,-1,6,10,11,3,3,-1,6,12,4,11,4,0,2,0,2,16,4,12,3,-7,-5,13,0,-4,3,0,-5,5,-2,-2,0,-7,0,8,2,-2,3,1,3,7,2,0,0,4,0,1,0,0,3,-3,3,6,2,0,53,21,32,49,23,26,28,7,18,6,-7,2,15,0,10,-2,1,-4,13,7,8,8,-8,6,13,23,3,7,0,3,9,11,-3,2,4,0,4,12,6,5,-4,3,-29,-34,5,-50,-44,-6,4,-6,-12,-19,-4,7,6,-9,-17,-16,-2,4,-2,3,5,-3,-2,3,0,2,-18,-19,-14,-1,3,-1,-17,-19,-9,-1,-3,3,-1,0,-5,0,-60,-48,-12,-12,-16,4,-11,-7,-21,-14,-6,-1,-6,-6,-16,-15,-6,2,-5,-1,-5,1,0,-3,1,6,-5,-8,-6,0,1,0,-5,-6,-6,0,0,6,0,-2,0,0,4,-15,19,-24,-16,-8,-11,-2,-25,-20,-3,64,-9,-1,-8,-11,-4,18,-2,-1,-17,-9,1,46,0,-1,-5,-10,-8,-1,-1,-2,-2,-7,-4,0,1,1,-3,-3,-4,-1,-88,-54,-34,-44,-31,-13,-8,7,-40,-32,-19,4,-4,8,-26,-22,-13,3,-4,-1,-14,-10,-6,1,3,11,-19,-21,-19,1,2,7,-14,-12,-14,0,1,4,-5,-9,-5,1,-39,-7,-32,-13,-13,0,-3,-5,-15,-20,-6,6,2,-1,2,-10,-4,4,-5,-4,-17,-10,-2,2,5,3,-3,-15,-2,-2,4,3,-5,-13,-2,0,1,0,2,-2,0,-2,40,3,37,-22,-21,-1,11,-7,-18,1,4,47,4,-4,-9,0,-1,12,7,-3,-9,1,5,35,3,2,-15,-6,-5,-1,0,-2,-6,-7,-5,-1,3,4,-9,1,0,0,-30,-37,7,-52,-41,-11,16,-9,-9,-25,-10,5,8,-6,-7,-23,-10,0,8,-3,-2,-2,0,5,4,3,-17,-27,-12,-4,2,1,-13,-18,-9,-4,2,2,-4,-9,-3,0
16,16134,Motilla del Palancar,5149,18,10,8,33,16,17,-3,22,-1,-1,8,-6,-6,14,5,-5,7,-3,3,8,-6,4,1,-3,4,12,12,4,0,0,0,6,9,1,0,0,4,6,3,3,0,0,-6,-9,3,15,6,9,-8,0,6,-6,-1,2,-4,-3,2,-4,-2,2,-4,3,4,-2,1,0,2,5,2,5,0,0,0,2,1,3,0,0,2,3,1,2,0,0,44,21,23,3,1,2,7,9,5,5,2,13,1,5,2,3,2,6,6,4,3,2,0,7,1,2,0,0,0,0,0,1,0,0,0,0,1,1,0,0,0,0,68,42,26,5,6,-1,7,7,25,12,6,11,-3,12,13,9,3,8,10,-5,12,3,3,3,0,1,3,1,0,0,0,1,4,1,0,0,0,0,-1,0,0,0,55,47,8,67,33,34,24,6,23,-3,2,-2,17,9,15,4,2,-3,7,-3,8,-7,0,1,18,18,21,7,3,0,6,8,13,5,1,0,12,10,8,2,2,0,103,63,40,111,70,41,16,29,36,16,3,-2,2,12,29,13,2,2,14,17,7,3,1,-4,13,32,39,21,4,2,8,16,27,16,1,2,5,16,12,5,3,0,14,8,6,92,55,37,-5,24,-9,8,-7,4,-1,12,-6,10,-10,1,-4,12,-3,-2,3,3,18,32,17,22,1,1,12,17,12,13,-1,1,6,15,5,9,2,0,337,169,168,244,128,116,52,79,128,47,14,8,26,39,71,24,3,3,26,40,57,23,11,5,46,66,88,31,11,0,23,34,49,19,3,-1,23,32,39,12,8,1,163,110,53,145,92,53,9,79,54,16,-4,12,2,47,40,15,-1,9,7,32,14,1,-3,3,13,54,54,23,-1,0,7,35,29,18,1,0,6,19,25,5,-2,0,30,10,20,54,29,25,19,11,-13,12,7,-5,13,7,-19,2,4,-1,6,4,6,10,3,-4,13,25,2,7,4,1,8,13,1,2,2,1,5,12,1,5,2,0,-3,-9,6,14,5,9,-4,16,-4,-23,11,-2,-6,3,6,-20,7,-2,2,13,-10,-3,4,0,10,9,-6,-4,3,1,3,3,-2,-3,2,1,7,6,-4,-1,1,0,26,5,21,24,8,16,2,8,7,2,1,5,-11,6,7,-3,4,2,13,2,0,5,-3,3,1,7,9,3,1,1,-4,4,5,2,0,0,5,3,4,1,1,1,-74,-43,-31,28,10,18,-16,0,-10,-31,-12,-5,-7,2,-6,-23,-8,-1,-9,-2,-4,-8,-4,-4,3,11,5,8,1,0,2,4,3,1,0,0,1,7,2,7,1,0,-1,-7,6,20,9,11,-12,12,-18,20,-3,-1,-15,5,-14,20,-3,0,3,7,-4,0,0,-1,2,5,3,6,3,0,1,2,3,2,0,0,1,3,0,4,3,0,-16,-3,-13,17,8,9,5,-9,-8,0,-5,5,4,-1,-7,2,-2,3,1,-8,-1,-2,-3,2,5,5,3,4,-1,0,1,0,3,3,0,0,4,5,0,1,-1,0,5,-8,13,27,11,16,8,-2,-4,-5,1,-2,2,-5,-9,2,-1,-2,6,3,5,-7,2,0,5,7,8,2,4,0,0,1,5,4,1,0,5,6,3,-2,3,0,37,3,34,34,9,25,15,-5,13,6,1,4,5,-2,-1,0,0,-2,10,-3,14,6,1,6,12,10,7,5,0,0,4,4,2,0,-1,0,8,6,5,5,1,0,42,46,-4,29,17,12,22,-4,4,10,6,3,18,6,0,14,7,0,4,-10,4,-4,-1,3,4,9,1,12,1,2,3,3,3,6,2,0,1,6,-2,6,-1,2
16,16154,"Pedroñeras, Las",6429,118,111,7,178,150,28,-5,47,56,13,2,5,-5,47,55,9,2,3,0,0,1,4,0,2,8,66,77,24,3,0,4,59,68,17,2,0,4,7,9,7,1,0,292,254,38,316,268,48,9,112,131,41,0,-1,5,108,107,31,1,1,4,4,24,10,-1,-2,5,132,132,42,4,0,2,120,110,33,2,0,3,12,22,9,2,0,103,94,9,203,157,46,10,47,45,6,3,-10,10,44,39,0,5,-5,0,3,6,6,-2,-5,15,78,79,26,3,0,9,67,62,15,3,0,6,11,17,11,0,0,75,33,42,131,91,40,20,23,7,26,-5,3,12,13,-3,12,-2,0,8,10,10,14,-3,3,14,41,45,32,-1,0,7,33,32,20,-1,0,7,8,13,12,0,0,112,86,26,236,152,84,-3,56,50,9,6,-4,-2,45,36,10,2,-3,-1,11,14,-1,4,-1,15,83,102,27,9,-1,9,57,64,17,5,-1,6,26,38,10,4,0,31,3,28,224,130,94,7,36,-25,12,4,-3,-1,21,-19,1,0,-1,8,15,-6,11,4,-2,17,80,76,36,11,1,7,47,47,19,6,1,10,33,29,17,5,0,137,87,50,283,183,100,3,72,35,23,-3,5,-1,49,19,14,2,2,4,23,16,9,-5,3,18,119,91,50,4,1,9,74,60,34,5,1,9,45,31,16,-1,0,217,141,76,298,176,122,19,70,95,20,11,1,15,53,51,13,6,1,4,17,44,7,5,0,27,105,121,40,2,2,15,63,66,30,0,1,12,42,55,10,2,1,213,154,59,259,154,105,13,71,69,35,9,12,0,46,66,28,5,6,13,25,3,7,4,6,22,86,91,48,9,1,6,51,60,31,5,0,16,35,31,17,4,1,56,52,4,149,105,44,-1,11,30,24,-4,-6,2,19,15,21,-4,-2,-3,-8,15,3,0,-4,12,39,67,26,2,1,6,33,45,18,2,0,6,6,22,8,0,1,-36,-33,-3,99,64,35,12,9,-47,-9,0,-1,9,0,-32,-10,1,0,3,9,-15,1,-1,-1,19,34,26,15,4,0,13,17,19,12,3,0,6,17,7,3,1,0,7,25,-18,69,41,28,3,7,-13,13,2,-1,-1,8,9,7,6,-2,4,-1,-22,6,-4,1,11,19,19,16,4,0,4,11,12,10,4,0,7,8,7,6,0,0,-13,-8,-5,48,28,20,13,-6,-9,-7,-1,-2,8,0,-9,-8,2,-1,5,-6,0,1,-3,-1,10,13,13,6,2,2,4,8,9,4,1,1,6,5,4,2,1,1,15,12,3,35,17,18,14,0,-6,7,4,-5,7,-1,4,2,2,-2,7,1,-10,5,2,-3,6,10,6,8,3,1,3,4,3,5,2,0,3,6,3,3,1,1,62,14,48,67,38,29,16,23,5,12,5,0,-2,9,6,1,1,-1,18,14,-1,11,4,1,9,22,17,15,4,0,3,13,10,9,3,0,6,9,7,6,1,0,-39,-38,-1,45,19,26,9,3,-32,-4,-11,-1,6,3,-17,-14,-11,-1,3,0,-15,10,0,0,8,17,7,8,3,1,4,9,3,2,1,0,4,8,4,6,2,1,-28,-27,-1,43,15,28,2,10,-17,-22,3,-3,4,5,-19,-17,2,-1,-2,5,2,-5,1,-2,8,13,14,4,3,0,2,6,7,-1,1,0,6,7,7,5,2,0,28,26,2,58,30,28,13,6,-12,12,5,3,9,7,-3,12,-1,0,4,-1,-9,0,6,3,7,20,11,14,2,3,3,12,7,7,0,0,4,8,4,7,2,3
16,16170,Priego,1026,23,15,8,25,17,8,0,7,8,5,3,0,2,4,5,2,2,0,-2,3,3,3,1,0,2,7,10,6,0,0,1,4,8,4,0,0,1,3,2,2,0,0,-5,-1,-4,12,9,3,-8,0,10,-3,-2,-3,-5,3,9,-3,0,-5,-3,-3,1,0,-2,2,0,1,10,1,0,0,0,1,7,1,0,0,0,0,3,0,0,0,47,28,19,62,42,20,3,15,19,4,11,-6,1,6,12,4,7,-3,2,9,7,0,4,-3,5,18,21,12,5,0,3,10,17,7,4,0,2,8,4,5,1,0,9,8,1,40,19,21,-7,11,10,-2,1,-3,-5,9,4,-1,0,1,-2,2,6,-1,1,-4,3,13,16,7,1,0,2,6,9,2,0,0,1,7,7,5,1,0,31,18,13,53,29,24,6,11,4,11,2,-3,1,7,3,9,0,-2,5,4,1,2,2,-1,3,18,11,20,1,0,0,11,7,11,0,0,3,7,4,9,1,0,54,30,24,60,32,28,11,8,8,20,4,1,7,2,7,11,1,1,4,6,1,9,3,0,10,19,13,15,2,0,4,9,9,8,1,0,6,10,4,7,1,0,7,3,4,52,27,25,-3,20,8,-16,-2,0,-4,9,3,-4,-2,0,1,11,5,-12,0,0,12,24,10,1,4,0,4,14,6,1,1,0,8,10,4,0,3,0,57,35,22,85,53,32,10,27,5,7,5,4,2,18,4,3,6,2,8,9,1,4,-1,2,17,27,27,11,1,1,10,18,17,5,1,1,7,9,10,6,0,0,-15,-12,-3,11,-1,12,-2,-3,-6,-4,-3,3,1,-6,-5,-2,-1,1,-3,3,-1,-2,-2,2,3,6,0,2,0,0,2,-3,-1,1,0,0,1,9,1,1,0,0,-9,-4,-5,-23,-13,-10,1,-6,1,-3,2,-4,-2,-4,3,0,-1,0,3,-2,-2,-3,3,-4,-3,-5,1,-10,-6,0,-2,-5,1,-4,-3,0,-1,0,0,-6,-3,0,15,9,6,-6,2,-8,8,-3,4,3,-1,4,6,-1,4,0,0,0,2,-2,0,3,-1,4,2,-3,-2,-1,-2,0,4,-1,0,0,-1,0,-2,-2,-2,-1,-1,0,-3,0,-3,-10,-8,-2,3,-7,0,-4,6,-1,7,-5,0,-5,3,-1,-4,-2,0,1,3,0,-2,-1,-2,-4,-1,-1,2,-1,-1,-6,-2,-1,-4,0,-1,2,1,0,-38,-21,-17,-6,-8,2,-5,-6,-11,-8,-5,-3,-4,-3,-4,-3,-4,-3,-1,-3,-7,-5,-1,0,-2,-1,-4,1,0,0,-3,-2,-4,1,0,0,1,1,0,0,0,0,-28,-19,-9,-23,-13,-10,2,-3,-10,1,-10,-8,2,0,-9,-1,-4,-7,0,-3,-1,2,-6,-1,-3,-3,-12,0,-5,0,-2,1,-8,-2,-2,0,-1,-4,-4,2,-3,0,-19,-1,-18,-1,-1,0,2,-3,-7,-8,2,-7,5,-1,-2,-1,1,-2,-3,-2,-5,-7,1,-5,3,0,-4,-1,0,0,1,0,-2,0,0,0,2,0,-2,-1,0,0,-40,-24,-16,-21,-13,-8,-9,-2,-10,-14,-2,-2,-4,-3,-7,-8,-1,0,-5,1,-3,-6,-1,-2,-3,1,-9,-11,1,0,0,1,-7,-8,1,0,-3,0,-2,-3,0,0,-11,-4,-7,-4,2,-6,-3,1,-5,-8,2,1,-1,1,-2,-4,0,2,-2,0,-3,-4,2,-1,-2,2,3,-6,-1,0,0,3,0,-1,0,0,-2,-1,3,-5,-1,0,-9,0,-9,2,1,1,-1,-2,-4,2,-3,-3,0,0,-2,1,0,-1,-1,-2,-2,1,-3,-2,0,0,0,1,0,0,0,0,0,0,0,0,0,0,0,1,0,0
16,16175,Quintanar del Rey,6158,220,144,76,198,134,64,11,71,78,53,8,0,5,45,53,36,6,-1,6,26,25,17,2,1,11,63,72,44,7,1,4,44,48,32,6,0,7,19,24,12,1,1,177,118,59,209,135,74,17,56,65,36,5,-4,9,42,38,27,3,-2,8,14,27,9,2,-2,22,59,73,44,8,0,10,45,46,29,4,0,12,14,27,15,4,0,259,176,83,298,189,109,41,99,81,30,8,0,24,66,61,20,7,-3,17,33,20,10,1,3,54,99,89,46,8,1,30,65,59,28,6,0,24,34,30,18,2,1,213,163,50,262,184,78,12,92,71,28,9,3,3,73,59,17,9,2,9,19,12,11,0,1,28,97,87,46,2,1,15,71,67,28,3,0,13,26,20,18,-1,1,23,3,20,99,60,39,15,19,-24,12,2,-1,11,3,-10,2,-1,-1,4,16,-14,10,3,0,14,29,36,14,6,-1,8,17,26,7,2,-1,6,12,10,7,4,0,194,114,80,223,138,85,31,68,48,29,16,0,11,40,35,16,10,-2,20,28,13,13,6,2,31,62,67,51,12,0,10,39,49,32,8,0,21,23,18,19,4,0,235,157,78,266,171,95,49,78,65,38,3,-2,30,46,51,25,2,0,19,32,14,13,1,-2,46,82,96,35,5,1,29,50,65,23,3,0,17,32,31,12,2,1,249,156,93,309,178,131,41,90,81,40,0,-5,16,55,58,28,0,-2,25,35,23,12,0,-3,54,99,98,53,2,0,24,57,63,32,0,0,30,42,35,21,2,0,-4,-10,6,96,42,54,17,6,-25,-9,7,-1,12,12,-25,-14,3,0,5,-6,0,5,4,-1,32,24,27,4,8,0,15,17,9,-2,3,0,17,7,18,6,5,0,-49,-32,-17,42,14,28,-2,8,-41,-17,2,-6,2,9,-20,-20,-1,-2,-4,-1,-21,3,3,-4,10,27,-4,2,2,3,9,13,-5,-2,-1,0,1,14,1,4,3,3,-40,-30,-10,44,26,18,-4,12,-23,-17,-6,-2,5,-4,-22,-5,-3,1,-9,16,-1,-12,-3,-3,6,21,7,10,0,-1,4,7,2,14,1,-2,2,14,5,-4,-1,1,-18,-18,0,14,10,4,1,5,-19,8,-4,-6,1,3,-19,-1,0,-1,0,2,0,9,-4,-5,-6,14,-3,8,1,0,-3,10,-3,5,1,0,-3,4,0,3,0,0,-4,-10,6,-18,-17,-1,12,28,-20,-22,-9,2,3,13,-16,-9,-4,2,9,15,-4,-13,-5,0,8,15,-13,-23,-7,-1,4,5,-8,-14,-5,0,4,10,-5,-9,-2,-1,-112,-55,-57,-11,-9,-2,-19,-19,-44,-14,-8,-5,-8,-9,-21,-8,-6,-2,-11,-10,-23,-6,-2,-3,0,2,-11,-1,-1,0,2,-1,-10,0,0,0,-2,3,-1,-1,-1,0,-47,-37,-10,-55,-39,-16,10,2,-29,-12,-14,-7,6,-3,-20,-9,-8,-4,4,5,-9,-3,-6,-3,4,1,-28,-14,-18,-3,2,0,-17,-13,-10,-2,2,1,-11,-1,-8,-1,14,17,-3,15,6,9,1,4,-8,13,-4,5,4,6,-5,6,2,1,-3,-2,-3,7,-6,4,2,6,0,4,1,1,2,3,-2,1,1,0,0,3,2,3,0,1,62,29,33,71,34,37,15,28,3,17,7,-5,4,11,6,10,4,-3,11,17,-3,7,3,-2,14,24,10,13,7,3,4,7,9,9,4,1,10,17,1,4,3,2,3,4,-1,54,28,26,5,11,-13,-2,-7,10,0,3,2,1,-5,3,5,8,-15,-3,-2,7,21,6,14,12,-1,1,11,4,10,5,-2,0,10,2,4,7,1,1
16,16203,Tarancón,11335,251,131,120,244,136,108,42,55,79,61,8,3,25,31,43,25,0,4,17,24,36,36,8,-1,28,63,82,60,10,0,19,39,48,27,3,0,9,24,34,33,7,0,107,62,45,184,87,97,27,18,39,18,3,2,19,7,29,4,2,1,8,11,10,14,1,1,40,41,50,40,11,2,20,20,24,19,3,1,20,21,26,21,8,1,276,142,134,304,167,137,32,71,103,41,11,13,-5,41,59,27,9,6,37,30,44,14,2,7,47,93,96,53,10,4,13,50,60,35,6,2,34,43,36,18,4,2,360,195,165,233,131,102,67,68,140,55,13,22,33,35,79,30,7,9,34,33,61,25,6,13,31,80,67,35,14,5,18,47,36,19,8,2,13,33,31,16,6,3,534,285,249,338,185,153,105,143,173,63,21,23,49,92,90,39,7,8,56,51,83,24,14,15,22,126,105,58,18,9,7,75,61,35,4,3,15,51,44,23,14,6,397,189,208,284,141,143,94,70,127,58,21,15,42,32,68,30,8,0,52,38,59,28,13,15,47,90,82,43,16,4,19,42,50,22,7,0,28,48,32,21,9,4,547,320,227,509,268,241,94,204,176,67,6,-2,46,121,118,36,2,-4,48,83,58,31,4,2,93,171,143,74,24,3,43,91,85,38,9,2,50,80,58,36,15,1,690,370,320,604,313,291,90,203,246,115,33,-5,28,102,153,71,11,2,62,101,93,44,22,-7,73,213,176,101,26,8,22,112,102,64,9,1,51,101,74,37,17,7,539,312,227,323,162,161,96,119,183,113,16,3,63,62,92,81,8,4,33,57,91,32,8,-1,62,84,97,61,12,2,37,45,47,29,3,0,25,39,50,32,9,2,72,35,37,185,83,102,14,37,8,16,0,-9,16,17,2,8,-7,-4,-2,20,6,8,7,-5,30,59,43,36,10,6,15,24,27,12,2,3,15,35,16,24,8,3,44,14,30,158,74,84,34,4,15,-2,-3,-6,23,2,-12,-4,7,-1,11,2,27,2,-10,-5,26,47,43,26,9,5,13,20,26,8,4,3,13,27,17,18,5,2,180,129,51,186,94,92,28,46,69,22,16,-2,18,31,64,19,-1,-3,10,15,5,3,17,1,29,56,57,30,11,2,13,27,36,14,4,0,16,29,21,16,7,2,1,10,-9,62,31,31,12,-22,-5,19,-4,-10,9,-4,-5,9,2,-4,3,-18,0,10,-6,-6,19,17,15,6,1,0,6,5,14,3,2,0,13,12,1,3,-1,0,-43,-36,-7,35,8,27,5,-12,-21,-26,5,4,10,-16,-19,-22,6,2,-5,4,-2,-4,-1,2,3,18,9,0,3,1,4,6,2,-3,-2,0,-1,12,7,3,5,1,5,-2,7,74,26,48,26,-17,0,9,-16,-5,11,-7,-5,6,-11,2,15,-10,5,3,-5,-7,19,13,21,9,3,1,6,1,9,6,0,1,13,12,12,3,3,0,-137,-85,-52,43,21,22,-32,-8,-40,-41,-20,0,-21,-8,-30,-14,-21,4,-11,0,-10,-27,1,-4,12,11,16,1,4,-2,5,8,10,-2,-1,0,7,3,6,3,5,-2,169,83,86,81,51,30,45,21,52,18,9,14,17,12,36,3,2,2,28,9,16,15,7,12,15,20,25,12,2,3,9,8,19,10,1,1,6,12,6,2,1,2,218,116,102,112,63,49,55,25,76,12,19,22,39,9,42,-1,12,12,16,16,34,13,7,10,28,28,32,12,8,1,20,15,21,1,4,1,8,13,11,11,4,0
16,16249,Villamayor de Santiago,2721,15,19,-4,20,16,4,-3,7,3,-1,2,7,3,7,5,1,1,2,-6,0,-2,-2,1,5,2,11,6,0,1,0,2,8,5,0,1,0,0,3,1,0,0,0,22,19,3,34,22,12,-2,6,8,-3,3,8,2,7,6,-1,1,4,-4,-1,2,-2,2,4,5,11,11,5,0,0,3,8,8,3,0,0,2,3,3,2,0,0,16,3,13,56,29,27,7,7,7,0,-1,-5,2,4,0,0,-1,-3,5,3,7,0,0,-2,21,9,15,8,2,0,9,4,8,5,2,0,12,5,7,3,0,0,68,39,29,65,31,34,9,19,13,6,6,9,4,10,9,5,3,4,5,9,4,1,3,5,9,24,20,7,1,0,3,10,12,3,0,0,6,14,8,4,1,0,56,34,22,98,59,39,1,20,22,12,4,-3,1,10,18,5,1,-1,0,10,4,7,3,-2,11,29,39,15,3,1,7,16,27,8,1,0,4,13,12,7,2,1,120,64,56,86,45,41,35,18,21,15,19,8,16,13,18,6,9,-1,19,5,3,9,10,9,31,17,25,9,1,2,16,10,15,2,1,1,15,7,10,7,0,1,61,45,16,99,57,42,5,34,16,9,1,-5,2,18,13,9,2,0,3,16,3,0,-1,-5,19,29,25,22,2,1,10,16,14,15,1,0,9,13,11,7,1,1,83,53,30,96,62,34,11,34,24,8,1,2,7,19,18,10,-3,0,4,15,6,-2,4,2,16,35,26,11,6,0,7,23,20,9,2,0,9,12,6,2,4,0,92,48,44,59,34,25,19,24,10,18,13,4,10,13,2,13,7,1,9,11,8,5,6,3,11,17,12,10,8,0,5,9,10,6,4,0,6,8,2,4,4,0,-1,1,-2,25,16,9,-3,7,-1,4,-2,-7,0,6,-2,1,-1,-4,-3,1,1,3,-1,-3,1,11,7,4,1,0,1,8,3,3,0,0,0,3,4,1,1,0,-12,-1,-11,31,18,13,0,4,-8,-12,0,3,1,6,-3,-9,-1,4,-1,-2,-5,-3,1,-1,8,9,8,3,2,0,4,6,5,2,0,0,4,3,3,1,2,0,-11,-5,-6,12,4,8,-3,1,-4,-4,3,-3,-1,3,-5,-1,2,-3,-2,-2,1,-3,1,0,4,6,1,2,-1,0,1,2,1,1,-1,0,3,4,0,1,0,0,-13,-7,-6,7,2,5,1,-2,-16,0,0,4,1,-1,-10,1,0,2,0,-1,-6,-1,0,2,0,5,1,1,0,0,0,0,1,1,0,0,0,5,0,0,0,0,-17,0,-17,5,3,2,8,-2,-7,0,-1,-16,4,1,-6,1,0,-1,4,-3,-1,-1,-1,-15,3,1,2,0,-1,0,3,0,1,0,-1,0,0,1,1,0,0,0,-10,2,-12,3,1,2,-3,-14,0,8,0,-1,1,-4,0,5,2,-2,-4,-10,0,3,-2,1,1,2,1,0,0,-1,1,0,0,0,0,0,0,2,1,0,0,-1,31,7,24,9,2,7,15,4,6,-1,-4,8,7,0,2,-3,-3,4,8,4,4,2,-1,4,3,2,2,3,-1,0,1,0,0,2,-1,0,2,2,2,1,0,0,4,4,0,13,9,4,1,-3,-4,4,-2,8,1,1,-3,4,-2,3,0,-4,-1,0,0,5,1,3,3,3,2,1,1,2,3,2,1,0,0,1,0,1,1,1,-7,-5,-2,10,6,4,-4,-5,-2,-4,-3,11,-3,-3,-2,-2,-3,8,-1,-2,0,-2,0,3,2,2,2,2,2,0,0,1,2,2,1,0,2,1,0,0,1,0
17,17007,Amer,2246,-1,-1,0,14,7,7,8,3,-2,-6,0,-3,4,3,0,-6,0,-2,4,0,-2,0,0,-1,6,3,2,3,0,0,3,3,0,1,0,0,3,0,2,2,0,0,6,6,0,6,5,1,-2,3,3,-1,0,2,2,2,1,0,0,0,-4,1,2,-1,0,2,2,1,1,1,0,0,2,1,1,0,0,0,0,0,0,1,0,0,9,4,5,6,3,3,0,1,3,4,2,-2,-2,-1,2,3,1,1,2,2,1,1,1,-3,1,1,1,3,0,0,1,1,0,1,0,0,0,0,1,2,0,0,0,-3,3,8,4,4,5,-1,-14,-3,4,8,6,3,-15,-3,5,1,-1,-4,1,0,-1,7,3,1,2,1,1,0,2,1,0,0,1,0,1,0,2,1,0,0,59,36,23,24,13,11,5,10,23,14,2,1,3,5,17,10,0,-2,2,5,6,4,2,3,1,6,11,3,1,1,1,4,5,2,0,0,0,2,6,1,1,1,29,15,14,24,9,15,3,3,6,9,6,1,2,1,3,5,3,0,1,2,3,4,3,1,6,4,8,5,1,0,3,2,1,3,0,0,3,2,7,2,1,0,40,22,18,27,9,18,-3,17,6,2,-1,13,2,12,4,-3,-1,7,-5,5,2,5,0,6,3,8,11,0,1,2,3,4,3,-2,0,1,0,4,8,2,1,1,26,-8,34,39,17,22,5,0,9,12,1,0,-8,1,-1,4,-2,-1,13,-1,10,8,3,1,2,9,17,7,3,1,0,7,7,2,1,0,2,2,10,5,2,1,28,21,7,16,9,7,1,7,14,7,2,-4,3,7,11,1,1,-2,-2,0,3,6,1,-2,2,4,5,4,1,0,1,2,4,2,0,0,1,2,1,2,1,0,-2,-6,4,10,4,6,4,0,-3,3,1,-4,1,-1,-5,1,1,-2,3,1,2,2,0,-2,0,6,6,1,-3,0,0,5,0,0,-1,0,0,1,6,1,-2,0,-18,-9,-9,2,0,2,-1,4,-12,-8,-1,-1,-1,1,-8,-2,-1,0,0,3,-4,-6,0,-1,-2,6,-4,1,-1,1,-1,1,-2,0,0,1,-1,5,-2,1,-1,0,6,-11,17,-5,-8,3,6,-2,2,-4,0,3,0,-5,-1,-8,2,0,6,3,3,4,-2,3,0,2,-4,-5,1,1,0,-1,-3,-6,1,1,0,3,-1,1,0,0,8,-3,11,14,3,11,2,13,-3,4,-5,-3,-1,4,-6,2,-2,0,3,9,3,2,-3,-3,1,6,3,2,1,1,1,1,-1,2,0,0,0,5,4,0,1,1,3,-6,9,14,7,7,5,-3,4,-5,4,-2,1,-4,-1,-2,2,-2,4,1,5,-3,2,0,5,2,3,2,2,0,2,0,1,3,1,0,3,2,2,-1,1,0,-21,11,-32,11,9,2,-4,2,-1,-6,-4,-8,0,9,5,-1,0,-1,-4,-7,-6,-5,-4,-7,1,4,3,3,0,0,0,4,2,2,1,0,1,0,1,1,-1,0,17,15,2,11,5,6,9,8,-7,2,2,0,7,6,0,2,-2,1,2,2,-7,0,4,-1,3,6,1,0,2,-1,3,3,-1,0,0,0,0,3,2,0,2,-1,-6,-7,1,-3,-6,3,7,2,6,-13,-3,-3,3,2,0,-6,-6,0,4,0,6,-7,3,-3,-2,1,-1,-1,1,-1,-2,1,-1,-2,-1,-1,0,0,0,1,2,0,21,19,2,11,6,5,0,2,9,7,7,-7,6,5,6,0,6,-5,-6,-3,3,7,1,-2,3,5,4,0,0,-1,2,4,0,0,1,-1,1,1,4,0,-1,0
17,17009,Arbúcies,4939,177,112,65,114,79,35,32,27,74,26,8,5,12,23,46,17,8,4,20,4,28,9,0,1,22,28,48,13,1,0,9,22,36,10,1,0,13,6,12,3,0,0,171,100,71,134,92,42,50,32,45,34,3,8,24,21,31,23,2,-1,26,11,14,11,1,9,37,33,48,15,1,0,21,25,33,12,1,0,16,8,15,3,0,0,243,183,60,230,162,68,30,60,86,55,5,6,14,46,68,51,2,1,16,14,18,4,3,5,34,58,82,48,3,2,12,45,61,40,0,2,22,13,21,8,3,0,246,155,91,165,109,56,33,50,98,42,9,16,25,35,61,23,4,7,8,15,37,19,5,9,24,51,56,28,4,1,14,39,35,19,2,0,10,12,21,9,2,1,217,148,69,244,159,85,28,72,79,22,1,12,10,47,65,20,-2,7,18,25,14,2,3,5,37,73,87,33,7,4,19,48,59,24,5,3,18,25,28,9,2,1,208,155,53,276,201,75,35,63,71,25,2,11,17,59,64,13,-2,3,18,4,7,12,4,8,46,78,102,36,10,2,24,62,85,26,3,0,22,16,17,10,7,2,149,58,91,190,100,90,57,23,32,23,12,4,21,15,20,-4,7,0,36,8,12,27,5,4,53,47,47,36,5,1,23,32,25,17,3,-1,30,15,22,19,2,2,223,113,110,236,136,100,53,65,61,33,2,4,21,37,28,20,2,0,32,28,33,13,0,4,57,74,64,43,0,-5,27,47,35,28,0,-3,30,27,29,15,0,-2,62,34,28,120,63,57,14,38,9,12,-8,-4,8,30,-5,8,-5,-1,6,8,14,4,-3,-3,22,46,38,10,1,2,14,28,20,1,0,0,8,18,18,9,1,2,55,15,40,95,41,54,24,31,7,0,-4,-7,19,7,-4,-4,-3,-1,5,24,11,4,-1,-6,33,32,15,8,3,1,23,10,2,3,1,1,10,22,13,5,2,0,-27,-30,3,-9,-14,5,22,-23,-24,-3,-1,0,13,-7,-31,-2,-1,-2,9,-16,7,-1,0,2,11,-5,-6,-9,2,-2,9,-2,-15,-7,1,0,2,-3,9,-2,1,-2,5,-11,16,55,22,33,9,-5,26,-17,-11,2,0,-9,16,-19,-2,3,9,4,10,2,-9,-1,17,17,31,-4,-6,-1,12,0,20,-9,-2,1,5,17,11,5,-4,-2,-232,-146,-86,-112,-96,-16,-51,-36,-72,-58,-6,-5,-22,-22,-53,-36,-7,-1,-29,-14,-19,-22,1,-4,-17,-6,-46,-34,-9,-1,-15,-10,-35,-31,-4,-1,-2,4,-11,-3,-5,0,-67,-38,-29,55,31,24,-20,-2,-3,-30,-8,-4,-8,-4,-3,-18,-2,-4,-12,2,0,-12,-6,0,11,13,22,3,2,2,7,6,11,3,3,0,4,7,11,0,-1,2,-175,-117,-58,-141,-101,-40,-22,-19,-70,-58,-22,13,-11,-13,-46,-38,-14,4,-11,-6,-24,-20,-8,9,-14,-1,-54,-55,-18,-1,-9,-5,-32,-40,-17,1,-5,4,-22,-15,-1,-2,57,39,18,42,23,19,17,4,18,11,-1,0,18,2,3,11,5,-2,-1,2,15,0,-6,2,15,11,7,9,-1,-1,14,2,-4,7,3,0,1,9,11,2,-4,-1,59,20,39,69,38,31,16,3,9,17,-2,13,9,-5,7,6,-4,5,7,8,2,11,2,8,20,9,21,21,-3,1,15,4,11,7,-1,2,5,5,10,14,-2,-1,124,81,43,91,63,28,25,13,21,33,12,18,19,10,11,22,11,6,6,3,10,11,1,12,15,19,28,26,-1,2,13,10,17,18,1,2,2,9,11,8,-2,0
17,17015,Banyoles,14985,205,120,85,289,182,107,-21,88,78,9,25,27,-20,56,61,8,11,5,-1,32,17,1,14,22,41,77,112,43,12,3,21,48,80,27,5,0,20,29,32,16,7,3,304,214,90,381,241,140,20,124,110,33,5,11,12,85,84,27,3,3,8,39,26,6,2,8,58,127,137,45,10,2,28,86,91,30,4,0,30,41,46,15,6,2,321,180,141,342,206,136,6,125,102,27,16,48,8,68,70,5,11,18,-2,57,32,22,5,30,50,114,99,54,12,10,28,69,64,32,7,5,22,45,35,22,5,5,228,131,97,295,153,142,34,84,52,24,14,18,14,58,34,13,4,6,20,26,18,11,10,12,72,80,87,33,14,4,35,46,48,21,2,1,37,34,39,12,12,3,379,231,148,379,220,159,37,126,134,36,28,17,16,74,100,18,13,13,21,52,34,18,15,4,53,117,130,49,16,7,25,65,91,25,8,4,28,52,39,24,8,3,342,210,132,381,230,151,86,108,80,12,24,33,65,74,46,5,8,15,21,34,34,7,16,18,83,132,93,51,17,4,56,79,55,29,9,2,27,53,38,22,8,2,272,110,162,287,143,144,29,67,91,18,10,62,21,25,44,-3,3,22,8,42,47,21,7,40,47,96,97,27,7,11,26,43,52,14,2,4,21,53,45,13,5,7,461,270,191,449,267,182,77,138,147,35,30,35,65,75,82,25,13,7,12,63,65,10,17,28,84,153,136,48,18,6,56,82,80,33,10,3,28,71,56,15,8,3,430,219,211,415,230,185,72,114,113,64,10,57,36,72,56,34,4,15,36,42,57,30,6,42,86,123,119,69,11,4,48,72,65,36,5,1,38,51,54,33,6,3,343,145,198,230,114,116,75,72,66,57,14,57,47,27,14,29,9,19,28,45,52,28,5,38,51,73,56,32,9,3,36,37,17,15,4,1,15,36,39,17,5,2,268,148,120,204,113,91,79,61,26,15,39,50,60,36,3,6,22,23,19,25,23,9,17,27,73,65,41,14,7,4,51,42,11,6,2,1,22,23,30,8,5,3,159,62,97,169,74,95,9,38,43,5,24,41,10,5,15,1,15,20,-1,33,28,4,9,21,42,64,34,17,6,2,28,25,9,9,2,1,14,39,25,8,4,1,22,-1,23,-77,-51,-26,-27,24,11,-20,0,32,-7,22,7,-26,-1,6,-20,2,4,6,1,26,-4,3,-24,-35,-9,-7,1,4,-17,-29,-7,-2,-5,-1,-7,-6,-2,-5,-226,-153,-73,-328,-202,-126,-22,-4,-99,-73,-51,11,-2,-10,-45,-61,-40,-2,-20,6,-54,-12,-11,13,-32,10,-129,-112,-48,-23,-13,-1,-75,-77,-26,-14,-19,11,-54,-35,-22,-9,-9,-34,25,-26,-26,0,13,0,-57,-8,9,37,18,-18,-27,-22,14,9,-5,18,-30,14,-5,28,-2,9,-12,-13,-13,5,3,-6,-8,-9,-8,3,-5,15,-4,-4,-5,2,12,-15,27,22,19,3,-6,23,-20,18,-22,17,3,3,-17,9,-18,1,-9,20,-3,9,-4,16,9,20,-5,15,-13,-5,12,9,-2,8,-8,-1,-3,11,-3,7,-5,-4,170,45,125,74,26,48,45,3,52,13,14,45,29,-15,12,8,4,11,16,18,40,5,10,34,23,17,33,-2,4,-3,19,-1,10,-5,4,-3,4,18,23,3,0,0,248,107,141,147,83,64,42,43,67,34,22,40,8,14,38,25,12,14,34,29,29,9,10,26,25,31,57,20,10,1,16,11,38,17,2,-2,9,20,19,3,8,3
17,17016,Bàscara,803,15,14,1,9,7,2,0,3,8,5,-2,2,0,5,5,4,0,1,0,-2,3,1,-2,1,1,2,4,2,0,0,1,2,2,2,0,0,0,0,2,0,0,0,15,7,8,10,5,5,1,5,3,2,6,-2,0,0,2,1,3,1,1,5,1,1,3,-3,1,2,4,2,1,0,1,1,2,1,0,0,0,1,2,1,1,0,9,2,7,10,5,5,7,3,-2,-1,0,1,4,2,-1,-3,0,0,3,1,-1,2,0,1,3,2,3,2,0,0,1,1,1,2,0,0,2,1,2,0,0,0,26,13,13,10,4,6,-4,6,9,5,10,1,-3,3,4,2,6,1,-1,3,5,3,4,0,0,3,5,1,1,0,0,2,2,0,0,0,0,1,3,1,1,0,4,6,-2,10,5,5,-1,8,-5,0,-1,3,0,5,1,0,-2,2,-1,3,-6,0,1,1,1,2,4,1,2,0,1,1,3,0,0,0,0,1,1,1,2,0,25,15,10,13,7,6,1,7,12,0,4,0,-2,6,10,-1,2,-1,3,1,2,1,2,1,0,2,9,1,0,1,0,0,5,1,0,1,0,2,4,0,0,0,25,17,8,8,6,2,5,7,3,5,3,2,7,5,0,5,0,1,-2,2,3,0,3,1,-1,6,3,-1,1,0,1,4,2,-1,0,0,-2,2,1,0,1,0,6,5,1,15,5,10,-5,7,7,1,-2,-2,-2,0,8,1,0,-2,-3,7,-1,0,-2,0,1,5,6,3,0,0,1,0,2,2,0,0,0,5,4,1,0,0,28,12,16,14,4,10,12,2,1,8,1,4,4,2,2,3,0,1,8,0,-1,5,1,3,7,1,2,4,0,0,3,1,-1,1,0,0,4,0,3,3,0,0,5,-4,9,0,-5,5,8,2,-7,4,-1,-1,6,0,-7,-2,0,-1,2,2,0,6,-1,0,1,0,-1,-2,1,0,1,-1,-4,-2,0,0,0,1,3,0,1,0,20,8,12,2,0,2,13,0,0,7,-1,2,5,3,-2,2,1,1,8,-3,2,5,-2,1,4,0,-2,0,0,0,1,0,-1,0,0,0,3,0,-1,0,0,0,-13,-14,1,-5,-3,-2,-6,-2,3,-6,-2,-1,-6,-4,1,-2,-4,0,0,2,2,-4,2,-1,-1,0,1,-2,-2,-1,0,-1,1,-1,-1,-1,-1,1,0,-1,-1,0,13,7,6,1,1,0,4,-3,4,4,4,0,6,0,0,2,0,-1,-2,-3,4,2,4,1,1,-1,0,-1,0,2,0,0,0,0,0,1,1,-1,0,-1,0,1,4,0,4,-1,-1,0,2,2,2,2,-3,0,-1,1,1,2,-2,0,3,1,1,0,-1,0,0,0,0,1,-2,0,0,0,0,0,-1,0,0,0,0,1,-1,0,-1,-6,5,10,4,6,1,8,-5,-6,1,-1,1,4,-7,-5,0,1,0,4,2,-1,1,-2,3,5,-1,1,2,0,3,2,-2,1,0,0,0,3,1,0,2,0,37,34,3,12,8,4,0,3,17,10,5,2,6,2,11,8,5,2,-6,1,6,2,0,0,2,2,6,1,1,0,1,1,5,0,1,0,1,1,1,1,0,0,1,-1,2,1,0,1,-1,1,3,-1,-1,-4,0,0,0,0,-3,-1,-1,1,3,-1,2,-3,0,1,1,-1,-1,0,0,0,0,-1,0,0,0,1,1,0,-1,0,7,3,4,6,2,4,0,3,15,-9,-5,2,0,1,8,-1,-6,0,0,2,7,-8,1,2,1,3,3,0,-1,0,1,1,1,0,-1,0,0,2,2,0,0,0
17,17013,Begur,3288,153,73,80,77,47,30,30,11,55,31,17,4,7,4,35,14,5,3,23,7,20,17,12,1,11,19,24,12,8,2,6,11,16,10,1,2,5,8,8,2,7,0,80,44,36,98,59,39,25,23,17,0,9,7,7,20,7,0,4,5,18,3,10,0,5,2,19,25,15,21,12,6,9,17,10,14,5,4,10,8,5,7,7,2,126,73,53,97,60,37,28,25,43,2,21,8,18,17,26,-1,12,2,10,8,17,3,9,6,18,19,25,19,14,2,11,13,15,10,9,2,7,6,10,9,5,0,110,65,45,92,56,36,14,12,24,18,28,13,7,10,13,7,17,10,7,2,11,11,11,3,11,20,24,8,21,7,8,11,16,6,10,4,3,9,8,2,11,3,123,67,56,115,58,57,11,-1,47,43,28,-7,0,3,28,27,12,-4,11,-4,19,16,16,-3,11,19,31,31,20,1,5,10,19,17,6,0,6,9,12,14,14,1,30,24,6,69,38,31,-3,-3,25,2,22,-12,2,1,12,4,10,-3,-5,-4,13,-2,12,-9,7,11,15,17,17,2,3,7,8,7,9,4,4,4,7,10,8,-2,73,34,39,82,41,41,9,19,6,7,21,11,6,10,-4,5,14,3,3,9,10,2,7,8,10,18,15,13,18,8,6,11,5,7,8,4,4,7,10,6,10,4,189,113,76,96,55,41,36,31,45,32,41,1,22,20,32,15,21,0,14,11,13,17,20,1,14,20,30,15,17,-1,10,11,17,7,10,-1,4,9,13,8,7,0,-51,-26,-25,27,11,16,-12,-4,-7,-10,-12,-2,-2,-4,-5,-5,-10,2,-10,0,-2,-5,-2,-4,12,3,7,1,4,0,9,0,4,-1,-1,0,3,3,3,2,5,0,-49,-44,-5,5,-10,15,-7,-21,-4,-17,3,3,-13,-8,-7,-15,-1,4,6,-13,3,-2,4,-1,2,3,-3,-3,5,1,-1,-2,-6,-3,1,1,3,5,3,0,4,0,-4,-12,8,18,9,9,3,-15,14,7,-5,-11,-4,-7,-2,10,-2,-8,7,-8,16,-3,-3,-3,8,4,0,0,6,-1,6,1,-2,0,3,0,2,3,2,0,3,-1,4,14,-10,18,6,12,18,0,-14,-2,3,-3,12,8,-2,-6,1,-1,6,-8,-12,4,2,-2,9,7,-2,-3,2,4,5,5,0,-7,-1,3,4,2,-2,4,3,1,-53,-32,-21,-40,-25,-15,-4,-13,-1,-6,-19,-8,-3,-3,-13,5,-12,-3,-1,-10,12,-11,-7,-5,-2,0,-12,-8,-14,-5,-2,1,-10,-3,-8,-3,0,-1,-2,-5,-6,-2,-50,-18,-32,-10,-5,-5,-14,-1,-16,-18,-4,1,-5,0,-2,-11,-2,1,-9,-1,-14,-7,-2,0,-3,6,-5,-6,-3,1,0,1,-3,-2,-1,0,-3,5,-2,-4,-2,1,-90,-45,-45,-58,-24,-34,0,-6,-21,-11,-8,-43,-1,-3,-10,-8,-1,-22,1,-3,-11,-3,-7,-21,4,-5,-10,-11,-3,-34,2,-3,-5,-6,2,-15,2,-2,-5,-5,-5,-19,-25,-20,-5,16,8,8,-8,-14,6,-15,15,-9,-2,-3,-7,-9,10,-9,-6,-11,13,-6,5,0,2,-6,2,3,18,-3,2,1,-1,0,9,-3,0,-7,3,3,9,0,15,0,15,2,-6,8,6,-7,17,-5,10,-5,1,0,4,-7,2,2,5,-7,13,2,8,-7,0,2,5,-6,8,-7,-2,1,0,-5,4,-4,2,1,5,-1,4,-3,-12,-1,-11,30,25,5,12,7,-1,-1,-8,-23,2,0,-1,-1,7,-7,10,7,0,0,-15,-16,11,11,6,12,0,-12,8,3,7,7,3,-4,3,8,-1,5,-3,-8
17,17019,Besalú,1983,7,6,1,8,6,2,-3,9,0,0,4,-2,0,3,4,-1,1,0,-3,6,-4,1,3,-2,3,1,2,2,0,0,2,1,2,1,0,0,1,0,0,1,0,0,80,46,34,30,10,20,20,6,15,25,6,8,10,6,9,13,7,1,10,0,6,12,-1,7,8,2,9,8,3,0,2,1,2,3,2,0,6,1,7,5,1,0,52,20,32,41,19,22,5,12,14,17,-3,3,2,2,5,11,-3,1,3,10,9,6,0,2,6,8,12,11,1,0,3,3,5,6,0,0,3,5,7,5,1,0,62,32,30,20,12,8,6,7,40,3,5,1,0,1,23,5,3,1,6,6,17,-2,2,0,3,1,13,3,0,0,2,0,8,2,0,0,1,1,5,1,0,0,62,33,29,40,16,24,12,7,19,21,-3,4,7,6,10,8,0,2,5,1,9,13,-3,2,5,7,18,8,1,0,2,2,7,5,0,0,3,5,11,3,1,0,49,20,29,28,13,15,16,-1,7,17,4,3,5,0,5,6,4,-2,11,-1,2,11,0,5,8,7,5,6,1,1,2,3,4,3,1,0,6,4,1,3,0,1,27,15,12,7,1,6,5,10,11,-1,-1,2,4,9,4,-3,0,2,1,1,7,2,-1,0,-2,3,5,0,1,-1,-3,2,1,0,1,0,1,1,4,0,0,-1,31,2,29,23,12,11,5,18,10,-9,1,4,1,4,7,-9,0,0,4,14,3,0,1,4,6,12,1,2,0,2,3,4,2,1,1,1,3,8,-1,1,-1,1,59,34,25,20,11,9,12,8,20,12,5,1,5,4,11,7,3,3,7,4,9,5,2,-2,2,5,7,5,0,1,1,4,5,0,0,1,1,1,2,5,0,0,6,0,6,-6,-9,3,-4,3,5,3,2,-3,-2,0,-1,2,4,-4,-2,3,6,1,-2,1,-3,2,3,-6,-2,0,-1,-1,-1,-6,1,-1,-2,3,4,0,-3,1,17,2,15,6,-4,10,2,0,-3,10,1,4,1,-2,-3,2,3,0,1,2,0,8,-2,4,-1,5,3,-2,1,0,1,0,-3,-2,0,0,-2,5,6,0,1,0,52,28,24,18,9,9,19,7,10,11,7,-2,12,3,6,4,3,0,7,4,4,7,4,-2,7,3,4,2,3,-1,5,1,1,0,2,0,2,2,3,2,1,-1,8,5,3,-4,-4,0,-6,-5,8,1,4,7,-2,-3,1,5,1,5,-4,-2,7,-4,3,2,-3,1,-2,-1,1,0,-2,2,-2,-1,-1,0,-1,-1,0,0,2,0,3,5,-2,0,2,-2,8,-1,4,-6,-2,0,8,0,3,-6,1,-1,0,-1,1,0,-3,1,2,2,-4,2,-2,0,2,0,-2,2,0,0,0,2,-2,0,-2,0,28,-2,30,9,-1,10,14,1,12,2,-1,2,8,0,-4,0,-5,0,6,1,16,2,4,2,2,5,3,-1,-1,1,1,1,0,-2,-1,0,1,4,3,1,0,1,-1,-6,5,15,3,12,1,4,0,-11,3,3,-7,2,-1,-2,2,1,8,2,1,-9,1,2,9,4,1,2,0,-1,2,1,0,0,1,-1,7,3,1,2,-1,0,20,13,7,8,5,3,7,-1,-4,16,-6,6,3,-3,4,8,-3,1,4,2,-8,8,-3,5,5,3,1,2,0,-3,2,0,2,2,1,-2,3,3,-1,0,-1,-1,40,16,24,25,11,14,8,5,5,6,8,7,3,1,0,1,7,4,5,4,5,5,1,3,7,4,11,-2,5,-1,3,1,5,-3,4,0,4,3,6,1,1,-1
17,17020,Bescanó,3159,63,30,33,12,6,6,25,1,25,8,4,1,9,3,12,1,5,0,16,-2,13,7,-1,1,4,1,6,1,0,0,3,1,2,0,0,0,1,0,4,1,0,0,120,47,73,9,4,5,19,19,41,34,3,2,3,10,12,19,1,2,16,9,29,15,2,0,2,1,3,3,0,0,1,0,2,1,0,0,1,1,1,2,0,0,108,54,54,20,10,10,21,7,33,28,4,5,6,6,17,12,3,3,15,1,16,16,1,2,6,3,9,1,1,0,3,2,5,0,0,0,3,1,4,1,1,0,113,55,58,32,16,16,29,7,49,17,9,-2,16,5,15,10,6,-1,13,2,34,7,3,-1,11,5,8,5,2,0,7,0,5,2,1,0,4,5,3,3,1,0,96,53,43,20,10,10,24,12,39,9,11,0,18,4,18,7,5,1,6,8,21,2,6,-1,3,5,6,5,1,0,2,2,4,1,1,0,1,3,2,4,0,0,85,42,43,33,12,21,10,11,32,13,12,3,6,3,18,9,3,0,4,8,14,4,9,3,6,7,10,4,3,3,2,3,4,2,0,1,4,4,6,2,3,2,230,125,105,20,11,9,42,25,84,36,7,22,22,7,44,29,3,11,20,18,40,7,4,11,3,2,11,4,0,0,2,0,5,4,0,0,1,2,6,0,0,0,92,40,52,15,8,7,4,0,44,12,12,13,-2,4,18,9,4,5,6,-4,26,3,8,8,2,4,4,2,2,0,1,2,4,0,1,0,1,2,0,2,1,0,166,91,75,28,12,16,39,26,35,41,13,9,25,15,21,14,10,5,14,11,14,27,3,4,12,4,4,4,2,2,6,3,1,0,1,1,6,1,3,4,1,1,97,43,54,-3,-6,3,25,11,37,14,6,2,11,8,16,5,1,1,14,3,21,9,5,1,1,1,-1,-4,0,0,-1,0,-1,-3,-1,0,2,1,0,-1,1,0,29,9,20,-20,-8,-12,3,-2,8,12,2,3,6,-1,1,3,-1,0,-3,-1,7,9,3,3,-7,-3,-4,-3,-1,-2,-3,-3,-1,-1,0,0,-4,0,-3,-2,-1,-2,98,50,48,10,4,6,26,4,50,-2,6,11,4,1,34,1,3,3,22,3,16,-3,3,8,5,4,-2,-1,3,1,2,3,-1,-2,1,1,3,1,-1,1,2,0,106,47,59,-12,-9,-3,24,9,45,11,7,6,6,9,18,5,5,2,18,0,27,6,2,4,3,-3,-5,-7,-2,2,2,-2,-4,-4,-2,1,1,-1,-1,-3,0,1,12,18,-6,3,1,2,-10,3,13,7,0,-1,1,2,5,7,1,2,-11,1,8,0,-1,-3,1,-1,2,0,0,0,0,-1,1,0,0,0,1,0,1,0,0,0,-64,-23,-41,-10,-6,-4,-19,-12,1,-9,-21,-7,-7,-8,9,-3,-11,-6,-12,-4,-8,-6,-10,-1,-7,3,-2,-1,-1,-2,-6,4,-1,-1,-1,-1,-1,-1,-1,0,0,-1,9,4,5,8,6,2,0,1,25,-4,-13,-2,-1,-2,10,3,-5,-2,1,3,15,-7,-8,0,2,5,1,-1,0,0,3,2,1,0,0,0,-1,3,0,-1,0,0,46,26,20,10,5,5,15,-3,27,2,-3,3,19,-1,10,0,-5,1,-4,-2,17,2,2,2,2,1,5,2,1,-1,3,1,2,-1,0,0,-1,0,3,3,1,-1,-1,9,-10,14,5,9,-10,4,3,10,-2,-8,-8,2,3,14,1,-2,-2,2,0,-4,-3,-6,2,4,5,1,1,0,2,2,1,1,-1,0,0,2,4,0,2,0
17,17022,"Bisbal d'Empordà, La",8182,-33,-16,-17,31,17,14,-17,-11,9,-11,5,-5,-9,-8,9,-7,0,1,-8,-3,0,-4,5,-6,6,10,10,4,1,0,3,5,8,1,0,0,3,5,2,3,1,0,-87,-29,-58,13,8,5,-12,-15,-42,-15,-1,-1,0,-5,-17,-6,-4,4,-12,-10,-25,-9,3,-5,3,3,2,3,2,0,2,1,2,2,1,0,1,2,0,1,1,0,149,81,68,49,22,27,30,33,59,38,-8,-11,8,14,38,23,-6,-3,22,19,21,15,-2,-8,9,17,14,6,0,3,2,8,6,6,0,0,7,9,8,0,0,3,263,137,126,192,99,93,25,84,81,44,7,22,23,34,47,25,-2,9,2,50,34,19,9,13,35,53,54,33,10,5,23,28,31,11,2,2,12,25,23,22,8,3,223,138,85,174,91,83,37,61,58,56,1,13,19,29,35,42,4,8,18,32,23,14,-3,5,36,60,39,28,6,4,21,33,16,14,4,3,15,27,23,14,2,1,181,82,99,222,114,108,40,70,51,8,15,-5,6,37,34,7,5,-7,34,33,17,1,10,2,55,65,55,31,10,3,28,36,29,17,4,-1,27,29,26,14,6,4,326,204,122,262,134,128,66,59,103,60,26,12,34,31,75,48,8,11,32,28,28,12,18,1,54,67,79,42,9,8,29,31,43,22,3,5,25,36,36,20,6,3,387,244,143,365,222,143,28,116,150,57,15,23,22,64,105,31,5,15,6,52,45,26,10,8,64,114,111,49,14,9,39,66,69,32,7,6,25,48,42,17,7,3,233,172,61,241,155,86,11,96,66,38,25,2,6,66,60,17,22,0,5,30,6,21,3,2,28,90,76,35,12,-1,18,55,56,21,6,-1,10,35,20,14,6,0,77,25,52,64,22,42,28,22,11,4,-4,5,26,6,-12,2,-6,4,2,16,23,2,2,1,28,25,25,-13,-1,-3,18,11,6,-11,-2,-1,10,14,19,-2,1,-2,-107,-85,-22,-77,-73,-4,-7,-28,-38,-29,-15,7,-12,-20,-32,-21,-3,1,5,-8,-6,-8,-12,6,7,-9,-31,-20,-17,-7,0,-9,-34,-19,-8,-3,7,0,3,-1,-9,-4,76,69,7,49,27,22,10,19,12,16,6,-2,25,11,9,8,8,3,-15,8,3,8,-2,-5,12,22,7,2,1,0,12,13,2,-2,0,0,0,9,5,4,1,0,26,-13,39,3,-14,17,23,0,-27,17,1,6,15,-1,-39,7,-3,4,8,1,12,10,4,2,14,6,-12,-5,-1,1,10,2,-15,-7,-5,1,4,4,3,2,4,0,-188,-123,-65,-160,-96,-64,-33,-13,-88,-36,-10,-8,-22,-7,-63,-22,-10,3,-11,-6,-25,-14,0,-11,-22,-13,-61,-40,-15,-9,-9,-8,-46,-23,-9,-1,-13,-5,-15,-17,-6,-8,-66,-73,7,-107,-71,-36,-28,2,-5,-39,7,-4,-22,-7,-13,-30,-1,-2,-6,9,8,-9,8,-2,-18,-4,-21,-42,-17,-4,-7,-9,-14,-28,-12,-1,-11,5,-7,-14,-5,-3,-44,-44,0,-25,-22,-3,-15,-4,-2,-27,-4,3,-23,-6,8,-23,-3,3,8,2,-10,-4,-1,0,-14,11,-2,-13,-4,-3,-10,5,1,-12,-2,-3,-4,6,-3,-1,-2,0,48,46,2,-22,-3,-19,24,7,-14,16,6,8,19,8,-8,21,0,6,5,-1,-6,-5,6,2,-5,12,0,-15,-7,-8,2,4,2,-1,-6,-5,-7,8,-2,-14,-1,-3,84,43,41,48,18,30,21,19,61,6,-5,-18,16,11,30,-5,-4,-7,5,8,31,11,-1,-11,3,23,21,7,-6,0,-1,10,12,1,-5,1,4,13,9,6,-1,-1
17,17023,Blanes,29615,431,177,254,22,8,14,30,73,80,52,112,75,14,28,40,10,57,23,16,45,40,42,55,52,5,3,1,2,8,3,0,0,1,1,6,0,5,3,0,1,2,3,414,209,205,36,20,16,35,45,68,72,88,103,26,16,41,33,51,42,9,29,27,39,37,61,9,2,11,6,6,1,7,1,8,1,3,0,2,1,3,5,3,1,484,232,252,-1,-5,4,48,61,85,123,88,77,7,35,55,60,46,23,41,26,30,63,42,54,7,-3,-4,1,-2,-1,1,0,-1,-2,-1,-2,6,-3,-3,3,-1,1,340,147,193,-10,-3,-7,27,61,83,22,75,70,15,33,27,0,51,16,12,28,56,22,24,54,1,1,-2,-5,2,-7,0,1,-3,1,3,-5,1,0,1,-6,-1,-2,958,509,449,833,490,343,81,274,275,97,132,105,38,158,174,50,52,42,43,116,101,47,80,63,125,238,261,119,52,29,63,151,169,66,23,12,62,87,92,53,29,17,870,561,309,797,525,272,84,247,295,65,97,77,41,151,249,43,45,27,43,96,46,22,52,50,86,244,270,125,50,17,50,161,210,75,22,6,36,83,60,50,28,11,1177,572,605,948,496,452,181,240,358,192,135,68,70,121,200,108,55,18,111,119,158,84,80,50,174,209,282,156,95,29,83,107,167,88,43,8,91,102,115,68,52,21,612,257,355,593,291,302,114,191,156,21,65,56,49,83,49,4,45,20,65,108,107,17,20,36,102,166,188,69,33,30,57,82,89,38,15,8,45,84,99,31,18,22,774,502,272,720,479,241,86,227,340,88,55,-23,53,135,238,60,17,-5,33,92,102,28,38,-18,114,208,297,84,25,-8,79,129,206,58,9,-2,35,79,91,26,16,-6,-113,-114,1,13,-14,27,51,31,-124,-43,-10,-29,56,23,-108,-62,-12,-17,-5,8,-16,19,2,-12,49,72,-70,-7,-22,-15,40,44,-57,-21,-17,-6,9,28,-13,14,-5,-9,-119,-61,-58,-8,-5,-3,38,38,-138,-70,-22,29,38,27,-88,-41,-21,18,0,11,-50,-29,-1,11,24,65,-38,-38,-31,-1,32,50,-48,-27,-20,2,-8,15,10,-11,-11,-3,-79,-40,-39,-99,-77,-22,53,2,-109,-57,-13,39,27,16,-48,-50,-2,12,26,-14,-61,-7,-11,27,44,33,-65,-61,-37,-21,28,16,-46,-51,-17,-11,16,17,-19,-10,-20,-10,-121,-89,-32,-240,-154,-86,-19,53,-73,-41,-19,-20,0,19,-39,-26,-22,-25,-19,34,-34,-15,3,5,-46,33,-93,-75,-47,-16,-25,9,-62,-42,-25,-10,-21,24,-31,-33,-22,-6,-280,-161,-119,-207,-129,-78,-54,-1,-123,-94,-15,6,-30,0,-71,-64,-10,13,-24,-1,-52,-30,-5,-7,-27,-2,-85,-71,-15,-14,-13,-5,-48,-57,-6,-4,-14,3,-37,-14,-9,-10,-71,-72,1,-22,-11,-11,30,22,-84,-74,42,-13,35,5,-81,-65,28,-2,-5,17,-3,-9,14,-11,8,36,-47,-38,9,4,16,23,-35,-29,8,2,-8,13,-12,-9,1,2,28,-5,33,-11,-10,-1,65,-14,-58,-15,37,2,33,-13,-36,-2,3,3,32,-1,-22,-13,34,-1,27,9,-18,-40,4,0,26,-1,-15,-25,0,2,1,10,-3,-15,4,-2,-11,-13,2,75,9,66,6,40,-16,-33,17,-16,5,24,-12,-35,10,-4,1,16,-4,2,7,-12,54,12,18,-11,-1,-4,24,15,8,-28,-13,-1,30,-3,10,17,12,-3,197,85,112,126,26,100,65,26,-6,2,59,38,28,27,-21,-22,47,18,37,-1,15,24,12,20,46,43,12,12,9,0,22,26,-5,-16,0,-4,24,17,17,28,9,4
17,17027,Breda,3325,60,25,35,11,7,4,14,9,20,2,8,7,8,2,6,1,4,4,6,7,14,1,4,3,0,6,2,3,0,0,0,3,1,3,0,0,0,3,1,0,0,0,40,20,20,27,15,12,6,5,15,7,2,4,-2,6,10,6,1,-1,8,-1,5,1,1,5,7,6,9,5,0,0,3,5,3,4,0,0,4,1,6,1,0,0,56,31,25,21,15,6,10,8,2,16,17,2,7,6,1,6,10,1,3,2,1,10,7,1,4,9,6,2,0,0,3,5,6,1,0,0,1,4,0,1,0,0,22,2,20,36,19,17,14,4,4,-2,-2,5,2,-1,3,-1,-3,2,12,5,1,-1,1,3,17,7,9,3,0,0,7,5,5,2,0,0,10,2,4,1,0,0,49,34,15,25,16,9,13,10,4,4,7,8,7,6,2,7,7,3,6,4,2,-3,0,5,4,6,6,5,2,2,3,5,4,3,0,1,1,1,2,2,2,1,41,27,14,17,13,4,19,7,14,-4,5,-1,16,3,6,0,3,-2,3,4,8,-4,2,1,4,3,8,0,1,1,4,2,7,0,0,0,0,1,1,0,1,1,38,12,26,15,4,11,-9,3,31,3,9,1,-9,1,15,-2,8,-1,0,2,16,5,1,2,1,3,5,5,1,-1,0,0,2,2,1,-1,1,3,3,3,0,0,34,27,7,42,28,14,16,26,-8,13,-9,-5,14,16,-4,8,-6,-1,2,10,-4,5,-3,-4,14,16,8,4,0,0,11,10,5,2,0,0,3,6,3,2,0,0,22,8,14,31,15,16,-6,16,2,-7,12,3,-3,11,3,-13,6,2,-3,5,-1,6,6,1,2,14,10,2,0,1,3,8,5,-2,-1,1,-1,6,5,4,1,0,-15,-6,-9,2,0,2,-8,7,-23,10,2,-4,-4,-3,-14,11,3,0,-4,10,-9,-1,-1,-4,4,0,-1,-1,0,0,4,-1,-1,-2,0,0,0,1,0,1,0,0,23,3,20,9,4,5,14,-2,4,5,-3,2,4,-2,1,5,-4,-1,10,0,3,0,1,3,11,0,-3,3,0,-2,7,-2,-2,4,-1,-2,4,2,-1,-1,1,0,-6,-1,-5,14,6,8,7,-9,10,-2,-11,0,9,1,8,-8,-9,-2,-2,-10,2,6,-2,2,2,6,6,-2,1,1,3,3,2,-3,1,0,-1,3,4,1,0,1,-10,-17,7,0,-5,5,7,-6,-15,10,-4,1,4,-9,-12,8,-7,2,3,3,-3,2,3,-1,2,-1,-5,4,0,0,1,-1,-5,1,-1,0,1,0,0,3,1,0,19,8,11,5,3,2,11,1,0,-6,9,3,7,-4,3,-7,5,4,4,5,-3,1,4,-1,0,2,1,1,0,-1,-1,-1,5,0,0,0,1,3,-4,1,0,-1,-29,-13,-16,-2,-9,7,1,-5,-27,9,-9,-2,4,3,-22,2,0,-2,-3,-8,-5,7,-9,0,2,2,-8,0,1,0,2,-1,-11,0,1,0,0,3,3,0,0,0,20,1,19,5,0,5,6,8,14,-6,2,-7,2,7,-3,0,-1,-6,4,1,17,-6,3,-1,4,1,5,-4,-1,0,2,1,1,-4,0,0,2,0,4,0,-1,0,25,12,13,18,1,17,14,-5,0,-2,8,9,10,0,-2,-5,3,5,4,-5,2,3,5,4,8,5,5,2,-3,0,4,0,0,-1,-3,0,4,5,5,3,0,0,1,13,-12,13,6,7,-4,-2,-11,1,15,0,4,-3,-3,8,7,-2,-8,1,-8,-7,8,2,5,4,5,-1,0,0,4,2,1,-1,0,0,1,2,4,0,0,0
17,17030,Cabanes,777,-22,-5,-17,11,8,3,-9,-2,-9,1,-3,-1,-4,2,-3,2,-3,0,-5,-4,-6,-1,0,-1,0,4,4,3,0,0,0,3,3,2,0,0,0,1,1,1,0,0,11,3,8,10,3,7,2,6,5,0,-1,-2,0,1,3,-1,-1,0,2,5,2,1,0,-2,2,0,5,2,0,0,0,0,2,0,0,0,2,0,3,2,0,0,29,19,10,10,7,3,11,-3,15,2,2,-1,6,2,6,1,2,0,5,-5,9,1,0,-1,2,1,4,2,0,0,2,1,2,1,0,0,0,0,2,1,0,0,40,22,18,12,7,5,19,0,8,10,1,-1,11,3,2,7,0,-1,8,-3,6,3,1,0,3,2,4,1,0,1,2,2,1,1,0,1,1,0,3,0,0,0,30,18,12,12,8,4,4,11,5,10,-1,1,4,4,8,4,-2,0,0,7,-3,6,1,1,1,6,4,0,0,1,2,3,3,0,0,0,-1,3,1,0,0,1,19,8,11,24,11,13,-1,7,-2,11,3,1,-4,6,-2,6,2,0,3,1,0,5,1,1,3,7,7,5,2,0,2,4,3,1,1,0,1,3,4,4,1,0,0,8,-8,11,7,4,-4,-4,6,-7,6,2,-1,-2,6,0,5,0,-3,-2,0,-7,1,2,1,1,5,1,3,0,1,0,3,0,3,0,0,1,2,1,0,0,-21,-7,-14,10,7,3,-6,6,-6,-12,0,-4,-2,5,-3,-6,1,-2,-4,1,-3,-6,-1,-2,4,6,1,-1,0,0,2,4,1,0,0,0,2,2,0,-1,0,0,32,12,20,19,5,14,11,7,8,4,0,1,5,1,2,3,0,1,6,6,6,1,0,0,5,3,8,2,0,1,1,2,1,1,0,0,4,1,7,1,0,1,-14,-3,-11,11,8,3,-2,-8,-1,-2,-3,0,0,-5,2,1,-2,1,-2,-3,-3,-3,-1,-1,2,4,3,1,0,1,2,4,1,0,0,1,0,0,2,1,0,0,10,15,-5,9,6,3,1,0,-1,5,5,-2,2,-1,4,4,5,-1,-1,1,-5,1,0,-1,3,-1,1,3,2,0,2,-1,1,1,2,0,1,0,0,2,0,0,8,13,-5,-1,1,-2,0,6,5,-2,4,-4,3,5,4,0,2,0,-3,1,1,-2,2,-4,-3,1,3,-2,1,-1,-1,0,3,-1,0,0,-2,1,0,-1,1,-1,-5,-1,-4,2,1,1,4,-2,1,-6,-2,2,5,0,-4,-4,-1,3,-1,-2,5,-2,-1,-1,2,0,0,-1,2,0,1,0,0,-1,1,0,1,0,0,0,1,0,-1,8,-9,-7,-3,-4,-3,0,1,3,-1,0,0,0,5,4,-1,1,-3,0,-4,-1,0,-1,-2,0,0,-4,-1,0,-1,0,0,-2,0,0,-1,0,0,-2,-1,0,12,12,0,8,3,5,-8,4,5,1,8,1,-1,-1,2,6,4,1,-7,5,3,-5,4,0,0,3,1,1,1,1,0,0,0,1,1,0,0,3,1,0,0,1,-6,3,-9,12,5,7,-7,1,2,3,-6,1,-2,1,2,7,-6,1,-5,0,0,-4,0,0,2,4,1,3,2,0,1,0,1,2,1,0,1,4,0,1,1,0,-4,5,-9,9,6,3,-1,0,-4,0,3,-1,-1,0,3,1,4,-2,0,0,-7,-1,-1,1,1,3,0,3,2,0,0,1,2,1,2,0,1,2,-2,2,0,0,37,10,27,5,-1,6,6,8,8,15,-1,0,4,2,1,6,-3,0,2,6,7,9,2,0,-2,1,9,-2,-1,0,0,0,4,-4,-1,0,-2,1,5,2,0,0
17,17032,Cadaqués,2280,78,39,39,51,29,22,8,29,25,6,5,2,2,13,17,2,3,2,6,16,8,4,2,0,5,15,19,6,2,1,2,10,10,4,2,1,3,5,9,2,0,0,85,45,40,57,32,25,14,13,33,14,7,4,8,11,14,6,4,3,6,2,19,8,3,1,11,13,22,7,4,0,7,8,9,5,3,0,4,5,13,2,1,0,109,45,64,109,46,63,14,34,43,20,1,-4,4,14,23,11,-2,-4,10,20,20,9,3,0,21,33,30,19,6,-1,9,14,14,8,2,-1,12,19,16,11,4,0,133,66,67,111,51,60,24,36,32,29,11,2,7,13,21,17,6,2,17,23,11,12,5,0,21,27,32,18,12,1,6,11,18,9,7,0,15,16,14,9,5,1,104,54,50,108,48,60,3,33,49,6,7,8,5,13,23,3,5,5,-2,20,26,3,2,3,11,33,45,8,7,4,7,9,23,2,4,3,4,24,22,6,3,1,94,59,35,128,65,63,15,27,21,7,12,6,12,17,10,6,5,5,3,10,11,1,7,1,28,33,31,15,10,7,18,13,16,8,3,5,10,20,15,7,7,2,104,67,37,142,75,67,24,13,29,17,3,12,20,6,23,7,0,5,4,7,6,10,3,7,43,26,40,18,9,2,26,8,23,10,3,2,17,18,17,8,6,0,36,33,3,67,38,29,5,22,-7,0,5,5,3,18,-1,1,8,0,2,4,-6,-1,-3,5,14,22,23,3,1,2,4,14,16,2,2,0,10,8,7,1,-1,2,22,16,6,35,22,13,5,10,1,-9,13,2,8,6,-5,0,8,-1,-3,4,6,-9,5,3,13,10,0,2,10,0,14,6,-3,2,4,-1,-1,4,3,0,6,1,47,32,15,5,2,3,4,7,12,15,6,1,4,2,14,8,2,1,0,5,-2,7,4,0,-4,0,2,2,1,3,-1,1,-1,1,0,1,-3,-1,3,1,1,2,-11,-9,-2,-19,-14,-5,-10,-7,10,-3,0,1,-7,-5,3,0,1,0,-3,-2,7,-3,-1,1,-8,2,-7,-4,-1,-1,-5,-2,-5,-3,1,0,-3,4,-2,-1,-2,-1,2,-4,6,10,1,9,-1,-1,-5,1,5,3,-5,1,-1,2,0,-1,4,-2,-4,-1,5,4,1,1,2,-4,5,4,-1,1,1,-2,-1,2,2,0,1,-2,6,2,-21,4,-25,-11,-7,-4,2,2,-4,-10,-13,1,5,-2,7,-2,-6,1,-3,4,-11,-8,-7,0,4,2,-5,-9,-4,0,4,-2,1,-6,-5,0,0,4,-6,-3,1,0,-89,-61,-28,-73,-48,-25,-18,-5,-6,-21,-24,-14,-7,-4,-7,-15,-19,-7,-11,-1,1,-6,-5,-7,-14,2,-15,-23,-13,-10,-6,-1,-7,-17,-10,-7,-8,3,-8,-6,-3,-3,19,4,15,11,0,11,-2,15,15,-2,-1,-6,-6,5,11,-3,2,-5,4,10,4,1,-3,-1,2,10,-5,2,3,-1,-1,-1,-3,3,4,-2,3,11,-2,-1,-1,1,-28,-9,-19,-22,-16,-6,-14,1,-3,-1,-10,-4,-4,3,-6,1,-6,1,-10,-2,3,-2,-4,-5,-9,3,-8,-5,-2,-1,-3,2,-10,-1,-4,0,-6,1,2,-4,2,-1,33,15,18,47,21,26,3,10,1,5,15,3,-4,7,2,-2,13,2,7,3,-1,7,2,1,9,8,8,8,9,5,0,4,4,4,5,4,9,4,4,4,4,1,-34,-3,-31,-36,-8,-28,-11,3,-1,-20,-3,-1,-3,5,11,-10,-7,1,-8,-2,-12,-10,4,-2,-7,-4,-11,-12,0,-2,-3,0,1,-5,-1,0,-4,-4,-12,-7,1,-2
17,17034,Calonge,6663,284,162,122,159,101,58,26,48,61,60,56,27,16,29,44,28,32,11,10,19,17,32,24,16,9,30,44,23,32,17,6,24,30,14,15,10,3,6,14,9,17,7,439,249,190,261,148,113,55,62,128,81,83,22,30,35,71,48,53,10,25,27,57,33,30,12,37,43,79,49,38,14,18,21,50,28,24,7,19,22,29,21,14,7,462,246,216,280,161,119,95,56,123,75,93,18,49,30,64,44,51,10,46,26,59,31,42,8,46,51,87,39,38,15,23,29,58,20,21,9,23,22,29,19,17,6,535,281,254,246,125,121,94,77,145,118,74,17,56,38,75,65,33,8,38,39,70,53,41,9,54,40,45,48,48,7,27,21,22,24,28,2,27,19,23,24,20,5,365,202,163,256,130,126,5,46,113,86,80,33,-2,22,69,53,43,18,7,24,44,33,37,15,31,49,50,63,38,22,15,19,32,32,17,13,16,30,18,31,21,9,372,190,182,292,165,127,43,66,94,66,59,31,17,40,53,32,24,19,26,26,41,34,35,12,41,57,72,52,43,24,24,31,42,30,22,16,17,26,30,22,21,8,523,260,263,301,154,147,84,84,165,94,89,10,51,33,79,51,48,1,33,51,86,43,41,9,40,59,81,45,58,13,19,28,42,18,36,7,21,31,39,27,22,6,329,177,152,194,116,78,58,76,107,32,36,22,24,33,73,16,22,8,34,43,34,16,14,14,27,65,52,28,11,8,18,32,33,19,4,8,9,33,19,9,7,0,202,77,125,152,68,84,42,38,58,54,19,-11,15,19,16,25,8,-7,27,19,42,29,11,-4,34,37,54,20,7,-4,16,18,24,7,2,-3,18,19,30,13,5,-1,101,26,75,43,13,30,18,33,-16,26,26,17,8,14,0,-7,12,1,10,19,-16,33,14,16,10,24,-26,11,21,1,6,5,-13,0,12,2,4,19,-13,11,9,-1,12,-13,25,-58,-38,-20,0,-7,0,5,4,8,1,-6,-10,-10,6,6,-1,-1,10,15,-2,2,-17,-6,-13,-9,-10,-6,-9,-4,-12,-9,-3,-2,-8,-2,-1,0,-7,-4,99,51,48,47,9,38,33,-4,38,22,10,-2,12,-8,21,25,1,-4,21,4,17,-3,9,2,22,7,-5,4,12,5,7,-4,-4,0,5,4,15,11,-1,4,7,1,-153,-69,-84,-153,-94,-59,-20,-15,14,-37,-42,-56,-7,-1,9,-23,-25,-23,-13,-14,5,-14,-17,-33,-10,-5,5,-30,-40,-73,-5,-2,-1,-19,-27,-40,-5,-3,6,-11,-13,-33,-6,8,-14,-40,-33,-7,9,-12,-6,7,-12,5,6,-6,-7,6,4,4,3,-6,1,1,-16,1,0,-6,-18,-9,-10,-1,-1,-4,-13,-13,-3,-2,1,-2,-5,4,-7,1,20,-16,36,30,8,22,12,4,33,-15,-7,-8,4,-7,14,-6,-19,-2,8,11,19,-9,12,-6,23,4,0,-3,7,-2,9,-1,-1,1,0,-1,14,5,1,-4,7,-1,191,82,109,115,65,50,34,35,36,47,43,-13,15,11,10,22,27,-5,19,24,26,25,16,-8,25,15,19,33,20,0,14,8,7,20,14,0,11,7,12,13,6,0,135,74,61,39,19,20,35,15,36,30,7,5,19,11,29,17,-5,0,16,4,7,13,12,5,24,11,18,-1,-7,-8,13,7,10,-3,-6,-3,11,4,8,2,-1,-5,107,34,73,92,28,64,12,46,8,21,27,-12,4,16,-1,18,10,-16,8,30,9,3,17,4,14,18,27,7,24,-2,7,3,8,5,8,-5,7,15,19,2,16,3
17,17036,Campdevànol,3349,69,28,41,17,7,10,9,15,20,9,-4,19,3,6,6,8,-2,6,6,9,14,1,-2,13,3,7,5,2,0,0,1,2,3,1,0,0,2,5,2,1,0,0,-1,1,-2,10,7,3,4,-1,-13,1,-1,10,2,2,-7,0,-1,5,2,-3,-6,1,0,5,1,4,2,1,2,0,1,3,2,0,1,0,0,1,0,1,1,0,14,-3,17,3,4,-1,-1,-5,-1,4,5,12,3,-5,-1,-1,0,1,-4,0,0,5,5,11,1,0,-1,3,0,0,1,1,0,2,0,0,0,-1,-1,1,0,0,28,13,15,19,11,8,-5,10,3,3,3,14,-1,2,3,2,2,5,-4,8,0,1,1,9,5,5,5,2,1,1,4,3,3,0,1,0,1,2,2,2,0,1,81,44,37,16,12,4,12,11,25,13,4,15,6,7,11,6,5,8,6,4,14,7,-1,7,0,4,7,3,1,1,0,4,5,2,1,0,0,0,2,1,0,1,76,55,21,30,14,16,26,3,9,16,4,13,17,4,9,9,4,9,9,-1,0,7,0,4,3,6,8,8,1,3,1,2,6,3,1,1,2,4,2,5,0,2,47,37,10,25,17,8,2,11,-2,11,15,9,4,8,1,8,10,4,-2,3,-3,3,5,5,2,7,7,5,3,0,2,4,3,4,3,0,0,3,4,1,0,0,8,1,7,14,10,4,-3,12,-3,-8,2,8,-4,3,-2,-4,4,4,1,9,-1,-4,-2,4,3,3,6,3,-1,0,1,1,5,4,-1,0,2,2,1,-1,0,0,0,0,0,2,-1,3,6,-14,7,2,-6,0,6,-6,-1,0,-4,0,0,-8,8,2,-2,0,2,3,2,-4,-2,0,1,1,0,-2,-2,0,1,2,2,-2,0,0,11,1,10,3,1,2,9,4,-15,2,3,11,9,0,-10,-2,-1,7,0,4,-5,4,4,4,3,0,-1,2,0,-1,2,-1,-1,1,0,0,1,1,0,1,0,-1,9,2,7,11,8,3,-1,5,-3,1,-2,10,-1,2,-1,2,-3,3,0,3,-2,-1,1,7,3,3,4,2,-2,1,3,1,3,1,-1,1,0,2,1,1,-1,0,-4,1,-5,1,3,-2,-11,-4,-1,-11,8,12,-2,-5,2,-4,9,2,-9,1,-3,-7,-1,10,1,1,0,-3,1,1,1,1,2,-2,1,0,0,0,-2,-1,0,1,-7,-8,1,-11,-7,-4,-3,-8,-8,-16,1,24,-1,-3,-3,-14,1,8,-2,-5,-5,-2,0,16,-1,1,-2,-6,-1,-2,0,1,-2,-5,0,-1,-1,0,0,-1,-1,-1,-6,-7,1,-2,-4,2,-8,5,-5,-8,1,9,-6,0,-6,0,0,5,-2,5,1,-8,1,4,1,2,-5,-1,1,0,0,1,-4,-1,0,0,1,1,-1,0,1,0,-11,-3,-8,-7,-5,-2,0,-5,-8,10,-1,-6,4,-2,-1,3,-3,-3,-4,-3,-7,7,2,-3,-2,1,-5,0,-1,0,-1,0,-3,0,-1,0,-1,1,-2,0,0,0,-2,-3,1,4,6,-2,1,-1,4,-5,2,-3,0,3,1,-2,0,-5,1,-4,3,-3,2,2,0,3,-1,1,1,0,0,3,1,1,1,0,0,0,-2,0,0,0,-31,-27,-4,-3,-4,1,-7,-3,-14,-8,1,0,-6,0,-11,-5,-2,-3,-1,-3,-3,-3,3,3,1,-2,0,-2,-1,0,0,-1,-1,-1,-2,0,1,-1,1,-1,1,0,2,-11,13,-1,-6,5,3,-6,1,6,-3,2,-2,-6,-6,7,-3,-1,5,0,7,-1,0,3,1,1,-4,1,0,0,0,0,-5,-1,0,0,1,1,1,2,0,0
17,17041,Cantallops,264,2,1,1,2,1,1,1,0,1,0,0,0,1,0,1,0,0,-1,0,0,0,0,0,1,1,1,0,0,0,0,1,0,0,0,0,0,0,1,0,0,0,0,7,0,7,4,2,2,0,0,3,3,0,0,-1,0,1,-1,0,0,1,0,2,4,0,0,0,0,1,2,1,0,0,0,0,1,1,0,0,0,1,1,0,0,8,3,5,2,1,1,2,-2,6,0,2,0,2,0,2,-1,0,0,0,-2,4,1,2,0,0,0,0,0,0,2,0,0,0,0,0,1,0,0,0,0,0,1,3,3,0,2,1,1,-2,0,2,-1,3,1,-1,1,1,0,2,0,-1,-1,1,-1,1,1,0,0,0,0,2,0,0,0,0,0,1,0,0,0,0,0,1,0,8,6,2,2,1,1,-1,2,1,1,2,4,-1,0,1,1,1,4,0,2,0,0,1,0,0,0,2,0,0,0,0,0,1,0,0,0,0,0,1,0,0,0,14,10,4,11,5,6,3,5,4,3,0,-1,2,2,3,3,0,0,1,3,1,0,0,-1,2,2,3,2,2,0,1,0,2,1,1,0,1,2,1,1,1,0,18,11,7,13,7,6,2,5,4,9,1,-1,1,3,2,5,1,-1,1,2,2,4,0,0,3,2,2,6,0,0,2,1,0,4,0,0,1,1,2,2,0,0,20,9,11,6,5,1,3,4,0,5,3,2,2,1,1,1,1,2,1,3,-1,4,2,0,0,0,3,2,1,0,0,0,2,2,1,0,0,0,1,0,0,0,3,4,-1,7,3,4,2,-3,5,-1,2,-2,2,-1,3,1,0,-1,0,-2,2,-2,2,-1,2,0,5,0,0,0,0,0,3,0,0,0,2,0,2,0,0,0,0,1,-1,4,3,1,-4,3,-1,0,1,0,-3,1,1,-1,2,0,-1,2,-2,1,-1,0,1,0,1,1,0,0,0,0,1,0,1,0,1,0,0,1,-1,0,5,5,0,5,4,1,-4,0,0,3,3,3,-1,-1,-1,6,1,1,-3,1,1,-3,2,2,0,0,2,3,0,0,0,0,1,3,0,0,0,0,1,0,0,0,16,8,8,6,2,4,8,2,4,4,0,-2,2,1,3,2,1,-1,6,1,1,2,-1,-1,1,2,1,0,2,0,0,1,0,0,1,0,1,1,1,0,1,0,3,0,3,6,3,3,3,-3,3,0,2,-2,0,-1,2,1,0,-2,3,-2,1,-1,2,0,2,0,1,0,3,0,0,0,1,0,2,0,2,0,0,0,1,0,3,0,3,-2,-1,-1,2,1,0,1,0,-1,0,0,1,-1,0,0,2,1,-1,2,0,-1,-1,0,-1,0,0,0,-1,0,0,0,0,0,0,0,-1,0,0,0,4,1,3,-4,-4,0,1,1,-1,1,1,1,2,0,-3,0,1,1,-1,1,2,1,0,0,-1,1,-3,-2,0,1,0,0,-3,-2,0,1,-1,1,0,0,0,0,-4,-2,-2,9,5,4,0,1,-1,-2,-2,1,0,1,1,-3,-2,1,0,0,-2,1,0,0,4,0,2,1,1,1,2,0,1,0,1,1,2,0,1,1,0,0,13,6,7,0,0,0,3,0,4,3,3,0,1,-1,2,4,0,0,2,1,2,-1,3,0,0,0,-1,1,0,0,-1,0,0,1,0,0,1,0,-1,0,0,0,-1,-2,1,11,5,6,0,-1,-1,1,0,-1,0,-1,0,-1,0,0,0,0,-1,2,0,-1,5,0,2,2,1,0,4,0,1,0,0,0,1,0,1,2,1,0
17,17042,Capmany,407,10,2,8,9,4,5,1,-1,7,-2,3,2,1,-1,3,-3,1,1,0,0,4,1,2,1,2,0,5,1,1,0,1,0,2,0,1,0,1,0,3,1,0,0,27,6,21,7,2,5,5,1,9,4,7,1,-1,0,3,1,4,-1,6,1,6,3,3,2,1,1,1,3,0,1,0,0,1,0,0,1,1,1,0,3,0,0,-13,-1,-12,1,2,-1,-17,1,-1,-1,5,1,-10,2,4,-1,4,0,-7,-1,-5,0,1,1,0,1,1,0,-1,0,0,1,1,0,0,0,0,0,0,0,-1,0,7,6,1,8,6,2,-6,-1,3,5,5,1,-5,0,4,2,3,2,-1,-1,-1,3,2,-1,1,1,2,2,1,1,1,1,2,0,1,1,0,0,0,2,0,0,7,8,-1,9,8,1,-4,0,0,3,3,6,0,0,1,3,2,3,-4,0,-1,0,1,3,0,1,2,4,1,1,0,0,2,4,1,1,0,1,0,0,0,0,14,3,11,17,8,9,0,3,7,1,1,1,-1,-1,2,-1,2,1,1,4,5,2,-1,0,2,2,6,4,2,1,1,0,3,1,2,1,1,2,3,3,0,0,21,14,7,13,8,5,3,0,9,7,4,-2,0,-1,8,5,4,-2,3,1,1,2,0,0,0,2,4,3,4,0,0,0,3,3,2,0,0,2,1,0,2,0,44,34,10,21,17,4,9,5,16,11,7,-5,8,5,9,8,6,-3,1,0,7,3,1,-2,2,4,6,4,5,0,2,4,4,3,4,0,0,0,2,1,1,0,29,13,16,7,5,2,7,3,10,2,7,0,3,0,4,0,5,0,4,3,6,2,2,0,0,0,1,2,3,0,0,1,1,0,2,0,0,-1,0,2,1,0,23,11,12,2,1,1,5,4,12,-1,2,1,3,1,7,-1,0,1,2,3,5,0,2,0,0,0,2,0,0,0,0,-1,2,0,0,0,0,1,0,0,0,0,-6,3,-9,0,6,-6,-5,1,-5,2,1,0,-3,3,-2,4,1,0,-2,-2,-3,-2,0,0,-2,0,0,0,0,2,0,1,0,3,1,1,-2,-1,0,-3,-1,1,4,2,2,5,3,2,-1,3,-3,3,3,-1,-2,1,-3,3,3,0,1,2,0,0,0,-1,1,2,-2,0,3,1,1,1,-2,-1,2,2,0,1,0,1,1,-1,-24,-24,0,-27,-25,-2,2,1,-3,-12,-7,-4,0,0,-4,-9,-6,-4,2,1,1,-3,-1,0,-2,-1,-1,-14,-5,-4,-2,-1,-1,-12,-6,-3,0,0,0,-2,1,-1,12,12,0,9,5,4,9,-3,-2,8,-3,3,7,0,0,5,-1,1,2,-3,-2,3,-2,2,1,-1,2,2,-1,6,1,-1,1,2,-1,3,0,0,1,0,0,3,-12,-8,-4,-5,-3,-2,-10,2,6,-6,0,-5,-5,2,4,-8,2,-4,-5,0,2,2,-2,-1,-4,0,-2,0,0,0,-4,0,0,-1,1,0,0,0,-2,1,-1,0,27,8,19,9,4,5,2,4,5,14,0,1,-1,0,3,8,0,-2,3,4,2,6,0,3,1,2,1,1,0,4,1,1,0,1,-1,2,0,1,1,0,1,2,29,13,16,5,4,1,9,4,16,-4,3,1,5,0,8,-2,0,2,4,4,8,-2,3,-1,-2,1,3,1,3,-1,0,0,2,0,2,0,-2,1,1,1,1,-1,-6,-4,-2,-1,-1,0,0,-2,2,-2,-2,-2,-1,0,0,0,-1,-2,1,-2,2,-2,-1,0,0,1,0,0,-2,0,0,1,1,-1,-2,0,0,0,-1,1,0,0
17,17044,Cassà de la Selva,7583,73,44,29,41,26,15,14,14,9,12,14,9,12,3,9,10,4,4,2,11,0,2,10,5,13,7,10,6,5,0,8,5,8,4,1,0,5,2,2,2,4,0,57,20,37,33,14,19,8,3,25,3,0,14,4,-3,8,4,0,7,4,6,17,-1,0,7,6,10,9,3,2,2,1,4,5,2,1,1,5,6,4,1,1,1,23,26,-3,-1,1,-2,9,1,-4,13,11,-5,10,-4,5,15,5,-2,-1,5,-9,-2,6,-3,-1,0,0,0,0,0,0,0,1,0,0,0,-1,0,-1,0,0,0,59,28,31,19,14,5,-1,20,-5,22,6,14,-6,7,9,8,4,4,5,13,-14,14,2,10,9,3,6,2,-1,0,6,2,4,1,1,0,3,1,2,1,-2,0,237,159,78,176,130,46,44,51,81,38,3,17,29,34,59,27,0,10,15,17,22,11,3,7,35,50,63,22,3,2,23,35,54,16,0,2,12,15,9,6,3,0,231,140,91,144,100,44,45,57,97,25,10,-6,33,31,61,11,3,0,12,26,36,14,7,-6,22,46,50,21,1,3,18,27,38,14,0,3,4,19,12,7,1,0,166,83,83,121,72,49,50,45,37,24,5,1,30,20,18,12,4,-3,20,25,19,12,1,4,33,50,21,14,1,1,15,34,10,11,0,1,18,16,11,3,1,0,267,183,84,169,115,54,39,67,90,37,24,12,25,64,52,31,10,3,14,3,38,6,14,9,30,57,53,22,3,4,21,47,27,14,3,3,9,10,26,8,0,1,271,184,87,172,119,53,37,89,116,7,0,16,25,66,84,-5,3,7,12,23,32,12,-3,9,34,58,64,8,2,4,24,49,41,1,1,2,10,9,23,7,1,2,120,75,45,90,49,41,28,42,43,4,1,4,12,31,32,-2,-3,3,16,11,11,6,4,1,24,47,11,7,-1,1,13,30,3,4,-2,0,11,17,8,3,1,1,116,88,28,73,44,29,24,38,44,7,-4,7,23,28,33,4,-5,4,1,10,11,3,1,3,19,31,14,7,-2,3,14,16,11,4,-2,1,5,15,3,3,0,2,25,-35,60,-48,-57,9,27,-3,-10,-1,11,-5,12,-12,-24,-13,4,-3,15,9,14,12,7,-2,10,-8,-28,-11,-2,-10,7,-13,-33,-13,-3,-3,3,5,5,2,1,-7,-35,-11,-24,-78,-52,-26,1,9,-16,-22,7,-12,13,6,-18,-21,7,1,-12,3,2,-1,0,-13,-12,-2,-36,-23,-7,2,0,-4,-25,-19,-4,0,-12,2,-11,-4,-3,2,16,-25,41,-38,-46,8,11,15,4,-23,1,1,6,-3,-4,-27,-2,1,5,18,8,4,3,0,8,-1,-25,-13,-4,-4,4,-8,-22,-14,-3,-3,4,7,-3,1,-1,-1,117,74,43,98,58,40,12,17,73,11,1,5,1,11,44,12,5,2,11,6,29,-1,-4,3,12,26,47,9,2,0,7,15,29,4,2,0,5,11,18,5,0,0,-8,-24,16,19,4,15,-7,20,-20,-17,10,2,-11,8,-2,-24,4,1,4,12,-18,7,6,1,4,7,12,-10,1,2,6,2,6,-11,-1,1,-2,5,6,1,2,1,210,101,109,119,63,56,51,10,56,51,29,14,35,1,31,15,13,5,16,9,25,36,16,9,22,14,40,26,14,2,13,7,22,14,6,0,9,7,18,12,8,2,131,79,52,99,51,48,33,39,12,35,7,3,14,24,8,29,-2,5,19,15,4,6,9,-2,21,30,30,12,2,2,11,18,13,6,1,1,10,12,17,6,1,1
17,17046,Castellfollit de la Roca,968,19,20,-1,28,26,2,-1,7,14,3,-2,-2,-2,5,15,3,-1,0,1,2,-1,0,-1,-2,2,5,17,4,0,0,1,4,17,4,0,0,1,1,0,0,0,0,13,9,4,24,15,9,1,6,2,7,1,-4,0,-2,3,9,0,-1,1,8,-1,-2,1,-3,0,9,10,4,1,0,0,3,9,3,0,0,0,6,1,1,1,0,4,1,3,10,7,3,2,5,-3,-1,0,1,0,5,-2,-3,0,1,2,0,-1,2,0,0,0,6,1,2,1,0,0,5,0,1,1,0,0,1,1,1,0,0,-3,-4,1,10,6,4,-7,6,-1,2,-2,-1,-4,3,1,0,-2,-2,-3,3,-2,2,0,1,0,4,3,3,0,0,0,4,1,1,0,0,0,0,2,2,0,0,-12,-10,-2,24,18,6,-4,1,-4,-5,0,0,-3,-1,-2,-3,-1,0,-1,2,-2,-2,1,0,2,9,7,4,0,2,2,7,4,4,0,1,0,2,3,0,0,1,12,11,1,28,18,10,0,8,4,2,-1,-2,0,2,3,4,1,1,0,6,1,-2,-2,-3,2,7,10,9,0,0,1,4,6,7,0,0,1,3,4,2,0,0,7,2,5,13,6,7,3,4,-7,5,6,-3,3,1,-1,-1,3,-2,0,3,-6,6,3,-1,3,4,2,2,2,0,2,1,1,1,1,0,1,3,1,1,1,0,17,3,14,24,10,14,4,10,1,5,2,-5,6,3,-2,1,-2,-3,-2,7,3,4,4,-2,7,7,-1,6,3,2,6,3,-2,2,0,1,1,4,1,4,3,1,28,10,18,25,16,9,11,6,8,-2,4,-2,4,6,0,-1,0,0,7,0,8,-1,4,-2,7,5,6,4,3,0,5,6,3,2,0,0,2,-1,3,2,3,0,4,4,0,5,3,2,-1,-1,-2,2,5,1,1,1,-3,2,3,0,-2,-2,1,0,2,1,2,1,-3,5,-1,1,1,1,-1,3,0,-1,1,0,-2,2,-1,2,-40,-20,-20,-3,-3,0,-1,-5,-11,-17,0,-4,2,-3,-5,-12,0,-2,-3,-2,-6,-5,0,-2,0,-2,-1,-2,1,1,0,-1,-2,-2,1,1,0,-1,1,0,0,0,6,-2,8,-6,-4,-2,1,5,0,0,-3,3,1,3,-2,-3,-2,1,0,2,2,3,-1,2,1,2,-4,-3,-2,0,1,1,-2,-3,-1,0,0,1,-2,0,-1,0,24,18,6,7,4,3,10,2,4,6,3,-3,4,3,7,3,1,-2,6,-1,-3,3,2,-1,4,0,2,1,2,-2,2,0,1,1,1,-1,2,0,1,0,1,-1,-1,-2,1,0,-3,3,9,-1,-10,4,-1,-3,2,0,-6,2,-2,1,7,-1,-4,2,1,-4,5,-1,-2,-2,0,0,2,0,-2,-3,0,0,3,-1,0,1,0,0,-18,-17,-1,0,0,0,-6,-3,4,-10,0,-3,-6,-2,0,-6,-1,-2,0,-1,4,-4,1,-1,-1,1,1,-3,2,0,-1,1,1,-2,1,0,0,0,0,-1,1,0,-22,-9,-13,0,-2,2,-9,-6,-2,-1,-4,-1,-7,-2,-5,5,-1,0,-2,-4,3,-6,-3,-1,2,0,0,-1,-1,0,0,0,-2,0,0,0,2,0,2,-1,-1,0,1,1,0,2,-1,3,-3,6,-3,-2,-1,3,-1,1,0,-2,1,1,-2,5,-3,0,-2,2,0,1,1,0,0,0,0,0,-1,0,0,0,0,1,2,0,0,0,6,3,3,-5,-4,-1,1,2,4,-1,0,-1,2,-2,4,-2,0,0,-1,4,0,1,0,-1,2,0,-3,-4,0,0,2,0,-2,-4,0,0,0,0,-1,0,0,0
17,17047,Castelló d'Empúries,5816,603,342,261,537,303,234,60,81,137,107,133,88,26,47,95,59,67,51,34,34,42,48,66,37,50,75,107,91,128,86,26,42,68,54,65,48,24,33,39,37,63,38,599,333,266,552,306,246,59,102,132,113,125,62,32,60,87,71,48,34,27,42,45,42,77,28,63,90,111,110,119,57,32,54,70,66,50,34,31,36,41,44,69,23,624,312,312,391,210,181,90,92,160,113,66,100,51,37,89,56,35,43,39,55,71,57,31,57,59,87,112,71,44,16,33,42,61,38,23,12,26,45,51,33,21,4,577,305,272,475,255,220,64,133,138,111,80,47,35,55,92,61,39,20,29,78,46,50,41,27,70,100,124,93,61,22,40,47,75,49,31,10,30,53,49,44,30,12,936,491,445,633,336,297,109,169,284,164,123,74,59,75,160,96,63,34,50,94,124,68,60,40,63,127,172,130,97,39,38,49,101,73,52,21,25,78,71,57,45,18,707,367,340,589,324,265,91,125,164,137,143,35,37,62,87,76,87,12,54,63,77,61,56,23,73,112,136,110,121,32,37,54,80,65,68,17,36,58,56,45,53,15,975,525,450,854,455,399,117,160,272,192,165,65,57,85,136,126,83,34,60,75,136,66,82,31,122,139,194,175,163,57,54,73,99,109,88,30,68,66,95,66,75,27,1033,590,443,849,463,386,110,203,297,181,146,89,53,104,190,112,68,56,57,99,107,69,78,33,96,167,229,142,134,77,42,80,133,89,66,50,54,87,96,53,68,27,227,147,80,263,141,122,11,68,5,30,63,50,18,34,7,26,44,15,-7,34,-2,4,19,35,38,76,39,34,47,24,29,34,15,23,28,10,9,42,24,11,19,14,86,50,36,85,18,67,28,-7,-9,39,22,13,14,0,-16,19,24,12,14,-7,7,20,-2,1,33,22,-16,15,21,11,13,13,-22,-5,14,8,20,9,6,20,7,3,-368,-197,-171,-218,-155,-63,-51,2,-104,-137,-28,-45,-27,0,-47,-94,-5,-21,-24,2,-57,-43,-23,-24,4,13,-67,-89,-33,-48,3,-5,-44,-68,-18,-23,1,18,-23,-21,-15,-25,-88,-3,-85,42,25,17,-68,-3,-10,-19,14,2,-33,-1,17,-9,14,10,-35,-2,-27,-10,0,-8,-22,21,15,1,19,7,-12,10,6,-1,9,13,-10,11,9,2,10,-6,104,49,55,146,67,79,30,31,14,6,25,-7,20,19,8,-9,15,-10,10,12,6,15,10,3,39,26,30,30,31,-15,18,18,12,10,12,-8,21,8,18,20,19,-7,-464,-226,-238,-360,-206,-154,-64,2,-109,-116,-78,-110,-23,-3,-47,-64,-47,-51,-41,5,-62,-52,-31,-59,-22,6,-89,-101,-65,-95,-2,-1,-47,-63,-45,-50,-20,7,-42,-38,-20,-45,-624,-328,-296,-527,-287,-240,-58,-19,-38,-128,-140,-241,-36,-6,-10,-59,-90,-126,-22,-13,-28,-69,-50,-115,-34,-19,-6,-98,-125,-249,-14,-15,-4,-52,-75,-131,-20,-4,-2,-46,-50,-118,-93,-48,-45,44,22,22,-40,-3,-49,-17,2,10,-20,2,-25,-20,18,-8,-20,-5,-24,3,-16,18,4,14,-8,8,11,14,6,7,-9,3,10,4,-2,7,1,5,1,10,22,42,-20,50,54,-4,-13,32,12,-9,14,-20,-13,28,14,3,21,-14,0,4,-2,-12,-7,-6,0,32,8,4,23,-20,2,20,20,0,19,-8,-2,12,-12,4,4,-12,-8,7,-15,37,6,31,-1,6,43,12,-18,-53,16,-2,27,6,-16,-20,-17,8,16,6,-2,-33,27,24,46,-7,-3,-54,16,9,22,-14,-7,-22,11,15,24,7,4,-32
17,17048,Castell-Platja d'Aro,6185,327,147,180,221,116,105,44,52,99,76,53,11,22,20,45,34,25,7,22,32,54,42,28,4,39,38,66,40,30,7,18,20,37,22,16,3,21,18,29,18,14,4,453,256,197,298,160,138,51,67,113,131,51,34,30,39,71,63,26,25,21,28,42,68,25,9,47,66,81,55,30,18,24,33,50,27,14,11,23,33,31,28,16,7,325,190,135,289,150,139,20,81,65,48,76,28,9,46,35,34,37,24,11,35,30,14,39,4,43,79,65,42,40,14,19,40,34,23,22,8,24,39,31,19,18,6,505,274,231,313,190,123,56,104,131,129,68,8,30,71,60,69,44,-3,26,33,71,60,24,11,48,77,77,72,28,9,29,47,45,43,19,6,19,30,32,29,9,3,640,399,241,501,285,216,42,166,188,104,79,56,33,100,131,58,41,35,9,66,57,46,38,21,67,123,136,77,56,38,36,77,76,46,26,22,31,46,60,31,30,16,376,182,194,366,193,173,51,65,89,52,81,32,33,30,21,36,49,8,18,35,68,16,32,24,41,75,92,71,65,18,24,34,54,39,33,6,17,41,38,32,32,12,373,175,198,338,179,159,62,78,79,89,56,9,17,50,42,24,34,9,45,28,37,65,22,0,59,76,89,63,41,9,23,46,49,28,27,6,36,30,40,35,14,3,289,120,169,247,101,146,62,43,98,51,19,8,29,22,50,20,4,-4,33,21,48,31,15,12,49,50,80,37,22,7,17,20,34,23,4,2,32,30,46,14,18,5,213,117,96,219,83,136,15,46,62,46,9,25,18,13,36,31,3,8,-3,33,26,15,6,17,52,59,46,34,13,8,22,25,12,11,6,2,30,34,34,23,7,6,48,-12,60,83,17,66,21,41,-3,8,-10,-22,8,5,1,-19,-1,-12,13,36,-4,27,-9,-10,51,36,0,13,-3,-17,28,10,-4,-10,1,-8,23,26,4,23,-4,-9,-73,-96,23,-33,-73,40,0,7,-24,-13,-7,-40,-10,-11,-39,2,-13,-23,10,18,15,-15,6,-17,9,21,-5,-9,-18,-37,-2,-8,-18,-7,-19,-20,11,29,13,-2,1,-17,81,26,55,82,48,34,35,13,17,5,-5,8,18,4,1,-1,-1,0,17,9,16,6,-4,8,24,10,21,15,5,7,16,2,9,11,8,1,8,8,12,4,-3,6,203,119,84,173,89,84,51,49,55,26,16,-3,41,29,28,6,10,2,10,20,27,20,6,-5,46,23,53,32,17,-5,29,10,29,15,11,-6,17,13,24,17,6,1,-29,-16,-13,-2,-11,9,15,-15,-8,-38,30,-3,7,-14,-7,-20,28,-5,8,-1,-1,-18,2,2,15,-9,-7,-2,5,-3,4,-6,-8,-4,1,3,11,-3,1,2,4,-6,-27,-11,-16,95,40,55,-26,21,-30,10,17,-14,-7,-5,-10,1,14,-4,-19,26,-20,9,3,-10,13,17,5,33,20,6,11,2,2,11,8,5,2,15,3,22,12,1,-5,9,-14,84,43,41,-2,9,-25,18,-6,-1,7,2,-17,18,-2,-4,-9,7,-8,0,-4,3,13,23,8,23,20,-7,15,11,-3,10,13,-7,-2,12,11,13,7,0,22,18,4,38,18,20,29,15,21,-31,-10,-12,30,12,4,-13,-6,-15,-1,3,17,-18,-4,3,14,8,36,-3,-5,-18,11,5,16,1,-5,-14,3,3,20,-4,0,-4,-11,8,-19,-31,-18,-13,25,28,-2,-38,-1,-36,11,12,6,-14,3,-20,14,16,-8,-24,-4,-16,20,16,2,-29,-22,-32,8,5,-2,-14,-7,-19,12,11,4,-15,-15,-13
17,17189,"Cellera de Ter, La",2028,21,22,-1,26,18,8,-6,3,16,6,1,2,-3,1,15,7,2,1,-3,2,1,-1,-1,1,3,12,7,4,0,0,3,6,7,2,0,0,0,6,0,2,0,0,11,4,7,17,10,7,4,2,7,-1,-1,1,2,-1,8,-3,-2,1,2,3,-1,2,1,0,1,3,9,3,0,1,0,1,8,1,0,0,1,2,1,2,0,1,13,12,1,26,19,7,3,4,-4,9,5,-4,3,1,2,4,3,0,0,3,-6,5,2,-4,3,5,11,3,3,0,1,4,10,2,1,0,2,1,1,1,2,0,-3,3,-6,6,4,2,0,-1,-9,5,2,2,3,2,-7,6,-1,0,-3,-3,-2,-1,3,2,0,1,2,2,1,0,0,1,1,2,0,0,0,0,1,0,1,0,15,12,3,22,17,5,5,-5,14,-2,2,1,1,-2,10,0,3,0,4,-3,4,-2,-1,1,3,4,8,6,1,0,2,3,8,3,1,0,1,1,0,3,0,0,20,10,10,38,16,22,3,10,3,-1,3,-1,4,2,2,0,2,-1,-1,8,1,-1,1,0,6,12,10,7,2,0,2,5,4,3,2,0,4,7,6,4,0,0,33,9,24,38,13,25,17,9,0,5,-2,2,6,4,-3,4,-2,-1,11,5,3,1,0,3,11,12,10,3,1,1,4,7,1,1,0,0,7,5,9,2,1,1,34,17,17,30,13,17,2,0,14,13,2,3,-3,2,7,7,2,1,5,-2,7,6,0,2,3,10,8,6,3,0,0,7,1,3,2,0,3,3,7,3,1,0,26,13,13,20,12,8,14,8,4,0,0,-1,10,4,1,-2,1,-1,4,4,3,2,-1,0,5,6,3,3,3,0,5,2,3,0,2,0,0,4,0,3,1,0,-23,-12,-11,2,-1,3,-4,-3,-11,-5,-1,0,-2,-1,-4,-4,-1,0,-2,-2,-7,-1,0,0,0,2,-3,2,0,1,0,0,-2,0,0,1,0,2,-1,2,0,0,-36,-21,-15,5,2,3,-15,-7,-19,-2,3,4,-7,-3,-10,-5,2,2,-8,-4,-9,3,1,2,1,-2,1,3,1,0,1,-1,0,1,0,0,0,-1,1,2,1,0,-44,-31,-13,-4,-9,5,-4,-11,-8,-10,-5,-4,-3,-7,-6,-9,-2,-3,-1,-4,-2,-1,-3,-1,-2,3,0,-3,-1,-1,-1,0,-2,-4,-1,-1,-1,3,2,1,0,0,2,2,0,0,0,0,-3,-1,13,1,-4,-3,-4,1,7,1,1,-3,1,-2,6,0,-5,0,-2,0,1,1,0,0,-1,0,1,0,0,0,-1,0,0,1,0,0,13,2,11,2,0,2,1,-1,9,3,-3,2,-2,-1,2,4,-3,1,3,0,7,-1,0,1,-3,1,1,1,1,1,-1,0,1,-1,0,1,-2,1,0,2,1,0,4,-5,9,-4,-4,0,1,1,7,-1,0,-3,1,1,4,-3,-2,-3,0,0,3,2,2,0,-2,-1,1,-1,-1,0,-2,-1,1,-1,-1,0,0,0,0,0,0,0,-26,-13,-13,-9,-7,-2,-8,4,-12,-7,-6,2,-5,5,-8,-4,-3,1,-3,-1,-4,-3,-3,1,-2,6,-7,-2,-5,0,-2,3,-5,-1,-3,0,0,3,-2,-1,-2,0,-34,-10,-24,-8,-4,-4,-2,-7,-16,-8,4,-5,4,-7,-5,-5,1,2,-6,0,-11,-3,3,-7,-6,-4,0,-1,0,3,-2,-4,1,-1,0,2,-4,0,-1,0,0,1,-18,-14,-4,-2,-1,-1,-10,4,-3,0,-13,1,-4,0,2,-5,-9,1,-6,4,-5,5,-4,0,-4,4,0,-2,-1,0,-1,2,1,-2,-1,0,-3,2,-1,0,0,0
17,17049,Celrà,2640,45,23,22,23,15,8,-5,9,43,-3,-2,0,-5,3,23,-5,1,2,0,6,20,2,-3,-2,1,7,12,1,1,1,1,3,8,1,1,1,0,4,4,0,0,0,67,47,20,21,15,6,16,9,28,5,-1,6,14,6,22,1,-1,4,2,3,6,4,0,2,1,6,7,2,3,1,0,6,5,1,2,1,1,0,2,1,1,0,208,107,101,67,41,26,37,36,80,42,5,0,13,19,45,25,2,0,24,17,35,17,3,0,9,16,31,9,1,0,2,9,22,6,1,0,7,7,9,3,0,0,142,79,63,75,44,31,34,24,60,28,0,-9,17,9,36,16,1,-5,17,15,24,12,-1,-4,16,17,26,10,4,1,7,10,16,6,3,1,9,7,10,4,1,0,242,134,108,119,78,41,43,37,77,48,22,11,24,19,46,24,13,5,19,18,31,24,9,6,21,27,29,30,7,3,12,17,21,21,4,2,9,10,8,9,3,1,254,121,133,95,51,44,63,41,103,33,4,1,27,17,50,24,0,0,36,24,53,9,4,1,22,22,23,23,1,2,9,13,12,17,-2,1,13,9,11,6,3,1,198,82,116,58,31,27,48,44,79,12,14,-1,22,19,37,-4,9,-2,26,25,42,16,5,1,15,15,20,11,-1,-2,11,5,10,8,0,-3,4,10,10,3,-1,1,317,161,156,78,37,41,60,67,130,36,17,-1,31,29,71,18,6,3,29,38,59,18,11,-4,13,22,26,12,5,-2,5,12,13,5,0,1,8,10,13,7,5,-3,130,58,72,50,21,29,9,38,65,1,4,9,10,14,27,1,1,2,-1,24,38,0,3,7,11,15,26,-2,0,0,9,3,11,-2,1,-1,2,12,15,0,-1,1,62,33,29,8,1,7,-5,30,47,-10,3,-5,-7,9,32,-1,-1,-1,2,21,15,-9,4,-4,-3,12,4,-5,-2,0,-4,6,4,-3,-2,0,1,6,0,-2,0,0,72,44,28,46,30,16,9,16,45,6,1,0,3,10,25,10,0,0,6,6,20,-4,1,0,7,20,3,9,5,1,6,13,2,5,2,1,1,7,1,4,3,0,112,48,64,41,18,23,40,21,41,9,1,-1,17,8,22,3,1,-3,23,13,19,6,0,2,15,10,18,2,-1,-4,7,3,9,2,-2,-2,8,7,9,0,1,-2,52,30,22,2,-9,11,9,-1,18,10,10,3,8,8,16,-7,3,-1,1,-9,2,17,7,4,5,1,-12,-3,8,-2,-2,0,-5,-8,4,-1,7,1,-7,5,4,-1,5,10,-5,0,0,0,-13,12,-16,27,-15,4,-4,7,-4,16,-12,4,-9,5,-12,11,-3,0,-6,15,-9,2,-5,0,-5,8,-2,0,-4,0,-1,7,-7,2,-1,0,71,46,25,7,11,-4,0,16,11,5,28,2,-10,12,13,5,17,3,10,4,-2,0,11,-1,-9,9,-1,-1,5,0,-7,7,3,1,4,0,-2,2,-4,-2,1,0,93,59,34,51,31,20,50,29,-2,30,-20,2,34,11,3,20,-13,3,16,18,-5,10,-7,-1,12,20,11,5,-3,4,10,10,8,2,0,1,2,10,3,3,-3,3,38,10,28,47,16,31,4,15,-14,24,2,5,3,1,-10,12,3,1,1,14,-4,12,-1,4,13,15,3,8,5,0,7,3,-3,3,3,0,6,12,6,5,2,0,-3,5,-8,6,-1,7,-18,16,17,-6,-1,-10,-11,10,14,-8,-1,-2,-7,6,3,2,0,-8,-3,5,4,7,-7,-1,-2,0,4,-1,-3,0,-1,5,0,8,-4,-1
17,17057,Corçà,1122,30,19,11,3,2,1,3,-1,8,14,2,5,3,0,4,10,0,3,0,-1,4,4,2,2,0,1,0,1,1,0,0,1,0,1,0,0,0,0,0,0,1,0,-4,1,-5,4,1,3,-4,-2,0,2,-1,1,-3,1,3,1,-1,0,-1,-3,-3,1,0,1,2,0,0,2,0,0,0,0,0,1,0,0,2,0,0,1,0,0,19,10,9,15,5,10,10,8,-8,6,2,-1,7,3,-4,2,0,2,3,5,-4,4,2,-3,4,5,2,3,1,0,2,1,1,1,0,0,2,4,1,2,1,0,37,10,27,18,12,6,9,-4,4,19,3,6,0,-1,0,9,1,2,9,-3,4,10,2,4,1,2,6,9,0,0,0,1,4,7,0,0,1,1,2,2,0,0,33,17,16,25,14,11,10,1,14,9,1,-2,8,0,4,4,1,0,2,1,10,5,0,-2,8,2,7,8,0,0,5,0,4,5,0,0,3,2,3,3,0,0,41,25,16,27,15,12,8,-1,11,13,4,5,3,0,7,10,0,3,5,-1,4,3,4,2,4,4,12,4,2,1,1,2,7,4,0,1,3,2,5,0,2,0,-1,-9,8,10,4,6,4,-3,0,-6,-1,4,0,-1,-5,-5,0,1,4,-2,5,-1,-1,3,3,3,3,0,1,0,1,1,2,0,0,0,2,2,1,0,1,0,12,6,6,20,16,4,-1,6,6,1,-1,-2,-3,5,4,-2,1,-1,2,1,2,3,-2,-1,1,6,6,9,-1,-1,0,5,6,6,0,-1,1,1,0,3,-1,0,6,-4,10,21,11,10,1,-8,-5,8,9,1,-2,-8,-1,3,5,-1,3,0,-4,5,4,2,3,4,4,6,4,0,1,1,2,5,2,0,2,3,2,1,2,0,13,7,6,0,-2,2,4,3,9,-1,-2,1,5,3,0,0,-3,1,-1,0,9,-1,1,0,0,2,2,-2,-1,-1,0,2,-1,-2,-1,0,0,0,3,0,0,-1,13,-2,15,4,-2,6,3,4,4,-1,2,1,1,0,-4,-2,1,1,2,4,8,1,1,0,1,-1,1,-1,3,0,0,-1,-1,-2,2,0,1,0,2,1,1,0,-38,-16,-22,-18,-13,-5,-12,0,-16,-5,-6,0,-5,-2,-9,0,-3,2,-7,2,-7,-5,-3,-2,-4,0,-5,-5,-3,-1,-2,-2,-4,-3,-2,0,-2,2,-1,-2,-1,-1,-3,-1,-2,6,3,3,-1,-2,4,7,-7,-3,-2,2,2,2,-2,-2,1,-4,2,5,-5,-1,1,0,3,2,-1,1,0,0,1,2,-1,1,1,0,2,0,0,0,-12,1,-13,-7,-4,-3,-7,2,-1,-1,-2,-3,-3,1,4,1,0,-3,-4,1,-5,-2,-2,0,0,0,-3,0,-1,-3,0,-1,0,-2,0,-1,0,1,-3,2,-1,-2,-19,1,-20,-8,-4,-4,0,-10,-2,2,-18,3,2,-5,3,6,-9,1,-2,-5,-5,-4,-9,2,0,-2,-1,-3,-4,1,0,-2,-1,-1,-1,1,0,0,0,-2,-3,0,11,9,2,-6,-1,-5,-4,-2,9,-3,7,4,6,1,5,-5,3,0,-10,-3,4,2,4,4,-3,0,-1,-3,0,2,0,1,1,-3,0,1,-3,-1,-2,0,0,1,-1,5,-6,-4,-2,-2,3,2,2,-9,1,-1,7,1,6,-7,-1,-1,-4,1,-4,-2,2,0,1,1,-1,-3,-2,0,1,0,0,-1,-2,0,0,1,-1,-2,0,0,-4,-2,-2,1,1,0,-4,2,4,-1,-6,-1,-2,2,1,-1,-2,0,-2,0,3,0,-4,-1,1,0,0,-1,0,0,1,0,1,-1,0,0,0,0,-1,0,0,0
17,17901,"Cruïlles, Monells i Sant Sadurní de l'Heura",1100,22,13,9,8,6,2,4,0,8,10,4,-4,4,2,1,6,4,-4,0,-2,7,4,0,0,0,0,4,4,0,0,0,0,4,2,0,0,0,0,0,2,0,0,46,24,22,20,12,8,13,4,13,9,5,2,2,8,9,2,2,1,11,-4,4,7,3,1,4,5,7,2,2,0,0,5,4,1,2,0,4,0,3,1,0,0,-1,-2,1,10,6,4,2,0,-3,-2,1,1,5,0,-4,-2,0,-1,-3,0,1,0,1,2,2,2,3,3,0,0,1,0,3,2,0,0,1,2,0,1,0,0,54,22,32,17,10,7,8,4,27,5,8,1,0,2,10,3,5,1,8,2,17,2,3,0,1,2,9,4,1,0,0,1,5,3,1,0,1,1,4,1,0,0,21,13,8,24,13,11,-2,1,-3,14,12,-2,-2,2,1,7,6,-1,0,-1,-4,7,6,-1,6,8,5,4,1,0,2,4,5,2,0,0,4,4,0,2,1,0,23,17,6,13,10,3,11,1,-1,14,-6,4,8,0,0,10,-2,1,3,1,-1,4,-4,3,4,3,1,5,0,0,3,1,1,5,0,0,1,2,0,0,0,0,43,16,27,28,11,17,14,-2,13,19,-5,1,4,2,0,10,-2,0,10,-4,13,9,-3,1,9,0,9,7,1,1,3,1,2,4,1,0,6,-1,7,3,0,1,-37,-22,-15,7,3,4,-7,-8,-12,-8,-1,-1,-5,-4,-4,-8,1,-2,-2,-4,-8,0,-2,1,1,3,3,0,0,0,0,2,1,0,0,0,1,1,2,0,0,0,10,7,3,3,1,2,0,2,-10,11,7,-2,-1,-1,-4,10,4,-3,1,3,-6,1,3,1,-1,3,-2,3,0,0,-1,2,-2,3,0,-1,0,1,0,0,0,1,-30,-5,-25,0,0,0,-7,-4,-6,-7,-4,-2,0,1,1,-4,-2,-1,-7,-5,-7,-3,-2,-1,-2,1,3,-1,-1,0,0,1,2,-2,-1,0,-2,0,1,1,0,0,31,13,18,-5,-4,-1,13,-2,3,12,6,0,3,1,1,8,1,-1,10,-3,2,4,5,1,-1,3,-3,-2,2,-4,-1,2,-2,-2,1,-2,0,1,-1,0,1,-2,-27,-18,-9,-10,-7,-3,-8,-2,-3,-7,-4,-2,-9,-1,-1,-3,-2,-1,1,-1,-2,-4,-2,-1,-2,-2,0,-6,0,0,-1,-2,0,-4,0,0,-1,0,0,-2,0,0,13,8,5,7,6,1,7,0,12,1,-3,-3,5,1,3,4,-3,-1,2,-1,9,-3,0,-2,0,1,1,2,3,0,1,1,1,2,1,0,-1,0,0,0,2,0,15,2,13,-2,-2,0,3,9,1,2,1,0,2,3,2,-5,1,-1,1,6,-1,7,0,1,0,0,1,-1,-1,-1,0,0,1,-2,0,-1,0,0,0,1,-1,0,22,11,11,3,1,2,3,8,5,6,-10,5,2,1,4,5,-5,2,1,7,1,1,-5,3,1,3,-1,1,-3,2,1,0,-1,1,-1,1,0,3,0,0,-2,1,-8,-7,-1,0,1,-1,2,-7,-7,-4,4,5,-3,0,-4,-2,2,1,5,-7,-3,-2,2,4,3,2,-1,-2,-2,0,0,1,0,1,-1,0,3,1,-1,-3,-1,0,6,9,-3,10,6,4,8,-2,2,1,4,-7,5,0,3,-2,7,-5,3,-2,-1,3,-3,-2,5,0,-1,4,4,-2,2,0,-1,1,5,-1,3,0,0,3,-1,-1,-7,-5,-2,9,4,5,-5,-7,-7,9,9,-7,-3,-6,-5,6,5,-2,-2,-1,-2,3,4,-5,4,1,2,2,2,-2,2,0,1,2,0,-1,2,1,1,0,2,-1
17,17062,"Escala, L'",5926,-169,-76,-93,32,21,11,-34,-32,-38,-33,-20,-10,-18,-8,-20,-16,-11,-3,-16,-24,-18,-17,-9,-7,2,6,12,5,1,5,1,4,9,2,1,3,1,2,3,3,0,2,46,25,21,57,31,26,-7,0,20,-2,31,1,-2,4,3,-3,17,3,-5,-4,17,1,14,-2,6,11,21,9,8,1,5,6,11,4,4,0,1,5,10,5,4,1,374,200,174,284,160,124,49,68,72,94,60,26,23,35,35,57,34,15,26,33,37,37,26,11,39,54,55,73,44,18,21,33,33,42,19,12,18,21,22,31,25,6,457,228,229,305,154,151,47,70,112,94,85,46,27,40,56,48,34,22,20,30,56,46,51,24,40,42,70,49,76,26,29,20,32,25,33,14,11,22,38,24,43,12,465,284,181,299,172,127,40,71,111,88,108,39,23,39,84,51,63,21,17,32,27,37,45,18,28,49,61,48,74,38,11,30,41,23,45,22,17,19,20,25,29,16,408,224,184,302,164,138,63,44,94,66,79,49,34,27,54,39,32,28,29,17,40,27,47,21,52,51,51,54,60,33,28,28,33,26,26,23,24,23,18,28,34,10,474,285,189,289,161,128,47,82,102,100,77,59,34,49,66,55,44,34,13,33,36,45,33,25,33,67,56,52,50,28,19,40,33,26,28,15,14,27,23,26,22,13,474,242,232,388,210,178,54,101,117,80,70,41,31,49,55,40,40,20,23,52,62,40,30,21,49,93,106,64,45,28,27,50,55,40,23,14,22,43,51,24,22,14,355,188,167,358,193,165,60,53,80,52,78,22,32,11,59,33,39,9,28,42,21,19,39,13,47,56,116,44,70,22,26,24,78,19,36,9,21,32,38,25,34,13,240,113,127,181,84,97,6,67,46,39,50,24,2,34,21,17,25,12,4,33,25,22,25,12,17,55,35,21,28,23,10,18,19,13,12,13,7,37,16,8,16,10,166,84,82,177,92,85,3,28,10,44,48,34,-7,17,4,19,33,16,10,11,6,25,15,18,21,32,19,38,43,24,10,13,7,26,22,13,11,19,12,12,21,11,48,17,31,128,68,60,1,22,17,-16,25,4,11,10,0,-10,6,3,-10,12,17,-6,19,1,15,32,28,19,31,2,12,12,18,8,15,3,3,20,10,11,16,-1,41,-4,45,89,46,43,3,-5,11,14,15,8,-8,-9,8,4,5,-1,11,4,3,10,10,9,4,11,19,25,17,13,-3,7,11,15,8,8,7,4,8,10,9,5,-29,-15,-14,53,23,30,5,14,-13,-40,1,3,3,0,-4,-12,-1,-2,2,14,-9,-28,2,5,10,10,7,-2,17,10,7,1,-2,2,7,7,3,9,9,-4,10,3,90,43,47,115,57,58,20,10,1,14,24,15,22,2,-10,8,11,7,-2,8,11,6,13,8,17,12,18,21,29,15,18,4,2,9,15,8,-1,8,16,12,14,7,-11,6,-17,74,39,35,6,13,-13,-22,11,-6,7,3,-2,-6,7,0,-1,10,-11,-16,4,-6,10,11,23,2,19,7,6,7,11,1,10,4,4,4,12,1,9,3,-30,-7,-23,65,21,44,-36,26,-5,-19,-2,9,-32,12,7,-6,2,12,-4,14,-12,-13,-4,-3,12,15,15,1,9,13,2,5,0,2,2,10,10,10,15,-1,7,3,44,24,20,136,65,71,-2,34,-2,-21,6,29,7,18,-5,-11,1,16,-9,16,3,-10,5,13,14,34,27,19,27,12,7,13,13,13,11,7,7,21,14,6,16,5
17,17066,Figueres,33823,15,-23,38,169,87,82,6,42,20,-48,-25,33,-12,20,8,-21,-21,8,18,22,12,-27,-4,25,39,37,54,25,10,3,23,18,23,16,5,1,16,19,31,9,5,2,496,232,264,679,350,329,90,162,175,52,2,6,45,72,88,33,-8,-1,45,90,87,19,10,7,139,180,210,99,36,8,70,88,123,47,16,5,69,92,87,52,20,3,948,536,412,955,497,458,135,259,359,170,43,-5,69,135,228,95,15,3,66,124,131,75,28,-8,217,244,294,147,30,15,108,125,167,71,14,7,109,119,127,76,16,8,840,422,418,980,509,471,111,341,280,75,27,18,45,164,166,42,8,-4,66,177,114,33,19,22,186,301,267,155,44,19,95,145,147,89,23,7,91,156,120,66,21,12,1415,853,562,1245,719,526,183,384,509,256,41,47,91,226,337,157,20,24,92,158,172,99,21,23,197,364,410,195,43,24,109,198,262,115,21,10,88,166,148,80,22,14,807,455,352,1157,619,538,108,278,331,51,15,36,65,126,217,39,5,8,43,152,114,12,10,28,216,318,371,158,65,22,107,157,218,88,34,10,109,161,153,70,31,12,1425,727,698,1575,850,725,155,535,432,236,46,29,46,257,263,135,29,7,109,278,169,101,17,22,291,454,501,225,82,13,155,237,289,122,38,6,136,217,212,103,44,7,1435,834,601,1740,989,751,155,554,502,173,45,17,65,320,315,109,16,22,90,234,187,64,29,-5,263,565,581,231,68,22,126,319,351,140,36,12,137,246,230,91,32,10,538,357,181,946,553,393,48,269,212,40,-6,-8,49,155,154,12,-9,5,-1,114,58,28,3,-13,159,326,317,125,17,-3,88,183,202,73,7,-3,71,143,115,52,10,0,13,-151,164,62,-84,146,141,82,-90,-104,-17,-10,56,3,-95,-84,-31,-2,85,79,5,-20,14,-8,120,101,-87,-63,-10,-6,52,14,-73,-58,-19,-2,68,87,-14,-5,9,-4,134,24,110,218,100,118,43,58,41,-58,22,27,36,33,-20,-42,9,8,7,25,61,-16,13,19,70,67,72,-8,9,0,55,35,25,-28,5,1,15,32,47,20,4,-1,246,120,126,323,119,204,96,105,36,4,-7,10,40,51,27,1,-11,6,56,54,9,3,4,4,134,122,41,12,0,2,65,49,3,5,-7,-3,69,73,38,7,7,5,-100,-91,-9,-218,-176,-42,23,48,-62,-68,-30,-25,12,23,-27,-47,-31,-18,11,25,-35,-21,1,-7,7,49,-79,-147,-46,-7,14,12,-46,-101,-46,-7,-7,37,-33,-46,0,0,93,13,80,-212,-127,-85,100,61,5,-82,13,-17,62,29,-28,-59,5,-6,38,32,33,-23,8,-11,-26,35,-72,-93,-40,-26,-6,11,-47,-55,-25,-10,-20,24,-25,-38,-15,-16,-198,-76,-122,-447,-239,-208,37,66,-84,-68,-86,-70,41,27,-66,-40,-22,-21,-4,39,-18,-28,-64,-49,-24,10,-174,-135,-89,-43,6,-6,-113,-71,-42,-14,-30,16,-61,-64,-47,-29,185,68,117,194,114,80,38,157,15,-32,15,-14,6,65,26,-27,3,-3,32,92,-11,-5,12,-11,21,104,59,-20,9,4,5,49,52,-9,7,2,16,55,7,-11,2,2,347,158,189,381,164,217,45,105,130,25,7,32,31,56,71,1,-8,8,14,49,59,24,15,24,61,108,129,46,23,7,43,53,60,10,-2,-3,18,55,69,36,25,10,208,103,105,231,118,113,75,185,37,-77,-33,12,55,104,24,-54,-43,10,20,81,13,-23,10,2,77,148,90,-52,-27,-14,46,85,64,-40,-34,-10,31,63,26,-12,7,-4
17,17902,Forallac,1650,24,14,10,15,11,4,14,5,7,2,-7,2,8,7,5,-1,-5,0,6,-2,2,3,-2,2,0,8,6,1,0,0,0,7,4,0,0,0,0,1,2,1,0,0,18,6,12,22,11,11,4,1,9,4,3,-2,-4,4,0,5,5,-3,8,-3,9,-1,-2,1,6,2,10,1,3,0,0,2,6,1,2,0,6,0,4,0,1,0,-2,-15,13,17,7,10,-8,-1,10,-2,-8,6,-9,-3,2,0,-5,1,1,2,8,-2,-3,5,5,3,4,5,0,0,1,0,2,4,0,0,4,3,2,1,0,0,29,13,16,11,6,5,11,4,5,9,-1,2,5,2,5,-1,0,2,6,2,0,10,-1,0,2,2,4,2,1,0,1,0,4,0,1,0,1,2,0,2,0,0,-1,6,-7,8,5,3,6,-1,2,-8,1,-1,8,-2,8,-5,-2,-1,-2,1,-6,-3,3,0,3,1,4,0,0,0,2,0,3,0,0,0,1,1,1,0,0,0,9,3,6,9,4,5,4,4,-4,7,0,0,6,3,-6,2,-2,0,-2,1,2,5,2,0,0,2,2,3,1,1,0,1,2,0,0,1,0,1,0,3,1,0,5,4,1,9,0,9,9,3,-3,8,-10,-5,4,5,-2,2,-4,-3,5,-2,-1,6,-6,-2,2,4,1,2,0,0,0,1,-1,0,0,0,2,3,2,2,0,0,6,1,5,13,6,7,1,1,1,-2,4,-1,7,2,-5,-5,2,-1,-6,-1,6,3,2,0,5,1,3,2,1,1,4,-1,2,1,0,0,1,2,1,1,1,1,3,4,-1,13,5,8,13,1,2,-2,-4,-9,12,3,-5,1,-3,-5,1,-2,7,-3,-1,-4,4,3,5,1,0,0,2,1,1,1,0,0,2,2,4,0,0,0,15,-1,16,3,1,2,6,-5,14,1,-3,2,-1,-7,10,0,-3,0,7,2,4,1,0,2,-1,2,1,1,0,-1,-1,0,0,1,0,0,0,2,1,0,0,-1,14,3,11,2,2,0,10,-5,14,-6,2,-5,5,-1,4,-7,1,-2,5,-4,10,1,1,-3,4,0,-1,2,-3,0,4,1,1,-2,-2,0,0,-1,-2,4,-1,0,-44,-29,-15,-1,2,-3,-6,7,-23,-22,6,-2,-5,2,-9,-14,-2,-2,-1,5,-14,-8,8,0,3,2,-6,-1,3,-2,3,1,-2,-1,1,0,0,1,-4,0,2,-2,-9,2,-11,-4,-1,-3,-5,-3,4,-5,2,-2,-4,1,0,5,1,0,-1,-4,4,-10,1,-2,3,-1,-1,-4,-1,0,1,0,-1,-1,0,0,2,-1,0,-3,-1,0,34,18,16,-5,-7,2,5,0,21,3,2,1,1,-1,10,3,3,0,4,1,11,0,-1,1,-1,-1,4,-5,-3,0,-2,-1,0,-4,-1,0,1,0,4,-1,-2,0,-22,-11,-11,-6,-3,-3,-15,0,10,-18,1,3,-8,-1,6,-9,3,0,-7,1,4,-9,-2,3,-3,-1,1,-4,1,0,-2,0,2,-2,0,0,-1,-1,-1,-2,1,0,29,23,6,-3,-3,0,6,10,5,4,4,-2,0,6,4,4,7,0,6,4,1,0,-3,-2,-1,2,-3,-4,1,1,-3,0,-1,-1,1,1,2,2,-2,-3,0,0,-29,-17,-12,5,5,0,-9,4,-14,-1,-6,-4,-6,1,-10,4,-5,0,-3,3,-4,-5,-1,-4,0,2,5,0,-2,0,0,1,3,3,-2,0,0,1,2,-3,0,0,22,7,15,4,2,2,14,0,-2,4,2,5,4,1,-1,-1,1,4,10,-1,-1,5,1,1,0,1,-1,1,2,1,0,1,0,1,0,0,0,0,-1,0,2,1
17,17074,Fortià,507,21,6,15,6,2,4,6,4,4,5,3,-1,2,-1,1,3,2,-1,4,5,3,2,1,0,0,2,4,0,0,0,0,0,2,0,0,0,0,2,2,0,0,0,3,5,-2,3,2,1,2,3,3,-1,0,-3,1,3,1,0,1,-1,1,0,2,-1,-1,-2,0,0,0,1,2,0,0,0,0,1,1,0,0,0,0,0,1,0,13,7,6,7,4,3,6,-2,0,7,4,-2,5,0,-1,2,2,-1,1,-2,1,5,2,-1,1,2,0,4,2,-2,1,1,0,2,1,-1,0,1,0,2,1,-1,14,6,8,7,5,2,4,2,7,0,0,1,2,1,4,0,-1,0,2,1,3,0,1,1,3,0,1,3,0,0,2,0,1,2,0,0,1,0,0,1,0,0,15,17,-2,9,6,3,2,3,2,8,1,0,2,3,2,8,2,0,0,0,0,0,-1,0,0,1,3,5,0,0,0,1,2,3,0,0,0,0,1,2,0,0,3,0,3,6,2,4,-3,-1,4,3,-1,0,-1,-1,3,0,-1,-1,-2,0,1,3,0,1,0,1,3,1,0,1,0,0,2,0,0,0,0,1,1,1,0,1,15,10,5,7,3,4,2,-2,4,4,4,4,1,1,2,1,2,3,1,-3,2,3,2,1,0,2,1,1,1,2,0,2,0,0,0,1,0,0,1,1,1,1,14,4,10,4,2,2,0,4,3,5,1,2,1,1,-1,3,1,0,-1,3,4,2,0,2,1,0,1,1,1,0,1,0,0,0,1,0,0,0,1,1,0,0,7,8,-1,7,3,4,2,1,-4,1,2,6,1,0,1,2,1,3,1,1,-5,-1,1,3,2,2,0,1,0,2,0,1,0,1,0,1,2,1,0,0,0,1,1,-2,3,-3,-3,0,4,-1,5,-1,-3,-1,3,0,0,-1,-2,-1,1,-1,5,0,-1,0,0,0,0,0,-4,1,0,0,-1,0,-2,0,0,0,1,0,-2,1,14,5,9,-4,-3,-1,7,1,0,1,3,4,5,-1,-1,1,0,2,2,2,1,0,3,2,0,0,-1,-2,-2,1,0,0,0,-2,-2,1,0,0,-1,0,0,0,18,6,12,4,1,3,7,-2,7,3,1,3,0,-1,2,2,1,2,7,-1,5,1,0,1,2,0,0,0,0,2,1,0,-1,0,0,1,1,0,1,0,0,1,6,-1,7,-10,-8,-2,-1,-2,4,1,5,-2,0,-3,-1,-1,3,0,-1,1,5,2,2,-2,-2,-3,-1,-5,0,1,-1,-3,-1,-4,0,1,-1,0,0,-1,0,0,26,11,15,3,2,1,4,1,17,6,-2,-3,3,0,8,5,-3,-2,1,1,9,1,1,-1,0,0,2,0,1,0,0,0,1,0,1,0,0,0,1,0,0,0,18,5,13,-2,0,-2,8,2,7,5,-2,-3,1,1,5,2,-2,-2,7,1,2,3,0,-1,0,0,0,1,-3,0,0,1,0,1,-2,0,0,-1,0,0,-1,0,3,-1,4,5,1,4,5,1,-1,-1,-1,1,1,-2,1,-1,1,0,4,3,-2,0,-2,1,2,0,1,1,1,0,1,0,0,0,0,0,1,0,1,1,1,0,13,10,3,3,1,2,-2,0,5,8,4,-1,0,3,4,4,2,-2,-2,-3,1,4,2,1,0,0,1,0,2,0,0,0,1,0,0,0,0,0,0,0,2,0,9,10,-1,2,2,0,0,5,5,1,3,-8,-2,7,3,0,2,-3,2,-2,2,1,1,-5,-1,3,2,-2,0,0,-1,2,1,0,0,0,0,1,1,-2,0,0
17,17077,Garriguella,687,1,6,-5,12,11,1,-1,0,8,0,-5,-2,-1,3,8,1,-4,-2,0,-3,0,-1,-1,0,0,4,7,1,0,0,0,4,6,1,0,0,0,0,1,0,0,0,12,12,0,15,9,6,3,10,4,-3,-3,1,3,4,5,1,-1,0,0,6,-1,-4,-2,1,4,6,4,1,0,0,2,2,4,1,0,0,2,4,0,0,0,0,-14,-5,-9,12,8,4,-9,1,-6,-3,4,0,-3,2,-4,-2,3,0,-6,-1,-2,-1,1,0,0,3,7,0,2,0,0,2,5,-1,2,0,0,1,2,1,0,0,20,10,10,21,11,10,6,6,0,4,2,0,4,3,2,-1,1,0,2,3,-2,5,1,0,4,4,6,2,3,0,3,1,4,1,1,0,1,3,2,1,2,0,13,8,5,20,11,9,1,6,3,-1,8,-3,1,6,0,-2,4,-1,0,0,3,1,4,-2,2,6,6,5,1,0,0,5,5,1,0,0,2,1,1,4,1,0,11,-2,13,3,5,-2,2,2,0,3,-1,6,0,-2,1,-1,0,2,2,4,-1,4,-1,4,-3,0,4,2,-1,1,0,0,4,1,-1,1,-3,0,0,1,0,0,73,47,26,10,7,3,14,7,20,21,9,2,6,5,14,13,6,3,8,2,6,8,3,-1,1,2,0,6,1,1,0,2,0,4,1,1,1,0,0,2,0,0,19,3,16,20,7,13,5,8,3,0,2,0,-2,4,1,-1,2,-1,7,4,2,1,0,1,5,5,4,4,2,0,1,3,1,2,1,-1,4,2,3,2,1,1,7,-1,8,6,4,2,-5,0,4,-1,5,5,-3,-2,2,-2,2,3,-2,2,2,1,3,2,-1,3,1,-1,4,0,0,2,1,-1,2,0,-1,1,0,0,2,0,-1,-10,9,7,2,5,6,0,-5,5,-3,-4,1,0,-5,-1,-4,-1,5,0,0,6,1,-3,4,2,1,1,-1,0,1,1,1,-1,0,0,3,1,0,2,-1,0,10,8,2,6,2,4,-5,1,6,4,2,2,2,3,-3,5,-1,2,-7,-2,9,-1,3,0,-1,3,3,1,-1,1,0,2,0,0,-1,1,-1,1,3,1,0,0,-7,-11,4,2,0,2,6,0,-10,-3,3,-2,3,-3,-8,-2,1,-1,3,3,-2,-1,2,-1,1,-2,1,1,1,0,1,-2,0,1,0,0,0,0,1,0,1,0,19,12,7,6,3,3,9,7,5,2,-1,-3,5,2,1,2,0,1,4,5,4,0,-1,-4,1,5,1,0,-1,0,0,2,1,0,0,0,1,3,0,0,-1,0,3,7,-4,8,6,2,-8,-2,7,1,2,2,-5,-3,8,4,3,0,-3,1,-1,-3,-1,2,1,1,3,1,0,2,1,0,2,2,0,1,0,1,1,-1,0,1,-13,-13,0,-5,-3,-2,-2,-1,-1,-8,2,-2,-1,0,-6,-6,-1,1,-1,-1,5,-2,3,-3,-2,0,-1,-3,-1,2,-1,0,-1,-1,-1,1,-1,0,0,-2,0,1,6,5,1,7,1,6,-3,4,-1,10,-5,2,-5,0,2,10,-3,1,2,4,-3,0,-2,1,0,3,0,3,2,-2,0,0,0,2,0,-2,0,3,0,1,2,0,0,-7,7,16,5,11,-3,3,10,3,-4,-8,-2,2,2,-1,-2,-6,-1,1,8,4,-2,-2,2,2,7,6,0,-1,1,2,2,1,0,-1,1,0,5,5,0,0,-18,-8,-10,2,1,1,-8,0,-2,-9,3,-1,-2,0,0,-9,2,0,-6,0,-2,0,1,-1,-1,1,-2,3,2,-1,0,1,-2,1,1,0,-1,0,0,2,1,-1
17,17079,Girona,72682,1075,522,553,908,495,413,149,251,434,207,5,14,84,84,236,105,-6,12,65,167,198,102,11,2,175,203,321,160,29,12,92,102,187,91,14,4,83,101,134,69,15,8,1558,748,810,1375,685,690,163,441,639,216,50,45,102,172,371,85,-1,15,61,269,268,131,51,30,257,341,453,219,68,21,130,149,259,105,26,11,127,192,194,114,42,10,2476,1192,1284,1852,932,920,437,575,988,311,84,68,198,291,508,145,29,15,239,284,480,166,55,53,360,479,578,285,106,22,179,252,309,129,44,6,181,227,269,156,62,16,2201,1009,1192,1605,779,826,321,567,843,328,56,101,113,265,456,145,2,35,208,302,387,183,54,66,326,398,487,264,80,32,155,178,265,130,31,11,171,220,222,134,49,21,2188,1144,1044,1941,1004,937,216,625,778,433,43,127,94,319,444,246,5,54,122,306,334,187,38,73,325,509,614,342,90,44,166,271,324,169,40,24,159,238,290,173,50,20,2530,1423,1107,2264,1174,1090,284,724,908,435,124,84,158,389,542,267,55,29,126,335,366,168,69,55,369,635,721,379,108,31,178,309,407,211,45,9,191,326,314,168,63,22,2507,1204,1303,2803,1351,1452,263,956,903,320,15,60,165,438,480,128,1,2,98,518,423,192,14,58,447,904,846,427,110,40,242,429,437,177,43,8,205,475,409,250,67,32,1174,642,532,1891,987,904,12,685,488,-17,-28,58,-18,418,270,1,-36,25,30,267,218,-18,8,33,281,766,637,180,15,-10,143,425,341,77,-7,-3,138,341,296,103,22,-7,393,34,359,1093,519,574,-17,627,38,-232,-43,32,1,301,-20,-218,-40,20,-18,326,58,-14,-3,12,203,569,264,33,-5,15,129,297,90,-12,-1,11,74,272,174,45,-4,4,-930,-835,-95,-153,-397,244,-5,68,-436,-407,-130,8,15,-38,-407,-307,-83,-3,-20,106,-29,-100,-47,11,175,74,-196,-201,-21,0,101,-35,-256,-188,-24,-6,74,109,60,-13,3,6,-455,-730,275,-487,-599,112,-41,172,-270,-322,-65,42,-65,5,-349,-300,-53,18,24,167,79,-22,-12,24,65,67,-322,-263,-36,-16,34,-19,-328,-249,-40,-7,31,86,6,-14,4,-9,-325,-364,39,-508,-478,-30,74,338,-260,-348,-102,-3,61,116,-161,-291,-65,-2,13,222,-99,-57,-37,-1,63,127,-238,-320,-89,-64,40,20,-190,-265,-63,-29,23,107,-48,-55,-26,-35,-557,-492,-65,-181,-299,118,3,137,-366,-282,-70,48,-20,47,-210,-239,-80,26,23,90,-156,-43,10,22,12,190,-173,-207,-20,6,10,27,-152,-155,-39,5,2,163,-21,-52,19,1,-480,-299,-181,-784,-540,-244,31,105,-275,-297,-94,53,26,46,-157,-198,-35,23,5,59,-118,-99,-59,30,-16,7,-352,-309,-106,-16,-11,-21,-230,-225,-49,-6,-5,28,-122,-84,-57,-10,-70,-232,162,-316,-273,-43,112,206,-177,-224,-47,50,40,52,-145,-179,-40,30,72,154,-32,-45,-7,20,23,129,-193,-221,-70,-9,13,50,-128,-160,-60,-1,10,79,-65,-61,-10,-8,167,39,128,74,-49,123,29,297,-120,-38,-54,49,-5,142,-51,-41,-41,30,34,155,-69,3,-13,19,40,240,-25,-140,-45,-13,23,81,-25,-99,-33,-6,17,159,0,-41,-12,-7,555,121,434,546,103,443,154,337,201,-135,-61,63,52,112,71,-73,-79,37,102,225,130,-62,18,26,126,297,175,-60,-9,4,54,103,20,-61,-31,11,72,194,155,1,22,-7,764,327,437,852,348,504,148,541,262,-170,-34,-4,80,271,177,-143,-47,-22,68,270,85,-27,13,18,210,397,260,-58,-8,25,102,193,138,-73,-21,1,108,204,122,15,13,24
17,17083,Hostalric,2894,33,11,22,10,3,7,3,7,10,1,4,7,-3,4,-6,6,3,5,6,3,16,-5,1,2,2,1,7,0,0,0,1,0,2,0,0,0,1,1,5,0,0,0,-14,6,-20,3,1,2,-11,5,-13,4,4,-4,-2,5,-4,5,2,-1,-9,0,-9,-1,2,-3,0,1,2,0,0,0,0,0,1,0,0,0,0,1,1,0,0,0,103,57,46,22,14,8,22,27,37,11,0,2,10,15,21,9,-2,1,12,12,16,2,2,1,3,6,7,2,4,0,2,4,5,2,1,0,1,2,2,0,3,0,175,99,76,28,17,11,25,23,64,37,11,10,15,8,42,20,5,7,10,15,22,17,6,3,8,4,9,4,1,2,2,3,7,3,1,1,6,1,2,1,0,1,171,117,54,49,39,10,30,35,60,34,7,0,22,25,45,23,-1,-1,8,10,15,11,8,1,4,18,25,2,-1,0,2,15,20,1,0,0,2,3,5,1,-1,0,138,71,67,37,22,15,30,21,36,26,21,5,15,7,22,16,12,1,15,14,14,10,9,4,6,10,13,6,1,1,1,4,11,5,0,1,5,6,2,1,1,0,152,83,69,35,17,18,18,23,68,15,14,4,8,5,49,6,6,2,10,18,19,9,8,2,4,10,6,12,1,1,3,5,1,7,0,0,1,5,5,5,1,1,91,52,39,53,31,22,1,41,30,3,14,0,0,30,10,4,5,3,1,11,20,-1,9,-3,7,16,18,8,2,1,3,8,10,7,1,1,4,8,8,1,1,0,89,44,45,62,34,28,14,31,31,9,1,2,7,13,15,7,-2,4,7,18,16,2,3,-2,18,19,16,5,4,-2,9,12,8,1,2,0,9,7,8,4,2,-2,-5,-15,10,42,10,32,1,14,7,-12,-7,-6,-7,5,13,-14,-8,-4,8,9,-6,2,1,-2,14,14,10,1,4,-1,4,6,3,-3,1,-1,10,8,7,4,3,0,-9,-6,-3,-13,-16,3,1,1,10,-8,-4,-10,10,-5,10,-10,-7,-5,-9,6,0,2,3,-5,-2,3,3,-10,-6,-2,1,-1,0,-12,-3,-2,-3,4,3,2,-3,0,-39,-18,-21,-30,-26,-4,7,-3,-39,-8,-1,8,7,3,-19,-15,2,4,0,-6,-20,7,-3,4,4,-6,-20,-6,-4,2,2,-3,-15,-9,-2,1,2,-3,-5,3,-2,1,-50,-28,-22,-19,-11,-8,-19,-5,-6,-10,-1,-6,-14,0,4,-9,-4,-6,-5,-5,-10,-1,3,0,-8,-3,-5,2,-4,-1,-5,-1,-2,0,-2,-1,-3,-2,-3,2,-2,0,30,-1,31,-46,-25,-21,-6,23,-13,4,17,2,-7,9,-16,2,7,2,1,14,3,2,10,0,-15,-3,-9,-15,-2,-1,-6,-3,-6,-9,0,0,-9,0,-3,-6,-2,-1,10,4,6,-31,-25,-6,5,-12,3,15,-1,-3,-5,-6,0,10,5,-2,10,-6,3,5,-6,-1,-12,-2,-11,-7,1,0,-8,-2,-10,-6,1,0,-4,0,-1,-1,0,0,39,27,12,20,11,9,13,5,23,2,-6,3,11,8,9,3,-5,2,2,-3,14,-1,-1,1,14,3,1,1,-1,1,8,1,2,2,-2,0,6,2,-1,-1,1,1,64,22,42,56,27,29,18,11,20,24,-8,-5,3,2,8,21,-8,-4,15,9,12,3,0,-1,22,10,13,11,1,-1,11,6,6,4,0,0,11,4,7,7,1,-1,39,36,3,8,3,5,-10,4,22,15,-10,16,-2,3,12,18,-6,10,-8,1,10,-3,-4,6,-2,5,5,-4,-1,3,-1,1,4,-2,0,1,-1,4,1,-2,-1,2
17,17086,"Jonquera, La",2510,62,36,26,89,48,41,-6,14,38,8,14,-5,-5,11,15,6,11,-2,-1,3,23,2,3,-3,2,20,39,19,9,0,1,10,19,11,7,0,1,10,20,8,2,0,135,60,75,159,77,82,37,42,37,18,1,1,19,25,12,3,0,2,18,17,25,15,1,-1,35,40,54,17,9,4,20,23,21,6,5,2,15,17,33,11,4,2,73,48,25,152,85,67,-2,41,32,2,-1,-1,1,19,20,4,-1,3,-3,22,12,-2,0,-4,32,39,54,21,4,1,19,20,27,13,3,2,13,19,27,8,1,-1,111,78,33,141,71,70,12,34,52,17,-3,1,14,16,29,21,-2,2,-2,18,23,-4,-1,-1,20,39,57,16,6,2,11,19,26,12,1,2,9,20,31,4,5,0,57,51,6,127,70,57,-5,42,29,-3,-3,-5,2,28,26,-3,0,-3,-7,14,3,0,-3,-2,18,40,35,23,8,3,12,20,23,12,3,0,6,20,12,11,5,3,47,37,10,128,66,62,-13,32,14,9,4,2,-9,16,20,7,3,0,-4,16,-6,2,1,2,12,37,47,22,8,1,6,16,25,13,4,1,6,21,22,9,4,0,65,35,30,136,78,58,10,36,13,13,-2,-4,13,10,8,7,0,-1,-3,26,5,6,-2,-3,16,48,32,25,13,1,9,22,23,16,7,1,7,26,9,9,6,0,2,-12,14,86,42,44,30,-3,-2,-17,-7,0,14,5,-14,-15,-1,-1,16,-8,12,-2,-6,1,27,26,21,9,1,1,13,15,8,4,2,0,14,11,13,5,-1,1,39,7,32,81,34,47,0,56,14,-20,-17,3,3,28,2,-13,-15,0,-3,28,12,-7,-2,3,14,47,26,0,-6,1,13,22,7,-3,-5,0,1,25,19,3,-1,1,-68,-40,-28,-29,-27,-2,6,-23,-7,-26,-16,-3,4,-12,-9,-15,-7,-3,2,-11,2,-11,-9,0,18,-5,-14,-20,-7,-2,10,-6,-18,-12,-2,-1,8,1,4,-8,-5,-1,-18,-6,-12,-25,-31,6,14,21,-36,-1,-13,-6,7,3,-10,4,-12,-3,7,18,-26,-5,-1,-3,20,12,-31,-8,-14,-5,10,5,-23,-9,-12,-2,10,7,-8,1,-2,-3,98,68,30,96,53,43,11,20,41,16,0,1,7,6,28,17,5,1,4,14,13,-1,-5,0,28,15,32,17,-1,1,15,3,18,14,1,0,13,12,14,3,-2,1,-83,-49,-34,-42,-27,-15,-29,0,-35,-17,0,-3,-15,3,-25,-12,0,-1,-14,-3,-10,-5,0,-2,-2,-4,-18,-18,-4,1,0,-1,-14,-11,-2,-1,-2,-3,-4,-7,-2,2,-18,-9,-9,-10,-10,0,-2,0,13,-22,-11,1,-1,3,12,-20,-6,1,-1,-3,1,-2,-5,0,-3,4,10,-16,-5,-1,-1,0,8,-16,-2,-1,-2,4,2,0,-3,0,103,43,60,48,16,32,21,27,5,49,4,-5,9,2,0,35,1,-4,12,25,5,14,3,-1,10,15,-1,17,6,0,1,1,1,12,1,0,9,14,-2,5,5,0,18,18,0,8,1,7,9,19,-17,10,-5,2,1,17,-2,1,-4,3,8,2,-15,9,-1,-1,-4,16,-14,9,-3,1,-2,9,-7,1,-2,0,-2,7,-7,8,-1,1,-60,-33,-27,-2,-1,-1,-20,18,-31,-10,-21,4,-15,4,-4,-6,-19,6,-5,14,-27,-4,-2,-2,0,14,-13,-5,-6,6,-3,4,0,-2,-7,5,3,10,-13,-3,1,1,65,19,46,72,27,45,33,17,18,-6,14,-13,14,7,10,-14,11,-8,19,10,8,8,3,-5,22,16,16,8,10,-3,10,8,7,-3,6,-1,12,8,9,11,4,-2
17,17089,Llagostera,5624,133,83,50,103,75,28,16,9,52,30,13,9,5,8,39,21,4,5,11,1,13,9,9,4,16,17,46,21,3,0,10,10,35,17,3,0,6,7,11,4,0,0,139,91,48,118,77,41,17,38,30,27,23,5,8,27,24,18,14,1,9,11,6,9,9,4,17,25,34,25,8,8,10,17,23,19,4,4,7,8,11,6,4,4,236,133,103,124,79,45,54,41,67,30,25,11,30,28,43,9,15,4,24,13,24,21,10,7,27,36,39,15,4,3,14,21,33,7,3,1,13,15,6,8,1,2,258,125,133,125,66,59,43,39,81,45,27,17,21,16,49,25,15,-3,22,23,32,20,12,20,34,23,33,21,10,2,18,12,21,10,5,0,16,11,12,11,5,2,265,176,89,163,112,51,27,54,93,42,31,11,24,35,53,34,17,8,3,19,40,8,14,3,30,36,46,29,15,5,18,25,30,24,10,4,12,11,16,5,5,1,339,196,143,153,92,61,46,60,134,54,27,14,19,40,84,32,11,8,27,20,50,22,16,6,27,37,59,19,10,-2,15,26,41,8,4,-2,12,11,18,11,6,0,279,161,118,139,86,53,14,84,106,27,33,16,9,51,53,28,14,8,5,33,53,-1,19,8,14,51,51,21,2,0,7,31,30,18,1,-1,7,20,21,3,1,1,210,103,107,106,47,59,29,79,44,16,20,11,8,42,25,8,13,2,21,37,19,8,7,9,19,63,8,4,6,2,8,30,4,2,2,-1,11,33,4,2,4,3,190,108,82,130,81,49,23,53,83,7,4,14,19,35,40,8,0,2,4,18,43,-1,4,12,21,40,42,15,3,5,14,28,27,8,0,2,7,12,15,7,3,3,165,71,94,73,30,43,32,27,69,15,10,13,16,4,28,7,9,7,16,23,41,8,1,6,18,13,30,10,0,3,6,7,14,3,0,1,12,6,16,7,0,2,106,58,48,40,21,19,34,5,42,11,11,9,21,8,18,1,3,9,13,-3,24,10,8,0,16,15,8,1,1,-1,9,13,3,-4,-1,1,7,2,5,5,2,-2,-17,-9,-8,67,41,26,-37,8,15,-4,6,-4,-22,1,24,-5,-5,-3,-15,7,-9,1,11,-1,8,16,21,10,7,4,6,10,19,5,-1,2,2,6,2,5,8,2,26,10,16,18,-1,19,8,11,-17,10,9,-1,13,9,-26,4,6,1,-5,2,9,6,3,-2,-6,6,10,7,1,-1,-2,1,2,-1,0,-1,-4,5,8,8,1,0,-65,-61,-4,-74,-58,-16,-13,-3,-29,-7,-22,7,-7,3,-31,-13,-10,-3,-6,-6,2,6,-12,10,-7,5,-36,-27,-15,3,-4,1,-28,-20,-10,1,-3,4,-8,-7,-5,2,17,5,12,27,14,13,-17,14,26,-23,11,9,-9,11,16,-19,3,4,-8,3,10,-4,8,5,1,3,22,0,0,1,3,2,15,-6,0,0,-2,1,7,6,0,1,2,-9,11,-49,-29,-20,-5,9,-20,12,3,1,4,0,-13,4,2,-7,-9,9,-7,8,1,8,-8,-1,-12,-7,-3,-19,0,-6,-9,-2,-2,-11,-8,5,-3,-5,-1,-8,-73,-44,-29,-95,-49,-46,-20,0,-19,-11,-23,-1,-7,3,-16,-9,-15,1,-13,-3,-3,-2,-8,-2,-21,2,-29,-16,-23,-7,-7,3,-16,-10,-16,-3,-14,-1,-13,-6,-7,-4,87,47,40,31,18,13,4,20,23,17,2,17,5,4,17,7,5,4,-1,16,6,10,-3,13,9,10,8,3,-2,2,5,3,7,2,-2,2,4,7,1,1,0,0
17,17092,Llançà,3982,50,34,16,35,20,15,1,0,6,12,11,17,1,5,12,4,3,8,0,-5,-6,8,8,9,3,4,7,8,6,5,1,3,4,5,3,3,2,1,3,3,3,2,71,29,42,37,19,18,3,16,-5,19,28,9,2,3,0,6,15,3,1,13,-5,13,13,6,5,3,6,6,10,7,2,1,4,4,4,4,3,2,2,2,6,3,78,42,36,39,16,23,5,9,19,26,11,5,3,6,6,16,7,1,2,3,13,10,4,4,6,4,8,8,8,5,2,2,5,3,4,0,4,2,3,5,4,5,140,74,66,58,34,24,15,7,30,39,43,5,11,6,14,17,25,3,4,1,16,22,18,2,2,6,11,11,28,0,0,5,7,7,14,1,2,1,4,4,14,-1,139,57,82,102,49,53,1,30,44,17,32,15,1,7,20,11,13,4,0,23,24,6,19,11,14,12,24,23,14,14,7,3,13,13,6,6,7,9,11,10,8,8,177,88,89,101,54,47,29,26,51,54,10,3,14,14,25,32,0,3,15,12,26,22,10,0,9,20,23,26,16,4,6,8,13,14,8,4,3,12,10,12,8,0,272,135,137,117,60,57,45,34,77,76,22,15,15,17,44,40,12,6,30,17,33,36,10,9,18,21,24,28,14,10,4,9,14,15,12,5,14,12,10,13,2,5,200,115,85,99,59,40,26,22,58,49,34,13,11,9,35,32,19,9,15,13,23,17,15,4,7,22,29,21,20,0,5,7,21,13,12,1,2,15,8,8,8,-1,121,67,54,92,42,50,19,13,26,26,26,14,10,7,14,12,20,6,9,6,12,14,6,8,14,16,25,13,17,7,7,4,10,6,11,4,7,12,15,7,6,3,13,1,12,-18,-17,-1,1,2,18,-3,14,-23,-1,-4,23,-9,5,-13,2,6,-5,6,9,-10,7,4,-13,-6,1,-14,4,3,-8,-5,-5,-6,3,1,-5,-1,6,-8,-90,-39,-51,-81,-40,-41,-16,-10,-14,-21,-5,-27,-11,2,-5,-10,-1,-17,-5,-12,-9,-11,-4,-10,-6,-1,-17,-27,-9,-24,-5,2,-11,-11,-4,-14,-1,-3,-6,-16,-5,-10,7,2,5,-5,-15,10,15,-4,-12,-8,-10,21,10,-3,-6,-11,-1,10,5,-1,-6,3,-9,11,-2,1,-10,-5,4,7,-3,-2,-6,-9,2,3,1,3,-4,4,2,4,-75,-44,-31,-52,-39,-13,-3,9,-19,-18,-5,-36,-1,1,-4,-11,-7,-20,-2,8,-15,-7,2,-16,0,1,-14,-5,-11,-23,0,-1,-9,-3,-13,-13,0,2,-5,-2,2,-10,-50,-33,-17,-12,-9,-3,-11,15,-22,-12,5,-22,-9,9,-3,-14,0,-14,-2,6,-19,2,5,-8,-5,6,-9,-7,9,-6,-4,3,-3,-3,1,-3,-1,3,-6,-4,8,-3,32,19,13,18,9,9,-5,6,2,18,-2,11,0,2,-1,20,-5,3,-5,4,3,-2,3,8,4,5,-7,6,9,1,2,3,-5,7,2,0,2,2,-2,-1,7,1,67,46,21,32,21,11,12,-8,19,13,33,-4,15,1,2,6,24,-2,-3,-9,17,7,9,-2,4,3,12,-1,16,-2,3,4,10,-3,8,-1,1,-1,2,2,8,-1,-24,-19,-5,2,1,1,2,2,-4,-24,-10,8,7,0,-11,-16,-6,5,-5,2,7,-8,-4,3,-1,10,-12,-2,-2,8,1,8,-10,-1,-3,6,-2,2,-2,-1,1,2,47,36,11,71,36,35,-2,7,0,8,32,3,-2,4,7,4,16,6,0,3,-7,4,16,-3,9,11,12,6,21,12,3,8,6,4,7,8,6,3,6,2,14,4
17,17093,Llers,922,52,24,28,5,3,2,14,6,9,19,1,2,6,2,3,9,2,2,8,4,6,10,-1,0,0,2,0,2,0,1,0,1,0,1,0,1,0,1,0,1,0,0,39,15,24,14,6,8,16,8,17,-4,0,3,5,4,7,-2,0,1,11,4,10,-2,0,2,5,3,4,1,1,0,1,1,2,1,1,0,4,2,2,0,0,0,27,15,12,13,6,7,11,1,10,3,1,-2,4,2,4,3,2,-1,7,-1,6,0,-1,-1,0,2,2,4,3,0,0,0,1,3,2,0,0,2,1,1,1,0,31,17,14,13,7,6,8,-4,7,12,4,1,6,-2,1,9,1,0,2,-2,6,3,3,1,2,1,5,4,0,0,1,1,2,3,-1,0,1,0,3,1,1,0,46,28,18,24,13,11,8,3,10,6,15,3,6,0,5,6,7,3,2,3,5,0,8,0,2,5,10,2,4,0,1,2,7,1,1,0,1,3,3,1,3,0,23,15,8,13,6,7,-2,5,6,11,2,1,-1,5,3,5,3,0,-1,0,3,6,-1,1,3,3,3,1,2,1,1,2,1,0,2,0,2,1,2,1,0,1,-13,-12,-1,17,11,6,-2,3,-14,-7,-2,8,-1,-1,-6,-4,-2,2,-1,4,-8,-3,0,6,3,3,6,4,1,0,1,2,6,2,0,0,2,1,0,2,1,0,24,15,9,17,7,10,4,10,10,8,-6,-2,6,5,3,5,-1,-2,-2,5,7,3,-5,0,3,5,6,2,0,0,2,1,4,0,0,0,1,4,2,2,0,0,22,12,10,11,4,7,5,11,9,5,-7,-2,2,5,6,4,-4,-2,3,6,3,1,-3,0,0,5,5,1,-1,0,0,2,2,1,-1,0,0,3,3,0,0,0,-1,-2,1,13,6,7,5,-3,-1,0,2,-2,5,1,-7,-2,0,0,0,-4,6,2,2,-2,1,4,7,1,0,0,1,2,2,1,0,0,0,2,5,0,0,0,23,7,16,9,5,4,15,8,-4,5,-3,2,5,2,0,-4,2,2,10,6,-4,9,-5,0,0,5,3,0,1,0,0,2,2,0,1,0,0,3,1,0,0,0,6,0,6,0,-2,2,4,-6,9,1,0,-5,2,-2,0,-1,1,-3,2,-4,9,2,-1,-2,0,-2,1,0,1,0,0,-2,1,-1,0,0,0,0,0,1,1,0,35,15,20,3,0,3,19,3,6,4,2,-1,9,3,-3,4,4,-2,10,0,9,0,-2,1,2,1,0,0,0,0,0,0,-1,1,0,0,2,1,1,-1,0,0,23,-1,24,4,3,1,5,-1,10,2,2,1,-3,0,5,-2,-1,-1,8,-1,5,4,3,2,0,0,1,1,2,0,0,1,2,0,0,0,0,-1,-1,1,2,0,-29,-13,-16,-41,-18,-23,-2,0,-14,-2,-6,-5,-3,-1,-2,1,-3,-5,1,1,-12,-3,-3,0,-6,0,-16,-11,-5,-3,-3,0,-7,-2,-3,-3,-3,0,-9,-9,-2,0,6,7,-1,-1,-1,0,2,3,2,-7,0,4,2,1,2,-4,2,2,0,2,0,-3,-2,2,-2,-1,-2,3,1,1,-2,0,-1,1,0,1,0,-1,-1,2,1,0,6,2,4,7,1,6,6,-5,-9,15,1,-1,1,-1,-6,9,-1,0,5,-4,-3,6,2,-1,0,2,0,4,-1,2,0,1,0,0,-1,1,0,1,0,4,0,1,30,17,13,6,5,1,10,-1,14,10,3,-5,4,1,6,9,-1,-2,6,-2,8,1,4,-3,4,-1,5,1,-3,0,2,0,4,2,-3,0,2,-1,1,-1,0,0
17,17094,Llívia,961,44,28,16,15,8,7,-2,14,20,1,5,6,-2,7,12,5,4,2,0,7,8,-4,1,4,2,5,4,3,0,1,1,3,1,3,0,0,1,2,3,0,0,1,53,30,23,35,21,14,6,13,16,16,2,1,3,6,9,13,0,0,3,7,7,3,2,1,6,10,8,11,0,0,4,5,5,7,0,0,2,5,3,4,0,0,44,23,21,36,21,15,11,22,-5,10,6,2,6,11,-1,4,6,-1,5,11,-4,6,0,3,4,13,5,10,4,0,2,6,4,5,4,0,2,7,1,5,0,0,34,16,18,37,16,21,6,6,14,10,2,-3,5,-1,9,6,-1,-1,1,7,5,4,3,-2,10,10,7,8,2,0,6,3,3,4,0,0,4,7,4,4,2,0,78,48,30,37,19,18,4,15,33,18,6,0,4,-1,26,13,4,1,0,16,7,5,2,-1,5,8,11,9,0,2,2,2,7,6,0,1,3,6,4,3,0,1,33,15,18,32,18,14,10,6,15,3,3,-1,3,5,9,1,0,-1,7,1,6,2,3,0,7,7,12,6,0,0,2,4,6,6,0,0,5,3,6,0,0,0,109,67,42,38,19,19,15,20,48,30,-4,-1,14,8,29,19,-3,-1,1,12,19,11,-1,0,7,11,8,12,0,0,4,4,5,6,0,0,3,7,3,6,0,0,118,73,45,34,20,14,22,25,21,32,12,6,16,15,16,19,7,2,6,10,5,13,5,4,7,10,11,4,1,0,6,6,7,2,-1,0,1,4,4,2,2,0,74,44,30,28,16,12,10,15,22,25,4,-1,9,4,17,13,1,-1,1,11,5,12,3,0,4,11,4,9,-1,0,3,5,2,6,-1,0,1,6,2,3,0,0,36,11,25,11,0,11,5,10,2,12,5,1,1,7,0,0,1,0,4,3,2,12,4,1,5,3,0,4,-1,0,3,2,-1,-2,-2,0,2,1,1,6,1,0,54,29,25,22,13,9,-3,11,28,9,1,2,-1,9,12,4,0,1,-2,2,16,5,1,1,3,3,10,4,1,-1,2,3,5,2,0,0,1,0,5,2,1,-1,31,27,4,12,4,8,0,8,10,14,-1,1,0,9,14,7,-2,-1,0,-1,-4,7,1,2,1,6,2,0,3,0,1,2,0,0,1,0,0,4,2,0,2,0,-57,-32,-25,3,3,0,1,-4,-3,-31,-24,3,1,-5,-1,-18,-10,2,0,1,-2,-13,-14,1,0,1,1,-3,2,2,0,1,1,-2,1,2,0,0,0,-1,1,0,-46,-19,-27,0,1,-1,-5,1,-23,-8,-3,-7,-3,-2,-10,-1,0,-2,-2,3,-13,-7,-3,-5,0,4,-4,-2,2,0,1,1,-1,-1,1,0,-1,3,-3,-1,1,0,-140,-87,-53,-95,-62,-33,-7,-13,-33,-51,-27,-8,-4,-8,-23,-31,-18,-1,-3,-5,-10,-20,-9,-7,-6,-6,-29,-34,-16,-4,-3,-3,-20,-25,-10,-1,-3,-3,-9,-9,-6,-3,24,7,17,10,3,7,3,10,27,-8,-2,-5,2,4,13,-7,-3,-1,1,6,14,-1,1,-4,0,2,9,-2,1,0,1,1,2,-1,0,0,-1,1,7,-1,1,0,-47,-30,-17,-33,-22,-11,-6,3,-6,-22,-10,-6,-5,-1,-5,-11,-4,-4,-1,4,-1,-11,-6,-2,-4,-2,-10,-11,-3,-3,-4,-1,-5,-6,-4,-2,0,-1,-5,-5,1,-1,23,4,19,15,5,10,5,7,2,3,2,3,3,0,5,-7,2,1,2,7,-3,10,0,2,3,6,0,5,0,1,1,3,0,1,0,0,2,3,0,4,0,1
17,17095,Lloret de Mar,19041,419,205,214,97,56,41,32,91,98,76,69,53,6,56,47,41,35,20,26,35,51,35,34,33,11,17,28,20,13,7,2,13,19,13,7,2,9,4,9,7,6,5,1453,818,635,1223,704,519,147,344,413,304,132,116,86,186,255,184,59,52,61,158,158,120,73,64,159,287,415,226,98,34,90,154,257,135,47,18,69,133,158,91,51,16,1657,944,713,1463,824,639,197,410,584,288,130,45,111,245,364,152,52,18,86,165,220,136,78,27,206,370,512,245,102,21,115,202,309,140,44,11,91,168,203,105,58,10,1785,973,812,1468,777,691,258,379,508,346,175,101,122,179,323,219,85,38,136,200,185,127,90,63,243,356,411,282,121,44,117,164,250,166,53,22,126,192,161,116,68,22,2580,1513,1067,1801,1040,761,350,541,829,447,287,116,194,331,520,273,137,49,156,210,309,174,150,67,226,434,580,319,179,53,124,242,368,197,82,21,102,192,212,122,97,32,3053,1772,1281,2161,1282,879,370,699,923,639,289,102,226,385,555,403,142,49,144,314,368,236,147,53,281,567,672,401,170,54,166,326,425,248,82,29,115,241,247,153,88,25,3015,1721,1294,2306,1304,1002,381,763,915,555,270,104,212,408,574,329,139,45,169,355,341,226,131,59,302,665,657,412,174,73,159,360,426,245,74,30,143,305,231,167,100,43,2401,1358,1043,2032,1121,911,367,638,742,429,160,60,190,371,455,241,66,33,177,267,287,188,94,27,337,586,632,355,102,9,160,341,367,201,45,3,177,245,265,154,57,6,1417,778,639,1499,806,693,236,449,349,203,108,62,124,234,210,120,46,35,112,215,139,83,62,27,245,493,423,213,79,31,144,252,242,107,31,20,101,241,181,106,48,11,397,125,272,677,286,391,30,193,-7,58,64,54,15,77,-36,19,26,25,15,116,29,39,38,29,114,273,114,76,67,18,56,116,36,28,34,10,58,157,78,48,33,8,268,102,166,547,237,310,108,171,-80,19,28,8,62,97,-68,3,1,1,46,74,-12,16,27,7,135,208,60,71,48,6,77,104,5,20,19,3,58,104,55,51,29,3,415,144,271,718,314,404,109,194,-35,16,67,43,53,81,-41,-5,38,8,56,113,6,21,29,35,145,215,115,129,72,18,77,95,32,59,34,4,68,120,83,70,38,14,-177,-181,4,185,18,167,4,1,-184,-78,30,39,33,-7,-171,-89,22,21,-29,8,-13,11,8,18,76,82,-50,26,34,6,57,16,-88,-12,28,8,19,66,38,38,6,-2,-313,-267,-46,52,-34,86,-32,1,-152,-173,8,19,-24,-26,-118,-102,-8,3,-8,27,-34,-71,16,16,27,60,-47,-47,39,1,17,19,-59,-40,17,3,10,41,12,-7,22,-2,-1913,-1073,-840,-1488,-856,-632,-138,-105,-488,-573,-377,-239,-65,-62,-220,-390,-225,-119,-73,-43,-268,-183,-152,-120,-82,-38,-372,-482,-312,-219,-29,-31,-189,-321,-196,-100,-53,-7,-183,-161,-116,-119,-532,-364,-168,-370,-291,-79,74,24,-228,-320,-92,-11,54,8,-162,-193,-71,-12,20,16,-66,-127,-21,1,57,57,-192,-228,-80,-11,40,22,-138,-158,-71,-2,17,35,-54,-70,-9,-9,-292,-138,-154,-265,-128,-137,75,72,-148,-158,-113,-56,55,46,-50,-113,-58,-34,20,26,-98,-45,-55,-22,56,76,-128,-150,-81,-62,48,42,-43,-111,-39,-34,8,34,-85,-39,-42,-28,-193,-121,-72,-135,-100,-35,57,62,-67,-171,-67,-36,40,24,-14,-108,-44,-35,17,38,-53,-63,-23,-1,76,79,-62,-140,-72,-44,51,34,-19,-110,-35,-39,25,45,-43,-30,-37,-5
17,17102,Maçanet de Cabrenys,650,8,4,4,2,1,1,-8,5,0,4,0,7,-3,1,-1,3,0,4,-5,4,1,1,0,3,0,0,1,0,1,0,0,0,0,0,1,0,0,0,1,0,0,0,17,11,6,4,1,3,3,3,-3,7,5,2,3,1,-1,4,3,1,0,2,-2,3,2,1,1,1,1,1,0,0,1,0,0,0,0,0,0,1,1,1,0,0,35,15,20,13,7,6,14,6,4,6,9,-6,3,2,4,1,7,-2,11,4,0,5,2,-4,4,0,2,4,3,0,1,0,2,1,3,0,3,0,0,3,0,0,30,15,15,10,6,4,5,-1,10,0,16,0,3,2,3,-1,8,0,2,-3,7,1,8,0,2,3,3,1,3,-2,1,2,2,1,1,-1,1,1,1,0,2,-1,22,13,9,4,3,1,4,1,1,6,5,5,2,2,3,2,1,3,2,-1,-2,4,4,2,0,1,1,2,0,0,0,1,1,1,0,0,0,0,0,1,0,0,-15,-5,-10,3,2,1,-6,1,-7,-5,1,3,-3,1,-1,-5,1,2,-3,0,-6,0,0,1,1,0,2,0,0,0,1,0,1,0,0,0,0,0,1,0,0,0,1,4,-3,4,3,1,-8,-3,-5,9,8,0,0,-2,-3,4,6,-1,-8,-1,-2,5,2,1,0,1,2,1,0,0,0,1,1,1,0,0,0,0,1,0,0,0,4,0,4,5,5,0,2,2,-4,4,-1,2,-2,0,-4,3,1,2,4,2,0,1,-2,0,1,1,1,2,0,0,0,1,1,2,0,1,1,0,0,0,0,-1,8,-3,11,3,2,1,5,2,-4,7,0,-2,3,0,-5,2,-2,-1,2,2,1,5,2,-1,3,1,0,-1,1,-1,3,1,0,-1,0,-1,0,0,0,0,1,0,-2,0,-2,9,6,3,0,2,-2,3,3,-6,-1,3,-2,1,2,-1,1,-1,0,2,1,-5,4,2,1,0,1,1,2,2,0,0,1,1,2,0,1,0,0,0,14,11,3,13,10,3,9,0,4,0,0,2,8,-1,1,1,2,1,1,1,3,-1,-2,1,4,3,5,0,1,0,4,2,4,0,0,0,0,1,1,0,1,0,9,10,-1,7,5,2,4,-1,-1,4,2,1,4,0,0,3,0,3,0,-1,-1,1,2,-2,0,0,3,2,0,2,0,0,1,2,0,2,0,0,2,0,0,0,15,11,4,14,8,6,0,2,9,7,-3,1,2,0,6,6,-1,-1,-2,2,3,1,-2,2,3,2,5,2,2,0,2,1,2,1,2,0,1,1,3,1,0,0,37,14,23,9,2,7,4,6,8,10,9,1,0,2,3,7,5,-2,4,4,5,3,4,3,2,1,0,3,3,0,0,0,-1,1,2,0,2,1,1,2,1,0,-4,0,-4,5,3,2,2,-2,1,-3,-2,0,1,-1,2,-2,0,0,1,-1,-1,-1,-2,0,2,1,0,2,0,0,1,0,0,2,0,0,1,1,0,0,0,0,-8,7,-15,8,6,2,-8,1,4,2,-3,-3,-3,3,8,2,-2,-1,-5,-2,-4,0,-1,-2,2,2,3,2,-1,0,1,1,3,1,-1,1,1,1,0,1,0,-1,-23,-17,-6,5,2,3,-8,-2,-7,-5,3,-4,-2,-1,-6,-6,0,-2,-6,-1,-1,1,3,-2,0,0,0,2,3,0,0,0,0,1,1,0,0,0,0,1,2,0,-15,-4,-11,-4,-2,-2,-4,-2,-2,1,-5,-3,-2,-2,2,0,-3,0,-2,0,-4,1,-2,-3,-2,0,0,0,0,-2,-1,0,1,-1,0,-1,-1,0,-1,1,0,-1
17,17103,Maçanet de la Selva,3672,153,78,75,5,2,3,25,25,42,29,21,10,6,14,22,16,15,5,19,11,20,13,6,5,0,2,1,0,2,0,0,0,1,0,1,0,0,2,0,0,1,0,137,74,63,25,12,13,23,21,12,50,22,11,9,10,7,30,15,3,14,11,5,20,7,8,6,4,6,5,1,2,3,1,2,3,1,1,3,3,4,2,0,1,285,143,142,41,19,22,70,19,77,59,48,13,38,5,40,29,27,4,32,14,37,30,21,9,11,6,10,7,6,1,5,4,3,5,2,0,6,2,7,2,4,1,367,209,158,38,24,14,76,26,140,48,58,12,48,13,76,30,33,6,28,13,64,18,25,6,6,6,13,6,5,2,4,2,8,5,4,1,2,4,5,1,1,1,406,209,197,78,48,30,63,46,133,97,47,9,37,26,63,44,27,3,26,20,70,53,20,6,12,15,22,17,8,2,8,10,13,10,4,1,4,5,9,7,4,1,311,139,172,96,49,47,49,61,114,49,28,2,13,35,61,17,11,-2,36,26,53,32,17,4,23,19,32,12,8,2,8,11,16,9,3,2,15,8,16,3,5,0,515,291,224,108,60,48,96,78,136,90,76,32,45,44,82,53,46,18,51,34,54,37,30,14,21,27,20,17,18,5,9,12,13,12,10,4,12,15,7,5,8,1,331,235,96,111,71,40,39,60,91,64,37,30,35,42,68,44,25,19,4,18,23,20,12,11,15,26,31,26,9,2,9,17,20,18,5,1,6,9,11,8,4,1,165,112,53,73,40,33,20,25,50,27,22,14,10,15,36,27,10,13,10,10,14,0,12,1,7,26,16,14,8,1,0,16,10,9,4,1,7,10,6,5,4,0,102,46,56,47,16,31,40,12,38,8,11,-8,20,2,20,3,4,-3,20,10,18,5,7,-5,12,14,19,5,-3,0,6,4,10,1,-5,-1,6,10,9,4,2,1,71,33,38,58,29,29,20,-8,-1,30,16,14,10,-1,1,17,5,1,10,-7,-2,13,11,13,16,15,10,13,3,0,8,6,6,7,2,-1,8,9,4,6,1,1,24,14,10,51,22,29,2,-9,12,-11,17,11,14,-3,6,-10,4,3,-12,-6,6,-1,13,8,12,17,15,4,2,1,11,7,2,0,1,1,1,10,13,4,1,0,2,-22,24,11,2,9,-27,10,-7,5,24,-3,-23,2,1,-10,13,-4,-4,8,-8,15,11,1,1,2,0,4,1,3,1,2,-1,-2,0,2,0,0,1,6,1,1,-148,-56,-92,3,1,2,-49,-20,-31,-53,7,4,-11,-8,-18,-15,3,-4,-38,-12,-13,-38,4,8,-4,1,2,4,0,1,-3,2,2,2,0,-1,-1,-1,0,2,0,2,-20,-2,-18,26,14,12,-20,12,9,-14,-5,-4,-5,9,14,-18,0,-4,-15,3,-5,4,-5,0,1,9,2,-1,7,8,0,5,3,-2,5,3,1,4,-1,1,2,5,13,17,-4,38,24,14,15,-3,13,-15,-4,-3,17,-6,6,-12,-2,8,-2,3,7,-3,-2,-11,3,9,16,3,6,0,3,5,10,3,2,0,0,4,6,0,4,0,41,43,-2,33,19,14,-4,7,21,2,16,-3,-14,8,19,19,15,-5,10,-1,2,-17,1,2,2,11,11,2,2,5,-1,4,8,4,1,3,3,7,3,-2,1,2,108,59,49,40,20,20,28,14,20,19,12,11,8,2,13,22,2,8,20,12,7,-3,10,3,5,10,8,7,3,6,2,3,5,3,2,4,3,7,3,4,1,2
17,17110,Mont-ras,1599,42,22,20,18,10,8,23,-10,22,5,1,2,13,-5,8,6,2,0,10,-5,14,-1,-1,2,6,1,3,4,2,2,2,0,3,2,2,1,4,1,0,2,0,1,-3,-11,8,12,6,6,4,-3,0,-4,-1,1,3,-7,-4,-3,0,1,1,4,4,-1,-1,0,2,4,4,1,1,0,0,1,3,1,1,0,2,3,1,0,0,0,63,35,28,14,7,7,27,-5,23,19,-1,1,17,-3,10,12,0,0,10,-2,13,7,-1,1,0,5,4,4,1,0,0,3,1,2,1,0,0,2,3,2,0,0,-50,-27,-23,6,3,3,-14,-8,-13,-9,0,-6,-12,-3,-6,-5,1,-2,-2,-5,-7,-4,-1,-4,0,3,2,1,0,0,0,1,1,1,0,0,0,2,1,0,0,0,41,33,8,20,10,10,24,2,8,8,-2,-1,18,11,1,2,1,-2,6,-9,7,6,-3,1,3,5,3,3,3,3,2,4,1,0,2,1,1,1,2,3,1,2,12,8,4,24,15,9,7,-5,-6,10,4,-1,-1,-1,-4,7,3,1,8,-4,-2,3,1,-2,3,7,6,5,3,0,2,5,3,3,2,0,1,2,3,2,1,0,23,12,11,16,10,6,3,-3,17,4,0,1,2,-2,8,1,1,1,1,-1,9,3,-1,0,3,3,6,4,-1,1,3,2,4,1,-1,1,0,1,2,3,0,0,-23,-17,-6,11,7,4,-2,-3,-10,0,-7,-2,0,-3,-9,3,-7,-1,-2,0,-1,-3,0,-1,0,1,7,3,0,0,0,1,3,3,0,0,0,0,4,0,0,0,-13,-10,-3,3,2,1,2,-6,-11,-4,4,-1,-4,-6,-2,-1,2,0,6,0,-9,-3,2,-1,1,3,0,1,0,-2,0,2,0,1,0,-1,1,1,0,0,0,-1,-20,-19,-1,3,1,2,3,-8,-16,3,-2,2,-1,-5,-10,1,-4,1,4,-3,-6,2,2,1,1,3,-2,0,1,0,1,2,-2,0,0,0,0,1,0,0,1,0,7,3,4,13,8,5,3,10,-14,5,-2,3,6,3,-10,2,-3,3,-3,7,-4,3,1,0,5,4,2,1,0,1,5,2,2,0,-1,0,0,2,0,1,1,1,-15,-12,-3,-9,-3,-6,5,-14,1,0,-8,-1,3,-8,0,-1,-7,-1,2,-6,1,1,-1,0,-3,-1,-1,-1,-2,0,-1,-1,0,0,-1,0,-2,0,-1,-1,-1,0,-33,-16,-17,-12,-5,-7,-6,-3,-9,-13,-6,4,-5,-1,-4,-6,-1,1,-1,-2,-5,-7,-5,3,0,-2,-1,-7,-2,0,0,-1,0,-3,-1,0,0,-1,-1,-4,-1,0,-37,-16,-21,-9,-3,-6,-17,-3,-7,-9,-4,3,-7,-1,-2,-5,-2,1,-10,-2,-5,-4,-2,2,-6,1,1,-2,-3,0,-2,1,1,-1,-2,0,-4,0,0,-1,-1,0,-29,-8,-21,-7,-5,-2,-10,-2,-7,-10,-2,3,-4,0,-1,-3,-2,2,-6,-2,-6,-7,0,1,-2,-1,-3,-3,0,2,-1,-1,-2,-3,0,2,-1,0,-1,0,0,0,-20,-8,-12,6,3,3,-7,0,-13,-1,6,-3,-2,-3,-3,-1,3,-1,-5,3,-10,0,3,-2,-1,2,1,2,2,0,-1,0,2,0,2,0,0,2,-1,2,0,0,29,18,11,-1,-5,4,20,2,2,7,-3,2,19,-2,2,-1,-1,2,1,4,0,8,-2,0,4,-1,1,-5,-2,2,1,-1,-2,-3,-1,1,3,0,3,-2,-1,1,-17,-5,-12,4,-2,6,-2,-7,-1,-3,-4,0,3,-3,-4,-1,1,0,-5,-4,3,-2,-5,0,5,-2,0,2,-1,0,2,-1,0,-2,-1,0,3,-1,0,4,0,0
17,17111,Navata,670,18,10,8,4,2,2,9,-3,0,4,6,1,6,-2,2,-2,4,1,3,-1,-2,6,2,0,1,0,1,1,1,0,1,0,0,0,1,0,0,0,1,1,0,0,30,21,9,17,8,9,5,3,-2,10,12,0,3,1,3,6,6,2,2,2,-5,4,6,-2,5,0,0,3,7,1,2,0,0,1,4,1,3,0,0,2,3,0,39,18,21,12,4,8,11,5,13,7,0,3,7,2,4,3,1,1,4,3,9,4,-1,2,2,4,1,2,2,1,0,2,0,1,1,0,2,2,1,1,1,1,35,16,19,9,6,3,8,4,6,7,8,2,0,1,6,2,6,1,8,3,0,5,2,1,0,3,1,0,4,0,0,2,1,0,3,0,0,1,0,0,1,0,60,28,32,33,15,18,26,-1,13,19,3,-2,13,0,6,6,3,-2,13,-1,7,13,0,0,12,2,7,8,4,0,4,1,2,4,4,0,8,1,5,4,0,0,101,53,48,37,19,18,23,13,20,28,9,5,11,7,9,15,7,2,12,6,11,13,2,3,9,4,8,11,4,1,5,2,2,6,4,0,4,2,6,5,0,1,44,29,15,23,14,9,8,7,15,5,3,5,4,5,7,5,2,5,4,2,8,0,1,0,3,5,9,2,3,1,1,3,5,1,3,1,2,2,4,1,0,0,63,35,28,22,11,11,15,1,6,24,7,6,8,1,5,10,4,4,7,0,1,14,3,2,3,3,2,8,3,3,2,2,1,4,1,1,1,1,1,4,2,2,52,31,21,23,11,12,8,4,10,17,3,9,5,5,6,11,3,1,3,-1,4,6,0,8,8,2,2,7,1,3,4,2,1,3,2,-1,4,0,1,4,-1,4,31,9,22,-11,-8,-3,7,9,19,-9,2,-3,5,3,5,-3,-1,-3,2,6,14,-6,3,0,-1,2,-1,-6,-3,-4,0,1,-2,-2,-3,-3,-1,1,1,-4,0,-1,69,36,33,24,14,10,15,-1,21,20,9,4,6,-1,12,11,5,2,9,0,9,9,4,2,7,1,3,8,3,2,3,0,0,7,3,1,4,1,3,1,0,1,27,12,15,7,6,1,6,4,-1,13,3,-2,6,2,-6,8,1,-1,0,2,5,5,2,-1,0,5,-2,5,0,-1,0,3,-1,5,0,-1,0,2,-1,0,0,0,-12,-3,-9,-15,-6,-9,-15,3,-1,-11,9,3,-9,1,2,-5,5,3,-6,2,-3,-6,4,0,-8,0,-1,-11,5,0,-3,-1,0,-5,2,1,-5,1,-1,-6,3,-1,4,1,3,-10,-7,-3,1,0,8,1,-3,-4,4,-1,0,3,-3,-2,-3,1,8,-2,0,-2,-5,-4,3,-1,-1,-2,-3,-3,1,-1,-1,0,-2,-1,2,0,0,-2,62,26,36,19,8,11,15,-2,29,4,11,3,4,-1,11,1,8,2,11,-1,18,3,3,1,5,0,1,4,5,4,1,0,1,0,3,3,4,0,0,4,2,1,19,3,16,6,0,6,9,-2,11,-1,2,-4,3,-4,7,-2,-2,-2,6,2,4,1,4,-2,3,1,3,-2,3,-2,1,0,2,-3,1,-1,2,1,1,1,2,-1,0,2,-2,-1,-3,2,-4,0,-5,-1,7,2,-3,-2,0,1,4,2,-1,2,-5,-2,3,0,-1,1,-1,0,-1,0,-1,0,0,0,-2,0,0,1,-1,0,1,0,20,9,11,3,1,2,3,-2,1,3,7,6,3,-2,1,0,2,4,0,0,0,3,5,2,0,-1,2,-1,2,1,0,-1,0,-1,2,1,0,0,2,0,0,0
17,17114,Olot,27814,167,133,34,9,4,5,36,15,37,43,26,16,22,21,41,33,12,10,14,-6,-4,10,14,6,4,1,1,1,0,2,1,1,0,1,0,1,3,0,1,0,0,1,75,51,24,4,2,2,-20,31,20,4,-2,42,-11,26,11,1,-3,26,-9,5,9,3,1,16,2,0,1,1,0,0,0,0,1,1,0,0,2,0,0,0,0,0,409,266,143,198,104,94,87,58,119,123,10,8,42,40,88,89,6,-3,45,18,31,34,4,11,47,48,55,31,11,6,23,24,31,18,6,2,24,24,24,13,5,4,792,421,371,533,259,274,149,198,228,149,36,29,89,105,141,71,5,9,60,93,87,78,31,20,145,142,115,91,26,12,88,69,56,32,8,5,57,73,59,59,18,7,877,478,399,624,343,281,127,211,229,193,50,48,63,127,131,107,22,21,64,84,98,86,28,27,124,168,183,100,28,13,68,96,109,55,8,6,56,72,74,45,20,7,809,513,296,776,456,320,129,226,232,180,30,17,70,145,184,89,15,9,59,81,48,91,15,8,147,212,246,129,27,11,77,119,179,68,8,3,70,93,67,61,19,8,618,359,259,791,473,318,145,176,168,76,15,40,85,129,104,24,7,11,60,47,64,52,8,29,159,235,232,123,25,7,89,161,145,58,10,3,70,74,87,65,15,4,536,298,238,654,362,292,78,217,184,51,7,11,63,108,104,27,1,6,15,109,80,24,6,5,123,218,213,71,26,3,80,133,110,28,12,2,43,85,103,43,14,1,475,208,267,575,305,270,95,173,99,90,13,7,61,86,21,34,5,3,34,87,78,56,8,4,108,213,163,80,9,-1,69,119,74,36,6,-2,39,94,89,44,3,1,148,1,147,406,186,220,95,138,-88,-8,4,6,57,64,-86,-33,-2,4,38,74,-2,25,6,2,123,149,78,39,16,-3,75,85,15,5,5,-1,48,64,63,34,11,-2,105,6,99,382,187,195,74,75,-22,-40,-6,32,39,56,-42,-41,-6,5,35,19,20,1,0,27,113,124,84,42,13,5,60,78,36,10,1,3,53,46,48,32,12,2,94,22,72,256,133,123,55,51,-40,-7,17,16,41,30,-24,-28,-1,7,14,21,-16,21,18,9,78,101,30,36,12,-3,52,58,9,6,10,-2,26,43,21,30,2,-1,247,103,144,219,109,110,46,65,36,34,25,36,5,27,14,23,18,15,41,38,22,11,7,21,36,78,47,38,10,9,18,40,20,24,4,2,18,38,27,14,6,7,151,74,77,98,42,56,31,63,-9,47,-12,21,47,13,2,6,-6,8,-16,50,-11,41,-6,13,30,67,10,-15,0,2,29,36,-5,-22,1,0,1,31,15,7,-1,2,43,-38,81,20,-8,28,19,42,-25,-19,-15,35,6,13,-15,-44,-11,8,13,29,-10,25,-4,27,3,56,-2,-20,-22,-1,2,34,-14,-25,-7,-1,1,22,12,5,-15,0,88,23,65,-22,-44,22,25,43,-7,3,16,9,21,16,-7,-4,-8,3,4,27,0,7,24,6,4,39,-34,-19,-13,-5,2,17,-35,-17,-12,-3,2,22,1,-2,-1,-2,333,155,178,247,139,108,40,92,81,70,4,38,22,55,43,30,-5,8,18,37,38,40,9,30,21,90,82,33,4,13,18,52,42,16,0,8,3,38,40,17,4,5,531,290,241,366,196,170,47,148,166,84,24,56,12,80,114,59,8,15,35,68,52,25,16,41,15,130,136,50,23,9,5,78,79,24,5,4,10,52,57,26,18,5
17,17117,Palafrugell,17816,259,159,100,231,132,99,20,65,71,44,20,33,17,41,57,15,6,21,3,24,14,29,14,12,36,58,79,33,15,8,20,34,52,15,8,2,16,24,27,18,7,6,460,282,178,460,277,183,61,131,142,68,17,34,28,73,111,47,2,13,33,58,31,21,15,21,79,130,147,57,24,17,38,74,108,35,9,8,41,56,39,22,15,9,514,303,211,464,254,210,50,158,115,131,42,15,14,106,83,82,13,4,36,52,32,49,29,11,72,125,133,90,33,5,30,70,85,53,10,3,42,55,48,37,23,2,491,277,214,435,244,191,90,150,171,45,33,5,55,90,118,10,3,2,35,60,53,35,30,3,92,129,129,54,27,3,47,75,86,26,10,0,45,54,43,28,17,3,470,260,210,486,263,223,43,187,117,84,16,21,14,85,90,57,10,3,29,102,27,27,6,18,83,145,131,84,31,10,42,75,78,49,16,3,41,70,53,35,15,7,631,352,279,620,342,278,124,184,144,117,40,20,83,89,113,50,18,1,41,95,31,67,22,19,121,164,172,110,36,14,66,74,126,57,16,3,55,90,46,53,20,11,542,273,269,727,392,335,81,193,170,68,15,13,51,122,84,22,-5,0,30,71,86,46,20,13,122,208,239,101,34,17,67,116,138,49,14,6,55,92,101,52,20,11,470,208,262,604,318,286,82,184,128,47,-4,25,29,87,47,33,-6,14,53,97,81,14,2,11,114,187,186,79,18,14,54,91,105,47,8,10,60,96,81,32,10,4,154,63,91,309,162,147,45,33,73,6,-12,8,36,14,31,-20,-3,5,9,19,42,26,-9,3,50,85,114,41,10,7,32,46,67,11,3,3,18,39,47,30,7,4,128,16,112,104,20,84,51,74,6,-2,-27,19,42,5,-16,-10,-21,12,9,69,22,8,-6,7,16,79,-11,5,9,3,13,23,-19,-4,6,0,3,56,8,9,3,3,4,-57,61,33,-42,75,8,34,-47,-7,18,-2,2,1,-46,-19,8,-3,6,33,-1,12,10,1,20,36,-8,-21,0,1,9,6,-28,-30,-1,0,11,30,20,9,1,1,46,1,45,78,40,38,-13,39,-4,-21,24,22,-4,17,4,-27,13,5,-9,22,-8,6,11,17,23,33,15,1,1,-1,15,13,17,-7,0,0,8,20,-2,8,1,-1,3,-29,32,33,-16,49,-25,20,-1,-6,3,6,-6,-2,-5,-12,-5,0,-19,22,4,6,8,6,5,36,-5,-4,7,-6,5,9,-13,-9,1,-8,0,27,8,5,6,2,-41,-49,8,-43,-42,-1,-21,21,-33,-17,-1,11,-18,-1,-18,-4,-12,1,-3,22,-15,-13,11,10,-22,9,3,-25,-9,0,-19,1,-4,-16,-7,2,-3,8,7,-9,-2,-2,-239,-189,-50,-266,-177,-89,-17,6,-82,-80,-49,-19,-16,0,-84,-61,-16,-10,-1,6,2,-19,-33,-9,-37,12,-101,-76,-42,-24,-22,4,-73,-56,-22,-9,-15,8,-28,-20,-20,-15,131,27,104,-72,-58,-14,55,51,-10,4,11,18,37,16,-15,-22,12,-3,18,35,5,26,-1,21,-13,29,-47,-27,-5,-13,-10,9,-29,-21,-2,-7,-3,20,-18,-6,-3,-6,-136,-86,-50,-121,-82,-39,-40,-13,-11,-76,-12,11,-25,-8,2,-48,-4,-4,-15,-5,-13,-28,-8,15,-45,3,-6,-55,-23,1,-19,-1,-3,-46,-13,-2,-26,4,-3,-9,-10,3,193,79,114,173,83,90,-15,53,54,29,29,35,-5,19,33,19,-3,11,-10,34,21,10,32,24,-3,64,67,2,20,15,-2,29,39,-5,8,11,-1,35,28,7,12,4
17,17118,Palamós,14740,195,92,103,142,75,67,47,40,63,18,12,13,12,25,41,-2,11,2,35,15,22,20,1,11,28,31,38,33,7,4,12,17,24,17,2,3,16,14,14,16,5,1,346,194,152,258,135,123,30,60,126,51,47,36,20,35,73,28,24,16,10,25,53,23,23,20,54,49,89,48,8,10,17,27,51,31,4,5,37,22,38,17,4,5,321,145,176,336,168,168,18,60,73,103,42,31,-3,38,46,39,13,16,21,22,27,64,29,15,66,74,100,62,27,3,28,38,62,29,10,0,38,36,38,33,17,3,315,152,163,301,144,157,43,60,80,55,40,35,28,45,40,21,8,12,15,15,40,34,32,23,65,65,77,59,22,8,33,32,34,30,10,2,32,33,43,29,12,6,489,220,269,325,159,166,109,87,142,71,50,24,65,45,53,24,18,12,44,42,89,47,32,12,50,79,107,50,24,13,25,44,50,25,10,4,25,35,57,25,14,9,262,153,109,313,148,165,24,57,80,20,52,30,19,22,70,0,28,14,5,35,10,20,24,16,63,77,74,48,29,16,30,27,41,27,13,8,33,50,33,21,16,8,442,239,203,409,209,200,71,87,128,70,48,32,39,45,90,34,14,16,32,42,38,36,34,16,81,86,119,78,32,12,42,42,69,42,10,4,39,44,50,36,22,8,270,118,152,352,184,168,19,108,53,67,15,-2,14,46,41,18,-5,0,5,62,12,49,20,-2,53,101,131,52,11,1,29,52,79,26,-3,-1,24,49,52,26,14,2,321,167,154,272,138,134,59,62,112,57,-1,22,35,24,56,43,-11,16,24,38,56,14,10,6,56,70,96,48,0,-2,38,31,41,28,0,-1,18,39,55,20,0,-1,-79,-58,-21,24,0,24,-43,-2,-23,-24,12,0,-21,-5,-43,10,11,-9,-22,3,20,-34,1,9,9,7,-5,12,1,-1,5,2,-9,5,1,-4,4,5,4,7,0,3,-103,-64,-39,-155,-101,-54,-41,11,-18,-30,-12,-15,-12,2,-15,-18,-16,-7,-29,9,-3,-12,4,-8,-20,13,-42,-55,-28,-24,-9,5,-32,-35,-18,-13,-11,8,-10,-20,-10,-11,-50,-35,-15,-5,-7,2,2,-3,-23,-61,7,25,10,-23,-17,-40,11,23,-8,20,-6,-21,-4,2,8,-13,-9,-8,6,9,12,-20,-11,-3,9,5,-4,7,2,-5,-3,4,73,0,73,8,-9,17,14,47,1,-9,35,-14,-16,10,11,-26,18,1,30,37,-10,17,17,-15,-1,27,-14,-18,13,-4,-5,9,-11,-13,6,1,4,18,-3,-5,7,-5,12,-13,25,-21,-13,-8,-14,-4,19,-6,-4,20,0,3,-11,-4,-6,7,-14,-7,30,-2,2,13,-14,4,3,-8,-3,-3,-9,1,3,-3,-4,0,-5,3,0,-5,1,-3,116,79,37,17,4,13,21,30,47,19,-2,-7,14,23,25,21,-10,4,7,7,22,-2,8,-11,-5,14,3,-5,7,0,0,5,-2,1,0,-1,-5,9,5,-6,7,1,-100,-37,-63,-58,-31,-27,-4,-8,4,-16,-47,-26,-7,-3,6,5,-22,-18,3,-5,-2,-21,-25,-8,3,6,-15,-17,-25,-14,5,-2,-4,-12,-14,-7,-2,8,-11,-5,-11,-7,54,12,42,69,20,49,-1,10,22,-12,33,3,-4,9,7,-19,19,3,3,1,15,7,14,0,14,23,23,6,13,-11,8,9,10,-4,2,-6,6,14,13,10,11,-5,193,113,80,169,93,76,25,20,54,-16,75,43,22,13,25,-7,37,26,3,7,29,-9,38,17,22,50,51,17,23,5,9,23,34,10,15,2,13,27,17,7,8,3
17,17120,Palau-saverdera,914,22,13,9,33,17,16,-5,1,0,7,16,3,-4,2,1,3,10,1,-1,-1,-1,4,6,2,3,2,6,5,13,4,1,1,4,2,7,2,2,1,2,3,6,2,30,22,8,27,17,10,7,3,-2,13,9,0,6,2,2,8,4,0,1,1,-4,5,5,0,2,0,5,5,14,1,2,0,2,4,8,1,0,0,3,1,6,0,105,45,60,34,15,19,6,14,25,24,19,17,1,7,12,8,11,5,5,7,13,16,8,12,3,3,6,8,14,0,1,1,3,2,8,0,2,2,3,6,6,0,53,23,30,33,18,15,2,24,0,18,9,-1,-3,10,1,10,6,-1,5,14,-1,8,3,0,3,12,4,7,7,0,1,7,2,5,4,-1,2,5,2,2,3,1,67,21,46,42,15,27,7,13,7,19,16,5,-3,2,5,7,8,3,10,11,2,12,8,2,7,9,5,11,7,3,1,0,2,4,6,2,6,9,3,7,1,1,42,41,1,23,12,11,-1,-4,7,16,21,3,8,-1,10,11,11,2,-9,-3,-3,5,10,1,2,-2,5,4,14,0,2,-1,2,2,7,0,0,-1,3,2,7,0,87,62,25,35,21,14,7,7,25,23,8,13,8,5,21,11,3,11,-1,2,4,12,5,2,7,4,-2,17,3,6,5,1,0,9,1,5,2,3,-2,8,2,1,120,42,78,56,29,27,22,22,32,14,18,11,6,6,9,8,11,4,16,16,23,6,7,7,6,8,13,8,11,10,2,3,9,2,8,5,4,5,4,6,3,5,10,7,3,12,2,10,4,-2,1,4,-1,1,1,1,-3,4,1,1,3,-3,4,0,-2,0,0,3,-4,3,8,2,0,1,-6,1,5,1,0,2,2,2,3,1,35,18,17,5,4,1,24,-1,4,4,6,-6,15,1,-4,2,2,-2,9,-2,8,2,4,-4,2,0,3,-2,4,-4,2,0,2,-1,1,-2,0,0,1,-1,3,-2,12,0,12,-48,-27,-21,15,5,18,11,-17,-25,5,4,5,9,-12,-14,10,1,13,2,-5,-11,-1,-2,-4,-4,-13,-25,-1,1,-3,-1,-10,-14,0,-3,-1,-3,-3,-11,2,-3,5,0,-1,1,4,-4,-5,7,4,-6,-2,-3,0,3,1,-3,6,-1,-5,4,3,-3,-4,-1,6,-2,3,-4,-3,-1,3,-1,2,-2,-1,0,3,-1,1,-2,-16,1,-17,-9,-5,-4,-3,-2,-1,0,0,-10,1,2,4,0,0,-4,-4,-4,-5,0,0,-6,2,0,0,1,-3,-9,2,0,-1,1,-2,-5,0,0,1,0,-1,-4,15,1,14,-1,-5,4,17,-3,-2,1,-3,1,10,-2,-2,-3,-4,-1,7,-1,0,4,1,2,9,-5,-2,0,-3,-1,3,-3,-3,0,-2,-1,6,-2,1,0,-1,0,10,9,1,-30,-20,-10,4,-1,19,6,-7,-13,4,-1,6,2,4,-8,0,0,13,4,-11,-5,1,-2,-6,-3,-5,-14,-1,0,-5,-4,1,-10,2,-2,-1,1,-6,-4,-21,-10,-11,-5,-8,3,-5,2,7,-11,-8,-8,2,0,-1,-1,-7,-3,-7,2,8,-10,-1,-5,1,2,7,-6,-3,-7,-1,0,3,-4,-3,-3,2,2,4,-2,0,-4,-9,-13,4,-14,-5,-9,4,-8,1,-2,-7,4,-2,-4,2,-4,-4,-1,6,-4,-1,2,-3,5,-3,1,-4,-4,-7,3,-2,3,-1,-1,-4,0,-1,-2,-3,-3,-3,3,-19,0,-19,-15,-7,-8,-8,1,1,-8,-6,0,4,2,1,-4,-2,-1,-12,-1,0,-4,-4,1,-5,0,-5,0,-1,-4,-1,-1,-3,1,0,-3,-4,1,-2,-1,-1,-1
17,17124,Pals,1842,79,45,34,31,15,16,4,14,25,21,14,2,4,9,11,14,5,2,0,5,14,7,9,0,0,6,7,5,9,4,0,4,3,3,2,3,0,2,4,2,7,1,38,24,14,26,14,12,0,10,13,-3,14,3,3,6,10,-6,7,3,-3,4,3,3,7,0,1,9,5,2,7,1,1,4,3,1,3,1,0,5,2,1,4,0,87,35,52,98,45,53,11,1,8,10,33,21,3,0,-2,4,10,17,8,1,10,6,23,4,6,10,10,15,28,27,0,3,4,8,12,17,6,7,6,7,16,10,74,35,39,74,36,38,15,1,16,15,23,2,9,0,7,6,14,-1,6,1,9,9,9,3,12,9,16,14,19,3,9,3,7,4,11,2,3,6,9,10,8,1,54,23,31,51,27,24,-8,4,31,4,13,10,-9,1,14,5,7,5,1,3,17,-1,6,5,1,7,19,6,12,6,0,5,9,3,8,2,1,2,10,3,4,4,57,41,16,54,35,19,-3,11,16,10,11,7,-2,7,14,3,13,1,-1,4,2,7,-2,6,2,13,6,16,11,4,3,8,6,10,5,1,-1,5,0,6,6,3,175,86,89,107,51,56,30,13,65,41,21,1,14,8,29,23,7,5,16,5,36,18,14,-4,14,17,33,27,10,5,6,12,13,13,3,4,8,5,20,14,7,1,145,77,68,105,50,55,3,32,63,27,17,0,5,13,32,13,9,4,-2,19,31,14,8,-4,3,36,45,10,12,-1,3,15,20,5,5,2,0,21,25,5,7,-3,122,58,64,99,34,65,21,26,37,13,20,3,10,18,11,4,10,2,11,8,26,9,10,1,12,22,31,12,14,7,6,11,4,3,6,3,6,11,27,9,8,4,5,6,-1,45,26,19,4,11,-8,1,-4,-1,0,3,3,-2,0,0,4,8,-11,3,-4,-1,15,13,10,11,0,-4,11,4,7,5,0,-1,4,9,3,6,0,-3,-12,4,-16,24,12,12,-6,2,-6,-1,-1,-1,-4,5,5,2,-1,-3,-2,-3,-11,-3,0,2,7,9,4,-1,5,-2,3,3,3,1,2,0,4,6,1,-2,3,-2,30,16,14,43,22,21,11,2,4,0,6,6,5,2,1,-3,6,3,6,0,3,3,0,3,5,7,9,9,7,6,3,2,7,4,4,2,2,5,2,5,3,4,-48,-25,-23,7,3,4,-22,1,1,-25,3,-5,-11,0,4,-14,0,-4,-11,1,-3,-11,3,-1,-1,4,3,-2,4,-1,0,1,1,0,2,-1,-1,3,2,-2,2,0,0,8,-8,0,-1,1,1,4,-4,-1,4,-3,8,-2,1,-3,6,-1,-7,6,-5,2,-2,-2,-4,1,3,-3,1,2,-3,-1,2,-1,1,1,-1,2,1,-2,0,1,-33,-16,-17,14,5,9,5,2,-9,-11,-8,-13,-1,-1,-1,-3,-6,-5,6,3,-8,-8,-2,-8,3,5,2,8,5,-9,2,2,2,2,3,-6,1,3,0,6,2,-3,-47,-21,-26,22,14,8,-14,-3,-16,-12,-2,-3,-11,-4,-3,-5,2,0,-3,1,-13,-7,-4,-3,4,2,4,4,9,-1,-1,-1,5,4,6,1,5,3,-1,0,3,-2,-7,-3,-4,8,7,1,-10,13,7,-13,-7,2,-1,7,-1,-6,-2,1,-9,6,8,-7,-5,1,4,9,7,2,-11,-3,5,5,3,1,-5,-2,-1,4,4,1,-6,-1,8,14,-6,43,24,19,7,-2,4,4,-3,-2,5,1,4,6,-1,-1,2,-3,0,-2,-2,-1,9,8,15,3,8,0,6,2,9,3,3,1,3,6,6,0,5,-1
17,17132,Peralada,1242,59,30,29,8,4,4,9,4,18,15,6,5,3,1,11,10,2,2,6,3,7,5,4,3,0,1,1,1,2,3,0,1,0,1,1,1,0,0,1,0,1,2,31,16,15,19,11,8,6,8,9,15,-1,-4,0,6,6,7,-1,-2,6,2,3,8,0,-2,2,3,6,7,1,0,0,2,4,4,1,0,2,1,2,3,0,0,49,31,18,17,9,8,7,6,8,14,12,0,3,3,6,11,6,0,4,3,2,3,6,0,3,4,3,4,2,1,2,2,1,3,1,0,1,2,2,1,1,1,83,37,46,25,11,14,22,17,5,15,17,4,8,5,3,6,9,4,14,12,2,9,8,0,2,6,7,5,5,0,1,0,4,3,3,0,1,6,3,2,2,0,66,31,35,28,15,13,12,14,24,10,5,0,7,6,11,4,5,-2,5,8,13,6,0,2,2,7,12,5,2,0,2,3,6,2,2,0,0,4,6,3,0,0,75,41,34,29,17,12,11,9,18,23,13,2,2,5,14,12,7,2,9,4,4,11,6,0,4,4,3,8,9,0,1,3,3,4,5,0,3,1,0,4,4,0,68,20,48,38,20,18,22,-1,19,10,9,9,6,0,4,4,0,5,16,-1,15,6,9,4,6,9,12,7,2,2,3,3,6,5,1,2,3,6,6,2,1,0,60,33,27,17,6,11,9,9,25,4,10,0,7,2,14,-1,9,0,2,7,11,5,1,0,0,7,4,3,3,0,0,2,2,1,1,0,0,5,2,2,2,0,37,31,6,20,10,10,3,17,2,13,6,-6,3,13,2,9,4,-1,0,4,0,4,2,-5,2,7,2,8,1,-1,1,4,0,4,1,0,1,3,2,4,0,-1,40,21,19,15,5,10,11,3,7,8,8,3,9,0,-1,3,8,2,2,3,8,5,0,1,6,5,3,-3,5,0,2,2,-1,-1,4,0,4,3,4,-2,1,0,27,8,19,11,6,5,11,16,1,-2,-4,0,4,9,2,-5,-5,1,7,7,-1,3,1,-1,5,0,1,2,1,2,4,0,0,1,0,1,1,0,1,1,1,1,41,16,25,27,8,19,1,6,3,11,12,4,-4,5,-1,6,8,2,5,1,4,5,4,2,8,4,1,7,3,3,2,1,-1,3,2,1,6,3,2,4,1,2,33,13,20,12,7,5,7,5,8,10,6,-2,1,4,3,5,3,-3,6,1,5,5,3,1,9,0,1,3,0,-1,6,0,2,0,0,-1,3,0,-1,3,0,0,-14,-5,-9,11,9,2,4,-4,0,-8,-7,1,4,-1,4,-7,-4,0,0,-3,-4,-1,-3,1,4,2,-1,1,2,3,5,1,-1,0,1,3,-1,1,0,1,1,0,2,2,0,8,5,3,-6,10,-8,-1,9,-3,5,4,-7,-1,4,-2,-11,6,-1,0,5,-1,-2,-2,5,-1,8,0,0,-1,1,0,5,0,-2,-1,4,-1,3,0,4,5,-1,-5,-2,-3,4,5,-10,6,2,-4,1,2,5,-2,2,-2,3,3,-15,8,0,-2,0,-1,-2,-7,4,-1,0,-1,2,-4,2,-2,0,0,-4,-3,2,1,31,7,24,9,2,7,1,5,13,9,1,2,-2,0,5,3,0,1,3,5,8,6,1,1,0,0,4,5,1,-1,0,0,1,1,2,-2,0,0,3,4,-1,1,37,16,21,17,8,9,10,7,2,-1,14,6,2,3,3,0,4,5,8,4,-1,-1,10,1,2,4,3,2,5,1,1,1,2,1,2,1,1,3,1,1,3,0
17,17133,"Planes d'Hostoles, Les",1735,32,19,13,9,4,5,14,1,0,10,2,1,9,1,-1,5,1,2,5,0,1,5,1,-1,3,1,3,0,1,1,1,0,2,0,0,1,2,1,1,0,1,0,-23,-9,-14,3,1,2,-5,-5,-9,-1,-1,-2,-5,0,-2,0,-1,-1,0,-5,-7,-1,0,-1,0,1,1,1,0,0,0,0,0,1,0,0,0,1,1,0,0,0,-16,-10,-6,1,0,1,-11,0,-2,-2,1,-3,-6,-1,-2,-1,0,0,-5,1,0,-1,1,-3,0,-1,2,0,0,0,0,-1,1,0,0,0,0,0,1,0,0,0,11,6,5,8,2,6,7,-1,-5,5,3,1,4,0,-3,2,2,1,3,-1,-2,3,1,0,2,3,0,1,0,2,0,1,-1,1,0,1,2,2,1,0,0,1,39,24,15,9,2,7,6,2,16,1,8,1,4,-1,10,4,6,-1,2,3,6,-3,2,2,1,3,2,0,1,0,0,0,1,0,0,0,1,3,1,0,1,0,33,18,15,20,11,9,9,6,8,3,5,4,7,4,4,0,1,2,2,2,4,3,4,2,5,5,5,4,1,0,4,2,2,3,0,0,1,3,3,1,1,0,22,11,11,19,10,9,3,10,9,-2,2,-1,1,5,8,-2,0,-2,2,5,1,0,2,1,7,6,4,2,0,0,4,3,2,1,0,0,3,3,2,1,0,0,-11,-9,-2,13,9,4,-9,1,0,-9,0,3,-6,-1,2,-6,2,0,-3,2,-2,-3,-2,3,1,5,2,2,2,1,1,5,1,0,2,0,0,0,1,2,0,1,-40,-19,-21,12,8,4,-8,-6,-14,-4,-3,-5,-5,0,-3,-3,-3,-4,-3,-6,-11,-1,0,-1,2,3,2,4,1,-1,2,1,1,2,1,0,0,2,1,2,0,-1,-17,-11,-6,6,2,4,-9,1,-15,5,-1,2,-4,2,-8,0,0,0,-5,-1,-7,5,-1,2,1,2,2,1,-1,0,0,2,0,1,-1,0,1,0,2,0,0,0,-1,-7,6,8,1,7,1,3,3,-1,-1,-6,0,-2,-1,-1,-1,-2,1,5,4,0,0,-4,0,3,4,1,0,0,0,0,1,0,0,0,0,3,3,1,0,0,4,4,0,2,2,0,2,-2,4,1,0,-2,2,1,-2,0,4,-2,0,-3,6,1,-4,0,1,1,0,-1,0,0,1,1,0,0,0,0,0,0,0,-1,0,0,3,15,-12,1,2,-1,11,1,-4,0,-1,-4,10,2,-1,6,0,-2,1,-1,-3,-6,-1,-2,0,6,-3,-1,-1,0,0,3,-1,0,0,0,0,3,-2,-1,-1,0,1,-9,10,-1,-2,1,3,0,-6,9,0,-5,2,-2,-6,1,0,-4,1,2,0,8,0,-1,-1,1,0,-1,0,0,-1,0,0,-1,0,0,0,1,0,0,0,0,-11,-10,-1,2,1,1,2,-5,-1,0,-6,-1,0,-2,-4,-2,-3,1,2,-3,3,2,-3,-2,1,0,0,1,0,0,1,0,0,0,0,0,0,0,0,1,0,0,3,-4,7,-3,-2,-1,9,-4,-5,5,-4,2,-1,-4,0,4,-4,1,10,0,-5,1,0,1,0,-1,-2,2,-2,0,-1,-1,-1,2,-1,0,1,0,-1,0,-1,0,-19,0,-19,4,3,1,-13,1,1,-5,0,-6,-4,4,2,-2,1,-2,-9,-3,-1,-3,-1,-4,-1,1,0,2,0,1,0,1,0,1,0,1,-1,0,0,1,0,0,48,22,26,14,2,12,21,5,7,14,2,-2,14,0,3,6,-1,0,7,5,4,8,3,-2,4,3,5,2,0,0,1,0,1,0,0,0,3,3,4,2,0,0
17,17137,Porqueres,3511,122,64,58,3,1,2,33,20,32,21,1,7,22,10,13,13,0,3,11,10,19,8,1,4,0,1,0,2,0,0,0,0,0,1,0,0,0,1,0,1,0,0,39,25,14,5,4,1,3,6,18,10,2,-1,3,4,12,5,1,-1,0,2,6,5,1,0,1,0,3,1,0,0,1,0,2,1,0,0,0,0,1,0,0,0,18,10,8,4,2,2,8,-7,26,-2,-2,-4,4,-6,14,1,1,-4,4,-1,12,-3,-3,0,0,2,1,0,1,0,0,2,0,-1,1,0,0,0,1,1,0,0,70,27,43,12,5,7,20,6,25,16,8,-7,15,2,10,2,3,-5,5,4,15,14,5,-2,1,1,7,2,1,0,0,1,2,1,1,0,1,0,5,1,0,0,131,73,58,11,8,3,40,9,28,37,3,2,21,3,17,21,1,3,19,6,11,16,2,-1,2,3,-2,8,0,0,1,3,1,3,0,0,1,0,-3,5,0,0,103,52,51,10,4,6,18,19,31,19,2,7,13,7,15,12,0,2,5,12,16,7,2,5,0,4,2,4,0,0,0,0,1,3,0,0,0,4,1,1,0,0,23,28,-5,22,16,6,1,-5,22,0,5,-2,6,2,11,4,3,-2,-5,-7,11,-4,2,0,7,4,5,2,4,0,7,4,2,0,3,0,0,0,3,2,1,0,98,56,42,39,20,19,31,11,24,26,-3,2,13,6,15,20,-3,0,18,5,9,6,0,2,9,13,13,0,2,0,3,6,10,0,0,0,6,7,3,0,2,0,20,15,5,27,14,13,6,2,14,1,2,-3,8,3,13,-4,0,-2,-2,-1,1,5,2,-1,3,6,10,4,3,-1,3,4,5,2,0,0,0,2,5,2,3,-1,-2,-1,-1,3,-1,4,-2,-4,-7,5,-5,4,-5,1,-2,3,-2,1,3,-5,-5,2,-3,3,4,2,-3,1,-2,0,3,0,-2,-1,-1,0,1,2,-1,2,-1,0,-8,-17,9,1,-5,6,3,-13,-1,2,-5,4,-1,-12,-3,0,-4,2,4,-1,2,2,-1,2,1,1,-3,0,2,0,-1,0,-2,-2,0,0,2,1,-1,2,2,0,41,37,4,3,2,1,20,2,-14,16,9,4,21,3,-8,14,4,1,-1,-1,-6,2,5,3,5,0,0,-4,2,0,5,-1,-1,-2,0,1,0,1,1,-2,2,-1,13,-6,19,0,-3,3,-1,9,4,5,-3,1,-4,-2,-2,6,-2,1,3,11,6,-1,-1,0,-1,4,-3,1,0,-1,0,0,-1,0,-1,-1,-1,4,-2,1,1,0,11,10,1,4,5,-1,11,4,11,-15,-1,-2,4,2,9,-8,1,0,7,2,2,-7,-2,-2,5,0,4,-8,0,1,3,2,4,-6,0,0,2,-2,0,-2,0,1,-5,11,-16,-8,-4,-4,-6,5,-7,7,-6,-4,-2,7,-6,13,-5,-1,-4,-2,-1,-6,-1,-3,-4,5,-4,-3,-1,-2,-2,1,-2,-1,0,0,-2,4,-2,-2,-1,-2,9,-15,24,14,7,7,4,-2,-1,-2,6,4,0,-3,-6,-11,3,2,4,1,5,9,3,2,2,3,6,2,1,0,1,1,3,1,1,0,1,2,3,1,0,0,60,30,30,7,3,4,9,7,31,8,-3,5,4,5,15,2,2,-1,5,2,16,6,-5,6,-2,3,2,0,3,1,-2,2,2,-1,2,0,0,1,0,1,1,1,-19,2,-21,-4,-5,1,16,-26,10,-6,-5,-7,12,-13,9,1,-3,-3,4,-13,1,-7,-2,-4,1,-4,-1,-1,1,0,1,-4,-2,1,-1,0,0,0,1,-2,2,0
17,17138,Portbou,283,-24,-14,-10,12,5,7,-10,1,-10,-3,0,-2,-5,1,-5,-5,0,0,-5,0,-5,2,0,-2,2,1,5,3,1,0,0,1,2,2,0,0,2,0,3,1,1,0,-5,-4,-1,10,6,4,1,-2,-8,-3,6,0,0,-1,-6,-3,4,2,1,-1,-2,0,2,-2,1,1,2,3,3,0,0,0,1,2,3,0,1,1,1,1,0,0,4,-1,5,23,9,14,3,6,-8,0,9,-6,-2,2,-6,1,4,0,5,4,-2,-1,5,-6,5,4,7,4,3,0,1,1,4,2,1,0,4,3,3,2,2,0,-5,-2,-3,17,8,9,7,-6,0,3,-2,-6,6,-5,-1,3,0,-5,1,-1,1,0,-2,-1,4,1,5,3,4,0,3,0,3,1,1,0,1,1,2,2,3,0,16,9,7,25,13,12,3,2,2,12,-4,2,2,-1,5,5,-4,3,1,3,-3,7,0,-1,3,0,8,6,5,3,1,1,5,2,2,2,2,-1,3,4,3,1,2,12,-10,23,15,8,-4,12,1,-7,3,-5,0,13,1,-1,1,-2,-4,-1,0,-6,2,-3,0,11,4,2,4,2,1,8,1,3,2,0,-1,3,3,-1,2,2,-30,-11,-19,15,8,7,-7,-1,-18,3,1,-6,-3,1,-9,2,2,-4,-4,-2,-9,1,-1,-2,4,2,1,5,3,0,1,2,1,2,2,0,3,0,0,3,1,0,-5,-1,-4,14,7,7,-2,-3,-1,0,5,-4,0,-3,1,1,2,-2,-2,0,-2,-1,3,-2,0,0,4,3,6,1,0,0,2,2,2,1,0,0,2,1,4,0,20,10,10,23,13,10,1,12,-5,7,7,-2,3,7,0,2,2,-3,-2,5,-5,5,5,1,1,6,7,4,4,1,1,4,5,1,2,0,0,2,2,3,2,1,-7,-4,-3,17,8,9,5,-4,-5,0,9,-9,2,0,-4,1,2,-3,3,-4,-1,-1,7,-6,4,2,2,2,8,-1,1,1,0,2,4,0,3,1,2,0,4,-1,1,3,-2,2,0,2,5,2,1,3,1,-11,2,1,2,0,3,-5,3,1,-1,3,-2,-6,1,0,0,1,1,-1,1,-1,-1,-1,2,0,0,1,1,2,-1,-1,16,12,4,16,10,6,0,9,-2,8,6,-5,2,8,-1,1,4,-2,-2,1,-1,7,2,-3,1,3,1,7,3,1,1,2,2,1,3,1,0,1,-1,6,0,0,-11,-5,-6,6,3,3,4,-4,-1,1,-7,-5,3,-1,-5,4,-5,-1,1,-3,4,-3,-2,-4,0,1,1,3,1,0,0,-1,2,2,0,0,0,2,-1,1,1,0,-64,-44,-20,-72,-42,-30,1,-7,-27,-14,-13,-4,-5,-4,-14,-9,-11,-1,6,-3,-13,-5,-2,-3,1,-9,-20,-15,-24,-5,0,-4,-13,-7,-16,-2,1,-5,-7,-8,-8,-3,-28,-7,-21,-5,-1,-4,-10,-1,-13,-6,2,0,-5,2,-9,-2,5,2,-5,-3,-4,-4,-3,-2,0,-1,-3,0,-3,2,-1,0,-2,0,0,2,1,-1,-1,0,-3,0,15,5,10,9,3,6,3,0,6,8,-2,-2,3,0,-1,6,-2,-2,0,0,7,2,0,0,5,0,2,5,-1,-3,2,0,-2,4,1,-2,3,0,4,1,-2,-1,-35,-16,-19,-12,-3,-9,0,-4,-6,-9,-4,-12,2,-3,0,-7,-1,-7,-2,-1,-6,-2,-3,-5,2,1,-5,-2,-2,-6,3,0,0,-2,-1,-3,-1,1,-5,0,-1,-3,-13,-11,-2,6,-1,7,-4,1,1,-7,-3,-1,-3,0,3,-8,-2,0,-1,1,-2,1,-1,-1,0,5,4,0,-2,-1,-1,2,3,-3,-2,0,1,3,1,3,0,-1
17,17139,"Preses, Les",1341,52,26,26,9,4,5,19,4,26,1,3,-1,10,-4,15,3,2,0,9,8,11,-2,1,-1,1,3,1,1,1,2,1,1,1,0,0,1,0,2,0,1,1,1,79,42,37,18,8,10,29,7,23,14,3,2,19,0,14,7,1,0,10,7,9,7,2,2,5,2,7,2,1,0,4,1,1,1,0,0,1,1,6,1,1,0,58,34,24,9,7,2,4,3,35,4,7,3,8,3,20,-2,5,0,-4,0,15,6,2,3,6,0,2,1,0,0,4,0,1,2,0,0,2,0,1,-1,0,0,76,32,44,5,2,3,29,8,20,18,0,-3,15,5,6,7,0,-3,14,3,14,11,0,0,3,0,0,1,1,0,2,0,0,0,0,0,1,0,0,1,1,0,12,11,1,5,2,3,2,7,3,-2,-1,0,-1,5,6,0,1,0,3,2,-3,-2,-2,0,1,2,0,0,0,2,0,1,0,0,0,1,1,1,0,0,0,1,28,12,16,10,7,3,3,7,8,4,6,0,0,4,3,0,4,1,3,3,5,4,2,-1,3,3,2,1,1,0,2,3,1,0,1,0,1,0,1,1,0,0,-2,1,-3,0,0,0,4,-4,-4,-1,5,-5,5,-4,-1,1,1,-2,-1,0,-3,-2,4,-3,0,2,0,0,0,-2,0,1,0,0,0,-1,0,1,0,0,0,-1,11,8,3,12,8,4,4,-4,11,1,-3,1,1,0,6,3,-4,2,3,-4,5,-2,1,-1,4,4,4,0,0,0,2,3,3,0,0,0,2,1,1,0,0,0,19,4,15,16,11,5,9,-5,5,4,3,3,4,-3,1,0,1,1,5,-2,4,4,2,2,4,5,6,1,0,0,4,2,5,0,0,0,0,3,1,1,0,0,-11,-16,5,-1,-2,1,-3,6,-3,-9,-2,0,-6,3,-5,-5,-2,-1,3,3,2,-4,0,1,-1,2,-1,0,-1,0,-2,2,-1,0,-1,0,1,0,0,0,0,0,4,3,1,-5,-4,-1,4,-2,-10,4,3,2,0,-3,2,1,-1,2,4,1,-12,3,4,0,1,-1,-4,0,-1,0,0,-1,-2,0,-1,0,1,0,-2,0,0,0,11,17,-6,2,2,0,1,-2,13,-2,-2,2,5,2,8,1,1,0,-4,-4,5,-3,-3,2,0,1,0,0,1,0,1,1,0,0,0,0,-1,0,0,0,1,0,32,20,12,4,1,3,6,5,14,8,0,-2,10,1,6,5,-1,-1,-4,4,8,3,1,-1,1,0,1,2,0,0,1,0,-1,1,0,0,0,0,2,1,0,0,-7,12,-19,-3,2,-5,0,6,-1,0,-7,-8,0,8,3,4,-5,0,0,-2,-4,-4,-2,-8,0,0,-1,1,-2,-1,0,1,0,1,0,0,0,-1,-1,0,-2,-1,-6,-8,2,7,5,2,-5,-2,-6,4,-2,1,-2,1,-11,3,0,-1,-3,-3,5,1,-2,2,3,1,1,1,0,0,3,1,0,0,0,0,0,0,1,1,0,0,11,10,1,4,2,2,2,-1,4,2,3,2,0,2,2,1,3,3,2,-3,2,1,0,-1,0,2,0,-1,2,1,-2,2,0,0,1,1,2,0,0,-1,1,0,-21,-17,-4,1,-1,2,0,-2,-4,-3,-11,0,-3,-2,-3,-4,-4,-1,3,0,-1,1,-7,1,0,0,0,1,0,0,0,0,-1,0,0,0,0,0,1,1,0,0,-2,0,-2,-7,-3,-4,-2,1,6,-6,-3,-2,-3,-1,2,0,-1,0,1,2,4,-6,-2,-2,-1,0,0,-2,-2,-2,0,0,0,0,-1,-2,-1,0,0,-2,-1,0
17,17141,Puigcerdà,6699,341,182,159,201,117,84,27,110,129,56,7,6,13,57,68,41,1,-1,14,53,61,15,6,7,17,54,83,42,3,1,9,31,49,25,2,0,8,23,34,17,1,1,482,255,227,355,193,162,75,121,151,82,26,16,35,78,72,48,11,4,40,43,79,34,15,12,63,90,124,57,12,3,31,50,67,36,6,0,32,40,57,21,6,3,271,169,102,262,156,106,53,67,107,45,-4,0,27,37,63,32,4,6,26,30,44,13,-8,-6,55,72,79,44,7,2,34,39,45,29,6,1,21,33,34,15,1,1,399,232,167,317,174,143,51,113,124,64,30,15,43,64,66,34,16,8,8,49,58,30,14,7,47,78,109,63,16,2,29,39,58,37,8,1,18,39,51,26,8,1,418,263,155,389,253,136,37,108,170,49,32,16,11,79,112,32,20,4,26,29,58,17,12,12,44,115,136,52,31,7,21,79,92,38,17,2,23,36,44,14,14,5,142,61,81,235,119,116,50,52,4,27,-2,10,27,31,-7,10,-2,1,23,21,11,17,0,9,74,55,47,43,11,1,39,27,22,24,4,0,35,28,25,19,7,1,150,52,98,283,141,142,13,64,35,20,7,6,-9,19,25,14,5,-1,22,45,10,6,2,7,72,66,79,48,7,6,36,28,47,23,3,1,36,38,32,25,4,5,78,38,40,194,113,81,11,60,18,-14,11,-3,10,37,4,-12,5,-4,1,23,14,-2,6,1,48,80,57,7,-2,1,31,43,36,2,-1,1,17,37,21,5,-1,0,-370,-215,-155,-126,-75,-51,-87,-35,-94,-114,-25,-7,-44,-12,-61,-79,-16,0,-43,-23,-33,-35,-9,-7,-20,-3,-33,-54,-11,-5,-13,2,-24,-35,-6,0,-7,-5,-9,-19,-5,-5,-216,-154,-62,-107,-72,-35,-63,-13,-58,-56,-23,-2,-37,-25,-31,-38,-18,-2,-26,12,-27,-18,-5,0,-29,-17,-37,-25,0,2,-11,-15,-31,-16,0,2,-18,-2,-6,-9,0,0,57,34,23,44,15,29,11,29,17,10,-9,3,9,13,14,5,-2,-1,2,16,3,5,-7,4,20,18,8,6,-4,-1,10,8,8,-6,-2,-1,10,10,0,12,-2,0,150,71,79,58,14,44,16,43,50,21,7,16,16,16,17,19,-2,7,0,27,33,2,9,9,8,11,20,9,5,3,2,-1,9,3,0,0,6,12,11,6,5,3,-65,-33,-32,-52,-30,-22,-18,14,-27,-27,-9,7,-9,8,-15,-15,-1,2,-9,6,-12,-12,-8,5,-10,-1,-15,-27,-1,3,-7,-3,-3,-15,-1,0,-3,2,-12,-12,0,3,18,9,9,25,17,8,8,12,17,-10,-21,14,9,7,3,-4,-12,6,-1,5,14,-6,-9,8,3,14,2,-3,4,5,5,5,0,3,3,1,-2,9,2,-6,1,4,27,2,25,-31,-34,3,9,21,-13,3,-13,16,9,12,-13,-6,-11,8,0,9,0,9,-2,8,4,5,-12,-27,-5,2,0,5,-12,-22,-8,2,4,0,0,-5,3,0,109,60,49,50,27,23,10,33,24,30,-4,11,4,17,5,26,4,2,6,16,19,4,-8,9,3,22,16,0,2,3,1,12,7,3,-1,2,2,10,9,-3,3,1,118,59,59,85,45,40,5,38,17,13,33,15,2,22,1,7,18,9,3,16,16,6,15,6,10,27,23,12,7,5,3,16,14,5,4,2,7,11,9,7,3,3,-174,-125,-49,-250,-156,-94,8,17,-33,-102,-61,-12,2,14,-16,-68,-53,-9,6,3,-17,-34,-8,-3,-12,4,-48,-118,-61,-18,-6,7,-20,-79,-47,-11,-6,-3,-28,-39,-14,-7
17,17142,Quart,2275,31,13,18,7,4,3,9,9,13,4,-8,-1,1,3,10,3,-5,-1,8,6,3,1,-3,0,0,3,3,1,0,0,0,1,2,1,0,0,0,2,1,0,0,0,53,21,32,8,5,3,11,11,7,7,9,5,7,4,-1,3,5,1,4,7,8,4,4,4,3,1,2,2,0,0,0,1,2,2,0,0,3,0,0,0,0,0,46,17,29,18,10,8,12,4,3,15,6,4,4,-1,-1,7,4,2,8,5,4,8,2,2,5,1,7,4,1,0,1,1,4,3,1,0,4,0,3,1,0,0,21,16,5,15,3,12,2,4,22,-9,-1,0,0,2,14,1,0,-2,2,2,8,-10,-1,2,3,1,8,2,1,0,0,1,2,0,0,0,3,0,6,2,1,0,4,11,-7,8,3,5,4,3,-2,-1,-2,2,11,0,2,-1,-1,1,-7,3,-4,0,-1,1,0,1,2,3,1,0,0,0,1,2,0,0,0,1,1,1,1,0,3,3,0,5,3,2,3,5,-7,2,4,-3,-3,5,0,1,2,-1,6,0,-7,1,2,-2,3,4,1,-1,-2,0,2,1,1,0,-1,0,1,3,0,-1,-1,0,-5,-2,-3,-2,0,-2,-2,3,-12,0,3,-1,-3,3,-3,0,-1,0,1,0,-9,0,4,-1,-1,1,0,-1,-1,-1,-1,1,1,0,-1,0,0,0,-1,-1,0,-1,91,34,57,14,10,4,31,-1,33,15,6,3,10,0,10,9,4,0,21,-1,23,6,2,3,2,4,2,3,1,1,0,3,2,4,0,1,2,1,0,-1,1,0,69,37,32,7,3,4,16,5,20,23,7,-2,10,1,11,10,4,0,6,4,9,13,3,-2,0,0,3,4,0,0,0,0,1,2,0,0,0,0,2,2,0,0,110,45,65,2,3,-1,39,3,50,25,-5,-4,17,-6,23,18,-6,-2,22,9,27,7,1,-2,5,-1,0,-2,-1,1,3,-1,2,-1,0,0,2,0,-2,-1,-1,1,137,78,59,7,4,3,19,17,73,19,0,0,9,6,43,10,5,1,10,11,30,9,-5,-1,1,3,5,-3,0,0,1,0,4,-2,0,0,0,3,1,-1,0,0,83,56,27,9,5,4,4,0,64,8,-1,3,5,1,38,6,0,3,-1,-1,26,2,-1,0,0,1,3,2,2,1,0,1,0,2,1,1,0,0,3,0,1,0,65,23,42,11,6,5,19,7,33,10,-8,2,12,8,6,0,-4,-1,7,-1,27,10,-4,3,6,3,3,-2,0,0,3,2,3,-3,0,0,3,1,0,1,0,0,43,12,31,-1,-3,2,12,-7,28,9,-7,7,-3,-5,14,9,-6,2,15,-2,14,0,-1,5,-2,-1,2,-2,-1,3,-2,-1,0,-1,0,1,0,0,2,-1,-1,2,-31,-8,-23,-14,-9,-5,-15,-1,2,-11,-2,-5,3,4,-5,-5,-3,-2,-18,-5,7,-6,1,-3,-2,1,-4,-6,-2,-1,-1,0,-2,-5,-1,0,-1,1,-2,-1,-1,-1,14,5,9,12,5,7,18,-9,22,-1,-2,-10,4,-9,13,3,4,-6,14,0,9,-4,-6,-4,2,9,2,-2,1,0,0,4,0,0,1,0,2,5,2,-2,0,0,53,35,18,9,2,7,11,14,7,16,4,-4,11,9,4,9,2,-1,0,5,3,7,2,-3,4,0,0,2,0,2,3,-1,-2,1,0,1,1,1,2,1,0,1,58,27,31,11,1,10,16,5,19,11,6,-2,10,6,-1,9,2,0,6,-1,20,2,4,-2,1,2,0,3,3,0,1,0,-1,1,0,0,0,2,1,2,3,0
17,17145,Ribes de Freser,2118,30,20,10,7,6,1,2,-2,13,2,8,5,0,2,7,-1,5,6,2,-4,6,3,3,-1,1,2,2,1,0,1,1,2,1,1,0,1,0,0,1,0,0,0,-15,-3,-12,10,4,6,-6,3,0,-3,3,-10,-2,1,1,0,2,-4,-4,2,-1,-3,1,-6,2,4,1,2,1,0,1,2,0,0,1,0,1,2,1,2,0,0,16,14,2,18,8,10,11,-4,17,-2,-2,-5,8,-2,10,0,0,-1,3,-2,7,-2,-2,-4,4,2,2,7,0,2,3,1,0,3,0,1,1,1,2,4,0,1,23,15,8,20,9,11,4,13,4,2,-2,1,5,7,1,1,-1,1,-1,6,3,1,-1,0,6,4,6,2,1,0,1,3,4,1,0,0,5,1,2,1,1,0,31,16,15,37,25,12,6,5,0,5,8,6,6,1,2,4,2,2,0,4,-2,1,6,4,9,12,8,6,1,1,9,7,5,4,0,0,0,5,3,2,1,1,2,0,2,17,6,11,0,7,0,-13,2,6,3,1,-1,-8,0,4,-3,6,1,-5,2,2,2,8,3,4,0,0,0,3,3,0,0,0,2,5,0,4,0,0,6,-5,11,24,15,9,-2,-5,1,11,-2,3,-4,-8,3,0,2,2,2,3,-2,11,-4,1,6,3,8,5,2,0,5,1,7,1,1,0,1,2,1,4,1,0,22,16,6,29,10,19,-2,7,-4,18,7,-4,-2,4,-2,13,5,-1,0,3,-2,5,2,-3,3,12,7,6,1,0,0,3,5,2,0,0,3,9,2,4,1,0,4,3,1,14,10,4,1,3,-3,-3,-1,6,3,1,2,-4,-6,6,-2,2,-5,1,5,0,0,5,3,6,0,0,0,2,3,5,0,0,0,3,0,1,0,0,-14,-7,-7,6,5,1,0,-5,-4,-3,-3,1,-3,-2,0,-2,-3,3,3,-3,-4,-1,0,-2,-1,3,4,1,-1,0,-1,2,3,1,0,0,0,1,1,0,-1,0,23,13,10,10,4,6,3,7,0,9,1,3,0,2,4,3,0,4,3,5,-4,6,1,-1,2,5,1,1,1,0,1,2,0,0,1,0,1,3,1,1,0,0,-15,-10,-5,-7,-6,-1,0,-2,-11,-4,-2,4,3,-3,-8,-6,1,2,-3,1,-3,2,-3,2,0,-1,-5,1,-2,0,-1,0,-5,1,-1,0,1,-1,0,0,-1,0,-5,8,-13,3,3,0,4,1,-6,-9,6,-2,5,3,-2,-2,2,1,-1,-2,-4,-7,4,-3,1,2,0,-1,1,0,1,1,0,0,1,0,0,1,0,-1,0,0,-8,-8,0,-4,1,-5,0,6,-5,-6,0,-4,1,-1,-1,-2,-3,-3,-1,7,-4,-4,3,-1,-1,-1,-1,-1,-1,0,0,0,1,-1,0,0,-1,-1,-2,0,-1,0,-9,-3,-6,2,2,0,-2,-6,-2,1,-3,3,-2,-1,1,2,-3,0,0,-5,-3,-1,0,3,0,0,2,1,-1,0,0,1,2,0,-1,0,0,-1,0,1,0,0,-2,4,-6,7,2,5,5,-4,-7,6,2,-4,2,-2,-2,1,4,0,3,-2,-5,5,-2,-4,1,4,1,0,1,0,0,1,0,0,1,0,1,3,1,0,0,0,16,13,3,12,9,3,10,1,4,9,-2,-6,8,1,6,0,1,-2,2,0,-2,9,-3,-4,1,4,4,2,1,0,1,4,3,0,1,0,0,0,1,2,0,0,3,2,1,7,3,4,0,3,2,-9,1,4,1,3,-1,-4,0,2,-1,0,3,-5,1,2,2,3,2,0,-1,1,1,1,1,0,0,0,1,2,1,0,-1,1
17,17146,Riells i Viabrea,1862,116,54,62,9,3,6,25,11,34,29,8,9,14,1,19,11,7,2,11,10,15,18,1,7,2,2,2,2,1,0,1,0,1,1,0,0,1,2,1,1,1,0,179,94,85,7,3,4,28,7,54,46,25,11,14,5,25,27,14,4,14,2,29,19,11,7,2,2,1,1,0,0,1,1,0,1,0,0,1,1,1,0,0,0,227,122,105,7,4,3,53,27,62,44,24,15,28,15,33,32,5,8,25,12,29,12,19,7,4,1,2,0,0,0,2,0,2,0,0,0,2,1,0,0,0,0,270,147,123,18,9,9,54,40,63,62,33,12,42,20,25,37,21,-1,12,20,38,25,12,13,7,3,4,3,0,0,4,1,2,2,0,0,3,2,2,1,0,0,171,83,88,15,6,9,29,8,75,35,22,-3,13,-1,41,19,15,-6,16,9,34,16,7,3,5,3,2,3,2,0,2,2,1,0,1,0,3,1,1,3,1,0,191,87,104,20,12,8,48,16,70,50,6,2,16,6,33,27,2,5,32,10,37,23,4,-3,5,4,8,2,0,1,3,2,4,2,0,1,2,2,4,0,0,0,173,91,82,24,11,13,26,25,55,43,15,11,16,10,36,19,7,4,10,15,19,24,8,7,9,1,10,4,0,0,5,-1,4,3,0,0,4,2,6,1,0,0,177,107,70,24,16,8,26,30,63,40,9,5,14,18,34,24,10,1,12,12,29,16,-1,4,2,6,9,3,2,1,1,3,5,4,2,0,1,3,4,-1,0,1,97,53,44,25,17,8,10,17,35,32,4,-3,6,9,19,18,-2,0,4,8,16,14,6,-3,1,4,14,3,1,2,1,2,11,1,1,1,0,2,3,2,0,1,76,24,52,-6,-8,2,26,-2,32,12,-5,9,5,-1,16,2,-1,1,21,-1,16,10,-4,8,4,6,-6,-7,-3,0,1,3,-4,-6,-2,0,3,3,-2,-1,-1,0,108,51,57,-6,-4,-2,28,5,34,18,6,12,19,-2,12,12,3,2,9,7,22,6,3,10,-3,2,2,-6,-4,1,1,0,-1,-4,-1,-1,-4,2,3,-2,-3,2,-15,-8,-7,2,-2,4,-19,0,-3,-9,21,-4,-4,3,-7,-6,7,-1,-15,-3,4,-3,14,-3,0,2,-4,2,0,0,0,2,-4,0,-1,0,0,0,0,2,1,0,-38,-21,-17,-8,-9,1,-16,2,-4,-10,-13,2,-14,3,1,-1,-9,-1,-2,-1,-5,-9,-4,3,-1,2,-2,-2,-3,-2,-2,1,-1,-3,-3,-1,1,1,-1,1,0,-1,41,22,19,3,1,2,-6,12,10,19,9,-5,-10,1,8,11,10,0,4,11,2,8,-1,-5,-1,4,1,-2,2,-2,0,1,0,-2,3,-1,-1,3,1,0,-1,-1,-56,-21,-35,1,1,0,-25,-14,-1,-16,0,0,-12,-11,7,-4,0,-3,-13,-3,-8,-12,0,3,2,0,1,-1,-4,1,2,0,0,-1,-3,1,0,0,1,0,-1,0,-11,-15,4,12,5,7,-5,-7,-10,-5,8,8,-1,-1,-15,2,-2,2,-4,-6,5,-7,10,6,2,4,-1,4,1,2,1,2,0,2,0,0,1,2,-1,2,1,2,-6,-1,-5,-1,-5,4,-3,9,-20,-8,12,4,-4,4,-6,-3,5,2,1,5,-14,-5,7,2,0,0,1,-4,2,0,0,0,-3,-1,-1,0,0,0,4,-3,3,0,73,34,39,32,21,11,9,-2,35,16,9,3,2,-2,22,1,5,2,7,0,13,15,4,1,9,6,14,4,-1,-1,6,3,9,1,0,1,3,3,5,3,-1,-2
17,17147,Ripoll,10818,51,55,-4,56,34,22,16,24,-9,20,5,-3,14,21,8,11,2,0,2,3,-17,9,3,-3,9,25,10,12,0,0,7,16,7,4,0,0,2,9,3,8,0,0,151,92,59,140,82,58,26,41,62,15,-1,4,7,31,37,9,2,3,19,10,25,6,-3,1,22,47,50,15,4,2,12,31,28,8,1,2,10,16,22,7,3,0,1,2,-1,74,38,36,-12,16,13,-9,6,-15,-12,14,7,-4,1,-4,0,2,6,-5,5,-11,8,19,33,8,5,1,2,13,16,4,2,1,6,6,17,4,3,0,31,55,-24,68,34,34,20,11,-1,5,1,-7,12,15,16,8,2,0,8,-4,-17,-3,-1,-7,20,21,17,5,2,1,9,12,9,2,0,1,11,9,8,3,2,0,-6,10,-16,75,40,35,27,1,-41,21,-15,-1,16,1,-7,9,-8,1,11,0,-34,12,-7,-2,19,12,22,14,3,2,10,9,11,8,1,1,9,3,11,6,2,1,135,96,39,103,63,40,24,52,7,25,6,14,19,27,14,22,7,2,5,25,-7,3,-1,12,11,25,30,30,3,3,6,12,23,20,1,0,5,13,7,10,2,3,76,42,34,130,63,67,4,23,27,15,6,-2,10,10,10,2,1,5,-6,13,17,13,5,-7,19,43,45,19,3,1,11,18,22,8,3,1,8,25,23,11,0,0,218,144,74,157,94,63,51,34,56,40,12,17,36,25,35,25,7,10,15,9,21,15,5,7,28,47,49,25,5,1,16,26,30,18,2,0,12,21,19,7,3,1,58,22,36,98,57,41,13,28,20,11,11,-22,1,17,17,-10,10,-10,12,11,3,21,1,-12,22,31,25,19,1,-1,15,15,15,11,1,-1,7,16,10,8,0,0,-64,-39,-25,15,-10,25,-11,-15,-11,-9,-3,-16,-1,-23,-10,1,-4,0,-10,8,-1,-10,1,-16,9,12,-2,-3,-1,0,4,-3,-7,-3,-1,0,5,15,5,0,0,0,-23,-13,-10,38,12,26,18,4,-8,-27,5,-14,14,2,-2,-19,1,-8,4,2,-6,-8,4,-6,17,7,8,4,2,0,10,-2,3,1,1,-1,7,9,5,3,1,1,7,-7,14,44,20,24,14,1,-15,15,9,-14,-4,6,-9,6,1,-7,18,-5,-6,9,8,-7,13,13,5,14,2,-4,6,6,0,9,0,-2,7,7,5,5,2,-2,-89,-46,-43,-33,-29,-4,-4,16,-59,-12,-11,-19,4,11,-33,-14,-6,-7,-8,5,-26,2,-5,-12,-4,6,-17,-13,-7,2,-2,4,-16,-9,-6,0,-2,2,-1,-4,-1,2,-19,-15,-4,24,13,11,1,12,-5,-3,-10,-11,-2,7,-7,-1,-4,-6,3,5,2,-2,-6,-5,6,12,4,3,0,-1,2,4,8,1,-1,-1,4,8,-4,2,1,0,-85,-64,-21,0,-9,9,-1,-4,-38,-8,-9,-24,-5,-7,-27,-8,-9,-8,4,3,-11,0,0,-16,-2,3,4,1,-4,-3,-1,1,-6,0,-3,-1,-1,2,10,1,-1,-2,-27,-11,-16,6,-3,9,1,-2,-6,-9,-2,-9,1,-4,-2,-2,-2,-3,0,2,-4,-7,0,-6,1,1,0,2,-1,3,3,-3,-2,-3,0,2,-2,4,2,5,-1,1,78,74,4,83,41,42,23,18,20,7,6,-2,22,8,22,13,1,4,1,10,-2,-6,5,-6,18,19,21,12,7,2,13,7,10,8,1,1,5,12,11,4,6,1,68,57,11,72,39,33,3,38,13,16,-2,-5,7,25,16,6,3,-3,-4,13,-3,10,-5,-2,13,25,19,13,-1,2,7,12,8,11,0,1,6,13,11,2,-1,1
17,17148,Riudarenes,1258,41,25,16,15,9,6,8,3,10,8,11,1,5,4,5,3,10,-2,3,-1,5,5,1,3,3,3,7,0,0,2,1,3,4,0,0,1,2,0,3,0,0,1,66,38,28,13,8,5,9,6,27,11,13,0,5,7,11,8,6,1,4,-1,16,3,7,-1,1,6,3,3,0,0,1,6,1,0,0,0,0,0,2,3,0,0,14,3,11,8,0,8,-6,4,2,2,3,7,-7,1,5,0,2,2,1,3,-3,2,1,5,-1,5,0,3,1,0,-1,1,-1,1,0,0,0,4,1,2,1,0,151,76,75,22,12,10,34,26,32,40,16,3,18,13,13,20,10,1,16,13,19,20,6,2,3,5,6,5,3,0,1,2,3,4,2,0,2,3,3,1,1,0,99,58,41,21,13,8,5,16,44,22,7,1,0,8,23,23,3,-1,5,8,21,-1,4,2,4,3,6,8,-1,0,2,2,3,6,-1,0,2,1,3,2,0,0,79,47,32,24,20,4,18,10,17,18,15,0,8,4,12,9,10,2,10,6,5,9,5,-2,7,1,12,2,2,0,6,1,11,1,1,0,1,0,1,1,1,0,90,64,26,35,29,6,10,16,31,16,12,1,12,13,18,11,8,1,-2,3,13,5,4,0,2,13,12,7,0,1,2,11,9,7,0,0,0,2,3,0,0,1,142,71,71,39,22,17,33,31,47,23,10,-5,20,12,25,11,4,-2,13,19,22,12,6,-3,3,11,20,5,0,0,1,4,15,2,0,0,2,7,5,3,0,0,57,36,21,28,13,15,19,1,17,8,8,4,17,6,1,6,6,1,2,-5,16,2,2,3,0,10,7,5,2,3,0,6,2,3,0,2,0,4,5,2,2,1,60,28,32,19,11,8,10,9,22,14,0,4,9,5,12,3,1,-3,1,4,10,11,-1,7,5,3,3,6,1,1,5,1,1,3,1,0,0,2,2,3,0,1,55,24,31,19,12,7,9,0,19,21,-2,3,5,-4,6,16,-2,1,4,4,13,5,0,2,4,7,4,3,0,0,3,3,3,3,0,0,1,4,1,0,0,0,2,7,-5,16,8,8,-6,8,6,-3,0,-4,-9,6,10,3,-4,1,3,2,-4,-6,4,-5,0,3,6,5,2,0,0,0,5,3,0,0,0,3,1,2,2,0,-1,5,-6,10,6,4,1,-1,9,-4,-7,0,4,0,8,-2,-4,-2,-3,-1,1,-2,-3,2,1,1,4,1,1,2,1,0,3,1,0,1,0,1,1,0,1,1,-17,-5,-12,6,3,3,-12,-1,7,-2,1,-8,-1,-6,7,-2,1,-4,-11,5,0,0,0,-4,1,3,1,0,1,0,1,1,0,0,1,0,0,2,1,0,0,0,-10,-4,-6,3,2,1,7,2,-3,2,-6,-7,4,3,-3,0,-3,-1,3,-1,0,2,-3,-6,-3,0,4,0,1,1,-2,0,3,0,0,1,-1,0,1,0,1,0,-4,-3,-1,4,3,1,-9,-3,1,1,3,3,-5,-1,0,-2,3,2,-4,-2,1,3,0,1,-1,0,2,2,1,0,0,-1,1,2,1,0,-1,1,1,0,0,0,18,8,10,14,10,4,9,5,13,-2,-3,-3,1,3,3,3,-4,2,8,2,10,-5,1,-5,0,6,6,1,2,-2,0,5,3,1,1,-1,0,1,3,0,1,-1,36,24,12,26,10,16,14,6,9,0,18,-10,8,2,6,1,10,-4,6,4,3,-1,8,-6,8,5,5,5,1,0,3,1,2,0,2,0,5,4,3,5,-1,0
17,17152,Roses,12408,605,325,280,459,267,192,79,112,164,93,93,56,39,67,88,51,54,23,40,45,76,42,39,33,63,89,129,74,70,30,33,52,78,42,41,18,30,37,51,32,29,12,560,281,279,528,277,251,93,72,140,121,96,34,42,35,75,56,55,16,51,37,65,65,41,18,94,79,129,107,90,25,40,34,79,54,56,11,54,45,50,53,34,14,499,230,269,544,271,273,80,78,127,96,88,23,29,35,55,48,49,9,51,43,72,48,39,14,91,104,150,91,74,31,42,53,65,52,41,16,49,51,85,39,33,15,736,354,382,598,295,303,128,110,155,109,146,77,74,56,74,53,63,29,54,54,81,56,83,48,103,104,103,100,123,63,55,43,53,53,63,27,48,61,50,47,60,36,718,390,328,625,327,298,96,140,185,114,122,58,65,65,115,63,49,30,31,75,70,51,73,28,108,111,142,111,105,42,65,49,78,60,46,26,43,62,64,51,59,16,1202,639,563,865,479,386,141,215,366,182,189,103,83,84,186,120,104,60,58,131,180,62,85,43,111,150,203,153,168,76,60,66,110,106,90,45,51,84,93,47,78,31,1125,624,501,926,494,432,151,173,259,235,197,96,75,90,169,139,97,48,76,83,90,96,100,48,128,162,187,178,177,86,65,85,112,99,86,44,63,77,75,79,91,42,1115,625,490,942,500,442,90,196,296,224,197,91,41,92,205,129,104,46,49,104,91,95,93,45,114,206,251,157,129,74,51,86,159,85,66,47,63,120,92,72,63,27,620,295,325,665,348,317,54,149,115,155,89,61,25,46,73,81,43,30,29,103,42,74,46,31,88,151,141,146,89,46,49,59,85,84,46,23,39,92,56,62,43,23,107,5,102,134,31,103,80,42,-4,-14,3,-2,38,30,-20,-23,-10,-10,42,12,16,9,13,8,73,44,16,4,-1,-7,36,26,-18,-5,-4,-5,37,18,34,9,3,-2,-877,-524,-353,-798,-460,-338,-79,-69,-176,-174,-150,-225,-46,-34,-124,-123,-75,-119,-33,-35,-52,-51,-75,-106,-76,-46,-131,-162,-158,-230,-37,-19,-95,-110,-87,-116,-39,-27,-36,-52,-71,-114,49,-38,87,31,-34,65,1,45,30,-21,-7,-4,-5,11,-3,-17,-13,-12,6,34,33,-4,6,8,23,46,4,-8,-11,-27,10,17,-12,-13,-16,-22,13,29,16,5,5,-5,-94,-55,-39,74,31,43,-11,37,-85,-41,14,12,-7,21,-52,-27,10,7,-4,16,-33,-14,4,5,36,27,3,-2,15,-7,21,10,-12,2,11,-2,15,17,15,-4,4,-5,-282,-171,-111,-150,-92,-58,-56,2,-61,-86,-40,-42,-27,-6,-33,-56,-26,-23,-29,8,-28,-30,-14,-19,-28,12,-42,-52,-3,-43,-9,2,-31,-37,-5,-17,-19,10,-11,-15,2,-26,-109,-12,-97,53,61,-8,-52,-26,-21,-17,-19,23,-7,-11,1,-7,8,6,-45,-15,-22,-10,-27,17,-19,8,25,10,23,2,-6,7,21,13,28,-3,-13,1,4,-3,-5,5,-154,-79,-75,-34,-11,-23,-63,-14,-25,-29,18,-38,-33,-4,2,-12,2,-31,-30,-10,-27,-17,16,-7,-20,0,2,-3,20,-37,-5,-4,9,-4,13,-21,-15,4,-7,1,7,-16,-172,-48,-124,-90,-19,-71,-29,-14,-12,-53,-48,-25,-11,4,2,-11,-34,-4,-18,-18,-14,-42,-14,-21,-16,13,1,-28,-33,-31,-3,10,8,-14,-20,-2,-13,3,-7,-14,-13,-29,78,61,17,86,45,41,15,18,36,22,8,-21,-14,27,10,29,19,-10,29,-9,26,-7,-11,-11,-2,33,37,19,14,-19,-12,25,14,16,11,-9,10,8,23,3,3,-10
17,17155,Salt,21822,433,344,89,408,272,136,71,139,146,58,0,14,54,94,122,64,4,7,17,45,24,-6,-4,7,80,111,141,57,13,2,50,71,104,36,6,2,30,40,37,21,7,0,562,382,180,573,371,202,77,227,192,44,8,11,41,140,152,39,2,4,36,87,40,5,6,7,85,166,224,69,18,8,49,101,165,45,6,2,36,65,59,24,12,6,1091,750,341,853,526,327,193,310,377,170,32,16,105,204,309,116,17,2,88,106,68,54,15,14,190,215,291,117,28,8,106,136,195,72,12,2,84,79,96,45,16,6,1519,1007,512,1016,570,446,261,476,543,203,12,9,173,281,420,126,-1,1,88,195,123,77,13,8,229,297,324,124,20,13,127,171,202,58,6,1,102,126,122,66,14,12,1309,907,402,1108,671,437,133,484,554,124,-4,9,69,311,427,95,-1,3,64,173,127,29,-3,6,185,366,375,125,39,12,110,221,252,66,16,4,75,145,123,59,23,8,488,310,178,945,529,416,143,248,158,25,-53,-30,70,160,111,14,-29,-7,73,88,47,11,-24,-23,224,326,277,78,23,11,125,183,175,31,8,5,99,143,102,47,15,6,79,78,1,923,509,414,-18,213,86,-17,-99,-67,-44,147,72,10,-58,-34,26,66,14,-27,-41,-33,179,364,258,98,14,4,97,200,152,53,3,2,82,164,106,45,11,2,447,398,49,1297,773,524,68,341,192,24,-99,-57,70,239,163,10,-56,-20,-2,102,29,14,-43,-37,226,489,427,120,21,5,135,310,262,50,9,3,91,179,165,70,12,2,857,532,325,1218,737,481,171,305,341,79,-25,-18,90,174,235,47,-10,-7,81,131,106,32,-15,-11,240,383,425,141,13,3,137,225,282,77,9,0,103,158,143,64,4,3,39,-136,175,265,20,245,109,141,-130,-77,-14,-8,64,55,-186,-71,-11,-2,45,86,56,-6,-3,-6,99,204,-4,-42,-3,1,53,97,-66,-65,-9,2,46,107,62,23,6,-1,32,101,-69,749,439,310,50,152,-128,21,-35,-3,57,116,-59,31,-18,-7,-7,36,-69,-10,-17,4,146,243,215,105,23,9,83,157,123,59,10,4,63,86,92,46,13,5,-901,-579,-322,-56,-140,84,-174,-54,-363,-229,-30,-47,-70,-52,-240,-165,-30,-17,-104,-2,-123,-64,0,-30,33,65,-93,-71,-1,1,26,0,-88,-77,-6,1,7,65,-5,6,5,0,-217,-133,-84,154,82,72,-58,52,-75,-73,-19,-40,-24,29,-61,-46,-15,-14,-34,23,-14,-27,-4,-26,-3,95,24,41,4,-8,-1,60,9,16,-3,-1,-2,35,15,25,7,-7,-478,-334,-144,-186,-163,-23,-66,-31,-190,-110,-53,-29,-32,-31,-115,-115,-37,-5,-34,0,-75,5,-16,-24,-25,28,-88,-69,-32,-9,4,-1,-72,-73,-22,-4,-29,29,-16,4,-10,-5,-636,-351,-285,-270,-188,-82,-146,-27,-181,-242,-10,-18,-47,-18,-87,-183,-7,-6,-99,-9,-94,-59,-3,-12,-56,21,-67,-138,-28,-3,-12,3,-33,-123,-21,-2,-44,18,-34,-15,-7,-1,-261,-249,-12,-59,-55,-4,-34,14,-83,-157,-11,2,-30,-6,-94,-119,-6,0,-4,20,11,-38,-5,2,-3,37,-11,-50,-29,-9,0,13,-10,-42,-17,-4,-3,24,-1,-8,-12,-5,566,329,237,417,277,140,100,150,152,87,44,28,80,102,78,37,26,4,20,48,74,50,18,24,56,127,113,73,24,18,45,88,82,46,10,4,11,39,31,27,14,14,716,355,361,679,372,307,121,172,273,118,30,-4,33,79,170,66,5,0,88,93,103,52,25,-4,96,195,225,118,35,5,45,90,138,70,23,5,51,105,87,48,12,0
17,17160,Sant Feliu de Guíxols,18067,148,90,58,46,22,24,23,22,13,27,25,26,15,16,14,13,8,12,8,6,-1,14,17,14,11,9,10,7,3,5,7,5,4,2,2,2,4,4,6,5,1,3,53,49,4,25,11,14,-15,-4,41,-15,24,10,-13,-3,45,-5,12,6,-2,-1,-4,-10,12,4,6,0,4,4,5,2,0,0,2,2,3,0,6,0,2,2,2,2,153,62,91,38,15,23,7,2,12,25,47,45,-3,2,12,16,14,15,10,0,0,9,33,30,7,8,7,12,4,-1,2,4,3,6,1,-1,5,4,4,6,3,0,481,255,226,296,164,132,66,94,110,95,61,51,38,37,73,50,33,24,28,57,37,45,28,27,56,64,76,65,17,13,27,34,47,37,8,8,29,30,29,28,9,5,539,299,240,404,230,174,71,115,139,103,87,19,49,48,85,55,47,11,22,67,54,48,40,8,66,98,130,66,34,5,43,47,81,36,16,4,23,51,49,30,18,1,518,276,242,404,222,182,76,87,194,77,51,28,41,38,124,41,15,12,35,49,70,36,36,16,81,94,121,57,31,16,45,51,76,29,8,10,36,43,45,28,23,6,394,267,127,387,227,160,-2,109,130,81,54,18,9,67,108,54,23,4,-11,42,22,27,31,14,54,98,118,60,34,19,37,56,77,30,15,10,17,42,41,30,19,9,597,408,189,568,361,207,112,157,179,100,53,0,60,123,128,69,25,-2,52,34,51,31,28,2,102,180,171,83,32,1,53,124,110,55,18,2,49,56,61,28,14,-1,143,78,65,314,165,149,32,61,56,-10,-4,10,16,36,22,1,-3,6,16,25,34,-11,-1,4,57,100,114,34,1,4,42,52,46,19,0,4,15,48,68,15,1,0,-56,-97,41,-3,-54,51,20,19,-94,-7,18,-9,12,-17,-77,-13,2,-5,8,36,-17,6,16,-4,22,25,-8,-41,4,-7,12,-6,-14,-43,1,-5,10,31,6,2,3,-2,-159,-108,-51,-82,-76,-6,-33,-24,-75,-47,-7,24,-29,-13,-48,-25,-9,11,-4,-11,-27,-22,2,13,-12,10,-70,-28,10,6,-9,0,-60,-11,1,2,-3,10,-10,-17,9,4,134,63,71,107,39,68,28,60,-6,35,0,17,18,37,-4,18,-5,-2,10,23,-2,17,5,19,40,43,-13,25,10,3,25,22,-19,5,4,2,15,21,6,20,6,1,-137,-73,-64,-83,-59,-24,-54,12,-29,-36,-20,-4,-21,-3,-5,-27,7,-16,-33,15,-24,-9,-27,12,-11,18,-9,-46,-19,-17,3,1,-15,-34,-2,-12,-14,17,6,-12,-17,-5,-105,-81,-24,-140,-92,-48,3,-18,10,-72,-2,-33,-9,0,8,-58,-12,-15,12,-18,2,-14,10,-18,-7,17,-39,-67,-12,-36,2,6,-18,-54,-12,-19,-9,11,-21,-13,0,-17,-125,-59,-66,-37,-40,3,-10,2,-71,-33,-5,-11,-2,18,-30,-29,-14,-5,-8,-16,-41,-4,9,-6,1,19,-15,-19,2,-27,0,12,-16,-17,-6,-15,1,7,1,-2,8,-12,152,80,72,92,36,56,50,27,17,17,44,-7,30,17,-7,6,32,2,20,10,24,11,12,-9,33,28,2,-2,14,12,22,10,-7,-5,10,4,11,18,9,3,4,8,28,-15,43,118,24,94,-24,45,8,-33,32,1,-33,8,18,-21,11,1,9,37,-10,-12,21,0,32,45,46,-21,22,-8,4,19,21,-20,6,-7,28,26,25,-1,16,-1,176,92,84,93,50,43,55,12,54,62,-17,10,32,-6,0,62,-7,13,23,18,54,0,-10,-3,25,33,-2,31,5,-3,15,12,-17,35,5,-2,10,21,15,-4,0,-1
17,17164,Sant Hilari Sacalm,4932,111,82,29,89,66,23,23,14,39,23,9,3,12,10,34,19,6,1,11,4,5,4,3,2,17,17,32,19,2,1,10,10,28,16,1,1,7,7,4,3,1,0,139,103,36,134,101,33,24,38,51,19,0,6,15,33,39,13,-2,5,9,5,12,6,2,1,21,39,47,21,3,2,11,32,39,17,2,0,10,7,8,4,1,2,188,119,69,190,120,70,36,36,64,27,10,14,16,32,45,16,3,7,20,4,19,11,7,7,33,44,70,30,11,2,14,32,51,17,5,1,19,12,19,13,6,1,125,86,39,130,85,45,13,43,36,19,8,7,8,35,23,11,5,4,5,8,13,8,3,3,12,49,46,18,4,1,6,35,32,9,2,1,6,14,14,9,2,0,10,13,-3,81,51,30,-2,13,-14,2,6,6,4,10,-1,-6,4,3,-6,3,-13,8,2,3,20,28,16,15,1,0,11,20,12,7,0,0,9,8,4,8,1,0,86,46,40,81,51,30,20,22,21,29,-1,-6,13,11,0,20,2,-1,7,11,21,9,-3,-5,12,27,28,13,-1,2,5,19,15,11,0,1,7,8,13,2,-1,1,143,71,72,89,53,36,27,34,30,31,10,5,15,13,16,13,7,2,12,21,14,18,3,3,14,26,28,21,2,-3,11,12,18,11,2,-2,3,14,10,10,0,-1,164,105,59,127,91,36,40,37,29,43,5,8,24,18,31,25,3,4,16,19,-2,18,2,4,25,36,37,21,5,2,20,23,34,10,2,2,5,13,3,11,3,0,37,31,6,106,62,44,17,20,-3,-4,8,-2,10,10,1,-1,8,1,7,10,-4,-3,0,-3,26,32,29,15,4,1,13,17,18,11,2,0,13,15,11,4,2,1,-32,-32,0,26,5,21,-2,3,-22,-4,-14,4,0,-3,-15,-5,-8,-2,-2,6,-7,1,-6,6,9,13,3,3,-3,0,7,1,-2,1,-3,0,2,12,5,2,0,0,2,-17,19,59,24,35,-5,2,-8,2,6,3,-7,-7,-9,0,6,-1,2,9,1,2,0,4,16,14,15,10,4,-2,7,5,4,6,3,-1,9,9,11,4,1,-1,13,8,5,21,8,13,2,3,6,-12,7,6,4,-3,9,-7,4,0,-2,6,-3,-5,3,6,2,8,10,-3,2,0,0,0,10,-3,-1,0,2,8,0,0,3,0,-26,-16,-10,1,-3,4,13,0,-13,-14,-1,-13,7,-1,-15,-5,2,-4,6,1,2,-9,-3,-9,-3,7,5,-6,-1,0,-1,0,3,-4,0,0,-2,7,2,-2,-1,0,-24,-15,-9,-35,-16,-19,4,-22,-11,-8,6,7,7,-14,-10,-5,4,3,-3,-8,-1,-3,2,4,-5,-8,-12,-7,-5,2,0,-3,-6,-6,-2,1,-5,-5,-6,-1,-3,1,-68,-46,-22,3,-7,10,-27,-8,-15,-19,-5,8,-16,-3,-15,-10,-4,3,-11,-5,0,-9,-1,5,2,5,-3,-5,5,-1,1,2,-8,-4,3,-1,1,3,5,-1,2,0,0,-2,2,30,7,23,2,4,-4,-14,5,8,2,4,4,-13,-2,4,0,0,-8,-1,7,4,11,7,6,1,3,1,6,2,0,-2,0,1,5,5,6,3,3,0,2,-4,6,15,11,4,1,2,4,-5,-3,4,-2,2,3,-3,-6,2,3,0,1,-2,3,2,3,11,4,2,-2,-3,1,6,4,2,-1,-1,2,5,0,0,-1,-2,18,7,11,48,27,21,0,18,-7,-1,9,2,-1,9,-4,-3,3,4,1,9,-3,2,6,-2,3,17,21,2,0,3,1,10,14,0,-1,1,2,7,7,2,1,2
17,17167,Sant Joan de les Abadesses,3706,-16,-7,-9,6,5,1,-7,6,-6,2,-5,-6,-5,4,-4,1,-4,1,-2,2,-2,1,-1,-7,0,3,2,1,0,0,0,3,2,0,0,0,0,0,0,1,0,0,47,26,21,39,22,17,15,13,8,5,6,1,11,6,7,1,2,0,4,7,1,4,4,1,12,12,10,3,1,1,7,6,7,1,0,1,5,6,3,2,1,0,-3,4,-7,17,14,3,-7,1,-9,4,1,6,-3,2,-3,6,-2,4,-4,-1,-6,-2,3,2,2,6,6,1,1,1,2,5,4,1,1,1,0,1,2,0,0,0,31,29,2,31,20,11,16,1,6,0,1,4,12,6,5,2,-2,2,4,-5,1,-2,3,2,11,6,8,3,1,0,6,4,6,1,1,0,5,2,2,2,0,0,54,36,18,53,30,23,21,15,-4,4,11,5,11,9,1,2,8,4,10,6,-5,2,3,1,11,18,10,10,3,0,5,11,7,5,1,0,6,7,3,5,2,0,-6,0,-6,33,25,8,10,-1,-11,7,-8,-1,6,-5,1,4,-4,0,4,4,-12,3,-4,-1,12,12,7,2,0,0,9,8,6,2,0,0,3,4,1,0,0,0,29,20,9,38,24,14,12,0,5,12,4,-3,10,-4,8,4,2,-1,2,4,-3,8,2,-2,7,8,15,7,0,0,7,2,10,4,0,0,0,6,5,3,0,0,13,5,8,34,17,17,4,8,-5,-2,4,5,-3,7,-2,1,3,-1,7,1,-3,-3,1,6,4,12,10,6,1,1,-1,6,7,3,1,1,5,6,3,3,0,0,0,-10,10,14,6,8,-6,-2,-7,-10,1,20,-8,-1,-5,-3,3,4,2,-1,-2,-7,-2,16,4,4,4,1,-1,0,1,1,3,2,-1,0,3,3,1,-1,0,0,-3,-6,3,2,2,0,-2,-11,-5,-2,4,13,0,-1,-8,-7,6,4,-2,-10,3,5,-2,9,-1,-1,2,1,1,0,0,0,1,0,1,0,-1,-1,1,1,0,0,-14,-14,0,2,0,2,9,1,-17,-4,-3,0,4,-1,-12,-2,-2,-1,5,2,-5,-2,-1,1,-1,1,1,1,0,0,-2,0,0,2,0,0,1,1,1,-1,0,0,-3,0,-3,7,4,3,0,-2,3,-2,-5,2,0,0,1,-2,-1,1,0,-2,2,0,-4,1,3,2,1,1,-1,1,1,1,0,1,0,1,2,1,1,0,-1,0,-17,-23,6,5,2,3,-5,1,-6,-11,3,2,-2,-3,-3,-9,-2,-3,-3,4,-3,-2,5,5,2,4,-1,0,0,0,2,2,-1,-1,0,0,0,2,0,1,0,0,2,9,-7,0,-2,2,4,-6,-8,11,4,-3,3,-3,-5,6,6,2,1,-3,-3,5,-2,-5,0,0,-2,1,1,0,0,-1,-2,1,0,0,0,1,0,0,1,0,8,-1,9,-8,-5,-3,6,-11,9,-6,2,9,6,-7,-4,-2,1,5,0,-4,13,-4,1,4,-3,1,-1,-4,-1,0,-1,0,0,-3,-1,0,-2,1,-1,-1,0,0,-6,-2,-4,-2,-1,-1,-5,-7,-7,1,-4,15,-2,-4,-3,0,0,7,-3,-3,-4,1,-4,8,-2,0,1,-2,1,0,-2,0,1,0,0,0,0,0,0,-2,1,0,-19,-5,-14,7,1,6,-14,-2,-1,-4,2,-2,-10,1,1,-2,3,1,-4,-3,-2,-2,-1,-3,-2,2,4,1,1,0,-3,1,2,-1,1,0,1,1,2,2,0,0,-13,-8,-5,-5,-2,-3,-10,13,-5,-5,-3,-3,-9,8,-1,-1,-5,0,-1,5,-4,-4,2,-3,-6,0,-1,2,-1,1,-2,0,1,1,-2,0,-4,0,-2,1,1,1
17,17169,Sant Julià de Ramis,1986,59,17,42,21,4,17,17,16,12,12,0,2,6,2,6,2,2,0,11,14,6,10,-2,2,1,12,6,2,0,0,0,1,3,0,0,0,1,11,3,2,0,0,72,55,17,11,5,6,35,0,11,16,7,1,25,6,5,11,5,1,10,-6,6,5,2,0,2,3,4,1,1,0,1,1,2,0,1,0,1,2,2,1,0,0,62,43,19,6,1,5,22,12,9,12,4,2,11,12,5,11,3,0,11,0,4,1,1,2,-1,4,3,0,0,0,0,0,1,0,0,0,-1,4,2,0,0,0,110,55,55,25,14,11,27,6,26,36,6,6,10,2,11,24,4,3,17,4,15,12,2,3,3,6,8,5,3,0,1,4,5,3,1,0,2,2,3,2,2,0,130,73,57,21,7,14,31,19,36,31,2,6,16,6,26,17,2,3,15,13,10,14,0,3,3,12,3,3,-1,1,2,2,1,2,0,0,1,10,2,1,-1,1,136,69,67,19,9,10,22,23,62,25,3,-5,13,11,27,15,0,-2,9,12,35,10,3,-3,4,5,2,5,1,1,1,4,1,3,0,0,3,1,1,2,1,1,206,103,103,42,16,26,54,27,82,32,6,1,28,11,43,12,7,0,26,16,39,20,-1,1,9,8,13,6,5,0,6,1,5,2,2,0,3,7,8,4,3,0,237,145,92,42,26,16,61,35,89,46,5,-3,35,19,51,29,8,1,26,16,38,17,-3,-4,7,8,16,11,-1,1,5,3,8,8,1,1,2,5,8,3,-2,0,87,38,49,26,8,18,24,11,16,11,8,12,11,3,-1,11,3,6,13,8,17,0,5,6,7,7,3,4,2,0,6,3,-2,-3,1,0,1,4,5,7,1,0,12,12,0,-11,-4,-7,-1,7,7,2,1,-7,-2,5,4,8,0,-4,1,2,3,-6,1,-3,0,-3,-1,-9,2,0,-1,1,1,-4,-1,0,1,-4,-2,-5,3,0,61,40,21,-11,-7,-4,21,12,4,16,-8,10,14,6,5,11,-3,3,7,6,-1,5,-5,7,-2,-2,-1,-5,-1,0,-2,-1,0,-4,0,0,0,-1,-1,-1,-1,0,81,35,46,3,0,3,30,4,32,10,-1,0,14,2,12,2,2,0,16,2,20,8,-3,0,-1,2,-1,0,1,0,-1,0,-1,-2,2,0,0,2,0,2,-1,0,-14,17,-31,-8,-6,-2,9,-13,-6,-8,1,0,12,-6,2,4,-1,3,-3,-7,-8,-12,2,-3,-1,3,-4,-5,-1,0,-2,1,-4,-1,-1,1,1,2,0,-4,0,-1,-69,-22,-47,-7,1,-8,-24,-5,-18,-14,-8,-2,-13,-2,2,-1,-5,-3,-11,-3,-20,-13,-3,1,-2,0,-1,-3,-2,1,0,3,-2,1,-1,0,-2,-3,1,-4,-1,1,-48,-19,-29,-2,2,-4,-23,-9,-7,-3,-2,1,-8,-4,0,-1,-5,3,-15,-5,-7,-2,3,-2,-1,-2,2,-2,0,1,1,-1,0,1,1,0,-2,-1,2,-3,-1,1,28,26,2,6,0,6,-5,10,19,-4,-1,7,6,5,6,6,-4,5,-11,5,13,-10,3,2,3,6,1,-2,-2,0,0,4,-1,-1,-2,0,3,2,2,-1,0,0,-18,-6,-12,9,-6,15,-20,13,1,-3,-3,-9,-13,2,7,-4,2,-1,-7,11,-6,1,-5,-8,3,5,7,0,-5,-1,-1,0,1,-3,-3,0,4,5,6,3,-2,-1,9,1,8,5,-2,7,0,3,14,-4,-4,-1,5,-2,2,0,-3,-1,-5,5,12,-4,-1,0,2,1,0,-2,1,3,1,-1,0,-4,1,1,1,2,0,2,0,2
17,17181,Santa Cristina d'Aro,2730,112,55,57,49,21,28,17,26,18,19,32,2,8,12,12,8,17,-2,9,14,6,11,15,4,8,10,12,8,9,2,4,5,6,2,3,1,4,5,6,6,6,1,111,59,52,72,44,28,25,19,25,25,10,8,12,12,8,15,8,2,13,7,17,10,2,6,19,14,20,5,10,3,10,10,11,3,8,1,9,4,9,2,2,2,284,128,156,88,56,32,47,43,75,52,41,20,25,21,34,20,17,9,22,22,41,32,24,11,7,16,18,22,16,8,7,12,14,12,7,4,0,4,4,10,9,4,222,137,85,98,65,33,37,37,58,42,35,12,27,24,27,29,18,9,10,13,31,13,17,3,15,19,28,16,16,3,13,14,14,13,9,2,2,5,14,3,7,1,219,99,120,83,45,38,37,28,71,34,38,3,11,17,30,22,15,0,26,11,41,12,23,3,16,17,18,10,14,4,7,12,10,6,6,2,9,5,8,4,8,2,209,96,113,100,51,49,45,19,73,39,22,7,20,14,35,13,11,4,25,5,38,26,11,3,20,14,22,25,15,3,10,7,10,12,8,4,10,7,12,13,7,-1,273,132,141,97,51,46,47,43,89,49,25,11,29,16,45,16,15,5,18,27,44,33,10,6,5,17,23,20,23,8,1,13,12,9,11,4,4,4,11,11,12,4,119,45,74,65,35,30,17,34,31,5,17,12,10,16,13,0,2,2,7,18,18,5,15,10,13,19,16,5,8,4,8,14,6,2,4,1,5,5,10,3,4,3,276,151,125,83,49,34,61,26,82,60,33,8,37,12,40,35,25,2,24,14,42,25,8,6,10,9,22,23,15,4,4,3,14,13,12,3,6,6,8,10,3,1,25,36,-11,14,9,5,-5,2,16,-2,2,4,1,11,14,3,2,3,-6,-9,2,-5,0,1,12,7,3,-6,-1,-2,8,3,-2,2,0,-2,4,4,5,-8,-1,0,-24,-19,-5,-36,-37,1,-5,-6,8,-16,0,-9,-3,-6,11,-16,1,-7,-2,0,-3,0,-1,-2,-3,-3,-5,-15,-8,-3,-8,-4,-5,-14,-5,-1,5,1,0,-1,-3,-2,11,0,11,-15,-16,1,1,7,0,-11,13,0,6,6,-7,-5,3,-2,-5,1,7,-6,10,2,1,0,0,-11,2,-9,1,-1,-4,-7,-1,-5,0,1,4,-4,3,-4,9,3,6,9,6,3,-3,-10,8,15,3,-5,-4,-4,2,10,2,-4,1,-6,6,5,1,-1,2,2,-1,11,2,-7,3,0,1,5,1,-4,-1,2,-2,6,1,-3,80,37,43,25,12,13,14,13,-6,35,24,-1,12,5,-4,12,10,2,2,8,-2,23,14,-3,8,5,1,5,5,1,7,3,-1,1,1,1,1,2,2,4,4,0,-88,-48,-40,-59,-26,-33,-23,0,-8,-28,-18,-14,-15,0,-1,-25,-3,-2,-8,0,-7,-3,-15,-12,-4,1,-11,-12,-12,-21,-1,2,-7,-7,-5,-8,-3,-1,-4,-5,-7,-13,48,1,47,17,-4,21,25,6,-2,20,-3,0,13,-1,-7,2,-4,-5,12,7,5,18,1,5,6,10,0,1,2,-2,0,5,-4,-4,-1,0,6,5,4,5,3,-2,81,52,29,40,20,20,33,9,11,24,1,2,18,10,8,17,-4,2,15,-1,3,7,5,0,19,6,0,13,-2,3,9,4,0,5,-2,3,10,2,0,8,0,0,6,12,-6,27,21,6,11,-19,-4,7,3,6,9,-8,-1,11,1,-1,2,-11,-3,-4,2,7,18,-5,5,4,-5,9,15,1,-1,7,-5,3,3,-6,6,-3,0,6
17,17186,Sarrià de Ter,3347,178,92,86,12,5,7,52,31,53,30,5,8,24,16,31,15,3,3,28,15,22,15,2,5,2,4,4,1,1,0,1,0,3,0,1,0,1,4,1,1,0,0,84,43,41,6,3,3,10,26,23,22,-1,6,1,14,13,14,0,1,9,12,10,8,-1,5,3,1,2,0,0,0,1,1,1,0,0,0,2,0,1,0,0,0,147,68,79,14,7,7,36,29,38,35,4,1,19,8,24,17,1,-1,17,21,14,18,3,2,4,6,1,3,0,0,3,2,0,2,0,0,1,4,1,1,0,0,87,51,36,22,8,14,6,37,16,14,5,0,3,22,12,8,1,2,3,15,4,6,4,-2,6,4,8,3,1,0,1,0,6,1,0,0,5,4,2,2,1,0,96,42,54,33,23,10,14,12,24,20,7,5,7,7,14,9,0,3,7,5,10,11,7,2,1,6,9,12,3,1,1,5,6,10,1,0,0,1,3,2,2,1,2,10,-8,31,20,11,-19,28,-15,0,-2,10,-10,15,1,-1,-2,4,-9,13,-16,1,0,6,7,9,-2,15,1,0,2,4,4,8,1,0,5,5,-6,7,0,0,90,53,37,49,23,26,17,21,21,23,-2,5,5,7,22,13,-1,4,12,14,-1,10,-1,1,7,11,16,14,2,-1,2,3,11,7,0,0,5,8,5,7,2,-1,155,76,79,57,33,24,27,31,43,28,6,19,9,18,14,17,5,12,18,13,29,11,1,7,8,14,16,8,3,7,4,10,10,3,1,4,4,4,6,5,2,3,84,28,56,11,2,9,12,28,27,10,1,3,1,12,3,4,3,3,11,16,24,6,-2,0,7,13,-11,0,2,-1,1,7,-8,0,2,0,6,6,-3,0,0,-1,110,51,59,3,-1,4,19,2,57,23,5,5,9,-6,32,13,5,0,10,8,25,10,0,5,3,-5,5,0,0,-1,3,-4,0,1,0,-1,0,-1,5,-1,0,0,80,33,47,9,0,9,9,10,57,7,3,-2,2,-2,32,3,-2,1,7,12,25,4,5,-3,-1,8,-1,1,1,1,-3,2,0,0,0,1,2,6,-1,1,1,0,47,24,23,5,-4,9,0,15,11,16,7,-1,4,5,8,5,2,0,-4,10,3,11,5,-1,-3,1,11,-2,0,-2,-1,-2,5,-3,-1,-2,-2,3,6,1,1,0,81,51,30,-9,-9,0,2,30,22,20,7,2,13,12,7,9,8,0,-11,18,15,11,-1,2,0,2,-7,3,-4,-3,2,0,-5,-2,-2,-2,-2,2,-2,5,-2,-1,51,21,30,-19,-6,-13,16,5,17,12,-1,5,13,-1,3,6,0,1,3,6,14,6,-1,4,-3,-3,-7,-3,-1,-1,2,-2,-4,-2,0,0,-5,-1,-3,-1,-1,-1,-7,-7,0,13,6,7,-7,-9,6,1,-6,4,-8,-8,2,2,0,2,1,-1,4,-1,-6,2,2,-1,8,2,0,1,3,-1,3,1,0,0,-1,0,5,1,0,1,58,21,37,18,5,13,12,10,24,4,15,-4,3,10,8,0,7,-7,9,0,16,4,8,3,4,2,5,5,2,-1,0,2,3,0,0,-1,4,0,2,5,2,0,-6,-24,18,11,6,5,-10,2,10,-11,-2,8,-10,-4,-1,-11,-1,5,0,6,11,0,-1,3,4,3,2,2,0,0,4,2,0,2,-2,0,0,1,2,0,2,0,51,25,26,23,5,18,16,10,23,5,12,-10,17,5,4,4,3,-5,-1,5,19,1,9,-5,6,0,17,-2,2,0,4,1,4,-2,-1,-1,2,-1,13,0,3,1
17,17193,Sils,2896,92,37,55,4,1,3,15,21,23,22,14,-4,2,8,10,9,11,-3,13,13,13,13,3,-1,2,0,0,2,0,0,1,0,0,0,0,0,1,0,0,2,0,0,150,83,67,22,8,14,30,19,43,38,10,8,18,3,25,25,10,1,12,16,18,13,0,7,6,4,5,4,2,1,3,1,2,1,1,0,3,3,3,3,1,1,151,81,70,17,9,8,31,26,32,36,20,2,14,17,14,26,11,-2,17,9,18,10,9,4,1,3,8,5,0,0,0,1,6,2,0,0,1,2,2,3,0,0,177,86,91,23,9,14,31,29,45,35,27,6,7,14,24,21,15,4,24,15,21,14,12,2,3,8,7,4,1,0,1,2,4,2,0,0,2,6,3,2,1,0,245,123,122,30,13,17,49,35,79,38,26,11,27,16,40,20,12,4,22,19,39,18,14,7,9,9,4,4,2,1,4,4,1,2,1,0,5,5,3,2,1,1,200,115,85,28,17,11,58,9,46,29,40,11,34,6,31,14,25,4,24,3,15,15,15,7,11,4,5,4,2,2,6,4,2,4,1,0,5,0,3,0,1,2,228,127,101,44,21,23,47,35,81,36,24,1,29,16,49,17,12,2,18,19,32,19,12,-1,7,8,17,8,3,0,2,4,8,6,1,0,5,4,9,2,2,0,444,265,179,80,50,30,62,65,164,84,42,21,38,41,87,53,32,9,24,24,77,31,10,12,17,14,27,11,10,2,11,12,16,4,6,1,6,2,11,7,4,1,219,123,96,58,27,31,39,50,72,34,16,12,23,24,50,15,7,7,16,26,22,19,9,5,7,14,20,9,5,3,0,7,13,3,2,2,7,7,7,6,3,1,189,87,102,38,13,25,32,20,39,39,25,31,9,7,27,16,15,11,23,13,12,23,10,20,19,9,6,-2,0,4,6,5,3,-5,1,1,13,4,3,3,-1,3,116,71,45,28,6,22,26,15,12,20,29,10,19,10,7,14,18,4,7,5,5,6,11,6,10,2,9,3,0,2,5,-1,-1,1,1,1,5,3,10,2,-1,1,173,89,84,25,18,7,47,5,44,15,4,57,39,3,12,3,13,17,8,2,32,12,-9,40,10,2,7,3,2,1,8,0,3,4,2,1,2,2,4,-1,0,0,-44,-10,-34,-26,-12,-14,-15,-9,-21,0,-5,13,-5,-8,-5,3,-2,10,-10,-1,-16,-3,-3,3,0,-2,-13,-2,-1,-9,1,-3,-5,0,0,-5,-1,1,-8,-2,-1,-4,157,87,70,29,14,15,37,14,41,6,23,33,10,13,31,7,9,14,27,1,10,-1,14,19,10,4,11,1,0,3,0,0,8,4,-1,3,10,4,3,-3,1,0,7,-12,19,-18,-12,-6,-1,3,11,4,-14,-1,-1,-6,13,-8,-8,-4,0,9,-2,12,-6,3,-1,3,-8,-6,-6,0,2,0,-4,-5,-4,-1,-3,3,-4,-1,-2,1,118,69,49,32,23,9,26,15,25,22,12,17,14,18,9,17,7,3,12,-3,16,5,5,14,8,2,6,10,4,2,9,2,1,8,3,0,-1,0,5,2,1,2,9,-10,19,18,0,18,5,-6,7,-6,6,4,8,2,-10,-6,1,-5,-3,-8,17,0,5,9,2,8,7,1,0,0,-2,5,1,-2,-2,0,4,3,6,3,2,0,57,15,42,26,9,17,-5,4,1,27,13,20,-5,0,-5,13,8,3,0,4,6,14,5,17,5,2,8,8,-1,4,0,2,5,1,0,1,5,0,3,7,-1,3
17,17198,Torroella de Fluvià,309,11,5,6,18,10,8,0,1,3,1,5,1,-1,-2,6,0,3,-1,1,3,-3,1,2,2,4,2,4,2,4,2,3,0,3,1,2,1,1,2,1,1,2,1,16,12,4,15,10,5,-2,1,0,12,3,2,0,0,-1,10,2,1,-2,1,1,2,1,1,1,4,1,5,2,2,1,2,1,4,1,1,0,2,0,1,1,1,24,15,9,19,13,6,0,5,6,8,6,-1,2,3,0,5,5,0,-2,2,6,3,1,-1,3,2,6,5,2,1,3,2,3,2,2,1,0,0,3,3,0,0,35,23,12,12,9,3,8,5,7,12,-2,5,4,2,6,9,-1,3,4,3,1,3,-1,2,0,1,4,3,3,1,0,1,3,3,1,1,0,0,1,0,2,0,27,16,11,22,11,11,5,6,6,4,6,0,3,3,2,2,6,0,2,3,4,2,0,0,6,5,5,3,3,0,2,2,3,2,2,0,4,3,2,1,1,0,37,13,24,10,5,5,7,4,17,2,5,1,2,3,5,0,1,1,5,1,12,2,4,0,3,1,6,-1,2,-1,2,1,2,-1,2,-1,1,0,4,0,0,0,102,57,45,29,16,13,22,13,34,18,10,1,14,5,20,9,7,0,8,8,14,9,3,1,11,5,5,5,2,0,7,2,3,2,1,0,4,3,2,3,1,0,88,37,51,36,18,18,15,16,24,20,10,1,1,6,11,12,5,0,14,10,13,8,5,1,9,8,4,5,8,1,4,4,0,2,6,1,5,4,4,3,2,0,3,-6,9,2,-1,3,-3,0,-2,6,0,1,-2,-2,-7,7,-2,0,-1,2,5,-1,2,1,2,2,-2,0,0,0,1,0,-3,2,-1,0,1,2,1,-2,1,0,10,1,9,15,5,10,-3,3,11,-2,2,-1,-3,1,6,-1,-4,1,0,2,5,-1,6,-2,0,5,1,1,6,1,0,1,0,1,1,1,0,4,1,0,5,0,-8,-4,-4,-12,-9,-3,-6,-3,-7,10,2,-4,-1,-1,-3,3,1,-3,-5,-2,-4,7,1,-1,-4,2,-7,-2,2,-3,-2,2,-5,-2,1,-3,-2,0,-2,0,1,0,6,2,4,5,3,2,1,-1,4,4,-6,2,-2,1,2,0,-2,2,3,-2,2,4,-4,0,2,1,1,0,1,0,1,0,0,0,1,1,1,1,1,0,0,-1,19,8,11,6,3,3,3,6,10,-2,0,4,2,1,8,-3,-1,2,1,5,2,1,1,2,1,1,1,1,1,1,0,1,1,0,0,1,1,0,0,1,1,0,-13,5,-18,-2,2,-4,-10,8,3,-9,-2,-3,-2,9,5,-3,-3,-1,-8,-1,-2,-6,1,-2,-1,1,4,-2,-1,-4,0,1,4,1,-3,-2,-1,0,0,-3,2,-2,18,17,1,16,6,10,-5,8,1,-1,9,4,-3,2,3,2,8,3,-2,6,-2,-3,1,1,-1,3,2,0,9,2,-1,0,0,0,5,1,0,3,2,0,4,1,-8,-8,0,2,1,1,-6,-3,2,4,-2,-2,-7,-2,0,3,-2,0,1,-1,2,1,0,-2,2,0,0,1,0,-1,0,0,0,1,0,0,2,0,0,0,0,-1,-12,-5,-7,12,7,5,-6,2,-6,0,0,-2,0,3,-4,0,-1,-3,-6,-1,-2,0,1,1,1,1,4,2,4,0,0,1,2,2,2,0,1,0,2,0,2,0,20,-2,22,-19,-15,-4,9,3,6,14,-5,-7,-1,1,1,7,-6,-4,10,2,5,7,1,-3,-1,2,-6,0,-7,-7,-2,0,-4,0,-6,-3,1,2,-2,0,-1,-4
17,17199,Torroella de Montgrí,8265,259,132,127,206,109,97,32,49,71,45,32,30,14,23,48,21,14,10,18,26,23,24,18,20,32,36,64,37,22,12,12,20,36,20,13,5,20,16,28,17,9,7,199,105,94,215,127,88,26,38,60,36,24,18,10,27,29,23,13,6,16,11,31,13,11,12,38,51,64,39,16,6,20,30,40,24,10,3,18,21,24,15,6,3,262,133,129,254,132,122,39,53,95,32,29,12,15,29,47,21,12,8,24,24,48,11,17,4,48,76,67,39,19,2,25,35,39,23,10,0,23,41,28,16,9,2,286,157,129,243,136,107,65,59,88,34,22,14,43,22,41,28,13,8,22,37,47,6,9,6,50,58,65,42,21,6,25,30,42,23,13,2,25,28,23,19,8,4,443,258,185,376,213,163,41,106,122,91,61,18,28,65,79,45,27,12,13,41,43,46,34,6,56,87,114,72,33,11,34,46,68,42,15,6,22,41,46,30,18,5,261,135,126,284,155,129,13,74,69,39,29,31,-1,34,47,30,10,11,14,40,22,9,19,20,47,73,80,47,19,16,24,36,50,27,11,7,23,37,30,20,8,9,548,262,286,447,206,241,107,119,160,96,46,13,55,57,61,52,29,5,52,62,99,44,17,8,85,117,124,78,37,3,41,54,51,36,21,2,44,63,73,42,16,1,438,194,244,423,194,229,67,105,123,67,54,16,7,53,63,25,29,11,60,52,60,42,25,5,66,110,107,90,35,13,18,53,49,48,16,8,48,57,58,42,19,5,135,46,89,226,93,133,53,27,26,12,5,12,14,14,22,-5,-7,8,39,13,4,17,12,4,53,45,64,33,16,15,25,19,31,7,1,10,28,26,33,26,15,5,-123,-63,-60,-66,-35,-31,-19,36,-28,-55,-21,-40,-2,18,-10,-37,-15,-17,-17,18,-18,-18,-6,-23,7,39,-14,-35,-29,-38,7,12,-7,-15,-17,-16,0,27,-7,-20,-12,-22,-176,-90,-86,-162,-97,-65,-34,-1,-59,-63,-9,-15,-20,3,-20,-36,-6,-16,-14,-4,-39,-27,-3,1,-13,-1,-68,-52,-4,-25,-4,-2,-40,-33,0,-18,-9,1,-28,-19,-4,-7,71,29,42,-15,-22,7,26,27,-17,10,0,16,12,15,-14,-1,2,8,14,12,-3,11,-2,8,4,27,-47,-1,0,0,5,10,-28,-8,-1,1,-1,17,-19,7,1,-1,-33,-1,-32,-12,-32,20,-16,-2,-25,-10,4,13,0,-4,-9,-2,6,8,-16,2,-16,-8,-2,5,16,-1,-18,-6,-10,8,4,-8,-17,-10,-6,5,12,7,-1,4,-4,3,-90,-45,-45,-94,-51,-43,-34,-7,-38,4,-28,11,-28,1,-18,13,-20,5,-6,-8,-20,-9,-8,6,-17,0,-42,-30,-9,2,-8,0,-23,-17,-4,0,-9,0,-19,-13,-5,2,18,2,16,13,4,9,22,4,41,-10,-24,-14,24,4,14,-8,-21,-6,-2,0,27,-2,-3,-8,19,9,19,-6,-5,-23,18,1,9,-5,-11,-8,1,8,10,-1,6,-15,104,39,65,65,41,24,17,19,33,20,18,-6,2,9,5,10,17,-3,15,10,28,10,1,-3,14,32,18,12,2,-14,5,15,6,14,6,-6,9,17,12,-2,-4,-8,13,12,1,98,53,45,-25,30,5,-21,-9,37,-2,22,-1,-12,-3,13,-23,8,6,-9,-6,24,13,30,31,20,-2,4,14,15,10,8,5,1,-1,15,21,12,-7,3,34,10,24,86,38,48,-23,22,4,-11,16,28,-16,3,16,-8,7,11,-7,19,-12,-3,9,17,20,27,16,11,5,5,11,12,13,1,-1,1,9,15,3,10,6,4
17,17202,Tossa de Mar,4115,46,33,13,6,4,2,4,7,11,12,2,9,4,5,4,12,2,4,0,2,7,0,0,5,0,1,3,2,0,0,0,1,1,2,0,0,0,0,2,0,0,0,95,46,49,6,3,3,8,12,20,22,22,11,4,-1,17,13,10,3,4,13,3,9,12,8,1,1,1,0,3,0,0,0,1,0,2,0,1,1,0,0,1,0,15,11,4,-1,-1,0,7,-4,-2,10,1,4,7,1,-1,6,-2,1,0,-5,-1,4,3,3,1,0,-1,0,-2,1,1,-1,0,0,-1,0,0,1,-1,0,-1,1,126,66,60,6,2,4,12,13,40,22,19,20,9,7,24,11,11,5,3,6,16,11,8,15,3,1,1,-1,1,0,1,0,1,-1,1,0,2,1,0,0,0,0,224,129,95,163,88,75,9,51,77,35,28,24,7,27,47,22,9,15,2,24,30,13,19,9,16,45,46,29,21,6,9,23,29,16,9,2,7,22,17,13,12,4,205,111,94,191,104,87,28,55,35,35,35,13,16,42,8,15,16,8,12,13,27,20,19,5,34,59,38,27,25,7,19,40,15,11,13,5,15,19,23,16,12,2,212,106,106,186,95,91,18,45,49,48,25,22,6,22,26,31,9,11,12,23,23,17,16,11,22,49,49,37,18,9,10,22,28,21,8,5,12,27,21,16,10,4,174,103,71,179,92,87,25,38,45,30,23,10,15,19,32,18,14,5,10,19,13,12,9,5,32,42,43,33,22,4,20,21,20,17,11,2,12,21,23,16,11,2,151,81,70,147,74,73,16,41,23,34,16,15,14,19,4,23,15,4,2,22,19,11,1,11,20,42,42,19,18,5,11,18,21,12,10,1,9,24,21,7,8,4,11,8,3,72,34,38,-4,17,-12,-6,15,-3,4,6,-1,-4,6,-3,-8,11,-11,-2,9,0,13,29,13,7,4,4,11,12,5,1,1,2,2,17,8,6,3,2,10,-4,14,67,31,36,5,-3,4,5,-5,4,6,-8,4,-1,-6,0,-1,5,0,6,1,4,14,14,18,15,0,5,11,6,8,6,-3,2,3,8,10,9,3,3,54,27,27,63,33,30,14,19,7,-2,8,6,14,1,7,0,3,1,0,18,0,-2,5,5,17,20,8,9,6,2,10,8,7,3,3,1,7,12,1,6,3,1,-11,-23,12,49,21,28,-4,16,-12,-10,-5,3,-3,7,-11,-11,-3,-3,-1,9,-1,1,-2,6,8,17,12,7,4,0,6,6,4,4,1,-1,2,11,8,3,3,1,-9,-11,2,39,19,20,-6,13,-20,12,-4,-5,-1,4,-9,3,-2,-5,-5,9,-11,9,-2,0,9,10,5,5,6,2,6,5,2,1,2,2,3,5,3,4,4,0,-12,-14,2,25,7,18,0,-2,0,-11,-6,8,-5,-2,-2,-5,-6,7,5,0,2,-6,0,1,0,5,10,-2,7,5,-3,2,5,-3,4,2,3,3,5,1,3,3,-212,-110,-102,-151,-83,-68,-30,-9,-55,-74,-38,-6,-26,-2,-28,-41,-10,-3,-4,-7,-27,-33,-28,-3,-10,-2,-50,-46,-34,-9,-12,-3,-29,-29,-9,-1,2,1,-21,-17,-25,-8,-235,-129,-106,-267,-139,-128,-7,-2,-31,-80,-61,-58,-1,-4,-16,-48,-33,-30,-6,2,-15,-32,-28,-28,-12,-1,-36,-86,-66,-68,-2,-2,-13,-52,-36,-35,-10,1,-23,-34,-30,-33,16,12,4,32,17,15,22,6,13,-24,2,-1,20,0,7,-13,-3,3,2,6,6,-11,5,-4,20,11,14,-3,-2,-8,13,4,5,-1,-4,0,7,7,9,-2,2,-8
17,17204,Ullà,788,20,18,2,13,11,2,-3,5,18,2,1,-3,-4,4,12,4,2,0,1,1,6,-2,-1,-3,1,3,6,2,1,0,0,3,5,2,1,0,1,0,1,0,0,0,66,57,9,64,51,13,2,30,32,9,-2,-5,2,23,29,6,0,-3,0,7,3,3,-2,-2,5,23,27,7,1,1,3,19,23,5,1,0,2,4,4,2,0,1,55,55,0,18,12,6,6,19,10,15,1,2,6,21,16,9,2,0,0,-2,-6,6,-1,2,4,4,7,2,0,1,3,3,5,1,0,0,1,1,2,1,0,1,27,2,25,22,3,19,10,6,-1,7,5,0,-2,2,-5,5,3,-1,12,4,4,2,2,1,12,0,7,2,1,0,3,-1,1,0,0,0,9,1,6,2,1,0,-10,-3,-7,28,15,13,2,-4,4,-6,-6,0,2,-2,3,-3,-2,-1,0,-2,1,-3,-4,1,3,14,6,3,0,2,0,7,5,2,0,1,3,7,1,1,0,1,65,54,11,65,41,24,6,21,37,5,-1,-2,6,19,27,2,1,0,0,2,10,3,-2,-2,9,16,28,13,-1,0,6,11,18,7,-1,0,3,5,10,6,0,0,-5,11,-16,31,30,1,5,13,-13,-12,6,-4,6,8,-3,-4,4,-1,-1,5,-10,-8,2,-3,12,12,5,-1,4,-1,8,9,9,2,2,0,4,3,-4,-3,2,-1,33,19,14,65,46,19,3,24,-10,20,-5,5,2,16,-11,16,-2,1,1,8,1,4,-3,4,5,24,15,19,1,1,4,16,12,12,2,0,1,8,3,7,-1,1,8,1,7,15,9,6,7,-9,7,7,-1,-1,4,0,-5,4,-2,0,3,-9,12,3,1,-1,1,5,5,4,-1,1,1,3,1,5,-2,1,0,2,4,-1,1,0,-49,-37,-12,-22,-19,-3,3,-6,-26,-12,-5,-2,3,-7,-22,-6,-3,-1,0,1,-4,-6,-2,-1,7,0,-18,-8,-3,0,7,-4,-16,-5,-1,0,0,4,-2,-3,-2,0,42,18,24,37,18,19,25,-4,9,5,6,-2,12,3,6,-5,3,-2,13,-7,3,10,3,0,11,1,14,3,5,1,7,0,8,-1,3,0,4,1,6,4,2,1,-50,-34,-16,-4,-10,6,-9,-10,-19,-11,8,-2,-3,-3,-12,-13,2,-1,-6,-7,-7,2,6,-1,3,2,1,-8,-1,0,3,0,-1,-9,-3,0,0,2,2,1,2,0,14,10,4,22,15,7,2,9,5,-4,1,1,-1,7,8,-3,0,0,3,2,-3,-1,1,1,0,13,3,-1,6,-1,-1,8,5,-1,3,0,1,5,-2,0,3,-1,0,3,-3,-10,0,-10,8,-5,15,-5,-9,-3,3,-5,16,-6,-2,-2,5,0,-1,1,-7,-1,-3,-5,8,-6,-4,0,-1,-1,7,-5,-1,0,-2,-4,1,-1,-3,0,16,11,5,-3,-2,-1,5,0,5,5,3,-2,2,2,3,5,1,-2,3,-2,2,0,2,0,2,0,0,0,-3,-2,2,-1,0,1,-2,-1,0,1,0,-1,-1,-1,0,0,0,16,9,7,-4,0,-3,5,2,2,-3,1,4,-3,0,1,-1,-1,-7,8,2,1,-4,1,8,8,3,0,-4,-1,6,6,2,0,0,2,2,2,1,0,59,32,27,17,7,10,20,2,15,17,7,0,14,1,9,6,4,0,6,1,6,11,3,0,-1,3,6,5,3,0,-1,1,4,2,1,0,0,2,2,3,2,0,10,7,3,25,14,11,3,14,-9,2,1,-2,3,6,-4,-1,3,-1,0,8,-5,3,-2,-1,6,11,2,2,2,1,5,5,2,-1,1,1,1,6,0,3,1,0
17,17213,Vidreres,4489,274,153,121,101,48,53,56,47,71,54,22,15,37,22,36,28,15,10,19,25,35,26,7,5,22,23,28,16,8,3,11,11,12,7,5,2,11,12,16,9,3,1,236,128,108,89,50,39,46,24,77,56,24,7,21,15,45,34,11,0,25,9,32,22,13,7,8,22,28,25,6,0,2,13,17,15,3,0,6,9,11,10,3,0,258,140,118,78,51,27,26,49,83,45,46,6,17,25,48,25,22,1,9,24,35,20,24,5,8,24,22,14,9,1,5,17,15,9,5,0,3,7,7,5,4,1,207,130,77,53,35,18,34,34,43,31,31,29,22,23,30,24,20,10,12,11,13,7,11,19,4,20,14,7,6,2,2,13,10,6,3,1,2,7,4,1,3,1,408,210,198,127,79,48,82,46,141,67,39,25,36,23,86,34,19,8,46,23,55,33,20,17,17,32,45,14,12,6,8,24,31,6,6,3,9,8,14,8,6,3,431,237,194,125,71,54,62,78,169,73,21,17,41,40,90,38,15,4,21,38,79,35,6,13,15,42,35,18,11,2,8,24,20,10,6,1,7,18,15,8,5,1,361,182,179,95,47,48,77,39,78,96,44,21,42,17,32,50,24,12,35,22,46,46,20,9,11,23,23,19,14,5,6,11,12,6,7,5,5,12,11,13,7,0,293,162,131,148,90,58,62,70,72,57,14,14,39,42,45,24,3,6,23,28,27,33,11,8,21,50,39,22,9,5,13,34,24,10,4,3,8,16,15,12,5,2,136,87,49,88,53,35,18,22,48,32,3,14,24,19,27,11,7,2,-6,3,21,21,-4,12,10,24,29,14,4,4,10,14,18,3,5,2,0,10,11,11,-1,2,136,91,45,44,27,17,30,30,28,11,23,10,23,23,4,13,20,6,7,7,24,-2,3,4,14,22,5,3,2,-2,8,12,-2,6,2,1,6,10,7,-3,0,-3,53,42,11,25,5,20,19,2,23,0,9,2,5,6,15,12,1,3,14,-4,8,-12,8,-1,11,7,-1,4,0,3,5,3,-6,4,-2,1,6,4,5,0,2,2,26,42,-16,80,46,34,21,-4,6,17,-2,-13,14,-3,15,19,5,-10,7,-1,-9,-2,-7,-3,19,19,21,12,8,1,11,7,17,6,6,-1,8,12,4,6,2,2,47,32,15,25,13,12,-1,22,11,0,8,-2,1,5,8,10,4,-1,-2,17,3,-10,4,-1,1,10,6,7,-2,3,1,6,3,3,-2,2,0,4,3,4,0,1,38,37,1,9,12,-3,-10,-1,15,20,4,11,-6,-5,17,6,10,16,-4,4,-2,14,-6,-5,1,3,0,-1,5,1,1,3,3,1,2,2,0,0,-3,-2,3,-1,34,41,-7,8,-9,17,7,6,3,-8,8,13,12,6,-1,6,5,10,-5,0,4,-14,3,3,9,8,-5,-11,3,0,6,2,-13,-9,1,1,3,6,8,-2,2,-1,26,24,2,61,41,20,-8,2,16,-13,4,22,8,12,4,-14,1,10,-16,-10,12,1,3,12,4,9,16,15,9,7,3,9,8,10,6,4,1,0,8,5,3,3,47,19,28,15,1,14,1,8,26,14,4,-7,6,-3,5,11,2,-4,-5,11,21,3,2,-3,6,7,3,-7,2,3,1,4,0,-6,2,0,5,3,3,-1,0,3,121,70,51,97,55,42,47,0,30,13,18,9,15,11,14,9,16,5,32,-11,16,4,2,4,18,7,23,23,14,9,8,7,8,16,10,5,10,0,15,7,4,4
17,17223,Vilajuïga,924,26,19,7,11,5,6,-2,4,18,1,3,0,0,1,14,2,1,0,-2,3,4,-1,2,0,2,1,4,1,2,1,1,0,2,1,0,1,1,1,2,0,2,0,14,6,8,13,8,5,-7,2,10,7,1,1,-4,0,3,6,1,0,-3,2,7,1,0,1,1,0,6,6,0,0,0,0,3,5,0,0,1,0,3,1,0,0,13,10,3,12,7,5,1,5,0,7,3,-3,0,3,1,2,3,1,1,2,-1,5,0,-4,1,3,4,0,3,1,1,1,2,0,2,1,0,2,2,0,1,0,25,17,8,34,15,19,-4,4,7,10,9,-1,2,1,3,7,4,0,-6,3,4,3,5,-1,3,8,9,5,5,2,3,3,3,3,2,0,0,5,6,2,3,2,19,7,12,24,11,13,5,-1,-1,9,4,2,3,-5,2,2,2,2,2,4,-3,7,2,0,8,1,6,7,2,0,3,0,3,3,2,0,5,1,3,4,0,0,17,18,-1,12,8,4,-2,13,-3,2,6,1,-2,9,0,3,4,3,0,4,-3,-1,2,-2,0,5,0,4,1,2,0,3,0,3,0,2,0,2,0,1,1,0,41,35,6,10,8,2,6,6,27,3,3,-2,4,8,19,2,2,0,2,-2,8,1,1,-2,2,0,5,2,1,0,1,0,4,2,1,0,1,0,1,0,0,0,9,-1,10,9,-1,10,8,-4,-4,-3,3,9,6,1,-6,-4,-1,3,2,-5,2,1,4,6,1,3,-2,-1,3,3,1,1,-4,-2,0,2,0,2,2,1,3,1,11,2,9,9,6,3,-4,1,9,4,0,-1,-3,-2,2,7,-1,-2,-1,3,7,-3,1,1,0,2,3,3,1,0,0,0,3,3,0,0,0,2,0,0,1,0,15,3,12,12,7,5,-1,6,-1,-1,2,11,0,2,0,-3,0,5,-1,4,-1,2,2,6,0,0,4,1,1,6,0,0,3,1,0,3,0,0,1,0,1,3,-3,2,-5,-1,-1,0,-3,1,-1,-2,1,0,0,0,3,-3,1,1,-3,1,-4,1,0,-1,0,0,-1,-2,1,1,0,0,0,-1,0,0,0,0,-1,-1,1,1,6,0,6,4,-2,6,7,-1,5,-3,-3,2,4,-1,0,-2,-3,2,3,0,5,-1,0,0,2,0,3,-2,1,0,1,-1,0,-3,0,1,1,1,3,1,1,-1,47,25,22,7,1,6,10,-2,23,1,10,2,5,-4,11,1,8,2,5,2,12,0,2,0,1,-1,4,2,1,0,1,0,1,-2,1,0,0,-1,3,4,0,0,-4,-6,2,1,-3,4,-2,-2,-14,5,8,1,-2,3,-10,0,2,1,0,-5,-4,5,6,0,-2,-1,0,2,0,1,-2,-1,0,-1,0,0,0,0,0,3,0,1,-24,-7,-17,-7,-1,-6,-7,1,-6,-2,-3,-6,-9,0,5,3,-3,-3,2,1,-11,-5,0,-3,-1,0,3,-2,-3,-4,-1,0,2,1,-1,-2,0,0,1,-3,-2,-2,1,-3,4,6,3,3,-2,0,5,-6,5,-2,-6,-3,5,-4,4,0,4,3,0,-2,1,-2,1,0,-1,4,1,1,0,0,0,2,0,1,1,0,-1,2,1,0,-9,-3,-6,5,3,2,-12,10,-5,4,1,-5,-3,5,-2,2,0,-3,-9,5,-3,2,1,-2,0,1,2,3,-1,0,0,1,2,1,-1,0,0,0,0,2,0,0,-21,-11,-10,5,5,0,-8,3,-7,-3,-4,-1,-2,2,-5,-5,0,0,-6,1,-2,2,-4,-1,2,2,-1,1,2,-1,3,2,-2,1,1,0,-1,0,1,0,1,-1
17,17233,Vilobí d'Onyar,2182,26,15,11,9,6,3,8,9,2,-1,3,5,4,6,1,-2,2,4,4,3,1,1,1,1,1,2,4,1,1,0,1,2,1,1,1,0,0,0,3,0,0,0,74,52,22,29,19,10,18,8,21,18,7,2,12,7,14,12,3,3,6,1,7,6,4,-1,6,10,9,2,0,2,3,7,6,2,0,1,3,3,3,0,0,1,107,60,47,51,32,19,19,26,43,20,-1,-3,5,18,26,9,0,-1,14,8,17,11,-1,-2,6,21,18,8,0,-2,3,14,11,4,0,0,3,7,7,4,0,-2,78,56,22,49,30,19,14,18,24,13,3,5,10,15,12,11,5,2,4,3,12,2,-2,3,9,17,17,6,0,0,5,12,10,3,0,0,4,5,7,3,0,0,150,81,69,44,28,16,25,28,57,20,19,0,14,12,30,10,13,1,11,16,27,10,6,-1,6,17,13,6,1,1,4,11,9,3,1,0,2,6,4,3,0,1,30,11,19,49,30,19,-3,9,23,-9,1,7,-4,2,16,-9,0,6,1,7,7,0,1,1,5,15,20,5,3,0,2,7,14,5,2,0,3,8,6,0,1,0,56,14,42,38,18,20,14,13,-4,9,13,8,13,5,-11,0,4,1,1,8,7,9,9,7,3,16,7,6,4,1,0,7,5,3,2,1,3,9,2,3,2,0,101,75,26,67,50,17,10,44,39,4,2,-2,12,32,23,4,3,-1,-2,12,16,0,-1,-1,12,33,20,1,2,-1,8,25,16,1,0,0,4,8,4,0,2,-1,43,12,31,26,12,14,1,0,30,5,2,6,-4,-2,12,9,-2,1,5,2,18,-4,4,5,5,5,10,4,1,1,2,3,3,3,0,1,3,2,7,1,1,0,31,28,3,16,14,2,4,9,0,3,8,5,11,7,-1,-1,9,1,-7,2,1,4,-1,4,4,5,0,5,3,-1,4,4,0,4,3,-1,0,1,0,1,0,0,-23,-26,3,6,1,5,-4,-7,-14,9,-7,4,-6,-6,-6,-2,-6,2,2,-1,-8,11,-1,2,1,1,4,-1,2,-1,0,0,2,-1,0,0,1,1,2,0,2,-1,1,13,-12,-17,-6,-11,6,1,-3,8,-10,-2,10,3,3,6,-7,-1,-4,-2,-6,2,-3,-1,5,0,-6,-7,-6,-3,6,-2,-1,-4,-4,-1,-1,2,-5,-3,-2,-2,27,5,22,-4,-10,6,-1,13,25,-4,1,-3,-5,3,12,-3,-1,-1,4,10,13,-1,2,-2,-2,3,1,-4,-2,0,-4,1,-1,-4,-2,0,2,2,2,0,0,0,13,20,-7,9,8,1,-1,9,3,-1,1,6,3,8,4,4,-1,3,-4,1,-1,-5,2,3,1,1,4,3,-2,2,1,1,5,2,-3,2,0,0,-1,1,1,0,14,4,10,-7,-3,-4,0,3,8,2,-5,4,1,4,2,1,-6,0,-1,-1,6,1,1,4,-3,0,-4,-2,2,0,-1,0,-3,-1,2,0,-2,0,-1,-1,0,0,15,7,8,17,9,8,9,8,12,-2,-6,-5,4,5,0,3,-3,-2,5,3,12,-5,-3,-3,8,6,7,1,-3,-1,3,6,1,1,-2,0,5,0,6,0,-1,-1,-10,13,-23,22,11,11,-17,3,11,8,-7,-8,-4,0,14,12,-5,-4,-13,3,-3,-4,-2,-4,-3,6,11,4,3,1,0,2,6,2,2,-1,-3,4,5,2,1,2,30,3,27,6,7,-1,10,-1,9,12,1,-2,9,-3,-7,5,-2,-1,1,2,16,7,3,-1,2,4,2,-2,-1,1,3,6,2,-2,-2,0,-1,-2,0,0,1,1
18,18013,Alhama de Granada,5934,16,26,-10,30,25,5,0,9,4,7,2,-8,1,11,6,12,-1,-4,-1,-2,-2,-5,3,-4,1,10,9,8,1,0,1,7,8,8,1,0,0,3,1,0,0,0,74,58,16,114,78,36,-1,37,35,7,-3,-1,-6,26,27,6,3,1,5,11,8,1,-6,-2,13,34,49,15,2,0,5,25,35,10,2,0,8,9,14,5,0,0,65,62,3,113,92,21,-2,32,22,-2,9,2,-1,38,23,-3,4,0,-1,-6,-1,1,5,2,4,48,39,17,5,0,3,41,35,12,1,0,1,7,4,5,4,0,46,30,16,39,28,11,9,18,-13,22,5,4,6,12,-11,18,0,5,3,6,-2,4,5,-1,4,11,11,8,2,2,3,10,7,6,1,0,1,1,4,2,1,2,132,154,-22,144,112,32,-12,53,86,10,3,-9,-2,50,91,13,4,-2,-10,3,-5,-3,-1,-7,8,43,72,17,2,0,4,35,60,12,1,0,4,8,12,5,1,0,-24,3,-27,97,68,29,-29,18,16,-22,1,-6,-17,17,13,-8,1,-2,-12,1,3,-14,0,-4,9,37,38,11,2,0,3,30,25,9,1,0,6,7,13,2,1,0,10,2,8,115,55,60,0,20,11,-6,1,-15,-1,2,11,-6,1,-5,1,18,0,0,0,-10,19,44,34,16,1,0,6,19,25,4,0,0,13,25,9,12,1,0,40,-1,41,101,48,53,40,1,-8,11,2,-7,22,-6,-19,5,2,-6,18,7,11,6,0,-1,30,17,26,20,6,2,19,3,12,10,3,1,11,14,14,10,3,1,34,48,-14,58,40,18,3,18,39,-13,0,-10,1,19,40,-8,0,-3,2,-1,-1,-5,0,-7,6,15,33,3,0,1,2,8,28,2,0,0,4,7,5,1,0,1,42,39,3,55,34,21,12,29,14,-2,11,-18,7,16,20,-1,6,-5,5,13,-6,-1,5,-13,10,15,19,7,4,-1,8,8,15,1,2,0,2,7,4,6,2,-1,155,135,20,79,53,26,7,33,53,36,22,6,2,27,54,35,11,8,5,6,-1,1,11,-2,7,16,30,12,13,1,4,10,23,8,7,1,3,6,7,4,6,0,88,70,18,65,40,25,17,25,38,12,2,-8,4,18,31,11,5,-1,13,7,7,1,-3,-7,6,12,27,15,5,0,2,7,20,8,3,0,4,5,7,7,2,0,15,19,-4,51,30,21,4,-9,15,8,1,-2,-2,-9,11,14,2,3,6,0,4,-6,-1,-5,13,6,18,11,0,1,6,3,10,10,-1,1,7,3,8,1,1,0,54,61,-7,55,41,14,13,4,32,19,-1,-10,7,11,31,15,5,-5,6,-7,1,4,-6,-5,16,8,25,6,0,-1,9,5,23,3,2,-1,7,3,2,3,-2,0,-8,34,-42,75,55,20,-18,11,-8,-3,0,10,3,10,11,0,2,8,-21,1,-19,-3,-2,2,14,19,21,15,4,1,10,14,17,11,2,1,4,5,4,4,2,0,-36,-10,-26,44,40,4,-3,-1,2,-16,-2,-15,-6,-3,10,-16,7,-2,3,2,-8,0,-9,-13,9,9,16,9,1,-1,3,7,18,8,4,-1,6,2,-2,1,-3,0,1,-1,2,46,30,16,14,3,2,-9,-13,4,2,4,9,-12,-8,3,12,-1,-7,3,-5,1,5,13,16,9,0,3,1,9,13,4,1,2,4,4,3,5,-1,1,29,44,-15,143,103,40,-12,52,-2,-3,4,-7,-1,52,5,-10,1,-1,-11,0,-7,7,3,-6,19,58,41,16,6,2,13,53,30,4,1,1,6,5,11,12,5,1
18,18017,Almuñécar,21170,262,128,134,232,127,105,14,9,36,56,89,51,6,5,19,20,44,31,8,4,17,36,45,20,27,35,40,34,54,37,12,15,25,19,30,23,15,20,15,15,24,14,339,175,164,287,152,135,49,51,65,43,84,44,21,20,28,29,41,33,28,31,37,14,43,11,49,37,36,45,73,46,23,19,12,26,41,30,26,18,24,19,32,16,1028,542,486,671,352,319,157,108,175,219,250,107,82,57,99,111,130,57,75,51,76,108,120,50,86,89,106,116,173,99,41,51,62,57,84,56,45,38,44,59,89,43,555,265,290,589,277,312,73,36,74,105,186,80,32,18,33,49,86,49,41,18,41,56,100,31,92,49,89,107,153,95,47,20,38,50,74,48,45,29,51,57,79,47,710,341,369,645,313,332,109,102,192,108,139,49,40,33,114,61,60,30,69,69,78,47,79,19,105,91,162,115,117,47,45,37,83,65,50,30,60,54,79,50,67,17,1194,619,575,999,494,505,165,147,188,228,286,179,93,79,94,116,138,97,72,68,94,112,148,82,149,141,156,178,226,146,76,60,82,83,115,78,73,81,74,95,111,68,814,424,390,715,378,337,123,122,133,145,182,104,63,54,72,82,90,62,60,68,61,63,92,42,110,106,129,124,151,88,64,50,66,70,73,52,46,56,63,54,78,36,705,384,321,614,346,268,129,127,95,142,125,84,70,76,44,85,66,40,59,51,51,57,59,44,107,111,104,120,108,59,59,71,60,66,55,32,48,40,44,54,53,27,211,148,63,374,202,172,1,18,43,39,74,42,0,22,34,33,42,18,1,-4,9,6,32,24,45,54,88,80,67,37,27,32,47,45,34,15,18,22,41,35,33,22,100,69,31,264,124,140,-7,-12,-26,32,88,30,6,3,-9,2,47,25,-13,-15,-17,30,41,5,33,31,49,43,68,37,14,11,29,18,32,20,19,20,20,25,36,17,125,68,57,222,115,107,37,2,62,-8,50,-14,22,9,21,-2,29,-7,15,-7,41,-6,21,-7,25,21,51,48,54,18,16,11,26,24,26,10,9,10,25,24,28,8,140,76,64,207,104,103,16,8,1,14,70,22,14,0,-4,7,34,16,2,8,5,7,36,6,26,24,46,19,65,24,16,8,26,6,30,15,10,16,20,13,35,9,9,7,2,177,89,88,-12,-12,-21,29,28,-8,-6,-3,-18,10,21,2,-6,-9,-3,19,7,-10,29,19,32,35,41,20,14,11,8,16,25,15,15,8,24,19,16,5,73,65,8,165,87,78,-15,-10,-30,19,76,31,-4,0,5,11,42,11,-11,-10,-35,8,34,20,18,1,17,22,55,51,9,-1,14,10,29,27,9,2,3,12,26,24,163,83,80,243,121,122,2,7,-31,56,83,53,2,3,-13,16,46,33,0,4,-18,40,37,20,34,25,13,43,74,47,21,14,5,21,37,20,13,11,8,22,37,27,-301,-152,-149,-160,-92,-68,-64,-34,-94,-80,3,-34,-46,-28,-38,-36,-2,-6,-18,-6,-56,-44,5,-28,-7,-3,-64,-74,-1,-14,-6,-9,-29,-42,-8,1,-1,6,-35,-32,7,-15,134,61,73,327,158,169,11,-9,-44,51,80,47,2,-5,-39,21,45,35,9,-4,-5,30,35,12,54,30,30,62,88,60,25,12,6,29,46,37,29,18,24,33,42,23,259,116,143,343,169,174,39,11,10,49,104,43,34,-4,-4,13,48,29,5,15,14,36,56,14,46,31,39,67,97,62,30,16,19,25,49,30,16,15,20,42,48,32
18,18021,Armilla,13706,535,245,290,32,15,17,73,132,172,99,36,22,31,60,73,57,15,10,42,72,99,42,21,12,8,5,11,6,1,0,4,2,6,2,1,0,4,3,5,4,0,0,695,365,330,22,13,9,85,113,234,105,65,83,45,62,133,53,34,32,40,51,101,52,31,51,2,7,7,4,1,1,1,5,4,2,1,0,1,2,3,2,0,1,745,369,376,48,24,24,93,109,289,110,67,55,37,49,145,57,36,29,56,60,144,53,31,26,11,5,13,17,3,-1,5,2,4,11,2,0,6,3,9,6,1,-1,350,217,133,16,9,7,55,84,114,59,11,22,31,44,90,35,1,14,24,40,24,24,10,8,4,4,3,3,0,2,2,3,0,2,0,2,2,1,3,1,0,0,794,511,283,180,111,69,175,150,247,129,59,27,113,91,171,81,35,15,62,59,76,48,24,12,26,44,72,23,10,2,17,23,47,16,7,0,9,21,25,7,3,2,736,515,221,205,144,61,92,122,237,125,72,79,70,80,183,98,44,33,22,42,54,27,28,46,37,49,62,33,13,8,30,31,46,22,9,3,7,18,16,11,4,5,443,316,127,264,156,108,39,119,126,99,30,25,45,69,103,64,14,14,-6,50,23,35,16,11,41,65,76,57,18,4,23,41,48,30,10,2,18,24,28,27,8,2,636,448,188,304,195,109,86,163,137,147,37,50,53,111,125,98,29,26,33,52,12,49,8,24,51,100,78,41,21,8,27,64,51,31,11,8,24,36,27,10,10,0,379,220,159,228,139,89,31,61,160,70,33,20,37,27,90,38,18,5,-6,34,70,32,15,15,31,72,70,32,14,3,21,41,42,21,6,2,10,31,28,11,8,1,491,225,266,94,25,69,70,105,155,64,65,31,34,62,75,20,27,8,36,43,80,44,38,23,23,18,43,10,-3,3,12,3,16,0,-6,0,11,15,27,10,3,3,381,160,221,105,41,64,86,70,139,74,-1,-5,35,20,61,28,4,-1,51,50,78,46,-5,-4,13,34,30,14,9,0,6,11,11,6,5,-1,7,23,19,8,4,1,298,126,172,38,-8,46,35,63,113,19,24,43,10,37,53,5,3,23,25,26,60,14,21,20,16,22,5,-9,2,-2,3,11,-14,-9,0,0,13,11,19,0,2,-2,186,102,84,30,4,26,36,20,102,26,-3,7,31,24,43,-10,5,5,5,-4,59,36,-8,2,19,5,17,-3,-9,-1,12,2,1,-5,-7,0,7,3,16,2,-2,-1,155,96,59,22,0,22,37,62,-1,-3,47,25,37,20,3,0,28,15,0,42,-4,-3,19,10,12,13,9,-12,-7,3,8,4,-4,-7,-4,1,4,9,13,-5,-3,2,525,309,216,94,61,33,91,93,189,139,9,19,62,54,120,66,3,8,29,39,69,73,6,11,24,30,23,10,3,3,14,19,12,15,0,1,10,11,11,-5,3,2,159,117,42,-130,-89,-41,-2,62,126,-8,-16,-2,10,8,94,14,-5,-1,-12,54,32,-22,-11,-1,-3,4,-31,-73,-22,-6,-3,-9,-15,-50,-8,-5,0,13,-16,-23,-14,-1,131,41,90,68,18,50,13,19,31,19,42,13,-14,10,30,2,14,11,27,9,1,17,28,2,18,23,11,-8,14,4,12,8,-4,-10,9,2,6,15,15,2,5,2,-210,-172,-38,-96,-104,8,-2,10,-85,-116,-33,32,-20,-2,-62,-65,-29,19,18,12,-23,-51,-4,13,5,9,-60,-36,-20,0,1,-1,-56,-37,-13,0,4,10,-4,1,-7,0
18,18022,Atarfe,11220,204,104,100,14,6,8,66,12,56,36,18,6,30,7,29,22,8,3,36,5,27,14,10,3,1,3,5,1,1,3,0,3,2,0,0,1,1,0,3,1,1,2,257,147,110,15,9,6,60,50,69,65,10,1,24,34,41,38,8,0,36,16,28,27,2,1,2,4,5,2,0,2,2,2,3,1,0,1,0,2,2,1,0,1,174,70,104,31,15,16,43,39,41,40,10,-5,15,14,17,21,2,0,28,25,24,19,8,-5,7,4,9,9,1,1,3,3,3,5,1,0,4,1,6,4,0,1,296,168,128,49,24,25,72,56,76,70,11,7,37,39,43,35,6,5,35,17,33,35,5,2,15,9,10,9,6,0,9,6,5,1,3,0,6,3,5,8,3,0,450,260,190,74,41,33,81,90,129,84,40,20,40,50,83,53,25,3,41,40,46,31,15,17,13,23,16,9,11,1,6,10,9,8,6,1,7,13,7,1,5,0,493,266,227,104,49,55,101,102,180,74,20,10,62,57,86,36,8,12,39,45,94,38,12,-2,25,27,27,18,5,2,14,14,11,8,1,1,11,13,16,10,4,1,616,319,297,87,41,46,110,129,221,97,45,6,53,49,133,52,23,5,57,80,88,45,22,1,19,23,23,14,3,4,6,8,15,8,2,1,13,15,8,6,1,3,620,362,258,126,69,57,93,102,226,98,51,36,55,46,145,65,25,15,38,56,81,33,26,21,16,28,44,16,18,4,7,13,27,12,9,1,9,15,17,4,9,3,319,191,128,80,39,41,14,66,150,40,26,22,16,31,95,27,18,6,-2,35,55,13,8,16,15,18,19,13,13,1,10,6,10,7,5,0,5,12,9,6,8,1,410,191,219,59,25,34,62,92,185,29,26,7,33,40,92,12,15,-3,29,52,93,17,11,10,11,12,27,2,7,0,3,4,16,-1,3,0,8,8,11,3,4,0,395,194,201,50,23,27,63,67,162,59,17,15,24,37,83,27,9,4,39,30,79,32,8,11,12,10,13,2,4,7,6,6,6,-2,2,3,6,4,7,4,2,4,319,141,178,51,24,27,26,67,128,40,41,9,9,19,65,19,21,4,17,48,63,21,20,5,9,13,17,6,4,1,6,5,6,4,2,0,3,8,11,2,2,1,229,130,99,24,10,14,22,33,112,24,21,10,8,27,61,8,18,8,14,6,51,16,3,2,12,6,6,-1,-1,1,3,4,4,-2,0,1,9,2,2,1,-1,0,246,133,113,-7,-6,-1,56,42,85,39,2,5,36,12,41,21,8,6,20,30,44,18,-6,-1,5,9,-5,-11,-5,-1,3,3,-3,-9,-2,0,2,6,-2,-2,-3,-1,143,67,76,26,9,17,-12,23,62,24,28,7,-11,9,26,22,13,0,-1,14,36,2,15,7,0,8,13,2,2,0,1,3,3,1,0,1,-1,5,10,1,2,-1,171,93,78,14,10,4,17,37,83,5,19,11,13,8,59,-1,7,6,4,29,24,6,12,5,-2,6,7,-3,2,3,-2,3,7,-1,1,2,0,3,0,-2,1,1,153,94,59,50,28,22,39,31,20,26,18,17,28,11,32,9,4,8,11,20,-12,17,14,9,20,6,12,11,-2,1,13,5,6,5,-2,-1,7,1,6,6,0,2,91,37,54,37,20,17,-27,16,60,7,26,13,-17,7,28,-4,18,6,-10,9,32,11,8,7,10,7,23,1,-4,-2,6,1,12,2,-2,0,4,6,11,-1,-2,-2
18,18023,Baza,21336,45,55,-10,103,55,48,15,13,2,18,12,-17,9,12,20,8,10,-4,6,1,-18,10,2,-13,23,23,37,17,3,0,11,14,20,8,2,0,12,9,17,9,1,0,165,113,52,184,106,78,17,25,76,37,9,3,11,14,47,31,7,3,6,11,29,6,2,0,32,43,68,33,8,0,16,21,40,25,4,0,16,22,28,8,4,0,284,153,131,227,119,108,53,45,79,43,19,47,24,27,52,29,6,18,29,18,27,14,13,29,40,67,70,37,8,5,19,39,35,22,2,2,21,28,35,15,6,3,197,105,92,196,105,91,70,26,33,55,12,-5,17,16,15,35,9,5,53,10,18,20,3,-10,41,56,47,40,9,2,15,34,25,25,4,1,26,22,22,15,5,1,384,216,168,253,149,104,54,92,107,64,49,24,26,67,67,39,25,-4,28,25,40,25,24,28,45,82,70,38,12,3,22,52,45,23,6,1,23,30,25,15,6,2,410,244,166,344,216,128,94,65,103,81,53,12,47,45,67,55,26,4,47,20,36,26,27,8,56,98,87,68,33,2,37,58,61,42,17,1,19,40,26,26,16,1,336,224,112,269,165,104,79,42,92,73,34,8,50,21,69,56,14,4,29,21,23,17,20,4,46,61,95,41,17,6,28,35,59,30,9,2,18,26,36,11,8,4,377,211,166,377,212,165,89,72,64,84,26,28,47,46,56,40,11,8,42,26,8,44,15,20,65,101,121,65,19,2,27,54,84,37,9,0,38,47,37,28,10,2,227,129,98,210,115,95,29,45,44,40,18,40,5,35,26,25,15,16,24,10,18,15,3,24,29,69,64,31,8,4,12,38,35,20,6,2,17,31,29,11,2,2,120,108,12,120,64,56,26,5,26,37,26,-2,31,13,12,38,17,-2,-5,-8,14,-1,9,0,23,34,30,19,10,2,18,13,18,10,4,0,5,21,12,9,6,2,148,109,39,51,21,30,21,30,84,16,1,-9,20,22,47,12,3,-1,1,8,37,4,-2,-8,11,12,28,-2,0,1,3,4,18,-4,0,0,8,8,10,2,0,1,12,-15,27,60,20,40,32,18,-62,10,-2,15,11,10,-42,-6,-1,10,21,8,-20,16,-1,5,4,22,9,9,12,3,1,9,0,2,5,2,3,13,9,7,7,1,-32,-32,0,34,9,25,1,-15,-10,-6,-11,9,-7,-11,-7,-9,-8,9,8,-4,-3,3,-3,0,4,14,6,6,1,2,1,2,2,3,-1,1,3,12,4,3,2,1,-83,-17,-66,25,11,14,-14,-8,-39,-18,15,-18,-2,-5,-17,-2,8,3,-12,-3,-22,-16,7,-21,2,15,1,1,4,2,0,8,3,-4,1,2,2,7,-2,5,3,0,61,38,23,31,21,10,69,-12,-13,19,-3,3,29,5,1,4,-5,3,40,-17,-14,15,2,0,14,15,-6,8,-2,2,8,8,-1,6,-1,1,6,7,-5,2,-1,1,63,24,39,-42,-41,-1,38,24,20,-14,0,-9,20,14,-2,-2,0,-8,18,10,22,-12,0,-1,2,5,-10,-24,-13,-3,-2,0,-10,-16,-12,-2,4,5,0,-8,-1,-1,16,-16,32,60,25,35,49,13,-44,10,6,-10,33,4,-33,-13,5,-9,16,9,-11,23,1,-1,35,26,-5,9,-4,-2,19,10,-4,2,-3,0,16,16,-1,7,-1,-2,-50,-19,-31,52,21,31,16,-27,-53,-19,-13,49,9,-14,-27,-11,-4,27,7,-13,-26,-8,-9,22,13,22,2,6,6,3,6,12,-4,2,3,2,7,10,6,4,3,1
18,18047,Cenes de la Vega,5043,254,130,124,14,7,7,-4,70,111,37,20,18,-10,34,64,22,12,10,6,36,47,15,8,8,1,2,7,2,1,0,0,1,4,1,1,0,1,1,3,1,0,0,129,68,61,39,22,17,10,40,47,17,5,10,4,27,28,6,-1,4,6,13,19,11,6,6,14,5,9,7,4,0,8,3,4,5,2,0,6,2,5,2,2,0,172,111,61,46,22,24,-50,71,117,1,20,16,-16,36,76,0,12,4,-34,35,41,1,8,12,8,13,14,2,5,4,5,4,8,1,2,2,3,9,6,1,3,2,143,81,62,44,19,25,-43,66,84,1,15,11,-26,30,59,4,5,3,-17,36,25,-3,10,8,9,10,15,7,1,0,5,5,6,2,0,0,4,5,9,5,1,0,203,117,86,77,46,31,-34,87,127,7,14,0,-19,33,90,5,9,1,-15,54,37,2,5,-1,7,17,29,16,5,0,5,8,17,11,3,0,2,9,12,5,2,0,-19,-23,4,47,20,27,-49,39,6,-18,1,7,-31,22,6,-15,0,2,-18,17,0,-3,1,5,5,15,12,8,6,1,2,7,5,3,3,0,3,8,7,5,3,1,-42,-19,-23,46,21,25,-72,36,17,-29,4,3,-50,27,24,-17,-3,2,-22,9,-7,-12,7,1,8,13,13,7,3,2,3,5,7,4,1,1,5,8,6,3,2,1,38,-1,39,49,26,23,-21,27,55,-22,-13,7,-20,16,18,-14,-7,4,-1,11,37,-8,-6,3,6,16,21,2,1,2,4,11,8,1,1,1,2,5,13,1,0,1,50,24,26,54,27,27,2,43,-16,14,2,9,5,18,-3,3,-3,6,-3,25,-13,11,5,3,7,23,13,9,0,1,3,11,8,5,-1,1,4,12,5,4,1,0,101,40,61,26,9,17,-5,25,60,0,4,8,-5,10,27,0,-2,5,0,15,33,0,6,3,1,14,8,0,2,1,-1,4,4,0,2,0,2,10,4,0,0,1,69,16,53,31,9,22,-11,10,40,3,20,6,-6,10,3,-1,8,-1,-5,0,37,4,12,7,5,8,9,3,6,-2,1,3,1,1,3,0,4,5,8,2,3,-2,27,-11,38,26,3,23,4,9,-1,6,-4,6,-4,0,-4,0,-6,1,8,9,3,6,2,5,0,8,15,1,0,1,0,1,1,0,0,1,0,7,14,1,0,0,2,-6,8,2,2,0,-6,6,-8,-7,8,5,0,-1,2,-12,1,2,-6,7,-10,5,7,3,-3,3,1,1,0,-1,-2,2,3,-1,0,0,-1,1,-2,2,0,-1,-39,-39,0,-5,-6,1,9,-12,-40,4,2,-7,9,-6,-35,-10,4,-3,0,-6,-5,14,-2,-4,1,2,-9,2,-2,0,1,1,-6,-3,0,0,0,1,-3,5,-2,0,-59,-19,-40,-66,-28,-38,12,7,-33,-34,-14,-10,9,5,-7,-26,-9,0,3,2,-26,-8,-5,-10,-2,-1,-24,-26,-6,-9,3,0,-12,-16,-2,-2,-5,-1,-12,-10,-4,-7,-54,-29,-25,-17,-12,-5,-25,10,-4,-29,-4,-4,-14,3,-10,-11,4,-5,-11,7,6,-18,-8,1,-3,1,-6,-2,-5,-2,-3,1,-5,-2,-1,-2,0,0,-1,0,-4,0,-85,-53,-32,-58,-26,-32,-33,-9,0,-42,-3,-12,-17,-4,-1,-25,-2,-12,-16,-5,1,-17,-1,0,-10,7,-18,-26,-3,-9,-5,2,-1,-12,-5,-6,-5,5,-17,-14,2,-3,43,6,37,42,19,23,8,21,16,8,-10,4,-7,7,20,-7,-4,-4,15,14,-4,15,-6,8,11,9,21,-2,3,0,5,2,14,-4,2,0,6,7,7,2,1,0
18,18059,Chauchina,4138,55,17,38,15,9,6,6,10,30,0,5,4,2,5,15,-6,1,2,4,5,15,6,4,2,3,1,5,4,1,1,2,0,3,3,0,1,1,1,2,1,1,0,68,41,27,8,4,4,2,26,24,14,0,0,1,15,12,9,0,2,1,11,12,5,0,-2,0,0,3,1,1,3,0,0,3,0,0,1,0,0,0,1,1,2,64,36,28,6,6,0,11,15,15,12,8,-4,5,9,9,8,2,0,6,6,6,4,6,-4,2,0,6,-1,-1,0,2,1,3,0,0,0,0,-1,3,-1,-1,0,93,55,38,16,8,8,37,-2,28,8,22,-3,28,5,7,3,10,0,9,-7,21,5,12,-3,6,1,6,2,1,0,3,0,4,0,1,0,3,1,2,2,0,0,43,27,16,5,2,3,5,8,15,15,0,-1,2,3,12,11,0,-1,3,5,3,4,0,0,0,5,0,0,0,0,0,2,0,0,0,0,0,3,0,0,0,0,86,39,47,10,6,4,27,9,30,4,13,1,16,2,9,2,8,0,11,7,21,2,5,1,2,2,1,1,4,0,1,1,0,1,3,0,1,1,1,0,1,0,53,31,22,9,7,2,18,8,27,3,-2,-3,14,2,12,4,0,-1,4,6,15,-1,-2,-2,1,3,4,0,1,0,1,3,2,0,1,0,0,0,2,0,0,0,144,68,76,21,11,10,13,33,33,46,15,-1,6,14,18,24,6,0,7,19,15,22,9,-1,2,6,5,6,-1,2,1,5,1,4,-1,1,1,1,4,2,0,1,28,15,13,25,15,10,6,7,15,-2,5,-4,11,0,6,-4,1,-1,-5,7,9,2,4,-3,2,4,12,4,3,0,2,4,6,1,2,0,0,0,6,3,1,0,-13,-15,2,-5,-5,0,-15,13,-11,-2,1,-3,-17,6,-12,4,4,-3,2,7,1,-6,-3,0,0,-5,-1,-2,1,2,0,-3,-1,-2,1,0,0,-2,0,0,0,2,-5,3,-8,3,-1,4,2,-2,5,-1,-6,-4,-8,-1,10,5,-4,-2,10,-1,-5,-6,-2,-2,-1,2,3,-2,2,-1,-2,0,2,0,0,-1,1,2,1,-2,2,0,38,11,27,1,1,0,13,2,18,8,0,-7,15,-6,6,-3,1,-3,-2,8,12,11,-1,-4,1,0,-1,1,-2,1,0,-1,1,0,-1,1,1,1,-2,1,-1,0,51,31,20,17,6,11,19,3,11,5,10,2,7,6,2,5,5,4,12,-3,9,0,5,-2,-1,4,2,6,5,1,-1,0,2,2,3,0,0,4,0,4,2,1,14,9,5,-10,-8,-2,-7,2,20,-7,6,1,-4,4,11,-4,2,1,-3,-2,9,-3,4,0,-1,-2,-3,-2,-1,-1,-2,-2,-3,-1,0,0,1,0,0,-1,-1,-1,-68,-48,-20,-20,-9,-11,1,-16,-11,-23,-10,-5,-5,-13,-3,-21,-1,-2,6,-3,-8,-2,-9,-3,-1,0,-5,-10,-4,0,-1,0,0,-8,0,0,0,0,-5,-2,-4,0,-24,-17,-7,-13,-7,-6,5,-7,0,-6,-3,-15,0,-7,2,-6,-3,-5,5,0,-2,0,0,-10,-1,1,-3,-3,-3,-4,0,1,-1,-3,-2,-2,-1,0,-2,0,-1,-2,19,-4,23,-10,-5,-5,15,4,13,-1,-4,-7,6,-4,4,0,-2,-5,9,8,9,-1,-2,-2,2,-1,-2,-6,-3,0,1,0,-2,-2,-2,0,1,-1,0,-4,-1,0,40,12,28,46,23,23,-5,3,12,12,13,3,-9,-2,6,5,9,3,4,5,6,7,4,0,4,1,12,19,8,2,0,-1,8,12,4,0,4,2,4,7,4,2
18,18912,Cuevas del Campo,2232,50,41,9,58,44,14,7,10,11,16,6,0,4,8,11,15,1,2,3,2,0,1,5,-2,2,20,18,15,2,0,2,15,15,11,0,0,0,5,3,4,2,0,-45,-23,-22,42,35,7,-9,-20,-12,-6,3,-1,-8,-8,-3,-5,2,-1,-1,-12,-9,-1,1,0,0,12,20,8,2,0,0,10,16,7,2,0,0,2,4,1,0,0,-30,-12,-18,10,7,3,2,-9,-13,-12,4,-1,3,-4,-5,-6,2,-2,-1,-5,-8,-6,2,1,1,2,5,1,0,1,1,1,5,0,0,0,0,1,0,1,0,1,-37,-14,-23,12,7,5,-5,-18,-8,-2,-3,-1,-1,-6,-1,-5,-1,0,-4,-12,-7,3,-2,-1,0,3,5,2,2,0,0,2,3,1,1,0,0,1,2,1,1,0,35,31,4,48,28,20,5,15,26,2,2,-15,5,11,17,2,1,-5,0,4,9,0,1,-10,8,19,16,5,0,0,5,12,8,3,0,0,3,7,8,2,0,0,6,13,-7,40,29,11,8,-2,-3,3,4,-4,3,3,2,4,3,-2,5,-5,-5,-1,1,-2,1,13,16,6,4,0,1,7,12,5,4,0,0,6,4,1,0,0,20,15,5,56,32,24,5,4,-10,6,12,3,7,6,-7,0,8,1,-2,-2,-3,6,4,2,11,11,14,12,7,1,8,7,7,5,5,0,3,4,7,7,2,1,62,57,5,109,73,36,4,28,8,18,7,-8,5,21,14,14,5,-5,-1,7,-6,4,2,-3,10,35,31,27,3,1,5,26,21,18,2,1,5,9,10,9,1,0,-31,-9,-22,19,12,7,-8,-8,-10,1,2,-8,-7,-3,-3,3,1,0,-1,-5,-7,-2,1,-8,2,8,6,1,2,0,1,5,3,1,2,0,1,3,3,0,0,0,22,0,22,7,-2,9,10,12,-11,3,6,1,2,3,-7,0,3,-1,8,9,-4,3,3,2,2,4,-4,0,1,4,0,0,-4,0,1,1,2,4,0,0,0,3,-48,-18,-30,4,2,2,-13,-14,-11,-7,0,-4,-6,-3,-4,-4,1,-3,-7,-11,-7,-3,-1,-1,0,0,1,1,1,1,0,-1,2,0,1,0,0,1,-1,1,0,1,-27,-10,-17,9,4,5,3,-7,-22,-4,8,-4,-1,-2,-11,-2,6,1,4,-5,-11,-2,2,-5,4,2,0,-1,4,0,1,2,-1,-1,2,1,3,0,1,0,2,-1,-4,-3,-1,12,1,11,8,3,-4,-5,-2,-4,2,0,-1,-4,0,0,6,3,-3,-1,-2,-4,8,4,-4,-2,3,3,2,1,-3,-1,1,1,6,3,-1,-1,2,2,-2,2,-4,15,9,6,-1,4,-13,14,2,-8,-1,-1,-5,11,4,-5,0,5,-8,3,-2,-3,5,6,0,3,1,0,1,2,2,2,1,1,4,4,-2,1,0,-1,-25,-11,-14,10,4,6,-6,-10,-5,-2,6,-9,-4,-3,-2,-1,2,-4,-2,-7,-3,-1,4,-5,0,0,2,3,3,2,0,0,1,1,1,1,0,0,1,2,2,1,13,14,-1,7,4,3,-2,3,-8,17,2,-2,3,3,2,3,3,-1,-5,0,-10,14,-1,-1,-1,2,1,3,1,0,0,1,1,1,1,0,-1,1,0,2,0,0,-24,-11,-13,19,8,11,-11,-2,-5,-11,1,2,-6,0,-4,-4,0,2,-5,-2,-1,-7,1,0,2,6,3,1,2,4,1,2,1,0,0,3,1,4,2,1,2,1,-1,-3,2,16,6,10,6,9,-12,4,-5,-2,6,4,-7,-3,0,-2,0,5,-5,7,-5,0,0,9,3,3,1,0,0,2,2,1,1,0,0,7,1,2,0,0
18,18905,"Gabias, Las",8338,259,157,102,13,9,4,43,47,144,2,16,1,21,29,87,7,11,-2,22,18,57,-5,5,3,0,3,7,2,1,0,0,1,6,2,0,0,0,2,1,0,1,0,405,224,181,39,21,18,55,102,156,45,43,0,28,57,87,24,29,-3,27,45,69,21,14,3,11,11,7,7,2,0,6,5,5,3,2,0,5,6,2,4,0,0,264,149,115,20,15,5,21,80,90,40,23,5,17,42,51,15,12,7,4,38,39,25,11,-2,1,8,6,0,5,0,1,5,5,0,4,0,0,3,1,0,1,0,480,269,211,37,15,22,56,91,230,64,24,10,30,38,131,40,16,9,26,53,99,24,8,1,6,13,9,7,3,-1,0,3,7,4,1,0,6,10,2,3,2,-1,767,417,350,116,67,49,109,158,352,80,43,20,63,73,195,49,20,12,46,85,157,31,23,8,10,39,47,11,4,2,5,21,25,10,2,1,5,18,22,1,2,1,709,390,319,140,78,62,60,182,303,91,50,20,33,98,165,55,27,10,27,84,138,36,23,10,21,44,50,15,8,1,8,25,33,9,2,0,13,19,17,6,6,1,696,314,382,145,76,69,87,168,249,106,47,23,53,67,104,51,27,3,34,101,145,55,20,20,24,50,38,21,10,1,15,23,19,13,6,0,9,27,19,8,4,1,834,458,376,134,68,66,105,187,352,117,38,23,71,96,189,66,24,4,34,91,163,51,14,19,13,39,50,22,4,0,8,22,27,8,1,0,5,17,23,14,3,0,1024,546,478,166,86,80,96,219,427,122,60,75,60,108,235,77,31,24,36,111,192,45,29,51,36,40,49,17,17,4,21,23,23,9,7,3,15,17,26,8,10,1,652,299,353,2,-23,25,73,141,251,95,51,22,32,56,138,28,26,9,41,85,113,67,25,13,13,11,-16,-16,4,5,2,6,-18,-17,1,3,11,5,2,1,3,2,437,230,207,53,26,27,-3,80,219,78,37,18,2,38,105,51,29,7,-5,42,114,27,8,11,6,9,20,8,6,3,3,4,10,3,4,1,3,5,10,5,2,2,316,145,171,46,24,22,50,73,108,65,27,-3,22,36,43,36,9,-2,28,37,65,29,18,-1,7,12,14,8,3,1,4,7,6,5,1,1,3,5,8,3,2,0,82,37,45,-217,-128,-89,-19,42,48,-34,25,17,2,28,13,-37,20,3,-21,14,35,3,5,14,-23,-25,-87,-68,-9,-8,-9,-14,-55,-45,-3,-3,-14,-11,-32,-23,-6,-5,309,150,159,-57,-41,-16,29,57,113,96,-4,16,18,17,63,48,-5,11,11,40,50,48,1,5,-4,-15,-8,-18,-13,0,-3,-8,-8,-14,-8,-1,-1,-7,0,-4,-5,1,148,101,47,22,12,10,-40,40,63,0,43,34,-23,26,41,17,17,17,-17,14,22,-17,26,17,0,3,10,4,4,-1,-2,2,4,6,1,-1,2,1,6,-2,3,0,232,113,119,33,12,21,32,16,105,32,31,14,28,-6,52,18,9,13,4,22,53,14,22,1,2,2,5,12,8,5,0,2,4,4,1,2,2,0,1,8,7,3,145,78,67,60,30,30,-38,84,50,2,32,11,-10,54,30,-6,11,1,-28,30,20,8,21,10,1,10,20,23,-1,6,-2,5,7,14,2,3,3,5,13,9,-3,3,135,20,115,-35,-40,5,-60,28,76,2,61,31,-38,4,24,3,25,7,-22,24,52,-1,36,24,-8,11,-11,-31,3,1,-3,4,-14,-27,-1,1,-5,7,3,-4,4,0
18,18087,Granada,244767,-3883,-2135,-1748,68,32,36,-381,-966,-1577,-552,-252,-66,-225,-477,-876,-326,-167,-23,-156,-489,-701,-226,-85,-43,13,6,18,8,16,7,7,2,10,5,4,4,6,4,8,3,12,3,-3406,-1925,-1481,66,41,25,-158,-754,-1566,-520,-313,-91,-96,-414,-926,-281,-181,-24,-62,-340,-640,-239,-132,-67,7,9,11,11,19,8,2,8,5,8,12,5,5,1,6,3,7,3,-4423,-2410,-2013,-184,-75,-109,-367,-837,-1857,-671,-374,-231,-207,-419,-1046,-383,-229,-79,-160,-418,-811,-288,-145,-152,9,-49,-103,-18,-21,-3,3,-18,-41,-10,-8,-1,6,-31,-62,-8,-13,-2,-1351,-977,-374,393,208,185,-169,-144,-1070,-64,-45,220,-92,-121,-641,-54,-66,53,-77,-23,-429,-10,21,167,36,127,129,50,28,21,21,67,79,20,12,8,15,60,50,30,16,13,-1707,-846,-861,2279,1330,949,-183,-10,-1100,-107,-193,-71,-113,81,-522,-132,-122,-26,-70,-91,-578,25,-71,-45,268,618,828,375,116,26,133,361,533,206,54,14,135,257,295,169,62,12,2030,954,1076,3241,1823,1418,738,571,194,459,40,-39,306,308,100,220,-16,-2,432,263,94,239,56,-37,432,924,1118,477,169,42,220,511,684,270,76,17,212,413,434,207,93,25,-239,-227,-12,1963,1034,929,561,180,-621,-113,-145,-156,298,58,-392,-87,-70,-68,263,122,-229,-26,-75,-88,355,621,572,240,72,31,197,332,308,115,26,13,158,289,264,125,46,18,1136,479,657,3246,1742,1504,500,484,33,115,75,-107,167,327,18,17,-11,-31,333,157,15,98,86,-76,468,963,1068,440,171,33,229,514,626,223,85,20,239,449,442,217,86,13,-375,-276,-99,1702,916,786,139,220,-471,-229,-46,-142,-49,145,-197,-192,-21,-30,188,75,-274,-37,-25,-112,227,563,560,123,36,1,108,283,376,53,7,-3,119,280,184,70,29,4,-380,-311,-69,1921,1007,914,45,168,-411,-78,-94,-73,13,65,-247,-29,-112,-22,32,103,-164,-49,18,-51,247,541,606,257,100,29,127,277,324,149,45,12,120,264,282,108,55,17,-1360,-637,-723,1393,711,682,-17,132,-799,-310,-170,-134,57,91,-465,-151,-100,-44,-74,41,-334,-159,-70,-90,223,424,455,171,77,21,116,213,225,101,35,7,107,211,230,70,42,14,-548,-285,-263,1248,620,628,-52,39,-348,-103,-34,-5,39,32,-205,-96,-48,25,-91,7,-143,-7,14,-30,199,383,419,120,84,25,108,202,210,46,34,9,91,181,209,74,50,16,-111,1,-112,1011,505,506,-28,74,-152,14,50,-46,-25,1,-34,71,10,-7,-3,73,-118,-57,40,-39,147,302,334,137,54,22,87,133,165,74,24,12,60,169,169,63,30,10,-565,-423,-142,360,96,264,-136,79,-415,-80,-78,52,-104,30,-244,-47,-66,-12,-32,49,-171,-33,-12,64,73,146,58,26,11,32,40,34,4,13,-11,7,33,112,54,13,22,25,-1508,-1180,-328,-275,-327,52,-110,113,-832,-518,-52,-129,-78,-32,-622,-325,-70,-62,-32,145,-210,-193,18,-67,72,145,-235,-256,-18,-2,30,41,-193,-196,-19,0,42,104,-42,-60,1,-2,-1106,-685,-421,-666,-479,-187,13,145,-747,-393,-151,-36,-12,73,-425,-226,-114,-17,25,72,-322,-167,-37,-19,51,155,-369,-387,-122,-21,35,62,-221,-278,-82,-10,16,93,-148,-109,-40,-11,-917,-593,-324,-435,-249,-186,54,109,-602,-425,-73,-27,40,29,-325,-311,-61,15,14,80,-277,-114,-12,-42,40,154,-243,-303,-110,-14,44,65,-92,-211,-67,-9,-4,89,-151,-92,-43,-5,353,26,327,991,436,555,206,459,-303,-87,51,-13,90,193,-183,-120,-11,26,116,266,-120,33,62,-39,238,341,232,56,61,36,131,145,115,-3,23,12,107,196,117,59,38,24
18,18089,Guadix,20246,-53,-36,-17,36,22,14,3,-30,-44,8,2,-1,-3,-22,-25,4,2,2,6,-8,-19,4,0,-3,9,4,10,10,2,0,4,3,5,7,2,0,5,1,5,3,0,0,191,92,99,57,22,35,48,20,26,34,22,42,39,3,7,22,10,11,9,17,19,12,12,31,8,22,14,8,2,2,3,6,5,4,2,1,5,16,9,4,0,1,226,102,124,68,32,36,59,22,34,40,45,9,25,8,13,18,24,9,34,14,21,22,21,0,14,12,18,13,8,2,9,2,10,7,3,1,5,10,8,6,5,1,-85,-43,-42,83,35,48,-4,-4,-23,-39,0,-17,-2,-6,-12,-21,-1,-3,-2,2,-11,-18,1,-14,14,32,20,12,2,3,7,10,9,9,-1,1,7,22,11,3,3,2,27,2,25,66,31,35,24,-12,-5,-10,17,10,23,-13,-9,-19,6,11,1,1,4,9,11,-1,16,15,14,8,6,7,5,8,10,3,2,3,11,7,4,5,4,4,123,81,42,57,31,26,46,16,11,19,23,6,27,7,22,8,13,5,19,9,-11,11,10,1,9,14,15,11,7,1,7,6,9,6,3,0,2,8,6,5,4,1,89,56,33,105,68,37,69,-1,4,37,-13,-6,40,-5,-5,36,-2,-7,29,4,9,1,-11,1,31,21,32,16,6,-1,20,10,22,12,4,0,11,11,10,4,2,-1,32,62,-30,152,101,51,9,24,1,-12,13,-9,13,11,19,-1,14,3,-4,13,-18,-11,-1,-12,24,44,54,21,8,0,13,21,40,18,7,1,11,23,14,3,1,-1,77,85,-8,105,66,39,3,10,16,37,20,-6,20,11,18,21,14,4,-17,-1,-2,16,6,-10,14,22,32,25,9,3,10,16,21,13,5,1,4,6,11,12,4,2,131,65,66,72,43,29,33,25,4,21,0,44,15,14,16,3,-1,18,18,11,-12,18,1,26,14,15,23,13,4,1,6,14,16,5,2,0,8,1,7,8,2,1,64,37,27,45,25,20,27,-7,15,12,4,13,5,-8,15,7,2,13,22,1,0,5,2,0,8,11,11,9,4,2,6,4,7,5,1,2,2,7,4,4,3,0,94,93,1,45,28,17,24,9,20,19,8,10,28,18,22,11,5,4,-4,-9,-2,8,3,6,8,11,13,8,5,0,6,7,6,5,4,0,2,4,7,3,1,0,16,11,5,42,20,22,12,-32,-27,40,3,21,0,-9,-8,23,-4,13,12,-23,-19,17,7,8,8,3,12,10,5,4,1,1,7,7,1,3,7,2,5,3,4,1,65,19,46,28,12,16,9,15,10,16,21,-8,5,8,-2,1,12,-5,4,7,12,15,9,-3,6,6,12,3,4,-3,4,1,4,3,1,-1,2,5,8,0,3,-2,-155,-94,-61,-269,-171,-98,25,-25,-72,-80,-28,12,25,-16,-50,-43,-22,5,0,-9,-22,-37,-6,7,-15,-14,-82,-95,-48,-16,-4,-10,-54,-62,-36,-6,-11,-4,-28,-33,-12,-10,-10,-13,3,38,14,24,4,-22,-34,10,2,18,-8,-8,-28,12,0,10,12,-14,-6,-2,2,8,8,5,1,10,6,4,1,3,0,5,1,2,7,2,1,5,5,2,47,28,19,74,37,37,33,2,-24,40,10,-12,12,-10,-12,30,8,0,21,12,-12,10,2,-12,21,13,16,22,-2,4,10,2,10,15,-2,2,11,11,6,7,0,2,-5,18,-23,102,64,38,-8,-19,-13,17,10,8,-3,-6,0,7,11,8,-5,-13,-13,10,-1,0,18,15,34,22,12,0,9,9,19,20,8,-1,9,6,15,2,4,1
18,18098,Huéscar,8024,-22,-9,-13,4,1,3,7,-8,-16,-12,9,-1,7,-6,-7,-6,4,2,0,-2,-9,-6,5,-3,1,1,0,1,1,0,1,0,0,0,0,0,0,1,0,1,1,0,-3,5,-8,9,6,3,-12,-28,-16,2,10,40,-6,-9,-11,7,6,18,-6,-19,-5,-5,4,22,1,1,4,2,1,0,0,1,2,2,1,0,1,0,2,0,0,0,-41,0,-41,18,12,6,-23,-9,-6,-9,5,3,-9,3,3,-5,5,4,-14,-12,-9,-4,0,-1,0,5,7,3,2,1,0,3,4,3,1,1,0,2,3,0,1,0,-36,-21,-15,13,7,6,-2,-21,-15,-15,3,13,-1,-19,-1,-5,1,5,-1,-2,-14,-10,2,8,3,1,4,2,2,0,2,0,2,2,1,0,1,1,2,0,1,0,27,8,19,27,14,13,-11,-7,-18,-9,30,37,-5,-6,-6,-10,16,16,-6,-1,-12,1,14,21,4,4,5,5,6,3,3,2,2,3,3,1,1,2,3,2,3,2,-13,-15,2,26,10,16,9,-5,-29,17,-1,-9,-1,1,-17,4,-1,-3,10,-6,-12,13,0,-6,4,1,7,9,3,2,1,0,2,4,2,1,3,1,5,5,1,1,35,10,25,41,20,21,4,4,-22,16,18,10,-4,1,-13,6,11,7,8,3,-9,10,7,3,8,6,8,7,11,0,4,2,5,3,7,-1,4,4,3,4,4,1,33,1,32,33,10,23,9,-2,-16,10,17,11,2,-2,-17,7,4,4,7,0,1,3,13,7,8,5,5,6,9,-1,2,1,0,3,3,0,6,4,5,3,6,-1,14,12,2,26,17,9,2,1,-12,17,-5,10,0,-1,-3,10,0,6,2,2,-9,7,-5,4,0,4,6,10,4,2,0,1,7,6,3,0,0,3,-1,4,1,2,-11,15,-26,15,9,6,-1,-11,-29,15,15,1,2,-3,-13,12,13,3,-3,-8,-16,3,2,-2,4,1,3,5,0,1,1,0,2,3,1,1,3,1,1,2,-1,0,0,6,-6,15,6,9,-5,0,-17,16,1,3,-5,-1,1,0,3,5,0,1,-18,16,-2,-2,6,1,4,3,0,0,1,-1,4,1,0,0,5,2,0,2,0,0,-55,-24,-31,-9,-5,-4,-14,-14,-1,-25,7,-5,-7,-4,-2,-12,3,-1,-7,-10,1,-13,4,-4,1,0,-9,-6,2,3,1,-1,-5,-4,2,2,0,1,-4,-2,0,1,-18,-7,-11,12,6,6,12,-17,-9,2,-11,5,8,-9,-7,4,-6,0,4,-8,-2,-2,-5,5,1,2,1,7,-1,1,0,1,1,4,-1,0,1,1,0,3,0,1,-76,-31,-45,6,4,2,-22,-3,-27,-15,-1,-9,-12,0,-9,-12,1,0,-10,-3,-18,-3,-2,-9,0,1,-1,1,5,0,0,1,0,0,3,0,0,0,-1,1,2,0,-62,-42,-20,-28,-10,-18,-9,-12,-35,6,-7,-8,-12,-10,-18,6,-4,-4,3,-2,-17,0,-3,-4,-9,-2,-6,-6,-4,-1,-4,0,-2,-1,-3,0,-5,-2,-4,-5,-1,-1,15,17,-2,14,9,5,-3,-4,-6,-1,24,4,-3,4,4,-6,14,3,0,-8,-10,5,10,1,2,0,-2,1,12,1,3,0,-2,-1,8,1,-1,0,0,2,4,0,-58,-34,-24,10,5,5,-7,-7,-26,-13,4,-1,-4,-9,-12,-1,-2,-1,-3,2,-14,-12,6,0,1,1,1,3,1,3,1,1,0,2,0,1,0,0,1,1,1,2,-42,-19,-23,12,10,2,-7,-17,-19,-8,7,3,-6,-7,-16,-7,12,7,-1,-10,-3,-1,-5,-4,0,0,-1,4,9,0,0,0,0,3,7,0,0,0,-1,1,2,0
18,18101,Huétor Vega,8575,281,138,143,26,12,14,56,41,86,62,25,12,21,12,62,29,11,5,35,29,24,33,14,7,3,7,10,2,4,0,2,2,4,0,4,0,1,5,6,2,0,0,267,132,135,37,16,21,44,38,136,50,-6,5,19,11,64,34,-1,5,25,27,72,16,-5,0,7,7,15,3,3,1,2,4,6,1,2,0,5,3,9,2,1,1,330,177,153,39,18,21,66,52,99,86,19,-2,35,29,54,44,12,-3,31,23,45,42,7,1,9,9,7,9,2,2,2,5,4,5,1,1,7,4,3,4,1,1,134,62,72,20,5,15,19,10,51,28,19,9,3,8,33,5,10,4,16,2,18,23,9,5,8,0,7,2,4,-1,3,-1,4,0,0,-1,5,1,3,2,4,0,120,65,55,41,18,23,13,11,75,12,8,-4,17,0,43,7,1,-5,-4,11,32,5,7,1,6,4,18,6,7,0,2,1,6,5,4,0,4,3,12,1,3,0,112,68,44,25,16,9,20,18,3,54,7,12,21,4,4,30,4,5,-1,14,-1,24,3,7,5,3,2,4,6,5,3,3,3,3,2,2,2,0,-1,1,4,3,111,47,64,49,21,28,10,9,3,51,16,12,1,3,-6,25,11,7,9,6,9,26,5,5,7,13,17,10,1,0,3,6,9,2,0,0,4,7,8,8,1,0,139,60,79,29,12,17,13,31,19,72,-4,10,4,12,14,35,-4,-1,9,19,5,37,0,11,7,12,6,6,1,-3,4,6,2,2,0,-2,3,6,4,4,1,-1,174,95,79,35,22,13,56,2,14,57,18,19,34,7,7,24,11,9,22,-5,7,33,7,10,3,5,11,5,8,2,2,6,4,3,6,1,1,-1,7,2,2,1,162,86,76,-8,-4,-4,53,2,-18,102,17,10,37,2,-14,51,7,4,16,0,-4,51,10,6,0,2,1,-9,-2,0,2,0,2,-6,-1,-1,-2,2,-1,-3,-1,1,214,83,131,-40,-19,-21,69,-15,25,94,14,25,23,-17,6,51,7,12,46,2,19,43,7,13,-13,-1,-25,1,-1,-1,-6,0,-15,1,1,0,-7,-1,-10,0,-2,-1,41,4,37,-8,-8,0,6,-1,14,23,6,-4,-4,-14,14,4,6,0,10,13,0,19,0,-4,-3,0,1,1,-4,-3,-1,-3,-1,0,-2,-1,-2,3,2,1,-2,-2,-22,-10,-12,-25,-7,-18,0,10,-50,23,-12,-4,-6,6,-14,12,-10,-6,6,4,-36,11,-2,2,-8,0,-5,-8,-4,0,-3,0,1,-4,-2,1,-5,0,-6,-4,-2,-1,-4,10,-14,-22,-9,-13,52,-15,-18,-1,-20,2,38,-3,-11,-1,-10,0,14,-12,-7,0,-10,2,0,-5,-10,-8,1,0,0,-4,-4,-4,2,1,0,-1,-6,-4,-1,-1,-4,-8,4,-9,-7,-2,14,-16,3,-10,9,-5,6,-4,-3,-19,10,-1,8,-12,6,9,-1,-4,-5,2,-2,-6,2,0,0,1,-4,-3,-1,0,-5,1,2,-3,3,0,-84,-44,-40,-21,-12,-9,-4,-21,-38,-13,-5,7,-14,-3,-15,-7,-2,0,10,-18,-23,-6,-3,7,0,-6,-12,-6,4,-1,-2,-1,-9,-2,3,-1,2,-5,-3,-4,1,0,121,68,53,-5,-1,-4,52,4,0,60,2,4,23,4,-3,33,8,1,29,0,3,27,-6,3,-2,2,-5,0,1,-1,-5,5,1,-1,0,-1,3,-3,-6,1,1,0,50,23,27,30,6,24,39,-3,-17,30,-2,3,17,5,1,14,-14,2,22,-8,-18,16,12,1,2,6,7,6,3,4,1,0,-4,4,0,3,1,6,11,2,3,1
18,18102,Illora,10672,-60,-36,-24,16,7,9,-25,-19,-29,-2,10,0,-10,-14,-15,-4,8,-1,-15,-5,-14,2,2,1,2,1,4,2,6,1,1,0,1,0,4,1,1,1,3,2,2,0,-51,-46,-5,13,4,9,-5,-26,-20,-10,1,4,-7,-21,-16,-6,3,-3,2,-5,-4,-4,-2,7,1,2,1,2,6,1,0,0,1,0,3,0,1,2,0,2,3,1,11,7,4,33,20,13,22,-15,-14,0,17,-2,12,-10,-2,0,5,2,10,-5,-12,0,12,-4,8,6,6,4,5,3,7,3,5,1,2,2,1,3,1,3,3,1,7,1,6,17,8,9,0,-3,-6,7,9,-2,-4,0,-9,6,7,0,4,-3,3,1,2,-2,3,2,6,5,0,1,2,2,1,3,0,0,1,0,5,2,0,1,90,57,33,46,26,20,27,-9,34,8,9,16,17,-2,22,4,7,7,10,-7,12,4,2,9,7,3,13,10,10,3,4,3,7,5,6,1,3,0,6,5,4,2,51,16,35,60,30,30,21,-5,-6,19,15,5,7,-7,-4,6,8,7,14,2,-2,13,7,-2,13,7,11,10,15,3,6,4,6,5,7,2,7,3,5,5,8,1,75,40,35,42,20,22,20,16,-15,27,22,5,8,13,-2,8,9,4,12,3,-13,19,13,1,6,7,7,15,7,0,5,3,4,6,2,0,1,4,3,9,5,0,23,28,-5,58,32,26,0,-4,2,14,21,-9,2,-1,5,12,11,1,-2,-3,-3,2,10,-10,14,12,9,14,9,0,8,7,4,7,6,0,6,5,5,7,3,0,-8,-16,8,21,13,8,-9,0,-28,-5,15,16,-3,0,-17,-3,11,-4,-6,0,-11,-2,4,20,3,4,5,5,4,0,2,3,3,3,2,0,1,1,2,2,2,0,-31,0,-31,4,1,3,-8,-9,-14,-3,6,0,-5,3,1,-2,1,3,-3,-12,-15,-1,5,-3,3,-1,-3,0,3,2,3,-1,-2,-1,1,1,0,0,-1,1,2,1,-22,-21,-1,-4,-8,4,24,-1,-31,0,7,-17,8,0,-22,-2,0,-4,16,-1,-9,2,7,-13,2,3,-11,2,0,0,1,1,-10,1,-1,0,1,2,-1,1,1,0,-22,-4,-18,-1,1,-2,-11,-9,-13,1,6,2,-6,1,-2,0,-2,3,-5,-10,-11,1,8,-1,0,0,2,-3,0,0,0,1,2,-1,-2,1,0,-1,0,-2,2,-1,-34,-8,-26,-4,-3,-1,-4,-7,-17,0,4,-8,-5,-1,-1,3,0,-4,1,-6,-16,-3,4,-4,1,0,-2,-8,3,2,0,-2,0,-3,1,1,1,2,-2,-5,2,1,-63,-28,-35,-28,-17,-11,-4,-12,-17,-28,2,-2,3,-11,-7,-12,-1,1,-7,-1,-10,-16,3,-3,-4,-4,-4,-9,-6,-1,-1,-4,-3,-5,-4,0,-3,0,-1,-4,-2,-1,-41,-20,-21,5,4,1,-4,-7,-13,-7,1,-9,7,-4,-15,-5,3,-4,-11,-3,2,-2,-2,-5,-3,1,2,1,4,0,-1,0,1,1,3,0,-2,1,1,0,1,0,-86,-33,-53,23,10,13,-21,-10,-37,-11,-5,0,-8,-6,-12,-5,-1,1,-13,-4,-25,-6,-4,-1,8,4,6,7,0,-2,3,1,2,5,0,-1,5,3,4,2,0,-1,-31,-20,-11,-6,-4,-2,3,2,-22,-13,7,-6,1,2,-15,-12,5,-2,2,0,-7,-1,2,-4,2,2,-5,-5,3,-3,2,-1,-2,-3,1,-1,0,3,-3,-2,2,-2,-30,1,-31,10,9,1,14,-18,-25,3,10,-11,11,-6,-13,3,13,-5,3,-12,-12,0,-3,-6,3,2,5,2,-2,0,3,2,2,2,0,0,0,0,3,0,-2,0
18,18105,Iznalloz,7094,-38,-14,-24,8,4,4,-10,-5,-14,-10,6,-4,1,-2,-5,-9,3,0,-11,-3,-9,-1,3,-4,1,0,3,1,3,0,0,0,1,1,2,0,1,0,2,0,1,0,-2,-1,-1,21,8,13,3,1,-4,0,0,-1,-2,2,-1,-1,0,1,5,-1,-3,1,0,-2,6,3,7,5,0,0,2,1,4,1,0,0,4,2,3,4,0,0,27,7,20,26,14,12,18,-5,-1,9,11,-2,12,-5,-3,0,7,-2,6,0,2,9,4,0,9,3,5,4,2,3,3,3,3,1,2,2,6,0,2,3,0,1,8,19,-11,38,20,18,-4,12,-22,5,6,11,1,12,-7,3,4,6,-5,0,-15,2,2,5,7,7,9,10,1,2,5,2,7,5,0,0,2,5,2,5,1,2,0,15,-15,57,36,21,-4,-5,-9,5,9,1,-2,0,1,8,6,-1,-2,-5,-10,-3,3,2,4,10,20,12,5,5,2,7,14,6,4,2,2,3,6,6,1,3,-12,2,-14,49,30,19,-1,5,-14,-2,7,-4,-2,7,-3,0,2,0,1,-2,-11,-2,5,-4,10,17,10,7,3,2,4,11,9,3,1,2,6,6,1,4,2,0,-23,4,-27,34,26,8,6,-16,3,-7,9,-14,7,-1,-1,1,6,-6,-1,-15,4,-8,3,-8,4,9,12,5,4,0,4,6,9,3,3,1,0,3,3,2,1,-1,23,26,-3,55,46,9,-4,1,8,8,22,-10,-3,9,5,8,12,-3,-1,-8,3,0,10,-7,4,16,15,11,8,0,3,14,13,12,5,-1,1,2,2,-1,3,1,-94,-39,-55,13,8,5,-19,-6,-31,-18,-2,-15,-8,-3,-16,-8,3,-5,-11,-3,-15,-10,-5,-10,3,2,3,4,3,-2,2,2,0,2,3,-1,1,0,3,2,0,-1,-101,-38,-63,20,12,8,-6,-21,-34,-18,-6,-10,3,-9,-14,-8,0,-7,-9,-12,-20,-10,-6,-3,6,4,4,1,4,1,3,3,4,-1,2,1,3,1,0,2,2,0,-48,-21,-27,-3,-5,2,-10,15,-14,-7,-6,-25,-3,4,-2,-2,-3,-15,-7,11,-12,-5,-3,-10,1,0,3,-3,-1,-4,0,-1,1,-1,-1,-3,1,1,2,-2,0,-1,3,-3,6,4,3,1,-10,6,1,2,6,-6,-7,3,1,4,0,-4,-3,3,0,-2,6,-2,-1,3,2,1,-1,0,0,1,1,1,0,0,-1,2,1,0,-1,0,-85,-41,-44,1,-3,4,-30,-8,-21,-20,4,-10,-18,-8,-7,-12,5,-2,-12,0,-14,-8,-1,-8,-2,4,-4,-1,3,0,0,0,-3,-2,2,0,-2,4,-1,1,1,0,-19,-26,7,-14,-16,2,3,-4,-19,-5,4,2,0,-8,-19,-2,2,1,3,4,0,-3,2,1,0,-2,-6,-5,0,-2,0,-1,-7,-5,-2,-1,0,-1,1,0,2,-1,-43,-5,-38,7,3,4,-17,1,-16,8,-4,-12,-11,6,2,3,1,-6,-6,-5,-18,5,-5,-6,1,0,1,3,1,1,1,0,1,2,-1,0,0,0,0,1,2,1,-36,-16,-20,8,4,4,-11,-11,-10,-10,14,-10,-7,-12,-3,-3,13,-3,-4,1,-7,-7,1,-7,-2,1,1,3,4,1,-2,0,1,2,2,1,0,1,0,1,2,0,-36,-18,-18,3,2,1,-8,-1,-10,-5,-5,-4,-2,-2,-5,-3,-4,-1,-6,1,-5,-2,-1,-3,3,0,-2,0,2,0,2,0,-1,-1,1,1,1,0,-1,1,1,-1,4,7,-3,13,6,7,1,1,2,2,-5,2,1,2,1,4,-2,0,0,-1,1,-2,-3,2,1,0,7,1,2,2,2,0,2,1,0,1,-1,0,5,0,2,1
18,18116,Lanjarón,3870,0,-1,1,2,1,1,-4,-4,-1,10,-3,2,-6,-3,1,7,-2,2,2,-1,-2,3,-1,0,0,0,1,1,0,0,0,0,1,0,0,0,0,0,0,1,0,0,-28,-18,-10,4,1,3,-6,-7,-17,-1,0,3,-5,-3,-5,-3,-3,1,-1,-4,-12,2,3,2,1,0,0,2,1,0,0,0,0,1,0,0,1,0,0,1,1,0,-4,5,-9,31,17,14,9,-6,4,0,5,-14,3,0,4,2,0,-2,6,-6,0,-2,5,-12,12,1,6,7,5,0,7,0,2,5,2,1,5,1,4,2,3,-1,48,25,23,31,17,14,8,7,9,10,11,3,8,2,6,6,3,1,0,5,3,4,8,2,11,2,6,8,5,-1,7,0,5,4,2,-1,4,2,1,4,3,0,-4,0,-4,39,19,20,-13,-2,-2,13,13,-12,-12,1,5,8,4,-5,-1,-3,-7,5,9,-7,2,4,11,8,13,1,0,3,7,4,5,0,2,1,4,4,8,1,46,30,16,30,17,13,15,9,10,19,2,-6,9,6,7,10,3,-2,6,3,3,9,-1,-4,4,5,9,6,6,0,2,4,5,3,3,0,2,1,4,3,3,0,32,24,8,41,26,15,0,10,1,-4,24,2,1,1,2,2,16,2,-1,9,-1,-6,8,0,5,8,7,5,12,4,4,3,4,3,9,3,1,5,3,2,3,1,90,57,33,41,24,17,2,16,23,6,34,9,3,6,17,6,18,7,-1,10,6,0,16,2,7,3,14,5,9,2,2,2,8,5,5,1,5,1,6,0,4,1,-6,1,-7,12,9,3,-5,2,-1,3,2,-7,1,3,2,-3,0,-2,-6,-1,-3,6,2,-5,0,3,4,6,0,-2,0,3,4,2,0,0,0,0,0,4,0,-2,-11,-4,-7,17,8,9,2,5,-1,-7,6,-16,2,5,-1,-2,1,-9,0,0,0,-5,5,-7,2,2,2,4,4,3,2,2,1,0,1,2,0,0,1,4,3,1,21,21,0,15,7,8,15,4,-1,4,7,-9,5,1,5,5,3,0,10,3,-6,-1,4,-9,2,1,2,6,3,-1,1,0,-1,4,2,-1,1,1,3,2,1,0,-8,-17,9,10,-1,11,4,1,-5,7,-3,-15,1,-5,-2,0,-5,-7,3,6,-3,7,2,-8,1,1,1,6,1,-1,0,-1,1,0,-1,0,1,2,0,6,2,-1,-9,1,-10,22,12,10,3,-4,-2,-9,2,0,-4,4,6,-8,-1,3,7,-8,-8,-1,3,-3,3,2,2,2,8,5,1,2,3,0,3,3,2,0,-1,2,5,2,-31,-11,-20,-16,-14,-2,0,-4,-4,-14,-8,-1,-1,4,-4,-10,0,-2,1,-8,0,-4,-8,1,-2,0,-6,-11,0,2,-4,0,-4,-8,1,0,2,0,-2,-3,-1,2,1,-7,8,-44,-26,-18,0,4,-7,0,4,-2,0,1,-6,-4,1,-1,0,3,-1,4,3,-1,-5,-2,-17,-12,-6,-3,-3,0,-11,-7,-5,-1,-2,-2,-6,-5,-1,-2,-49,-15,-34,26,14,12,-20,-3,-8,-7,6,-14,-11,-5,1,0,5,-3,-9,2,-9,-7,1,-11,2,0,5,7,10,1,1,0,4,4,5,0,1,0,1,3,5,1,-36,-26,-10,6,4,2,-11,-3,-8,-6,5,-12,-6,0,-6,-2,-3,-6,-5,-3,-2,-4,8,-6,2,0,2,1,1,-1,2,0,1,0,0,0,0,0,1,1,1,-1,29,22,7,31,19,12,1,0,5,1,19,4,2,2,4,1,13,0,-1,-2,1,0,6,4,3,3,6,7,10,2,1,1,4,5,6,2,2,2,2,2,4,0
18,18122,Loja,20143,-3,-6,3,30,16,14,-8,-9,12,-5,-2,13,-3,-12,8,1,-1,4,-5,3,4,-6,-1,9,1,7,8,7,4,3,1,3,3,6,2,1,0,4,5,1,2,2,-63,-21,-42,15,13,2,-10,-21,-14,-11,8,-12,0,-10,-9,-3,6,-5,-10,-11,-5,-8,2,-7,0,7,3,3,2,0,0,6,3,2,2,0,0,1,0,1,0,0,73,63,10,110,64,46,-18,16,29,25,18,-2,-8,11,23,21,9,7,-10,5,6,4,9,-9,17,20,33,23,8,6,10,13,19,15,4,3,7,7,14,8,4,3,38,33,5,90,47,43,10,10,1,12,10,-3,4,3,8,13,4,1,6,7,-7,-1,6,-4,11,17,17,20,18,5,5,11,11,8,8,4,6,6,6,12,10,1,141,72,69,166,89,77,54,30,11,25,19,2,30,12,-9,18,14,6,24,18,20,7,5,-4,33,29,37,31,24,10,19,18,15,15,13,7,14,11,22,16,11,3,268,160,108,215,134,81,63,42,49,71,38,3,27,30,41,39,21,0,36,12,8,32,17,3,36,50,51,37,30,7,21,31,37,23,15,4,15,19,14,14,15,3,169,66,103,139,55,84,60,19,20,39,30,2,13,10,1,22,20,3,47,9,19,17,10,-1,34,23,19,35,27,0,10,6,4,17,17,0,24,17,15,18,10,0,258,176,82,240,156,84,26,50,115,21,35,8,25,32,77,19,20,1,1,18,38,2,15,7,28,65,71,38,35,2,21,38,49,25,20,2,7,27,22,13,15,0,77,77,0,148,89,59,12,12,20,22,11,-2,6,10,23,21,7,8,6,2,-3,1,4,-10,21,32,35,39,13,6,11,18,22,24,7,5,10,14,13,15,6,1,37,42,-5,74,42,32,13,-7,15,9,23,-12,2,5,12,14,11,-3,11,-12,3,-5,12,-9,3,22,17,13,16,2,2,14,12,7,5,1,1,8,5,6,11,1,-67,-19,-48,-36,-39,3,8,6,-56,-30,-3,5,-1,12,-27,-16,7,5,9,-6,-29,-14,-10,0,7,-8,-29,-11,3,2,2,-3,-32,-8,1,1,5,-5,3,-3,2,1,-68,-11,-57,2,2,0,-51,-10,12,-22,-10,16,-19,2,19,-12,-6,7,-32,-12,-7,-10,-4,9,1,2,-2,-3,2,2,0,2,-2,1,-1,2,1,0,0,-4,3,0,-94,-6,-88,-20,-13,-7,-11,-5,8,-32,-30,-21,-1,1,33,-17,-9,-13,-10,-6,-25,-15,-21,-8,-10,1,-2,-5,-4,0,-5,-1,-4,-2,-1,0,-5,2,2,-3,-3,0,-147,-76,-71,-24,-23,-1,4,-44,-107,-2,9,-2,10,-26,-57,-13,9,3,-6,-18,-50,11,0,-5,1,-6,-19,-4,3,0,1,-4,-15,-6,0,0,0,-2,-4,2,3,0,-185,-118,-67,-47,-42,-5,1,-45,-108,-34,3,0,5,-24,-81,-22,7,-2,-4,-21,-27,-12,-4,2,2,-3,-35,-16,3,1,1,-1,-33,-13,3,1,1,-2,-2,-3,0,0,-148,-93,-55,-19,-14,-5,-5,-51,-71,-24,-2,6,-5,-21,-44,-20,-4,2,0,-30,-27,-4,2,4,4,-4,-12,-7,-3,3,1,-1,-10,-5,0,1,3,-3,-2,-2,-3,2,-274,-174,-100,-139,-92,-47,-5,-21,-82,-93,-27,-49,-7,-15,-39,-61,-22,-33,2,-6,-43,-32,-5,-16,0,2,-42,-51,-22,-28,1,1,-24,-38,-15,-18,-1,1,-18,-13,-7,-10,-222,-138,-84,-127,-99,-28,-4,-48,-56,-53,-25,-37,-14,-8,-46,-44,-17,-11,10,-40,-10,-9,-8,-26,-11,-2,-17,-44,-30,-24,-14,0,-18,-38,-22,-8,3,-2,1,-6,-8,-16
18,18127,Maracena,14331,398,192,206,19,9,10,64,79,142,45,33,31,35,29,68,25,15,16,29,50,74,20,18,15,2,3,6,2,3,3,0,1,4,2,1,1,2,2,2,0,2,2,441,235,206,60,35,25,51,112,166,36,34,44,41,55,87,20,16,17,10,57,79,16,18,27,11,14,15,10,5,5,7,8,9,6,2,3,4,6,6,4,3,2,632,308,324,113,58,55,134,125,192,91,44,44,77,56,79,47,27,18,57,69,113,44,17,26,27,29,26,20,8,2,11,14,17,12,3,1,16,15,9,8,5,1,542,286,256,95,49,46,110,80,204,78,47,21,42,46,122,41,20,9,68,34,82,37,27,12,22,19,20,14,12,6,15,10,8,9,3,3,7,9,12,5,9,3,679,333,346,114,56,58,114,131,252,92,45,34,67,64,118,46,19,11,47,67,134,46,26,23,28,23,40,18,3,2,14,10,18,11,2,1,14,13,22,7,1,1,341,144,197,105,61,44,41,55,164,39,24,4,10,18,69,27,19,2,31,37,95,12,5,2,14,29,34,18,10,0,6,15,20,12,8,0,8,14,14,6,2,0,307,150,157,119,59,60,50,51,115,23,24,40,35,22,55,19,10,11,15,29,60,4,14,29,26,23,41,17,8,3,15,8,24,7,3,1,11,15,17,10,5,2,280,146,134,143,91,52,36,52,106,54,13,20,13,22,59,30,9,14,23,30,47,24,4,6,23,35,52,23,8,0,11,23,35,15,5,0,12,12,17,8,3,0,272,126,146,89,34,55,24,61,101,86,14,-8,28,32,35,40,-2,-8,-4,29,66,46,16,0,8,38,29,12,2,-2,2,13,16,5,-1,-1,6,25,13,7,3,-1,248,87,161,127,65,62,29,56,87,21,33,14,15,8,30,5,18,8,14,48,57,16,15,6,24,39,49,12,1,1,12,18,27,6,1,0,12,21,22,6,0,1,179,74,105,74,22,52,23,8,68,42,23,23,19,-2,26,8,20,7,4,10,42,34,3,16,17,16,29,9,1,2,10,3,6,4,-1,0,7,13,23,5,2,2,270,113,157,70,38,32,69,46,65,29,26,28,22,22,7,33,17,10,47,24,58,-4,9,18,12,19,21,8,7,2,6,9,12,6,4,1,6,10,9,2,3,1,84,60,24,41,23,18,12,15,22,7,-8,31,4,-4,41,4,-4,14,8,19,-19,3,-4,17,10,6,19,4,1,0,6,3,8,3,2,0,4,3,11,1,-1,0,-50,-36,-14,19,6,13,-33,-13,15,-20,-16,13,-24,3,-5,-10,-15,9,-9,-16,20,-10,-1,4,8,6,3,-2,4,0,2,3,2,-3,1,1,6,3,1,1,3,-1,175,63,112,64,28,36,32,25,42,20,33,24,-1,2,23,10,20,8,33,23,19,10,13,16,2,19,26,11,3,1,-3,8,18,3,1,0,5,11,8,8,2,1,3,-3,6,-111,-67,-44,23,37,10,-82,9,10,21,16,-3,-44,4,7,2,21,13,-38,5,3,2,-10,-24,-47,-20,-12,5,-5,-16,-34,-12,-5,-3,-5,-8,-13,-8,-7,-59,-20,-39,10,4,6,10,-52,-4,-31,16,10,12,-31,-5,-6,10,7,-2,-21,1,-25,6,3,10,-4,11,-7,3,-3,3,-2,7,-4,1,-1,7,-2,4,-3,2,-2,21,-10,31,66,29,37,2,-35,65,-12,-25,21,-4,-16,42,-13,-26,3,6,-19,23,1,1,18,11,15,14,18,6,2,5,2,10,9,2,1,6,13,4,9,4,1
18,18133,Molvízar,2769,-19,-5,-14,7,4,3,-10,4,-7,1,-4,1,-3,1,1,1,-3,2,-7,3,-8,0,-1,-1,0,1,5,1,0,0,0,0,3,1,0,0,0,1,2,0,0,0,36,23,13,20,17,3,4,12,9,-1,11,2,3,7,4,2,6,1,1,5,5,-3,5,1,4,6,7,3,0,0,3,5,6,3,0,0,1,1,1,0,0,0,111,51,60,30,14,16,0,49,15,28,20,-2,1,20,10,10,13,-3,-1,29,5,18,7,1,3,10,11,4,2,0,1,3,6,3,1,0,2,7,5,1,1,0,-1,9,-10,34,23,11,6,5,0,4,-4,-11,7,9,-2,5,-3,-6,-1,-4,2,-1,-1,-5,3,10,11,6,4,0,2,6,9,4,2,0,1,4,2,2,2,0,61,40,21,58,34,24,10,18,21,7,4,1,6,12,15,6,2,0,4,6,6,1,2,1,7,18,22,11,0,0,4,9,13,8,0,0,3,9,9,3,0,0,62,38,24,104,61,43,0,26,19,8,12,-1,1,13,12,11,3,0,-1,13,7,-3,9,-1,10,28,45,18,3,0,5,16,28,12,0,0,5,12,17,6,3,0,125,67,58,77,43,34,13,37,19,18,31,7,7,26,6,6,17,5,6,11,13,12,14,2,9,28,22,10,7,0,5,20,11,2,5,0,4,8,11,8,2,0,188,121,67,213,125,88,-1,73,63,34,15,4,-5,47,49,21,9,1,4,26,14,13,6,3,13,73,75,38,10,3,4,41,52,23,4,1,9,32,23,15,6,2,-90,-47,-43,15,9,6,-10,-14,-34,-22,4,-10,-6,-7,-16,-13,2,-4,-4,-7,-18,-9,2,-6,1,6,3,2,3,0,0,4,1,1,3,0,1,2,2,1,0,0,-40,-8,-32,17,10,7,-11,0,-2,-14,-9,-3,-1,-1,0,-6,-1,1,-10,1,-2,-8,-8,-4,5,3,4,1,3,1,3,2,3,0,1,1,2,1,1,1,2,0,-34,-20,-14,25,15,10,1,7,-8,-17,-17,2,0,5,-1,-9,-12,-1,1,2,-7,-8,-5,3,7,7,7,1,2,1,6,3,5,1,0,0,1,4,2,0,2,1,42,20,22,24,7,17,1,11,10,18,7,-5,0,5,3,6,5,0,1,6,7,12,2,-5,5,5,4,11,-1,0,1,1,1,5,-1,0,4,4,3,6,0,0,6,20,-14,16,11,5,8,3,1,0,0,-5,6,4,6,3,4,-3,2,-1,-5,-3,-4,-2,5,2,6,2,0,1,2,2,4,2,0,1,3,0,2,0,0,0,-24,-2,-22,11,7,4,-10,2,-6,1,-1,-9,-7,4,-1,1,5,-3,-3,-2,-5,0,-6,-6,0,5,3,1,2,0,0,3,2,1,1,0,0,2,1,0,1,0,-20,-18,-2,22,11,11,0,5,-15,-17,2,5,0,4,-12,-9,-1,0,0,1,-3,-8,3,5,5,7,3,4,3,0,4,2,2,2,1,0,1,5,1,2,2,0,-37,-16,-21,22,12,10,-16,0,-7,-10,-1,-5,-10,6,-3,-9,1,-2,-6,-6,-4,-1,-2,-3,1,4,8,3,4,1,1,2,3,2,2,1,0,2,5,1,2,0,-29,-11,-18,13,10,3,-5,9,-21,-9,-2,0,-2,9,-11,-3,-2,-1,-3,0,-10,-6,0,1,2,6,3,1,1,0,1,5,2,1,1,0,1,1,1,0,0,0,-14,-3,-11,24,13,11,-11,0,-7,8,4,-8,-14,-1,2,12,1,-2,3,1,-9,-4,3,-6,2,5,2,9,5,1,0,2,2,6,2,1,2,3,0,3,3,0
18,18134,Monachil,5067,91,74,17,23,16,7,13,17,31,8,10,6,15,14,27,1,11,4,-2,3,4,7,-1,2,5,7,5,4,1,1,4,5,5,1,1,0,1,2,0,3,0,1,114,56,58,32,18,14,7,25,43,24,15,1,1,7,24,15,10,-1,6,18,19,9,5,2,6,6,8,9,1,2,2,4,6,4,1,1,4,2,2,5,0,1,165,81,84,46,22,24,35,30,66,28,8,-4,15,16,40,12,2,-4,20,14,26,16,6,0,13,9,15,6,2,0,7,3,7,2,2,0,6,6,8,4,0,0,87,45,42,38,14,24,50,4,28,14,-10,0,27,2,15,4,-8,4,23,2,13,10,-2,-4,7,5,13,8,2,3,1,1,7,4,1,0,6,4,6,4,1,3,169,81,88,27,13,14,45,21,49,36,7,7,20,11,18,23,4,3,25,10,31,13,3,4,6,4,11,3,3,0,3,1,5,2,2,0,3,3,6,1,1,0,156,75,81,55,34,21,20,21,61,29,19,8,9,14,33,11,1,8,11,7,28,18,18,0,15,9,16,10,4,1,9,6,11,7,0,1,6,3,5,3,4,0,-63,-18,-45,35,15,20,-35,-12,12,-25,-7,2,-10,-7,12,-7,-6,-1,-25,-5,0,-18,-1,3,8,2,9,5,8,3,2,2,4,3,4,0,6,0,5,2,4,3,-23,-5,-18,38,17,21,-20,18,-4,-8,-3,-3,-14,9,4,-3,-1,0,-6,9,-8,-5,-2,-3,5,14,6,2,9,0,0,7,3,1,5,0,5,7,3,1,4,0,5,-5,10,36,12,24,-1,9,15,-8,-10,0,-3,4,12,-9,-2,-3,2,5,3,1,-8,3,5,9,6,10,3,3,4,1,1,4,1,1,1,8,5,6,2,2,124,72,52,12,4,8,33,21,69,10,8,-13,22,16,24,9,8,-5,11,5,45,1,0,-8,0,4,13,-2,-1,-3,-1,0,4,1,0,-1,1,4,9,-3,-1,-2,70,54,16,8,3,5,1,14,39,19,1,-4,6,16,11,13,4,1,-5,-2,28,6,-3,-5,0,5,7,-5,1,-2,-2,4,3,-4,1,0,2,1,4,-1,0,-2,36,32,4,-12,-4,-8,31,-6,18,-5,-1,-4,11,1,22,5,-6,0,20,-7,-4,-10,5,-4,-1,0,-4,-3,-4,-2,1,-1,-4,1,0,-2,-2,1,0,-4,-4,0,-89,-26,-63,-64,-34,-30,-34,-7,-21,-27,-4,0,-16,-4,6,-16,4,-3,-18,-3,-27,-11,-8,3,-6,-4,-26,-20,-4,-6,-4,-3,-11,-15,0,-3,-2,-1,-15,-5,-4,-3,-11,-6,-5,-20,-15,-5,10,4,-3,-13,7,-3,11,6,-7,-16,5,0,-1,-2,4,3,2,-3,2,-3,-7,-11,-3,0,0,-3,-7,-6,0,-1,2,0,0,-5,-3,1,125,81,44,4,9,-5,17,15,38,33,9,10,15,16,15,14,10,8,2,-1,23,19,-1,2,-7,4,8,-5,3,0,-4,3,8,-2,3,0,-3,1,0,-3,0,0,112,45,67,10,7,3,36,18,25,5,19,5,24,6,6,-2,7,4,12,12,19,7,12,1,-2,2,4,3,4,-1,0,-2,3,3,3,0,-2,4,1,0,1,-1,-2,8,-10,31,19,12,-21,9,2,19,3,-11,-9,5,-2,18,3,-5,-12,4,4,1,0,-6,8,4,6,4,3,3,6,2,2,5,0,1,2,2,4,-1,3,2,95,44,51,27,13,14,2,22,65,24,0,-15,-7,13,29,13,-1,-3,9,9,36,11,1,-12,6,8,4,-1,9,0,3,7,5,-5,2,0,3,1,-1,4,7,0
18,18135,Montefrío,7028,-69,-53,-16,4,3,1,-3,-35,-15,-11,4,-7,1,-34,-15,-4,2,-3,-4,-1,0,-7,2,-4,0,1,2,0,0,1,0,0,2,0,0,1,0,1,0,0,0,0,-59,-33,-26,4,2,2,-1,-28,-22,-4,6,-9,0,-16,-15,0,4,-5,-1,-12,-7,-4,2,-4,0,2,1,1,0,0,0,1,0,1,0,0,0,1,1,0,0,0,-94,-46,-48,8,8,0,-13,-29,-20,-2,-15,-11,-10,-13,-11,4,-7,-7,-3,-16,-9,-6,-8,-4,3,0,3,3,0,-1,2,-1,3,5,0,-1,1,1,0,-2,0,0,15,16,-1,38,20,18,22,-15,11,6,4,-13,18,-9,9,1,4,-5,4,-6,2,5,0,-8,14,4,9,6,5,0,7,3,5,3,2,0,7,1,4,3,3,0,-48,-23,-25,58,32,26,-10,-20,-14,-5,1,-5,-8,-10,-2,-6,1,-1,-2,-10,-12,1,0,-4,14,12,10,15,4,1,8,7,7,6,2,1,6,5,3,9,2,0,-44,-24,-20,27,12,15,-2,-21,-31,9,14,-13,2,-10,-20,2,10,-8,-4,-11,-11,7,4,-5,1,3,6,7,9,1,1,1,0,4,6,0,0,2,6,3,3,1,-20,0,-20,35,20,15,-7,-10,-10,8,8,-10,4,-2,-7,7,5,-7,-11,-8,-3,1,3,-3,5,4,7,11,7,1,3,2,4,8,3,0,2,2,3,3,4,1,-27,-6,-21,58,42,16,-5,-4,-5,0,-4,-12,-6,5,1,1,0,-9,1,-9,-6,-1,-4,-3,8,7,21,8,12,0,6,5,13,7,9,0,2,2,8,1,3,0,-48,-22,-26,28,18,10,-24,1,-15,0,-2,-11,-16,3,-4,-2,-1,-3,-8,-2,-11,2,-1,-8,0,3,7,9,6,2,0,3,5,6,3,1,0,0,2,3,3,1,-11,-2,-9,27,15,12,12,-1,-21,7,5,-13,5,0,-6,0,4,-4,7,-1,-15,7,1,-9,5,2,6,5,7,2,2,1,5,3,3,1,3,1,1,2,4,1,-24,5,-29,25,15,10,9,-5,-14,8,1,-22,6,3,3,8,0,-16,3,-8,-17,0,1,-6,5,2,1,10,6,1,2,2,1,7,3,0,3,0,0,3,3,1,-47,-23,-24,11,8,3,-9,-3,-16,-2,-3,-11,-5,1,-9,2,-3,-8,-4,-4,-7,-4,0,-3,2,2,4,6,-2,-1,2,1,1,5,-1,0,0,1,3,1,-1,-1,-75,-22,-53,4,1,3,-20,-13,-25,-10,-4,-2,-9,-2,-6,-3,-2,1,-11,-11,-19,-7,-2,-3,-2,0,-1,4,3,0,-2,0,-1,2,2,0,0,0,0,2,1,0,-45,-23,-22,5,5,0,-14,3,-18,-7,1,-7,-15,-1,-4,-4,1,1,1,4,-14,-3,0,-8,1,1,2,0,1,0,0,2,2,0,1,0,1,-1,0,0,0,0,-21,6,-27,10,8,2,-11,-1,-19,5,1,6,-2,1,-4,7,4,1,-9,-2,-15,-2,-3,5,0,-1,5,4,2,0,0,-1,4,4,1,0,0,0,1,0,1,0,-43,-12,-31,-2,-2,0,-12,-15,-13,-14,4,12,0,-9,1,-9,4,3,-12,-6,-14,-5,0,9,-1,0,-1,-2,2,0,-1,0,-1,-1,1,0,0,0,0,-1,1,0,-64,-27,-37,14,12,2,-6,-8,-22,-4,-8,-14,-6,-2,-12,5,-3,-8,0,-6,-10,-9,-5,-6,3,7,0,2,3,-1,1,7,1,2,2,-1,2,0,-1,0,1,0,45,37,8,45,26,19,14,0,13,3,15,1,9,5,9,2,9,2,5,-5,4,1,6,-1,7,9,8,7,12,1,3,7,5,1,9,0,4,2,3,6,3,1
18,18140,Motril,50398,360,240,120,302,203,99,120,42,90,63,34,8,78,30,54,46,17,13,42,12,36,17,17,-5,48,69,105,53,16,9,31,49,71,38,8,5,17,20,34,15,8,4,711,444,267,664,388,276,94,161,253,112,22,35,59,90,163,77,10,23,35,71,90,35,12,12,93,178,235,98,31,11,53,90,149,59,17,7,40,88,86,39,14,4,952,504,448,891,467,424,185,190,289,188,45,25,90,93,181,95,17,13,95,97,108,93,28,12,141,263,258,147,52,19,71,130,149,77,25,9,70,133,109,70,27,10,910,443,467,827,429,398,141,186,238,134,76,94,58,80,144,69,36,41,83,106,94,65,40,53,119,236,252,135,47,20,53,107,156,71,28,6,66,129,96,64,19,14,1136,544,592,1078,532,546,146,356,349,165,76,27,70,170,152,96,35,11,76,186,197,69,41,16,115,352,382,169,40,14,59,172,191,85,16,6,56,180,191,84,24,8,1266,649,617,1037,531,506,196,364,316,222,103,38,98,171,182,122,48,16,98,193,134,100,55,22,142,324,309,166,63,18,81,150,162,97,31,4,61,174,147,69,32,14,644,380,264,801,432,369,129,163,133,135,49,23,55,110,86,83,22,17,74,53,47,52,27,6,132,251,218,127,42,20,67,136,122,71,22,7,65,115,96,56,20,13,298,206,92,715,392,323,67,159,21,24,20,-10,63,85,26,9,15,-4,4,74,-5,15,5,-6,104,255,177,123,37,9,50,139,102,71,18,7,54,116,75,52,19,2,-128,-79,-49,118,40,78,4,25,-117,-21,-18,6,11,-22,-44,-11,-10,-4,-7,47,-73,-10,-8,10,52,60,1,3,-14,10,37,14,-1,-12,-10,6,15,46,2,15,-4,4,16,44,-28,215,91,124,-2,16,-32,-22,12,39,-12,27,20,-21,8,17,10,-11,-52,-1,4,22,60,58,62,22,4,5,26,25,28,7,3,0,34,33,34,15,1,5,-106,-114,8,46,9,37,5,-54,-93,-14,9,26,2,-31,-67,-31,4,6,3,-23,-26,17,5,20,-1,37,-7,-12,8,14,-5,14,-3,-13,4,8,4,23,-4,1,4,6,-72,-41,-31,113,42,71,-18,-22,-79,-3,31,3,-6,-35,-39,3,11,17,-12,13,-40,-6,20,-14,46,17,3,13,20,9,21,0,-2,5,9,7,25,17,5,8,11,2,-163,-129,-34,-79,-74,-5,5,-56,-84,-46,16,-5,9,-20,-100,-11,-4,-3,-4,-36,16,-35,20,-2,6,2,-46,-47,3,-2,2,-3,-42,-29,-4,2,4,5,-4,-18,7,-4,104,-2,106,126,49,77,72,5,-33,38,4,9,21,-14,-48,19,6,5,51,19,15,19,-2,4,31,52,17,7,-2,12,21,28,-5,-4,-4,6,10,24,22,11,2,6,-344,-196,-148,-293,-169,-124,-29,-59,-141,-100,-39,10,-3,-27,-89,-63,-27,12,-26,-32,-52,-37,-12,-2,-38,12,-116,-108,-48,-6,-12,15,-63,-77,-32,-4,-26,-3,-53,-31,-16,-2,-605,-324,-281,-480,-254,-226,-1,-4,-236,-261,-73,-23,6,-11,-116,-156,-32,-6,-7,7,-120,-105,-41,-17,-13,41,-167,-208,-90,-46,-1,15,-77,-120,-50,-23,-12,26,-90,-88,-40,-23,304,191,113,286,171,115,52,25,49,111,56,-5,33,12,33,74,26,1,19,13,16,37,30,-6,41,76,79,55,21,8,25,39,48,33,16,5,16,37,31,22,5,3,59,32,27,80,46,34,25,37,-52,-21,36,18,14,38,-28,-11,12,-1,11,-1,-24,-10,24,19,0,97,17,-26,-9,-8,-3,71,14,-32,0,-9,3,26,3,6,-9,1
18,18145,Ogíjares,8502,363,188,175,28,10,18,89,46,113,75,15,16,59,22,48,42,7,7,30,24,65,33,8,9,9,3,4,3,6,3,3,1,0,2,2,2,6,2,4,1,4,1,473,252,221,32,15,17,75,83,147,86,64,19,40,46,85,36,37,8,35,37,62,50,27,11,11,4,9,4,3,1,4,2,6,1,1,1,7,2,3,3,2,0,477,252,225,42,19,23,59,67,177,100,36,24,32,36,83,61,20,12,27,31,94,39,16,12,8,10,8,4,8,1,4,4,5,2,4,0,4,6,3,2,4,1,570,303,267,46,23,23,130,83,192,118,28,11,73,45,93,70,14,6,57,38,99,48,14,5,10,10,14,8,4,0,6,1,10,3,3,0,4,9,4,5,1,0,422,195,227,64,28,36,98,68,125,75,33,29,41,22,53,46,21,13,57,46,72,29,12,16,14,14,17,5,9,4,5,7,5,2,6,2,9,7,12,3,3,2,52,23,29,38,19,19,-15,14,75,-16,-9,2,-7,8,42,-14,-8,3,-8,6,33,-2,-1,-1,8,7,12,7,4,0,6,2,8,2,1,0,2,5,4,5,3,0,44,58,-14,39,23,16,-4,-12,25,17,21,3,-1,2,41,11,10,-2,-3,-14,-16,6,11,5,7,7,12,3,9,1,3,3,9,1,6,1,4,4,3,2,3,0,109,28,81,76,35,41,9,1,43,25,17,15,10,0,-3,17,2,3,-1,1,46,8,15,12,15,19,23,9,10,0,7,8,13,6,2,-1,8,11,10,3,8,1,19,-3,22,21,13,8,27,0,-11,10,-7,11,13,-9,-9,5,1,1,14,9,-2,5,-8,10,12,11,1,1,0,-4,8,3,3,-1,1,-1,4,8,-2,2,-1,-3,-1,-2,1,-31,-11,-20,12,0,-5,-4,-13,15,13,-4,2,-8,-4,4,-1,4,-7,4,-9,11,-4,-2,-12,-7,-3,-2,-2,-3,-5,-1,1,-1,-2,1,-7,-6,-4,-1,10,-22,32,28,8,20,15,-10,-37,7,13,27,-6,-4,-15,-11,4,9,21,-6,-22,18,9,18,12,7,3,2,2,2,4,4,-2,-2,2,1,8,3,5,4,0,1,19,21,-2,9,-4,13,10,-37,5,22,-3,21,-1,-14,18,16,-4,6,11,-23,-13,6,1,15,1,-2,7,1,-1,2,-3,-3,2,-2,1,1,4,1,5,3,-2,1,154,36,118,9,5,4,42,27,1,31,15,33,16,9,-12,7,2,10,26,18,13,24,13,23,5,1,0,2,1,0,1,1,0,3,0,0,4,0,0,-1,1,0,14,-12,26,5,3,2,26,3,-24,-5,18,1,15,-7,-22,-6,13,-4,11,10,-2,1,5,5,2,2,0,-2,2,-1,3,0,0,0,1,-2,-1,2,0,-2,1,1,-7,1,-8,-32,-17,-15,33,7,-51,-6,5,9,26,-6,-17,-15,12,4,7,13,-34,9,-7,5,1,-5,-12,-5,-9,-2,4,-6,-5,-5,-4,-1,-3,1,-7,0,-5,-1,-21,-17,-4,-8,-1,-7,2,-22,9,6,-29,17,5,-10,3,-8,-17,6,-3,-12,6,14,-12,11,-5,3,-3,-7,2,2,-3,4,-1,-5,2,2,-2,-1,-2,-2,0,0,28,17,11,-55,-35,-20,8,1,-24,14,30,-4,8,4,-11,-1,17,-3,0,-3,-13,15,13,-1,-4,-1,-20,-22,-2,-6,-3,-3,-8,-15,-3,-3,-1,2,-12,-7,1,-3,161,89,72,2,7,-5,70,12,57,41,-10,-18,41,1,31,16,-5,-2,29,11,26,25,-5,-16,4,1,4,-5,1,-4,5,3,3,-4,-2,1,-1,-2,1,-1,3,-5
18,18147,Órgiva,5123,-33,-14,-19,4,2,2,3,-14,-19,9,-3,-9,-3,-10,-11,13,0,-2,6,-4,-8,-4,-3,-7,1,1,0,2,0,0,0,1,0,1,0,0,1,0,0,1,0,0,52,33,19,42,23,19,17,12,14,1,15,-8,13,6,8,0,9,-3,4,6,6,1,6,-5,5,5,16,4,11,0,3,1,11,2,6,0,2,4,5,2,5,0,51,18,33,64,24,40,12,-16,-5,37,17,4,-1,-6,-7,18,9,4,13,-10,2,19,8,0,15,2,6,24,14,1,2,1,0,12,6,2,13,1,6,12,8,-1,89,45,44,127,67,60,31,4,19,21,17,-9,16,1,4,12,13,-4,15,3,15,9,4,-5,35,7,30,32,16,1,19,3,14,17,10,1,16,4,16,15,6,0,110,76,34,132,78,54,9,10,53,13,39,-17,1,8,34,7,29,-5,8,2,19,6,10,-12,11,17,40,25,33,4,5,7,19,16,26,3,6,10,21,9,7,1,37,30,7,117,64,53,11,-10,22,12,11,-10,8,-4,14,4,10,-2,3,-6,8,8,1,-8,17,11,42,28,16,1,8,8,24,12,11,1,9,3,18,16,5,0,71,30,41,119,54,65,18,10,22,9,21,-8,4,4,9,4,13,-2,14,6,13,5,8,-6,22,16,30,28,18,3,12,10,12,11,9,0,10,6,18,17,9,3,141,94,47,157,84,73,29,19,22,31,27,14,21,10,17,18,14,13,8,9,5,13,13,1,29,26,31,25,30,16,13,14,18,15,14,9,16,12,13,10,16,7,36,26,10,66,29,37,2,-3,5,14,30,-12,-4,-1,2,16,14,-1,6,-2,3,-2,16,-11,5,4,7,18,27,5,0,1,2,9,13,4,5,3,5,9,14,1,147,74,73,63,32,31,5,19,35,23,42,22,1,12,18,11,24,8,4,7,17,12,18,14,9,9,11,9,24,-2,3,4,5,7,11,0,6,5,6,2,13,-2,10,9,1,74,43,31,-12,-4,-10,-2,20,21,-2,-1,0,-3,9,9,-10,-3,-10,1,11,12,16,11,12,20,14,1,10,8,11,7,7,0,6,3,1,13,7,1,63,21,42,56,24,32,6,7,4,4,18,21,6,0,-7,-1,15,6,0,7,11,5,3,15,10,11,7,10,15,2,7,2,1,3,9,1,3,9,6,7,6,1,34,21,13,31,14,17,10,7,4,6,5,4,3,10,-7,8,4,5,7,-3,11,-2,1,-1,8,12,-4,1,9,3,3,10,-6,-1,7,1,5,2,2,2,2,2,46,42,4,24,23,1,18,-2,23,-3,15,-9,16,-2,18,6,3,-2,2,0,5,-9,12,-7,12,12,-3,-3,7,-1,10,15,-3,1,0,0,2,-3,0,-4,7,-1,44,30,14,59,35,24,5,-13,-7,5,47,5,5,-6,5,-7,29,4,0,-7,-12,12,18,1,-2,14,-7,8,32,13,0,13,-3,-1,18,8,-2,1,-4,9,14,5,96,53,43,92,55,37,28,2,-4,30,36,6,22,4,-5,13,18,2,6,-2,1,17,18,4,24,13,10,16,21,8,22,12,1,5,11,4,2,1,9,11,10,4,26,17,9,24,15,9,15,-10,5,4,17,-3,7,-8,5,0,18,-4,8,-2,0,4,-1,1,5,9,5,1,7,-3,2,9,1,-1,3,1,3,0,4,2,4,-4,-80,-41,-39,-53,-14,-39,-1,-29,-14,-6,-16,-10,2,-17,-1,-6,-10,-9,-3,-12,-13,0,-6,-1,9,-1,0,-22,-11,-28,9,6,1,-10,-1,-19,0,-7,-1,-12,-10,-9
18,18149,Otura,4058,226,118,108,15,6,9,28,44,67,45,32,3,22,20,31,22,15,5,6,24,36,23,17,-2,2,5,2,2,2,1,1,1,2,1,0,0,1,4,0,1,2,1,103,58,45,9,4,5,0,22,37,20,14,10,1,19,19,9,7,4,-1,3,18,11,7,6,3,1,2,2,0,1,1,0,1,1,0,1,2,1,1,1,0,0,167,88,79,27,15,12,22,28,54,36,25,2,14,16,27,19,16,-1,8,12,27,17,9,3,8,4,8,4,2,1,5,1,4,3,1,1,3,3,4,1,1,0,142,72,70,6,2,4,21,17,37,38,13,10,9,9,25,16,4,6,12,8,12,22,9,4,1,1,1,-1,4,0,0,0,0,0,2,0,1,1,1,-1,2,0,136,76,60,9,5,4,28,7,28,34,29,7,14,6,9,25,15,4,14,1,19,9,14,3,1,0,1,3,4,0,0,0,0,3,2,0,1,0,1,0,2,0,136,79,57,31,15,16,13,11,22,45,29,12,7,10,16,24,17,4,6,1,6,21,12,8,2,8,6,5,8,2,3,4,1,3,3,1,-1,4,5,2,5,1,249,132,117,48,31,17,64,29,63,65,17,8,32,18,30,37,13,1,32,11,33,28,4,7,13,20,13,1,1,0,9,11,10,0,1,0,4,9,3,1,0,0,184,121,63,37,31,6,50,22,20,62,19,12,32,21,13,37,12,8,18,1,7,25,7,4,11,14,3,8,0,1,8,13,2,7,1,0,3,1,1,1,-1,1,253,135,118,39,25,14,67,30,70,58,12,10,42,21,27,30,7,3,25,9,43,28,5,7,12,13,13,1,0,0,10,8,7,0,0,0,2,5,6,1,0,0,158,62,96,22,11,11,52,-5,33,34,29,9,34,-18,9,15,16,0,18,13,24,19,13,9,4,7,5,0,5,0,3,4,3,-1,1,0,1,3,2,1,4,0,141,71,70,16,11,5,46,5,23,40,17,6,25,2,21,8,10,3,21,3,2,32,7,3,3,7,-3,6,3,0,3,6,-2,2,2,0,0,1,-1,4,1,0,139,54,85,13,5,8,64,-10,32,36,19,3,24,-4,16,13,7,-1,40,-6,16,23,12,4,5,2,3,2,-3,2,4,0,1,0,-3,1,1,2,2,2,0,1,-86,-28,-58,2,0,2,-20,-9,-42,-17,2,-1,0,-11,-20,-1,2,1,-20,2,-22,-16,0,-2,0,2,-4,-1,4,0,1,0,-4,0,3,0,-1,2,0,-1,1,0,-73,-49,-24,-35,-25,-10,-5,-38,-38,-4,-7,5,-18,-22,-16,3,-7,2,13,-16,-22,-7,0,3,-4,-13,-14,-3,-3,-2,-5,-12,-7,0,-2,-1,1,-1,-7,-3,-1,-1,-75,-45,-30,10,6,4,-18,-5,-18,-20,-8,-11,-20,2,-12,-9,-1,-5,2,-7,-6,-11,-7,-6,2,5,2,-2,1,0,-1,5,2,-1,0,0,3,0,0,-1,1,0,61,35,26,32,28,4,22,0,-6,35,3,9,8,1,0,26,1,2,14,-1,-6,9,2,7,10,11,4,2,4,1,10,9,3,4,2,0,0,2,1,-2,2,1,33,11,22,1,1,0,10,16,-13,12,-1,7,5,12,-1,-8,-1,0,5,4,-12,20,0,7,-4,3,1,-6,4,2,-2,3,2,-6,2,1,-2,0,-1,0,2,1,93,41,52,22,17,5,30,-4,20,16,16,6,15,-3,-1,12,15,-2,15,-1,21,4,1,8,5,2,6,0,5,4,4,1,4,3,3,2,1,1,2,-3,2,2
18,18157,Pinos Genil,1159,24,10,14,10,7,3,10,3,3,8,-2,2,6,1,-2,4,0,1,4,2,5,4,-2,1,3,3,3,1,0,0,3,2,2,0,0,0,0,1,1,1,0,0,48,22,26,10,5,5,3,19,16,8,1,1,3,9,9,2,-1,0,0,10,7,6,2,1,2,3,4,1,0,0,2,1,2,0,0,0,0,2,2,1,0,0,-10,-2,-8,7,3,4,-1,3,-8,-7,5,0,-4,3,0,-3,3,0,3,0,-8,-4,2,0,1,3,1,0,2,0,0,1,1,0,1,0,1,2,0,0,1,0,9,6,3,3,1,2,-2,-2,13,1,-3,2,-2,3,6,1,-3,1,0,-5,7,0,0,1,0,0,3,0,0,0,0,0,1,0,0,0,0,0,2,0,0,0,14,6,8,3,2,1,8,1,-2,11,-2,-2,0,-1,3,4,0,0,8,2,-5,7,-2,-2,1,2,-1,1,0,0,1,0,0,1,0,0,0,2,-1,0,0,0,-14,-4,-10,5,2,3,-12,-11,-1,2,3,6,-4,-5,-3,3,1,4,-8,-6,2,-1,2,2,0,1,3,0,0,1,0,0,1,0,0,1,0,1,2,0,0,0,14,3,11,6,2,4,-3,8,-4,13,-3,3,-2,1,-3,6,-1,2,-1,7,-1,7,-2,1,0,0,1,4,0,1,0,0,0,1,0,1,0,0,1,3,0,0,-6,-1,-5,6,1,5,-7,-1,4,6,-2,-5,-2,-3,0,5,2,-3,-5,2,4,1,-4,-2,0,1,4,1,0,0,0,1,0,0,0,0,0,0,4,1,0,0,-9,-2,-7,2,1,1,-1,1,-6,-4,1,0,2,1,-3,-3,1,0,-3,0,-3,-1,0,0,0,0,1,0,1,0,0,0,1,-1,1,0,0,0,0,1,0,0,10,14,-4,3,2,1,7,4,-3,4,-2,1,7,4,2,1,0,1,0,0,-5,3,-2,0,0,1,3,0,-1,0,0,1,1,0,0,0,0,0,2,0,-1,0,-22,-15,-7,-1,0,-1,0,-5,-7,-7,-2,-2,-2,-1,-4,-6,-1,-1,2,-4,-3,-1,-1,-1,0,0,0,-1,0,0,0,0,1,-1,0,0,0,0,-1,0,0,0,25,9,16,6,4,2,6,3,-1,8,7,2,2,0,-4,5,5,1,4,3,3,3,2,1,2,1,0,2,0,1,1,1,0,1,0,1,1,0,0,1,0,0,-9,-2,-7,2,-1,3,-2,-5,-2,2,-3,1,-1,-1,1,0,-1,-1,-1,-4,-3,2,-2,2,1,0,1,1,0,-1,0,0,0,0,0,-1,1,0,1,1,0,0,4,-8,12,4,2,2,1,-7,-2,10,1,0,-3,-6,-7,4,2,1,4,-1,5,6,-1,-1,1,0,3,0,0,0,1,0,1,0,0,0,0,0,2,0,0,0,19,14,5,2,1,1,6,6,2,6,0,-1,3,5,1,4,1,0,3,1,1,2,-1,-1,2,0,-1,0,1,0,1,0,-1,0,1,0,1,0,0,0,0,0,3,6,-3,5,3,2,-9,11,7,-3,-1,-2,-6,7,7,-1,2,-2,-3,4,0,-2,-3,0,0,2,1,0,0,2,0,1,1,0,0,1,0,1,0,0,0,1,-30,-11,-19,-2,-1,-1,0,-3,-9,-4,-9,-2,-1,-1,-4,3,-5,-3,1,-2,-5,-7,-4,1,0,-1,-1,2,-2,0,0,-1,-1,1,0,0,0,0,0,1,-2,0,20,9,11,-6,-8,2,9,2,-2,12,4,-4,3,-1,-2,10,3,-3,6,3,0,2,1,-1,0,-1,-1,-1,-2,-2,-2,-1,-1,0,-2,-2,2,0,0,-1,0,0
18,18158,Pinos Puente,13524,-118,-50,-68,25,13,12,-29,-12,-57,-6,-7,-2,-17,1,-28,-2,-5,2,-12,-13,-29,-4,-2,-4,5,3,4,7,3,3,1,1,2,5,2,2,4,2,2,2,1,1,-107,-40,-67,19,12,7,-9,-46,-43,-2,1,-6,-5,-18,-26,5,6,0,-4,-28,-17,-7,-5,-6,6,3,4,4,2,0,2,3,2,3,2,0,4,0,2,1,0,0,-157,-56,-101,20,10,10,-38,-41,-60,-8,10,-22,-21,-21,-16,0,9,-9,-17,-20,-44,-8,1,-13,7,1,1,5,4,2,5,-1,0,2,3,1,2,2,1,3,1,1,-96,-40,-56,38,21,17,-7,-18,-68,-8,11,-6,4,-9,-33,-4,3,0,-11,-9,-35,-4,8,-6,8,10,6,8,2,3,8,4,3,4,1,1,0,6,3,4,1,2,-47,-14,-33,45,20,25,-6,-20,-42,17,1,4,0,-10,-21,10,4,4,-6,-10,-21,7,-3,0,5,11,13,10,5,1,2,4,6,5,3,0,3,7,7,5,2,1,17,39,-22,48,23,25,21,-11,0,-10,13,0,13,5,3,3,11,0,8,-16,-3,-13,2,0,8,15,14,3,4,3,2,7,9,1,2,1,6,8,5,2,2,2,-39,-4,-35,42,21,21,5,-10,-21,-1,2,-16,8,-4,-8,3,0,-5,-3,-6,-13,-4,2,-11,3,15,8,9,4,3,1,6,4,6,2,2,2,9,4,3,2,1,10,28,-18,56,37,19,38,9,-13,-8,-8,-20,17,9,1,1,-1,-7,21,0,-14,-9,-7,-13,10,6,16,14,8,0,4,4,10,11,6,0,6,2,6,3,2,0,-37,-4,-33,37,25,12,16,-40,5,-6,-3,-10,13,-25,9,-4,3,-1,3,-15,-4,-2,-6,-9,2,10,10,9,6,0,3,5,7,6,4,0,-1,5,3,3,2,0,-35,-10,-25,37,17,20,-13,-6,-29,6,3,2,-13,1,-5,7,-2,2,0,-7,-24,-1,5,0,5,12,6,9,4,3,4,5,1,6,1,1,1,7,5,3,3,2,-84,-40,-44,13,4,9,1,-10,-33,-15,-5,-22,-7,-8,-18,-3,-1,-1,8,-2,-15,-12,-4,-21,5,6,8,-4,-2,0,1,3,5,-3,-2,0,4,3,3,-1,0,0,-139,-48,-91,9,0,9,-16,-11,-59,-24,-8,-20,6,-7,-26,-12,1,-11,-22,-4,-33,-12,-9,-9,4,4,4,-4,-1,1,2,2,2,-5,-1,0,2,2,2,1,0,1,-163,-101,-62,-2,-3,1,-22,-31,-53,-26,-14,-14,-8,-17,-31,-24,-12,-7,-14,-14,-22,-2,-2,-7,9,-1,-2,-3,-2,-3,4,0,-2,-2,-1,-2,5,-1,0,-1,-1,-1,-73,-19,-54,-15,-12,-3,-16,-5,-38,-5,5,-8,-7,-4,-13,4,5,-1,-9,-1,-25,-9,0,-7,-2,-1,-10,0,-2,0,0,-1,-10,-1,0,0,-2,0,0,1,-2,0,-139,-65,-74,-44,-24,-20,-39,-27,-49,-20,-1,-3,-17,-23,-21,-10,4,1,-22,-4,-28,-10,-5,-4,-2,-7,-17,-8,-9,-2,-1,-2,-9,-5,-7,-1,-1,-5,-8,-3,-2,-1,-124,-49,-75,-3,-5,2,-26,-19,-53,-15,2,-7,-3,-6,-24,-8,4,-4,-23,-13,-29,-7,-2,-3,-2,3,-4,-4,1,2,-1,0,-3,-3,0,2,-1,3,-1,-1,1,0,-190,-111,-79,-8,-7,-1,-51,-24,-59,-30,-12,-8,-32,-13,-41,-20,-4,3,-19,-11,-18,-10,-8,-11,-1,-4,3,-3,-4,1,1,-2,0,-3,-3,0,-2,-2,3,0,-1,1,-129,-49,-80,5,3,2,-9,-7,-42,-29,-18,-21,0,3,-23,-11,-6,-12,-9,-10,-19,-18,-12,-9,4,4,2,-1,0,-4,1,3,3,-1,-1,-2,3,1,-1,0,1,-2
18,18173,Salobreña,10255,70,38,32,11,6,5,6,7,15,22,17,4,7,4,12,5,11,0,-1,3,3,17,6,4,2,0,0,3,4,2,1,0,0,3,2,0,1,0,0,0,2,2,56,16,40,9,7,2,10,-6,5,18,26,2,1,-9,0,4,18,0,9,3,5,14,8,2,2,0,1,3,1,1,1,0,1,3,1,0,1,0,0,0,0,1,79,55,24,0,-1,1,19,2,4,-2,41,8,25,3,-4,0,20,7,-6,-1,8,-2,21,1,1,1,-2,1,0,-1,0,1,0,-1,-1,0,1,0,-2,2,1,-1,164,82,82,21,10,11,22,32,43,33,18,15,15,11,15,21,12,11,7,21,28,12,6,4,5,3,5,2,3,1,2,2,1,1,4,0,3,1,4,1,-1,1,248,144,104,161,83,78,39,22,71,50,52,15,17,6,49,27,32,12,22,16,22,23,20,3,23,29,37,28,35,9,10,11,23,16,18,5,13,18,14,12,17,4,213,114,99,165,87,78,41,19,64,52,34,4,16,16,27,32,24,-3,25,3,37,20,10,7,25,29,42,36,32,1,13,20,19,21,14,0,12,9,23,15,18,1,231,111,120,158,75,83,56,48,19,63,36,9,30,26,-3,26,24,10,26,22,22,37,12,-1,33,29,32,38,20,6,16,12,15,18,10,4,17,17,17,20,10,2,334,150,184,193,91,102,64,64,60,66,53,26,26,22,32,36,23,11,38,42,28,30,30,15,40,44,34,33,28,13,19,17,16,18,16,5,21,27,18,15,12,8,41,24,17,75,26,49,10,-29,4,6,30,15,13,-11,-9,1,15,12,-3,-18,13,5,15,3,11,10,13,3,25,10,8,3,2,-3,9,7,3,7,11,6,16,3,50,33,17,52,27,25,2,-17,-20,3,58,23,6,-11,0,3,25,8,-4,-6,-20,0,33,15,9,-5,6,4,25,13,8,-3,6,1,11,4,1,-2,0,3,14,9,64,47,17,54,24,30,-5,-1,-14,3,62,17,1,2,-16,4,30,23,-6,-3,2,-1,32,-6,7,2,-4,3,31,15,3,0,-6,3,13,11,4,2,2,0,18,4,-111,-31,-80,-7,-6,-1,-7,-19,-49,-11,-8,-13,-1,-4,-12,-9,1,-6,-6,-15,-37,-2,-9,-7,-5,-1,-2,-6,-2,8,-4,1,-4,-6,1,5,-1,-2,2,0,-3,3,-127,-81,-46,-83,-56,-27,-26,-3,-26,-21,-16,-34,-20,1,-25,-13,-6,-17,-6,-4,-1,-8,-10,-17,-14,-5,-23,-24,2,-20,-6,-4,-19,-15,1,-14,-8,-1,-4,-9,1,-6,-70,-49,-21,-55,-47,-8,-12,-24,-28,2,12,-21,-4,-22,-20,7,5,-16,-8,-2,-8,-5,7,-5,2,-1,-22,-5,-12,-17,-1,-7,-16,-4,-9,-10,3,6,-6,-1,-3,-7,7,27,-20,-15,-2,-13,1,0,-22,35,3,-10,-1,13,-10,25,1,-2,2,-13,-12,10,2,-8,-1,0,-8,-6,10,-13,-1,5,-1,-5,3,-5,0,-5,-7,-1,7,-8,-7,27,-34,6,10,-4,-18,-1,-1,-3,31,-24,-11,-8,19,6,23,-9,-7,7,-20,-9,8,-15,-3,12,2,-3,11,-15,-5,7,9,0,6,-9,2,5,-7,-3,5,-6,-11,20,-31,50,26,24,19,-18,12,-27,13,-9,17,-3,20,-23,17,-8,2,-15,-8,-4,-4,-1,9,10,9,4,18,-1,5,8,6,-1,11,-4,4,2,3,5,7,3,50,-8,58,28,0,28,23,-5,-38,9,23,38,5,4,-40,-2,9,18,18,-9,2,11,14,20,-1,-6,-6,9,14,15,-2,-4,-12,4,6,6,1,-2,6,5,8,9
18,18175,Santa Fe,12740,128,63,65,43,25,18,41,-13,55,24,13,4,21,-15,30,18,6,-1,20,2,25,6,7,5,13,3,18,5,3,1,7,2,11,3,2,0,6,1,7,2,1,1,167,74,93,38,17,21,35,21,41,32,19,11,17,9,18,12,8,6,18,12,23,20,11,5,14,8,6,7,2,0,6,4,3,4,0,0,8,4,3,3,2,0,205,98,107,71,35,36,45,11,51,40,24,28,26,2,32,20,10,6,19,9,19,20,14,22,14,14,13,14,13,3,8,4,6,10,5,2,6,10,7,4,8,1,188,88,100,52,29,23,32,16,28,56,20,35,10,7,10,39,10,12,22,9,18,17,10,23,12,7,10,14,6,3,5,4,7,10,2,1,7,3,3,4,4,2,410,186,224,125,64,61,103,55,120,76,30,24,44,24,52,38,18,9,59,31,68,38,12,15,18,27,44,20,10,6,10,18,18,10,5,3,8,9,26,10,5,3,149,79,70,107,53,54,11,41,53,12,26,7,7,23,25,5,14,3,4,18,28,7,12,4,22,35,24,13,10,3,12,19,8,7,5,2,10,16,16,6,5,1,315,167,148,117,56,61,70,44,93,53,44,6,38,24,48,34,15,4,32,20,45,19,29,2,27,23,34,14,13,0,11,9,19,9,4,0,16,14,15,5,9,0,101,39,62,104,54,50,6,28,30,-12,9,39,-11,16,16,4,5,11,17,12,14,-16,4,28,18,33,27,22,3,-1,8,20,12,11,2,0,10,13,15,11,1,-1,291,133,158,107,47,60,59,30,99,28,8,56,26,10,64,14,-7,18,33,20,35,14,15,38,15,35,24,17,7,7,4,11,17,8,1,4,11,24,7,9,6,3,4,-23,27,31,18,13,-16,-31,-20,18,-5,57,-13,-22,-12,10,7,7,-3,-9,-8,8,-12,50,-2,5,9,4,10,4,1,1,8,-1,7,1,-3,4,1,5,3,3,-65,-53,-12,27,12,15,-26,3,-39,-11,-6,7,-17,-4,-19,-7,-9,-1,-9,7,-20,-4,3,8,6,4,11,4,-1,2,4,2,3,1,1,1,2,2,8,3,-2,1,-23,-10,-13,-90,-56,-34,-12,-13,-5,-10,-8,12,-5,-4,3,-14,1,6,-7,-9,-8,4,-9,6,-12,-6,-39,-30,-2,-3,-7,-3,-27,-18,-1,0,-5,-3,-12,-12,-1,-3,0,4,-4,14,19,-5,-18,3,0,-16,17,1,-11,6,-9,2,13,-2,-7,-3,9,-18,4,3,2,17,-5,-1,4,-3,1,19,-3,2,2,-2,1,-2,-2,-3,2,-1,-85,-73,-12,-14,-12,-2,-21,-23,-21,-18,-10,2,-29,-13,-13,-11,-11,1,8,-10,-8,-7,1,1,-5,3,-10,-3,2,-1,-2,0,-9,-2,1,0,-3,3,-1,-1,1,-1,-102,-63,-39,-27,-17,-10,-25,-5,-32,-30,-15,5,-19,-12,-1,-23,-9,3,-6,7,-31,-7,-6,2,-2,-3,-8,-7,-7,0,-2,-2,-2,-7,-3,-1,0,-1,-6,0,-4,1,30,17,13,-7,-2,-5,16,-6,-3,3,-3,20,15,1,-5,5,0,0,1,-7,2,-2,-3,20,10,-12,-5,0,-1,2,8,-10,-1,2,-1,1,2,-2,-4,-2,0,1,-74,-60,-14,-2,-7,5,-19,-16,-15,-19,-20,17,-4,-8,-20,-22,-15,7,-15,-8,5,3,-5,10,1,1,0,2,-7,1,2,-2,-1,0,-6,0,-1,3,1,2,-1,1,75,50,25,48,33,15,-5,16,9,1,22,27,0,11,-2,17,12,6,-5,5,11,-16,10,21,4,16,14,13,3,-2,4,5,9,17,0,-2,0,11,5,-4,3,0
18,18182,Ugíjar,2499,-55,-30,-25,3,2,1,-14,-14,-13,0,-9,-4,-6,-12,-6,3,-6,-2,-8,-2,-7,-3,-3,-2,0,1,0,1,1,0,0,0,0,1,1,0,0,1,0,0,0,0,-49,-24,-25,3,2,1,-8,-14,-8,-12,-4,-3,-6,-6,-4,-6,-1,-1,-2,-8,-4,-6,-3,-2,0,1,1,0,0,1,0,1,0,0,0,1,0,0,1,0,0,0,25,21,4,10,8,2,9,-4,6,10,2,-4,9,-1,7,4,2,-2,0,-3,-1,6,0,-2,1,1,3,2,2,0,1,1,3,1,1,0,0,0,0,1,1,0,-4,13,-17,26,20,6,-2,-4,1,-7,6,1,0,4,5,1,2,1,-2,-8,-4,-8,4,0,7,4,4,6,3,2,5,4,4,4,2,1,2,0,0,2,1,1,4,11,-7,39,30,9,-4,-6,-10,11,10,2,-3,0,-2,8,7,1,-1,-6,-8,3,3,1,5,4,9,10,9,1,4,4,7,7,8,0,1,0,2,3,1,1,-14,6,-20,29,23,6,0,-4,-14,5,2,-3,0,5,-7,5,3,0,0,-9,-7,0,-1,-3,3,9,6,6,3,1,0,8,6,4,3,1,3,1,0,2,0,0,5,21,-16,26,24,2,-2,1,0,1,4,1,0,7,5,2,3,4,-2,-6,-5,-1,1,-3,1,10,4,6,3,2,1,10,3,5,3,2,0,0,1,1,0,0,17,35,-18,51,42,9,4,-3,13,-1,13,-12,11,2,14,-1,11,-5,-7,-5,-1,0,2,-7,11,7,17,10,4,0,11,7,12,7,3,0,0,0,5,3,1,0,-20,-16,-4,9,3,6,-4,-3,1,-2,-4,-9,-1,-4,-3,-1,-5,-3,-3,1,4,-1,1,-6,1,3,3,2,0,0,1,0,1,1,0,0,0,3,2,1,0,0,-9,-3,-6,5,-2,7,6,-5,0,-6,-1,-3,2,-1,1,-1,-3,0,4,-4,-1,-5,2,-3,3,0,3,-3,2,-1,1,-1,-1,-1,1,-1,2,1,4,-2,1,0,3,-6,9,8,-1,9,4,1,-4,3,1,-1,-2,1,-8,4,2,-2,6,0,4,-1,-1,1,8,1,-1,-1,2,-1,3,-1,-3,-1,2,-1,5,2,2,0,0,0,-55,-43,-12,-37,-39,2,-3,-8,-16,-15,-1,-12,-1,-7,-12,-13,-4,-7,-2,-1,-4,-2,3,-5,-9,-6,0,-14,-4,-4,-7,-8,-2,-14,-5,-3,-2,2,2,0,1,-1,22,13,9,9,3,6,7,-1,0,1,11,3,4,1,-2,-1,8,2,3,-2,2,2,3,1,0,2,3,1,1,2,0,1,2,0,0,0,0,1,1,1,1,2,6,9,-3,16,7,9,1,5,2,-2,4,-3,3,2,5,-1,1,-1,-2,3,-3,-1,3,-2,3,6,4,0,2,1,0,3,3,-1,1,1,3,3,1,1,1,0,-29,-12,-17,11,4,7,-12,-4,-17,2,-4,7,-10,1,-8,3,-2,4,-2,-5,-9,-1,-2,3,2,5,2,1,1,0,0,2,1,1,0,0,2,3,1,0,1,0,-22,-12,-10,6,3,3,-1,-1,-10,-4,-7,1,1,-3,-6,1,-5,0,-2,2,-4,-5,-2,1,3,0,1,1,0,0,2,-1,1,0,0,0,1,1,0,1,0,0,14,4,10,9,4,5,2,-6,7,5,9,-5,1,-7,-1,4,6,-2,1,1,8,1,3,-3,3,1,3,2,0,0,1,0,1,2,0,0,2,1,2,0,0,0,27,13,14,10,8,2,4,4,-1,6,12,1,6,1,0,1,6,0,-2,3,-1,5,6,1,2,1,3,2,1,-1,2,2,2,1,1,0,0,-1,1,1,0,-1
18,18911,Vegas del Genil,2791,167,91,76,5,2,3,38,16,75,18,18,0,22,5,41,12,10,0,16,11,34,6,8,0,0,2,2,0,1,0,0,0,1,0,1,0,0,2,1,0,0,0,403,200,203,6,2,4,90,63,160,65,20,3,35,24,89,37,11,3,55,39,71,28,9,0,1,0,1,1,3,0,0,0,0,0,2,0,1,0,1,1,1,0,427,229,198,17,8,9,70,79,169,66,27,13,47,32,92,37,14,5,23,47,77,29,13,8,2,10,3,3,-1,0,1,3,4,1,-1,0,1,7,-1,2,0,0,632,338,294,43,21,22,109,101,271,102,39,4,55,55,138,58,22,7,54,46,133,44,17,-3,8,17,8,7,3,0,3,10,4,3,1,0,5,7,4,4,2,0,687,390,297,126,79,47,104,129,299,98,30,14,63,68,167,60,15,7,41,61,132,38,15,7,10,49,42,20,1,1,2,30,30,14,0,1,8,19,12,6,1,0,679,374,305,86,51,35,105,142,278,95,35,17,70,71,155,48,23,4,35,71,123,47,12,13,9,30,35,3,5,2,7,16,21,2,4,1,2,14,14,1,1,1,572,304,268,41,15,26,51,133,247,62,40,34,15,74,147,25,22,18,36,59,100,37,18,16,8,17,8,4,1,2,1,14,-1,-2,2,1,7,3,9,6,-1,1,563,288,275,14,17,-3,73,85,232,83,40,39,43,32,125,48,23,16,30,53,107,35,17,23,4,13,-1,-6,2,1,4,13,5,-6,1,0,0,0,-6,0,1,1,243,118,125,-3,-11,8,18,20,115,33,19,33,12,7,54,22,11,8,6,13,61,11,8,25,-1,0,-6,0,2,2,-1,-3,-6,-1,0,0,0,3,0,1,2,2,374,197,177,-8,-6,-2,71,24,185,60,22,5,28,7,108,31,15,5,43,17,77,29,7,0,1,-8,-1,-2,1,1,3,-7,0,-3,0,1,-2,-1,-1,1,1,0,273,133,140,5,-4,9,33,32,118,53,11,19,14,15,64,24,8,7,19,17,54,29,3,12,-1,3,7,-1,-2,-2,1,-3,1,-2,1,-2,-2,6,6,1,-3,0,151,70,81,-9,-14,5,24,52,48,17,3,8,24,15,31,3,-6,4,0,37,17,14,9,4,6,0,-4,-9,0,-2,1,-3,-4,-5,-3,0,5,3,0,-4,3,-2,172,99,73,2,2,0,6,25,84,24,17,15,13,7,42,17,10,7,-7,18,42,7,7,8,0,5,1,-6,3,-1,0,2,1,-3,2,0,0,3,0,-3,1,-1,121,57,64,-15,-9,-6,26,10,56,2,7,10,30,-2,26,-4,1,1,-4,12,30,6,6,9,1,-2,-12,0,-1,-2,-2,0,-5,0,-1,-2,3,-2,-7,0,0,0,91,56,35,-21,0,-21,2,4,43,1,4,22,-3,0,37,7,-3,11,5,4,6,-6,7,11,-5,1,-7,-6,-5,0,0,2,0,-3,0,0,-5,-1,-7,-3,-5,0,60,10,50,-1,-1,0,17,-7,44,-16,4,15,7,0,22,-21,-1,5,10,-7,22,5,5,10,-3,0,3,-4,3,0,-2,0,2,-2,1,0,-1,0,1,-2,2,0,175,97,78,18,8,10,29,22,84,29,-1,5,18,9,47,21,-1,1,11,13,37,8,0,4,5,7,4,3,-1,0,5,2,1,3,-2,-1,0,5,3,0,1,1,121,58,63,22,10,12,38,5,74,-17,1,14,24,0,21,1,-1,11,14,5,53,-18,2,3,10,9,-2,5,1,-2,5,7,-3,0,0,0,5,2,1,5,1,-2
18,18193,"Zubia, La",12826,296,150,146,17,4,13,23,85,65,50,32,36,19,34,43,24,12,15,4,51,22,26,20,21,4,1,3,6,3,0,0,0,1,3,0,0,4,1,2,3,3,0,253,115,138,41,18,23,32,31,78,49,31,21,10,5,48,25,15,6,22,26,30,24,16,15,6,8,12,9,3,0,3,4,7,2,1,0,3,4,5,7,2,0,279,140,139,51,32,19,44,59,71,58,27,10,28,15,45,36,11,4,16,44,26,22,16,6,10,10,12,11,5,3,7,4,8,9,3,1,3,6,4,2,2,2,231,94,137,59,22,37,31,35,76,13,41,34,7,18,28,7,18,14,24,17,48,6,23,20,15,11,15,9,7,2,4,6,6,2,4,0,11,5,9,7,3,2,250,137,113,48,33,15,22,22,109,35,35,22,5,18,75,14,11,10,17,4,34,21,24,12,9,8,14,13,1,3,7,5,11,8,0,2,2,3,3,5,1,1,380,204,176,86,48,38,20,90,140,50,39,37,11,62,81,30,13,10,9,28,59,20,26,27,21,16,26,16,4,2,13,12,13,9,0,0,8,4,13,7,4,2,361,192,169,103,62,41,53,72,147,64,20,21,26,33,85,36,9,7,27,39,62,28,11,14,15,16,29,32,8,2,7,8,17,24,4,1,8,8,12,8,4,1,394,216,178,69,32,37,67,69,129,60,21,40,40,35,89,32,5,13,27,34,40,28,16,27,11,23,17,4,9,3,4,12,7,3,3,2,7,11,10,1,6,1,277,150,127,70,36,34,57,46,62,59,23,22,40,20,28,45,7,7,17,26,34,14,16,15,14,13,23,11,4,1,12,6,8,5,3,1,2,7,15,6,1,0,258,111,147,57,23,34,79,22,60,44,25,12,57,6,20,5,10,1,22,16,40,39,15,11,9,10,19,10,4,2,6,5,6,4,-2,2,3,5,13,6,6,0,102,27,75,-69,-49,-20,21,0,-9,32,14,26,0,0,-14,9,18,5,21,0,5,23,-4,21,-14,5,-31,-21,-6,-5,-8,1,-21,-18,-1,-4,-6,4,-10,-3,-5,-1,-74,-55,-19,-62,-38,-24,-20,17,-35,-25,-19,8,-27,0,-28,4,-6,1,7,17,-7,-29,-13,7,-4,-5,-23,-19,-14,1,-2,-3,-13,-12,-10,1,-2,-2,-10,-7,-4,0,104,48,56,23,14,9,38,-14,-8,45,13,22,27,-13,-1,21,8,6,11,-1,-7,24,5,16,-1,10,3,-2,7,2,1,8,1,-2,4,0,-2,2,2,0,3,2,-54,-60,6,-49,-31,-18,-10,2,-28,-48,-1,27,-26,-2,-15,-19,-11,12,16,4,-13,-29,10,15,2,-9,-22,-15,-6,0,-2,-7,-11,-10,-2,0,4,-2,-11,-5,-4,0,36,31,5,-16,-8,-8,7,-5,2,-5,25,5,4,0,6,1,19,-2,3,-5,-4,-6,6,7,-2,-8,1,-4,-5,1,-4,-1,-2,1,-4,2,2,-7,3,-5,-1,-1,240,134,106,36,15,21,44,27,58,81,-2,28,17,23,31,43,-4,18,27,4,27,38,2,10,12,10,0,10,-1,2,6,4,-1,4,-1,1,6,6,1,6,0,1,63,22,41,-30,-15,-15,8,8,35,4,-12,20,11,0,9,-4,-1,7,-3,8,26,8,-11,13,-6,-6,4,-16,-9,2,4,-8,-2,-11,0,1,-10,2,6,-5,-9,1,-24,-12,-12,24,13,11,-55,2,28,-25,4,24,-12,-8,21,-25,9,6,-43,10,7,0,-5,18,12,8,10,1,-1,-6,9,5,5,-2,-2,-2,3,3,5,3,1,-4
19,19046,Azuqueca de Henares,18592,569,274,295,7,2,5,82,142,170,104,26,33,32,56,99,57,16,13,50,86,71,47,10,20,2,0,4,0,0,1,0,0,2,0,0,0,2,0,2,0,0,1,241,160,81,7,3,4,-23,108,72,39,18,26,-6,74,45,18,12,15,-17,34,27,21,6,11,3,0,2,2,0,0,2,0,0,1,0,0,1,0,2,1,0,0,265,127,138,8,3,5,-2,132,55,37,31,31,-16,65,60,15,10,9,14,67,-5,22,21,22,5,2,2,2,0,-4,0,1,2,1,0,-1,5,1,0,1,0,-3,248,113,135,73,41,32,-7,115,100,-4,13,27,-22,52,68,-5,9,6,15,63,32,1,4,21,7,24,26,4,6,5,4,10,17,3,4,2,3,14,9,1,2,3,797,428,369,506,266,240,10,324,344,73,18,35,12,164,212,32,5,11,-2,160,132,41,13,24,65,145,184,79,23,7,36,67,104,45,11,2,29,78,80,34,12,5,1775,933,842,592,301,291,270,421,712,220,81,46,148,189,403,119,45,9,122,232,309,101,36,37,105,200,161,83,31,6,50,98,87,47,12,2,55,102,74,36,19,4,2201,1162,1039,919,480,439,259,612,862,303,90,39,129,294,492,174,37,21,130,318,370,129,53,18,176,279,272,126,59,2,92,139,147,68,26,5,84,140,125,58,33,-3,2292,1350,942,1210,706,504,204,612,999,337,97,19,133,343,602,210,41,4,71,269,397,127,56,15,204,356,366,211,57,10,121,199,235,119,28,3,83,157,131,92,29,7,1596,845,751,796,367,429,182,444,641,191,66,43,106,206,378,107,13,18,76,238,263,84,53,25,141,237,245,118,38,11,55,97,137,63,11,2,86,140,108,55,27,9,596,280,316,272,98,174,61,225,257,-11,2,27,32,124,111,-18,5,6,29,101,146,7,-3,21,47,115,69,-2,27,5,27,45,20,-13,13,-2,20,70,49,11,14,7,144,79,65,-311,-229,-82,22,87,103,-59,-47,23,27,34,56,-31,-20,2,-5,53,47,-28,-27,21,-12,19,-152,-119,-52,-3,-6,-6,-105,-86,-28,-2,-6,25,-47,-33,-24,-1,551,235,316,127,56,71,62,174,246,30,15,10,15,72,135,-1,0,8,47,102,111,31,15,2,23,80,57,-35,0,-6,6,36,38,-29,1,1,17,44,19,-6,-1,-7,-80,-53,-27,-147,-102,-45,-13,70,-122,-16,-29,20,7,28,-77,-9,-20,9,-20,42,-45,-7,-9,11,-23,53,-86,-63,-22,-12,-8,20,-55,-44,-17,0,-15,33,-31,-19,-5,-12,-377,-272,-105,-298,-202,-96,-34,2,-196,-167,-6,18,-18,5,-149,-103,-8,-2,-16,-3,-47,-64,2,20,-20,-26,-135,-84,-28,-10,-10,-21,-84,-69,-13,-9,-10,-5,-51,-15,-15,-1,-709,-432,-277,-513,-363,-150,-120,15,-349,-230,-46,14,-36,-11,-208,-171,-27,8,-84,26,-141,-59,-19,6,-47,-19,-225,-196,-34,0,-32,-22,-140,-147,-26,0,-15,3,-85,-49,-8,0,-411,-247,-164,-316,-169,-147,-21,5,-199,-171,-54,25,-20,0,-90,-119,-30,12,-1,5,-109,-52,-24,13,-12,1,-137,-119,-42,-11,-3,7,-69,-79,-22,-5,-9,-6,-68,-40,-20,-6,-109,-109,0,-117,-105,-12,-46,71,-34,-117,-1,17,-26,15,-6,-94,-7,11,-20,56,-28,-23,6,6,2,35,-65,-70,-26,4,5,3,-36,-56,-21,-1,-3,32,-29,-14,-5,5,-248,-129,-119,-78,-38,-40,-70,78,-22,-203,-63,22,-36,61,-7,-120,-40,10,-34,17,-15,-83,-23,12,-7,55,7,-106,-32,-2,-6,41,15,-67,-26,1,-1,14,-8,-39,-6,-3
19,19058,Cabanillas del Campo,2214,409,203,206,23,13,10,88,55,116,104,27,14,39,32,58,51,15,4,49,23,58,53,12,10,9,4,5,4,1,0,6,3,1,2,1,0,3,1,4,2,0,0,333,172,161,34,19,15,53,54,105,87,15,19,25,22,63,47,9,6,28,32,42,40,6,13,9,4,10,8,1,1,5,0,9,4,0,0,4,4,1,4,1,1,472,233,239,44,24,20,92,64,163,99,19,23,40,38,80,52,11,10,52,26,83,47,8,13,8,9,10,11,4,1,4,5,4,6,4,0,4,4,6,5,0,1,771,377,394,52,25,27,173,87,307,138,39,18,78,44,142,84,16,9,95,43,165,54,23,9,9,13,16,9,3,2,4,7,7,6,0,1,5,6,9,3,3,1,654,311,343,61,30,31,153,73,258,109,36,6,74,29,123,57,19,1,79,44,135,52,17,5,13,17,13,15,3,0,7,11,6,5,0,1,6,6,7,10,3,-1,475,247,228,50,25,25,105,48,173,102,22,11,54,31,84,54,10,3,51,17,89,48,12,8,13,10,19,6,1,0,5,4,11,5,0,0,8,6,8,1,1,0,376,192,184,98,51,47,62,49,133,77,35,13,31,19,77,25,26,8,31,30,56,52,9,5,19,21,22,27,7,1,10,10,14,9,7,0,9,11,8,18,0,1,425,225,200,144,75,69,85,67,158,74,18,15,50,43,68,46,7,8,35,24,90,28,11,7,27,35,47,25,6,4,13,20,20,17,3,2,14,15,27,8,3,2,211,108,103,38,11,27,27,28,74,32,26,15,20,9,41,20,6,7,7,19,33,12,20,8,5,13,5,4,9,1,3,3,0,0,5,0,2,10,5,4,4,1,200,92,108,27,2,25,43,12,60,41,-1,38,25,-3,27,22,2,14,18,15,33,19,-3,24,11,11,7,-4,2,-1,6,2,-3,-4,1,-1,5,9,10,0,1,0,-4,13,-17,8,8,0,12,17,-26,-7,-6,3,-4,12,-7,5,-2,6,16,5,-19,-12,-4,-3,10,9,-3,0,-6,-3,7,6,-1,-2,-2,-1,3,3,-2,2,-4,-2,175,97,78,24,17,7,56,7,31,45,18,25,30,7,24,18,11,8,26,0,7,27,7,17,5,12,4,-5,7,1,6,9,3,-2,0,1,-1,3,1,-3,7,0,-20,-21,1,-29,-26,-3,-6,-4,9,-12,-25,10,-3,-1,-2,-12,-8,1,-3,-3,11,0,-17,9,-5,-2,-11,-7,-4,0,-6,-1,-10,-8,-2,1,1,-1,-1,1,-2,-1,64,45,19,-36,-21,-15,7,10,-7,7,17,29,9,9,3,7,8,11,-2,1,-10,0,9,18,-1,-5,-15,-13,0,-1,-1,-2,-7,-8,-2,0,0,-3,-8,-5,2,-1,-135,-56,-79,-44,-23,-21,-29,-29,-45,-45,-8,17,-15,-14,-10,-17,-10,7,-14,-15,-35,-28,2,10,-9,-7,-10,-10,-3,-5,-5,-4,-4,-4,-4,-2,-4,-3,-6,-6,1,-3,75,43,32,14,2,12,30,-3,2,18,-11,32,19,-2,0,17,-2,9,11,-1,2,1,-9,23,3,7,4,3,-6,1,-1,-1,2,3,-1,0,4,8,2,0,-5,1,178,91,87,-12,-1,-11,58,7,64,27,-5,23,36,0,26,17,4,5,22,7,38,10,-9,18,-5,1,0,-13,-2,6,0,1,5,-7,-3,2,-5,0,-5,-6,1,4,156,88,68,23,9,14,27,-8,68,15,-3,52,7,0,47,13,1,21,20,-8,21,2,-4,31,3,4,4,-6,8,9,3,1,-2,1,2,3,0,3,6,-7,6,6
19,19071,"Casar, El",2796,332,172,160,42,25,17,44,33,144,66,24,14,22,17,70,40,14,4,22,16,74,26,10,10,5,7,13,11,4,2,2,6,7,8,1,1,3,1,6,3,3,1,410,234,176,90,51,39,71,44,158,87,37,8,40,27,87,48,25,5,31,17,71,39,12,3,24,15,24,15,7,2,15,10,15,7,3,0,9,5,9,8,4,2,365,189,176,49,29,20,58,43,146,73,24,11,31,9,78,47,14,6,27,34,68,26,10,5,9,12,13,11,4,0,5,4,9,7,4,0,4,8,4,4,0,0,659,370,289,56,28,28,120,75,218,155,55,21,66,47,114,92,28,13,54,28,104,63,27,8,6,16,19,9,3,2,0,9,10,6,1,1,6,7,9,3,2,1,781,400,381,92,52,40,161,76,304,147,61,23,90,34,143,78,37,12,71,42,161,69,24,11,10,26,37,16,4,-1,8,12,24,8,1,0,2,14,13,8,3,-1,1033,489,544,120,51,69,237,90,391,208,70,20,108,48,201,84,37,4,129,42,190,124,33,16,24,25,34,26,6,4,10,11,17,9,2,2,14,14,17,17,4,2,885,455,430,164,83,81,181,111,341,161,53,24,87,52,181,90,28,9,94,59,160,71,25,15,20,41,59,30,13,1,8,22,33,13,6,1,12,19,26,17,7,0,753,419,334,207,112,95,132,92,297,144,44,30,69,46,166,86,26,16,63,46,131,58,18,14,28,50,72,40,15,1,8,22,46,27,9,0,20,28,26,13,6,1,581,302,279,121,61,60,120,88,172,116,44,15,55,48,86,65,26,9,65,40,86,51,18,6,25,33,25,25,6,3,13,18,8,16,4,1,12,15,17,9,2,2,431,196,235,78,36,42,76,40,170,75,33,29,39,23,75,32,14,10,37,17,95,43,19,19,25,12,14,13,11,2,11,5,9,8,1,1,14,7,5,5,10,1,418,223,195,52,21,31,72,21,171,96,13,32,34,9,80,72,8,12,38,12,91,24,5,20,13,10,17,-2,5,7,5,6,6,-2,1,4,8,4,11,0,4,3,241,117,124,43,16,27,29,22,133,46,-12,21,9,10,80,27,-11,1,20,12,53,19,-1,20,10,18,12,1,-2,2,4,10,2,2,-1,-2,6,8,10,-1,-1,4,70,78,-8,-26,-25,-1,39,-12,47,-11,-2,4,47,-4,29,-7,6,5,-8,-8,18,-4,-8,-1,5,1,-8,-15,-7,-2,4,-4,-11,-11,-4,1,1,5,3,-4,-3,-3,-5,-6,1,-17,-16,-1,-3,-10,23,-3,-16,-1,4,-10,11,-1,-15,2,-7,0,12,-2,-1,-3,-7,3,0,-13,-1,1,-6,1,2,-8,-4,0,-1,2,-2,-5,3,1,-39,-18,-21,19,7,12,-20,-27,12,-21,4,12,-17,-7,8,-3,4,-1,-3,-20,4,-18,0,13,5,6,2,5,0,1,-1,5,-1,2,2,0,6,1,3,3,-2,1,-104,-58,-46,-14,-13,-1,-26,-33,14,-64,-1,2,-11,-22,8,-37,0,0,-15,-11,6,-27,-1,2,18,-1,-6,-19,-3,-6,11,-2,-3,-14,-5,-1,7,1,-3,-5,2,-5,144,63,81,12,6,6,32,5,80,-11,5,16,17,1,24,4,8,3,15,4,56,-15,-3,13,6,8,8,-7,-2,-1,5,4,1,-3,0,-1,1,4,7,-4,-2,0,24,-25,49,1,-13,14,-15,2,23,7,-2,0,-18,-3,14,-9,-5,-9,3,5,9,16,3,9,-6,10,-12,-1,4,7,-1,4,-12,-7,0,4,-5,6,0,6,4,3
19,19113,Espinosa de Henares,568,-8,-3,-5,6,4,2,-2,6,-10,0,-3,1,-1,3,-5,1,-1,0,-1,3,-5,-1,-2,1,0,5,1,0,0,0,0,3,1,0,0,0,0,2,0,0,0,0,24,26,-2,22,15,7,1,2,10,6,2,3,1,4,10,5,3,3,0,-2,0,1,-1,0,2,3,13,3,1,0,1,3,8,2,1,0,1,0,5,1,0,0,19,11,8,19,10,9,6,0,1,2,6,5,2,0,2,4,3,1,4,0,-1,-2,3,4,4,5,5,4,0,0,1,2,3,4,0,0,3,3,2,0,0,0,48,33,15,20,12,8,11,5,17,7,11,-3,9,3,10,7,5,-1,2,2,7,0,6,-2,5,5,10,0,0,0,4,3,5,0,0,0,1,2,5,0,0,0,35,22,13,23,16,7,8,9,16,2,6,-6,3,2,11,1,4,0,5,7,5,1,2,-6,2,10,8,3,0,0,0,5,8,3,0,0,2,5,0,0,0,0,34,20,14,19,9,10,14,5,10,6,-2,-1,10,0,6,4,-2,0,4,5,4,2,0,-1,4,8,5,2,0,0,2,2,4,1,0,0,2,6,1,1,0,0,55,27,28,34,14,20,15,4,15,18,6,-4,6,5,9,8,2,-4,9,-1,6,10,4,0,6,6,12,8,2,0,1,2,7,3,1,0,5,4,5,5,1,0,69,37,32,34,16,18,9,6,20,20,4,9,2,4,9,16,3,3,7,2,11,4,1,6,5,7,12,7,1,2,2,2,6,5,0,1,3,5,6,2,1,1,42,21,21,23,11,12,14,10,13,8,-2,-2,6,8,6,3,0,-2,8,2,7,5,-2,0,9,6,5,3,0,0,6,3,2,0,0,0,3,3,3,3,0,0,8,15,-7,7,4,3,1,2,5,-3,5,-2,2,4,4,0,3,2,-1,-2,1,-3,2,-4,2,2,3,0,0,0,2,2,0,0,0,0,0,0,3,0,0,0,-19,-7,-12,8,5,3,-8,6,-7,-3,-7,0,-5,6,-3,-3,-2,0,-3,0,-4,0,-5,0,0,5,0,1,0,2,0,4,0,0,0,1,0,1,0,1,0,1,-6,-4,-2,2,2,0,1,-1,-6,3,0,-4,3,-1,-6,2,0,-3,-2,0,0,1,0,-1,0,1,-1,2,0,0,0,1,0,1,0,0,0,0,-1,1,0,0,-11,-8,-3,-1,-1,0,0,-5,0,3,-1,-8,1,-3,-3,3,-1,-5,-1,-2,3,0,0,-3,0,0,0,0,-1,0,0,0,-1,0,0,0,0,0,1,0,-1,0,-12,-11,-1,1,-1,2,1,-4,-2,-4,1,-3,1,-4,-3,-1,-2,-2,0,0,1,-3,3,-1,0,1,0,0,0,0,0,-1,0,0,0,0,0,2,0,0,0,0,-66,-34,-32,-46,-29,-17,-21,-7,-12,-20,-8,2,-9,-2,-6,-18,-4,4,-12,-5,-6,-2,-4,-2,-14,-1,-10,-14,-5,-2,-8,-1,-6,-11,-3,0,-6,0,-4,-3,-2,-2,1,1,0,1,0,1,-1,3,-4,4,1,-2,0,3,-1,1,1,-3,-1,0,-3,3,0,1,0,1,-1,1,0,0,-1,1,0,0,0,0,1,0,-1,1,0,0,21,10,11,4,1,3,0,5,5,5,6,-1,1,4,1,2,2,-1,-1,1,4,3,4,0,0,1,3,0,0,0,0,0,2,-1,0,0,0,1,1,1,0,0,-1,5,-6,11,8,3,1,2,-1,2,-5,-2,3,2,2,0,-2,-1,-2,0,-3,2,-3,-1,-1,6,2,2,1,0,0,5,2,1,0,0,-1,1,0,1,1,0
19,19130,Guadalajara,69959,1050,518,532,695,363,332,279,154,364,154,9,93,148,82,189,68,-5,39,131,72,175,86,14,54,122,162,245,132,25,6,65,83,136,63,12,4,57,79,109,69,13,2,1100,535,565,916,461,455,269,193,369,177,31,59,168,78,182,78,0,29,101,115,187,99,31,30,188,221,298,155,44,6,101,112,158,68,18,3,87,109,140,87,26,3,1041,565,476,1025,541,484,305,223,311,124,7,66,153,135,195,71,-11,15,152,88,116,53,18,51,237,271,328,146,23,12,127,139,185,73,11,3,110,132,143,73,12,9,1088,462,626,912,457,455,312,252,256,159,-30,138,165,122,98,66,-33,46,147,130,158,93,3,92,192,245,260,142,46,18,99,119,122,82,22,8,93,126,138,60,24,10,1275,606,669,917,463,454,193,299,388,237,29,117,78,130,200,144,-3,51,115,169,188,93,32,66,142,258,274,174,52,13,71,119,154,96,16,6,71,139,120,78,36,7,1976,1013,963,1229,662,567,284,517,659,331,77,106,147,262,348,169,37,52,137,255,311,162,40,54,224,314,383,224,67,13,113,157,228,129,28,5,111,157,155,95,39,8,2245,1248,997,1617,883,734,328,672,829,348,17,43,173,344,538,169,-2,21,155,328,291,179,19,22,253,494,503,275,72,15,135,259,312,133,39,3,118,235,191,142,33,12,2857,1466,1391,2391,1290,1101,379,794,869,498,110,208,157,405,519,264,34,97,222,389,350,234,76,111,421,699,712,408,114,25,199,357,441,219,59,9,222,342,271,189,55,16,1302,779,523,919,507,412,230,294,337,215,43,165,138,180,190,137,45,81,92,114,147,78,-2,84,182,259,315,136,10,6,93,151,167,83,9,2,89,108,148,53,1,4,485,70,415,717,310,407,154,188,-6,60,-24,106,80,45,-55,-8,-28,31,74,143,49,68,4,75,188,206,210,78,23,5,82,75,109,28,10,2,106,131,101,50,13,3,350,69,281,420,145,275,138,87,34,25,-57,99,56,31,-1,-12,-51,50,82,56,35,37,-6,49,124,141,101,31,23,-8,64,69,27,-17,1,0,60,72,74,48,22,-8,-186,-228,42,-548,-427,-121,61,55,-255,-138,-16,86,47,1,-166,-103,-53,39,14,54,-89,-35,37,47,15,-7,-253,-225,-69,-15,18,-30,-201,-165,-50,-2,-3,23,-52,-60,-19,-13,-112,-153,41,-312,-252,-60,18,88,-265,-95,-52,179,-2,56,-178,-82,-36,80,20,32,-87,-13,-16,99,-11,39,-138,-131,-63,-16,-14,15,-119,-92,-42,-7,3,24,-19,-39,-21,-9,-793,-665,-128,-522,-359,-163,90,-53,-559,-206,-108,21,53,-71,-402,-195,-62,4,37,18,-157,-11,-46,17,-33,-9,-224,-176,-75,-9,-19,-17,-147,-128,-48,-2,-14,8,-77,-48,-27,-7,-564,-421,-143,-215,-142,-73,21,-70,-247,-206,-73,9,-2,-54,-152,-162,-45,-13,23,-16,-95,-44,-28,22,-42,8,-118,-77,-1,5,2,-15,-66,-62,-9,3,-44,23,-52,-15,8,2,329,60,269,137,18,119,164,62,-40,2,18,98,87,2,-50,-20,-17,42,77,60,10,22,35,56,60,49,6,-4,7,6,36,8,-9,-21,-8,4,24,41,15,17,15,2,492,171,321,235,78,157,175,162,14,14,-15,134,75,71,11,-1,-46,65,100,91,3,15,31,69,62,109,56,-13,-12,23,37,62,8,-22,-21,8,25,47,48,9,9,15,650,332,318,545,277,268,172,229,133,-6,1,110,107,115,106,-35,-1,35,65,114,27,29,2,75,120,184,160,14,24,28,64,93,109,-6,-3,13,56,91,51,20,27,15
19,19151,Humanes,1188,-2,4,-6,4,3,1,-13,5,-2,9,-1,0,-3,1,-1,6,1,1,-10,4,-1,3,-2,-1,0,1,1,0,2,0,0,1,1,0,1,0,0,0,0,0,1,0,43,23,20,10,4,6,9,5,3,10,5,9,3,2,4,5,5,3,6,3,-1,5,0,6,0,1,5,2,2,0,0,0,2,1,1,0,0,1,3,1,1,0,21,8,13,12,3,9,7,5,-9,7,7,3,1,0,-5,7,4,1,6,5,-4,0,3,2,4,4,1,2,1,0,1,1,0,0,1,0,3,3,1,2,0,0,53,35,18,17,10,7,0,17,16,2,9,7,-1,10,13,1,7,4,1,7,3,1,2,3,2,7,4,3,1,0,2,3,3,1,1,0,0,4,1,2,0,0,87,38,49,16,7,9,9,17,17,4,9,31,4,7,12,1,1,12,5,10,5,3,8,19,1,7,5,3,0,0,1,1,5,0,0,0,0,6,0,3,0,0,38,28,10,23,14,9,0,14,5,8,5,5,1,10,3,6,6,2,-1,4,2,2,-1,3,5,6,7,2,1,1,3,5,4,0,1,1,2,1,3,2,0,0,51,20,31,10,1,9,14,3,12,12,9,-1,3,0,7,7,5,-2,11,3,5,5,4,1,2,2,0,5,0,1,0,0,-1,2,0,0,2,2,1,3,0,1,49,30,19,41,19,22,-2,10,15,11,11,1,-1,13,6,4,8,-1,-1,-3,9,7,3,2,7,9,5,11,8,1,3,6,2,4,5,-1,4,3,3,7,3,2,86,45,41,10,8,2,16,1,28,23,15,1,8,2,17,11,6,-1,8,-1,11,12,9,2,2,3,6,0,0,-1,2,1,3,2,0,0,0,2,3,-2,0,-1,1,3,-2,19,10,9,-11,4,-3,9,3,0,-2,1,1,2,1,1,-9,3,-4,7,2,-1,2,7,3,3,4,0,2,5,1,1,1,0,0,2,2,2,3,0,24,1,23,6,-2,8,-2,4,16,-5,1,7,-2,-2,8,-8,-1,3,0,6,8,3,2,4,5,-1,3,-1,0,0,1,-2,1,-1,-1,0,4,1,2,0,1,0,87,46,41,14,6,8,17,8,29,2,16,16,9,7,14,3,8,6,8,1,15,-1,8,10,1,4,9,0,0,0,0,3,4,-1,0,0,1,1,5,1,0,0,-22,-8,-14,4,5,-1,-3,-4,-3,-1,-9,-1,-2,0,-2,-2,-3,1,-1,-4,-1,1,-6,-2,1,3,1,0,-1,0,0,3,1,0,1,0,1,0,0,0,-2,0,-17,-20,3,6,5,1,-8,0,-14,1,0,7,-10,-2,-8,3,-3,2,2,2,-6,-2,3,5,-1,4,2,1,0,0,1,2,1,1,0,0,-2,2,1,0,0,0,-52,-38,-14,-33,-24,-9,-1,-3,-29,-12,-5,-5,-2,-3,-22,-5,-3,-4,1,0,-7,-7,-2,-1,0,-1,-19,-5,-3,-5,0,-2,-14,-3,-2,-3,0,1,-5,-2,-1,-2,9,17,-8,2,3,-1,-4,2,-1,-5,2,16,4,4,-2,0,4,8,-8,-2,1,-5,-2,8,-1,2,1,0,0,0,0,1,1,1,0,0,-1,1,0,-1,0,0,19,-1,20,-16,-8,-8,-7,-5,-2,-8,0,38,-2,0,-2,-5,-5,12,-5,-5,0,-3,5,26,-2,-4,-2,-5,-1,-2,0,-1,-3,-2,-1,-1,-2,-3,1,-3,0,-1,45,21,24,9,4,5,9,5,6,0,1,19,4,4,2,-2,2,9,5,1,4,2,-1,10,4,2,3,-1,0,0,2,3,2,-2,-1,0,2,-1,1,1,1,0
19,19156,Jadraque,1253,33,26,7,41,25,16,1,7,8,10,0,5,3,0,9,9,1,2,-2,7,-1,1,-1,3,5,7,14,11,1,1,3,1,9,9,1,0,2,6,5,2,0,1,45,24,21,48,23,25,12,11,8,7,7,0,4,7,6,3,3,1,8,4,2,4,4,-1,11,11,13,9,4,0,4,7,6,5,1,0,7,4,7,4,3,0,36,29,7,81,53,28,-2,25,14,6,-1,-9,1,12,16,5,-4,-2,-3,13,-2,1,3,-7,10,28,25,17,0,0,7,16,19,10,0,0,3,12,6,7,0,0,41,8,33,54,24,30,6,2,5,15,6,7,0,0,-4,7,2,3,6,2,9,8,4,4,5,18,16,12,2,1,2,10,6,6,0,0,3,8,10,6,2,1,69,43,26,78,49,29,2,15,25,13,9,4,2,11,13,10,5,1,0,4,12,3,4,3,7,26,25,17,3,0,3,15,17,13,1,0,4,11,8,4,2,0,101,69,32,89,50,39,27,8,37,22,6,1,14,11,26,13,4,0,13,-3,11,9,2,1,16,20,32,20,1,0,10,12,18,10,0,0,6,8,14,10,1,0,10,1,9,31,19,12,13,-3,5,-5,1,0,1,-2,5,-5,2,1,12,-1,0,0,-1,-1,4,10,10,6,1,0,1,7,8,2,1,0,3,3,2,4,0,0,76,40,36,88,52,36,28,20,8,10,15,-4,16,7,3,10,9,-3,12,13,5,0,6,-1,21,20,18,16,12,0,13,12,8,12,7,0,8,8,10,4,5,0,25,5,20,11,5,6,10,-2,6,7,9,-1,1,0,1,6,3,-3,9,-2,5,1,6,2,1,2,3,2,3,0,0,1,3,1,0,0,1,1,0,1,3,0,23,1,22,0,-7,7,8,4,14,-5,-3,2,5,-1,1,-4,0,0,3,5,13,-1,-3,2,2,7,-2,-6,-2,0,0,2,-3,-5,-1,0,2,5,1,-1,-1,0,0,-1,1,8,1,7,1,6,-1,-9,2,1,0,0,0,-4,3,1,1,6,-1,-5,-1,0,0,3,1,5,-2,0,-1,-1,0,4,-1,0,1,4,1,1,-1,0,15,10,5,10,4,6,1,-5,-4,11,8,3,-3,2,2,4,3,2,4,-7,-6,7,5,1,3,1,3,3,0,0,0,1,2,1,0,0,3,0,1,2,0,0,-18,-10,-8,6,1,5,-15,4,6,-6,-3,-2,-6,-1,4,-6,-2,2,-9,5,2,0,-1,-4,0,3,4,0,-1,0,0,0,1,0,0,0,0,3,3,0,-1,0,-69,-34,-35,-56,-32,-24,-11,-12,-24,-12,-7,-3,-4,-4,-11,-8,-4,-3,-7,-8,-13,-4,-3,0,-10,-6,-19,-16,-4,-1,-6,-2,-9,-12,-2,-1,-4,-4,-10,-4,-2,0,-56,-30,-26,-13,-12,-1,-19,3,-16,-21,5,-5,-9,2,-4,-16,2,-3,-10,1,-12,-5,3,-2,-4,4,0,-9,-4,0,-3,2,1,-9,-3,0,-1,2,-1,0,-1,0,1,-5,6,0,0,0,5,-5,3,3,-7,2,-1,-4,-2,1,-1,2,6,-1,5,2,-6,0,-1,1,4,0,-4,0,-1,0,2,0,-1,0,0,1,2,0,-3,0,4,15,-11,25,15,10,5,3,-3,-2,1,0,8,3,1,0,2,1,-3,0,-4,-2,-1,-1,8,2,7,7,0,0,5,1,5,4,0,0,3,1,2,3,0,0,-13,0,-13,-5,-3,-2,0,-5,-16,2,-1,4,3,-3,-6,1,-3,7,-3,-2,-10,1,2,-3,0,1,-4,0,-4,0,2,-1,-3,1,-3,0,-2,2,-1,-1,-1,0
19,19192,Mondéjar,2083,24,13,11,29,17,12,7,0,5,8,7,-1,2,4,3,1,4,0,5,-4,2,7,3,-1,5,5,14,4,1,0,4,4,6,3,0,0,1,1,8,1,1,0,29,27,2,31,18,13,5,6,13,-1,3,3,1,12,9,0,3,2,4,-6,4,-1,0,1,9,10,9,3,0,0,3,8,5,2,0,0,6,2,4,1,0,0,51,25,26,26,16,10,15,5,10,13,8,0,8,3,3,6,5,1,7,2,7,7,3,-1,12,7,2,5,0,0,8,5,1,2,0,0,4,2,1,3,0,0,71,36,35,48,21,27,15,26,7,17,4,0,7,12,1,10,2,2,8,14,6,7,2,-2,14,13,14,3,2,0,6,5,7,2,1,0,8,8,7,1,1,0,94,60,34,64,42,22,19,19,23,17,8,7,13,15,17,8,3,3,6,4,6,9,5,4,9,24,21,9,1,0,6,16,16,4,0,0,3,8,5,5,1,0,35,11,24,70,36,34,14,19,6,-8,3,-1,4,9,-3,-2,3,1,10,10,9,-6,0,-2,16,25,20,9,0,0,6,11,12,7,0,0,10,14,8,2,0,0,-37,-15,-22,42,20,22,-8,-2,-28,3,5,-1,-9,6,-14,2,6,-3,1,-8,-14,1,-1,2,8,15,9,9,2,-1,2,8,5,4,2,-1,6,7,4,5,0,0,-3,0,-3,54,24,30,-2,7,-18,5,1,5,0,4,-10,6,-2,3,-2,3,-8,-1,3,2,14,7,12,13,7,1,7,2,6,5,3,1,7,5,6,8,4,0,22,10,12,33,16,17,5,-6,10,8,0,5,3,0,1,6,-1,0,2,-6,9,2,1,5,9,11,8,4,1,0,4,6,5,0,0,1,5,5,3,4,1,-1,34,31,3,21,11,10,-3,0,22,-1,5,8,5,-4,13,5,2,7,-8,4,9,-6,3,1,0,2,10,2,3,2,1,-2,5,2,1,2,-1,4,5,0,2,0,27,19,8,7,-4,11,7,2,9,3,2,1,6,2,2,5,0,1,1,0,7,-2,2,0,7,3,1,-4,1,-1,5,-2,-3,-2,-1,-1,2,5,4,-2,2,0,38,24,14,-2,-4,2,17,9,1,6,1,3,6,5,5,4,0,3,11,4,-4,2,1,0,6,1,-2,-5,-3,1,2,0,-2,-4,-1,1,4,1,0,-1,-2,0,-50,-33,-17,-5,-6,1,-6,3,-16,-17,-12,-4,-3,4,-16,-14,-6,1,-3,-1,0,-3,-6,-5,5,4,-8,-5,-2,1,5,3,-10,-3,-1,0,0,1,2,-2,-1,1,-45,-23,-22,-10,-12,2,1,-6,-19,-11,-7,-4,0,0,-6,-10,-4,-4,1,-6,-13,-1,-3,0,-1,4,-5,-2,-4,-2,-2,0,-2,-4,-2,-2,1,4,-3,2,-2,0,-61,-37,-24,-25,-14,-11,-17,7,-26,-28,6,-1,-11,3,-14,-18,5,-1,-6,4,-12,-10,1,0,-13,0,-9,-3,2,-1,-7,0,-5,-2,0,0,-6,0,-4,-1,2,-1,8,6,2,14,5,9,-8,6,2,1,3,4,-8,0,4,1,7,2,0,6,-2,0,-4,2,3,2,4,3,1,1,1,0,2,1,1,0,2,2,2,2,0,1,38,27,11,19,10,9,8,4,4,17,-4,12,4,3,4,11,0,6,4,1,0,6,-4,6,6,3,8,1,0,1,2,0,5,2,0,1,4,3,3,-1,0,0,1,8,-7,19,16,3,-8,-7,6,-6,3,9,0,-4,2,3,1,4,-8,-3,4,-9,2,5,5,3,11,-1,-2,3,3,2,7,4,-1,1,2,1,4,-5,-1,2
19,19225,Pozo de Guadalajara,371,9,9,0,6,5,1,0,3,2,1,0,3,0,2,4,2,-1,2,0,1,-2,-1,1,1,1,1,2,2,0,0,1,0,2,2,0,0,0,1,0,0,0,0,36,26,10,4,3,1,3,8,18,5,4,-2,2,6,12,4,3,-1,1,2,6,1,1,-1,0,1,1,2,0,0,0,1,0,2,0,0,0,0,1,0,0,0,130,64,66,12,7,5,26,23,47,22,8,2,7,13,26,11,4,1,19,10,21,11,4,1,3,4,4,1,0,0,3,2,2,0,0,0,0,2,2,1,0,0,80,35,45,6,2,4,17,19,25,12,6,1,6,9,13,4,4,0,11,10,12,8,2,1,1,1,4,0,0,0,0,0,2,0,0,0,1,1,2,0,0,0,184,104,80,21,14,7,31,27,72,26,17,10,11,15,46,17,11,3,20,12,26,9,6,7,1,4,7,8,0,1,1,2,6,5,0,0,0,2,1,3,0,1,154,75,79,12,8,4,24,27,51,35,12,2,12,14,18,20,9,1,12,13,33,15,3,1,1,5,0,5,1,0,1,5,0,1,1,0,0,0,0,4,0,0,108,60,48,23,13,10,22,23,46,10,3,4,14,9,27,8,0,2,8,14,19,2,3,2,3,7,7,4,2,0,1,4,5,2,1,0,2,3,2,2,1,0,62,39,23,28,18,10,4,11,37,6,3,-2,5,9,18,4,2,-1,-1,2,19,2,1,-1,1,11,11,4,1,0,0,9,5,3,1,0,1,2,6,1,0,0,54,23,31,8,7,1,5,11,33,-1,3,0,1,6,14,0,1,0,4,5,19,-1,2,0,0,3,3,2,0,0,0,2,3,2,0,0,0,1,0,0,0,0,38,28,10,-13,-6,-7,3,0,17,16,2,0,4,-3,20,5,2,-1,-1,3,-3,11,0,1,1,-8,-4,-2,1,-1,1,-5,-1,0,0,-1,0,-3,-3,-2,1,0,-24,-13,-11,-18,-8,-10,-12,3,-5,-1,-6,-1,-4,1,-3,-4,-1,-1,-8,2,-2,3,-5,0,-3,-1,-7,-4,-2,-1,0,1,-5,-3,0,-1,-3,-2,-2,-1,-2,0,-9,0,-9,-1,-3,2,2,2,-5,-3,-9,3,1,4,1,-3,-4,3,1,-2,-6,0,-5,0,1,4,-4,0,-1,-1,-1,3,-4,0,-1,0,2,1,0,0,0,-1,-36,-21,-15,-11,-5,-6,-6,0,-14,-8,-7,-3,-6,0,-7,-4,-3,-3,0,0,-7,-4,-4,0,-3,-1,-6,-2,1,0,-1,-1,-3,-1,1,0,-2,0,-3,-1,0,0,-46,-19,-27,-24,-13,-11,-12,-4,-11,-22,2,-2,-3,-1,-3,-11,-1,-3,-9,-3,-8,-11,3,1,-6,-2,-6,-8,-1,0,-2,-1,-3,-5,-2,0,-4,-1,-3,-3,1,0,-7,9,-16,-18,-7,-11,-6,-5,6,-6,3,2,4,-3,6,-2,3,1,-10,-2,0,-4,0,1,-4,-1,-2,-6,-4,-1,0,-1,-1,-3,-1,-1,-4,0,-1,-3,-3,0,-11,-10,-1,-5,-4,-1,0,-6,-7,-2,6,-3,1,-5,-4,-5,5,-2,-1,-1,-3,3,1,-1,0,-2,-1,-2,0,0,0,-2,-2,-1,1,0,0,0,1,-1,-1,0,-4,-3,-1,-5,-3,-2,-3,-2,6,-9,-2,6,0,0,3,-8,-1,3,-3,-2,3,-1,-1,3,-3,0,-2,-2,0,1,-1,0,-1,-2,0,1,-2,0,-1,0,0,0,11,10,1,-1,-1,0,-2,5,7,0,2,-3,0,1,9,-2,3,-1,-2,4,-2,2,-1,-2,-1,2,0,-1,0,-1,0,1,0,-2,1,-1,-1,1,0,1,-1,0
19,19280,Torrejón del Rey,1060,157,89,68,9,6,3,24,24,41,47,20,-1,17,11,25,26,10,-1,7,13,16,21,10,0,1,2,5,0,1,0,0,1,4,0,1,0,1,1,1,0,0,0,150,77,73,15,8,7,20,16,67,31,14,1,15,5,34,16,7,-1,5,11,33,15,7,2,0,5,7,2,1,0,0,2,5,1,0,0,0,3,2,1,1,0,241,132,109,6,5,1,39,31,67,53,23,19,18,13,38,33,13,13,21,18,29,20,10,6,0,1,2,0,2,1,0,2,1,0,1,1,0,-1,1,0,1,0,438,230,208,7,5,2,105,53,149,73,45,6,55,22,74,44,28,4,50,31,75,29,17,2,0,1,4,2,0,0,0,0,3,2,0,0,0,1,1,0,0,0,424,226,198,62,36,26,93,74,134,72,42,4,45,44,69,36,24,2,48,30,65,36,18,2,8,22,23,7,1,1,2,14,14,6,0,0,6,8,9,1,1,1,681,376,305,80,51,29,131,100,252,112,55,21,64,53,143,71,31,8,67,47,109,41,24,13,7,26,28,14,3,1,3,15,18,12,2,0,4,11,10,2,1,1,491,248,243,59,29,30,100,48,233,67,21,9,41,18,129,37,13,6,59,30,104,30,8,3,20,11,14,11,-1,1,12,3,5,8,0,0,8,8,9,3,-1,1,450,248,202,119,72,47,76,58,186,83,43,-10,31,27,110,51,28,-6,45,31,76,32,15,-4,19,27,36,15,17,3,14,13,19,12,11,1,5,14,17,3,6,2,119,63,56,28,11,17,29,3,63,10,7,5,7,5,41,6,-1,5,22,-2,22,4,8,0,10,1,11,8,0,-2,2,-2,8,3,0,0,8,3,3,5,0,-2,151,73,78,16,2,14,27,23,70,21,6,-2,18,4,36,6,3,2,9,19,34,15,3,-4,7,6,6,0,1,-4,5,0,0,-2,-1,0,2,6,6,2,2,-4,-72,-39,-33,-67,-44,-23,-24,-7,-6,-40,13,-8,-1,-6,-11,-22,7,-7,-23,-1,5,-18,6,-1,-7,-14,-14,-25,-4,-3,2,-7,-13,-21,-3,-2,-9,-7,-1,-4,-1,-1,-4,-4,0,-16,-9,-7,2,-11,33,-2,-18,-7,-6,-3,19,1,-7,-4,8,-8,14,-3,-11,-3,-3,0,-8,-2,-2,-1,-3,0,-4,0,-2,0,0,0,-4,-2,0,-1,-33,-26,-7,-6,-3,-3,-20,12,-16,-21,14,2,-21,6,-9,-14,10,4,1,6,-7,-7,4,-2,-1,5,-5,-6,0,1,0,1,-2,-2,-1,1,-1,4,-3,-4,1,0,-64,-41,-23,-34,-30,-4,-14,-7,-1,-20,-10,-11,-8,-3,6,-10,-21,-6,-6,-4,-7,-10,11,-5,2,-3,-14,-12,-5,-1,1,0,-13,-11,-4,-2,1,-3,-1,-1,-1,1,-113,-55,-58,-13,-15,2,-44,-9,0,-51,-9,1,-12,-2,-3,-37,-2,-2,-32,-7,3,-14,-7,3,-5,6,1,-12,-4,0,-4,3,2,-12,-3,-2,-1,3,-1,0,-1,2,71,30,41,-7,-6,-1,39,2,11,12,5,-3,17,1,-2,13,1,-2,22,1,13,-1,4,-1,0,1,-5,-6,1,1,-3,-1,-1,-3,0,1,3,2,-4,-3,1,0,-22,15,-37,-5,-6,1,1,-3,32,-29,-11,-9,9,2,17,-6,-2,-4,-8,-5,15,-23,-9,-5,4,-2,-2,-8,5,-3,3,-4,1,-6,1,-2,1,2,-3,-2,4,-1,115,65,50,8,2,6,32,4,36,24,26,-9,19,4,18,11,13,-4,13,0,18,13,13,-5,3,2,1,4,1,-3,2,1,-1,1,0,-1,1,1,2,3,1,-2
19,19293,Uceda,863,55,39,16,2,1,1,6,5,14,20,6,4,6,4,12,12,3,2,0,1,2,8,3,2,0,1,0,1,0,0,0,0,0,1,0,0,0,1,0,0,0,0,187,104,83,26,12,14,19,13,78,26,32,19,13,9,42,16,12,11,6,4,36,10,20,8,4,7,8,5,2,0,3,4,3,2,0,0,1,3,5,3,2,0,231,133,98,16,8,8,29,19,82,48,38,16,14,14,42,28,24,12,15,5,40,20,14,4,1,4,9,1,1,0,1,2,5,0,0,0,0,2,4,1,1,0,147,82,65,13,7,6,25,8,48,48,18,-1,14,1,22,32,14,-2,11,7,26,16,4,1,4,2,1,2,4,0,1,2,-1,2,3,0,3,0,2,0,1,0,174,79,95,22,14,8,33,24,49,46,11,6,6,11,24,26,6,5,27,13,25,20,5,1,5,5,7,4,1,0,2,3,6,2,1,0,3,2,1,2,0,0,116,56,60,29,15,14,18,11,47,20,18,-2,3,7,29,11,7,-4,15,4,18,9,11,2,6,6,12,0,4,1,2,4,6,0,2,1,4,2,6,0,2,0,110,73,37,21,12,9,9,20,42,36,6,-1,10,13,20,22,5,2,-1,7,22,14,1,-3,3,8,5,1,3,1,3,3,3,-1,3,1,0,5,2,2,0,0,155,79,76,41,18,23,33,7,68,44,2,-5,5,0,40,34,-1,-3,28,7,28,10,3,-2,7,10,12,7,4,1,2,1,8,4,3,0,5,9,4,3,1,1,138,74,64,25,12,13,15,19,61,27,12,0,9,10,33,12,9,-1,6,9,28,15,3,1,3,6,12,1,1,0,1,1,6,2,0,0,2,5,6,-1,1,0,146,80,66,0,3,-3,41,10,38,26,16,5,21,9,19,14,10,1,20,1,19,12,6,4,-2,0,2,-1,0,0,0,1,2,-1,0,0,-2,-1,0,0,0,0,66,34,32,1,2,-1,6,12,29,10,10,-5,1,7,12,9,6,-3,5,5,17,1,4,-2,2,0,0,-3,1,0,1,1,-1,0,0,0,1,-1,1,-3,1,0,34,23,11,6,2,4,-10,10,-3,17,11,9,8,7,-6,11,3,2,-18,3,3,6,8,7,5,-1,3,3,-2,-2,4,1,-3,3,-1,-2,1,-2,6,0,-1,0,4,-5,9,9,5,4,-13,6,4,19,-9,-6,-14,6,7,7,-11,-3,1,0,-3,12,2,-3,-1,2,-2,2,5,4,0,2,-1,2,0,2,-1,0,-1,0,5,2,5,15,-10,-4,-2,-2,13,-2,9,-14,-9,2,10,-2,7,-4,-1,2,3,0,2,-10,-8,0,2,-1,-1,-5,1,0,1,0,-1,-3,1,0,1,-1,0,-2,0,0,-89,-55,-34,-59,-33,-26,-22,-9,-18,-37,-8,-3,-14,-2,-5,-26,-7,-3,-8,-7,-13,-11,-1,0,-9,-6,-15,-16,-10,-3,-5,-2,-8,-10,-5,-3,-4,-4,-7,-6,-5,0,-14,-12,-2,3,-1,4,-23,-7,16,0,-2,0,-12,1,5,-2,1,-4,-11,-8,11,2,-3,4,-4,0,-2,3,4,2,-2,-1,-2,1,1,2,-2,1,0,2,3,0,-10,-1,-9,11,3,8,-7,-2,11,-10,0,-4,-2,-1,14,-10,-2,0,-5,-1,-3,0,2,-4,3,1,4,-3,3,2,0,0,3,-4,2,1,3,1,1,1,1,1,12,14,-2,2,4,-2,7,-1,3,18,-7,-12,7,4,3,9,-6,-5,0,-5,0,9,-1,-7,4,-2,1,0,0,-1,4,-1,0,1,0,0,0,-1,1,-1,0,-1
19,19319,Villanueva de la Torre,452,608,328,280,14,9,5,121,113,228,81,34,22,60,52,137,44,21,9,61,61,91,37,13,13,1,5,5,3,0,0,0,2,4,3,0,0,1,3,1,0,0,0,844,429,415,33,15,18,167,117,336,165,36,12,76,54,182,92,18,4,91,63,154,73,18,8,9,4,13,2,3,1,2,2,8,1,1,0,7,2,5,1,2,1,602,318,284,49,29,20,96,89,243,95,47,18,52,44,127,56,24,10,44,45,116,39,23,8,7,6,22,9,3,2,6,3,13,6,-1,2,1,3,9,3,4,0,386,176,210,33,16,17,52,59,128,63,47,27,19,19,68,34,21,8,33,40,60,29,26,19,3,7,9,9,3,1,0,3,5,4,2,1,3,4,4,5,1,0,241,125,116,36,19,17,49,-3,118,40,18,10,35,-4,56,20,12,0,14,1,62,20,6,10,6,6,15,6,2,0,3,5,8,1,1,0,3,1,7,5,1,0,266,123,143,43,21,22,44,44,85,45,26,14,12,19,44,32,8,4,32,25,41,13,18,10,13,8,11,8,2,1,8,3,6,5,-1,0,5,5,5,3,3,1,199,100,99,37,19,18,38,46,62,45,-6,4,19,24,36,17,0,3,19,22,26,28,-6,1,5,10,10,7,2,1,3,6,2,5,2,1,2,4,8,2,0,0,158,66,92,48,22,26,30,33,51,2,18,19,4,20,15,3,14,8,26,13,36,-1,4,11,10,16,9,9,2,1,4,9,5,3,1,0,6,7,4,6,1,1,46,12,34,23,12,11,-10,14,13,14,6,5,-10,9,6,4,3,-1,0,5,7,10,3,6,5,9,6,2,1,0,0,4,6,1,1,0,5,5,0,1,0,0,13,16,-3,-40,-8,-32,18,-11,11,-19,2,7,14,-3,4,-7,5,2,4,-8,7,-12,-3,5,-1,-1,-7,-23,-5,-3,0,2,0,-8,-1,-1,-1,-3,-7,-15,-4,-2,19,0,19,-41,-28,-13,-16,12,25,-6,-5,4,-3,6,5,-11,-3,1,-13,6,20,5,-2,3,-15,2,-13,-11,-2,-2,-5,-1,-13,-8,0,-1,-10,3,0,-3,-2,-1,48,34,14,12,11,1,-11,-16,55,-5,5,13,2,-6,35,-5,0,5,-13,-10,20,0,5,8,-4,-1,11,1,3,2,-1,0,9,1,0,2,-3,-1,2,0,3,0,-10,-7,-3,-9,-4,-5,-25,13,-6,-9,0,18,-16,8,4,-6,-4,8,-9,5,-10,-3,4,10,-1,-1,-8,0,-1,1,-3,-2,-2,2,-1,1,2,1,-6,-2,0,0,-102,-46,-56,-23,-19,-4,-41,-3,-11,-56,-10,17,-15,2,-2,-34,-8,9,-26,-5,-9,-22,-2,8,-1,4,-12,-12,-3,0,-1,4,-10,-9,-3,0,0,0,-2,-3,0,0,28,-9,37,-1,-3,2,11,-8,21,-12,-4,20,-1,-3,6,-13,-3,7,12,-5,15,1,-1,13,1,3,-7,-3,2,3,1,4,-5,-4,1,0,0,-1,-2,1,1,3,111,64,47,10,5,5,32,-4,56,-9,13,20,26,-3,34,-4,5,6,6,-1,22,-5,8,14,-1,-2,5,-2,6,3,0,-1,2,0,3,1,-1,-1,3,-2,3,2,-20,-20,0,-16,-12,-4,1,-24,26,-13,-19,6,-5,-12,16,-12,-10,1,6,-12,10,-1,-9,5,2,-3,-2,-8,-1,-4,-1,-1,-3,-4,-1,-2,3,-2,1,-4,0,-2,-19,-24,5,-16,-5,-11,-2,-17,3,-4,-23,24,5,-9,-6,-3,-13,3,-7,-8,9,-1,-10,21,-2,0,-3,-7,-5,-1,1,0,0,-2,-2,-2,-3,0,-3,-5,-3,1
20,20009,Andoain,14249,-60,-34,-26,12,8,4,5,-6,-21,-12,-17,-10,2,1,-14,-6,-12,-6,3,-7,-7,-6,-5,-4,4,1,7,0,0,0,3,1,4,0,0,0,1,0,3,0,0,0,-86,-55,-31,33,17,16,-9,-12,-45,-8,-19,8,-11,-4,-24,-5,-13,2,2,-8,-21,-3,-6,6,6,9,9,7,0,1,1,5,6,4,0,0,5,4,3,3,0,1,-67,-22,-45,42,25,17,1,-14,-10,-3,-24,-15,4,-7,0,4,-14,-10,-3,-7,-10,-7,-10,-5,10,12,11,6,2,1,6,6,5,5,2,1,4,6,6,1,0,0,-66,-52,-14,22,11,11,0,-8,-23,-19,-25,4,-5,-4,-14,-19,-16,2,5,-4,-9,0,-9,2,6,4,9,1,1,0,2,5,4,0,-1,0,4,-1,5,1,2,0,173,90,83,34,19,15,30,42,70,26,-9,15,23,12,47,7,-3,3,7,30,23,19,-6,12,9,2,14,7,0,2,7,0,5,5,0,2,2,2,9,2,0,0,110,69,41,33,19,14,19,8,70,16,-2,-4,8,9,41,11,0,-1,11,-1,29,5,-2,-3,10,3,8,6,2,3,7,6,1,3,0,1,3,-3,7,3,2,2,74,57,17,33,14,19,-5,12,65,-9,9,1,-1,11,50,-7,-1,5,-4,1,15,-2,10,-4,9,10,10,1,6,-4,3,8,4,-1,2,-2,6,2,6,2,4,-2,146,95,51,57,29,28,27,44,41,19,11,1,17,28,28,8,10,1,10,16,13,11,1,0,8,24,5,12,5,2,3,15,3,5,3,1,5,9,2,7,2,1,215,117,98,111,68,43,34,42,85,37,23,-8,8,19,52,21,12,2,26,23,33,16,11,-10,17,26,29,31,8,0,10,12,16,23,6,1,7,14,13,8,2,-1,-55,-6,-49,24,14,10,-25,11,-35,13,-14,3,-6,8,-11,6,-6,5,-19,3,-24,7,-8,-2,2,8,1,11,1,2,5,3,-2,7,-1,2,-3,5,3,4,2,0,-20,-45,25,1,-20,21,4,14,-12,-8,-12,-6,0,2,-16,-12,-11,-7,4,12,4,4,-1,1,1,8,11,-13,-7,0,0,-1,0,-13,-6,0,1,9,11,0,-1,0,-84,-27,-57,10,-6,16,-27,-12,-27,1,-13,-3,-13,-3,-15,9,-6,4,-14,-9,-12,-8,-7,-7,3,5,6,-4,0,0,3,3,-5,-5,-1,-1,0,2,11,1,1,1,-34,-29,-5,1,-1,2,2,10,-35,4,-13,4,3,4,-23,-1,-10,0,-1,6,-12,5,-3,4,6,7,-10,-1,-1,0,2,4,-8,3,-3,1,4,3,-2,-4,2,-1,-15,-21,6,-25,-18,-7,9,9,-3,-19,-12,2,1,10,1,-20,-8,-7,8,-1,-4,1,-4,9,0,1,-3,-17,-4,-1,-2,3,-2,-12,-3,-1,2,-2,-1,-5,-1,0,21,-1,22,14,3,11,8,-6,-3,37,-8,-1,3,-9,-7,23,-7,-3,5,3,4,14,-1,2,11,3,0,3,-4,1,3,-2,4,0,-2,0,8,5,-4,3,-2,1,-42,-17,-25,-2,-8,6,16,6,-44,2,-12,-13,23,3,-34,1,-2,-6,-7,3,-10,1,-10,-7,9,3,-2,-12,0,-1,8,2,-6,-12,1,-1,1,1,4,0,-1,0,54,18,36,54,15,39,33,19,-3,15,-2,-3,17,6,-8,6,2,-2,16,13,5,9,-4,-1,12,20,14,4,5,-1,5,5,3,0,2,0,7,15,11,4,3,-1,16,-10,26,37,7,30,-3,24,7,-18,1,1,-8,8,2,-15,-1,2,5,16,5,-3,2,-1,11,12,6,2,5,2,6,1,2,-2,-1,2,5,11,4,4,6,0
20,20055,Arrasate/Mondragón,23984,-276,-140,-136,37,14,23,-29,-21,-97,-42,-64,-25,-16,-7,-42,-22,-32,-20,-13,-14,-55,-20,-32,-5,4,8,17,4,2,1,0,6,6,0,2,0,4,2,11,4,0,1,-118,-53,-65,56,28,28,-5,1,-32,-24,-38,-19,-3,14,-24,-11,-20,-10,-2,-13,-8,-13,-18,-9,14,13,20,5,3,0,5,10,10,1,2,0,9,3,10,4,1,0,-157,-99,-58,62,21,41,-10,9,-82,-26,-42,-6,-14,6,-50,-19,-24,-1,4,3,-32,-7,-18,-5,8,23,22,3,3,1,5,9,6,0,0,0,3,14,16,3,3,1,-116,-46,-70,60,28,32,13,-18,-40,-18,-43,-10,7,-9,-17,-7,-14,-9,6,-9,-23,-11,-29,-1,19,12,22,5,0,1,12,5,10,1,0,0,7,7,12,4,0,1,-230,-105,-125,80,39,41,-9,-8,-98,-48,-52,-10,-8,6,-37,-32,-25,-6,-1,-14,-61,-16,-27,-4,14,27,26,11,1,1,8,5,20,4,1,1,6,22,6,7,0,0,-253,-141,-112,100,53,47,3,-25,-126,-38,-47,-16,-1,-10,-77,-12,-31,-8,4,-15,-49,-26,-16,-8,22,20,30,23,3,2,12,11,14,13,2,1,10,9,16,10,1,1,-150,-104,-46,125,53,72,6,-16,-91,-19,-31,-4,-1,3,-59,-21,-24,-3,7,-19,-32,2,-7,-1,22,30,40,23,7,0,12,14,15,10,2,0,10,16,25,13,5,0,-108,-46,-62,141,72,69,20,1,-80,8,-37,-22,18,8,-46,7,-20,-13,2,-7,-34,1,-17,-9,24,35,41,31,5,1,8,22,20,15,5,1,16,13,21,16,0,0,134,70,64,156,79,77,43,50,9,63,-27,-9,23,32,6,40,-28,-6,20,18,3,23,1,-3,32,47,35,38,4,0,21,22,13,24,-2,1,11,25,22,14,6,-1,-4,20,-24,91,44,47,42,13,-33,14,-49,4,22,4,-7,13,-18,3,20,9,-26,1,-31,1,45,35,10,6,-6,1,27,16,0,2,-2,1,18,19,10,4,-4,0,-37,-27,-10,59,26,33,28,27,-37,-5,-36,-12,-4,12,-1,-14,-12,-7,32,15,-36,9,-24,-5,21,28,8,0,1,0,8,15,2,1,0,-1,13,13,6,-1,1,1,91,66,25,92,55,37,11,7,56,36,-15,-5,4,8,33,34,-7,-7,7,-1,23,2,-8,2,18,28,31,17,-4,1,9,14,22,11,-2,0,9,14,9,6,-2,1,102,52,50,23,18,5,48,27,29,6,-9,-1,29,20,9,-4,-8,2,19,7,20,10,-1,-3,10,5,11,-2,1,-3,9,8,7,-5,-1,-1,1,-3,4,3,2,-2,103,65,38,28,5,23,42,20,42,9,-4,-10,27,4,39,11,-12,-4,15,16,3,-2,8,-6,16,12,11,-15,-1,2,12,5,3,-8,-7,1,4,7,8,-7,6,1,44,11,33,-5,0,-5,14,12,-18,40,11,-17,11,12,-19,6,14,-13,3,0,1,34,-3,-4,-1,6,-9,-5,-1,2,4,3,-6,-6,2,0,-5,3,-3,1,-3,2,34,-14,48,15,2,13,55,28,-17,8,-26,-22,37,5,-31,0,-21,-5,18,23,14,8,-5,-17,2,18,8,-14,-3,1,9,6,-4,-6,-3,0,-7,12,12,-8,0,1,32,-25,57,94,25,69,28,17,-17,0,-2,-3,12,9,-51,0,0,-1,16,8,34,0,-2,-2,28,32,28,-1,4,4,12,15,5,-7,0,2,16,17,23,6,4,2,151,59,92,147,68,79,69,43,14,13,19,-9,44,18,4,-7,9,-9,25,25,10,20,10,0,51,33,45,8,6,2,30,18,25,-8,3,-1,21,15,20,16,3,3
20,20017,Azkoitia,10212,14,9,5,16,8,8,6,5,13,-4,-1,-4,3,5,9,-5,0,-4,3,0,4,1,-1,0,6,2,3,5,0,0,4,0,2,2,0,0,2,2,1,3,0,0,37,30,7,24,14,10,-1,23,24,-3,-7,-1,0,13,18,-1,-4,3,-1,10,6,-2,-3,-4,7,6,7,2,0,0,4,4,4,1,0,0,3,2,3,1,0,0,23,21,2,23,10,13,7,9,6,1,3,-2,-2,5,13,7,3,-3,9,4,-7,-6,0,1,4,5,5,6,0,2,0,3,3,3,0,1,4,2,2,3,0,1,77,32,45,24,12,12,7,23,47,13,-8,-8,5,16,17,4,-3,-7,2,7,30,9,-5,-1,3,12,3,4,1,0,3,6,3,0,0,0,0,6,0,4,1,0,141,93,48,60,32,28,18,41,71,15,-1,-7,7,17,51,15,3,-3,11,24,20,0,-4,-4,14,14,18,9,4,1,7,7,10,5,2,1,7,7,8,4,2,0,144,89,55,43,30,13,31,35,44,21,-3,9,18,19,31,16,-1,5,13,16,13,5,-2,4,13,11,13,4,1,0,5,7,10,6,1,0,8,4,3,-2,0,0,145,74,71,61,24,37,28,19,74,15,5,7,19,8,48,-2,-1,3,9,11,26,17,6,4,23,18,16,4,-1,-1,13,4,9,-2,-2,0,10,14,7,6,1,-1,264,180,84,137,91,46,54,52,104,47,4,0,33,29,76,38,4,-2,21,23,28,9,0,2,33,35,39,26,5,-2,20,23,24,21,4,-2,13,12,15,5,1,0,117,76,41,89,46,43,15,39,27,24,6,5,10,22,18,19,3,2,5,17,9,5,3,3,19,28,17,17,6,1,11,14,8,7,4,1,8,14,9,10,2,0,45,22,23,10,-18,28,17,11,17,-10,-8,9,11,10,12,-14,-8,5,6,1,5,4,0,4,16,15,-7,-13,-5,2,8,6,-11,-16,-7,2,8,9,4,3,2,0,13,-21,34,52,9,43,25,18,-9,-7,-3,-10,13,14,-24,-18,-2,-3,12,4,15,11,-1,-7,30,16,5,3,-1,-2,13,7,-6,-3,-2,0,17,9,11,6,1,-2,34,53,-19,76,49,27,-1,23,12,1,2,-3,-1,14,33,2,8,-4,0,9,-21,-1,-6,1,17,23,21,9,1,4,11,13,15,7,1,1,6,10,6,2,0,3,-39,-36,-3,-7,-9,2,-9,5,-19,-17,2,-1,-7,-6,-9,-14,3,-2,-2,11,-10,-3,-1,1,4,0,-2,-10,1,0,0,-3,-1,-6,3,-1,4,3,-1,-4,-2,1,-8,6,-14,12,2,10,11,8,5,-22,-17,5,6,8,16,-14,-14,4,5,0,-11,-8,-3,1,6,10,2,-2,-8,3,5,5,2,-5,-6,1,1,5,0,3,-2,2,82,45,37,26,10,16,14,6,40,2,13,4,8,1,11,5,16,3,6,5,29,-3,-3,1,10,8,5,2,2,-2,6,3,3,-3,1,0,4,5,2,5,1,-2,65,9,56,28,14,14,11,14,18,15,4,3,2,4,-7,9,3,-2,9,10,25,6,1,5,-1,14,11,4,-2,2,-1,7,4,4,0,0,0,7,7,0,-2,2,-22,-24,2,10,6,4,7,-2,-15,1,-11,-6,0,-1,-14,1,-8,0,7,-1,-1,0,-3,-6,-3,10,2,9,-8,0,0,2,1,8,-6,1,-3,8,1,1,-2,-1,62,28,34,80,33,47,34,25,-29,20,5,-1,21,4,-12,4,6,0,13,21,-17,16,-1,-1,30,22,17,8,0,-1,15,6,7,3,-1,0,15,16,10,5,1,-1
20,20018,Azpeitia,13560,-22,-10,-12,29,12,17,-4,2,-2,-5,-21,9,-5,3,-3,1,-12,7,1,-1,1,-6,-9,2,3,4,14,7,0,1,1,1,7,3,0,0,2,3,7,4,0,1,44,31,13,53,29,24,10,3,17,3,1,12,7,0,18,3,1,4,3,3,-1,0,0,8,15,15,15,6,0,1,7,8,8,4,0,1,8,7,7,2,0,0,85,40,45,66,33,33,11,19,28,14,1,7,6,7,5,9,4,5,5,12,23,5,-3,2,15,17,22,8,4,-1,8,8,11,2,4,0,7,9,11,6,0,-1,-21,6,-27,35,28,7,3,-2,-11,-7,-5,4,3,3,7,-5,-5,4,0,-5,-18,-2,0,0,10,11,11,3,0,0,5,7,12,4,0,0,5,4,-1,-1,0,0,-29,-26,-3,51,26,25,9,2,-25,-8,-9,4,7,-4,-18,-6,-2,-2,2,6,-7,-2,-7,6,15,13,15,4,2,2,8,6,5,3,3,1,7,7,10,1,-1,1,19,29,-10,83,42,41,-1,15,12,-10,1,2,2,9,21,-5,0,1,-3,6,-9,-5,1,1,18,17,25,18,1,2,10,8,16,7,-1,1,8,9,9,11,2,1,103,68,35,130,80,50,26,19,13,48,-11,3,10,8,19,30,-2,0,16,11,-6,18,-9,3,29,29,32,28,8,2,11,17,23,21,6,1,18,12,9,7,2,1,87,35,52,129,64,65,13,58,-19,34,8,-9,3,25,-22,15,11,2,10,33,3,19,-3,-11,25,44,29,23,6,0,12,21,11,15,4,0,13,23,18,8,2,0,143,115,28,131,88,43,9,31,74,30,-2,-1,10,30,54,24,-6,2,-1,1,20,6,4,-3,15,34,59,22,-3,4,8,21,46,14,-3,2,7,13,13,8,0,2,-138,-110,-28,-33,-36,3,-10,-6,-76,-31,-9,-4,-5,-18,-55,-22,-12,3,-5,12,-21,-9,3,-7,7,1,-23,-18,0,0,8,-8,-23,-15,0,1,-1,9,0,-3,0,-1,11,6,5,33,11,22,19,12,-14,-11,-4,8,14,1,0,-13,-10,14,5,11,-14,2,6,-6,15,14,9,-6,0,-1,11,7,-1,-6,-2,0,4,7,10,0,2,-1,112,60,52,49,20,29,24,21,43,20,-6,10,16,4,27,9,-3,7,8,17,16,11,-3,3,18,15,8,7,-1,2,11,8,3,-1,-2,1,7,7,5,8,1,1,-26,-31,5,-44,-40,-4,18,-13,-29,0,-18,20,5,-6,-17,-7,-10,8,13,-7,-12,7,-8,12,-1,-11,-12,-13,-8,1,0,-8,-16,-12,-4,0,-1,-3,4,-1,-4,1,58,42,16,-11,-5,-6,1,17,14,4,3,13,3,22,4,-3,1,11,-2,-5,10,7,2,2,-11,10,-1,-10,1,-1,-6,5,2,-6,0,-1,-5,5,-3,-4,1,0,93,57,36,9,19,-10,37,14,6,37,-12,5,13,10,5,23,-3,4,24,4,1,14,-9,1,7,4,12,-4,-9,-2,7,5,10,1,-3,-1,0,-1,2,-5,-6,-1,-10,-20,10,14,6,8,5,15,-12,-19,-3,4,-1,-2,-5,-10,-6,4,6,17,-7,-9,3,0,-1,19,0,-6,2,-1,0,7,6,-5,-1,-1,-1,12,-6,-1,3,0,66,29,37,26,7,19,23,17,-9,9,1,23,21,-1,-9,6,1,11,2,18,0,3,0,12,3,24,-1,-2,1,0,4,10,-4,-3,0,0,-1,14,3,1,1,0,94,53,41,64,32,32,9,32,35,-12,4,23,5,23,13,-13,11,12,4,9,22,1,-7,11,16,26,13,-6,4,9,6,16,8,-6,4,4,10,10,5,0,0,5
20,20019,Beasain,12171,-2,-7,5,19,5,14,-8,-2,16,0,-6,0,-3,-1,6,-6,-3,0,-5,-1,10,6,-3,0,1,3,9,4,2,0,0,0,3,1,1,0,1,3,6,3,1,0,61,29,32,43,20,23,14,-1,34,4,-1,11,-1,-2,23,6,4,1,15,1,11,-2,-5,10,10,11,17,2,1,1,2,6,9,1,1,1,8,5,8,1,0,0,73,53,20,36,20,16,20,11,35,27,-18,-3,21,6,15,19,-4,-3,-1,5,20,8,-14,0,5,16,4,9,2,-1,3,9,3,5,1,-1,2,7,1,4,1,0,90,45,45,62,27,35,29,29,51,-11,-4,-2,17,24,22,-8,-3,-4,12,5,29,-3,-1,2,20,18,9,12,1,1,8,9,0,9,0,0,12,9,9,3,1,1,126,83,43,71,41,30,14,27,85,11,-1,-7,8,20,43,13,0,0,6,7,42,-2,-1,-7,11,13,23,18,5,1,4,5,14,13,4,1,7,8,9,5,1,0,90,69,21,78,47,31,0,12,76,2,1,1,5,7,57,3,1,-3,-5,5,19,-1,0,4,9,17,23,26,0,3,6,9,14,18,-1,1,3,8,9,8,1,2,210,126,84,97,50,47,43,40,96,32,-8,-3,38,18,63,3,0,-2,5,22,33,29,-8,-1,29,28,18,20,1,0,19,14,10,4,3,0,10,14,8,16,-2,0,467,362,105,364,256,108,41,159,145,124,1,-12,24,129,106,94,5,0,17,30,39,30,-4,-12,37,122,105,84,7,4,21,91,70,65,5,1,16,31,35,19,2,3,-1,-20,19,63,0,63,26,44,-46,4,-8,-16,15,20,-33,-7,-4,-9,11,24,-13,11,-4,-7,23,25,7,8,-1,0,11,3,-3,-8,-2,0,12,22,10,16,1,0,46,-20,66,34,-2,36,15,52,-2,-13,-10,-1,1,22,-10,-19,-10,-6,14,30,8,6,0,5,6,29,-1,-2,-1,3,3,11,-2,-13,-2,1,3,18,1,11,1,2,-6,-14,8,-8,-32,24,3,37,-2,-31,-11,5,8,4,-1,-21,-2,1,-5,33,-1,-10,-9,4,6,21,-8,-29,0,3,6,4,-14,-28,-1,2,0,17,6,-1,1,1,107,50,57,16,-12,28,29,40,51,-11,-3,-1,13,19,18,2,-8,1,16,21,33,-13,5,-2,4,35,-18,-4,-6,3,-1,9,-13,-7,-4,1,5,26,-5,3,-2,2,-87,-60,-27,-37,-42,5,-17,8,-38,-20,-14,-7,-12,12,-30,-14,-9,-9,-5,-4,-8,-6,-5,2,-7,11,-10,-20,-8,0,-10,5,-14,-14,-7,0,3,6,4,-6,-1,0,-1,8,-9,-33,-17,-16,-1,26,-34,8,-1,1,1,13,-21,9,1,0,-2,13,-13,-1,-2,1,-15,14,-16,-15,-1,0,-3,2,-9,-8,1,-1,-12,12,-7,-7,-2,1,134,84,50,4,3,1,60,45,6,10,11,-2,37,26,15,-2,5,1,23,19,-9,12,6,-3,3,29,4,-22,-9,-2,3,17,8,-18,-7,0,0,12,-4,-4,-2,-2,-50,-54,4,25,-5,30,-12,23,-23,-2,-25,-11,-6,26,-40,-4,-23,-6,-6,-3,17,2,-2,-5,10,21,7,8,-18,-2,6,13,-5,-2,-15,-1,4,8,12,10,-3,-1,-92,-77,-15,-8,-5,-3,0,1,-42,-31,-15,-4,-4,-10,-27,-19,-14,-2,4,11,-15,-12,-1,-2,1,28,-16,-10,-10,-2,4,12,-4,-9,-8,-1,-3,16,-12,-1,-2,-1,42,9,33,20,0,20,13,31,-15,8,-5,5,6,19,-4,-15,-2,0,7,12,-11,23,-3,5,5,11,6,-2,-8,0,6,3,0,-8,-5,-1,-1,8,6,6,-3,1
20,20074,Bergara,15141,-76,-44,-32,23,11,12,-6,-2,-24,-18,-22,-10,-6,0,-12,-12,-11,-7,0,-2,-12,-6,-11,-3,7,5,8,1,0,0,2,2,4,1,0,0,5,3,4,0,0,0,38,51,-13,43,27,16,-5,16,29,-3,1,-5,-2,15,32,7,0,-3,-3,1,-3,-10,1,-2,9,11,14,6,0,1,7,6,9,3,0,0,2,5,5,3,0,1,-4,2,-6,47,32,15,-13,16,14,2,-16,-9,-10,5,15,6,-7,-8,-3,11,-1,-4,-9,-1,5,12,14,9,3,2,2,11,9,6,2,1,3,1,5,3,1,1,-87,-36,-51,41,26,15,4,-10,-33,-14,-18,-15,3,3,-7,-12,-9,-10,1,-13,-26,-2,-9,-5,10,6,10,9,5,0,5,4,10,5,2,0,5,2,0,4,3,0,-20,-17,-3,120,58,62,8,18,-32,0,-5,-14,5,7,-16,-5,-5,-6,3,11,-16,5,0,-8,21,29,41,22,4,0,11,13,18,11,3,0,10,16,23,11,1,0,57,25,32,125,68,57,3,46,27,5,-14,-15,-7,27,21,1,-11,-11,10,19,6,4,-3,-4,20,38,40,20,3,1,7,26,24,9,-1,1,13,12,16,11,4,0,-4,-28,24,177,78,99,33,49,-50,-18,-11,-8,15,24,-38,-24,-2,-5,18,25,-12,6,-9,-3,38,65,45,22,3,1,19,28,16,9,3,1,19,37,29,13,0,0,-68,-41,-27,102,41,61,16,-15,-28,-6,-23,-11,10,-4,-14,-11,-14,-8,6,-11,-14,5,-9,-3,22,27,24,26,2,0,11,11,7,9,2,0,11,16,17,17,0,0,-38,-32,-6,63,24,39,8,6,-46,15,-16,-1,1,6,-41,8,-5,2,7,0,-5,7,-11,-3,11,21,14,11,2,3,4,16,1,1,1,1,7,5,13,10,1,2,-51,-26,-25,30,18,12,29,-16,-20,-15,-19,-9,20,0,-17,-8,-13,-7,9,-16,-3,-7,-6,-2,14,3,6,5,6,-4,10,3,4,-1,5,-3,4,0,2,6,1,-1,-55,-22,-33,17,5,12,9,4,-24,-24,-22,1,10,8,-23,-5,-17,2,-1,-4,-1,-19,-5,-1,19,8,-2,-6,-6,1,13,3,-9,-1,-4,0,6,5,7,-5,-2,1,128,85,43,60,31,29,38,26,53,21,-3,-11,22,17,35,14,1,-5,16,9,18,7,-4,-6,14,18,15,11,3,-1,7,6,10,7,2,-1,7,12,5,4,1,0,73,17,56,-4,-6,2,10,19,15,0,32,-7,-2,7,1,-9,17,0,12,12,14,9,15,-7,-2,6,-5,-3,-1,1,1,4,-6,-2,-3,0,-3,2,1,-1,2,1,93,40,53,41,12,29,8,18,27,27,5,9,7,7,10,15,0,2,1,11,17,12,5,7,16,12,18,-8,2,1,12,5,3,-5,-3,0,4,7,15,-3,5,1,-16,1,-17,9,11,-2,10,1,3,1,-21,-8,12,3,-7,6,-11,-1,-2,-2,10,-5,-10,-7,7,13,-8,-3,0,0,6,5,-2,-1,3,0,1,8,-6,-2,-3,0,-27,-20,-7,50,12,38,-2,-10,7,-16,-13,5,-2,-5,3,-18,-1,3,0,-5,4,2,-12,2,9,9,24,6,3,-1,6,1,5,-2,2,0,3,8,19,8,1,-1,19,12,7,54,24,30,43,-2,-22,4,-8,2,28,-9,-11,7,1,-3,15,7,-11,-3,-9,5,21,10,0,15,4,3,9,4,0,9,0,2,12,6,0,6,4,1,-13,20,-33,24,27,-3,2,9,-31,8,0,-3,5,12,-5,11,-2,2,-3,-3,-26,-3,2,-5,12,7,-13,11,4,1,9,8,-3,11,2,0,3,-1,-10,0,2,1
20,20029,Deba,5090,46,11,35,7,1,6,0,-1,24,12,1,12,-4,2,6,2,0,5,4,-3,18,10,1,7,2,1,1,3,0,0,0,1,0,0,0,0,2,0,1,3,0,0,49,25,24,15,5,10,5,15,7,11,12,-2,6,5,7,2,9,-4,-1,10,0,9,3,2,1,6,6,1,1,0,1,3,0,0,1,0,0,3,6,1,0,0,47,32,15,16,9,7,9,9,17,9,1,0,5,6,13,7,1,0,4,3,4,2,0,0,2,7,1,4,1,0,2,4,1,1,0,0,0,3,0,3,1,0,-20,-1,-19,3,4,-1,-10,0,-18,-7,7,5,-5,1,-7,1,4,4,-5,-1,-11,-8,3,1,0,3,2,-2,-1,1,0,1,4,-2,0,1,0,2,-2,0,-1,0,13,19,-6,12,4,8,-12,9,8,4,0,2,-3,7,9,3,-1,2,-9,2,-1,1,1,0,3,1,3,2,3,0,0,0,1,3,1,-1,3,1,2,-1,2,1,33,11,22,37,17,20,1,21,3,0,10,0,1,11,-4,-3,8,-2,0,10,7,3,2,2,4,16,7,7,3,0,3,9,1,2,2,0,1,7,6,5,1,0,33,8,25,29,8,21,-8,15,18,-1,0,9,-6,8,4,-2,-5,8,-2,7,14,1,5,1,2,12,7,2,3,2,2,3,2,0,0,1,0,9,5,2,3,1,22,8,14,47,21,26,-2,9,16,11,6,-15,-1,1,11,-2,2,-2,-1,8,5,13,4,-13,10,16,13,7,1,0,7,6,7,0,1,0,3,10,6,7,0,0,-9,-4,-5,40,23,17,7,6,-7,7,-13,-10,1,6,-4,4,-6,-6,6,0,-3,3,-7,-4,10,13,12,4,1,0,6,8,5,3,1,0,4,5,7,1,0,0,-17,-8,-9,17,9,8,-9,5,-8,-7,-2,7,-5,5,-3,0,-2,1,-4,0,-5,-7,0,6,4,1,4,5,0,3,1,0,2,4,1,1,3,1,2,1,-1,2,28,7,21,14,2,12,16,6,0,-8,9,0,8,-4,4,-7,3,0,8,10,-4,-1,6,0,5,6,2,-1,2,-1,3,1,-2,-1,0,0,2,5,4,0,2,-1,18,19,-1,32,13,19,-2,1,14,-4,4,5,3,4,5,0,2,4,-5,-3,9,-4,2,1,9,8,13,1,0,1,6,4,4,-1,-1,1,3,4,9,2,1,0,-20,-4,-16,15,8,7,-2,9,5,-17,-9,-6,-1,8,3,-9,-3,-2,-1,1,2,-8,-6,-4,5,3,7,1,1,-2,4,1,2,0,2,-1,1,2,5,1,-1,-1,24,14,10,11,3,8,1,12,-1,6,6,5,7,7,2,-1,4,-2,-6,5,-3,7,2,7,11,5,1,-3,-2,-1,6,3,-1,-3,-2,0,5,2,2,0,0,-1,26,10,16,3,0,3,16,-6,3,0,12,3,6,-9,6,0,6,3,10,3,-3,0,6,0,5,0,-3,2,-1,0,2,-2,1,0,-1,0,3,2,-4,2,0,0,29,12,17,23,8,15,13,4,-2,15,-8,2,7,1,-2,12,-4,-3,6,3,0,3,-4,5,9,6,6,-1,2,0,6,2,1,-1,0,0,3,4,5,0,2,0,47,4,43,19,13,6,24,12,-5,13,7,-5,8,7,-14,4,0,-2,16,5,9,9,7,-3,10,9,-4,-1,5,0,6,5,-3,2,2,1,4,4,-1,-3,3,-1,-22,-7,-15,20,6,14,-4,-4,15,-11,-10,-8,0,0,6,-10,-4,0,-4,-4,9,-1,-6,-8,4,6,8,-2,3,0,-1,1,5,-2,2,0,5,5,3,0,1,0
20,20069,Donostia-San Sebastián,179208,480,197,283,438,207,231,138,97,-56,163,72,57,53,89,-34,67,20,3,85,8,-22,96,52,54,88,76,131,79,29,23,48,33,61,35,16,12,40,43,70,44,13,11,-189,-144,-45,138,66,72,2,8,-232,-30,46,19,17,22,-179,-36,31,0,-15,-14,-53,6,15,19,44,26,25,13,7,12,20,12,7,8,5,7,24,14,18,5,2,5,-503,-266,-237,18,15,3,21,-54,-370,-115,-3,38,8,8,-195,-81,-12,23,13,-62,-175,-34,9,15,69,-21,-47,-9,19,2,31,-8,-12,-6,8,2,38,-13,-35,-3,11,0,-127,-46,-81,-41,-40,-1,33,73,-357,-28,76,92,36,40,-154,-9,20,32,-3,33,-203,-19,56,60,70,-5,-101,-41,7,24,30,0,-54,-29,4,8,40,-5,-47,-12,3,16,325,38,287,746,312,434,83,216,-203,101,9,120,23,99,-119,39,-33,33,60,117,-84,62,42,87,143,232,196,85,35,36,81,94,93,18,3,14,62,138,103,67,32,22,669,97,572,1129,439,690,107,347,-26,102,36,73,13,161,-118,9,15,10,94,186,92,93,21,63,162,358,326,159,64,32,62,154,133,48,20,9,100,204,193,111,44,23,552,112,440,1344,568,776,166,399,-122,85,50,-17,91,160,-128,-9,14,-11,75,239,6,94,36,-6,190,461,445,163,45,13,103,194,192,58,9,0,87,267,253,105,36,13,1307,523,784,1761,742,1019,148,561,263,171,108,56,88,253,108,17,53,2,60,308,155,154,55,54,245,594,580,236,73,15,133,249,232,83,32,7,112,345,348,153,41,8,1457,664,793,1325,545,780,142,472,512,195,57,88,87,236,192,84,31,43,55,236,320,111,26,45,160,458,477,181,17,16,91,198,163,63,11,14,69,260,314,118,6,2,475,159,316,460,74,386,197,242,48,45,1,-40,139,114,-46,-9,-2,-21,58,128,94,54,3,-19,172,241,51,-8,-14,5,104,71,-39,-50,-19,-1,68,170,90,42,5,6,854,288,566,611,151,460,178,318,211,148,6,-23,87,98,50,64,7,-21,91,220,161,84,-1,-2,114,274,168,56,-8,-3,56,62,39,3,-12,0,58,212,129,53,4,-3,639,233,406,568,153,415,107,372,198,-2,-3,-59,21,181,70,-26,-15,-16,86,191,128,24,12,-43,106,267,186,-22,2,7,38,86,48,-24,-8,-1,68,181,138,2,10,8,736,309,427,235,53,182,98,404,220,56,-20,-57,47,145,111,16,10,-33,51,259,109,40,-30,-24,77,235,-30,-57,-10,2,23,85,-21,-51,2,4,54,150,-9,-6,-12,-2,146,-1,147,-220,-180,-40,121,226,31,-91,-104,-41,60,87,-19,-80,-44,-8,61,139,50,-11,-60,-33,48,102,-138,-149,-83,-19,34,30,-88,-98,-50,-14,14,72,-50,-51,-33,-5,581,352,229,255,95,160,134,295,81,101,11,-38,107,114,80,102,-35,-20,27,181,1,-1,46,-18,96,226,4,-69,-3,-19,50,84,15,-46,-12,-9,46,142,-11,-23,9,-10,675,277,398,475,160,315,180,314,139,34,6,1,80,161,37,15,-21,-2,100,153,102,19,27,3,162,269,104,-61,-12,-1,73,119,28,-56,-11,1,89,150,76,-5,-1,-2,1057,407,650,841,313,528,372,394,115,116,40,31,173,167,44,31,0,7,199,227,71,85,40,24,220,322,213,4,36,20,104,134,95,-32,-2,4,116,188,118,36,38,16,1114,431,683,1158,497,661,192,413,321,111,59,17,89,191,156,-20,14,7,103,222,165,131,45,10,241,389,327,121,51,8,140,182,130,15,17,5,101,207,197,106,34,3
20,20030,Eibar,29339,-239,-117,-122,70,30,40,3,-7,-78,-55,-57,-39,0,6,-36,-33,-31,-20,3,-13,-42,-22,-26,-19,16,19,25,5,4,1,10,8,8,1,2,1,6,11,17,4,2,0,-38,-16,-22,82,43,39,15,32,-30,-1,-20,-29,7,29,-15,-2,-13,-18,8,3,-15,1,-7,-11,18,18,30,13,2,1,11,10,14,8,0,0,7,8,16,5,2,1,-173,-62,-111,83,46,37,-3,-11,-97,-19,-37,-5,-3,9,-45,-15,-17,7,0,-20,-52,-4,-20,-12,16,20,21,14,3,7,10,14,9,9,0,3,6,6,12,5,3,4,-70,-70,0,116,44,72,29,-1,-29,-20,-36,-23,12,0,-28,-24,-22,-9,17,-1,-1,4,-14,-14,33,28,30,13,4,3,14,11,14,-2,4,2,19,17,16,15,0,1,-110,-64,-46,67,25,42,8,23,-65,-26,-35,-19,7,16,-42,-8,-23,-15,1,7,-23,-18,-12,-4,17,21,23,0,3,0,8,11,8,0,-2,-1,9,10,15,0,5,1,-179,-113,-66,136,52,84,3,1,-91,-8,-59,-24,-4,2,-55,0,-36,-15,7,-1,-36,-8,-23,-9,26,38,47,17,4,1,9,13,23,5,0,1,17,25,24,12,4,0,-21,-4,-17,158,71,87,34,57,-27,-3,-43,-35,12,29,-2,-4,-17,-20,22,28,-25,1,-26,-15,29,51,55,12,6,4,12,20,27,7,3,2,17,31,28,5,3,2,122,92,30,233,132,101,42,53,52,21,-21,-29,32,28,33,10,-1,-12,10,25,19,11,-20,-17,40,58,70,56,8,0,23,32,40,31,4,1,17,26,30,25,4,-1,16,-15,31,166,96,70,26,20,15,4,-3,-50,-2,10,9,-1,-4,-27,28,10,6,5,1,-23,27,50,57,29,3,-1,8,30,35,19,5,-1,19,20,22,10,-2,0,-1,-30,29,60,22,38,10,52,-2,-19,-1,-43,17,16,-26,-20,-3,-14,-7,36,24,1,2,-29,18,26,0,3,7,3,19,8,-6,-1,0,1,-1,18,6,4,7,2,70,51,19,53,33,20,23,14,2,27,19,-22,5,16,14,15,9,-10,18,-2,-12,12,10,-12,9,31,9,7,-5,1,4,20,9,5,-5,0,5,11,0,2,0,1,175,109,66,40,16,24,53,25,68,46,-7,-17,31,8,46,32,-3,-7,22,17,22,14,-4,-10,9,16,13,0,0,1,8,2,5,3,-2,0,1,14,8,-3,2,1,72,37,35,52,24,28,33,37,-5,20,-2,-23,12,35,-5,3,-11,-4,21,2,0,17,9,-19,29,30,12,-10,-3,-5,16,19,2,-13,0,0,13,11,10,3,-3,-5,85,31,54,23,8,15,66,47,5,37,-43,-37,42,18,-1,2,-18,-15,24,29,6,35,-25,-22,17,16,5,-8,-11,1,8,8,4,-8,-6,0,9,8,1,0,-5,1,108,36,72,-4,-12,8,78,24,69,-4,-36,-33,40,7,20,-5,-20,-14,38,17,49,1,-16,-19,13,10,10,-26,-15,1,6,4,2,-19,-7,1,7,6,8,-7,-8,0,47,-3,50,46,9,37,51,25,-9,13,-8,-29,17,22,-8,-15,-6,-17,34,3,-1,28,-2,-12,25,11,7,-9,8,1,13,4,1,-14,4,0,12,7,6,5,4,1,171,80,91,128,59,69,48,74,46,20,0,-20,26,42,10,11,-2,-10,22,32,36,9,2,-10,56,56,25,-1,-6,-6,30,24,8,1,-3,-2,26,32,17,-2,-3,-4,160,98,62,129,54,75,36,61,86,27,-6,-48,30,32,55,6,-6,-19,6,29,31,21,0,-29,16,49,42,14,6,1,10,21,24,1,-3,1,6,28,18,13,9,0
20,20032,Elgoibar,10750,-58,-23,-35,13,5,8,-1,-19,-4,-27,-9,1,0,-5,-2,-12,-5,2,-1,-14,-2,-15,-4,-1,3,0,5,2,2,1,2,0,0,2,0,1,1,0,5,0,2,0,-13,-13,0,11,3,8,3,7,-7,-3,-11,-2,1,-1,0,-2,-8,-3,2,8,-7,-1,-3,1,1,3,2,3,2,0,0,0,1,1,1,0,1,3,1,2,1,0,33,17,16,30,22,8,17,11,9,4,-12,-1,13,15,-5,3,-8,-2,4,-4,14,1,-4,1,7,6,11,3,0,1,6,6,6,3,-1,1,1,0,5,0,1,0,-62,-29,-33,17,8,9,8,-17,-23,2,-13,-18,5,-15,-7,-1,-2,-7,3,-2,-16,3,-11,-11,9,0,6,1,1,0,4,1,3,0,0,0,5,-1,3,1,1,0,14,10,4,33,16,17,20,10,1,-6,-1,-13,13,5,-3,0,-3,-3,7,5,4,-6,2,-10,4,14,12,0,3,0,3,6,5,1,1,0,1,8,7,-1,2,0,155,85,70,51,17,34,13,16,84,32,-3,3,4,7,51,19,-4,1,9,9,33,13,1,2,10,17,19,5,0,0,3,7,7,0,0,0,7,10,12,5,0,0,192,116,76,73,35,38,23,38,70,37,21,0,11,19,44,28,12,1,12,19,26,9,9,-1,7,26,26,9,2,2,0,12,15,5,1,2,7,14,11,4,1,0,144,71,73,78,40,38,29,52,40,22,-5,-1,9,30,14,20,-3,-3,20,22,26,2,-2,2,11,25,19,15,6,2,4,14,7,10,5,0,7,11,12,5,1,2,136,103,33,73,50,23,15,34,55,26,-3,3,16,20,44,18,-1,0,-1,14,11,8,-2,3,8,25,22,13,3,2,6,17,16,9,1,1,2,8,6,4,2,1,66,1,65,33,-1,34,26,22,12,17,-12,-2,12,14,-12,2,-16,0,14,8,24,15,4,-2,18,22,5,-5,-6,-1,10,10,-2,-8,-11,0,8,12,7,3,5,-1,34,18,16,19,0,19,0,7,26,10,-4,-5,3,4,11,6,-5,-1,-3,3,15,4,1,-4,7,3,-3,4,5,2,6,-2,-4,-2,0,1,1,5,1,6,5,1,49,22,27,63,47,16,14,13,15,25,0,-14,6,11,-1,10,2,-6,8,2,16,15,-2,-8,7,17,27,12,-1,-2,7,9,19,8,2,0,0,8,8,4,-3,-2,93,50,43,15,11,4,32,31,42,-1,-12,-2,20,16,15,2,-4,-2,12,15,27,-3,-8,0,-1,17,7,-8,-1,0,-1,11,1,-1,-1,1,0,6,6,-7,0,-1,-22,-15,-7,1,-2,3,-1,-1,-2,-10,-9,-4,0,-3,4,-8,-8,-3,-1,2,-6,-2,-1,-1,3,8,-1,-9,-1,0,5,8,-2,-14,0,0,-2,0,1,5,-1,0,95,35,60,33,7,26,33,2,7,47,10,-7,6,3,1,26,3,-5,27,-1,6,21,7,-2,9,10,9,3,1,0,-2,5,3,0,1,0,11,5,6,3,0,0,53,37,16,34,16,18,11,25,-3,27,0,-9,9,6,11,4,6,-3,2,19,-14,23,-6,-6,9,8,14,4,0,-1,4,2,9,0,1,0,5,6,5,4,-1,-1,4,-11,15,35,14,21,5,14,1,-8,2,-10,0,17,-16,-5,1,-8,5,-3,17,-3,1,-2,3,15,17,-6,2,2,-1,11,5,-4,0,2,4,4,12,-2,2,0,41,10,31,58,37,21,18,25,29,0,-10,-17,4,8,19,-7,-8,-4,14,17,10,7,-2,-13,5,28,17,5,3,0,0,19,16,2,1,-1,5,9,1,3,2,1
20,20067,Errenteria,39189,-284,-165,-119,66,29,37,-22,-34,-106,-78,-31,-14,-26,-19,-39,-48,-28,-4,4,-15,-67,-30,-3,-10,11,21,22,6,5,0,2,8,11,4,3,0,9,13,11,2,2,0,-202,-73,-129,111,65,46,-14,4,-83,-45,-42,-17,13,1,-27,-25,-21,-13,-27,3,-56,-20,-21,-4,18,23,46,15,4,3,14,12,29,7,2,1,4,11,17,8,2,2,-295,-131,-164,69,35,34,-26,7,-136,-44,-47,-33,-14,-2,-48,-14,-27,-19,-12,9,-88,-30,-20,-14,32,21,1,14,3,0,19,8,0,8,0,0,13,13,1,6,3,0,-261,-117,-144,90,38,52,-29,28,-94,-75,-61,-20,-15,20,-29,-43,-33,-11,-14,8,-65,-32,-28,-9,23,27,21,8,7,0,11,12,8,1,4,1,12,15,13,7,3,-1,-274,-147,-127,67,35,32,-16,-19,-93,-33,-47,-58,-12,-6,-55,-19,-21,-31,-4,-13,-38,-14,-26,-27,24,16,16,7,3,-1,12,9,6,6,2,-1,12,7,10,1,1,0,-23,0,-23,106,48,58,-10,43,3,-23,-28,-11,-4,27,10,-8,-18,-7,-6,16,-7,-15,-10,-4,33,37,16,18,-2,2,18,13,7,11,-4,4,15,24,9,7,2,-2,436,239,197,94,36,58,58,124,198,84,-21,-10,44,54,106,59,-19,-7,14,70,92,25,-2,-3,22,43,10,11,9,0,16,21,-6,2,3,0,6,22,16,9,6,0,158,87,71,164,86,78,52,90,11,43,-22,-10,31,49,7,20,-17,1,21,41,4,23,-5,-11,33,76,23,20,7,4,18,38,16,9,3,1,15,38,7,11,4,3,239,134,105,196,98,98,34,49,90,57,-2,7,25,20,58,43,-11,-1,9,29,32,14,9,8,37,53,64,35,7,2,24,28,23,24,0,0,13,25,41,11,7,2,205,63,142,82,34,48,66,67,59,31,-7,-16,29,17,-3,26,-7,-2,37,50,62,5,0,-14,30,28,8,5,11,1,23,10,-5,3,4,0,7,18,13,2,7,1,168,93,75,85,35,50,88,50,16,30,1,-16,44,30,1,20,3,-6,44,20,15,10,-2,-10,38,36,8,1,1,0,15,21,-1,-4,5,-1,23,15,9,5,-4,1,120,-6,126,74,8,66,34,36,20,9,14,7,9,-1,-8,-17,-2,9,25,37,28,26,16,-2,21,33,15,5,-3,2,9,1,5,-6,-2,0,12,32,10,11,-1,2,-68,-22,-46,-17,-15,-2,3,31,-59,-32,1,-1,6,7,-13,-21,5,-6,-3,24,-46,-11,-4,5,-6,20,-22,0,-5,-3,-3,2,-9,-2,-1,-2,-3,18,-13,2,-4,-1,143,67,76,-34,-39,5,50,59,54,7,-17,-10,0,33,31,9,-4,-2,50,26,23,-2,-13,-8,11,-1,-14,-13,-17,-3,-4,-7,-9,-7,-10,-1,15,6,-5,-6,-7,-2,103,72,31,31,11,20,57,39,52,-5,-12,-34,11,46,34,5,-3,-22,46,-7,18,-10,-9,-12,22,18,0,0,-5,-4,7,9,-3,0,-2,0,15,9,3,0,-3,-4,171,50,121,86,22,64,42,62,50,-4,15,-3,12,35,12,-7,-8,-3,30,27,38,3,23,0,29,35,22,-17,9,3,16,22,-5,-17,1,2,13,13,27,0,8,1,151,46,105,154,57,97,21,55,44,18,16,-19,18,22,4,-7,12,-11,3,33,40,25,4,-8,43,46,44,21,-4,1,20,18,17,6,-6,0,23,28,27,15,2,1,139,17,122,185,77,108,11,74,18,40,16,-25,-9,30,-4,0,11,-13,20,44,22,40,5,-12,41,53,49,18,16,5,21,16,23,9,5,4,20,37,26,9,11,1
20,20039,Getaria,2430,5,9,-4,15,8,7,1,8,-1,-1,-2,2,0,8,3,0,-1,1,1,0,-4,-1,-1,1,1,6,6,1,1,0,0,2,4,1,1,0,1,4,2,0,0,0,-11,-9,-2,23,11,12,2,-1,0,-3,-5,-3,3,-1,-1,-2,-4,-2,-1,0,1,-1,-1,-1,4,5,9,3,1,0,3,2,5,1,0,0,1,3,4,2,1,0,40,23,17,12,6,6,6,-2,29,5,6,-4,5,2,16,1,3,-2,1,-4,13,4,3,-2,3,3,6,0,0,-1,2,2,2,0,0,0,1,1,4,0,0,-1,11,14,-3,32,20,12,-4,4,8,1,7,-3,-1,7,3,0,5,1,-3,-3,5,1,2,-4,5,9,10,6,1,1,4,7,5,3,0,1,1,2,5,3,1,0,34,17,17,27,12,15,3,7,10,7,-1,3,3,6,2,6,-2,1,0,1,8,1,1,2,6,8,12,0,0,0,2,5,6,0,-1,0,4,3,6,0,1,0,-12,-9,-3,3,2,1,1,2,-3,-13,2,0,-1,1,2,-9,-1,0,2,1,-5,-4,3,0,-4,5,4,-2,0,0,-3,0,5,0,0,0,-1,5,-1,-2,0,0,13,7,6,21,11,10,-3,15,0,-7,2,6,-2,9,3,-5,-2,4,-1,6,-3,-2,4,2,3,11,6,0,1,0,1,6,3,0,1,0,2,5,3,0,0,0,68,36,32,34,14,20,10,8,26,19,6,-3,6,4,12,11,3,-2,4,4,14,8,3,-1,5,11,9,8,1,0,2,4,4,4,0,0,3,7,5,4,1,0,35,22,13,24,14,10,7,2,3,14,4,4,6,1,3,8,2,1,1,1,0,6,2,3,4,4,11,7,-2,0,3,2,6,4,-1,0,1,2,5,3,-1,0,41,16,25,21,7,14,8,11,24,3,-1,-4,1,4,12,0,1,-2,7,7,12,3,-2,-2,4,10,5,2,0,0,2,4,1,-1,1,0,2,6,4,3,-1,0,-16,-9,-7,16,8,8,-17,6,8,-18,0,5,-10,3,8,-10,-2,1,-7,3,0,-8,2,4,0,8,8,-2,2,0,0,3,6,-2,1,0,0,5,2,0,1,0,16,10,6,6,3,3,1,2,3,9,3,-1,3,4,-3,7,0,-1,-2,-2,6,2,3,0,1,1,1,2,1,0,2,3,-1,-1,0,0,-1,-2,2,3,1,0,-2,2,-4,6,5,1,-8,-2,6,12,-8,-1,-7,1,3,6,1,-2,-1,-3,3,6,-9,1,0,-1,4,4,-2,1,0,1,2,2,0,0,0,-2,2,2,-2,1,39,27,12,16,9,7,11,3,15,3,10,-2,7,4,4,5,7,1,4,-1,11,-2,3,-3,3,5,8,-2,2,0,1,2,4,0,2,0,2,3,4,-2,0,0,47,23,24,10,5,5,7,8,23,2,3,3,0,1,18,3,-1,2,7,7,5,-1,4,1,2,8,1,-3,0,2,1,4,1,-2,0,1,1,4,0,-1,0,1,23,12,11,18,4,14,0,10,9,0,4,0,1,3,5,5,-3,2,-1,7,4,-5,7,-2,4,5,4,2,2,1,1,0,1,1,0,1,3,5,3,1,2,0,9,5,4,6,-1,7,4,1,6,-4,4,-1,0,4,-1,-4,7,-1,4,-3,7,0,-3,0,2,2,4,0,0,-3,-1,3,0,-2,0,-2,3,-1,4,2,0,-1,0,-8,8,19,13,6,1,4,1,-3,-1,-2,4,2,-2,-9,-2,-1,-3,2,3,6,1,-1,11,2,3,2,0,1,8,0,3,0,1,1,3,2,0,2,-1,0
20,20040,Hernani,18682,-145,-93,-52,39,20,19,-25,-13,-67,-12,-15,-1,-10,-8,-50,-10,-6,-3,-15,-5,-17,-2,-9,2,8,10,7,10,1,2,3,6,2,7,1,1,5,4,5,3,0,1,102,51,51,51,24,27,0,12,76,25,-5,-7,1,5,40,7,0,-3,-1,7,36,18,-5,-4,17,9,17,6,0,1,9,5,7,1,0,1,8,4,10,5,0,0,72,46,26,56,29,27,15,15,43,-11,2,9,1,3,40,-1,0,3,14,12,3,-10,2,6,11,11,22,2,4,4,7,1,16,1,1,2,4,10,6,1,3,2,53,19,34,50,21,29,19,19,26,-12,9,-10,9,10,8,-9,4,-5,10,9,18,-3,5,-5,23,14,14,-1,3,-4,8,7,6,-1,3,-2,15,7,8,0,0,-2,10,-9,19,34,14,20,8,10,-16,-9,9,9,2,6,-20,-6,7,2,6,4,4,-3,2,7,9,8,4,4,3,5,5,4,0,1,1,2,4,4,4,3,2,3,104,40,64,33,19,14,7,13,67,15,6,-5,8,-2,27,11,0,-2,-1,15,40,4,6,-3,6,11,17,0,-1,-1,7,4,6,4,-1,0,-1,7,11,-4,0,-1,190,106,84,109,53,56,29,36,105,14,0,-1,14,25,63,6,-2,-2,15,11,42,8,2,1,18,28,47,12,0,1,11,14,21,6,-1,1,7,14,26,6,1,0,142,70,72,148,72,76,25,46,29,38,-3,1,-2,19,25,24,0,4,27,27,4,14,-3,-3,30,32,53,27,1,3,12,15,24,17,2,2,18,17,29,10,-1,1,52,39,13,128,70,58,3,51,-2,-13,-1,6,10,34,-1,-9,0,4,-7,17,-1,-4,-1,2,21,40,39,16,7,2,12,21,23,10,3,1,9,19,16,6,4,1,-67,-49,-18,33,7,26,-6,21,-28,-34,-14,-4,-4,12,-26,-19,-7,-3,-2,9,-2,-15,-7,-1,13,14,7,-6,4,0,7,3,1,-7,2,0,6,11,6,1,2,0,-4,-25,21,-10,-18,8,2,16,-5,-11,-14,9,-7,13,-13,-17,-4,6,9,3,8,6,-10,3,-1,15,-22,-3,-3,3,-3,9,-18,-8,0,2,2,6,-4,5,-3,1,-11,-5,-6,43,8,35,-4,40,-23,-22,-1,3,7,22,-13,-14,-6,6,-11,18,-10,-8,5,-3,17,17,5,5,-2,1,12,4,-4,-2,0,-1,5,13,9,7,-2,2,104,60,44,10,-8,18,27,14,16,3,30,12,15,2,19,3,16,3,12,12,-3,0,14,9,10,3,-7,-3,9,-3,6,-3,-5,-10,4,0,4,6,-2,7,5,-3,193,114,79,37,15,22,53,23,22,66,23,-1,29,15,4,40,22,-1,24,8,18,26,1,0,14,12,-3,5,5,0,2,3,-3,4,8,-1,12,9,0,1,-3,1,50,-11,61,27,2,25,31,19,11,2,4,-15,2,17,-12,-12,3,-7,29,2,23,14,1,-8,5,23,1,-9,6,1,3,11,1,-13,-1,1,2,12,0,4,7,0,141,64,77,43,23,20,34,18,19,34,24,7,21,0,8,22,8,6,13,18,11,12,16,1,9,16,18,-5,2,2,5,0,17,0,0,1,4,16,1,-5,2,1,326,161,165,39,3,36,73,27,154,64,-6,-1,37,15,74,35,-10,0,36,12,80,29,4,-1,17,19,4,2,-8,3,8,5,1,-6,-8,1,9,14,3,8,0,2,306,157,149,130,47,83,39,34,105,78,29,18,13,27,59,37,16,2,26,7,46,41,13,16,34,38,24,19,11,3,11,18,7,8,2,0,23,20,17,11,9,3
20,20036,Hondarribia,14674,148,87,61,46,21,25,12,12,60,16,32,3,8,8,36,7,22,2,4,4,24,9,10,1,10,7,8,10,5,1,5,3,2,6,4,0,5,4,6,4,1,1,274,165,109,124,73,51,39,49,91,64,27,0,18,29,70,38,8,0,21,20,21,26,19,0,21,24,42,25,11,0,7,16,28,15,6,0,14,8,14,10,5,0,133,82,51,81,51,30,7,12,-5,48,32,29,9,6,8,24,19,13,-2,6,-13,24,13,16,14,9,22,19,12,1,8,4,15,12,9,1,6,5,7,7,3,0,286,168,118,62,33,29,46,25,91,47,37,17,27,14,50,33,19,8,19,11,41,14,18,9,6,21,16,9,4,4,2,9,7,7,3,3,4,12,9,2,1,1,178,82,96,61,34,27,54,20,21,36,20,16,29,9,-3,18,11,11,25,11,24,18,9,5,17,20,16,-1,5,1,8,8,14,-2,3,1,9,12,2,1,2,0,135,59,76,39,13,26,17,27,47,14,6,12,15,14,13,0,6,4,2,13,34,14,0,8,2,15,15,-2,1,5,-4,9,6,0,0,2,6,6,9,-2,1,3,162,69,93,71,35,36,42,36,24,54,2,5,15,21,7,29,-1,1,27,15,17,25,3,4,11,15,17,22,3,1,6,3,8,12,2,2,5,12,9,10,1,-1,52,28,24,38,8,30,16,31,10,-14,-8,10,14,12,2,-5,3,-1,2,19,8,-9,-11,11,5,30,9,5,-10,0,2,12,4,-2,-5,-2,3,18,5,7,-5,2,103,55,48,68,28,40,7,28,31,23,8,-6,5,16,27,5,4,-10,2,12,4,18,4,4,-1,26,31,11,0,-5,-3,13,16,4,-3,-3,2,13,15,7,3,-2,6,-10,16,34,13,21,6,15,-16,6,-20,12,11,9,-19,8,-20,2,-5,6,3,-2,0,10,16,18,-1,8,-10,2,11,9,-1,3,-10,1,5,9,0,5,0,1,24,-5,29,17,2,15,30,19,-37,5,-3,8,12,13,-31,2,-2,1,18,6,-6,3,-1,7,14,9,-5,1,0,-1,7,4,-5,-1,-2,0,7,5,0,2,2,-1,-10,-13,3,-30,-30,0,10,0,2,-14,2,-17,6,-13,-4,0,4,-7,4,13,6,-14,-2,-10,0,1,-5,-21,0,-7,-1,-6,-8,-12,0,-2,1,7,3,-9,0,-5,253,115,138,32,6,26,59,32,44,68,28,20,20,14,15,40,17,10,39,18,29,28,11,10,19,15,-9,6,0,4,8,3,-8,4,2,-1,11,12,-1,2,-2,5,149,50,99,0,-3,3,45,3,9,65,7,20,22,-5,-5,39,-4,4,23,8,14,26,11,16,11,2,-14,2,-3,3,6,-1,-7,-1,-1,1,5,3,-7,3,-2,2,184,81,103,8,7,1,37,5,54,35,18,32,23,8,12,24,8,4,14,-3,42,11,10,28,11,8,-2,2,-8,-3,8,6,-4,3,-3,-3,3,2,2,-1,-5,0,69,40,29,53,33,20,41,2,-3,17,18,0,19,-2,1,9,18,-2,22,4,-4,8,0,2,12,11,17,5,7,2,9,8,14,0,2,2,3,3,3,5,5,0,72,40,32,58,22,36,13,5,10,4,-4,40,12,-1,20,-8,-1,16,1,6,-10,12,-3,24,10,20,14,10,-4,4,10,5,7,-3,0,0,0,15,7,13,-4,4,-68,-13,-55,-3,2,-5,1,23,-39,-38,-21,3,6,17,-11,-17,-15,6,-5,6,-28,-21,-6,-3,4,16,-9,-13,1,-2,0,12,-2,-7,-1,0,4,4,-7,-6,2,-2
20,20042,Ibarra,4334,-44,-23,-21,2,1,1,4,-9,-12,-13,-15,1,7,-5,-6,-10,-9,0,-3,-4,-6,-3,-6,1,0,1,1,0,0,0,0,0,1,0,0,0,0,1,0,0,0,0,11,5,6,8,7,1,6,4,5,8,-9,-1,0,1,2,5,-2,0,6,3,3,3,-7,-1,1,4,3,0,0,0,0,4,3,0,0,0,1,0,0,0,0,0,37,18,19,14,11,3,11,5,12,7,0,2,4,2,5,4,1,1,7,3,7,3,-1,1,3,3,5,3,0,0,2,3,4,2,0,0,1,0,1,1,0,0,-11,-13,2,8,3,5,10,-4,-18,4,-1,-1,4,-7,-13,2,0,1,6,3,-5,2,-1,-2,3,2,1,2,0,0,1,1,0,1,0,0,2,1,1,1,0,0,-80,-50,-30,8,2,6,-15,-9,-38,-15,-4,2,-11,-12,-16,-6,-1,-2,-4,3,-22,-9,-3,4,1,4,3,0,0,0,0,2,1,-1,0,0,1,2,2,1,0,0,-18,-6,-12,18,15,3,-2,11,-10,-5,-8,-4,6,2,-7,0,-5,0,-8,9,-3,-5,-3,-4,3,4,4,6,1,0,3,3,4,5,0,0,0,1,0,1,1,0,-41,-16,-25,25,15,10,-5,-6,-17,-10,-2,0,-4,5,-7,-8,-4,2,-1,-11,-10,-2,2,-2,4,5,11,5,0,0,3,3,9,1,-1,0,1,2,2,4,1,0,23,22,1,48,27,21,-2,8,-6,12,1,6,-2,11,-1,9,4,0,0,-3,-5,3,-3,6,10,9,11,13,2,1,3,7,6,8,2,1,7,2,5,5,0,0,19,-5,24,31,15,16,18,15,-7,-1,-6,2,3,10,-7,-6,0,-4,15,5,0,5,-6,6,5,10,8,4,3,1,2,8,5,-1,0,1,3,2,3,5,3,0,-1,1,-2,20,8,12,14,0,-23,7,-1,-1,11,5,-22,7,-3,0,3,-5,-1,0,2,-1,6,5,-2,11,0,0,3,5,-6,6,0,0,3,0,4,5,0,0,-55,-44,-11,7,6,1,-17,-5,-26,-8,-5,9,-12,-6,-19,-5,-1,1,-5,1,-7,-3,-4,8,6,4,2,-2,-2,0,3,1,3,0,0,0,3,3,-1,-2,-2,0,-16,-21,5,10,3,7,-4,4,-26,4,6,-2,-3,1,-15,-1,-1,-3,-1,3,-11,5,7,1,12,8,-6,-1,-3,-1,7,3,-3,-1,-3,-1,5,5,-3,0,0,0,-9,0,-9,0,1,-1,4,5,-10,-4,-4,-1,9,7,-11,-1,-1,-3,-5,-2,1,-3,-3,2,1,1,-1,-1,-1,0,1,1,1,-1,-1,0,0,0,-2,0,0,0,-17,-16,-1,-1,-6,5,1,-1,-3,-1,-14,2,0,-1,-8,-1,-4,-2,1,0,5,0,-10,4,4,-1,-4,2,-4,1,2,-4,-4,2,-3,1,2,3,0,0,-1,0,40,0,40,17,2,15,15,27,-11,12,-5,-1,8,8,-14,3,-6,-1,7,19,3,9,1,0,4,5,6,1,-1,1,1,0,4,-2,-3,1,3,5,2,3,2,0,-37,-36,-1,10,11,-1,-11,2,-13,-14,-12,10,1,2,-13,-9,-10,-5,-12,0,0,-5,-2,15,-4,7,7,-1,1,0,2,5,6,-1,-1,0,-6,2,1,0,2,0,-43,-16,-27,-2,-8,6,6,-7,-27,6,-11,-8,6,-3,-9,2,-3,-6,0,-4,-18,4,-8,-2,3,5,-4,0,-4,-2,0,1,-2,-1,-3,-3,3,4,-2,1,-1,1,-9,-4,-5,17,6,11,-5,0,1,-11,5,1,-1,-3,-4,0,3,0,-4,3,5,-11,2,1,2,3,6,1,4,1,0,-1,2,2,2,1,2,4,4,-1,2,0
20,20045,Irun,55497,297,194,103,149,76,73,25,58,93,47,14,45,10,43,69,40,6,17,15,15,24,7,8,28,30,26,34,20,19,18,13,14,19,13,7,8,17,12,15,7,12,10,476,242,234,260,142,118,34,87,185,106,24,32,24,32,99,73,10,2,10,55,86,33,14,30,36,65,85,58,10,3,21,30,46,36,7,1,15,35,39,22,3,2,490,255,235,226,137,89,71,127,211,32,20,15,34,65,108,28,7,4,37,62,103,4,13,11,62,62,48,26,12,11,29,26,34,27,11,8,33,36,14,-1,1,3,938,459,479,313,166,147,159,159,415,127,44,28,74,86,218,64,23,-5,85,73,197,63,21,33,84,82,55,64,14,6,40,40,28,47,5,3,44,42,27,17,9,3,646,330,316,81,27,54,100,159,298,42,6,21,55,62,178,9,12,3,45,97,120,33,-6,18,56,71,-40,-3,-7,0,28,29,-22,-10,1,-1,28,42,-18,7,-8,1,592,330,262,412,222,190,112,150,137,120,35,48,69,57,103,71,14,19,43,93,34,49,21,29,102,108,72,78,36,12,59,47,46,40,20,6,43,61,26,38,16,6,245,93,152,295,119,176,28,93,59,13,8,40,31,44,-2,11,8,6,-3,49,61,2,0,34,55,91,78,33,21,10,38,39,4,20,13,4,17,52,74,13,8,6,295,160,135,370,177,193,4,162,60,42,25,16,-4,70,42,42,16,1,8,92,18,0,9,15,33,142,87,81,28,9,12,60,43,43,20,1,21,82,44,38,8,8,-18,-63,45,189,48,141,-72,144,-41,-22,-13,-5,-39,59,-28,-26,-18,-5,-33,85,-13,4,5,0,19,138,29,20,-14,-2,25,57,1,-18,-14,1,-6,81,28,38,0,-3,5,-57,62,-46,-81,35,78,7,-24,-48,-13,10,37,-9,-22,-59,-5,3,41,16,-2,11,-8,7,49,16,-70,-30,-4,1,24,4,-51,-41,-8,-1,25,12,-19,11,4,2,45,18,27,-90,-71,-19,24,55,14,-13,-23,-11,10,37,0,5,-26,-8,14,18,14,-18,3,-3,0,60,-52,-79,-15,-5,-7,35,-43,-32,-20,-4,7,25,-9,-47,5,-1,91,27,64,9,-24,33,-3,124,-17,-17,-4,6,-5,71,-19,-21,2,-4,2,53,2,4,-6,10,6,79,-50,-41,13,2,1,37,-28,-37,3,-1,5,42,-22,-4,10,3,0,-3,3,-93,-76,-17,1,56,-9,-56,-10,27,27,26,-11,-25,-13,-1,-26,30,2,-31,3,28,2,38,-72,-57,-18,16,9,8,-51,-37,-12,9,-7,30,-21,-20,-6,7,176,114,62,-104,-65,-39,27,68,39,28,-9,17,2,23,72,13,-4,2,25,45,-33,15,-5,15,-32,18,-36,-42,-13,6,-21,4,7,-41,-15,3,-11,14,-43,-1,2,3,371,213,158,48,44,4,126,58,41,123,8,19,58,33,29,64,10,17,68,25,12,59,-2,2,18,48,-20,14,-6,-2,-2,24,10,5,1,2,20,24,-30,9,-7,-4,357,170,187,185,70,115,57,62,134,55,24,34,42,43,54,15,9,12,15,19,80,40,15,22,46,68,22,26,16,5,21,38,-1,-1,6,5,25,30,23,27,10,0,432,239,193,268,132,136,47,140,128,73,42,2,41,69,66,45,13,4,6,71,62,28,29,-2,58,108,38,39,30,-10,37,46,24,17,9,-2,21,62,14,22,21,-8,407,214,193,245,100,145,69,136,113,45,42,-9,36,57,77,26,16,-8,33,79,36,19,26,-1,80,90,56,7,10,-6,42,36,29,-9,2,-7,38,54,27,16,8,1
20,20902,Lasarte-Oria,17630,-30,-17,-13,37,17,20,-19,13,-7,-21,-1,7,-8,-7,8,-12,-3,6,-11,20,-15,-9,2,1,8,9,9,4,4,2,3,5,4,1,2,2,5,4,5,3,2,0,-86,-42,-44,69,37,32,-7,8,-34,-34,-21,4,-9,7,-6,-19,-11,-1,2,1,-28,-15,-10,5,16,9,25,13,1,5,10,4,14,7,0,2,6,5,11,6,1,3,196,122,74,103,64,39,11,63,98,10,16,-4,18,38,64,2,-1,3,-7,25,34,8,17,-7,20,33,29,11,7,0,13,19,21,5,4,1,7,14,8,6,3,-1,70,31,39,87,36,51,11,17,41,11,-11,2,-1,6,24,0,3,-1,12,11,17,11,-14,3,22,28,24,8,5,-1,10,12,12,0,3,-1,12,16,12,8,2,0,-123,-84,-39,89,46,43,-13,6,-108,6,-14,5,-17,-1,-69,12,-4,-1,4,7,-39,-6,-10,6,15,24,34,17,-2,0,5,12,19,10,0,0,10,12,15,7,-2,0,-110,-47,-63,145,69,76,-8,20,-63,-21,-31,-2,1,15,-37,-13,-13,2,-9,5,-26,-8,-18,-4,19,45,52,22,5,0,8,28,21,10,0,0,11,17,31,12,5,0,-36,-3,-33,121,67,54,13,-9,-32,-1,-23,14,16,4,-23,-1,-10,6,-3,-13,-9,0,-13,8,17,37,48,21,-1,-2,9,18,24,14,0,0,8,19,24,7,-1,-2,12,-38,50,117,33,84,35,41,-23,-15,-7,-16,5,18,-25,-10,-11,-12,30,23,2,-5,4,-4,23,61,30,5,0,-2,4,27,9,-1,-3,-2,19,34,21,6,3,0,42,24,18,118,57,61,2,61,-39,34,-23,8,5,36,-27,29,-13,-4,-3,25,-12,5,-10,12,13,57,35,15,1,-3,10,25,18,9,-1,-4,3,32,17,6,2,1,14,-7,21,67,6,61,4,36,-24,20,-20,-1,12,6,-18,10,-11,-6,-8,30,-6,10,-9,5,18,29,15,4,-2,1,10,2,-7,-1,2,-1,8,27,22,5,-4,2,-27,-22,-5,38,18,20,11,7,-21,-4,-8,-1,10,7,-27,-10,6,-4,1,0,6,6,-14,3,17,16,16,-2,-5,-2,11,4,11,-3,-4,0,6,12,5,1,-1,-2,60,38,22,44,14,30,3,11,34,9,3,2,7,14,22,-1,4,-6,-4,-3,12,10,-1,8,0,35,11,-3,1,0,2,18,-3,-4,1,0,-2,17,14,1,0,0,93,24,69,33,6,27,29,27,31,16,-9,-5,9,4,11,10,-16,1,20,23,20,6,7,-6,15,11,5,5,-3,1,8,1,2,-2,-3,1,7,10,3,7,0,0,40,-5,45,3,-7,10,3,22,5,2,2,4,-1,4,-10,2,-1,2,4,18,15,0,3,2,7,13,-5,-12,0,0,6,3,-10,-8,2,0,1,10,5,-4,-2,0,-2,10,-12,33,15,18,3,20,1,-7,-13,2,9,16,1,-11,-7,2,-6,4,0,4,-6,0,2,22,3,10,-3,-1,2,8,2,6,-3,0,0,14,1,4,0,-1,62,33,29,122,58,64,6,54,35,-12,-21,5,11,28,32,-20,-15,-1,-5,26,3,8,-6,6,21,49,39,8,2,4,9,24,23,1,-1,2,12,25,16,7,3,2,64,21,43,84,36,48,13,-7,28,8,7,16,3,-9,-1,7,7,10,10,2,29,1,0,6,18,40,16,9,0,-4,8,17,4,4,3,-2,10,23,12,5,-3,-2,111,38,73,136,68,68,36,60,-6,-4,1,27,24,29,-5,-13,-7,11,12,31,-1,9,8,16,40,29,37,20,5,5,28,21,17,0,0,2,12,8,20,20,5,3
20,20049,Lazkao,4873,-9,0,-9,12,7,5,13,2,-19,3,-5,-4,8,-1,-9,4,-6,0,5,3,-10,-1,1,-4,4,4,3,1,0,0,2,3,1,1,0,0,2,1,2,0,0,0,108,73,35,21,13,8,5,21,60,16,2,4,3,14,40,14,-2,3,2,7,20,2,4,1,2,5,7,3,2,1,1,4,2,3,1,1,1,1,5,0,1,0,54,27,27,32,17,15,13,29,19,5,-8,-8,4,18,6,4,-4,-3,9,11,13,1,-4,-5,5,15,9,1,0,0,2,7,6,0,0,1,3,8,3,1,0,-1,-7,-10,3,11,3,8,2,5,-10,-1,1,-3,4,0,-9,-4,1,-2,-2,5,-1,3,0,-1,1,5,2,3,0,0,0,2,1,0,0,0,1,3,1,3,0,0,36,22,14,15,7,8,-2,17,14,4,-3,4,0,7,15,6,-3,-2,-2,10,-1,-2,0,6,2,6,3,2,1,0,1,2,3,1,0,0,1,4,0,1,1,0,23,8,15,33,17,16,4,1,13,4,0,3,0,4,3,0,0,0,4,-3,10,4,0,3,3,4,15,10,0,1,2,2,7,6,0,0,1,2,8,4,0,1,50,33,17,48,30,18,10,23,3,15,0,-2,5,13,6,10,-3,2,5,10,-3,5,3,-4,4,12,18,10,3,0,4,6,12,7,1,0,0,6,6,3,2,0,53,48,5,63,38,25,13,30,-7,9,2,3,5,25,8,4,4,0,8,5,-15,5,-2,3,10,24,17,7,2,2,5,16,11,3,1,2,5,8,6,4,1,0,37,24,13,28,26,2,1,2,0,18,0,15,4,5,-2,18,-1,3,-3,-3,2,0,1,12,-2,6,11,10,1,1,3,6,7,10,0,0,-5,0,4,0,1,1,-29,-37,8,6,-4,10,-7,10,-7,-15,1,-10,-9,4,-18,-9,-2,0,2,6,11,-6,3,-10,-1,10,-5,-2,3,1,-2,6,-7,-2,0,1,1,4,2,0,3,0,30,-6,36,22,7,15,17,0,27,-3,-15,2,1,-7,11,-4,-6,-1,16,7,16,1,-9,3,7,11,9,-4,-2,0,1,1,5,-1,0,0,6,10,4,-3,-2,0,16,7,9,-4,-7,3,6,4,1,10,-3,-3,10,6,-2,0,-2,-5,-4,-2,3,10,-1,2,1,-1,-5,2,-2,0,2,-2,-3,-2,-2,0,-1,1,-2,4,0,0,14,17,-3,-3,-1,-2,-1,3,-6,4,2,10,0,3,2,4,3,4,-1,0,-8,0,-1,6,-4,0,1,-3,3,0,-2,0,1,-2,2,0,-2,0,0,-1,1,0,-5,3,-8,-1,3,-4,1,2,6,-10,-2,1,-2,2,12,-5,-1,0,3,0,-6,-5,-1,1,-1,4,-2,1,-1,-2,0,2,1,1,-1,0,-1,2,-3,0,0,-2,10,-11,21,5,-4,9,14,2,-11,10,-13,8,14,0,-11,-1,-14,1,0,2,0,11,1,7,6,5,-2,-1,-3,0,3,5,-5,-3,-4,0,3,0,3,2,1,0,74,32,42,4,4,0,11,6,38,14,0,2,7,2,11,4,1,3,4,4,27,10,-1,-1,-1,5,-1,-3,1,0,0,2,0,-3,2,0,-1,3,-1,0,-1,0,31,16,15,16,8,8,17,4,0,10,0,-1,10,7,-3,4,-1,0,7,-3,3,6,1,-1,7,7,0,0,3,-1,4,5,-2,-1,2,0,3,2,2,1,1,-1,83,42,41,28,16,12,21,19,31,8,-3,1,8,19,13,5,-4,-3,13,0,18,3,1,4,3,12,7,0,2,3,-1,12,3,1,-1,1,4,0,4,-1,3,2
20,20051,Legazpi,9064,-90,-53,-37,9,4,5,-2,-7,-52,-18,-5,-6,0,-6,-30,-13,0,-4,-2,-1,-22,-5,-5,-2,3,2,1,1,1,1,2,1,0,0,1,0,1,1,1,1,0,1,-50,-27,-23,20,10,10,2,0,-14,-13,-14,-11,5,-1,-10,-8,-10,-3,-3,1,-4,-5,-4,-8,7,3,5,5,0,0,6,1,1,2,0,0,1,2,4,3,0,0,-62,-37,-25,13,3,10,-6,2,-34,-12,-12,-1,-5,2,-14,-9,-6,-6,-1,0,-20,-3,-6,5,6,4,2,0,1,0,1,1,2,-1,0,0,5,3,0,1,1,0,-39,-13,-26,16,10,6,6,0,-27,-2,-15,-3,-1,2,-6,0,-7,-2,7,-2,-21,-2,-8,-1,6,4,-2,-3,7,3,3,1,1,0,3,1,3,3,-3,-3,4,2,21,9,12,21,11,10,3,14,-1,2,0,-1,-3,3,2,4,2,-1,6,11,-3,-2,-2,0,4,4,7,5,0,1,1,3,4,2,1,0,3,1,3,3,-1,1,-47,4,-51,36,31,5,-6,-10,-10,4,-14,-11,-3,-4,10,12,-7,-5,-3,-6,-20,-8,-7,-6,5,9,17,8,-2,-1,4,5,16,6,0,0,1,4,1,2,-2,-1,25,13,12,24,5,19,20,13,9,1,-8,-12,12,10,2,-2,-3,-7,8,3,7,3,-5,-5,8,5,3,5,3,0,4,2,-4,2,1,0,4,3,7,3,2,0,63,53,10,72,50,22,18,11,17,24,2,-11,7,10,15,22,1,-4,11,1,2,2,1,-7,10,6,23,27,5,0,3,0,19,22,5,0,7,6,4,5,0,0,9,23,-14,55,42,13,-7,17,3,16,-16,-4,-3,9,6,20,-7,-1,-4,8,-3,-4,-9,-3,2,19,16,14,0,3,1,12,14,11,3,1,1,7,2,3,-3,2,-21,-20,-1,8,-1,9,9,14,-28,0,-12,-7,7,2,-7,-12,-7,-5,2,12,-21,12,-5,-2,9,9,-5,-3,-3,1,8,3,-3,-8,-1,0,1,6,-2,5,-2,1,-48,-46,-2,-21,-26,5,9,2,-30,-10,-17,-5,3,1,-31,-8,-12,-1,6,1,1,-2,-5,-4,1,3,-5,-9,-6,-5,1,-1,-9,-10,-5,-2,0,4,4,1,-1,-3,-41,-30,-11,4,-5,9,-3,4,-27,-5,-8,-1,-1,4,-21,-4,-7,-1,-2,0,-6,-1,-1,0,6,-1,-1,-2,1,0,3,-2,-3,-5,1,0,3,1,2,3,0,0,10,-3,13,6,1,5,16,0,5,6,-8,-9,8,1,1,0,-4,-7,8,-1,4,6,-4,-2,6,2,-3,1,-2,2,3,2,-5,1,0,0,3,0,2,0,-2,2,9,7,2,-10,-9,-1,5,10,11,-16,-7,5,1,2,10,-12,-1,5,4,8,1,-4,-6,0,4,-1,1,-9,-6,1,2,-1,2,-8,-5,1,2,0,-1,-1,-1,0,-54,-19,-35,-20,-11,-9,-17,-6,-8,-5,-13,-5,-2,-2,3,-4,-8,-5,-15,-4,-11,-1,-5,0,-1,-6,1,-10,-4,-1,0,-3,3,-6,-4,-1,-1,-3,-2,-4,0,0,-24,-8,-16,-6,1,-7,-9,0,-6,-3,-9,5,0,-2,2,-5,-5,2,-9,2,-8,2,-4,3,-4,4,3,-5,-3,0,3,0,5,-4,-2,0,-7,4,-2,-1,-1,0,-18,-24,6,9,-5,14,-1,2,2,-5,-10,-2,-4,-1,2,-11,-5,-4,3,3,0,6,-5,2,7,5,-1,3,-3,-1,3,1,-5,-1,-2,-1,4,4,4,4,-1,0,-17,-22,5,7,-1,8,0,-4,-15,18,-7,-7,-1,-6,-13,3,-2,-2,1,2,-2,15,-5,-5,2,2,0,5,-1,-1,2,-2,0,-1,0,0,0,4,0,6,-1,-1
20,20053,Lezo,5829,39,12,27,9,3,6,6,9,34,4,-8,-5,1,3,14,2,-5,-4,5,6,20,2,-3,-1,3,3,2,1,0,0,0,1,1,1,0,0,3,2,1,0,0,0,59,25,34,4,2,2,-3,14,44,4,-4,2,-3,5,24,2,-3,-1,0,9,20,2,-1,3,0,1,2,1,0,0,0,0,1,1,0,0,0,1,1,0,0,0,24,-1,25,4,0,4,12,-1,12,5,-8,2,3,-5,6,2,-11,3,9,4,6,3,3,-1,2,-1,3,0,0,0,1,-1,1,0,-1,0,1,0,2,0,1,0,-99,-41,-58,9,6,3,-11,-30,-20,-17,-15,-2,-7,-6,-7,-11,-9,0,-4,-24,-13,-6,-6,-2,2,3,-2,3,3,0,1,1,2,0,2,0,1,2,-4,3,1,0,-12,-9,-3,0,1,-1,12,-4,-19,-4,4,-6,2,0,-10,-7,4,-3,10,-4,-9,3,0,-3,1,0,-3,-3,3,0,1,0,-1,-2,2,0,0,0,-2,-1,1,0,28,13,15,8,1,7,8,16,5,-5,5,-3,6,12,-4,-4,4,-2,2,4,9,-1,1,-1,-1,2,5,1,0,1,-1,1,1,0,0,0,0,1,4,1,0,1,17,7,10,13,3,10,-3,9,12,7,-10,-4,-10,0,8,9,0,-2,7,9,4,-2,-10,-2,3,2,7,-1,2,0,0,0,3,-1,1,0,3,2,4,0,1,0,41,22,19,35,24,11,7,14,22,2,-3,-2,5,3,17,2,-3,-3,2,11,5,0,0,1,15,10,4,6,0,-2,13,4,4,4,-1,-1,2,6,0,2,1,-1,-34,-18,-16,15,9,6,10,-2,-26,-4,-9,-4,9,0,-23,-2,-2,-2,1,-2,-3,-2,-7,-2,6,7,2,-1,1,-1,3,6,0,-1,1,0,3,1,2,0,0,-1,-9,-10,1,0,1,-1,14,-7,-3,-7,-9,0,4,-8,-2,-4,-4,2,10,1,-1,-3,-5,-2,3,-1,3,-2,-5,0,1,-1,2,-2,0,0,2,0,1,0,-5,0,-17,-9,-8,3,-5,8,-13,1,35,-28,-2,-11,-10,3,22,-17,-1,-6,-3,-2,13,-11,-1,-5,-2,3,2,1,-2,0,-3,1,-1,0,-2,0,1,2,3,1,0,0,-18,4,-22,10,7,3,-2,-5,2,-2,-7,-5,0,0,11,0,-4,-5,-2,-5,-9,-2,-3,0,4,6,-1,3,-3,1,0,4,4,-1,-1,1,4,2,-5,4,-2,0,22,16,6,12,8,4,10,-2,3,12,-6,4,11,-7,2,9,-2,0,-1,5,1,3,-4,4,1,3,2,6,-1,0,2,0,2,3,0,0,-1,3,0,3,-1,0,-31,-25,-6,5,3,2,-2,-6,-10,-7,0,-7,7,-7,-12,-10,0,-3,-9,1,2,3,0,-4,-2,4,0,5,1,-2,-1,3,-2,3,1,-1,-1,1,2,2,0,-1,-22,-19,-3,3,-4,7,-4,11,-19,1,-7,-7,-1,5,-12,-4,-2,-3,-3,6,-7,5,-5,-4,0,3,0,-1,1,-1,-2,2,0,-3,0,-1,2,1,0,2,1,0,-36,-17,-19,2,-7,9,-18,-4,-15,5,-4,3,-10,-1,-10,11,-6,-1,-8,-3,-5,-6,2,4,0,5,-3,1,-2,1,1,1,-7,1,-3,0,-1,4,4,0,1,1,46,15,31,25,10,15,23,0,16,5,7,-4,10,2,6,-1,4,-3,13,-2,10,6,3,-1,5,8,11,-2,2,0,2,2,5,0,1,0,3,6,6,-2,1,0,46,38,8,18,10,8,30,3,-7,13,7,-2,23,3,3,4,4,1,7,0,-10,9,3,-3,1,8,8,2,0,-1,2,4,4,0,0,0,-1,4,4,2,0,-1
20,20063,Oiartzun,9055,-14,-10,-4,17,7,10,3,-10,18,-17,-6,-5,6,-6,11,-13,-4,-4,-3,-4,7,-4,-2,-1,2,2,7,2,2,1,0,1,4,1,1,0,2,1,3,1,1,1,68,32,36,23,12,11,23,32,-19,23,-5,11,13,8,-5,11,-2,7,10,24,-14,12,-3,4,7,7,3,5,0,1,5,2,3,2,0,0,2,5,0,3,0,1,76,41,35,34,23,11,4,-11,51,11,3,3,2,-4,24,7,3,1,2,-7,27,4,0,2,6,7,2,10,7,2,3,5,2,7,6,0,3,2,0,3,1,2,200,93,107,29,13,16,34,27,74,43,-8,14,8,10,47,25,-9,7,26,17,27,18,1,7,5,10,7,3,2,2,2,5,4,2,-1,1,3,5,3,1,3,1,65,15,50,19,6,13,-4,29,10,5,10,14,6,11,-5,-5,5,6,-10,18,15,10,5,8,4,8,3,1,1,1,1,3,0,0,1,1,3,5,3,1,0,0,73,45,28,29,20,9,8,12,32,10,6,7,4,9,25,10,4,-3,4,3,7,0,2,10,3,12,18,-4,-1,1,3,7,14,-3,-1,0,0,5,4,-1,0,1,-74,-27,-47,16,9,7,-2,-3,-36,-16,-9,-4,0,1,-17,-1,-6,-1,-2,-4,-19,-15,-3,-3,5,9,-1,5,-1,-2,3,6,-3,3,-1,0,2,3,2,2,0,-2,-5,-9,4,37,25,12,-1,2,18,1,-26,0,0,-1,8,-2,-12,-4,-1,3,10,3,-14,4,7,10,10,6,2,2,4,7,11,2,2,0,3,3,-1,4,0,2,3,0,3,23,12,11,8,6,-6,-3,-1,-3,4,8,1,-15,1,-1,4,-2,-7,12,-2,-2,7,12,4,-1,0,0,4,9,4,-5,-1,1,3,3,0,4,1,-1,37,22,15,-4,3,-7,22,-2,10,1,-2,9,21,0,10,-3,-7,0,1,-2,0,4,5,9,0,2,-1,-4,1,-1,5,2,-2,-1,0,-1,-5,0,1,-3,1,0,-2,-3,1,21,8,13,-2,10,19,-17,-12,1,-5,4,22,-12,-12,1,3,6,-3,-5,0,0,8,9,12,-5,-2,-1,3,5,6,-4,-1,-1,5,4,6,-1,-1,0,-27,-41,14,-20,-15,-5,-10,13,-28,5,-4,0,-7,0,-28,1,-5,-2,-3,13,0,4,1,2,-7,0,-8,-6,1,1,-4,-1,-7,-5,1,1,-3,1,-1,-1,0,0,-40,-17,-23,12,17,-5,0,-6,-24,-17,-5,4,1,-4,-13,-7,0,4,-1,-2,-11,-10,-5,0,5,-3,1,6,2,0,3,-1,5,8,1,1,2,-2,-4,-2,1,-1,26,3,23,13,7,6,-10,-5,21,2,1,12,-5,-3,-1,3,0,3,-5,-2,22,-1,1,9,6,-2,6,0,3,0,4,-2,-1,3,3,0,2,0,7,-3,0,0,125,64,61,14,10,4,27,10,36,27,18,5,16,-4,26,7,11,4,11,14,10,20,7,1,4,-4,8,5,2,-1,2,-5,6,3,4,0,2,1,2,2,-2,-1,20,-18,38,1,2,-1,-5,13,12,4,-7,5,-11,4,-3,1,-7,-1,6,9,15,3,0,6,0,4,4,-5,-4,2,0,1,2,0,0,-1,0,3,2,-5,-4,3,18,13,5,12,5,7,1,12,15,13,-15,-6,3,6,9,5,-4,-5,-2,6,6,8,-11,-1,-2,10,0,1,-1,4,-2,4,1,1,0,1,0,6,-1,0,-1,3,69,60,9,26,6,20,14,3,42,10,-1,-2,20,1,21,11,5,1,-6,2,21,-1,-6,-3,-2,3,17,1,7,0,-1,0,7,-3,3,0,-1,3,10,4,4,0
20,20059,Oñati,10668,-4,-8,4,9,4,5,-9,-1,10,3,-8,-1,-5,0,5,0,-9,0,-4,-1,5,3,1,-1,1,4,1,3,0,0,1,1,1,1,0,0,0,3,0,2,0,0,17,13,4,39,20,19,4,10,5,2,-11,7,4,8,4,-3,-7,6,0,2,1,5,-4,1,3,10,14,6,3,3,2,6,6,3,1,2,1,4,8,3,2,1,17,8,9,58,31,27,3,18,12,-10,-14,5,2,16,1,-3,-11,0,1,2,11,-7,-3,5,11,21,14,9,2,1,3,11,10,6,1,0,8,10,4,3,1,1,-12,-14,2,29,9,20,8,-7,-2,-4,-13,4,2,-6,-4,2,-9,0,6,-1,2,-6,-4,4,7,2,15,3,2,-2,2,-2,5,3,1,-1,5,4,10,0,1,-1,-37,-20,-17,40,18,22,4,-14,-19,-9,-1,2,-6,0,-8,-7,0,1,10,-14,-11,-2,-1,1,10,0,21,5,4,0,3,-1,10,3,2,1,7,1,11,2,2,-1,38,10,28,49,21,28,0,16,-7,6,8,13,5,8,-3,-2,2,0,-5,8,-4,8,6,13,5,8,19,9,7,0,3,3,11,2,2,-1,2,5,8,7,5,1,43,11,32,54,23,31,10,12,1,18,-5,9,5,2,-7,12,-6,7,5,10,8,6,1,2,8,18,13,9,4,2,3,9,6,4,0,1,5,9,7,5,4,1,50,37,13,82,48,34,-1,14,12,18,-7,16,0,14,7,13,-4,7,-1,0,5,5,-3,9,17,20,26,16,1,2,8,13,11,12,1,3,9,7,15,4,0,-1,77,37,40,99,40,59,31,34,29,-11,1,-9,13,16,5,3,0,-1,18,18,24,-14,1,-8,25,40,25,9,-2,-1,12,14,10,3,0,0,13,26,15,6,-2,-1,36,35,1,36,16,20,13,12,9,4,-3,0,13,8,9,8,-3,0,0,4,0,-4,0,0,7,21,-2,4,3,3,7,8,-2,-1,2,2,0,13,0,5,1,1,49,20,29,12,11,1,16,1,33,3,-7,-3,6,8,16,-2,-8,-4,10,-7,17,5,1,1,17,3,-3,-4,-1,-2,8,8,-1,-3,-1,0,9,-5,-2,-1,0,-2,94,28,66,40,16,24,25,7,43,18,-3,4,6,-6,22,10,-3,0,19,13,21,8,0,4,16,4,17,3,-3,3,4,1,9,2,-1,1,12,3,8,1,-2,2,39,23,16,9,1,8,15,5,-2,12,0,10,13,5,-15,9,1,11,2,0,13,3,-1,-1,2,-5,0,8,3,1,2,-4,-3,4,1,1,0,-1,3,4,2,0,54,17,37,-12,-10,-2,16,6,15,7,1,6,5,3,1,1,5,2,11,3,14,6,-4,4,2,-3,-5,-8,3,-1,-1,1,-7,-4,1,0,3,-4,2,-4,2,-1,-3,11,-14,-12,-7,-5,7,-5,-7,9,-10,-1,3,-1,6,2,-3,-1,4,-4,-13,7,-7,0,-1,0,-4,-6,0,-2,1,0,-4,-6,2,-1,-2,0,0,0,-2,-1,68,23,45,34,18,16,31,24,8,13,-12,1,13,10,1,4,-8,1,18,14,7,9,-4,0,16,12,11,0,-5,-1,8,4,8,0,-2,0,8,8,3,0,-3,-1,67,20,47,41,15,26,16,12,9,12,19,0,11,6,-3,10,1,-3,5,6,12,2,18,3,9,12,1,4,14,1,4,7,-1,2,2,1,5,5,2,2,12,0,3,-3,6,3,-8,11,6,16,0,-16,-10,4,2,5,0,-6,-8,3,4,11,0,-10,-2,1,9,8,-7,-10,1,1,3,4,-6,-10,0,0,6,4,-1,0,1,1
20,20076,Ordizia,9087,-60,-27,-33,31,20,11,-12,-13,-12,-12,-8,-5,-5,-7,-10,-5,-2,0,-7,-6,-2,-7,-6,-5,5,7,10,7,0,0,4,4,5,5,0,0,1,3,5,2,0,0,-32,-23,-9,36,23,13,-3,20,-23,-3,-7,-13,-1,8,-15,-5,-6,-4,-2,12,-8,2,-1,-9,6,8,14,6,1,1,5,3,9,4,1,1,1,5,5,2,0,0,-52,-1,-51,49,31,18,-17,-16,-11,-4,-9,5,-6,-2,9,-4,0,1,-11,-14,-20,0,-9,4,7,9,21,9,2,0,3,7,12,6,2,1,4,2,9,3,0,-1,12,15,-3,76,38,38,10,7,-1,11,-10,-2,-2,2,9,9,-3,1,12,5,-10,2,-7,-3,11,20,28,15,0,2,5,7,15,9,0,2,6,13,13,6,0,0,70,31,39,81,47,34,34,26,7,23,-7,-11,15,11,0,15,-2,-5,19,15,7,8,-5,-6,21,21,16,20,2,0,13,8,8,17,1,0,8,13,8,3,1,0,152,101,51,116,68,48,49,39,46,29,-5,-1,26,28,26,26,-3,3,23,11,20,3,-2,-4,28,21,39,23,4,0,15,14,21,17,1,0,13,7,18,6,3,0,139,93,46,180,99,81,19,52,46,21,-2,-1,13,34,31,15,1,0,6,18,15,6,-3,-1,40,49,51,31,4,0,17,24,34,20,3,0,23,25,17,11,1,0,383,307,76,388,276,112,41,176,112,62,-2,-3,30,125,103,53,0,-2,11,51,9,9,-2,-1,47,133,120,78,6,2,27,91,90,62,4,1,20,42,30,16,2,1,-19,-45,26,-22,-51,29,12,1,13,-34,-10,-10,7,-7,-13,-29,-4,-6,5,8,26,-5,-6,-4,15,3,-12,-27,-5,2,8,-6,-26,-24,-5,0,7,9,14,-3,0,2,34,-25,59,19,-19,38,22,17,-23,4,6,1,2,0,-29,-3,2,-1,20,17,6,7,4,2,5,19,-13,1,8,-2,1,3,-17,-8,3,-1,4,16,4,9,5,-1,34,24,10,69,23,46,13,37,3,-9,-7,-1,6,35,10,-15,-6,-4,7,2,-7,6,-1,3,22,31,14,-2,0,3,9,19,2,-6,-1,0,13,12,12,4,1,3,7,-27,34,18,-9,27,21,19,-6,-16,-8,-3,14,5,-24,-18,-5,1,7,14,18,2,-3,-4,15,11,6,-9,-7,2,13,3,-8,-15,-2,0,2,8,14,6,-5,2,-44,-23,-21,-78,-63,-15,-19,-2,-14,2,-9,-4,-5,5,-7,-5,-12,-1,-14,-7,-7,7,3,-3,-16,-6,-36,-11,-8,-1,-7,-4,-33,-9,-10,0,-9,-2,-3,-2,2,-1,59,34,25,-69,-43,-26,-3,37,31,-11,-5,5,-5,24,27,-9,-6,2,2,13,4,-2,1,3,-13,-3,-19,-29,-6,-1,-6,-2,-13,-18,-5,0,-7,-1,-6,-11,-1,-1,97,82,15,29,20,9,13,44,16,16,2,-9,4,27,22,12,12,-3,9,17,-6,4,-10,-6,-3,27,12,-6,-6,0,-2,19,8,-5,-2,0,-1,8,4,-1,-4,0,57,-2,59,55,10,45,17,19,1,6,22,-8,2,7,-10,-1,9,-6,15,12,11,7,13,-2,17,24,6,0,4,1,5,13,-2,-6,1,1,12,11,8,6,3,0,113,39,74,59,15,44,37,31,20,22,4,-8,7,19,5,1,5,-5,30,12,15,21,-1,-3,27,25,-7,9,3,-2,11,14,-12,0,0,0,16,11,5,9,3,-2,154,50,104,104,58,46,66,32,51,15,0,-10,34,9,20,3,-3,-11,32,23,31,12,3,1,24,38,31,2,6,1,19,19,14,4,2,-1,5,19,17,-2,4,2
20,20061,Orio,4307,2,5,-3,10,5,5,1,-1,7,-2,-2,0,1,7,-1,-1,-2,1,0,-8,8,-1,0,-1,2,2,3,0,2,1,2,1,1,0,0,1,0,1,2,0,2,0,72,39,33,10,7,3,2,13,41,14,3,-1,1,7,21,9,3,-1,1,6,20,5,0,0,2,3,4,0,0,0,2,1,4,0,0,0,0,2,0,0,0,0,81,47,34,12,9,3,3,12,35,22,8,0,1,10,19,10,5,1,2,2,16,12,3,-1,1,2,3,6,0,0,1,3,2,3,0,0,0,-1,1,3,0,0,-24,-11,-13,16,8,8,-8,4,-11,3,-5,-6,-4,3,-10,6,-2,-2,-4,1,-1,-3,-3,-4,0,4,10,0,0,1,0,2,5,0,0,1,0,2,5,0,0,0,33,22,11,22,14,8,9,11,12,0,-1,2,6,3,7,2,0,4,3,8,5,-2,-1,-2,2,13,7,-1,0,0,2,7,5,0,0,0,0,6,2,-1,0,0,35,22,13,17,8,9,-3,8,6,12,10,0,-5,5,2,11,8,-1,2,3,4,1,2,1,4,7,3,1,1,0,2,3,3,-1,1,0,2,4,0,2,0,0,113,33,80,51,15,36,8,16,53,19,21,-6,3,5,15,2,11,-3,5,11,38,17,10,-3,6,20,16,4,5,0,2,7,4,0,2,0,4,13,12,4,3,0,106,57,49,39,12,27,20,13,47,15,6,1,12,0,30,9,2,0,8,13,17,6,4,1,6,10,19,2,1,0,2,2,7,1,0,0,4,8,12,1,1,0,34,13,21,45,22,23,7,6,10,7,-2,4,7,4,-3,1,-3,5,0,2,13,6,1,-1,6,12,12,10,2,2,3,6,6,4,2,1,3,6,6,6,0,1,95,63,32,37,21,16,20,13,44,17,2,-2,12,9,31,11,1,-2,8,4,13,6,1,0,9,7,17,2,1,1,7,4,7,4,-1,0,2,3,10,-2,2,1,110,51,59,25,11,14,19,28,25,21,6,6,6,9,13,15,3,1,13,19,12,6,3,5,9,6,12,-2,1,0,7,3,3,-3,1,0,2,3,9,1,0,0,76,62,14,27,16,11,19,2,30,6,10,10,13,1,27,8,10,5,6,1,3,-2,0,5,10,8,7,-2,2,2,7,2,8,-4,2,1,3,6,-1,2,0,1,111,55,56,2,0,2,15,6,49,28,2,5,8,0,27,14,0,2,7,6,22,14,2,3,1,5,-4,3,-2,-1,1,2,0,0,-2,-1,0,3,-4,3,0,0,167,91,76,-3,-1,-2,29,23,58,26,19,1,19,8,32,13,10,2,10,15,26,13,9,-1,0,0,0,2,-3,-4,2,-1,1,0,-1,-2,-2,1,-1,2,-2,-2,93,31,62,4,-1,5,24,-2,26,34,2,4,13,-5,12,9,0,0,11,3,14,25,2,4,4,0,-3,2,2,-2,3,0,-3,1,-1,-1,1,0,0,1,3,-1,19,12,7,25,14,11,6,7,23,0,-2,-11,5,-3,12,2,3,-4,1,10,11,-2,-5,-7,11,9,7,4,-7,0,8,2,5,1,-2,0,3,7,2,3,-5,0,-3,-6,3,14,5,9,0,-3,-15,17,1,-3,-4,-5,-4,7,3,-2,4,2,-11,10,-2,-1,4,-1,1,9,0,-1,2,0,1,1,0,0,2,-1,0,8,0,-1,71,36,35,27,15,12,14,22,18,27,-2,-9,13,10,-1,15,3,-6,1,12,19,12,-5,-3,9,11,12,-2,-3,-1,9,3,8,-4,-2,0,0,8,4,2,-1,-1
20,20062,Ormaiztegi,1176,13,10,3,5,4,1,4,4,6,-5,2,2,6,4,0,-2,0,2,-2,0,6,-3,2,0,1,1,3,0,0,0,1,1,2,0,0,0,0,0,1,0,0,0,-18,-7,-11,6,2,4,-1,0,-2,-4,-6,-5,0,1,-3,-2,-1,-2,-1,-1,1,-2,-5,-3,1,2,3,0,0,0,0,1,1,0,0,0,1,1,2,0,0,0,44,31,13,24,24,0,3,11,20,7,3,-2,1,9,14,5,2,-1,2,2,6,2,1,-1,1,5,12,6,0,0,1,5,12,6,0,0,0,0,0,0,0,0,47,33,14,10,6,4,2,5,27,10,4,-2,5,3,16,5,4,0,-3,2,11,5,0,-2,3,3,2,1,1,0,3,0,1,1,1,0,0,3,1,0,0,0,-4,4,-8,13,4,9,-3,-6,6,-1,-1,1,-1,-1,8,-1,0,-1,-2,-5,-2,0,-1,2,2,2,6,2,0,1,1,0,3,0,0,0,1,2,3,2,0,1,18,10,8,11,5,6,4,6,7,5,2,-5,0,1,3,7,1,-3,4,5,4,-2,1,-2,5,1,0,3,2,-1,1,1,-1,2,1,0,4,0,1,1,1,-1,23,13,10,23,13,10,7,1,9,4,1,3,1,3,2,4,2,1,6,-2,7,0,-1,2,8,2,9,4,0,0,4,2,4,3,0,0,4,0,5,1,0,0,-4,-11,7,8,3,5,-2,2,1,-3,2,-2,-2,-4,0,-3,1,-2,0,6,1,0,1,0,3,4,0,1,0,0,2,0,1,0,0,0,1,4,-1,1,0,0,4,-5,9,5,-1,6,2,7,4,-6,-7,4,-2,2,1,-2,-6,2,4,5,3,-4,-1,2,2,3,0,0,0,0,0,0,-2,1,0,0,2,3,2,-1,0,0,-5,-4,-1,7,0,7,-5,0,-2,3,2,-2,-2,2,-3,-1,2,-1,-3,-2,1,4,0,-1,1,1,3,1,1,0,0,0,1,-1,0,0,1,1,2,2,1,0,3,-7,10,2,-1,3,0,6,-5,-6,3,5,-4,2,-6,-4,3,2,4,4,1,-2,0,3,2,1,-3,-2,1,3,0,0,-3,-1,1,2,2,1,0,-1,0,1,-31,-12,-19,-3,-4,1,-6,-5,1,-7,-7,-6,-2,-2,2,-1,-4,-4,-4,-3,-1,-6,-3,-2,5,-2,0,-1,-2,-3,2,0,-4,-1,1,-2,3,-2,4,0,-3,-1,-4,-1,-3,1,-1,2,-3,6,-11,3,2,-2,0,2,-7,2,1,0,-3,4,-4,1,1,-2,2,1,-4,2,0,0,1,0,-4,2,0,0,1,1,0,0,0,0,-15,-13,-2,1,-1,2,0,-3,-1,-1,-10,1,1,-4,1,-3,-5,-1,-1,1,-2,2,-5,2,1,-1,2,2,-2,0,1,0,0,1,-2,0,0,-1,2,1,0,0,-3,-5,2,3,3,0,-3,7,-6,2,-3,-1,-2,3,-5,-1,0,-1,-1,4,-1,3,-3,0,-3,4,-1,2,0,1,0,2,0,1,0,0,-3,2,-1,1,0,1,14,4,10,4,2,2,6,-2,5,2,5,-1,2,0,-1,-1,4,1,4,-2,6,3,1,-2,2,0,1,0,1,0,1,1,0,0,0,0,1,-1,1,0,1,0,-8,-1,-7,-6,-3,-3,1,-6,3,-5,-1,-2,2,-2,0,-2,0,0,-1,-4,3,-3,-1,-2,-1,-3,-2,-1,1,0,1,-2,-1,-1,0,0,-2,-1,-1,0,1,0,-14,-9,-5,7,5,2,-1,1,-5,-7,0,-3,2,2,-6,-5,0,-3,-3,-1,1,-2,0,0,1,4,0,1,1,-1,1,3,0,0,1,-1,0,1,0,1,0,0
20,20065,Soraluze/Placencia de las Armas,4315,-66,-35,-31,5,3,2,-2,-2,-24,-14,-13,-10,0,-1,-11,-10,-8,-5,-2,-1,-13,-4,-5,-5,1,4,0,0,0,0,1,2,0,0,0,0,0,2,0,0,0,0,5,3,2,14,9,5,2,8,9,-4,-4,-7,4,4,2,-3,-2,-3,-2,4,7,-1,-2,-4,2,6,3,2,0,0,1,3,2,2,0,0,1,3,1,0,0,0,12,-1,13,38,16,22,8,1,10,5,-6,-5,7,-1,1,2,-4,-4,1,2,9,3,-2,-1,11,6,17,4,1,0,7,3,5,2,0,0,4,3,12,2,1,0,18,10,8,63,34,29,17,8,4,3,-5,-7,2,1,9,5,-4,-2,15,7,-5,-2,-1,-5,21,7,22,7,6,0,8,2,15,6,3,0,13,5,7,1,3,0,-8,-12,4,4,4,0,2,-5,-1,1,-4,1,1,-2,-4,-4,-3,0,1,-3,3,5,-1,1,1,2,-1,1,1,0,1,2,0,0,1,0,0,0,-1,1,0,0,-33,-7,-26,13,10,3,-4,3,-9,-5,-4,-12,-2,-1,5,-2,-1,-5,-2,4,-14,-3,-3,-7,2,2,5,3,1,0,1,2,5,2,0,0,1,0,0,1,1,0,-10,-9,-1,14,2,12,5,7,3,-3,-12,-11,7,2,-1,-3,-7,-7,-2,5,4,0,-5,-4,3,6,3,3,-1,0,3,1,-2,1,-1,0,0,5,5,2,0,0,-25,-6,-19,21,8,13,-4,7,-13,4,-14,-5,-5,4,-1,5,-8,-1,1,3,-12,-1,-6,-4,6,4,7,3,1,0,4,0,3,0,1,0,2,4,4,3,0,0,-20,-9,-11,33,18,15,5,7,4,-11,-14,-12,5,7,6,-14,-6,-5,0,0,-2,3,-8,-7,8,11,13,1,0,0,3,4,9,1,1,0,5,7,4,0,-1,0,12,1,11,17,4,13,15,-2,-4,2,-1,2,7,-2,4,-6,-3,1,8,0,-8,8,2,1,16,-2,2,1,-1,1,7,-3,3,-2,-1,0,9,1,-1,3,0,1,-1,14,-15,14,11,3,9,-3,8,-12,-2,-2,12,-1,11,-4,-2,-2,-3,-2,-3,-8,0,0,6,5,5,0,0,-1,6,1,3,1,1,0,0,4,2,-1,-1,-1,-4,-1,-3,-7,2,-9,5,-3,-2,1,-4,-2,4,0,0,-2,0,-3,1,-3,-2,3,-4,1,-3,1,3,-4,-3,-1,-1,5,2,-2,-2,0,-2,-4,1,-2,-1,-1,67,37,30,-2,2,-4,19,24,14,13,5,-5,5,11,10,12,6,-5,14,13,4,1,-1,0,-2,7,-4,-4,0,1,-2,7,-3,-1,1,0,0,0,-1,-3,-1,1,-7,-8,1,6,3,3,3,2,-14,10,-8,-2,2,5,-11,4,-7,-2,1,-3,-3,6,-1,0,1,5,0,1,-4,3,1,4,0,0,-2,0,0,1,0,1,-2,3,-35,-8,-27,14,7,7,-17,6,-1,-8,-5,-9,-5,4,0,1,-5,-2,-12,2,-1,-9,0,-7,-1,4,10,2,-1,0,0,2,4,2,-1,0,-1,2,6,0,0,0,-1,7,-8,21,13,8,10,0,-1,-9,4,-4,14,2,-9,-3,7,-2,-4,-2,8,-6,-3,-2,5,7,6,0,4,-1,4,4,2,0,3,0,1,3,4,0,1,-1,-13,-8,-5,17,3,14,-7,4,-18,5,2,0,-6,4,-7,2,1,-1,-1,0,-11,3,1,1,4,4,6,1,-1,2,2,2,1,-1,-1,0,2,2,5,2,0,2,23,-12,35,7,-10,17,16,1,-7,-6,-9,26,6,-1,-14,-6,-4,5,10,2,7,0,-5,21,4,-1,1,-1,1,1,0,-2,-4,-4,-1,0,4,1,5,3,2,1
20,20071,Tolosa,18113,18,7,11,25,9,16,22,1,-13,19,0,-7,12,-4,4,4,-4,-1,10,5,-17,15,4,-6,4,9,6,2,3,1,2,1,2,2,2,0,2,8,4,0,1,1,-56,-44,-12,32,14,18,5,-8,-60,-14,5,15,8,2,-49,-8,1,4,-3,-10,-11,-6,4,11,4,7,12,8,0,1,2,6,3,3,0,0,2,1,9,5,0,1,-62,-10,-52,41,29,12,16,-25,-41,3,-17,6,16,-9,-7,1,-7,0,0,-16,-34,2,-10,6,15,4,17,3,0,2,12,3,11,3,0,0,3,1,6,0,0,2,-92,-44,-48,36,17,19,-18,-8,-55,-20,-1,11,-19,-12,-12,-7,6,0,1,4,-43,-13,-7,11,12,4,9,5,6,0,4,1,6,2,4,0,8,3,3,3,2,0,65,13,52,64,28,36,12,28,-11,9,14,8,8,25,-25,-2,-4,6,4,3,14,11,18,2,7,19,28,7,0,2,3,7,14,4,-1,1,4,12,14,3,1,1,56,37,19,108,55,53,32,11,2,14,3,-10,22,3,2,14,1,-8,10,8,0,0,2,-2,39,21,19,24,5,-1,21,11,6,14,3,0,18,10,13,10,2,-1,17,-8,25,92,39,53,-7,40,-20,4,-1,0,-8,21,-22,7,-7,3,1,19,2,-3,6,-3,16,42,16,16,0,-1,10,23,2,4,-1,-1,6,19,14,12,1,0,71,7,64,145,62,83,33,8,-4,21,17,-6,12,-7,-5,0,8,0,21,15,1,21,9,-6,40,36,27,34,8,-1,24,14,7,15,2,0,16,22,20,19,6,-1,157,97,60,111,72,39,42,21,67,27,-5,-1,26,22,44,8,-5,0,16,-1,23,19,0,-1,28,29,32,17,5,0,18,26,17,9,2,0,10,3,15,8,3,0,95,42,53,58,20,38,25,25,45,26,4,-25,4,20,22,-1,2,-3,21,5,23,27,2,-22,22,16,20,6,-6,1,12,3,5,1,-1,1,10,13,15,5,-5,0,162,102,60,13,-7,20,46,11,41,48,3,12,39,1,27,25,4,9,7,10,14,23,-1,3,7,-3,11,-4,-1,3,6,-10,2,-8,1,2,1,7,9,4,-2,1,371,167,204,72,25,47,109,32,127,69,16,7,46,13,61,32,8,2,63,19,66,37,8,5,16,18,19,11,11,-3,3,6,8,2,8,-2,13,12,11,9,3,-1,303,105,198,13,-7,20,87,32,81,58,6,26,25,-3,34,33,-3,15,62,35,47,25,9,11,5,14,-8,1,0,1,1,5,-6,-6,-2,1,4,9,-2,7,2,0,119,66,53,-2,-6,4,19,16,34,30,18,-1,19,8,25,10,12,-6,0,8,9,20,6,5,1,2,3,-5,-4,1,4,0,-2,-7,0,-1,-3,2,5,2,-4,2,227,132,95,31,14,17,41,29,50,67,21,15,22,29,27,31,15,6,19,0,23,36,6,9,15,9,1,9,-2,-1,6,2,-2,9,-1,1,9,7,3,0,-1,-2,92,57,35,7,-3,10,15,22,33,5,11,2,12,5,21,5,8,2,3,17,12,0,3,0,0,20,1,-8,-4,-3,-1,12,-2,-7,-4,-2,1,8,3,-1,0,-1,248,97,151,75,29,46,48,64,71,37,2,23,31,25,35,2,-6,5,17,39,36,35,8,18,22,37,12,1,-1,4,13,16,7,-4,-4,1,9,21,5,5,3,3,168,68,100,124,65,59,42,41,28,23,13,16,20,12,20,13,3,-2,22,29,8,10,10,18,22,35,41,16,3,4,14,11,26,8,2,2,8,24,15,8,1,2
20,20073,Usurbil,5282,-11,-2,-9,14,6,8,-9,-7,7,-1,-1,-1,-3,-2,6,-1,-1,-1,-6,-5,1,0,0,0,5,0,6,2,0,1,4,0,1,1,0,0,1,0,5,1,0,1,73,40,33,18,12,6,8,2,31,27,1,4,3,4,14,15,3,1,5,-2,17,12,-2,3,1,1,7,6,1,2,1,0,5,5,0,1,0,1,2,1,1,1,88,57,31,51,34,17,7,20,44,8,4,7,7,9,26,9,3,3,0,11,18,-1,1,4,10,7,26,3,4,0,6,4,20,1,3,0,4,3,6,2,1,0,34,6,28,14,5,9,15,3,9,2,-2,5,10,0,4,-5,-4,2,5,3,5,7,2,3,8,4,2,1,-1,0,3,1,2,1,-2,0,5,3,0,0,1,0,128,73,55,16,8,8,30,7,93,5,-14,-1,21,0,53,2,-7,-2,9,7,40,3,-7,1,7,6,1,1,-1,0,4,3,1,-1,0,0,3,3,0,2,-1,0,43,16,27,17,8,9,4,0,39,4,-4,0,1,-3,20,6,-5,-3,3,3,19,-2,1,3,6,1,6,3,1,-1,3,-1,3,4,-1,-1,3,2,3,-1,2,0,-32,-16,-16,20,7,13,-10,8,-2,-16,-3,-6,1,8,-7,-13,0,-4,-11,0,5,-3,-3,-2,2,2,8,6,2,0,2,1,0,2,2,0,0,1,8,4,0,0,54,44,10,39,23,16,8,-10,31,20,0,6,7,3,15,21,-2,0,1,-13,16,-1,2,6,7,9,13,8,2,0,2,7,9,4,1,0,5,2,4,4,1,0,91,45,46,42,18,24,20,24,39,19,-7,-7,5,16,29,0,-3,-4,15,8,10,19,-4,-3,4,13,8,10,3,3,2,7,3,3,3,0,2,6,5,7,0,3,37,19,18,8,0,8,5,4,17,12,5,-7,0,-4,7,10,5,1,5,8,10,2,0,-8,3,5,-4,3,1,0,1,2,-5,2,0,0,2,3,1,1,1,0,8,3,5,10,5,5,4,17,2,0,-7,-5,5,10,-1,-4,-4,-2,-1,7,3,4,-3,-3,3,4,-1,2,0,2,2,0,0,2,0,1,1,4,-1,0,0,1,-22,-20,-2,-3,-7,4,22,-10,-6,-17,-9,-2,22,-3,-8,-17,-10,-3,0,-7,2,0,1,1,4,0,0,-5,-3,1,4,-1,-4,-3,-4,1,0,1,4,-2,1,0,11,8,3,7,-1,8,-13,11,0,13,3,-4,-10,8,-6,10,5,-1,-3,3,6,3,-2,-3,0,5,-5,4,1,0,0,0,-5,3,1,0,0,5,0,1,0,0,44,13,31,-4,-8,4,14,-2,27,7,3,-9,7,-3,12,2,-2,-5,7,1,15,5,5,-4,-3,3,3,-3,-1,-3,-4,0,-1,-1,0,-2,1,3,4,-2,-1,-1,4,-15,19,14,3,11,17,-1,9,-5,-17,1,7,-9,-4,-1,-10,1,10,8,13,-4,-7,0,4,0,12,0,-3,0,2,-2,4,0,-2,0,2,2,8,0,-1,0,4,10,-6,24,19,5,-3,-10,11,-2,4,-1,-3,-7,9,2,6,0,0,-3,2,-4,-2,-1,4,2,8,3,5,-1,4,0,7,3,4,-1,0,2,1,0,1,0,-51,-50,-1,-4,-9,5,-15,3,-5,-35,-2,-2,-12,1,-10,-26,-5,-3,-3,2,5,-9,3,1,3,0,2,-6,-3,0,0,-1,-1,-6,-2,1,3,1,3,0,-1,-1,-1,-6,5,-2,-4,2,7,-6,6,-8,3,-2,4,-2,-6,-4,3,1,3,-4,12,-4,0,-3,-1,2,3,-5,-2,1,-3,3,1,-5,-1,1,2,-1,2,0,-1,0
20,20075,Villabona,5443,8,-1,9,12,7,5,5,10,19,-24,-4,-2,7,3,9,-16,-2,-2,-2,7,10,-8,-2,0,3,4,5,0,0,0,1,3,3,0,0,0,2,1,2,0,0,0,17,7,10,17,11,6,0,-1,8,10,-4,0,2,-5,3,7,-2,0,-2,4,5,3,-2,0,3,5,5,3,1,0,2,5,2,2,0,0,1,0,3,1,1,0,60,26,34,25,15,10,-4,11,34,11,3,1,-1,3,21,3,1,-1,-3,8,13,8,2,2,4,5,8,4,2,2,3,2,5,2,2,1,1,3,3,2,0,1,73,46,27,19,14,5,-3,22,28,14,12,4,1,16,14,4,6,5,-4,6,14,10,6,-1,0,6,4,6,3,0,0,4,3,5,2,0,0,2,1,1,1,0,-27,-11,-16,22,9,13,-15,5,-5,-5,-5,-1,-6,0,-2,-2,-3,0,-9,5,-3,-3,-2,-1,5,3,9,5,0,0,3,0,5,1,0,0,2,3,4,4,0,0,-26,-10,-16,65,52,13,-3,-6,-7,-3,-8,1,-2,1,2,-5,-6,2,-1,-7,-9,2,-2,-1,18,14,22,8,2,0,13,12,19,7,1,0,5,2,3,1,1,0,-11,-21,10,8,-7,15,-2,-5,8,-10,0,0,-3,-6,-7,-7,0,2,1,1,15,-3,0,-2,7,-3,0,2,2,1,2,-5,-4,0,1,0,5,2,4,2,1,1,-48,-7,-41,59,37,22,-14,-1,-2,-24,-5,2,-6,1,10,-14,0,1,-8,-2,-12,-10,-5,1,7,12,26,8,5,1,3,10,13,8,3,0,4,2,13,0,2,1,7,13,-6,41,24,17,-11,27,-23,8,-5,6,-2,16,-17,8,1,6,-9,11,-6,0,-6,0,-1,18,8,10,2,2,0,8,4,7,2,2,-1,10,4,3,0,0,22,-13,35,4,-8,12,10,5,20,-6,-5,-5,-4,1,1,-10,1,-3,14,4,19,4,-6,-2,7,-1,1,2,-5,0,2,-3,-3,-1,-3,0,5,2,4,3,-2,0,22,5,17,22,14,8,15,2,8,-6,0,0,10,8,1,-8,-2,-3,5,-6,7,2,2,3,8,7,7,3,-3,0,4,5,5,1,-1,0,4,2,2,2,-2,0,-7,-7,0,32,12,20,10,10,-17,-14,-1,8,6,8,-13,-9,2,4,4,2,-4,-5,-3,4,7,14,3,1,5,0,5,6,-1,0,3,-1,2,8,4,1,2,1,-5,-6,1,10,4,6,-23,20,4,-3,-2,-1,-10,12,3,-4,-3,-2,-13,8,1,1,1,1,0,10,-2,1,0,-1,-1,6,0,-1,0,-1,1,4,-2,2,0,0,-1,-17,16,-4,-7,3,1,2,13,-20,3,-8,-3,-8,11,-15,-1,-5,4,10,2,-5,4,-3,-4,9,0,-10,0,-1,-2,3,0,-7,-2,0,-2,6,0,-3,2,-1,-27,-21,-6,4,2,2,-5,7,-23,0,-7,2,0,6,-22,-3,-6,2,-5,1,-1,3,-1,0,2,8,-2,2,-6,0,2,3,0,1,-4,0,0,5,-2,1,-2,0,31,28,3,3,2,1,8,-4,14,7,2,6,3,-2,16,3,2,8,5,-2,-2,4,0,-2,-4,2,4,2,-1,0,-1,-1,6,-2,0,0,-3,3,-2,4,-1,0,-20,-26,6,33,13,20,-12,9,-15,-3,4,0,-8,1,-15,1,0,-4,-4,8,0,-4,4,4,9,13,6,5,2,-2,6,5,0,4,0,-2,3,8,6,1,2,0,6,0,6,42,16,26,-4,17,0,-1,-8,5,0,11,-4,-2,-5,2,-4,6,4,1,-3,3,11,13,9,4,3,2,2,3,5,2,3,1,9,10,4,2,0,1
20,20079,Zarautz,20187,314,137,177,88,45,43,13,66,104,55,38,37,-4,29,49,25,18,20,17,37,55,30,20,17,13,25,29,11,8,2,7,12,17,4,4,1,6,13,12,7,4,1,250,129,121,113,63,50,29,47,92,38,25,14,21,24,35,31,15,1,8,23,57,7,10,13,29,28,28,19,2,4,16,15,15,11,2,2,13,13,13,8,0,2,163,91,72,111,56,55,21,50,26,47,5,3,18,22,18,23,2,0,3,28,8,24,3,3,15,33,35,16,7,4,9,15,18,10,1,2,6,18,17,6,6,2,208,91,117,152,77,75,35,48,32,54,6,21,22,20,4,33,-1,8,13,28,28,21,7,13,27,43,46,18,10,3,12,22,26,12,3,1,15,21,20,6,7,2,63,23,40,135,66,69,35,46,-10,-13,4,1,16,20,-4,-12,-1,5,19,26,-6,-1,5,-4,35,58,28,14,-3,3,15,33,14,2,0,2,20,25,14,12,-3,1,197,113,84,173,89,84,20,40,63,35,14,21,14,14,33,24,13,13,6,26,30,11,1,8,29,50,53,28,5,4,10,25,31,16,4,1,19,25,22,12,1,3,-29,-27,-2,214,88,126,-27,69,-30,-48,4,8,-14,31,-34,-18,6,4,-13,38,4,-30,-2,4,26,72,67,31,14,2,4,40,23,14,5,2,22,32,44,17,9,0,109,17,92,194,70,124,19,58,35,-6,-10,14,9,15,12,-16,-7,5,10,43,23,10,-3,9,41,53,78,25,-2,-2,16,13,36,8,-2,-1,25,40,42,17,0,-1,112,60,52,174,84,90,-5,28,40,4,23,24,-3,10,45,-2,7,6,-2,18,-5,6,16,18,24,40,70,20,17,0,16,12,39,11,4,1,8,28,31,9,13,-1,-6,3,-9,58,16,42,0,21,-18,-7,-11,5,7,22,-8,-16,-6,0,-7,-1,-10,9,-5,5,11,34,4,7,1,1,4,21,-9,0,-1,0,7,13,13,7,2,1,44,-11,55,20,-11,31,7,45,20,-33,2,0,11,16,13,-35,-15,-3,-4,29,7,2,17,3,10,29,-13,-9,0,1,2,7,-5,-11,-5,0,8,22,-8,2,5,1,-62,-37,-25,13,-3,16,7,5,-35,-11,-15,-20,-1,-3,-20,-3,-12,-1,8,8,-15,-8,-3,-19,5,23,-10,-5,1,-3,2,9,-14,-1,-2,1,3,14,4,-4,3,-4,75,6,69,18,-13,31,19,28,-4,-8,30,14,12,4,-11,-14,10,8,7,24,7,6,20,6,10,17,-5,1,-4,-1,7,0,-12,-5,-4,1,3,17,7,6,0,-2,126,49,77,-26,-20,-6,0,6,4,21,38,57,1,15,-3,14,3,21,-1,-9,7,7,35,36,2,8,-10,-22,-2,-2,-1,5,-7,-14,-2,-1,3,3,-3,-8,0,-1,74,30,44,19,8,11,7,40,1,-11,12,26,11,10,-2,-6,3,12,-4,30,3,-5,9,14,13,24,-8,-9,-1,-2,10,11,-12,-4,4,-2,3,13,4,-5,-5,0,148,91,57,35,19,16,41,37,14,35,11,6,25,29,13,15,5,2,16,8,1,20,6,4,11,29,14,-10,-5,-6,3,13,13,-5,-2,-3,8,16,1,-5,-3,-3,78,25,53,65,30,35,41,32,30,3,-21,-11,17,11,17,0,-17,-4,24,21,13,3,-4,-7,16,33,12,6,-6,2,11,18,6,0,-5,-1,5,15,6,6,-1,3,96,24,72,112,38,74,48,18,29,24,-34,7,21,15,13,-8,-25,6,27,3,16,32,-9,1,22,35,24,20,4,4,10,12,8,3,2,2,12,23,16,17,2,2
20,20025,Zegama,1307,17,17,0,7,5,2,1,0,6,5,4,-1,1,1,4,6,3,0,0,-1,2,-1,1,-1,2,0,2,2,0,0,1,0,1,2,0,0,1,0,1,0,0,0,24,12,12,5,3,2,8,3,8,8,0,-3,2,1,6,4,-1,0,6,2,2,4,1,-3,0,2,2,1,0,0,0,1,2,0,0,0,0,1,0,1,0,0,0,-1,1,8,5,3,-2,7,-1,0,-2,-2,-2,4,3,-2,-2,-2,0,3,-4,2,0,0,0,1,4,3,0,0,0,1,3,1,0,0,0,0,1,2,0,0,14,13,1,11,7,4,-1,9,2,4,1,-1,0,8,4,1,0,0,-1,1,-2,3,1,-1,1,2,6,2,0,0,0,2,4,1,0,0,1,0,2,1,0,0,1,1,0,9,7,2,1,5,-1,-1,1,-3,0,3,-2,1,0,-1,1,2,1,-2,1,-2,1,1,4,3,0,0,1,1,2,3,0,0,0,0,2,0,0,0,40,34,6,24,19,5,0,9,15,8,6,2,1,8,15,4,4,2,-1,1,0,4,2,0,1,7,10,5,1,0,1,7,7,3,1,0,0,0,3,2,0,0,65,44,21,33,28,5,4,13,30,9,7,1,1,8,22,5,7,1,3,5,8,4,0,0,2,10,9,11,1,0,1,10,8,8,1,0,1,0,1,3,0,0,44,27,17,32,21,11,10,5,20,14,-4,-3,5,5,4,14,-3,1,5,0,16,0,-1,-4,5,6,11,9,1,0,2,4,8,6,1,0,3,2,3,3,0,0,34,15,19,23,9,14,7,6,16,3,3,-1,6,2,6,1,1,0,1,4,10,2,2,-1,9,3,7,4,0,0,6,0,1,2,0,0,3,3,6,2,0,0,29,3,26,21,7,14,14,6,12,2,-4,1,6,-1,3,-1,-2,0,8,7,9,3,-2,1,9,8,4,0,-1,1,4,1,2,0,-1,1,5,7,2,0,0,0,13,16,-3,12,8,4,-6,10,6,5,3,-5,1,5,6,3,2,-2,-7,5,0,2,1,-3,0,4,4,4,0,0,0,2,3,3,0,0,0,2,1,1,0,0,-10,0,-10,-4,-1,-3,-4,2,-2,-8,-3,1,-6,7,0,-5,0,1,2,-5,-2,-3,-3,0,-4,2,1,-3,0,0,-2,2,-1,-1,1,0,-2,0,2,-2,-1,0,-11,-12,1,-1,-1,0,-5,-2,-3,3,-3,-2,-4,-2,-5,2,-4,-2,-1,0,2,1,1,0,0,2,-1,-1,-1,0,-1,2,-1,0,-1,0,1,0,0,-1,0,0,-16,-11,-5,-4,-4,0,-6,1,-5,-3,-2,0,-3,-1,-1,-2,-3,0,-3,2,-4,-1,1,0,1,1,-1,-4,-1,0,2,-1,0,-4,-1,0,-1,2,-1,0,0,0,-9,-7,-2,-24,-15,-9,7,-1,-3,-7,-5,-1,7,0,-1,-5,-6,-1,0,-1,-2,-2,1,0,-1,-5,-5,-9,-5,0,0,-3,-2,-6,-4,0,-1,-2,-3,-3,-1,0,-2,1,-3,9,5,4,0,4,-9,3,-1,0,1,3,-6,1,1,0,-1,1,-3,2,-2,0,0,2,3,2,2,0,0,1,1,2,1,0,0,1,2,0,1,0,13,2,11,11,4,7,6,1,3,-2,1,2,5,2,-1,-1,-4,0,1,-1,4,-1,5,2,5,-1,2,2,2,0,2,0,1,1,0,0,3,-1,1,1,2,0,-13,-6,-7,-2,1,-3,-1,0,1,-4,-3,-3,1,-1,1,-1,-1,-4,-2,1,0,-3,-2,1,0,2,2,-4,-1,-1,0,3,2,-3,0,-1,0,-1,0,-1,-1,0
20,20027,Zestoa,3182,6,-1,7,4,2,2,-3,6,-11,9,3,-1,-4,2,-5,4,2,0,1,4,-6,5,1,-1,1,0,0,1,0,1,0,0,0,1,0,1,1,0,0,0,0,0,-8,-12,4,4,2,2,1,0,-3,-6,1,0,0,-1,-5,-6,1,0,1,1,2,0,0,0,2,0,1,1,0,0,1,0,1,0,0,0,1,0,0,1,0,0,-28,-10,-18,7,1,6,-2,-10,-7,-2,-4,-2,-3,-1,-6,1,0,-1,1,-9,-1,-3,-4,-1,3,1,1,1,0,1,1,0,-1,1,0,0,2,1,2,0,0,1,35,24,11,11,5,6,5,16,2,5,6,-1,2,3,14,1,2,1,3,13,-12,4,4,-2,4,2,4,0,0,1,3,0,1,0,0,1,1,2,3,0,0,0,118,82,36,20,15,5,7,23,62,14,6,4,3,19,46,7,3,2,4,4,16,7,3,2,0,8,8,1,2,1,0,7,6,0,1,1,0,1,2,1,1,0,70,38,32,17,13,4,14,17,35,4,4,-5,8,10,17,-1,3,-1,6,7,18,5,1,-4,2,7,6,2,0,0,2,6,3,2,0,0,0,1,3,0,0,0,94,53,41,19,10,9,12,19,38,9,5,8,5,12,20,7,1,6,7,7,18,2,4,2,2,5,8,4,0,0,2,2,4,2,0,0,0,3,4,2,0,0,9,0,9,19,6,13,-7,0,5,9,0,3,-7,-1,2,6,0,1,0,1,3,3,0,2,3,6,4,4,3,-1,1,1,4,0,0,0,2,5,0,4,3,-1,43,32,11,30,18,12,-2,3,29,14,3,-7,2,-1,17,13,1,-2,-4,4,12,1,2,-5,0,11,8,8,1,2,0,4,5,8,0,1,0,7,3,0,1,1,56,44,12,21,16,5,5,25,14,7,7,-1,1,18,12,10,5,-1,4,7,2,-3,2,0,3,8,6,1,3,0,1,6,5,2,2,0,2,2,1,-1,1,0,92,44,48,44,21,23,18,22,36,13,3,-2,16,7,21,-1,3,-2,2,15,15,14,0,0,17,9,11,4,3,0,15,3,4,-1,0,0,2,6,7,5,3,0,-5,9,-14,6,4,2,0,6,-2,-2,-9,2,4,4,0,2,-2,0,-4,2,-2,-4,-7,2,0,5,1,4,-4,0,0,0,0,5,-1,0,0,5,1,-1,-3,0,-28,-14,-14,-8,-6,-2,-5,11,-32,6,-2,-3,-3,7,-18,3,-2,-1,-2,4,-14,3,0,-2,-1,6,-6,-6,-1,0,-1,5,-3,-6,-1,0,0,1,-3,0,0,0,23,16,7,7,4,3,-5,1,33,-5,1,-4,-6,0,20,2,1,-2,1,1,13,-7,0,-2,3,3,1,-2,1,1,2,2,1,-1,0,0,1,1,0,-1,1,1,48,31,17,14,9,5,10,14,3,6,5,5,7,8,6,0,3,4,3,6,-3,6,2,1,0,5,7,0,-1,3,2,1,5,1,-1,1,-2,4,2,-1,0,2,36,21,15,8,1,7,5,11,6,1,4,7,7,7,-1,1,4,2,-2,4,7,0,0,5,0,5,6,-1,0,-2,-1,1,4,-1,0,-2,1,4,2,0,0,0,-25,-16,-9,22,7,15,-15,5,-12,-16,16,-3,-7,4,-10,-13,8,0,-8,1,-2,-3,8,-3,2,6,3,7,4,0,1,2,1,2,1,0,1,4,2,5,3,0,13,5,8,23,12,11,-10,6,13,-1,2,0,-5,0,4,5,0,1,-5,6,9,-6,2,-1,3,3,10,6,0,0,2,0,7,3,0,0,1,3,3,3,0,0
20,20028,Zizurkil,2763,16,10,6,7,3,4,7,3,3,3,-1,2,1,5,-2,3,1,2,6,-2,5,0,-2,0,2,1,1,1,1,1,0,1,0,1,0,1,2,0,1,0,1,0,7,15,-8,12,8,4,2,-2,7,5,-3,-1,1,4,6,5,-1,0,1,-6,1,0,-2,-1,3,4,2,3,0,0,3,2,1,2,0,0,0,2,1,1,0,0,-22,-9,-13,9,5,4,-11,4,-4,-4,-7,0,-9,6,1,-3,-2,-2,-2,-2,-5,-1,-5,2,-1,5,5,0,0,0,0,3,3,-1,0,0,-1,2,2,1,0,0,-33,-10,-23,19,14,5,3,-12,-14,2,-8,-4,0,-5,-3,6,-4,-4,3,-7,-11,-4,-4,0,4,9,5,0,0,0,1,5,8,0,0,0,3,4,-3,0,0,0,-29,-18,-11,2,0,2,0,-8,-16,-3,-1,1,1,-8,-6,-2,-1,1,-1,0,-10,-1,0,0,-1,0,3,0,0,0,-1,-1,2,-1,1,0,0,1,1,1,-1,0,26,10,16,31,18,13,-1,16,23,-5,1,-7,-2,7,15,-7,-2,-1,1,9,8,2,3,-6,0,14,14,2,1,0,0,8,9,0,1,0,0,6,5,2,0,0,-58,-30,-28,9,4,5,-4,-3,-34,-6,-11,-1,-5,4,-16,-5,-6,-2,1,-7,-18,-1,-5,1,1,5,2,1,0,-1,1,2,-1,3,0,-1,0,3,3,-2,0,0,-7,-10,3,10,6,4,9,-5,-20,2,5,0,4,-6,-17,4,4,1,5,1,-3,-2,1,-1,3,1,2,2,1,1,2,0,3,-1,2,0,1,1,-1,3,-1,1,-13,-6,-7,26,19,7,-4,3,-2,-2,-3,-4,-5,5,-4,3,-3,-2,1,-2,2,-5,0,-2,0,10,9,5,2,0,0,7,5,5,1,1,0,3,4,0,1,-1,-22,-12,-10,8,7,1,-9,-1,-8,0,-3,1,-1,-4,0,-1,-4,-1,-8,3,-8,1,1,2,-2,-1,11,0,1,0,-2,-2,9,1,2,-1,0,1,2,-1,-1,1,28,17,11,12,10,2,6,11,3,-3,2,4,7,5,0,-2,2,2,-1,6,3,-1,0,2,1,4,1,3,-1,1,1,3,1,2,0,1,0,1,0,1,-1,0,100,28,72,-6,-12,6,21,-1,38,18,16,8,2,-3,13,6,7,3,19,2,25,12,9,5,0,-1,-2,-1,-1,0,-2,-2,-3,-2,-2,0,2,1,1,1,1,0,88,65,23,29,27,2,21,8,24,30,1,1,9,8,20,23,2,1,12,0,4,7,-1,0,0,11,10,7,1,0,0,8,10,8,1,0,0,3,0,-1,0,0,-11,-14,3,-33,-28,-5,13,4,-10,-8,-8,2,12,3,-15,-9,-2,0,1,1,5,1,-6,2,0,-1,-19,-9,-3,-1,0,0,-17,-8,-2,-1,0,-1,-2,-1,-1,0,14,11,3,-11,-12,1,12,-17,27,-6,-7,0,5,-4,14,-3,-4,1,7,-13,13,-3,-3,-1,2,-7,2,-3,-3,-2,1,-5,0,-4,-3,-1,1,-2,2,1,0,-1,-7,-5,-2,12,0,12,3,-7,1,-1,-6,-2,-1,-3,-1,2,0,-3,4,-4,2,-3,-6,1,2,4,-2,11,-3,0,0,-1,-2,5,-2,0,2,5,0,6,-1,0,-24,-4,-20,16,14,2,-6,-1,-12,-4,-4,0,-1,-1,-3,-1,0,1,-5,0,-9,-3,-4,-1,1,3,4,4,3,0,1,3,2,4,3,0,0,0,2,0,0,0,-4,-11,7,-14,-19,5,5,-1,-9,1,-3,0,0,1,-7,-1,-5,-1,5,-2,-2,2,2,1,2,0,-6,-9,-2,0,1,1,-8,-10,-3,0,1,-1,2,1,1,0
20,20081,Zumaia,8331,42,36,6,11,7,4,7,1,23,1,2,5,7,-1,25,-3,2,3,0,2,-2,4,0,2,2,3,2,2,2,0,1,2,2,1,1,0,1,1,0,1,1,0,90,57,33,21,12,9,12,25,34,23,-5,0,5,17,23,13,-5,3,7,8,11,10,0,-3,5,9,1,5,1,0,1,7,1,3,0,0,4,2,0,2,1,0,64,28,36,22,12,10,19,10,1,22,1,9,9,-4,10,9,-2,4,10,14,-9,13,3,5,6,4,4,6,-1,3,4,1,4,2,-1,2,2,3,0,4,0,1,24,8,16,14,7,7,4,-8,6,6,6,6,0,-5,2,3,0,4,4,-3,4,3,6,2,2,4,-2,4,5,1,1,0,3,2,1,0,1,4,-5,2,4,1,9,-3,12,9,7,2,6,-2,14,0,-4,-1,1,-7,9,-3,-1,-1,5,5,5,3,-3,0,1,7,4,-1,-1,-1,1,2,4,0,0,0,0,5,0,-1,-1,-1,84,31,53,28,9,19,13,5,18,30,5,11,8,4,1,10,3,5,5,1,17,20,2,6,9,5,5,5,4,0,7,2,1,-2,1,0,2,3,4,7,3,0,92,45,47,46,20,26,16,16,32,21,4,2,18,5,15,9,1,-2,-2,11,17,12,3,4,12,14,13,4,4,-1,8,6,4,1,1,0,4,8,9,3,3,-1,61,14,47,56,11,45,14,23,10,9,5,1,4,5,4,2,-2,2,10,18,6,7,7,-1,11,17,18,8,1,0,1,1,6,4,0,-1,10,16,12,4,1,1,122,67,55,36,24,12,40,16,39,23,1,-1,34,9,10,11,0,-1,6,7,29,12,1,0,12,15,5,3,0,0,12,7,3,1,0,-1,0,8,2,2,0,1,1,-12,13,-1,-6,5,-4,-1,-2,-3,-2,9,-12,-8,-2,2,0,5,8,7,0,-5,-2,4,0,3,4,-7,-2,1,0,-1,1,-5,-1,0,0,4,3,-2,-1,1,62,11,51,31,6,25,17,7,24,11,-5,6,-1,5,5,3,-7,1,18,2,19,8,2,5,3,6,11,7,3,1,-2,2,2,2,0,1,5,4,9,5,3,0,82,28,54,13,2,11,10,6,43,13,6,2,-5,0,23,13,-1,-1,15,6,20,0,7,3,1,2,8,3,0,-1,-3,0,4,3,-1,-1,4,2,4,0,1,0,8,4,4,2,0,2,-13,4,22,0,-9,6,-10,5,16,-7,-2,3,-3,-1,6,7,-7,3,0,4,2,-4,0,0,-1,1,0,-1,1,0,1,3,2,-3,-1,0,72,45,27,-3,-5,2,23,8,-3,14,18,13,16,9,-2,14,5,6,7,-1,-1,0,13,7,-1,6,-3,0,-3,-2,-2,3,-2,1,-4,-1,1,3,-1,-1,1,-1,44,23,21,11,0,11,3,9,30,6,-8,7,-2,6,18,7,-5,0,5,3,12,-1,-3,7,6,4,6,-5,-1,1,2,3,-2,-3,-1,1,4,1,8,-2,0,0,9,-7,16,14,7,7,21,2,6,-1,-5,-17,12,-4,-3,-4,-2,-7,9,6,9,3,-3,-10,11,3,-5,4,2,-2,10,-1,-3,2,0,-1,1,4,-2,2,2,-1,123,68,55,48,26,22,26,12,39,31,3,12,18,8,23,16,-2,5,8,4,16,15,5,7,13,16,11,6,0,2,9,10,2,5,0,0,4,6,9,1,0,2,70,54,16,16,7,9,15,4,27,10,0,12,2,7,19,13,3,8,13,-3,8,-3,-3,4,6,2,9,-1,-3,2,-1,2,3,3,-3,2,7,0,6,-4,0,0
20,20080,Zumarraga,10126,-47,-15,-32,15,7,8,-10,7,-2,-22,-4,-16,-5,12,-2,-9,-3,-7,-5,-5,0,-13,-1,-9,1,6,4,2,0,1,0,3,2,2,0,0,1,3,2,0,0,1,-4,-3,-1,37,13,24,-2,29,-1,-20,-4,-5,-3,15,-3,-8,-1,-2,1,14,2,-12,-3,-3,8,12,12,3,1,1,3,4,4,1,0,1,5,8,8,2,1,0,-76,-19,-57,34,19,15,-18,-5,-20,-23,-10,4,-1,-1,2,-14,-9,6,-17,-4,-22,-9,-1,-2,8,7,10,5,2,1,1,4,11,2,0,1,7,3,-1,3,2,0,-49,-18,-31,32,17,15,13,-8,-11,-15,-14,-11,12,-6,-2,-4,-10,-5,1,-2,-9,-11,-4,-6,8,6,11,6,0,1,5,3,6,3,0,0,3,3,5,3,0,1,-53,-25,-28,41,19,22,-3,-12,-53,16,-5,4,0,-5,-31,16,-3,-2,-3,-7,-22,0,-2,6,9,13,9,6,2,1,7,4,4,3,1,0,2,9,5,3,1,1,-12,-16,4,25,5,20,11,3,-8,-11,-12,7,2,8,-2,-17,-7,1,9,-5,-6,6,-5,6,9,6,5,3,1,1,2,2,-2,3,0,0,7,4,7,0,1,1,-23,-15,-8,45,16,29,3,-6,-15,-3,1,-6,1,-1,-9,-4,-3,-3,2,-5,-6,1,4,-3,14,11,12,2,4,1,4,3,5,2,0,1,10,8,7,0,4,0,-13,1,-14,45,25,20,3,15,-15,-9,-3,-3,3,5,-2,-2,0,-1,0,10,-13,-7,-3,-2,5,18,17,3,2,-1,0,9,13,1,2,0,5,9,4,2,0,-1,57,38,19,48,22,26,21,16,29,1,-6,-5,10,4,23,6,-4,-3,11,12,6,-5,-2,-2,8,7,20,10,3,0,4,-2,11,7,0,2,4,9,9,3,3,-2,-72,-26,-46,1,2,-1,-22,4,-29,-14,-3,-1,-5,2,-13,-8,-2,3,-17,2,-16,-6,-1,-4,5,6,-5,-2,-2,0,5,6,-5,-4,0,0,0,0,0,2,-2,0,0,-15,15,13,-4,17,-5,9,4,-12,-6,7,-9,8,4,-15,-1,-1,4,1,0,3,-5,8,3,5,1,1,-1,2,1,0,-1,-4,-2,1,2,5,2,5,1,1,13,0,13,6,4,2,-3,13,1,3,3,0,1,9,-9,4,-5,0,-4,4,10,-1,8,0,1,11,0,-6,4,-4,1,8,-2,-2,0,-1,0,3,2,-4,4,-3,82,63,19,18,14,4,17,12,24,24,0,7,14,12,27,6,4,2,3,0,-3,18,-4,5,-1,4,4,9,1,0,1,2,4,4,2,0,-2,2,0,5,-1,0,-111,-76,-35,-1,-7,6,-38,-13,-35,-30,-6,13,-25,-10,-16,-22,-6,5,-13,-3,-19,-8,0,8,3,4,-4,-7,1,2,1,-2,-3,-3,0,0,2,6,-1,-4,1,2,-26,-39,13,43,16,27,-12,1,-6,19,-10,-12,-5,-2,-18,9,-10,-8,-7,3,12,10,0,-4,15,7,12,2,6,1,5,3,5,1,2,0,10,4,7,1,4,1,56,26,30,21,4,17,27,30,-1,12,-4,-8,19,14,-1,-5,1,-5,8,16,0,17,-5,-3,8,10,-1,0,2,2,6,2,-4,-3,2,1,2,8,3,3,0,1,-26,-6,-20,18,9,9,-21,2,4,-5,-8,1,-9,7,-2,5,-5,-2,-12,-5,6,-10,-3,3,3,9,2,0,4,-1,4,9,-2,-1,1,-2,-1,0,4,1,3,1,53,39,14,68,22,46,30,27,8,-2,-7,-3,21,13,6,4,-5,1,9,14,2,-6,-2,-4,24,20,14,11,-3,-1,11,9,4,3,-5,0,13,11,10,8,2,-1
21,21002,Aljaraque,10298,697,365,332,10,5,5,160,89,224,152,46,10,83,58,105,78,29,4,77,31,119,74,17,6,0,0,5,3,1,1,0,0,2,2,1,0,0,0,3,1,0,1,513,267,246,69,31,38,85,78,176,121,34,17,51,30,91,68,19,8,34,48,85,53,15,9,10,22,16,10,10,1,5,7,10,3,6,0,5,15,6,7,4,1,792,387,405,67,34,33,137,119,322,128,51,20,73,49,170,60,26,5,64,70,152,68,25,15,12,11,14,16,14,0,9,3,8,5,9,0,3,8,6,11,5,0,676,339,337,62,34,28,82,134,306,83,29,18,44,56,161,46,15,6,38,78,145,37,14,12,6,18,15,12,4,4,4,8,8,7,1,3,2,10,7,5,3,1,537,257,280,49,21,28,125,28,208,103,45,9,64,5,111,47,22,0,61,23,97,56,23,9,9,9,16,7,8,0,4,5,6,3,3,0,5,4,10,4,5,0,673,362,311,72,37,35,169,43,191,173,47,30,94,24,98,89,31,15,75,19,93,84,16,15,6,20,24,19,-1,2,3,10,13,9,-1,1,3,10,11,10,0,1,619,282,337,75,31,44,150,41,210,169,14,16,64,10,111,83,6,-2,86,31,99,86,8,18,10,23,27,9,4,2,5,6,13,4,2,1,5,17,14,5,2,1,726,353,373,99,46,53,148,88,231,140,66,21,66,41,110,68,43,12,82,47,121,72,23,9,16,38,27,9,9,0,7,17,12,4,5,1,9,21,15,5,4,-1,519,261,258,87,43,44,118,39,193,85,52,14,67,15,106,38,23,3,51,24,87,47,29,11,25,18,19,13,10,1,17,7,10,5,3,0,8,11,9,8,7,1,392,189,203,42,12,30,88,9,133,80,28,30,51,1,67,31,21,7,37,8,66,49,7,23,12,4,18,6,1,1,1,0,6,2,1,2,11,4,12,4,0,-1,466,243,223,20,8,12,109,36,149,108,29,12,52,12,83,67,12,6,57,24,66,41,17,6,6,9,1,-2,5,1,2,3,1,-1,3,0,4,6,0,-1,2,1,252,103,149,19,3,16,67,7,79,58,10,5,42,-5,17,33,0,5,25,12,62,25,10,0,5,5,-2,6,5,0,4,1,-3,1,1,-1,1,4,1,5,4,1,141,42,99,23,5,18,42,-9,52,9,1,24,14,-15,21,0,-4,15,28,6,31,9,5,9,8,6,6,-1,1,2,4,2,0,0,-2,1,4,4,6,-1,3,1,51,20,31,-32,-19,-13,48,-17,23,1,-2,-9,24,-14,5,7,1,-9,24,-3,18,-6,-3,0,0,-3,-16,1,-13,-1,-2,2,-8,-3,-6,-2,2,-5,-8,4,-7,1,163,69,94,-3,-4,1,73,3,38,45,-14,3,39,1,2,21,-7,2,34,2,36,24,-7,1,5,2,-7,3,-9,3,2,-2,-4,1,-3,2,3,4,-3,2,-6,1,8,-15,23,-153,-81,-72,45,-29,3,-18,-21,10,31,-27,1,-15,-13,2,14,-2,2,-3,-8,8,-14,-16,-49,-43,-23,-8,-5,-10,-25,-22,-15,-4,-9,-6,-24,-21,-8,-4,2,-6,8,24,11,13,40,-31,23,-12,-24,2,20,-11,-5,-2,-1,-8,20,-20,28,-10,-23,10,12,3,6,-3,1,4,4,3,4,-4,2,1,8,0,2,1,-1,3,162,62,100,35,8,27,71,-28,81,44,-43,12,37,-20,45,8,-25,1,34,-8,36,36,-18,11,6,8,17,-1,-1,5,0,2,9,-4,-2,3,6,6,8,3,1,2
21,21010,Ayamonte,16980,84,57,27,18,12,6,15,-2,31,15,22,2,11,-8,26,10,15,1,4,6,5,5,7,1,3,1,4,2,8,0,1,1,3,1,6,0,2,0,1,1,2,0,118,62,56,36,18,18,7,0,52,37,22,-3,5,-2,26,16,17,0,2,2,26,21,5,-3,3,6,10,10,6,1,3,2,5,4,4,0,0,4,5,6,2,1,330,186,144,211,120,91,49,45,75,71,67,25,27,19,48,44,42,8,22,26,27,27,25,17,25,41,54,51,30,7,14,20,35,32,17,2,11,21,19,19,13,5,371,169,202,207,106,101,64,57,113,85,46,10,20,25,48,52,19,7,44,32,65,33,27,3,29,30,59,52,33,3,11,19,28,30,15,3,18,11,31,22,18,0,352,196,156,211,120,91,61,41,116,55,53,17,35,19,65,32,30,11,26,22,51,23,23,6,35,30,56,50,32,4,17,19,31,29,19,3,18,11,25,21,13,1,562,319,243,445,269,176,62,90,188,135,67,19,32,53,111,72,38,14,30,37,77,63,29,5,56,74,133,124,47,10,31,43,85,72,30,7,25,31,48,52,17,3,762,441,321,564,324,240,109,99,189,198,103,50,68,62,98,118,60,29,41,37,91,80,43,21,66,89,154,157,72,19,39,52,81,96,41,12,27,37,73,61,31,7,697,370,327,619,361,258,65,133,186,162,101,44,30,60,91,111,60,13,35,73,95,51,41,31,62,122,173,153,89,13,37,57,98,105,56,4,25,65,75,48,33,9,584,282,302,420,211,209,105,76,128,127,99,44,43,36,77,58,53,13,62,40,51,69,46,31,58,70,101,90,87,12,23,35,51,46,48,7,35,35,50,44,39,5,272,140,132,207,108,99,41,16,62,57,65,23,23,4,32,35,30,10,18,12,30,22,35,13,44,22,41,36,45,15,25,10,20,18,23,10,19,12,21,18,22,5,341,190,151,179,111,68,44,38,102,53,64,25,31,28,49,22,43,9,13,10,53,31,21,16,30,28,54,31,28,4,21,24,30,15,16,3,9,4,24,16,12,1,318,147,171,184,93,91,55,45,57,93,24,40,22,25,24,45,15,15,33,20,33,48,9,25,23,36,52,42,16,11,9,14,28,22,12,6,14,22,24,20,4,5,79,36,43,42,15,27,15,21,31,-5,5,13,16,1,12,-5,5,6,-1,20,19,0,0,7,8,20,1,0,11,-1,8,7,-4,-7,8,0,0,13,5,7,3,-1,18,12,6,66,32,34,-30,-18,44,-15,30,8,-21,7,25,-8,6,5,-9,-25,19,-7,24,3,5,7,21,8,22,2,4,4,11,4,10,-1,1,3,10,4,12,3,125,85,40,124,61,63,-9,10,16,11,37,51,1,7,21,-2,23,31,-10,3,-5,13,14,20,16,16,24,19,33,13,6,6,11,12,13,11,10,10,13,7,20,2,137,64,73,98,49,49,29,-8,24,-12,68,32,13,-3,-3,-1,42,14,16,-5,27,-11,26,18,9,18,13,10,30,16,1,7,5,5,19,11,8,11,8,5,11,5,216,120,96,130,76,54,27,19,41,26,48,55,12,13,39,7,29,22,15,6,2,19,19,33,22,15,24,15,35,17,11,13,22,5,18,7,11,2,2,10,17,10,-10,-1,-9,-69,-48,-21,8,1,-18,1,-26,11,20,-1,-9,-1,-23,6,-12,2,-9,2,-3,5,0,5,-7,-27,-32,-10,6,4,-4,-22,-29,-4,-6,1,-3,-5,-3,-6
21,21011,Beas,4165,-7,-10,3,2,1,1,-3,7,-4,-1,-8,1,-5,4,-4,-2,-4,1,2,3,0,1,-4,0,0,0,1,1,0,0,0,0,0,1,0,0,0,0,1,0,0,0,-9,-5,-4,2,1,1,-8,1,0,-2,0,1,-7,3,3,1,-2,-2,-1,-2,-3,-3,2,3,0,1,0,0,0,1,0,1,0,0,0,0,0,0,0,0,0,1,32,27,5,26,19,7,4,2,9,8,4,6,3,8,5,7,4,1,1,-6,4,1,0,5,6,5,5,8,1,0,5,6,3,5,0,0,1,-1,2,3,1,0,104,56,48,28,15,13,14,31,18,21,8,11,6,14,16,11,5,4,8,17,2,10,3,7,8,5,10,5,0,0,2,3,6,4,0,0,6,2,4,1,0,0,42,10,32,12,2,10,11,0,14,3,15,-1,1,0,6,0,3,0,10,0,8,3,12,-1,0,1,4,3,3,1,0,0,0,0,1,1,0,1,4,3,2,0,94,54,40,28,12,16,17,15,38,9,14,-2,10,10,19,9,7,-1,7,5,19,0,7,-1,7,7,8,1,4,1,4,3,4,0,0,1,3,4,4,1,4,0,57,17,40,35,16,19,7,21,3,4,12,8,0,12,-6,0,5,4,7,9,9,4,7,4,10,11,7,3,2,2,5,7,1,1,1,1,5,4,6,2,1,1,75,37,38,51,24,27,-5,30,12,15,10,9,-2,9,4,12,7,5,-3,21,8,3,3,4,11,17,18,2,2,1,6,7,9,1,0,1,5,10,9,1,2,0,-2,12,-14,22,12,10,-7,8,-32,12,5,12,0,8,-15,8,2,7,-7,0,-17,4,3,5,7,7,5,1,2,0,5,4,1,1,1,0,2,3,4,0,1,0,56,30,26,15,4,11,4,9,6,18,7,12,3,6,8,7,6,2,1,3,-2,11,1,10,1,5,2,6,1,0,0,2,1,1,0,0,1,3,1,5,1,0,23,-2,25,9,3,6,12,29,-12,-8,7,-7,2,15,-9,-7,0,-5,10,14,-3,-1,7,-2,5,4,-4,3,1,0,3,1,-3,2,0,0,2,3,-1,1,1,0,-6,6,-12,12,8,4,6,-6,-19,16,-7,4,7,2,-9,6,-3,3,-1,-8,-10,10,-4,1,8,1,-2,4,1,0,7,1,-2,1,1,0,1,0,0,3,0,0,-16,-5,-11,6,6,0,-10,0,-21,11,2,2,-4,0,-7,3,3,-1,-6,0,-14,8,-1,3,6,-1,2,-2,1,0,5,0,2,-1,0,0,1,-1,0,-1,1,0,-101,-45,-56,-1,0,-1,-15,-24,-31,-18,-8,-4,-6,-6,-18,-11,-3,-1,-9,-18,-13,-7,-5,-3,0,2,-2,2,-2,-1,0,2,-1,1,-1,-1,0,0,-1,1,-1,0,48,21,27,17,8,9,4,2,18,10,2,10,1,2,5,7,0,4,3,0,13,3,2,6,4,1,4,5,1,2,3,1,2,1,0,1,1,0,2,4,1,1,-26,-6,-20,0,-2,2,-7,-10,-10,-1,-2,5,-3,-6,1,3,-1,1,-4,-4,-11,-4,-1,4,0,-2,1,-1,2,0,0,-2,1,-1,0,0,0,0,0,0,2,0,6,-9,15,21,11,10,1,-3,-7,15,2,-2,-2,-4,-6,8,-1,-3,3,1,-1,7,3,1,3,4,5,6,1,2,2,3,3,2,0,1,1,1,2,4,1,1,21,9,12,6,3,3,13,-6,-5,2,9,8,3,-1,-3,-1,8,4,10,-5,-2,3,1,4,0,-1,4,1,2,0,0,0,0,1,2,0,0,-1,4,0,0,0
21,21013,Bollullos Par del Condado,12727,-4,8,-12,13,10,3,-7,1,-3,7,7,-9,-7,4,5,6,5,-5,0,-3,-8,1,2,-4,0,6,5,0,2,0,0,5,4,0,1,0,0,1,1,0,1,0,88,37,51,46,31,15,19,20,19,6,18,4,8,4,11,3,8,1,11,16,8,3,10,3,9,9,13,9,4,0,6,6,10,6,1,0,3,3,3,3,3,0,0,3,-3,12,8,4,-1,-4,-6,-3,5,6,0,-1,1,-6,3,4,-1,-3,-7,3,2,2,3,1,5,3,0,0,2,0,5,1,0,0,1,1,0,2,0,0,11,1,10,23,14,9,-5,1,19,-4,-1,1,-3,3,5,0,-2,-1,-2,-2,14,-4,1,2,2,4,11,2,3,1,2,2,6,1,2,1,0,2,5,1,1,0,123,79,44,133,77,56,23,32,38,27,1,3,14,17,30,16,0,1,9,15,8,11,1,2,22,33,52,22,3,1,13,19,31,11,3,0,9,14,21,11,0,1,114,63,51,96,45,51,32,2,45,21,11,2,20,3,22,9,6,2,12,-1,23,12,5,0,18,18,35,16,7,0,7,7,22,6,3,0,11,11,13,10,4,0,193,94,99,155,76,79,59,56,38,32,2,3,37,25,17,14,-2,0,22,31,21,18,4,3,37,50,45,20,0,0,22,26,21,6,-1,0,15,24,24,14,1,0,128,62,66,126,50,76,28,56,36,11,-3,-5,10,25,23,-4,3,1,18,31,13,15,-6,-6,21,51,35,13,3,1,12,23,9,-1,3,2,9,28,26,14,0,-1,-36,7,-43,5,5,0,-5,-16,-18,6,-2,-1,0,-4,2,6,1,0,-5,-12,-20,0,-3,-1,-1,9,1,-5,1,-1,0,5,3,-2,0,-1,-1,4,-2,-3,1,0,49,16,33,31,5,26,31,-2,5,15,-1,-3,13,-5,3,5,-1,-2,18,3,2,10,0,-1,25,6,-1,0,0,-1,11,0,-2,-4,-1,-1,14,6,1,4,1,0,89,53,36,45,14,31,34,12,27,21,-2,-4,22,2,19,12,2,-2,12,10,8,9,-4,-2,15,15,7,5,1,0,3,5,4,1,0,0,12,10,3,4,1,0,103,45,58,34,18,16,28,25,33,1,9,5,18,10,13,0,3,0,10,15,20,1,6,5,11,12,4,2,3,2,11,1,1,2,3,0,0,11,3,0,0,2,187,85,102,89,40,49,50,33,43,43,23,-2,20,12,22,15,15,3,30,21,21,28,8,-5,28,16,23,21,2,0,14,8,7,9,2,0,14,8,16,12,0,0,35,29,6,51,21,30,7,7,-5,10,10,3,9,9,-6,8,7,-1,-2,-2,1,2,3,4,14,14,7,10,5,0,8,6,1,3,2,0,6,8,6,7,3,0,7,8,-1,26,16,10,1,0,12,-6,5,-8,2,-1,10,-8,3,-1,-1,1,2,2,2,-7,7,11,6,-1,2,0,3,4,6,0,2,0,4,7,0,-1,0,0,-10,-21,11,67,24,43,-9,-3,-1,7,1,-4,-7,-8,-5,-2,2,0,-2,5,4,9,-1,-4,21,10,15,12,6,1,9,4,5,3,2,1,12,6,10,9,4,0,31,23,8,63,31,32,3,14,-5,20,1,-5,0,13,5,10,-2,-5,3,1,-10,10,3,0,10,15,16,16,5,0,5,11,6,6,3,0,5,4,10,10,2,0,53,14,39,96,33,63,4,2,22,25,1,1,-1,5,2,6,3,-1,5,-3,20,19,-2,2,9,24,29,28,6,-1,6,12,7,5,3,-1,3,12,22,23,3,0
21,21014,Bonares,5063,98,68,30,78,53,25,6,26,40,13,10,1,0,16,37,6,8,0,6,10,3,7,2,1,10,21,27,15,3,0,7,12,22,10,2,0,3,9,5,5,1,0,2,11,-9,25,19,6,3,1,-8,2,3,1,3,0,3,2,2,1,0,1,-11,0,1,0,4,9,5,4,3,0,4,6,5,2,2,0,0,3,0,2,1,0,24,3,21,37,20,17,7,4,0,6,6,2,5,-1,-6,1,2,2,2,5,6,5,4,0,5,13,7,7,3,2,4,6,3,4,2,1,1,7,4,3,1,1,16,5,11,46,24,22,7,2,2,3,4,-1,1,-1,4,-1,3,-1,6,3,-2,4,1,0,9,10,12,11,3,1,4,4,9,5,2,0,5,6,3,6,1,1,6,13,-7,57,35,22,3,8,-4,-5,1,2,-4,14,3,-4,3,1,7,-6,-7,-1,-2,1,10,14,17,10,4,1,3,10,11,7,3,1,7,4,6,3,1,0,173,107,66,126,72,54,6,41,94,20,12,2,7,26,58,5,9,2,-1,15,36,15,3,0,6,32,67,17,4,0,4,18,39,9,2,0,2,14,28,8,2,0,131,53,78,126,42,84,26,20,39,37,11,-2,11,5,19,17,2,-1,15,15,20,20,9,-1,17,19,45,32,12,1,6,4,17,11,4,0,11,15,28,21,8,1,160,54,106,203,78,125,10,41,71,46,0,-6,17,15,20,9,-4,-1,-7,26,51,37,4,-5,12,49,87,52,3,-1,9,24,30,13,2,0,3,25,57,39,1,-1,265,161,104,208,114,94,27,55,106,60,12,4,14,33,69,32,10,2,13,22,37,28,2,2,18,42,89,45,9,4,11,25,50,19,6,2,7,17,39,26,3,2,169,72,97,165,75,90,8,34,62,55,7,0,2,17,37,13,2,-1,6,17,25,42,5,1,8,35,67,49,3,0,3,19,38,12,0,0,5,16,29,37,3,0,49,21,28,107,45,62,3,34,-1,10,1,0,-4,22,1,-2,3,0,7,12,-2,12,-2,0,8,36,26,25,5,4,1,22,10,7,2,2,7,14,16,18,3,2,27,-3,30,63,20,43,5,12,-1,15,2,-6,1,5,-4,-6,3,-3,4,7,3,21,-1,-3,6,5,31,21,-1,0,3,2,11,4,-1,0,3,3,20,17,0,0,43,-3,46,83,26,57,-6,10,9,35,-2,-5,-4,3,-7,8,-2,-2,-2,7,16,27,0,-3,3,20,27,32,1,0,2,12,6,5,1,0,1,8,21,27,0,0,22,-9,31,78,29,49,-8,9,8,13,-1,-2,-10,2,-1,-3,2,0,2,7,9,16,-3,-2,11,12,22,28,2,2,3,7,7,8,2,1,8,5,15,20,0,1,71,13,58,113,25,88,11,4,19,46,-9,-1,4,6,8,2,-7,0,7,-2,11,44,-2,-1,8,13,39,51,1,0,2,7,11,7,-2,0,6,6,28,44,3,0,-98,-58,-40,-12,-18,6,-9,-5,-45,-32,-4,-5,-9,4,-27,-16,-5,-4,0,-9,-18,-16,1,-1,5,12,-16,-18,5,0,2,5,-12,-14,1,0,3,7,-4,-4,4,0,-4,-18,14,20,-1,21,13,3,-6,-14,-5,-2,7,-3,-5,-13,-7,0,6,6,-1,-1,2,-2,9,8,-4,3,2,0,6,7,-7,-7,0,0,3,1,3,10,2,0,13,15,-2,49,23,26,2,4,-21,12,2,0,4,1,-9,8,3,2,-2,3,-12,4,-1,-2,9,9,7,17,1,2,5,3,0,10,1,2,4,6,7,7,0,0
21,21025,Cortegana,5132,23,13,10,3,2,1,10,-2,9,9,-1,-3,2,3,3,4,1,-1,8,-5,6,5,-2,-2,0,0,1,2,0,0,0,0,1,1,0,0,0,0,0,1,0,0,-4,-3,-1,3,1,2,0,-4,7,-7,-3,2,1,-5,1,-4,1,2,-1,1,6,-3,-4,0,0,0,1,1,1,0,0,0,0,0,1,0,0,0,1,1,0,0,26,10,16,6,2,4,2,8,6,-4,6,4,1,4,1,-5,5,1,1,4,5,1,1,3,0,2,0,1,2,1,0,0,0,1,1,0,0,2,0,0,1,1,-3,5,-8,6,5,1,5,-3,-1,-7,3,-3,4,-3,5,-2,2,-1,1,0,-6,-5,1,-2,2,2,1,1,0,0,2,1,1,1,0,0,0,1,0,0,0,0,-48,-14,-34,6,3,3,-11,-9,-15,0,-9,-6,-4,0,-8,4,-5,-2,-7,-9,-7,-4,-4,-4,2,0,3,0,0,1,2,0,1,0,0,0,0,0,2,0,0,1,93,38,55,15,6,9,12,5,25,14,14,19,3,-1,14,3,9,8,9,6,11,11,5,11,2,1,6,3,1,2,0,1,2,1,1,1,2,0,4,2,0,1,-24,-12,-12,8,2,6,-9,-7,2,-1,1,-11,0,-9,2,0,0,-4,-9,2,0,-1,1,-7,0,-1,4,3,2,0,0,-1,2,0,1,0,0,0,2,3,1,0,57,39,18,26,17,9,19,10,23,11,0,-10,15,8,7,5,0,1,4,2,16,6,0,-11,2,8,9,5,2,0,0,6,5,4,2,0,2,2,4,1,0,0,-16,0,-16,6,-1,7,-13,3,-13,2,9,-4,-6,6,-2,3,4,-3,-7,-3,-11,-1,5,-1,-3,3,4,2,0,0,-3,0,2,0,0,0,0,3,2,2,0,0,-4,-1,-3,10,6,4,5,2,-3,3,-7,-3,3,2,-11,6,-4,3,2,0,8,-3,-3,-6,2,3,4,1,0,0,2,1,2,1,0,0,0,2,2,0,0,0,-26,-21,-5,19,7,12,-9,-1,-11,-9,4,-7,-10,-1,-2,-13,1,-1,1,0,-9,4,3,-6,4,3,3,5,2,0,2,2,1,-1,1,0,2,1,2,6,1,0,44,32,12,8,4,4,10,-4,17,12,2,7,11,6,10,4,1,0,-1,-10,7,8,1,7,0,4,1,3,0,0,2,2,0,1,-1,0,-2,2,1,2,1,0,12,10,2,2,1,1,-17,0,1,7,18,2,-9,-4,3,10,8,0,-8,4,-2,-3,10,2,0,1,0,1,-1,0,0,1,0,0,0,0,0,0,0,1,-1,0,170,110,60,2,0,2,18,30,45,47,15,14,2,18,35,34,15,6,16,12,10,13,0,8,-1,2,-2,-1,3,0,-1,0,0,-2,2,0,0,2,-2,1,1,0,-45,-3,-42,-5,-2,-3,-12,-8,1,-12,-4,-10,-5,1,8,-3,-1,-3,-7,-9,-7,-9,-3,-7,-2,-1,-2,0,0,0,-1,-1,-1,1,0,0,-1,0,-1,-1,0,0,-46,-48,2,2,0,2,-12,0,-22,-18,7,-2,-15,-1,-15,-16,0,-2,3,1,-7,-2,7,0,5,0,-4,1,0,0,1,0,-2,1,0,0,4,0,-2,0,0,0,-13,-3,-10,0,-2,2,1,-6,-8,-2,2,1,2,2,-4,-6,2,1,-1,-8,-4,4,0,0,1,-1,0,0,0,0,0,0,-1,-1,0,0,1,-1,1,1,0,0,-51,-23,-28,4,4,0,-2,-10,-20,-14,-6,-1,0,-4,-12,-9,-2,4,-2,-6,-8,-5,-4,-5,2,1,0,1,1,-1,2,1,0,1,0,0,0,0,0,0,1,-1
21,21040,Hinojos,3548,-9,-3,-6,8,4,4,7,-2,-3,-8,3,-5,4,1,-3,-5,3,-2,3,-3,0,-3,0,-3,2,0,1,3,2,0,1,0,0,2,1,0,1,0,1,1,1,0,34,20,14,6,4,2,5,7,9,3,5,3,4,7,1,1,4,2,1,0,8,2,1,1,2,2,1,0,1,0,1,2,0,0,1,0,1,0,1,0,0,0,12,11,1,15,6,9,-2,4,-6,6,6,4,4,3,-1,0,3,2,-6,1,-5,6,3,2,8,2,3,1,1,0,4,0,2,0,0,0,4,2,1,1,1,0,75,47,28,14,6,8,4,19,13,11,20,6,4,12,13,4,10,2,0,7,0,7,10,4,3,5,2,2,2,0,1,3,1,1,0,0,2,2,1,1,2,0,49,22,27,31,15,16,15,15,-7,13,13,-3,4,10,-7,11,4,-2,11,5,0,2,9,-1,9,4,8,9,1,0,5,4,2,4,0,0,4,0,6,5,1,0,90,57,33,80,43,37,12,29,30,16,1,3,13,23,17,4,2,-1,-1,6,13,12,-1,4,12,26,26,15,-1,1,8,15,13,7,-1,0,4,11,13,8,0,1,26,9,17,29,13,16,0,7,4,0,7,5,-3,0,3,0,4,4,3,7,1,0,3,1,1,7,11,5,2,1,0,3,5,3,0,1,1,4,6,2,2,0,15,-8,23,-9,-6,-3,7,-11,-5,5,12,4,0,-9,-12,1,6,3,7,-2,7,4,6,1,0,0,-9,-1,1,0,1,0,-7,-1,1,0,-1,0,-2,0,0,0,29,22,7,40,22,18,6,7,1,7,9,-4,1,3,8,6,3,0,5,4,-7,1,6,-4,1,11,11,7,9,0,1,5,8,4,4,0,0,6,3,3,5,0,0,-2,2,-12,-4,-8,-2,6,-17,4,0,5,-2,2,-9,2,1,0,0,4,-8,2,-1,5,1,3,-11,-3,-2,0,1,0,-6,1,0,0,0,3,-5,-4,-2,0,-7,-5,-2,8,1,7,-9,-8,-5,2,3,9,-3,0,-8,-1,2,3,-6,-8,3,3,1,6,3,1,4,2,-2,0,0,0,0,2,-1,0,3,1,4,0,-1,0,7,-13,20,0,-5,5,-13,-3,11,1,10,0,-8,-7,-2,-2,5,-1,-5,4,13,3,5,1,0,0,1,-1,1,-1,0,-1,0,-3,-1,0,0,1,1,2,2,-1,2,8,-6,10,5,5,-2,1,-4,5,-1,4,1,1,-1,4,0,3,-3,0,-3,1,-1,1,4,1,1,3,0,1,2,0,1,2,0,0,2,1,0,1,0,1,10,1,9,-1,0,-1,1,9,-5,1,2,0,-1,2,-2,2,0,-1,2,7,-3,-1,2,1,0,1,1,-2,0,-1,1,0,0,-1,0,0,-1,1,1,-1,0,-1,-24,-8,-16,-8,-6,-2,-9,-2,-11,-7,1,5,-5,-1,-4,-3,3,2,-4,-1,-7,-4,-2,3,0,-3,-3,-1,-1,0,0,-2,-1,-1,-1,-1,0,-1,-2,0,0,1,31,21,10,6,4,2,1,2,0,12,9,8,3,2,0,8,5,4,-2,0,0,4,4,4,2,3,0,1,0,0,2,1,0,1,0,0,0,2,0,0,0,0,5,-1,6,8,3,5,0,-2,-5,-8,6,14,4,-3,-6,-4,2,5,-4,1,1,-4,4,9,6,-1,5,-4,2,-1,3,-2,2,-1,1,-1,3,1,3,-3,1,0,41,9,32,20,7,13,19,1,-13,14,10,12,10,-2,-10,3,3,6,9,3,-3,11,7,6,5,2,2,7,4,0,1,2,1,2,1,0,4,0,1,5,3,0
21,21041,Huelva,140583,-1078,-622,-456,109,74,35,-111,-323,-312,-184,-103,-21,-87,-154,-184,-101,-69,-4,-24,-169,-128,-83,-34,-17,13,24,40,28,2,2,9,17,26,20,1,1,4,7,14,8,1,1,-1363,-786,-577,21,11,10,-144,-345,-382,-306,-125,-56,-104,-210,-201,-177,-79,-14,-40,-135,-181,-129,-46,-42,0,5,5,4,5,2,0,1,3,2,3,2,0,4,2,2,2,0,-1291,-691,-600,-66,-27,-39,-80,-329,-487,-163,-159,-58,-42,-184,-269,-81,-93,-21,-38,-145,-218,-82,-66,-37,0,-27,-28,-5,-1,-5,0,-10,-11,-4,-1,-1,0,-17,-17,-1,0,-4,-1246,-689,-557,16,4,12,-75,-352,-434,-168,-130,-44,-53,-166,-265,-116,-62,-7,-22,-186,-169,-52,-68,-37,2,3,0,4,4,3,-1,1,0,1,1,2,3,2,0,3,3,1,300,239,61,1032,612,420,25,206,125,-14,-121,89,13,153,94,-18,-64,66,12,53,31,4,-57,23,115,330,387,143,40,12,63,193,246,83,18,6,52,137,141,60,22,6,493,274,219,1244,725,519,17,246,281,68,-37,-49,-40,131,209,32,-24,-16,57,115,72,36,-13,-33,114,361,519,210,32,4,49,206,333,117,14,4,65,155,186,93,18,0,-206,-117,-89,1012,533,479,0,77,-68,-97,-40,-44,35,32,-46,-78,-26,-20,-35,45,-22,-19,-14,-24,147,292,346,168,48,3,89,147,189,82,19,3,58,145,157,86,29,0,-313,-186,-127,993,496,497,22,71,-215,-41,-78,-71,36,32,-125,-69,-47,-10,-14,39,-90,28,-31,-61,199,366,268,135,21,-6,132,174,140,40,7,-2,67,192,128,95,14,-4,-539,-436,-103,73,-128,201,96,-126,-243,-154,-61,-46,29,-102,-203,-125,-31,-2,67,-24,-40,-29,-30,-44,87,81,-29,-67,-5,-1,49,11,-94,-82,-13,-1,38,70,65,15,8,0,-268,-113,-155,502,256,246,53,-20,-46,-79,-112,-50,58,6,11,-60,-91,-14,-5,-26,-57,-19,-21,-36,106,133,170,64,22,0,59,69,93,22,11,-2,47,64,77,42,11,2,-908,-486,-422,242,97,145,-153,-84,-368,-193,-43,-50,-47,-39,-273,-110,-18,-2,-106,-45,-95,-83,-25,-48,61,100,14,35,18,4,43,57,-7,-6,3,2,18,43,21,41,15,2,-564,-489,-75,150,-3,153,-13,-108,-320,-84,-26,-18,-20,-78,-250,-128,-22,5,7,-30,-70,44,-4,-23,62,82,-25,13,7,-2,32,36,-49,-20,-8,1,30,46,24,33,15,-3,-376,-187,-189,147,63,84,-44,-21,-104,-112,-53,-41,-34,2,-65,-47,-22,-19,-10,-23,-39,-65,-31,-22,15,79,24,2,20,5,6,50,-11,2,10,5,9,29,35,0,10,0,-562,-479,-83,-99,-77,-22,23,-126,-241,-152,-53,-21,-38,-64,-199,-132,-38,-11,61,-62,-42,-20,-15,-10,16,-14,-75,-22,-6,0,0,-6,-46,-19,-4,-3,16,-8,-29,-3,-2,3,-743,-413,-330,-117,-72,-45,-30,-116,-208,-193,-112,-88,-2,-66,-140,-115,-64,-27,-28,-50,-68,-78,-48,-61,8,-1,-56,-51,-14,-4,13,-8,-31,-39,-7,-1,-5,7,-25,-12,-7,-3,-569,-285,-284,-10,-24,14,-104,-37,-173,-128,-56,-85,-66,-17,-74,-70,-34,-30,-38,-20,-99,-58,-22,-55,8,13,-3,-31,-13,6,0,2,-8,-21,-4,3,8,11,5,-10,-9,3,11,19,-8,157,90,67,27,13,-47,18,32,-45,15,-9,4,-19,32,-20,12,22,-51,37,0,-25,22,84,17,13,3,9,18,55,7,0,-1,3,4,29,10,13,4,6,-333,-242,-91,77,3,74,11,-21,-246,-30,-4,-61,17,-27,-200,-23,-3,-18,-6,6,-46,-7,-1,-43,14,63,-3,-19,6,8,13,30,-19,-20,-6,1,1,33,16,1,12,7
21,21042,Isla Cristina,18070,194,105,89,65,37,28,23,45,76,24,18,3,7,24,44,19,5,0,16,21,32,5,13,3,13,17,20,8,7,0,5,10,13,5,4,0,8,7,7,3,3,0,111,54,57,89,48,41,13,33,7,20,38,-1,-5,21,6,12,22,-1,18,12,1,8,16,0,16,24,22,15,10,1,3,14,15,8,7,1,13,10,7,7,3,0,216,87,129,119,54,65,43,46,49,29,37,-1,22,12,17,14,17,1,21,34,32,15,20,-2,26,35,23,14,12,5,14,16,11,5,5,2,12,19,12,9,7,3,160,107,53,119,66,53,12,44,30,41,30,2,7,39,12,30,18,1,5,5,18,11,12,1,18,38,30,24,7,2,12,22,14,13,5,0,6,16,16,11,2,2,234,132,102,180,95,85,23,69,47,55,43,-11,3,41,32,32,26,-3,20,28,15,23,17,-8,21,51,62,31,10,3,8,29,37,14,6,1,13,22,25,17,4,2,187,144,43,217,134,83,5,31,94,46,14,-5,-4,30,75,35,12,-3,9,1,19,11,2,-2,25,46,69,51,19,7,12,29,43,32,14,4,13,17,26,19,5,3,283,154,129,336,180,156,34,87,78,66,22,-2,19,40,46,30,17,3,15,47,32,36,5,-5,31,89,105,73,29,8,16,46,60,36,19,2,15,43,45,37,10,6,319,102,217,453,192,261,-1,110,88,84,28,7,-5,43,18,22,9,10,4,67,70,62,19,-3,33,139,142,96,27,12,14,69,50,35,15,7,19,70,92,61,12,5,153,69,84,251,119,132,1,47,56,35,21,-8,-2,21,31,8,11,-2,3,26,25,27,10,-6,26,58,87,60,16,5,14,25,45,24,9,2,12,33,42,36,7,3,320,137,183,187,59,128,47,52,113,86,14,-4,20,18,54,22,15,4,27,34,59,64,-1,-8,30,42,53,47,11,1,16,18,12,6,7,0,14,24,41,41,4,1,178,14,164,266,78,188,22,24,13,84,21,12,-4,3,-1,2,6,8,26,21,14,82,15,4,35,39,75,98,7,11,21,17,25,9,1,5,14,22,50,89,6,6,5,-34,39,147,35,112,-33,-9,-2,36,-1,10,-10,-16,-11,-6,0,4,-23,7,9,42,-1,6,10,17,38,65,16,0,1,5,15,8,5,0,9,12,23,57,11,0,-25,-16,-9,56,-4,60,-18,-14,-55,34,22,-4,-8,-3,-22,-7,18,2,-10,-11,-33,41,4,-6,9,6,7,31,0,0,1,-1,-1,-6,1,1,8,7,8,37,-1,-1,-87,-55,-32,38,13,25,-13,-5,-41,-14,-14,-5,3,-9,-29,-7,-8,-4,-16,4,-12,-7,-6,-1,5,8,1,23,-3,3,4,2,-4,9,0,2,1,6,5,14,-3,1,-144,-73,-71,33,11,22,-35,1,-49,-37,-12,-18,-22,4,-31,-16,-3,-7,-13,-3,-18,-21,-9,-11,9,7,11,3,2,1,4,5,3,-2,1,0,5,2,8,5,1,1,36,17,19,48,27,21,26,-2,16,5,4,-19,29,-7,1,-13,10,-9,-3,5,15,18,-6,-10,0,13,13,11,10,-2,3,6,6,5,6,-2,-3,7,7,6,4,0,46,22,24,54,18,36,5,-16,23,14,18,-6,3,-1,7,-7,19,-5,2,-15,16,21,-1,-1,1,12,23,12,5,-1,0,8,7,1,2,-1,1,4,16,11,3,0,-24,-14,-10,122,48,74,-37,24,-10,-24,14,16,-25,16,5,-26,7,11,-12,8,-15,2,7,5,16,24,32,39,7,1,8,12,15,5,6,-1,8,12,17,34,1,2
21,21043,Jabugo,2591,-11,-6,-5,3,2,1,-7,0,-3,-1,2,-4,-4,-4,2,-1,1,-2,-3,4,-5,0,1,-2,0,1,1,0,1,0,0,0,1,0,1,0,0,1,0,0,0,0,10,3,7,2,1,1,7,-2,3,5,0,-3,2,-2,1,1,1,0,5,0,2,4,-1,-3,0,0,1,1,0,0,0,0,1,0,0,0,0,0,0,1,0,0,-21,-4,-17,5,4,1,-2,-6,-12,-3,4,0,-1,2,-4,-3,3,1,-1,-8,-8,0,1,-1,0,1,2,2,0,0,0,1,2,1,0,0,0,0,0,1,0,0,-2,-2,0,10,6,4,5,1,-7,0,1,-2,0,0,-6,4,1,0,5,1,-1,-4,0,-2,0,2,6,1,0,0,0,2,3,1,0,0,0,0,3,0,0,0,-35,-20,-15,4,1,3,-11,3,-10,-9,-1,-7,-7,2,-6,-4,-1,-5,-4,1,-4,-5,0,-2,1,0,1,2,0,0,0,0,0,1,0,0,1,0,1,1,0,0,-15,-9,-6,3,1,2,-5,2,-19,8,3,-3,-4,-1,-11,7,1,0,-1,3,-8,1,2,-3,0,1,-1,3,0,0,-1,1,0,1,0,0,1,0,-1,2,0,0,-27,-13,-14,6,3,3,-7,-13,-7,-5,2,3,-5,-3,-2,-5,1,1,-2,-10,-5,0,1,2,0,3,1,2,0,0,0,2,0,1,0,0,0,1,1,1,0,0,-23,-9,-14,11,5,6,-5,-3,-1,-9,3,-7,-3,2,0,-7,2,-2,-2,-5,-1,-2,1,-5,0,3,5,2,1,0,0,1,3,1,0,0,0,2,2,1,1,0,18,15,3,12,3,9,3,7,2,0,0,4,3,1,5,1,0,4,0,6,-3,-1,0,0,1,5,3,2,0,1,0,2,1,0,0,0,1,3,2,2,0,1,-12,-5,-7,1,1,0,0,-7,-4,-1,-1,1,1,-6,3,-1,-1,-1,-1,-1,-7,0,0,2,0,1,1,-1,0,0,1,0,0,0,0,0,-1,1,1,-1,0,0,-7,-10,3,7,0,7,8,-8,-5,0,0,-4,0,0,-9,-1,1,-2,8,-8,4,1,-1,-2,4,-1,5,0,0,-1,1,-1,0,0,0,0,3,0,5,0,0,-1,-19,-8,-11,1,3,-2,-10,-5,-3,4,-2,-2,-4,-2,-7,7,0,-2,-6,-3,4,-3,-2,0,-2,1,2,-1,0,1,1,1,1,0,0,0,-3,0,1,-1,0,1,-5,5,-10,-1,0,-1,0,-2,1,2,-4,-1,3,-1,2,2,1,-1,-3,-1,-1,0,-5,0,0,-1,0,0,0,0,0,0,0,0,0,0,0,-1,0,0,0,0,6,5,1,6,3,3,10,7,-11,-1,4,-4,6,6,-5,-4,3,-2,4,1,-6,3,1,-2,2,3,-1,1,0,0,0,2,0,0,0,0,2,1,-1,1,0,0,-14,-8,-6,-4,-4,0,-6,-5,9,-4,-8,-2,-3,-5,6,-2,-4,-1,-3,0,3,-2,-4,-1,-1,-3,0,-1,0,1,-1,-2,0,-1,0,0,0,-1,0,0,0,1,-10,-9,-1,-6,-4,-2,-5,3,-10,4,1,-4,-2,3,-9,2,-2,-3,-3,0,-1,2,3,-1,0,-2,-2,-1,-1,0,0,-1,-2,0,-1,0,0,-1,0,-1,0,0,6,-2,8,-1,0,-1,6,-2,-4,6,-3,1,2,-2,-6,5,-2,1,4,0,2,1,-1,0,0,0,1,0,-2,0,0,0,0,0,0,0,0,0,1,0,-2,0,-6,5,-11,7,5,2,4,2,-6,-1,-3,-2,6,1,0,-2,0,0,-2,1,-6,1,-3,-2,5,0,-1,1,2,0,4,0,0,0,1,0,1,0,-1,1,1,0
21,21044,Lepe,18995,412,275,137,262,194,68,57,110,143,55,32,7,33,63,110,38,20,5,24,47,33,17,12,2,15,69,113,40,18,3,7,51,90,32,10,1,8,18,23,8,8,2,437,265,172,269,162,107,53,117,152,67,39,4,34,69,97,32,27,3,19,48,55,35,12,1,45,68,91,46,14,3,23,47,60,20,8,3,22,21,31,26,6,0,497,229,268,369,211,158,95,117,133,103,31,19,51,63,50,48,7,9,44,54,83,55,24,10,49,88,119,80,19,11,30,51,73,41,10,5,19,37,46,39,9,6,398,210,188,301,185,116,53,107,155,59,8,13,25,42,100,34,5,4,28,65,55,25,3,9,47,92,108,39,11,2,31,54,68,24,7,1,16,38,40,15,4,1,522,286,236,428,256,172,79,114,178,107,39,1,40,63,104,62,17,0,39,51,74,45,22,1,66,102,149,76,24,8,34,65,93,45,14,5,32,37,56,31,10,3,880,573,307,542,330,212,72,238,374,123,43,22,48,157,253,79,22,10,24,81,121,44,21,12,57,154,212,87,26,4,35,99,128,49,15,3,22,55,84,38,11,1,320,173,147,501,283,218,73,116,60,79,5,-8,35,65,39,33,7,-3,38,51,21,46,-2,-5,95,149,125,109,16,6,56,78,78,57,9,4,39,71,47,52,7,2,1211,566,645,1288,563,725,92,339,390,330,59,1,62,191,157,125,34,-1,30,148,233,205,25,2,99,343,449,332,47,16,55,182,187,105,24,9,44,161,262,227,23,7,471,293,178,489,282,207,55,181,103,90,12,29,25,114,77,55,0,18,30,67,26,35,12,11,76,152,133,77,18,29,38,96,86,38,8,14,38,56,47,39,10,15,392,218,174,251,128,123,49,138,124,38,12,21,25,97,88,1,-1,6,24,41,36,37,13,15,41,96,58,40,6,6,25,67,21,9,0,3,16,29,37,31,6,3,99,7,92,260,76,184,3,71,58,-16,-12,-2,-3,33,14,-43,-1,3,6,38,44,27,-11,-5,30,87,76,48,14,1,16,40,11,-3,9,0,14,47,65,51,5,1,-75,-51,-24,102,32,70,-27,16,-3,-52,1,-9,-10,7,-11,-35,2,-6,-17,9,8,-17,-1,-3,14,46,46,-9,6,-3,4,26,17,-19,4,-2,10,20,29,10,2,-1,90,151,-61,53,42,11,22,8,61,6,-12,8,21,21,102,11,-8,4,1,-13,-41,-5,-4,4,10,27,17,1,-9,5,11,20,14,2,-10,5,-1,7,3,-1,1,0,8,18,-10,-35,-17,-18,18,16,-22,-24,17,6,7,7,3,-10,10,2,11,9,-25,-14,7,4,4,8,-23,-25,1,-1,4,0,-1,-23,3,0,0,8,-22,-2,-2,-1,510,64,446,317,-43,360,13,127,138,243,17,-21,15,35,17,17,-10,-8,-2,92,121,226,27,-13,-12,91,71,173,4,-14,-1,27,-30,-18,-14,-8,-11,64,101,191,18,-6,-169,-9,-160,37,51,-14,-32,7,-60,-50,-28,-10,-15,7,7,1,-8,-4,-17,0,-67,-51,-20,-6,19,45,-11,-3,-12,-2,13,18,14,14,-6,-4,6,27,-25,-17,-6,2,-234,-71,-163,-158,-58,-100,-5,11,1,-145,-43,-45,14,10,31,-66,-31,-23,-19,1,-30,-79,-12,-22,9,26,-4,-103,-50,-36,13,19,11,-48,-31,-22,-4,7,-15,-55,-19,-14,-32,2,-34,74,65,9,20,38,22,-84,-18,-12,2,37,18,-41,-2,-10,18,1,4,-43,-16,-2,42,44,60,-67,-12,2,18,34,49,-33,-6,1,24,10,11,-34,-6,1
21,21054,"Palma del Condado, La",9709,28,3,25,12,6,6,9,5,18,-3,0,0,4,1,1,-1,0,0,5,4,17,-2,0,0,2,4,6,0,0,0,1,2,3,0,0,0,1,2,3,0,0,0,-20,-13,-7,9,7,2,6,2,-19,-9,-3,2,2,-2,-6,-6,-4,2,4,4,-13,-3,1,0,2,2,3,0,1,1,1,2,3,0,0,1,1,0,0,0,1,0,-68,-47,-21,18,10,8,-14,-12,-22,-16,1,-4,-12,-6,-16,-13,4,-3,-2,-6,-6,-3,-3,-1,2,5,6,3,2,0,1,1,4,3,1,0,1,4,2,0,1,0,90,61,29,22,14,8,26,4,34,9,9,4,28,6,25,-7,7,-2,-2,-2,9,16,2,6,10,2,4,5,1,0,6,2,3,3,0,0,4,0,1,2,1,0,70,52,18,45,33,12,6,17,38,1,11,-2,-1,14,29,3,10,-2,7,3,9,-2,1,0,3,14,20,6,2,0,1,8,17,5,2,0,2,6,3,1,0,0,163,82,81,85,49,36,13,33,35,32,12,36,12,10,25,18,6,9,1,23,10,14,6,27,8,27,29,17,2,0,4,14,16,11,2,0,4,13,13,6,0,0,146,70,76,56,26,30,33,23,50,21,7,6,6,8,34,16,4,1,27,15,16,5,3,5,13,8,16,14,4,1,7,2,6,8,2,1,6,6,10,6,2,0,129,50,79,62,29,33,32,14,50,4,6,18,7,3,23,3,3,8,25,11,27,1,3,10,11,14,22,11,3,1,4,5,12,6,1,1,7,9,10,5,2,0,45,24,21,24,15,9,-1,6,9,4,9,16,1,6,1,4,6,5,-2,0,8,0,3,11,5,13,4,1,1,0,4,7,2,1,1,0,1,6,2,0,0,0,30,18,12,21,12,9,3,-18,8,24,3,14,0,-9,8,11,5,6,3,-9,0,13,-2,8,7,0,9,5,0,0,3,0,6,2,1,0,4,0,3,3,-1,0,45,23,22,21,11,10,15,-1,8,19,-4,10,4,-2,11,6,-3,5,11,1,-3,13,-1,5,0,1,7,11,3,-1,1,0,2,7,2,-1,-1,1,5,4,1,0,54,17,37,31,8,23,0,14,19,15,8,-3,-5,3,7,9,5,-3,5,11,12,6,3,0,5,7,5,10,4,0,1,1,0,4,2,0,4,6,5,6,2,0,-37,-37,0,-32,-28,-4,4,3,-12,-37,-5,13,-3,8,-18,-27,-2,9,7,-5,6,-10,-3,4,-1,3,-14,-17,-4,1,-4,2,-11,-12,-3,0,3,1,-3,-5,-1,1,23,23,0,-20,-13,-7,10,16,-21,10,-3,8,7,12,1,1,-2,1,3,4,-22,9,-1,7,-5,1,-12,-6,-1,2,-3,2,-7,-6,-1,1,-2,-1,-5,0,0,1,14,2,12,-6,-4,-2,7,9,-6,-12,11,5,5,5,-9,-9,8,0,2,4,3,-3,3,5,2,4,-7,-3,-2,0,1,1,-3,-3,0,0,1,3,-4,0,-2,0,-33,-17,-16,-3,-2,-1,-11,3,-35,-13,6,11,-1,2,-25,-7,5,6,-10,1,-10,-6,1,5,-4,1,1,-3,2,0,-2,1,-3,-2,3,1,-2,0,4,-1,-1,-1,56,-7,63,34,9,25,34,5,10,9,-3,0,10,2,-12,-1,-3,-3,24,3,22,10,0,3,3,19,0,4,3,1,0,10,-3,-1,0,0,3,9,3,5,3,1,69,40,29,25,8,17,12,-5,11,26,11,11,5,-1,10,14,7,3,7,-4,1,12,4,8,6,2,4,8,4,1,1,2,3,1,1,0,5,0,1,7,3,1
21,21055,Palos de la Frontera,7060,188,120,68,148,100,48,15,58,64,34,10,8,11,28,40,30,5,4,4,30,24,4,5,4,6,51,60,26,3,0,1,32,41,21,3,0,5,19,19,5,0,0,165,144,21,202,145,57,17,51,67,44,-7,-7,3,50,58,38,-3,-3,14,1,9,6,-4,-4,11,63,80,46,1,0,4,49,60,30,1,0,7,14,20,16,0,0,155,89,66,252,163,89,36,38,69,8,5,0,21,29,32,6,1,2,15,9,37,2,4,-2,40,63,97,40,10,0,28,48,58,24,5,0,12,15,39,16,5,0,3,-4,7,175,97,78,-3,15,-10,-2,7,-4,5,-2,0,-8,3,0,-8,17,-10,6,4,-4,21,51,60,33,7,0,11,25,36,19,5,0,10,26,24,14,2,0,-91,-91,0,90,46,44,-2,-8,-59,-22,-8,2,-9,-16,-40,-22,-8,0,7,8,-19,0,0,2,11,30,34,9,4,1,5,15,19,5,1,0,6,15,15,4,3,1,313,213,100,200,97,103,1,100,163,43,1,1,0,71,121,22,-4,1,1,29,42,21,5,0,11,49,97,33,4,1,10,22,47,14,2,0,1,27,50,19,2,1,11,-54,65,134,36,98,26,29,-64,9,6,2,14,4,-79,-4,11,-2,12,25,15,13,-5,4,37,41,43,8,0,2,21,13,5,-4,-1,2,16,28,38,12,1,0,111,-66,177,229,10,219,43,82,-45,13,0,17,25,31,-101,-21,0,1,18,51,56,34,0,16,40,96,44,42,5,0,20,36,-43,-3,-1,0,20,60,87,45,6,0,43,24,19,61,31,30,17,23,-15,11,-2,4,8,20,-11,1,1,2,9,3,-4,10,-3,2,12,13,29,3,1,-1,4,8,16,-2,3,0,8,5,13,5,-2,-1,70,6,64,-24,-35,11,30,4,32,-12,-2,10,4,-6,8,-8,-3,5,26,10,24,-4,1,5,18,-16,3,-29,-4,1,2,-13,-4,-16,-5,0,16,-3,7,-13,1,1,27,-12,39,87,20,67,1,-2,10,6,4,3,-5,1,-11,-7,4,2,6,-3,21,13,0,1,25,4,31,22,2,2,10,5,-2,6,-1,1,15,-1,33,16,3,1,235,69,166,148,13,135,46,35,84,59,5,-1,20,17,21,13,-3,-3,26,18,63,46,8,2,21,16,47,55,0,1,12,0,-3,5,-4,0,9,16,50,50,4,1,372,203,169,137,56,81,69,65,161,67,4,-1,36,37,94,32,0,0,33,28,67,35,4,-1,24,26,54,27,1,0,9,11,26,7,1,0,15,15,28,20,0,0,267,151,116,143,54,89,28,47,107,80,-4,7,23,19,67,36,1,3,5,28,40,44,-5,4,18,27,48,47,2,-1,13,13,15,11,1,0,5,14,33,36,1,-1,-91,-14,-77,-159,-62,-97,11,16,-45,-67,-11,1,8,5,-7,-26,1,3,3,11,-38,-41,-12,-2,-4,-2,-48,-85,-21,0,-8,-1,-21,-29,-4,0,4,-1,-27,-56,-17,0,320,169,151,176,89,87,45,47,117,77,25,13,20,33,54,39,18,7,25,14,63,38,7,6,31,25,56,55,5,3,17,17,27,23,3,2,14,8,29,32,2,1,131,70,61,70,46,24,23,27,34,26,10,8,5,4,33,13,4,6,18,23,1,13,6,2,11,13,22,15,4,0,11,4,17,8,1,0,0,9,5,7,3,0,178,112,66,152,66,86,-8,38,93,48,12,3,-7,29,67,15,9,2,-1,9,26,33,3,1,12,20,76,35,5,5,2,15,38,5,4,2,10,5,38,30,1,3
21,21060,Punta Umbría,11864,107,58,49,2,1,1,-24,56,10,41,22,1,-9,25,7,21,16,-1,-15,31,3,20,6,2,0,0,1,0,1,0,0,0,0,0,1,0,0,0,1,0,0,0,278,156,122,46,28,18,27,41,96,67,36,10,18,15,59,42,18,4,9,26,37,25,18,6,5,8,13,17,1,1,3,6,6,12,0,0,2,2,7,5,1,1,146,63,83,38,20,18,-7,35,26,43,33,18,-7,21,8,19,12,10,0,14,18,24,21,8,3,10,7,9,7,2,1,6,3,5,4,1,2,4,4,4,3,1,104,59,45,31,11,20,-24,26,8,27,53,17,-11,9,6,23,25,10,-13,17,2,4,28,7,4,3,6,10,7,1,2,1,2,3,2,1,2,2,4,7,5,0,242,144,98,78,40,38,8,49,96,62,39,-16,13,19,64,38,15,-6,-5,30,32,24,24,-10,16,9,25,14,8,5,8,3,15,8,3,3,8,6,10,6,5,2,198,65,133,95,36,59,16,69,35,35,36,2,10,13,7,9,24,-1,6,56,28,26,12,3,18,26,29,16,1,4,7,8,12,8,0,1,11,18,17,8,1,3,201,117,84,146,61,85,12,70,60,53,5,7,13,31,29,36,10,3,-1,39,31,17,-5,4,7,46,61,26,4,2,4,18,26,10,2,1,3,28,35,16,2,1,158,110,48,122,62,60,24,47,13,37,19,14,27,35,10,23,12,3,-3,12,3,14,7,11,15,41,35,18,9,3,10,24,15,7,6,0,5,17,20,11,3,3,135,83,52,78,44,34,7,36,33,20,23,15,11,16,28,13,9,3,-4,20,5,7,14,12,12,18,35,3,6,3,9,7,23,0,3,2,3,11,12,3,3,1,-67,-29,-38,16,13,3,-13,-3,-48,-15,5,11,-12,0,-23,-2,3,6,-1,-3,-25,-13,2,5,2,7,6,0,1,0,3,4,4,1,1,0,-1,3,2,-1,0,0,143,83,60,32,7,25,14,63,45,16,8,1,1,33,35,9,4,4,13,30,10,7,4,-3,8,14,9,3,-4,0,2,4,4,-1,-2,0,6,10,5,4,-2,0,15,-14,29,-4,-13,9,-6,24,-36,28,14,-4,5,8,-41,15,7,-3,-11,16,5,13,7,-1,9,3,-21,1,3,1,6,4,-21,-3,0,1,3,-1,0,4,3,0,62,27,35,-43,-21,-22,7,23,-15,1,24,25,0,6,-1,9,11,7,7,17,-14,-8,13,18,-1,-3,-15,-21,-2,-2,0,-2,-8,-8,-4,0,-1,-1,-7,-13,2,-2,-67,-24,-43,-89,-45,-44,-16,3,-69,-20,17,15,1,6,-33,-17,10,6,-17,-3,-36,-3,7,9,-4,-4,-25,-31,-15,-10,-3,-2,-7,-20,-8,-5,-1,-2,-18,-11,-7,-5,-30,-32,2,-14,-6,-8,0,-1,-28,4,-9,10,-10,-10,-5,3,-10,4,10,9,-23,1,1,6,1,0,-6,-3,-3,-3,0,2,-7,3,-3,-1,1,-2,1,-6,0,-2,18,26,-8,38,15,23,8,-12,-14,18,10,11,12,-7,-6,25,6,0,-4,-5,-8,-7,4,11,6,7,8,10,6,1,4,2,2,4,3,0,2,5,6,6,3,1,-22,-16,-6,7,4,3,-2,17,-25,-30,12,15,-10,15,-11,-26,9,11,8,2,-14,-4,3,4,-2,4,-2,-1,2,5,2,1,1,-4,0,4,-4,3,-3,3,2,1,72,47,25,24,19,5,13,19,35,-2,19,-7,14,18,10,8,4,-2,-1,1,25,-10,15,-5,-1,14,3,2,6,0,-2,9,4,5,2,1,1,5,-1,-3,4,-1
21,21064,San Juan del Puerto,5882,16,16,0,4,2,2,-6,5,11,3,-3,4,-2,8,10,0,-3,1,-4,-3,1,3,0,3,0,1,3,0,0,0,0,1,1,0,0,0,0,0,2,0,0,0,66,31,35,9,3,6,12,10,15,17,8,3,11,3,2,10,4,1,1,7,13,7,4,2,6,2,0,0,0,0,3,0,0,0,0,0,3,2,0,0,0,0,142,73,69,7,3,4,40,26,49,26,3,-1,18,14,25,14,3,-1,22,12,24,12,0,0,0,4,3,1,0,-1,0,2,1,1,0,-1,0,2,2,0,0,0,168,79,89,11,6,5,24,46,69,16,2,3,5,18,38,12,-1,1,19,28,31,4,3,2,1,6,1,1,2,0,1,3,0,1,1,0,0,3,1,0,1,0,259,140,119,32,18,14,37,44,106,48,18,7,17,27,56,25,11,4,20,17,50,23,7,3,3,10,12,5,1,0,1,5,8,2,1,0,2,5,4,3,0,0,301,160,141,50,31,19,60,43,137,38,14,2,33,21,67,25,10,0,27,22,70,13,4,2,4,14,26,6,0,0,1,11,15,4,0,0,3,3,11,2,0,0,295,163,132,34,12,22,55,56,128,31,16,3,31,21,77,22,9,3,24,35,51,9,7,0,4,11,13,4,2,0,2,3,4,2,1,0,2,8,9,2,1,0,213,106,107,57,23,34,24,36,106,25,18,-1,6,12,60,14,9,1,18,24,46,11,9,-2,10,18,14,9,3,1,6,7,8,1,1,0,4,11,6,8,2,1,107,24,83,42,18,24,5,30,66,-2,4,2,-4,15,15,-3,0,0,9,15,51,1,4,2,10,11,13,8,0,0,4,7,4,3,0,0,6,4,9,5,0,0,98,34,64,29,10,19,0,13,58,14,2,8,-7,-5,26,12,1,3,7,18,32,2,1,5,4,5,18,2,0,0,2,-2,8,2,-1,1,2,7,10,0,1,-1,121,41,80,46,24,22,31,13,47,18,-1,8,6,-1,17,16,-2,3,25,14,30,2,1,5,11,9,13,10,0,2,7,5,6,5,0,1,4,4,7,5,0,1,87,33,54,32,8,24,9,8,35,25,9,1,-1,6,12,12,1,2,10,2,23,13,8,-1,6,7,12,2,4,1,1,2,4,0,0,1,5,5,8,2,4,0,18,10,8,22,14,8,6,11,12,4,-8,-1,5,1,15,-2,-7,1,1,10,-3,6,-1,-2,5,7,7,1,2,0,3,5,4,1,1,0,2,2,3,0,1,0,51,27,24,28,10,18,-1,12,16,11,9,5,7,7,7,-1,6,2,-8,5,9,12,3,3,6,8,6,5,0,3,4,3,2,0,0,1,2,5,4,5,0,2,44,5,39,20,5,15,-2,6,13,21,-1,6,2,-3,-1,3,1,2,-4,9,14,18,-2,4,3,8,10,-1,-1,1,5,2,2,-2,-2,0,-2,6,8,1,1,1,29,20,9,14,4,10,12,12,4,14,-6,-3,13,7,-6,15,-6,-3,-1,5,10,-1,0,0,3,9,-1,-1,3,0,3,4,-2,-1,1,-1,0,5,1,0,2,1,78,23,55,49,29,20,21,1,32,9,8,8,3,4,6,7,3,1,18,-3,26,2,5,7,15,9,11,9,4,1,9,6,6,5,3,0,6,3,5,4,1,1,69,47,22,72,36,36,2,9,38,16,1,2,7,7,31,-1,0,1,-5,2,7,17,1,1,12,14,24,20,2,0,5,9,16,7,-1,0,7,5,8,13,3,0
21,21073,Villablanca,2030,32,24,8,6,3,3,1,9,9,6,5,4,4,8,3,6,2,2,-3,1,6,0,3,2,0,0,1,1,3,1,0,0,0,1,2,0,0,0,1,0,1,1,18,27,-9,19,14,5,-8,11,9,6,2,-2,-3,12,12,6,1,-1,-5,-1,-3,0,1,-1,0,8,6,3,2,0,0,8,4,1,1,0,0,0,2,2,1,0,37,24,13,26,10,16,2,15,8,11,3,-2,4,6,7,5,3,0,-2,9,1,6,0,-2,5,8,7,4,2,-1,1,3,2,2,2,0,4,5,5,2,0,-1,60,32,28,40,18,22,12,3,17,8,10,8,7,1,10,3,7,4,5,2,7,5,3,4,3,11,7,6,8,4,0,7,2,2,5,2,3,4,5,4,3,2,52,30,22,46,29,17,9,20,4,11,13,-2,6,14,0,3,9,-1,3,6,4,8,4,-1,2,18,9,8,10,-1,0,14,5,3,8,-1,2,4,4,5,2,0,109,69,40,67,37,30,15,12,30,24,23,4,12,6,16,20,12,2,3,6,14,4,11,2,10,8,12,17,17,3,6,5,5,11,8,2,4,3,7,6,9,1,164,91,73,139,71,68,15,15,52,40,33,9,4,2,36,25,21,3,11,13,16,15,12,6,16,24,33,32,29,5,6,8,19,18,18,2,10,16,14,14,11,3,171,79,92,138,70,68,26,37,45,27,27,5,16,17,16,9,16,3,10,20,29,18,11,2,14,34,37,31,20,2,9,16,22,11,10,2,5,18,15,20,10,0,66,37,29,61,31,30,8,17,23,2,14,2,3,8,18,-2,10,1,5,9,5,4,4,1,9,8,20,9,11,3,3,5,13,3,5,2,6,3,7,6,6,1,4,-5,9,31,14,17,3,3,-1,-12,5,6,4,-1,-6,-8,3,4,-1,4,5,-4,2,2,4,9,6,3,7,2,3,2,3,2,3,1,1,7,3,1,4,1,120,33,87,68,10,58,7,4,41,58,7,3,-2,7,18,6,1,3,9,-3,23,52,6,0,2,7,14,42,3,0,0,4,3,2,1,0,2,3,11,40,2,0,62,39,23,23,7,16,3,11,8,20,10,4,7,9,7,6,6,1,-4,2,1,14,4,3,0,4,6,6,6,0,0,3,1,-2,4,0,0,1,5,8,2,0,40,21,19,30,8,22,8,12,2,9,0,7,5,6,-3,8,1,2,3,6,5,1,-1,5,1,9,4,11,2,2,0,3,0,3,1,1,1,6,4,8,1,1,68,15,53,44,6,38,5,12,31,7,11,0,3,3,2,1,4,1,2,9,29,6,7,-1,0,8,25,5,5,1,1,3,0,0,2,0,-1,5,25,5,3,1,1,-16,17,24,8,16,3,-4,-5,13,-5,-2,0,-8,-5,3,-4,-2,3,4,0,10,-1,0,3,3,1,14,2,0,3,1,0,2,2,-1,0,2,1,12,0,1,0,-21,21,7,-1,8,0,4,-11,-5,8,3,-1,-1,-9,-8,-1,0,1,5,-2,3,9,3,8,2,-1,-6,6,-2,4,0,-3,-4,2,0,4,2,2,-2,4,-2,9,1,8,24,5,19,-10,-2,21,1,7,-8,-6,1,5,-1,5,-3,-4,-3,16,2,2,-5,1,1,11,11,2,-2,1,1,0,4,0,-1,0,0,11,7,2,-1,67,19,48,81,25,56,-3,20,13,15,18,3,-1,9,5,-2,5,2,-2,11,8,17,13,1,5,20,15,25,14,1,3,8,5,3,4,1,2,12,10,22,10,0
21,21076,Villanueva de los Castillejos,2707,42,17,25,30,16,14,-9,15,18,9,5,4,-7,5,12,-1,5,3,-2,10,6,10,0,1,0,4,14,10,1,1,0,4,7,3,1,1,0,0,7,7,0,0,39,19,20,48,28,20,1,18,-5,16,5,4,1,10,-6,9,4,1,0,8,1,7,1,3,3,18,15,10,2,0,1,10,9,6,2,0,2,8,6,4,0,0,-14,1,-15,7,4,3,-6,9,-8,-9,0,0,-1,6,0,-5,-1,1,-5,3,-8,-4,1,-1,2,0,4,1,0,0,1,0,3,0,0,0,1,0,1,1,0,0,20,22,-2,6,4,2,0,-1,5,8,4,1,1,3,8,3,4,0,-1,-4,-3,5,0,1,0,1,3,1,0,1,0,0,3,1,0,0,0,1,0,0,0,1,33,19,14,22,14,8,5,1,3,8,12,5,0,-3,5,6,7,4,5,4,-2,2,5,1,4,1,8,6,1,2,2,1,5,4,1,1,2,0,3,2,0,1,64,41,23,42,22,20,10,22,15,16,5,-5,7,12,10,10,2,-2,3,10,5,6,3,-3,6,13,11,11,0,0,5,6,4,6,0,0,1,7,7,5,0,0,8,-4,12,26,10,16,2,13,3,-2,-2,-5,0,7,-2,-2,-4,-1,2,6,5,0,2,-4,1,10,8,5,2,0,0,5,4,1,0,0,1,5,4,4,2,0,17,-7,24,33,11,22,8,14,0,9,-6,-4,0,1,-2,2,-3,-4,8,13,2,7,-3,0,4,11,10,8,0,0,2,5,2,3,-1,0,2,6,8,5,1,0,29,16,13,18,8,10,3,7,5,7,6,-1,3,1,7,1,2,1,0,6,-2,6,4,-2,0,8,3,7,0,0,0,2,2,4,0,0,0,6,1,3,0,0,-10,9,-19,16,7,9,1,3,-14,-2,8,-8,2,13,-5,0,2,-4,-1,-10,-9,-2,6,-4,7,6,1,2,0,-1,3,3,1,1,0,-1,4,3,0,1,0,0,-19,-12,-7,-15,-10,-5,-4,1,-16,10,-5,-4,-3,0,-6,5,-5,-3,-1,1,-10,5,0,-1,0,1,-9,1,-4,-4,-1,1,-5,1,-3,-3,1,0,-4,0,-1,-1,23,6,17,12,1,11,12,6,2,7,3,-3,6,4,-1,-1,0,1,6,2,3,8,3,-4,2,3,-1,9,1,-2,1,1,-2,1,1,-1,1,2,1,8,0,-1,-12,-4,-8,5,2,3,-6,10,-21,-3,8,0,-4,5,-12,0,4,2,-2,5,-9,-3,4,-2,-1,3,1,0,3,-1,0,2,1,-1,1,-1,-1,1,0,1,2,0,16,16,0,3,2,1,-2,4,7,1,3,2,3,9,1,-1,3,0,-5,-5,6,2,0,2,1,1,-2,1,2,0,1,2,-2,-1,2,0,0,-1,0,2,0,0,-17,-17,0,-3,-8,5,-11,-6,-1,4,-1,-2,-6,-5,0,-5,-1,0,-5,-1,-1,9,0,-2,-2,-1,1,1,-2,0,0,-2,-1,-4,-2,1,-2,1,2,5,0,-1,23,12,11,11,4,7,7,-2,9,5,4,3,4,-1,5,2,0,3,3,-1,4,3,4,0,3,1,1,2,2,1,1,0,0,0,1,1,2,1,1,2,1,0,15,6,9,12,10,2,0,4,-7,11,1,3,1,2,-8,5,3,2,-1,2,1,6,-2,1,2,3,5,3,-2,1,3,3,3,1,0,0,-1,0,2,2,-2,1,9,5,4,-1,-4,3,4,-4,5,7,-6,2,2,1,2,3,0,-4,2,-5,3,4,-6,6,1,-1,4,2,-7,0,0,-1,4,-4,-2,-1,1,0,0,6,-5,1
22,22907,Aínsa-Sobrarbe,1579,32,14,18,10,5,5,5,5,4,13,0,4,4,2,-3,9,-1,2,1,3,7,4,1,2,3,0,2,4,1,0,2,0,1,2,0,0,1,0,1,2,1,0,46,23,23,23,12,11,10,7,16,3,1,10,8,4,9,-1,0,4,2,3,7,4,1,6,7,2,8,4,1,1,5,0,5,1,0,1,2,2,3,3,1,0,87,48,39,43,20,23,-1,12,25,23,14,13,3,3,19,12,6,5,-4,9,6,11,8,8,7,8,18,3,6,0,6,4,8,0,2,0,1,4,10,3,4,0,60,27,33,32,14,18,3,8,46,-3,-2,9,2,4,23,-4,-1,5,1,4,23,1,-1,4,3,7,17,5,0,0,3,2,6,3,0,0,0,5,11,2,0,0,62,32,30,41,17,24,0,12,19,24,10,-6,4,7,6,10,6,-3,-4,5,13,14,4,-3,3,6,12,14,6,0,1,5,3,4,4,0,2,1,9,10,2,0,68,28,40,71,30,41,22,15,27,-1,5,0,6,3,15,-2,5,0,16,12,12,1,0,0,22,16,20,9,3,1,8,5,10,4,2,1,14,11,10,5,1,0,82,43,39,48,26,22,15,14,18,20,5,9,4,9,7,16,3,4,11,5,11,4,2,5,17,13,8,10,-1,1,9,6,7,4,0,0,8,7,1,6,-1,1,145,81,64,125,68,57,37,21,46,27,11,3,20,14,27,12,5,2,17,7,19,15,6,1,27,29,33,30,6,0,12,18,22,14,2,0,15,11,11,16,4,0,99,47,52,59,23,36,14,22,31,35,-2,-1,8,6,21,18,-4,-1,6,16,10,17,2,0,13,17,20,8,-2,2,10,6,9,1,-3,0,3,11,11,7,1,2,9,1,8,19,12,7,-3,5,19,-4,-10,1,0,4,6,-1,-7,-2,-3,1,13,-3,-3,3,4,8,4,2,-1,1,3,5,0,2,1,0,1,3,4,0,-2,1,54,19,35,21,9,12,2,11,25,15,2,1,2,0,12,4,2,1,0,11,13,11,0,0,1,7,8,2,2,1,2,2,4,0,-1,2,-1,5,4,2,3,-1,8,-2,10,19,6,13,6,4,9,-9,-4,1,0,-1,7,-6,-5,1,6,5,2,-3,1,0,5,6,7,0,-1,2,2,1,4,0,-2,1,3,5,3,0,1,1,11,27,-16,-3,0,-3,7,-4,7,-2,3,0,10,0,6,1,8,2,-3,-4,1,-3,-5,-2,-1,-1,-2,0,1,0,-1,0,-1,0,2,0,0,-1,-1,0,-1,0,5,-8,13,5,-1,6,3,-1,-1,7,-3,1,2,-1,-4,-1,-2,-1,1,0,3,8,-1,2,3,2,2,-1,0,-1,1,1,-1,-2,0,0,2,1,3,1,0,-1,23,9,14,13,9,4,16,2,6,2,2,-8,6,5,5,-1,-2,-6,10,-3,1,3,4,-2,6,3,3,0,0,0,4,2,3,0,-1,0,2,1,0,0,1,0,-45,-32,-13,-40,-29,-11,-4,4,-26,-12,1,-10,-3,2,-13,-16,2,-5,-1,2,-13,4,-1,-5,2,4,-23,-10,-6,-8,0,3,-15,-10,-3,-5,2,1,-8,0,-3,-3,0,-1,1,21,12,9,-1,-4,5,-3,1,4,2,-4,8,-5,-2,1,-3,0,-3,2,3,3,2,1,9,6,4,-1,0,0,7,4,1,0,2,1,2,2,3,-1,-6,-17,11,-5,-6,1,0,6,-7,-5,-6,6,1,-1,-9,-6,-3,1,-1,7,2,1,-3,5,-2,8,-1,-5,-5,0,-1,1,2,-5,-3,0,-1,7,-3,0,-2,0
22,22007,Albalate de Cinca,1105,108,91,17,121,100,21,9,26,44,24,3,3,7,23,33,24,3,1,2,3,11,0,0,2,9,33,46,32,1,0,7,26,38,28,1,0,2,7,8,4,0,0,95,91,4,120,104,16,-2,21,45,33,1,-3,-1,22,42,28,1,-1,-1,-1,3,5,0,-2,2,29,53,35,1,0,2,25,48,29,0,0,0,4,5,6,1,0,-30,-27,-3,9,8,1,7,-10,-14,-15,3,-1,3,-5,-14,-11,1,-1,4,-5,0,-4,2,0,4,0,5,0,0,0,3,0,5,0,0,0,1,0,0,0,0,0,-19,-18,-1,18,6,12,2,-2,-15,-2,0,-2,1,-2,-12,-5,0,0,1,0,-3,3,0,-2,5,3,6,4,0,0,0,2,3,1,0,0,5,1,3,3,0,0,-30,-21,-9,16,8,8,5,-2,-20,-6,-5,-1,4,-3,-14,-4,-3,0,1,1,-6,-2,-2,-1,8,4,2,1,0,1,4,1,1,1,0,1,4,3,1,0,0,0,-31,-19,-12,-6,-3,-3,-8,-8,-10,-8,5,-1,-1,-6,-7,-7,4,-1,-7,-2,-3,-1,1,0,-1,-1,-1,-3,0,0,0,0,-1,-2,0,0,-1,-1,0,-1,0,0,2,1,1,14,9,5,-1,-2,3,-1,0,3,2,-2,1,-2,0,1,-3,0,2,1,0,2,0,3,6,3,2,0,0,3,3,2,1,0,0,0,3,1,1,0,25,14,11,36,20,16,0,20,-6,8,6,-2,-1,7,-3,6,5,1,1,13,-3,2,1,-3,5,17,0,10,4,0,1,9,-2,9,3,0,4,8,2,1,1,0,28,19,9,26,14,12,1,9,12,7,0,-1,-1,6,11,5,-2,0,2,3,1,2,2,-1,3,7,10,4,2,0,0,4,7,3,0,0,3,3,3,1,2,0,42,20,22,21,7,14,4,7,14,8,6,2,2,3,6,4,4,1,2,4,8,4,2,1,3,6,3,6,2,0,1,3,0,1,2,0,2,3,3,5,0,0,35,26,9,15,13,2,2,12,18,3,2,-2,0,10,13,1,2,0,2,2,5,2,0,-2,0,6,5,3,1,0,0,5,5,3,0,0,0,1,0,0,1,0,12,8,4,21,12,9,5,1,-4,9,0,-1,3,2,0,4,-2,0,2,-1,-4,5,2,-1,1,8,2,7,3,0,1,5,2,2,2,0,0,3,0,5,1,0,-3,-11,8,-8,-17,9,3,2,0,-6,0,-2,2,-9,4,-5,-1,-2,1,11,-4,-1,1,0,1,0,-4,-2,-3,0,0,-7,-4,-3,-3,0,1,7,0,1,0,0,-3,12,-15,10,7,3,1,-2,1,3,-5,-1,4,-1,1,7,-1,0,-3,-1,0,-4,-4,-1,4,1,4,0,1,0,3,0,3,0,1,0,1,1,1,0,0,0,-15,-7,-8,15,5,10,-4,-1,0,0,-4,-6,-4,2,-1,2,-1,-4,0,-3,1,-2,-3,-2,0,7,4,3,0,0,0,3,1,1,0,0,0,4,3,2,0,0,10,4,6,8,2,6,1,2,-4,9,2,0,2,1,-7,5,2,0,-1,1,3,4,0,0,1,1,0,6,1,-1,1,1,-3,3,1,-1,0,0,3,3,0,0,14,3,11,10,8,2,-1,10,-2,6,-1,1,-1,5,-2,2,-2,1,0,5,0,4,1,0,0,8,-1,2,0,1,3,4,0,0,0,1,-3,4,-1,2,0,0,2,7,-5,4,4,0,-4,5,-3,-1,5,1,-3,5,3,-2,3,2,-1,0,-6,1,2,-1,-1,1,2,-1,3,0,-1,2,2,-1,2,0,0,-1,0,0,1,0
22,22054,Benasque,1419,101,55,46,17,8,9,15,33,24,21,4,-1,9,19,8,18,0,0,6,14,16,3,4,-1,2,5,3,7,0,0,2,3,0,3,0,0,0,2,3,4,0,0,127,71,56,52,24,28,14,44,54,15,-2,2,7,15,42,7,-2,1,7,29,12,8,0,1,8,13,21,8,1,0,5,4,9,5,0,0,3,9,12,3,1,0,163,90,73,55,26,29,4,66,76,17,-4,1,3,37,38,8,0,2,1,29,38,9,-4,-1,5,19,22,6,2,1,1,9,10,4,1,1,4,10,12,2,1,0,193,116,77,71,32,39,8,52,82,33,17,-2,1,25,57,21,11,0,7,27,25,12,6,-2,8,17,34,6,3,1,3,6,16,3,3,0,5,11,18,3,0,1,51,33,18,30,15,15,12,3,20,6,9,1,8,4,7,9,6,-1,4,-1,13,-3,3,2,9,6,11,3,0,0,5,4,3,2,0,0,4,2,8,1,0,0,10,1,9,13,6,7,5,11,-8,0,2,-2,0,6,-2,-1,1,-3,5,5,-6,1,1,1,2,8,2,1,0,0,2,4,2,-1,-1,0,0,4,0,2,1,0,30,3,27,44,18,26,-9,7,32,0,-4,0,-10,2,15,-6,-1,1,1,5,17,6,-3,-1,5,11,21,7,0,0,1,5,9,3,0,0,4,6,12,4,0,0,42,22,20,45,27,18,8,47,-16,-6,9,-2,1,27,-9,-2,5,-2,7,20,-7,-4,4,0,11,24,-2,8,3,1,5,14,2,4,2,0,6,10,-4,4,1,1,-3,-11,8,17,-6,23,-1,12,-14,-1,-1,2,-2,7,-11,-1,-4,0,1,5,-3,0,3,2,7,10,3,-2,-1,0,0,2,-2,-5,-1,0,7,8,5,3,0,0,1,-8,9,-21,-16,-5,-10,1,12,3,-4,-2,-14,-2,7,2,-3,-1,4,3,5,1,-1,-1,0,-5,-10,-4,-2,0,-2,-4,-5,-3,-3,1,2,-1,-5,-1,1,-1,7,2,5,9,6,3,-8,13,22,-21,1,-1,-5,9,12,-14,-1,0,-3,4,10,-7,2,-1,6,3,-2,0,2,0,2,2,2,0,0,0,4,1,-4,0,2,0,-24,-10,-14,1,-2,3,-5,12,-2,-14,-10,-4,-5,7,-5,-2,-4,-1,0,5,3,-12,-6,-3,-2,8,2,-7,1,-1,-1,4,0,-5,1,-1,-1,4,2,-2,0,0,-29,1,-30,-2,-1,-1,-10,2,-13,-8,-2,-1,-3,6,-4,3,-2,0,-7,-4,-9,-11,0,-1,-2,-2,2,-1,0,1,0,-1,-1,0,0,1,-2,-1,3,-1,0,0,-46,-24,-22,-10,-4,-6,2,-4,-15,-23,-8,0,1,-2,-1,-11,-11,-2,1,-2,-14,-12,3,2,1,-1,-2,-7,-1,0,1,-1,1,-4,-1,0,0,0,-3,-3,0,0,-36,-19,-17,3,1,2,-3,5,-11,-24,-3,0,0,5,-5,-18,-1,0,-3,0,-6,-6,-2,0,1,2,-3,0,1,2,0,1,-1,0,1,0,1,1,-2,0,0,2,-75,-32,-43,-50,-25,-25,-14,10,-17,-27,-21,-5,-6,11,-7,-17,-9,-2,-8,-1,-10,-10,-12,-3,-1,4,-18,-20,-10,-5,-2,2,-7,-13,-4,-1,1,2,-11,-7,-6,-4,78,43,35,24,9,15,32,16,20,6,2,-1,24,7,16,-7,0,1,8,9,4,13,2,-2,5,2,10,3,-1,4,4,0,4,0,-2,2,1,2,6,3,1,2,25,7,18,12,2,10,3,6,20,-7,5,-1,7,-1,7,-6,4,-4,-4,7,13,-1,1,3,4,3,6,-1,-3,2,3,1,0,-2,0,-1,1,2,6,1,-3,3
22,22059,Biescas,1269,6,5,1,2,1,1,-3,3,2,1,0,3,-2,2,2,2,0,1,-1,1,0,-1,0,2,0,0,1,1,0,0,0,0,1,0,0,0,0,0,0,1,0,0,25,17,8,7,6,1,-2,7,9,0,10,1,-1,5,7,3,5,-2,-1,2,2,-3,5,3,0,2,2,2,0,1,0,2,2,2,0,0,0,0,0,0,0,1,44,34,10,20,12,8,-3,14,10,19,1,4,-2,10,6,15,2,3,-1,4,4,4,-1,1,0,5,5,9,1,0,0,3,2,6,1,0,0,2,3,3,0,0,66,38,28,26,16,10,1,9,38,8,8,4,1,4,23,5,4,2,0,5,15,3,4,2,2,9,8,8,0,-1,0,5,7,5,0,-1,2,4,1,3,0,0,131,81,50,42,24,18,16,11,49,30,8,17,9,5,34,19,3,11,7,6,15,11,5,6,5,4,20,10,1,1,2,3,12,5,0,1,3,1,8,5,1,0,59,45,14,37,25,12,4,20,9,20,2,2,10,11,3,16,2,1,-6,9,6,4,0,1,7,14,6,9,1,0,7,8,3,7,0,0,0,6,3,2,1,0,43,35,8,45,29,16,-7,20,13,11,2,6,-8,12,16,11,1,3,1,8,-3,0,1,3,1,18,8,13,1,3,0,9,8,10,0,2,1,9,0,3,1,1,143,86,57,100,59,41,24,39,44,32,6,-1,13,21,23,22,6,0,11,18,21,10,0,-1,19,30,26,25,3,-4,13,14,16,16,2,-2,6,16,10,9,1,-2,-38,-18,-20,23,13,10,2,-10,-10,-7,-4,-6,-2,-2,-5,-7,0,0,4,-8,-5,0,-4,-6,2,4,8,7,0,2,-1,4,4,4,1,1,3,0,4,3,-1,1,-19,-19,0,-7,-10,3,-7,3,-8,-5,0,0,-5,-4,-4,-5,1,-1,-2,7,-4,0,-1,1,-1,0,-6,-1,1,0,-1,-4,-6,0,1,0,0,4,0,-1,0,0,-24,-12,-12,-3,-5,2,-11,-1,-11,-6,4,1,-4,-1,-8,-4,4,0,-7,0,-3,-2,0,1,0,2,-4,1,-2,-1,0,-1,-3,-1,-1,0,0,3,-1,2,-1,-1,7,6,1,-1,1,-2,9,4,5,-2,-8,0,6,1,3,1,-5,0,3,3,2,-3,-3,0,0,2,1,-4,-1,0,-1,1,2,-2,0,0,1,1,-1,-2,-1,0,-10,0,-10,-5,-3,-2,-5,4,7,-8,-2,-7,-2,4,3,-2,1,-4,-3,0,4,-6,-3,-3,0,0,-1,-3,0,-1,0,1,-2,-2,0,0,0,-1,1,-1,0,-1,4,-2,6,-1,-2,1,5,-2,2,-3,1,1,2,0,-1,-2,0,-1,3,-2,3,-1,1,2,-1,0,-2,0,1,1,-1,0,-1,0,0,0,0,0,-1,0,1,1,14,8,6,6,3,3,2,5,3,3,-4,3,1,8,5,-3,-4,0,1,-3,-2,6,0,3,2,1,-1,1,2,0,0,2,-1,1,1,0,2,-1,0,0,1,0,12,8,4,3,0,3,-4,7,17,-4,-6,1,0,1,8,3,-3,-1,-4,6,9,-7,-3,2,2,1,0,2,-2,0,1,0,-1,1,-1,0,1,1,1,1,-1,0,5,6,-1,-2,-2,0,5,0,0,-7,4,5,3,-2,0,-4,4,5,2,2,0,-3,0,0,0,-3,1,-2,1,1,0,-3,0,-1,1,1,0,0,1,-1,0,0,3,-4,7,-4,-4,0,5,4,8,-10,1,-3,2,2,4,-7,-1,-2,3,2,4,-3,2,-1,-1,1,2,-5,-2,1,0,1,1,-4,-2,0,-1,0,1,-1,0,1
22,22060,Binaced,1596,57,42,15,40,33,7,3,24,27,1,0,1,2,15,24,2,0,-1,1,9,3,-1,0,2,0,16,22,1,0,1,0,12,20,1,0,0,0,4,2,0,0,1,91,69,22,64,57,7,5,29,30,18,8,1,2,25,25,14,3,0,3,4,5,4,5,1,2,29,29,3,1,0,0,27,26,3,1,0,2,2,3,0,0,0,21,31,-10,66,57,9,4,12,1,1,1,2,3,14,7,4,3,0,1,-2,-6,-3,-2,2,6,23,25,12,0,0,4,20,24,9,0,0,2,3,1,3,0,0,-50,-30,-20,15,13,2,-6,-13,-13,-11,-3,-3,-2,-5,-12,-8,-1,-1,-4,-8,-1,-3,-2,-2,1,6,8,0,0,0,1,5,7,0,0,0,0,1,1,0,0,0,-2,6,-8,5,7,-2,6,-6,-8,2,4,0,7,-4,-2,2,3,0,-1,-2,-6,0,1,0,-2,3,3,1,0,0,-1,3,4,1,0,0,-1,0,-1,0,0,0,-9,2,-11,7,5,2,-2,8,-19,8,-2,0,-1,3,-8,8,0,0,-1,5,-11,0,-2,0,0,3,0,3,1,0,0,1,0,3,1,0,0,2,0,0,0,0,3,0,3,14,9,5,1,9,1,-4,-1,-3,-2,9,1,-5,-2,-2,3,0,0,1,1,-1,2,6,3,2,1,0,1,4,2,2,0,0,1,2,1,0,1,0,-8,-13,5,11,10,1,4,12,-7,-7,-3,-5,-2,10,-5,-9,-2,-4,6,2,-2,2,-1,-1,-1,14,2,-2,-2,0,-1,14,3,-4,-2,0,0,0,-1,2,0,0,11,14,-3,25,18,7,-8,-1,7,9,5,0,-6,1,10,7,2,0,-2,-2,-3,2,3,0,0,6,11,5,3,0,0,5,9,3,1,0,0,1,2,2,2,0,-9,-6,-3,-2,-1,-1,6,-12,-7,2,3,-1,4,-6,-6,-2,4,0,2,-6,-1,4,-1,-1,0,-1,-1,0,0,0,0,-1,0,0,0,0,0,0,-1,0,0,0,-4,1,-5,6,4,2,0,4,1,-6,1,-4,0,5,0,-1,-2,-1,0,-1,1,-5,3,-3,4,0,2,0,0,0,3,0,1,0,0,0,1,0,1,0,0,0,23,19,4,9,4,5,1,6,7,7,7,-5,3,4,5,2,6,-2,-2,2,2,5,1,-3,0,2,2,3,2,0,0,0,1,1,2,0,0,2,1,2,0,0,0,3,-3,7,5,2,-5,0,-2,5,0,3,-2,-2,4,4,-1,1,-3,2,-6,1,1,2,2,2,1,2,0,0,2,1,1,1,0,0,0,1,0,1,0,0,14,8,6,13,8,5,1,10,-7,4,3,2,0,8,-3,1,0,0,1,2,-4,3,3,2,1,2,7,1,2,0,0,1,6,0,1,0,1,1,1,1,1,0,3,13,-10,14,12,2,-4,2,-1,8,0,0,-2,5,3,7,2,0,-2,-3,-4,1,-2,0,0,6,5,2,1,0,0,6,3,2,1,0,0,0,2,0,0,0,24,18,6,11,6,5,8,6,14,1,-1,-4,6,4,11,-2,1,-2,2,2,3,3,-2,-2,2,2,8,-3,1,0,2,2,5,-5,1,0,0,0,3,2,0,0,1,8,-7,5,2,3,-4,6,-7,0,3,3,-1,6,1,-1,3,0,-3,0,-8,1,0,3,2,3,-1,1,0,0,1,2,-1,0,0,0,1,1,0,1,0,0,43,24,19,23,19,4,12,7,12,12,-2,0,6,6,4,6,-1,2,6,1,8,6,-1,-2,5,6,5,5,1,0,4,5,4,4,1,0,1,1,1,1,0,0
22,22061,Binéfar,8199,85,61,24,74,47,27,16,44,16,-2,12,-4,9,27,14,2,6,1,7,17,2,-4,6,-5,10,26,21,10,5,2,4,16,16,8,2,1,6,10,5,2,3,1,124,79,45,121,79,42,26,37,37,7,11,6,16,30,19,5,3,6,10,7,18,2,8,0,17,44,42,12,3,3,11,31,27,8,0,2,6,13,15,4,3,1,137,98,39,152,98,54,12,65,37,23,2,-2,-1,54,30,17,0,-1,13,11,7,6,2,-1,15,61,52,18,3,2,3,46,35,9,2,2,12,15,17,9,1,0,204,152,52,188,141,47,32,84,64,17,-5,9,19,68,48,13,-1,4,13,16,16,4,-4,5,26,70,66,21,2,1,18,54,49,18,1,0,8,16,17,3,1,1,118,91,27,177,134,43,26,28,42,12,3,7,12,24,35,8,3,9,14,4,7,4,0,-2,19,62,76,18,2,0,10,46,63,14,0,0,9,16,13,4,2,0,126,61,65,129,82,47,28,39,34,-3,18,7,20,23,14,-5,4,3,8,16,20,2,14,4,21,47,39,15,4,0,11,34,26,8,1,0,10,13,13,7,3,0,178,110,68,120,91,29,42,39,65,15,16,1,31,26,34,7,12,0,11,13,31,8,4,1,16,36,50,13,4,1,13,31,34,11,2,0,3,5,16,2,2,1,203,138,65,151,90,61,39,59,65,27,11,-1,19,34,54,19,8,3,20,25,11,8,3,-4,24,51,39,19,14,1,13,34,24,8,8,1,11,17,15,11,6,0,173,135,38,163,113,50,25,51,63,23,-4,13,19,33,50,25,0,6,6,18,13,-2,-4,7,25,51,62,16,4,2,14,37,43,13,3,1,11,14,19,3,1,1,-46,-32,-14,1,-13,14,14,18,-48,-14,-20,4,10,13,-33,-19,-10,6,4,5,-15,5,-10,-2,10,19,-15,-11,-5,2,8,15,-18,-16,-4,1,2,4,3,5,-1,1,75,46,29,32,24,8,51,46,-20,7,-13,3,33,28,-15,-4,-3,7,18,18,-5,11,-10,-4,22,32,-8,-4,-8,-2,22,23,-10,-10,-1,0,0,9,2,6,-7,-2,-16,-34,18,44,13,31,27,-7,-20,-12,-8,2,10,-3,-24,-14,-4,0,17,-4,4,2,-4,2,20,22,-1,2,1,0,13,15,-13,-2,0,0,7,7,12,4,1,0,8,8,0,-36,-23,-13,8,9,17,-16,-18,5,7,13,2,-7,-10,1,1,-4,15,-9,-8,4,1,14,-30,-14,-8,1,3,11,-24,-10,-3,0,-2,3,-6,-4,-5,1,-14,-19,5,-29,-26,-3,6,-9,-20,0,3,5,11,-3,-26,3,-6,2,-5,-6,6,-3,9,3,7,2,-25,-9,-5,0,5,5,-26,-5,-5,0,2,-3,1,-4,0,0,-3,6,-9,-23,-20,-3,8,9,-12,-4,7,-9,3,1,-3,3,1,0,5,8,-9,-7,6,-9,5,-3,-10,-6,-6,-4,4,-1,-12,-4,-6,-2,1,-2,2,-2,0,-2,9,11,-2,34,15,19,10,7,2,0,-7,-5,3,-4,2,15,-4,-2,7,11,0,-15,-3,-3,15,13,5,1,-4,2,9,2,3,3,-3,0,6,11,2,-2,-1,2,19,18,1,39,22,17,25,4,-4,5,-3,-10,18,5,-2,2,-2,-4,7,-1,-2,3,-1,-6,17,21,1,-6,7,-2,15,13,-4,-3,2,-1,2,8,5,-3,5,-1,57,52,5,85,54,31,48,20,-6,0,-1,-1,38,12,-3,2,2,1,10,8,-3,-2,-3,-2,47,28,8,-1,2,1,38,14,2,-3,3,0,9,14,6,2,-1,1
22,22112,Fraga,11928,173,137,36,218,165,53,20,44,68,30,-2,9,12,38,61,19,0,4,8,6,7,11,-2,5,26,59,93,34,3,0,12,48,78,23,1,0,14,11,15,11,2,0,406,290,116,386,282,104,43,107,158,65,20,13,19,81,126,49,12,2,24,26,32,16,8,11,36,101,173,63,9,2,18,73,138,45,4,2,18,28,35,18,5,0,378,269,109,348,245,103,54,117,126,62,8,4,38,66,100,51,4,3,16,51,26,11,4,1,51,96,126,67,4,0,31,55,106,48,1,0,20,41,20,19,3,0,169,83,86,256,143,113,30,49,48,31,12,2,7,25,22,26,2,2,23,24,26,5,10,0,44,71,80,45,11,3,18,39,53,28,3,2,26,32,27,17,8,1,204,142,62,249,149,100,29,35,65,59,9,7,26,21,52,32,5,4,3,14,13,27,4,3,27,62,93,44,17,4,13,32,64,28,8,3,14,30,29,16,9,1,161,61,100,242,127,115,12,71,46,15,5,7,7,35,20,3,-5,0,5,36,26,12,10,7,28,76,91,36,6,2,19,33,54,19,0,1,9,43,37,17,6,1,300,182,118,284,156,128,48,103,79,69,2,-2,28,51,58,36,5,3,20,52,21,33,-3,-5,46,111,69,52,5,1,26,57,40,28,4,1,20,54,29,24,1,0,183,72,111,195,51,144,72,63,27,32,1,-12,37,31,-11,10,-1,1,35,32,38,22,2,-13,58,83,44,5,9,-4,26,36,6,-22,5,-1,32,47,38,27,4,-3,327,200,127,212,113,99,54,67,111,62,6,22,34,34,83,36,7,5,20,33,28,26,-1,17,12,65,82,44,3,2,8,31,45,26,2,0,4,34,37,18,1,2,123,41,82,75,3,72,21,55,32,1,6,8,14,22,14,-11,0,0,7,33,18,12,6,8,19,46,20,-10,-1,1,8,17,-2,-17,-3,0,11,29,22,7,2,1,-129,-84,-45,-206,-134,-72,-31,32,-33,-51,-44,-8,-5,-3,-7,-37,-28,-7,-26,35,-26,-14,-16,-1,-37,22,-71,-70,-41,-8,-10,1,-46,-52,-24,-3,-27,21,-25,-18,-17,-5,181,93,88,168,73,95,45,42,25,40,22,8,30,25,9,17,8,3,15,17,16,23,14,5,39,53,22,39,13,1,21,24,6,13,8,1,18,29,16,26,5,0,162,79,83,77,24,53,30,51,56,34,-4,-9,20,20,22,20,0,-3,10,31,34,14,-4,-6,14,32,21,14,-4,-1,12,11,-1,0,2,0,2,21,22,14,-6,-1,86,48,38,-29,-34,5,58,38,-5,20,-16,-2,30,12,-2,26,-15,-1,28,26,-3,-6,-1,-1,23,28,-56,-7,-17,0,8,13,-35,-7,-13,-1,15,15,-21,0,-4,1,21,11,10,-26,-11,-15,41,-5,16,-30,-6,13,25,-5,13,-23,1,7,16,0,3,-7,-7,6,28,1,-10,-27,-17,-3,14,-1,-3,-14,-6,-1,14,2,-7,-13,-11,-2,27,14,13,-15,-11,-4,19,12,5,3,-20,-3,2,4,16,0,-12,-2,17,8,-11,3,-8,-1,14,5,11,-32,-21,0,10,-5,12,-19,-14,0,4,10,-1,-13,-7,0,128,69,59,-9,-24,15,48,35,40,-4,-6,17,32,23,21,-15,-2,12,16,12,19,11,-4,5,13,22,-5,-29,-12,2,9,14,-7,-28,-11,-1,4,8,2,-1,-1,3,-56,-45,-11,-12,-2,-10,-13,4,-17,-17,-31,21,-15,6,-5,-14,-18,5,2,-2,-12,-3,-13,16,4,12,-2,-20,-12,4,-1,14,2,-8,-10,0,5,-2,-4,-12,-2,4
22,22125,Huesca,45627,-17,-4,-13,11,7,4,-29,20,-10,0,-24,27,-17,-2,21,4,-15,8,-12,22,-31,-4,-9,19,1,1,4,3,1,1,0,1,3,2,1,0,1,0,1,1,0,1,3,-11,14,9,4,5,-12,7,44,-25,-42,33,-11,5,24,-17,-27,15,-1,2,20,-8,-15,18,1,1,3,1,0,2,1,0,1,1,0,0,0,1,2,0,0,2,-71,-54,-17,-19,-4,-15,-22,-8,-10,-28,-4,16,-18,-3,13,-31,-9,5,-4,-5,-23,3,5,11,0,-7,-13,-4,2,3,0,0,-5,-2,1,2,0,-7,-8,-2,1,1,-68,-2,-66,53,23,30,33,0,24,-77,-34,-10,44,-6,23,-48,-17,3,-11,6,1,-29,-17,-13,16,12,19,3,5,-3,10,6,6,-2,4,-1,6,6,13,5,1,-2,521,271,250,527,268,259,29,236,208,17,-29,57,22,100,141,7,-31,30,7,136,67,10,2,27,72,153,191,77,23,6,37,61,111,45,9,2,35,92,80,32,14,4,545,310,235,532,287,245,144,161,131,95,-3,5,80,90,86,43,5,-1,64,71,45,52,-8,6,96,142,177,77,29,7,50,74,102,41,15,2,46,68,75,36,14,5,839,466,373,632,320,312,186,205,282,125,28,4,118,128,159,46,6,5,68,77,123,79,22,-1,120,157,196,111,39,5,74,74,113,45,11,2,46,83,83,66,28,3,1227,637,590,889,471,418,195,302,387,207,67,62,94,169,207,93,37,35,101,133,180,114,30,27,176,259,260,143,44,7,97,131,148,73,21,1,79,128,112,70,23,6,787,421,366,543,293,250,187,220,241,121,-19,29,79,116,125,87,-5,14,108,104,116,34,-14,15,97,180,194,56,8,0,38,95,118,30,8,1,59,85,76,26,0,-1,367,114,253,168,73,95,83,120,24,72,5,60,43,70,-18,17,-14,16,40,50,42,55,19,44,45,80,35,-11,18,3,36,44,19,-24,1,-1,9,36,16,13,17,4,129,-23,152,224,85,139,40,63,3,-16,-3,48,11,38,-37,-41,-10,19,29,25,40,25,7,29,46,96,42,34,4,-2,17,45,15,2,3,2,29,51,27,32,1,-4,-219,-220,1,-95,-109,14,34,10,-164,-41,-75,23,-4,18,-136,-64,-46,10,38,-8,-28,23,-29,13,19,44,-79,-50,-33,-4,5,13,-64,-48,-19,-1,14,31,-15,-2,-14,-3,4,-46,50,-5,-11,6,-29,-3,2,-40,24,58,-7,-1,-27,-51,16,22,-22,-2,29,11,8,36,9,35,-14,-23,-3,-11,7,19,-15,-24,3,-5,2,16,1,1,-6,-6,40,-6,46,-20,-21,1,8,29,-33,-23,-14,77,-8,1,-32,-10,-7,47,16,28,-1,-13,-7,30,12,34,-26,-43,-4,2,2,18,-13,-28,-7,4,10,16,-13,-15,3,-2,-347,-307,-40,-333,-225,-108,-30,8,-163,-140,-80,55,-32,-10,-127,-102,-52,17,2,18,-36,-38,-28,38,-32,10,-108,-136,-63,-6,-23,3,-74,-92,-37,-3,-9,7,-34,-44,-26,-3,106,25,81,39,-14,53,26,-36,52,14,-3,56,12,-4,7,-6,-8,25,14,-32,45,20,5,31,19,33,7,-11,-2,-11,15,10,-10,-25,-4,-1,4,23,17,14,2,-10,127,68,59,85,27,58,39,48,2,-33,26,49,64,20,-4,-48,17,19,-25,28,6,15,9,30,34,59,9,-32,8,0,31,29,0,-36,-4,1,3,30,9,4,12,-1,300,121,179,146,70,76,110,61,-87,84,21,114,57,48,-65,29,9,47,53,13,-22,55,12,67,58,65,1,11,0,5,39,33,2,-6,-2,-1,19,32,-1,17,2,6
22,22130,Jaca,11374,151,73,78,125,46,79,14,41,53,24,10,7,10,19,27,9,6,1,4,22,26,15,4,6,22,35,40,20,5,3,10,9,19,3,3,2,12,26,21,17,2,1,376,179,197,237,99,138,57,110,130,58,13,2,27,46,63,32,7,1,30,64,67,26,6,1,45,66,76,41,6,1,21,22,34,17,4,0,24,44,42,24,2,1,278,154,124,169,82,87,39,85,112,23,4,10,18,45,67,16,1,6,21,40,45,7,3,4,45,45,45,21,8,4,22,19,26,10,3,1,23,26,19,11,5,3,337,151,186,188,82,106,64,63,110,49,24,21,24,35,53,17,9,9,40,28,57,32,15,12,43,45,54,23,16,6,19,19,23,9,7,4,24,26,31,14,9,2,223,134,89,162,76,86,46,73,101,23,-12,-8,21,39,62,28,-10,-7,25,34,39,-5,-2,-1,34,36,64,22,7,-1,15,18,30,12,1,0,19,18,34,10,6,-1,258,166,92,193,106,87,43,46,78,73,23,2,28,33,47,49,16,-2,15,13,31,24,7,4,47,34,53,43,15,1,29,13,30,27,7,0,18,21,23,16,8,1,129,54,75,193,85,108,17,60,41,3,5,7,1,25,22,-3,3,6,16,35,19,6,2,1,36,42,61,40,7,6,14,12,28,26,2,3,22,30,33,14,5,3,253,122,131,247,128,119,72,65,68,28,18,11,45,36,33,8,4,-1,27,29,35,20,14,12,59,60,59,43,21,3,30,33,27,27,9,0,29,27,32,16,12,3,87,66,21,120,66,54,11,51,-4,8,13,17,11,25,17,-5,10,9,0,26,-21,13,3,8,19,38,34,24,6,-1,13,16,26,11,0,0,6,22,8,13,6,-1,-24,-55,31,-54,-37,-17,-10,14,8,-26,-16,6,-12,4,-6,-23,-17,-3,2,10,14,-3,1,9,3,1,-11,-30,-11,-7,6,7,-14,-20,-11,-5,-3,-6,3,-10,0,-2,0,24,-24,25,10,15,11,13,-30,3,1,8,15,23,-25,5,1,5,-4,-10,-5,-2,0,3,13,8,0,9,-4,-1,4,2,-1,6,-1,0,9,6,1,3,-3,-1,-11,-26,15,28,4,24,-5,2,7,-26,-3,10,-2,-1,-2,-15,-10,3,-3,3,9,-11,7,7,10,8,6,-2,1,4,2,3,0,1,-3,2,8,5,6,-3,4,2,-39,-23,-16,-93,-53,-40,-7,19,-14,-49,3,5,-1,6,-8,-35,3,9,-6,13,-6,-14,0,-4,-7,-9,-44,-25,-3,-6,-3,-6,-25,-16,-2,-2,-4,-3,-19,-9,-1,-4,-66,-29,-37,-60,-46,-14,21,-12,-28,-34,-21,3,19,11,-27,-20,-20,5,2,-23,-1,-14,-1,-2,5,2,-28,-29,-14,3,-1,3,-20,-17,-12,1,6,-1,-8,-12,-2,2,-24,3,-27,-85,-37,-48,28,5,-16,-15,-23,-7,18,10,-9,-9,-9,2,10,-5,-7,-6,-14,-9,-10,-4,-28,-24,-19,-2,1,0,-16,-16,-6,0,-11,-4,-12,-8,-13,-2,-105,-69,-36,-6,-6,0,-12,2,-57,-25,-14,8,-4,1,-39,-15,-14,6,-8,1,-18,-10,0,2,7,3,-10,-12,4,1,8,1,-12,-4,1,0,-1,2,2,-8,3,1,38,24,14,60,25,35,-10,20,10,-10,24,7,3,7,0,-8,15,6,-13,13,10,-2,9,1,4,23,14,5,13,0,1,10,5,4,4,0,3,13,9,1,9,0,-11,-22,11,46,19,27,6,6,-2,-27,-13,13,4,14,-15,-31,-3,5,2,-8,13,4,-10,8,12,13,14,3,-3,5,6,8,3,-4,4,1,6,5,11,7,-7,4
22,22158,Monzón,14577,203,132,71,157,107,50,52,34,92,35,2,-18,30,18,64,23,-1,-7,22,16,28,12,3,-11,23,36,67,26,4,1,15,25,48,17,1,1,8,11,19,9,3,0,188,161,27,220,156,64,24,49,80,36,-16,12,21,46,68,31,-12,5,3,3,12,5,-4,7,29,57,94,33,3,1,18,44,71,20,1,0,11,13,23,13,2,1,254,140,114,211,111,100,51,58,94,37,4,2,13,33,60,24,4,3,38,25,34,13,0,-1,41,51,75,33,7,0,15,25,48,19,2,0,26,26,27,14,5,0,103,65,38,170,88,82,30,16,39,27,-5,0,14,12,27,11,0,2,16,4,12,16,-5,-2,39,35,56,35,3,0,19,18,31,15,2,1,20,17,25,20,1,-1,259,128,131,265,139,126,48,69,66,43,21,10,26,36,38,19,5,0,22,33,28,24,16,10,52,80,79,36,11,1,22,43,47,21,1,1,30,37,32,15,10,0,332,214,118,239,129,110,52,68,125,59,13,8,37,34,75,44,10,10,15,34,50,15,3,-2,51,62,71,36,10,4,32,31,39,20,5,2,19,31,32,16,5,2,261,155,106,248,142,106,46,59,96,41,6,9,37,28,48,35,1,5,9,31,48,6,5,4,42,68,74,37,18,6,26,35,49,19,9,3,16,33,25,18,9,3,443,238,205,301,175,126,107,108,129,90,13,-5,58,66,62,54,4,-5,49,42,67,36,9,0,51,80,84,71,14,0,40,42,46,40,7,-1,11,38,38,31,7,1,333,224,109,251,159,92,52,66,137,60,28,-11,38,38,87,50,15,-4,14,28,50,10,13,-7,51,54,79,48,13,5,35,35,44,35,7,3,16,19,35,13,6,2,2,27,-25,36,21,15,4,21,-22,-10,19,-6,26,14,-19,-7,14,0,-22,7,-3,-3,5,-6,9,28,-3,-1,5,-6,13,12,-6,-4,6,-3,-4,16,3,3,-1,-3,38,-8,46,52,16,36,37,13,5,-4,-25,5,16,-1,-3,-13,-13,4,21,14,8,9,-12,1,19,21,4,13,-5,-2,8,12,-4,2,-4,1,11,9,8,11,-1,-3,-101,-78,-23,-24,-40,16,-36,11,-41,-16,-7,-10,-29,1,-35,-14,2,0,-7,10,-6,-2,-9,-10,-2,16,-23,-3,-6,-6,-11,0,-23,-1,-2,-3,9,16,0,-2,-4,-3,19,13,6,-7,-15,8,6,18,-9,-1,3,0,10,4,-2,3,-4,1,-4,14,-7,-4,7,-1,-1,13,-10,-7,-5,1,2,1,-9,-7,-4,1,-3,12,-1,0,-1,0,-18,-19,1,-63,-49,-14,-1,-25,26,-14,-6,-1,2,-11,11,-17,-8,4,-3,-14,15,3,2,-5,-19,-11,-8,-20,-10,2,-11,-8,-6,-16,-9,0,-8,-3,-2,-4,-1,2,12,5,7,-59,-40,-19,9,27,-2,-19,-2,-5,6,7,0,-5,-8,3,3,20,-2,-14,6,-8,-5,18,-18,-33,-16,-6,-1,3,-9,-21,-12,-1,-4,15,-9,-12,-4,-5,52,-23,75,-49,-58,9,18,3,23,-1,-7,9,-5,1,-13,-8,-10,7,23,2,36,7,3,2,-6,8,-2,-33,-20,-1,-5,1,-7,-30,-19,-1,-1,7,5,-3,-1,0,-38,-32,-6,-50,-41,-9,8,-6,-7,-27,-30,17,8,-8,-3,-18,-19,6,0,2,-4,-9,-11,11,2,-2,-10,-25,-16,0,5,-1,-12,-20,-14,0,-3,-1,2,-5,-2,0,-60,-21,-39,-25,-13,-12,-8,-4,-4,-42,7,-9,7,-2,11,-34,1,-2,-15,-2,-15,-8,6,-7,-7,16,-4,-22,-9,-1,3,6,2,-19,-7,2,-10,10,-6,-3,-2,-3
22,22213,Sariñena,4026,-7,0,-7,27,20,7,-2,5,1,-5,-5,-3,-3,3,0,1,0,-2,1,2,1,-6,-5,-1,2,6,13,2,2,1,0,4,11,2,1,1,2,2,2,0,1,0,54,37,17,57,30,27,11,6,16,15,1,4,9,4,12,13,-1,0,2,2,4,2,2,4,13,11,24,7,2,0,7,4,12,6,1,0,6,7,12,1,1,0,31,22,9,42,22,20,8,5,15,6,0,-3,5,5,9,0,-1,4,3,0,6,6,1,-7,10,12,14,6,0,0,4,7,9,1,1,0,6,5,5,5,-1,0,74,50,24,46,26,20,19,17,19,14,2,4,17,12,15,5,0,2,2,5,4,9,2,2,10,18,16,1,1,0,7,11,8,0,0,0,3,7,8,1,1,0,31,32,-1,71,35,36,10,9,-2,10,8,-3,9,9,-1,10,7,-2,1,0,-1,0,1,-1,21,16,23,6,3,2,11,10,10,1,3,0,10,6,13,5,0,2,95,53,42,60,36,24,34,16,18,12,11,2,19,8,7,11,6,0,15,8,11,1,5,2,7,19,17,7,7,2,4,12,11,4,4,0,3,7,6,3,3,2,104,54,50,104,51,53,32,36,13,11,9,1,9,27,12,6,-2,0,23,9,1,5,11,1,32,35,19,13,6,-1,13,20,10,7,1,0,19,15,9,6,5,-1,93,66,27,93,47,46,30,13,35,16,-1,1,17,6,26,15,1,2,13,7,9,1,-2,-1,17,30,21,23,1,1,9,17,8,13,0,0,8,13,13,10,1,1,165,109,56,81,50,31,23,40,59,22,9,8,13,23,44,19,4,4,10,17,15,3,5,4,19,22,26,10,4,0,13,11,16,9,1,0,6,11,10,1,3,0,-10,-4,-6,2,5,-3,4,-3,-13,0,-3,2,1,-1,-8,4,-1,1,3,-2,-5,-4,-2,1,1,2,0,0,-1,-1,4,1,-3,3,0,0,-3,1,3,-3,-1,-1,-20,-16,-4,2,-5,7,-8,-8,-25,18,-8,11,-5,0,-16,6,-3,2,-3,-8,-9,12,-5,9,2,3,-4,3,-1,-2,0,4,-5,-1,-2,-1,2,-1,1,4,1,-1,14,9,5,15,8,7,2,21,1,-2,0,-5,-4,9,6,1,-1,0,6,12,-5,-3,1,-5,2,12,3,-1,-2,1,4,5,4,-4,-1,0,-2,7,-1,3,-1,1,-44,-29,-15,-25,-21,-4,-2,-9,-16,-15,-5,2,3,-4,-6,-14,-9,0,-5,-5,-10,-1,4,2,2,-2,-11,-13,-1,0,2,-1,-10,-13,0,1,0,-1,-1,0,-1,-1,-10,-20,10,-21,-25,4,2,6,-15,-3,1,-6,-5,-10,-3,-5,3,-2,7,16,-12,2,-2,-4,2,2,-12,-10,-7,2,-1,-4,-11,-6,-5,1,3,6,-1,-4,-2,1,-48,-25,-23,-8,-5,-3,-4,7,-38,-1,-10,-2,-1,1,-14,-3,-6,-1,-3,6,-24,2,-4,-1,-2,8,-5,-1,-7,-1,0,4,0,-4,-4,-1,-2,4,-5,3,-3,0,-22,-7,-15,11,5,6,-1,0,-16,-1,0,-4,0,-3,-11,2,3,2,-1,3,-5,-3,-3,-6,3,7,7,-4,-2,0,3,2,4,-4,-1,1,0,5,3,0,-1,-1,-3,2,-5,11,4,7,7,10,-10,0,-4,-5,0,11,-6,6,-4,-3,7,-1,-4,-6,0,-2,2,7,1,0,-1,1,1,5,-2,1,-2,1,1,2,3,-1,1,0,14,17,-3,19,14,5,-4,5,5,13,0,-6,-3,6,3,11,-2,0,-1,-1,2,2,2,-6,0,0,9,10,0,-1,-1,3,6,4,0,1,1,-3,3,6,0,-2
22,22217,Sena,591,11,19,-8,12,11,1,0,6,6,-1,-1,1,0,9,9,1,0,0,0,-3,-3,-2,-1,1,0,6,5,1,0,0,0,5,5,1,0,0,0,1,0,0,0,0,2,6,-4,9,6,3,1,4,5,1,-1,-8,2,3,4,2,0,-5,-1,1,1,-1,-1,-3,1,3,5,0,0,0,1,2,3,0,0,0,0,1,2,0,0,0,28,26,2,21,13,8,4,11,5,6,0,1,3,7,8,6,0,1,1,4,-3,0,0,0,5,4,6,6,0,0,2,1,6,4,0,0,3,3,0,2,0,0,-25,-19,-6,4,3,1,-2,-4,-15,-3,-2,0,-2,-3,-10,-4,-1,0,0,-1,-5,1,-1,0,0,0,2,1,0,0,0,0,2,0,0,0,0,0,0,1,0,0,-5,-2,-3,10,9,1,2,-3,3,-2,-1,-4,0,0,1,0,1,-4,2,-3,2,-2,-2,0,1,3,3,3,0,0,1,3,2,3,0,0,0,0,1,0,0,0,13,-2,15,11,4,7,6,4,-1,1,3,0,3,0,-7,0,2,0,3,4,6,1,1,0,3,3,5,0,0,0,2,1,1,0,0,0,1,2,4,0,0,0,-6,2,-8,16,11,5,1,8,-4,-3,-3,-5,1,5,0,-1,-1,-2,0,3,-4,-2,-2,-3,5,5,5,1,0,0,3,3,4,1,0,0,2,2,1,0,0,0,4,1,3,13,10,3,3,5,-5,0,4,-3,4,2,-3,-3,3,-2,-1,3,-2,3,1,-1,5,4,3,1,0,0,5,3,3,-1,0,0,0,1,0,2,0,0,-15,-12,-3,5,3,2,-9,1,-12,0,4,1,-6,1,-9,0,1,1,-3,0,-3,0,3,0,0,3,1,1,0,0,0,1,1,1,0,0,0,2,0,0,0,0,3,1,2,6,3,3,0,-2,-2,1,0,6,0,-1,1,-1,-1,3,0,-1,-3,2,1,3,1,0,4,0,1,0,0,0,3,0,0,0,1,0,1,0,1,0,-6,-9,3,-6,-8,2,2,2,-4,-2,-2,-2,1,0,-4,-3,-2,-1,1,2,0,1,0,-1,1,2,-4,-1,-3,-1,1,0,-4,-2,-2,-1,0,2,0,1,-1,0,2,-1,3,1,1,0,2,6,-6,0,2,-2,0,3,-3,-1,1,-1,2,3,-3,1,1,-1,0,2,0,-1,0,0,0,1,1,-1,0,0,0,1,-1,0,0,0,-8,-3,-5,0,1,-1,2,-1,0,-7,0,-2,0,2,-1,-4,1,-1,2,-3,1,-3,-1,-1,0,-1,1,0,0,0,0,0,1,0,0,0,0,-1,0,0,0,0,-12,-6,-6,0,-2,2,-8,-1,-2,-1,-2,2,-5,-1,0,0,-1,1,-3,0,-2,-1,-1,1,0,1,-1,0,0,0,-1,0,-1,0,0,0,1,1,0,0,0,0,7,4,3,-3,-2,-1,-2,4,-4,5,2,2,-1,2,-1,3,1,0,-1,2,-3,2,1,2,0,1,-2,1,-3,0,0,1,-2,1,-2,0,0,0,0,0,-1,0,-3,0,-3,-2,-1,-1,1,4,0,-4,0,-3,1,3,1,-2,0,-3,0,1,-1,-2,0,0,-1,0,-1,0,0,0,-1,0,0,0,0,0,0,0,-1,0,0,0,-16,-13,-3,-1,-1,0,-7,0,-5,-3,1,-1,-7,0,-3,-3,-1,1,0,0,-2,0,2,-2,-2,1,0,0,0,0,-2,1,0,0,0,0,0,0,0,0,0,0,14,4,10,6,1,5,4,1,4,5,1,0,0,2,2,3,-1,-2,4,-1,2,2,2,2,0,0,5,1,-1,1,0,0,2,1,-2,0,0,0,3,0,1,1
22,22225,Tamarite de Litera,3777,15,20,-5,19,15,4,-6,14,9,-1,-2,-1,-1,10,11,1,-1,-1,-5,4,-2,-2,-1,0,1,11,5,2,0,0,0,8,5,2,0,0,1,3,0,0,0,0,-14,8,-22,24,17,7,-5,5,-8,-4,1,-4,1,4,1,0,2,-1,-6,1,-9,-4,-1,-3,1,10,11,0,0,0,1,5,9,0,0,0,0,5,2,0,0,0,22,11,11,31,19,12,7,-2,8,8,3,-2,5,1,2,5,1,-3,2,-3,6,3,2,1,6,9,8,6,0,2,3,5,7,3,0,1,3,4,1,3,0,1,22,2,20,23,12,11,2,2,-1,4,5,9,-1,1,-5,0,3,4,3,1,4,4,2,5,2,9,6,4,0,1,1,6,4,1,0,0,1,3,2,3,0,1,-4,7,-11,54,38,16,-2,0,11,-2,-4,-5,-3,5,11,-2,0,-1,1,-5,0,0,-4,-4,8,10,24,5,5,1,4,7,20,3,4,0,4,3,4,2,1,1,43,12,31,40,19,21,20,9,3,6,1,1,5,3,-1,3,-1,3,15,6,4,3,2,-2,12,12,10,6,0,0,3,5,6,5,0,0,9,7,4,1,0,0,60,45,15,63,46,17,11,14,32,6,0,-5,3,14,25,4,-1,-1,8,0,7,2,1,-4,3,21,28,4,4,3,1,17,22,3,2,1,2,4,6,1,2,2,19,19,0,48,26,22,2,14,-5,3,3,0,6,8,-2,4,2,-1,-4,6,-3,-1,1,1,6,15,10,13,1,1,3,8,6,6,1,1,3,7,4,7,0,0,63,29,34,39,23,16,16,13,14,13,1,3,10,7,7,2,2,-1,6,6,7,11,-1,4,8,8,17,4,2,-1,5,6,12,-1,1,0,3,2,5,5,1,-1,0,-5,5,21,10,11,3,6,-5,-7,-1,3,3,3,-8,-6,-1,4,0,3,3,-1,0,-1,4,9,4,2,0,1,4,6,1,-1,0,0,0,3,3,3,0,1,14,18,-4,27,15,12,3,0,-3,8,-1,7,5,3,-4,11,1,2,-2,-3,1,-3,-2,5,10,6,5,5,1,-1,7,4,1,2,1,0,3,2,4,3,0,-1,-44,-25,-19,-16,-10,-6,-4,-3,-23,-13,7,-7,-5,-3,-12,-8,7,-3,1,0,-11,-5,0,-4,-1,3,-8,-9,-1,0,1,1,-5,-6,-1,0,-2,2,-3,-3,0,0,8,3,5,-13,-12,-1,10,10,7,-4,-7,-11,6,8,3,-5,-1,-10,4,2,4,1,-6,-1,-1,6,-6,-9,-2,-1,1,3,-4,-9,-2,-1,-2,3,-2,0,0,0,10,1,9,-6,3,-9,9,-2,-2,7,-6,4,4,-3,5,3,-6,-2,5,1,-7,4,0,6,3,0,-4,-3,-1,-1,3,2,1,-2,0,-1,0,-2,-5,-1,-1,0,-45,-12,-33,5,8,-3,-5,-1,-18,-19,-3,-2,2,6,-8,-15,2,-1,-7,-7,-10,-4,-5,-1,2,8,-3,-5,3,0,2,8,-3,-2,3,0,0,0,0,-3,0,0,17,15,2,13,6,7,2,-9,1,17,6,-2,1,-4,0,15,3,-1,1,-5,1,2,3,-1,1,2,3,5,2,0,-1,1,1,4,1,0,2,1,2,1,1,0,4,9,-5,9,13,-4,9,13,-6,-3,-1,-8,6,12,-4,-3,-1,-2,3,1,-2,0,0,-6,9,8,1,-7,0,-2,9,7,3,-5,0,-1,0,1,-2,-2,0,-1,45,24,21,51,32,19,12,18,4,-2,12,-2,12,8,2,2,2,-3,0,10,2,-4,10,1,10,18,9,7,4,2,6,11,7,6,1,1,4,7,2,1,3,1
23,23002,Alcalá la Real,21521,-46,-20,-26,16,9,7,-14,-19,-24,-3,8,2,-7,-4,-13,0,5,-3,-7,-15,-11,-3,3,5,0,2,5,2,5,2,0,1,2,1,3,2,0,1,3,1,2,0,-40,-15,-25,19,10,9,4,-25,-24,-1,13,-5,0,-14,-9,-3,12,1,4,-11,-15,2,1,-6,1,8,2,2,3,3,1,3,1,1,2,2,0,5,1,1,1,1,130,88,42,54,25,29,38,2,54,18,13,-8,24,10,37,5,7,-1,14,-8,17,13,6,-7,13,7,20,8,2,4,7,3,11,3,-1,2,6,4,9,5,3,2,72,57,15,81,53,28,33,2,-11,27,17,2,21,6,1,7,15,5,12,-4,-12,20,2,-3,12,19,19,18,13,0,6,12,14,12,9,0,6,7,5,6,4,0,210,124,86,146,85,61,45,22,73,48,26,-16,20,6,51,24,16,-1,25,16,22,24,10,-15,19,36,49,28,11,1,8,18,33,15,8,1,11,18,16,13,3,0,113,75,38,140,82,58,46,-19,36,20,42,-14,14,-4,29,16,21,-3,32,-15,7,4,21,-11,27,22,44,24,17,3,16,12,30,12,10,1,11,10,14,12,7,2,167,73,94,140,65,75,34,15,12,50,52,-2,7,5,7,26,27,-3,27,10,5,24,25,1,26,27,20,37,26,4,10,14,7,20,13,1,16,13,13,17,13,3,298,203,95,279,172,107,31,83,73,77,48,-17,14,66,55,43,27,-3,17,17,18,34,21,-14,28,84,79,56,26,4,15,57,48,37,13,2,13,27,31,19,13,2,195,115,80,121,62,59,41,19,30,42,71,-10,14,16,19,27,35,4,27,3,11,15,36,-14,18,30,30,21,16,4,8,13,20,8,9,3,10,17,10,13,7,1,47,43,4,87,51,36,14,7,17,20,9,-22,5,14,8,21,3,-11,9,-7,9,-1,6,-11,13,17,23,16,15,1,7,7,14,13,8,1,6,10,9,3,7,0,37,23,14,88,51,37,33,0,-20,8,27,-7,15,1,2,-5,15,-3,18,-1,-22,13,12,-4,14,14,25,14,19,2,9,8,16,7,10,1,5,6,9,7,9,1,184,137,47,86,45,41,16,38,70,26,23,6,10,21,59,27,10,8,6,17,11,-1,13,-2,9,11,24,18,21,3,2,7,17,13,6,0,7,4,7,5,15,3,-54,-77,23,38,5,33,3,7,-75,14,18,-24,-8,-10,-62,3,4,-7,11,17,-13,11,14,-17,3,10,-2,7,13,5,-1,4,-8,2,3,3,4,6,6,5,10,2,-118,-72,-46,7,12,-5,-12,-30,-45,-27,14,-16,-6,-21,-31,-19,12,-2,-6,-9,-14,-8,2,-14,1,-2,-8,2,12,1,2,1,-2,1,7,2,-1,-3,-6,1,5,-1,-78,-46,-32,41,26,15,-17,-9,-29,-14,17,-29,-19,-1,-23,-11,11,-3,2,-8,-6,-3,6,-26,-5,14,12,2,12,3,-3,8,9,2,6,2,-2,6,3,0,6,1,-240,-129,-111,-101,-58,-43,-33,-35,-107,-33,-13,-21,-14,-22,-56,-24,-8,-6,-19,-13,-51,-9,-5,-15,-7,-11,-32,-32,-14,-6,-2,-7,-18,-23,-5,-4,-5,-4,-14,-9,-9,-2,4,1,3,50,19,31,1,0,7,-26,30,-8,-1,-1,5,-13,14,-3,2,1,2,-13,16,-5,1,10,6,7,17,7,-1,0,1,5,9,3,2,10,5,2,8,4,2,-8,10,32,6,26,22,-7,-4,8,8,-23,19,-10,-5,-5,-7,-1,3,3,1,13,15,-22,10,6,10,-9,11,2,3,-1,10,-13,3,2,7,7,0,4,8,0
23,23005,Andújar,38254,-90,-66,-24,70,30,40,-12,-59,-47,0,14,12,-11,-32,-24,-8,7,3,-1,-27,-23,8,7,9,13,15,17,10,14,1,9,4,7,4,6,0,4,11,10,6,8,1,-77,-54,-23,63,30,33,-11,-20,-45,-12,5,4,0,-12,-45,-8,2,9,-11,-8,0,-4,3,-5,13,10,23,12,4,0,8,8,4,8,2,0,5,2,19,4,2,0,-151,-84,-67,39,13,26,-39,-25,-68,-9,1,-10,-22,-12,-47,1,4,-6,-17,-13,-21,-10,-3,-4,5,11,8,12,4,-1,2,5,2,3,2,-1,3,6,6,9,2,0,21,19,2,108,45,63,8,12,5,1,0,-8,13,2,-3,2,5,-2,-5,10,8,-1,-5,-6,15,34,29,20,7,1,6,12,14,10,3,0,9,22,15,10,4,1,74,38,36,101,49,52,19,10,28,7,-3,17,1,6,14,15,0,5,18,4,14,-8,-3,12,13,24,29,26,6,2,9,11,11,14,3,1,4,13,18,12,3,1,68,43,25,141,59,82,19,21,-21,15,25,9,-1,4,6,3,20,12,20,17,-27,12,5,-3,29,42,41,21,7,0,12,12,19,10,5,1,17,30,22,11,2,-1,34,27,7,201,117,84,5,6,-15,0,41,-2,1,11,-7,3,22,0,4,-5,-8,-3,19,-2,29,53,63,35,16,3,19,26,41,20,10,1,10,27,22,15,6,2,190,134,56,394,237,157,30,53,34,50,27,-7,11,42,30,39,11,-1,19,11,4,11,16,-6,55,88,127,88,27,9,30,53,78,56,14,6,25,35,49,32,13,3,-4,-18,14,160,81,79,13,0,-41,22,17,-12,0,0,-29,3,18,-3,13,0,-12,19,-1,-9,23,45,49,28,13,1,12,17,27,18,6,1,11,28,22,10,7,0,47,26,21,97,39,58,42,-21,-38,40,22,5,15,-22,-20,26,20,5,27,1,-18,14,2,0,23,27,24,11,9,3,10,6,15,3,4,1,13,21,9,8,5,2,-86,-34,-52,65,33,32,-16,-24,-58,-12,-2,20,8,-6,-23,-11,-12,9,-24,-18,-35,-1,10,11,12,13,25,3,9,3,12,6,15,-4,2,2,0,7,10,7,7,1,38,49,-11,52,28,24,30,-17,-7,29,20,-16,7,14,19,22,4,-17,23,-31,-26,7,16,1,9,29,15,3,-1,-4,2,16,6,6,2,-4,7,13,9,-3,-3,0,-101,-15,-86,52,31,21,-21,-30,-23,25,-28,-23,-3,-16,-5,30,-10,-7,-18,-14,-18,-5,-18,-16,21,-1,12,16,4,-1,14,-6,12,13,-1,-1,7,5,0,3,5,0,-261,-171,-90,-43,-38,-5,17,-44,-108,-88,-16,-18,15,-21,-85,-66,-10,-4,2,-23,-23,-22,-6,-14,0,2,-9,-32,-8,3,2,2,-13,-24,-6,1,-2,0,4,-8,-2,2,-213,-113,-100,27,17,10,-29,-66,-55,-37,12,-32,-22,-28,-33,-23,3,-8,-7,-38,-22,-14,9,-24,4,3,3,11,6,0,0,3,3,6,4,1,4,0,0,5,2,-1,-235,-127,-108,-18,-12,-6,-47,-19,-105,-70,-2,0,-19,-16,-47,-43,-5,-1,-28,-3,-58,-27,3,1,-7,6,0,-17,2,-2,-5,1,3,-11,1,-1,-2,5,-3,-6,1,-1,-287,-175,-112,1,-2,3,-40,-49,-73,-75,-19,-20,-25,-21,-51,-38,-17,-12,-15,-28,-22,-37,-2,-8,4,9,-1,-13,2,0,4,6,1,-10,-2,-1,0,3,-2,-3,4,1,-676,-356,-320,-261,-141,-120,-84,-108,-226,-155,-78,-26,-43,-56,-115,-88,-44,-11,-41,-52,-111,-67,-34,-15,-16,-28,-74,-85,-53,-5,-7,-16,-41,-47,-28,-2,-9,-12,-33,-38,-25,-3
23,23009,Baeza,15841,-1,1,-2,34,19,15,5,-9,-11,17,-6,-1,-5,4,-7,16,-7,0,10,-13,-4,1,1,-1,4,9,12,5,2,0,2,5,8,2,2,0,2,4,4,3,0,0,39,35,4,27,20,7,24,-13,12,11,-3,7,16,-5,12,9,0,3,8,-8,0,2,-3,4,1,5,12,7,2,0,0,4,11,4,1,0,1,1,1,3,1,0,47,61,-14,14,11,3,1,-6,5,28,2,17,1,11,13,20,0,14,0,-17,-8,8,2,3,0,1,7,5,1,0,0,0,6,4,1,0,0,1,1,1,0,0,79,48,31,31,16,15,29,3,17,16,18,0,17,11,7,4,10,-2,12,-8,10,12,8,2,6,9,11,4,0,0,3,5,5,2,0,0,3,4,6,2,0,0,195,97,98,69,34,35,50,44,73,5,19,7,21,23,37,-2,11,7,29,21,36,7,8,0,12,28,18,9,2,0,7,14,10,3,0,0,5,14,8,6,2,0,187,108,79,58,32,26,44,11,67,22,14,29,24,4,52,6,11,11,20,7,15,16,3,18,4,14,27,8,4,0,1,9,16,3,3,0,3,5,11,5,1,0,100,56,44,41,21,20,24,-6,-8,55,14,20,14,2,-9,30,7,8,10,-8,1,25,7,12,4,9,12,15,0,0,2,4,7,8,0,0,2,5,5,7,0,0,107,72,35,128,74,54,37,19,22,16,11,-1,25,13,19,4,10,2,12,6,3,12,1,-3,21,38,40,25,4,0,11,19,26,16,2,0,10,19,14,9,2,0,15,5,10,3,-4,7,21,21,-7,-21,6,-7,11,10,1,-17,3,-1,10,11,-8,-4,3,-6,2,14,-4,-8,0,-1,2,8,0,-10,-2,-2,0,6,-4,2,2,1,110,59,51,37,17,20,25,18,41,38,1,-15,9,17,29,14,0,-12,16,1,12,24,1,-3,2,18,15,2,0,0,2,12,3,1,-1,0,0,6,12,1,1,0,59,66,-7,33,17,16,25,2,13,5,11,-4,13,8,26,10,9,-4,12,-6,-13,-5,2,0,4,10,3,7,6,0,0,4,5,3,3,0,4,6,-2,4,3,0,197,131,66,45,25,20,38,28,74,33,12,0,25,16,52,28,5,4,13,12,22,5,7,-4,11,13,18,2,-1,0,5,6,10,2,1,1,6,7,8,0,-2,-1,-191,-138,-53,-55,-40,-15,-5,-47,-83,-25,-14,-13,-12,-21,-60,-25,-12,-2,7,-26,-23,0,-2,-11,-1,-6,-24,-24,-1,0,0,-6,-14,-18,-2,0,-1,0,-10,-6,1,0,-73,-55,-18,-56,-48,-8,12,-5,-19,-33,-15,-16,10,-6,-11,-28,-12,-7,2,1,-8,-5,-3,-9,-5,-2,-21,-22,-3,-3,-5,-5,-15,-19,-3,-1,0,3,-6,-3,0,-2,-55,-28,-27,-12,-7,-5,-5,1,-24,-11,-4,-10,-5,0,-12,-2,-1,-5,0,1,-12,-9,-3,-5,3,-1,-15,-2,3,0,3,-3,-7,-3,3,0,0,2,-8,1,0,0,-43,-10,-33,32,35,-3,-5,-4,-13,-19,-3,1,4,1,3,-11,-4,-3,-9,-5,-16,-8,1,4,1,9,19,1,-2,3,6,7,18,4,-1,1,-5,2,1,-3,-1,2,-107,-71,-36,-76,-59,-17,-14,-18,-49,-18,0,-6,-5,-9,-32,-18,-4,-5,-9,-9,-17,0,4,-1,-8,-9,-28,-25,-4,-3,-5,-8,-23,-18,-4,-1,-3,-1,-5,-7,0,-2,-56,-15,-41,-3,3,-6,5,-27,-11,3,-20,-13,1,-13,-2,6,-7,-4,4,-14,-9,-3,-13,-9,0,-3,-1,0,-1,1,3,0,-1,-1,1,0,-3,-3,0,1,-2,1
23,23010,Bailén,17481,-33,-15,-18,5,1,4,-3,-8,-18,3,0,-3,-7,-4,-4,-2,3,0,4,-4,-14,5,-3,-3,3,0,2,0,0,0,0,0,1,0,0,0,3,0,1,0,0,0,-27,-17,-10,15,13,2,18,-20,-9,-4,0,-11,3,-6,-11,0,2,-6,15,-14,2,-4,-2,-5,4,6,1,4,0,0,4,5,0,4,0,0,0,1,1,0,0,0,-26,-12,-14,-3,-1,-2,-13,-3,-13,-1,-4,8,-5,-3,6,-6,-4,4,-8,0,-19,5,0,4,0,0,-3,0,0,0,0,0,-1,0,0,0,0,0,-2,0,0,0,14,12,2,5,2,3,11,3,-5,10,3,-7,13,4,-8,3,6,-5,-2,-1,3,7,-3,-2,2,1,0,2,0,0,1,0,0,1,0,0,1,1,0,1,0,0,34,34,0,53,34,19,-9,15,3,26,6,-2,-4,10,3,20,4,4,-5,5,0,6,2,-6,4,16,21,10,1,1,2,7,14,8,1,1,2,9,7,2,0,0,113,78,35,69,52,17,10,31,34,18,17,3,3,16,28,17,10,5,7,15,6,1,7,-2,9,18,24,14,3,0,7,12,18,11,3,0,2,6,6,3,0,0,127,86,41,59,34,25,37,18,29,35,9,-3,24,11,15,24,8,1,13,7,14,11,1,-4,13,13,20,11,0,1,10,10,8,5,0,1,3,3,12,6,0,0,150,78,72,144,81,63,20,38,49,37,7,-5,8,23,23,25,2,-2,12,15,26,12,5,-3,19,35,51,29,9,0,9,23,26,20,3,0,10,12,25,9,6,0,-110,-56,-54,27,15,12,4,-25,-56,-13,-13,-6,8,-8,-30,-11,-12,0,-4,-17,-26,-2,-1,-6,7,10,3,5,0,1,3,9,1,1,1,0,4,1,2,4,-1,1,-74,-62,-12,-23,-24,1,11,-6,-25,-37,-6,-11,12,-11,-10,-33,-13,-5,-1,5,-15,-4,7,-6,-2,3,-8,-14,-3,0,-2,-2,-4,-13,-3,0,0,5,-4,-1,0,0,-60,-12,-48,34,22,12,-25,-9,-10,-11,4,-6,-16,-5,10,-5,9,-7,-9,-4,-20,-6,-5,1,5,8,17,3,0,0,1,5,12,3,0,0,4,3,5,0,0,0,-108,-62,-46,-12,-15,3,-17,-25,-32,-29,-2,-4,-4,-14,-20,-22,-2,1,-13,-11,-12,-7,0,-5,1,-2,-7,-4,-1,1,1,-3,-8,-5,-1,1,0,1,1,1,0,0,-125,-76,-49,-4,-14,10,-22,-18,-53,-12,-20,5,-9,-10,-22,-16,-19,1,-13,-8,-31,4,-1,4,4,3,-10,-2,-3,4,2,0,-6,-6,-5,1,2,3,-4,4,2,3,-162,-91,-71,-37,-26,-11,-31,-25,-65,-19,-18,-1,-22,-11,-41,-9,-9,1,-9,-14,-24,-10,-9,-2,-2,-4,-19,-8,-5,0,-1,-1,-16,-7,-2,0,-1,-3,-3,-1,-3,0,-196,-120,-76,-35,-23,-12,-48,-41,-47,-41,-1,-14,-24,-24,-38,-23,0,-10,-24,-17,-9,-18,-1,-4,-8,-8,0,-16,-2,-1,-5,-5,0,-11,-2,0,-3,-3,0,-5,0,-1,-176,-82,-94,-30,-15,-15,-15,-30,-78,-37,-3,-14,-2,-11,-41,-22,-3,-1,-13,-19,-37,-15,0,-13,-8,1,-9,-13,-1,0,-4,2,-5,-7,-1,0,-4,-1,-4,-6,0,0,-148,-77,-71,23,18,5,-33,-35,-59,-13,-3,-5,-13,-22,-32,-6,-2,-1,-20,-13,-27,-7,-1,-4,5,5,3,5,5,1,4,5,4,3,2,1,1,0,-1,2,3,0,-105,-64,-41,19,11,8,2,-32,-34,-6,-19,-12,-1,-19,-12,-8,-11,-9,3,-13,-22,2,-8,-3,6,4,-2,9,1,1,2,4,1,3,1,0,4,0,-3,6,0,1
23,23028,Cazorla,8643,-47,-30,-17,8,4,4,-24,-20,-5,-8,10,-1,-15,-13,-8,2,4,0,-9,-7,3,-10,6,-1,1,1,0,0,5,1,1,1,0,0,2,0,0,0,0,0,3,1,-11,-3,-8,15,9,6,1,-4,-9,0,7,-5,1,-1,-8,2,5,-1,0,-3,-1,-2,2,-4,5,1,6,3,0,0,4,0,4,1,0,0,1,1,2,2,0,0,-6,3,-9,25,21,4,19,-14,-16,16,-3,-8,12,-7,-3,7,-2,-4,7,-7,-13,9,-1,-4,10,7,4,4,0,0,10,5,2,4,0,0,0,2,2,0,0,0,31,23,8,25,20,5,8,4,10,2,5,1,3,4,9,0,5,0,5,0,1,2,0,1,6,1,11,2,3,1,5,1,9,1,2,1,1,0,2,1,1,0,34,36,-2,15,13,2,7,15,8,-8,10,1,8,10,10,1,5,1,-1,5,-2,-9,5,0,3,4,3,1,4,0,3,3,3,1,3,0,0,1,0,0,1,0,21,42,-21,24,17,7,2,-9,7,11,9,4,6,2,19,8,4,3,-4,-11,-12,3,5,1,1,5,7,5,5,1,1,3,7,3,3,0,0,2,0,2,2,1,-13,-7,-6,17,8,9,-5,-2,2,-2,5,-7,-3,-1,4,-5,2,-1,-2,-1,-2,3,3,-6,3,3,6,4,1,0,2,1,4,3,-2,0,1,2,2,1,3,0,50,47,3,57,41,16,6,11,18,9,12,-6,4,8,21,7,5,3,2,3,-3,2,7,-9,4,15,27,7,4,0,1,8,24,5,3,0,3,7,3,2,1,0,-9,8,-17,24,14,10,0,-1,1,-1,-1,-9,7,0,-1,-3,-1,5,-7,-1,2,2,0,-14,4,8,8,4,0,0,2,6,3,2,1,0,2,2,5,2,-1,0,35,33,2,27,20,7,12,7,13,-3,10,-8,5,10,12,-2,11,-5,7,-3,1,-1,-1,-3,1,16,3,3,4,0,2,11,1,3,3,0,-1,5,2,0,1,0,-35,-27,-8,21,14,7,-3,-12,2,1,-16,-4,-1,-13,0,3,-12,-2,-2,1,2,-2,-4,-2,3,8,8,2,0,0,3,2,6,2,0,1,0,6,2,0,0,-1,10,34,-24,22,16,6,-1,22,-8,7,4,-13,0,14,9,8,5,-2,-1,8,-17,-1,-1,-11,1,10,10,1,1,-1,-1,7,9,1,0,0,2,3,1,0,1,-1,-36,-28,-8,-9,-10,1,-3,-2,-7,-1,-9,-12,-2,-2,-9,-2,-8,-5,-1,0,2,1,-1,-7,-2,0,-3,-2,-3,1,-1,-1,-3,-3,-2,0,-1,1,0,1,-1,1,-70,-44,-26,-5,0,-5,-5,-16,-19,-18,-3,-8,-9,-10,-5,-8,-5,-8,4,-6,-14,-10,2,0,0,0,-5,-1,1,0,1,2,-3,-1,1,0,-1,-2,-2,0,0,0,-85,-35,-50,-22,-16,-6,-12,2,-25,-15,-16,-17,-8,-2,-13,-2,-5,-5,-4,4,-12,-13,-11,-12,-7,6,-9,-7,-2,-2,-6,4,-5,-5,-1,-3,-1,2,-4,-2,-1,1,-12,-12,0,8,4,4,-5,19,-23,-7,7,-8,-8,15,-9,-11,-1,0,3,4,-14,4,8,-8,0,8,-4,-3,3,3,0,7,-2,-3,1,0,0,1,-2,0,2,3,3,-7,10,20,12,8,19,-1,-12,7,4,-10,6,1,-5,-4,4,-6,13,-2,-7,11,0,-4,4,4,2,7,3,0,0,4,1,6,1,0,4,0,1,1,2,0,-40,-6,-34,-14,-9,-5,-2,-13,-8,-9,1,-10,8,0,2,-15,2,-2,-10,-13,-10,6,-1,-8,-3,0,2,-11,-4,1,-1,1,4,-10,-3,0,-2,-1,-2,-1,-1,1
23,23034,Fuensanta de Martos,3372,-21,-10,-11,5,3,2,-4,1,-11,0,0,-6,-2,5,-9,0,0,-3,-2,-4,-2,0,0,-3,0,3,1,1,0,0,0,2,0,1,0,0,0,1,1,0,0,0,-26,-4,-22,8,5,3,-6,-2,-16,2,1,-5,-1,1,-4,0,0,0,-5,-3,-12,2,1,-5,2,3,2,1,0,0,1,3,1,0,0,0,1,0,1,1,0,0,-8,-8,0,13,7,6,-1,1,-13,2,3,-1,-3,0,-7,1,0,1,2,1,-6,1,3,-2,0,7,4,0,1,1,0,2,4,0,0,1,0,5,0,0,1,0,9,1,8,22,15,7,6,10,-2,-5,5,-6,6,6,-6,-6,3,-2,0,4,4,1,2,-4,5,7,5,3,1,0,5,5,2,2,1,0,0,2,3,1,0,0,27,26,1,14,8,6,7,6,11,6,2,-5,5,7,10,5,2,-2,2,-1,1,1,0,-3,0,4,9,1,0,0,0,2,6,0,0,0,0,2,3,1,0,0,-18,-4,-14,20,10,10,-1,-6,-11,1,3,-3,2,-3,-6,4,1,-1,-3,-3,-5,-3,2,-2,5,5,6,4,0,0,2,4,1,3,0,0,3,1,5,1,0,0,5,1,4,14,5,9,-7,8,-6,4,5,1,-9,6,1,1,1,1,2,2,-7,3,4,0,3,4,2,2,3,0,1,2,1,0,1,0,2,2,1,2,2,0,-11,-4,-7,23,11,12,0,5,-10,0,3,-9,0,4,-8,2,2,-4,0,1,-2,-2,1,-5,3,13,3,2,2,0,2,5,0,2,2,0,1,8,3,0,0,0,4,-3,7,7,4,3,4,4,-4,2,-1,-2,2,0,-7,3,-1,-1,2,4,3,-1,0,-1,1,0,3,3,0,0,1,0,1,2,0,0,0,0,2,1,0,0,-2,3,-5,2,0,2,0,-1,3,-3,-1,0,-1,2,2,0,0,0,1,-3,1,-3,-1,0,0,1,-1,1,1,0,0,1,-1,0,0,0,0,0,0,1,1,0,-22,-3,-19,4,2,2,-1,-5,-10,2,-4,-4,-2,4,-5,3,-1,-2,1,-9,-5,-1,-3,-2,0,1,1,2,0,0,0,0,1,1,0,0,0,1,0,1,0,0,46,42,4,6,4,2,8,13,24,5,1,-6,6,10,24,4,0,-3,2,3,0,1,1,-3,-1,3,0,2,2,0,0,2,0,1,1,0,-1,1,0,1,1,0,-3,3,-6,9,8,1,6,0,-5,7,0,-11,4,-3,-3,6,2,-3,2,3,-2,1,-2,-8,1,1,3,3,1,0,1,0,3,3,1,0,0,1,0,0,0,0,-28,-25,-3,-23,-16,-7,-3,-4,-11,-10,-6,6,-1,-5,-11,-6,-5,3,-2,1,0,-4,-1,3,0,-3,-5,-11,-4,0,1,-2,-5,-7,-3,0,-1,-1,0,-4,-1,0,15,9,6,8,4,4,7,8,4,0,1,-4,2,5,2,2,0,-1,5,3,2,-2,1,-3,1,4,2,2,0,-1,1,2,1,0,0,0,0,2,1,2,0,-1,-25,-3,-22,-2,0,-2,0,-4,-5,-2,-9,-8,3,-2,2,0,-4,-4,-3,-2,-7,-2,-5,-4,-2,1,0,1,-2,0,-1,1,1,0,-1,0,-1,0,-1,1,-1,0,-11,-6,-5,6,3,3,-1,4,-12,2,0,-4,0,-1,-5,2,0,-2,-1,5,-7,0,0,-2,-1,2,4,1,0,0,-1,1,2,1,0,0,0,1,2,0,0,0,10,12,-2,8,7,1,2,1,3,4,1,-2,1,0,5,5,1,-1,1,1,-2,-1,0,-1,1,3,2,2,0,0,1,2,2,2,0,0,0,1,0,0,0,0
23,23050,Jaén,109247,-376,-156,-220,15,9,6,-27,-127,-153,-34,-42,16,10,-76,-81,-6,-4,12,-37,-51,-72,-28,-38,4,0,4,4,2,5,0,0,1,4,1,3,0,0,3,0,1,2,0,88,18,70,12,5,7,44,-22,9,73,-22,12,22,-23,-14,42,-14,8,22,1,23,31,-8,4,1,1,1,4,2,3,0,0,1,1,1,2,1,1,0,3,1,1,-208,-134,-74,-22,-17,-5,15,-124,-43,4,-41,-14,-10,-46,-56,5,-28,2,25,-78,13,-1,-13,-16,2,-7,-14,-4,3,-2,0,-2,-8,-6,0,-1,2,-5,-6,2,3,-1,-304,-199,-105,15,5,10,4,-88,-83,-3,-88,-53,4,-60,-68,-4,-50,-24,0,-28,-15,1,-38,-29,2,5,0,4,3,0,2,1,-1,1,2,0,0,4,1,3,1,0,-222,-151,-71,405,206,199,-36,21,-93,-4,-68,-29,-14,4,-43,-17,-51,-21,-22,17,-50,13,-17,-8,59,118,137,61,20,10,36,53,73,32,7,5,23,65,64,29,13,5,-152,-145,-7,488,259,229,36,5,-72,-74,-16,-43,0,-10,-48,-38,-22,-27,36,15,-24,-36,6,-16,112,119,155,59,27,6,57,54,95,38,8,3,55,65,60,21,19,3,-107,-121,14,735,399,336,40,-19,-59,-8,-37,-39,-6,-18,-70,-25,2,-9,46,-1,11,17,-39,-30,130,152,238,165,38,6,65,85,134,79,31,3,65,67,104,86,7,3,-897,-423,-474,493,356,137,-149,-57,-403,-84,-85,-93,-78,-8,-217,-33,-40,-31,-71,-49,-186,-51,-45,-62,4,174,196,92,19,-2,3,124,137,70,15,2,1,50,59,22,4,-4,-495,-369,-126,338,154,184,49,-58,-257,-80,-78,-64,16,-40,-187,-74,-64,-23,33,-18,-70,-6,-14,-41,42,133,98,60,1,-1,24,65,40,31,-9,0,18,68,58,29,10,-1,-265,-214,-51,254,59,195,105,-7,-128,-93,-77,-45,67,23,-123,-81,-67,-20,38,-30,-5,-12,-10,-25,122,65,67,8,-10,-3,68,31,-2,-22,-14,-3,54,34,69,30,4,0,-357,-109,-248,-69,-45,-24,-20,-22,-124,-79,-71,-35,-25,15,18,-63,-31,-24,5,-37,-142,-16,-40,-11,-14,15,-14,-30,-19,-10,-17,16,-13,-22,-4,-7,3,-1,-1,-8,-15,-3,-320,-132,-188,-19,-55,36,-23,-135,-59,-44,-66,19,-1,-87,0,-19,-41,18,-22,-48,-59,-25,-25,1,31,2,-41,-14,0,2,21,-18,-40,-18,-4,3,10,20,-1,4,4,-1,-715,-504,-211,12,-1,13,-85,-67,-372,-114,-71,11,-44,-65,-273,-59,-48,0,-41,-2,-99,-55,-23,11,-9,39,-16,-5,-1,1,1,19,-8,-9,-3,-3,-10,20,-8,4,2,4,-506,-364,-142,-35,-41,6,-12,-48,-317,-63,-35,-33,-38,-13,-232,-56,-20,-11,26,-35,-85,-7,-15,-22,7,18,-64,-9,6,2,-2,18,-52,-11,6,0,9,0,-12,2,0,2,-548,-310,-238,-39,-37,-2,-8,-72,-281,-97,-56,-37,-4,-48,-157,-43,-38,-18,-4,-24,-124,-54,-18,-19,6,12,-47,-13,-1,2,-3,5,-28,-10,-5,2,9,7,-19,-3,4,0,-783,-440,-343,-172,-87,-85,-77,-110,-376,-138,-50,-19,-41,-44,-223,-87,-27,-6,-36,-66,-153,-51,-23,-13,-16,12,-95,-53,-20,-4,-1,12,-50,-36,-13,-1,-15,0,-45,-17,-7,-3,-550,-320,-230,-34,-48,14,-8,-76,-288,-100,-59,-21,-4,-38,-190,-41,-27,-18,-4,-38,-98,-59,-32,-3,23,23,-44,-36,-4,1,13,13,-46,-22,-5,-1,10,10,2,-14,1,2,-648,-377,-271,63,17,46,-46,-60,-230,-166,-92,-58,-22,-37,-134,-86,-62,-32,-24,-23,-96,-80,-30,-26,17,39,16,-16,-1,1,11,11,3,-9,0,-1,6,28,13,-7,-1,2
23,23055,Linares,58722,-184,-71,-113,121,70,51,18,-83,-71,-17,-21,-8,6,-38,-28,3,-4,-7,12,-45,-43,-20,-17,-1,11,29,42,23,10,4,4,14,26,14,9,3,7,15,16,9,1,1,-70,-37,-33,189,118,71,73,-62,-102,13,0,7,62,-42,-70,11,3,-1,11,-20,-32,2,-3,8,59,41,49,28,11,0,46,27,28,10,6,0,13,14,21,18,5,0,77,35,42,169,110,59,74,-48,-17,52,1,14,39,-21,-13,22,3,3,35,-27,-4,30,-2,11,35,34,54,37,6,3,20,22,40,22,5,1,15,12,14,15,1,2,223,117,106,172,93,79,115,-16,11,43,29,19,68,-6,-14,26,18,12,47,-10,25,17,11,7,24,48,61,22,8,3,14,25,34,14,3,0,10,23,27,8,5,3,252,108,144,233,137,96,94,66,33,10,14,20,38,35,15,4,0,10,56,31,18,6,14,10,36,69,85,28,8,5,21,43,50,15,4,2,15,26,35,13,4,3,407,223,184,240,142,98,164,14,78,65,45,25,97,8,42,22,29,18,67,6,36,43,16,7,36,68,79,41,16,0,15,43,53,21,9,1,21,25,26,20,7,-1,158,145,13,421,281,140,-30,12,69,64,37,-1,-24,35,75,31,29,-3,-6,-23,-6,33,8,2,42,103,178,72,18,7,27,66,127,46,12,2,15,37,51,26,6,5,-64,-6,-58,292,180,112,3,-48,-14,14,-25,5,1,-21,13,10,-18,5,2,-27,-27,4,-7,0,25,85,108,55,17,1,14,50,73,34,8,0,11,35,35,21,9,1,32,-24,56,237,131,106,57,0,-50,10,16,-14,29,-24,-44,10,12,-8,28,24,-6,0,4,-6,41,59,73,45,12,1,23,29,41,26,8,0,18,30,32,19,4,1,-70,-87,17,96,46,50,-10,-44,-75,-21,22,56,-11,-27,-67,-16,12,20,1,-17,-8,-5,10,36,9,19,48,14,6,0,2,1,31,10,2,1,7,18,17,4,4,-1,-242,-79,-163,133,77,56,-27,-42,-117,-18,-40,4,1,-3,-62,-4,-12,4,-28,-39,-55,-14,-28,0,21,30,50,21,7,1,14,20,28,10,2,1,7,10,22,11,5,0,-72,-8,-64,55,33,22,53,12,-82,-14,-5,-26,35,14,-40,-11,3,-3,18,-2,-42,-3,-8,-23,30,42,14,-26,-3,-5,14,28,13,-21,0,-3,16,14,1,-5,-3,-2,-291,-199,-92,-39,-30,-9,-31,-32,-130,-19,-41,-32,-23,-21,-89,-25,-21,-18,-8,-11,-41,6,-20,-14,-13,19,-11,-16,-10,-10,-10,12,-7,-16,-5,-5,-3,7,-4,0,-5,-5,-402,-215,-187,-32,-18,-14,-34,-74,-185,-71,-26,-7,10,-48,-104,-41,-16,-14,-44,-26,-81,-30,-10,7,4,24,3,-43,-9,-16,5,17,1,-29,-8,-8,-1,7,2,-14,-1,-8,-541,-244,-297,-219,-100,-119,-78,-93,-252,-68,-33,-12,-47,-34,-122,-31,-16,2,-31,-59,-130,-37,-17,-14,-38,-22,-99,-30,-23,-11,-15,2,-59,-17,-9,-6,-23,-24,-40,-13,-14,-5,-678,-364,-314,-59,-60,1,-100,-68,-272,-135,-68,-32,-56,-16,-158,-85,-34,-11,-44,-52,-114,-50,-34,-21,-6,10,-29,-24,-11,0,-7,4,-30,-21,-6,0,1,6,1,-3,-5,0,-320,-173,-147,13,-1,14,-8,-52,-170,-95,-15,20,8,-22,-102,-64,-4,14,-16,-30,-68,-31,-11,6,16,13,-2,-21,1,3,11,11,-9,-13,-5,2,5,2,7,-8,6,1,-543,-267,-276,63,32,31,-62,-87,-206,-96,-61,-26,-23,-55,-105,-54,-21,-9,-39,-32,-101,-42,-40,-17,15,14,11,14,10,-3,11,3,5,7,6,-2,4,11,6,7,4,-1
23,23060,Martos,22637,143,102,41,53,30,23,41,13,60,23,12,-5,22,9,45,10,11,4,19,4,15,13,1,-9,13,8,19,10,0,3,7,3,12,6,0,2,6,5,7,4,0,1,163,83,80,72,45,27,20,28,56,32,11,10,3,15,36,15,8,4,17,13,20,17,3,6,18,19,22,9,2,0,10,15,13,4,1,0,8,4,9,5,1,0,294,169,125,129,79,50,85,51,89,42,16,3,53,27,48,30,5,-2,32,24,41,12,11,5,21,25,50,26,2,3,12,19,29,15,1,1,9,6,21,11,1,2,125,75,50,97,53,44,23,20,40,28,13,7,17,12,22,20,3,4,6,8,18,8,10,3,15,32,32,13,2,3,7,19,17,8,1,1,8,13,15,5,1,2,104,57,47,48,34,14,45,14,12,30,0,3,30,9,3,14,-2,3,15,5,9,16,2,0,9,9,19,11,1,-1,6,6,16,6,0,0,3,3,3,5,1,-1,247,108,139,131,71,60,63,33,73,33,26,9,31,11,17,23,16,3,32,22,56,10,10,6,24,28,46,19,7,3,13,16,22,13,4,1,11,12,24,6,3,2,137,60,77,109,58,51,24,11,56,33,13,3,22,-7,23,23,-1,4,2,18,33,10,14,-1,13,21,36,24,10,3,8,13,18,14,4,1,5,8,18,10,6,2,247,122,125,164,90,74,43,73,59,24,33,9,24,33,35,6,20,4,19,40,24,18,13,5,32,39,31,42,14,2,18,19,18,25,7,2,14,20,13,17,7,0,21,5,16,77,42,35,7,5,-17,23,13,-12,0,8,-18,14,7,-4,7,-3,1,9,6,-8,13,18,28,15,3,1,8,13,12,9,0,1,5,5,16,6,3,0,50,32,18,25,11,14,-19,11,30,2,16,4,-11,8,25,-3,8,3,-8,3,5,5,8,1,-7,15,16,-7,8,0,-5,8,11,-6,3,0,-2,7,5,-1,5,0,8,-7,15,24,6,18,31,1,-24,8,10,-18,15,-9,-21,14,0,-7,16,10,-3,-6,10,-11,12,4,-2,-3,10,3,7,0,-5,-4,4,3,5,4,3,1,6,0,54,48,6,50,22,28,3,5,23,25,11,-10,-5,5,24,17,7,-2,8,0,-1,8,4,-8,10,12,5,9,10,3,6,7,-3,4,5,2,4,5,8,5,5,1,55,46,9,30,19,11,30,9,30,13,-10,-15,18,13,21,5,-6,-6,12,-4,9,8,-4,-9,4,6,4,9,6,2,4,5,3,5,3,-1,0,1,1,4,3,3,48,20,28,34,17,17,30,16,-4,5,16,-15,14,1,5,-4,10,-5,16,15,-9,9,6,-10,6,2,16,1,6,3,2,0,11,0,4,0,4,2,5,1,2,3,-121,-62,-59,16,3,13,-25,-16,-26,-21,-25,-10,-6,-2,-21,-15,-11,-8,-19,-14,-5,-6,-14,-2,5,9,3,-2,2,-2,5,3,-2,-4,1,0,0,6,5,2,1,-2,-127,-75,-52,-115,-78,-37,-2,-2,-20,-15,-40,-43,-6,-12,3,-18,-23,-16,4,10,-23,3,-17,-27,-6,-2,-17,-44,-34,-13,-5,-4,-9,-32,-19,-9,-1,2,-8,-12,-15,-4,39,19,20,18,14,4,17,-6,2,4,7,10,11,-4,5,-6,3,9,6,-2,-3,10,4,1,7,-3,2,0,8,3,4,-3,3,1,6,2,3,0,-1,-1,2,1,69,61,8,43,24,19,3,33,22,12,4,-4,1,24,17,13,8,-1,2,9,5,-1,-4,-3,6,10,15,9,1,1,2,6,7,6,1,1,4,4,8,3,0,0
23,23061,Mengíbar,8535,-19,-11,-8,13,8,5,12,-10,-4,-3,-7,-7,11,-16,-1,0,-2,-3,1,6,-3,-3,-5,-4,5,1,4,3,0,0,2,1,3,2,0,0,3,0,1,1,0,0,16,8,8,13,6,7,6,2,16,-10,5,-3,9,1,3,-6,4,-4,-3,1,13,-4,1,1,8,1,3,1,0,0,4,0,1,1,0,0,4,1,2,0,0,0,59,35,24,22,11,11,22,15,9,15,6,-5,8,11,5,12,3,-2,14,4,4,3,3,-3,6,5,11,0,0,0,3,3,5,0,0,0,3,2,6,0,0,0,48,44,4,17,11,6,20,2,23,4,7,-11,21,5,8,4,4,0,-1,-3,15,0,3,-11,6,2,5,4,0,0,4,1,4,2,0,0,2,1,1,2,0,0,-5,6,-11,7,3,4,3,2,-14,4,4,-2,8,-2,-6,2,3,2,-5,4,-8,2,1,-4,1,1,1,4,0,0,0,0,0,3,0,0,1,1,1,1,0,0,-7,-6,-1,12,10,2,-13,9,-9,-3,11,-1,-8,0,2,-3,5,0,-5,9,-11,0,6,-1,0,3,8,0,0,0,0,1,8,0,0,0,0,2,0,0,0,0,90,46,44,19,11,8,40,13,16,28,-2,-6,17,2,9,20,-3,1,23,11,7,8,1,-7,4,5,7,2,1,0,2,2,5,1,1,0,2,3,2,1,0,0,94,44,50,71,44,27,10,12,47,11,15,-3,-3,8,24,10,6,-1,13,4,23,1,9,-2,2,20,28,16,2,1,1,10,20,12,1,0,1,10,8,4,1,1,90,43,47,58,33,25,4,24,26,19,12,2,6,6,15,9,7,-2,-2,18,11,10,5,4,4,16,23,6,8,1,1,9,15,3,4,1,3,7,8,3,4,0,95,77,18,65,47,18,0,23,28,36,16,-10,1,19,28,23,13,-8,-1,4,0,13,3,-2,8,13,15,22,7,0,6,9,11,17,4,0,2,4,4,5,3,0,-31,-27,-4,23,13,10,-28,9,-5,5,-4,-7,-18,3,-5,-1,0,-3,-10,6,0,6,-4,-4,6,7,6,3,1,0,3,3,5,2,0,0,3,4,1,1,1,0,98,57,41,26,16,10,33,4,36,13,9,-2,20,0,15,13,3,0,13,4,21,0,6,-2,4,2,8,7,3,1,4,1,3,5,1,1,0,1,5,2,2,0,5,4,1,4,4,0,-4,2,12,2,-12,0,-6,7,6,-2,-3,0,2,-5,6,4,-9,0,-2,2,3,3,-2,0,-2,2,1,3,0,0,0,0,2,0,-2,0,-61,-50,-11,-28,-18,-10,-8,1,-25,-13,-14,0,-6,-14,-19,-6,-4,-1,-2,15,-6,-7,-10,1,-1,-2,-17,-4,-3,-1,-1,-1,-12,-2,-2,0,0,-1,-5,-2,-1,-1,-38,-24,-14,8,3,5,-11,-9,-27,7,-5,3,-4,-8,-16,6,-4,-1,-7,-1,-11,1,-1,4,-3,1,2,4,3,0,-3,0,2,3,0,0,0,1,0,1,3,0,-81,-52,-29,-36,-27,-9,-14,-4,-33,-23,-8,-1,-4,0,-20,-20,-7,-1,-10,-4,-13,-3,-1,0,0,1,-13,-17,-7,-1,1,1,-11,-14,-4,0,-1,0,-2,-3,-3,-1,-16,-4,-12,14,6,8,-14,13,-1,-7,-3,-2,-4,8,-1,-5,0,-1,-10,5,0,-2,-3,-1,3,5,3,0,2,0,3,2,0,0,1,0,0,3,3,0,1,0,44,4,40,5,2,3,24,0,14,-1,3,6,9,-2,1,-5,-1,5,15,2,13,4,4,1,-4,6,-2,4,0,0,-2,2,0,2,0,0,-2,4,-2,2,0,0
23,23069,Porcuna,6969,22,17,5,10,5,5,2,12,-2,14,1,-4,4,6,0,5,2,1,-2,6,-2,9,-1,-5,1,4,2,1,2,0,1,2,1,0,1,0,0,2,1,1,1,0,-29,-14,-15,8,6,2,-2,-6,-8,-4,1,-10,-1,1,-4,-5,3,-8,-1,-7,-4,1,-2,-2,3,2,1,1,1,0,2,2,1,0,1,0,1,0,0,1,0,0,-36,-14,-22,3,2,1,-1,-6,-19,-1,0,-10,1,-1,-10,-1,-3,0,-2,-5,-9,0,3,-10,0,0,1,1,1,0,0,0,1,1,0,0,0,0,0,0,1,0,25,6,19,18,13,5,19,5,-2,-1,2,1,8,1,-5,-2,2,2,11,4,3,1,0,-1,5,3,5,3,1,0,4,2,3,3,1,0,1,1,2,0,0,0,15,10,5,27,14,13,12,-7,0,5,7,-3,4,-6,-1,6,4,1,8,-1,1,-1,3,-4,6,4,13,2,1,1,4,2,7,0,0,1,2,2,6,2,1,0,-18,-10,-8,19,10,9,-7,-1,-18,10,-1,-1,-4,2,-11,2,-1,1,-3,-3,-7,8,0,-2,3,5,5,5,1,0,1,3,3,3,0,0,2,2,2,2,1,0,24,17,7,31,15,16,6,5,6,-2,10,-3,3,1,10,-4,9,-2,3,4,-4,2,1,-1,7,16,6,0,1,0,3,5,6,0,1,0,4,11,0,0,0,0,120,90,30,128,86,42,18,21,36,34,16,-4,16,15,29,24,5,2,2,6,7,10,11,-6,23,27,45,25,8,0,16,17,33,17,3,0,7,10,12,8,5,0,-48,-15,-33,22,11,11,-6,-6,-18,-12,8,-14,-1,1,-11,-8,6,-2,-5,-7,-7,-4,2,-12,6,5,6,3,2,0,3,5,0,2,1,0,3,0,6,1,1,0,-12,-6,-6,-22,-19,-3,7,-7,-12,-4,0,4,3,-1,-6,-3,-1,2,4,-6,-6,-1,1,2,4,-3,-10,-9,-4,0,2,-2,-9,-7,-3,0,2,-1,-1,-2,-1,0,43,21,22,16,10,6,11,22,16,0,1,-3,3,9,6,3,-1,2,8,13,10,-3,2,-5,2,5,9,1,-1,0,1,4,8,-1,-2,0,1,1,1,2,1,0,13,9,4,2,5,-3,-2,15,1,2,4,-6,-4,5,7,1,3,-3,2,10,-6,1,1,-3,0,1,0,2,-1,0,0,1,1,3,0,0,0,0,-1,-1,-1,0,-34,-13,-21,-9,-9,0,10,-8,-19,2,-6,-14,9,-7,-11,4,-4,-5,1,-1,-8,-2,-2,-9,-1,0,-5,0,-3,0,0,-2,-4,-1,-2,0,-1,2,-1,1,-1,0,-56,-16,-40,-7,-3,-4,-13,-2,-21,-11,-3,-4,-5,6,-11,-1,-3,0,-8,-8,-10,-10,0,-4,0,-1,-2,-2,-2,0,-1,1,0,-2,-1,0,1,-2,-2,0,-1,0,-25,-23,-2,-4,-9,5,-4,2,-15,-16,0,8,-6,-1,-7,-12,0,3,2,3,-8,-4,0,5,-3,4,-2,-2,-1,0,-3,0,-3,-2,-1,0,0,4,1,0,0,0,6,36,-30,42,43,-1,-4,-4,-1,24,-1,-5,0,1,12,22,0,1,-4,-5,-13,2,-1,-6,-1,1,20,27,-3,-2,-1,2,21,24,-2,-1,0,-1,-1,3,-1,-1,-88,-63,-25,-47,-37,-10,-9,-7,-38,-34,0,-2,-4,-5,-27,-28,-1,1,-5,-2,-11,-6,1,-3,-1,-1,-23,-22,0,0,-1,-1,-18,-17,0,0,0,0,-5,-5,0,0,-62,-33,-29,-3,1,-4,-1,-18,-30,-12,-3,2,-2,-8,-15,-10,-1,3,1,-10,-15,-2,-2,-1,1,0,-4,-1,1,0,1,1,-2,0,1,0,0,-1,-2,-1,0,0
23,23070,Pozo Alcón,5859,-88,-60,-28,33,17,16,-11,-35,-17,-15,4,-10,-8,-26,-6,-12,1,-6,-3,-9,-11,-3,3,-4,3,7,10,7,5,1,2,4,5,3,2,1,1,3,5,4,3,0,-13,4,-17,40,27,13,16,-13,-15,1,-3,-1,17,-10,-6,2,0,0,-1,-3,-9,-1,-3,-1,4,8,15,10,0,2,2,7,11,7,0,0,2,1,4,3,0,2,-46,-12,-34,24,20,4,5,-40,-7,-2,-1,-4,4,-14,-2,1,-2,0,1,-26,-5,-3,1,-4,3,9,5,8,-1,0,2,6,6,7,-1,0,1,3,-1,1,0,0,6,21,-15,43,36,7,23,-13,-5,2,9,-9,18,2,-7,5,3,-1,5,-15,2,-3,6,-8,14,11,11,7,1,-1,11,9,10,5,1,0,3,2,1,2,0,-1,5,39,-34,54,49,5,4,0,-8,0,7,0,12,4,6,3,7,4,-8,-4,-14,-3,0,-4,5,15,20,9,4,1,5,12,19,8,4,1,0,3,1,1,0,0,-42,-6,-36,46,40,6,-18,-29,-18,3,8,8,-7,-10,-3,7,3,3,-11,-19,-15,-4,5,5,11,7,20,8,0,0,9,5,18,8,0,0,2,2,2,0,0,0,-11,24,-35,46,35,11,-1,-26,-4,2,13,5,1,-10,10,7,10,5,-2,-16,-14,-5,3,0,10,9,15,11,1,0,6,7,12,10,0,0,4,2,3,1,1,0,8,26,-18,58,48,10,-1,-15,4,2,10,10,0,-3,7,8,8,6,-1,-12,-3,-6,2,4,9,14,17,17,1,0,7,12,14,14,1,0,2,2,3,3,0,0,20,30,-10,26,25,1,15,7,2,-13,2,3,5,11,12,-7,-1,6,10,-4,-10,-6,3,-3,1,9,12,2,2,0,1,9,12,1,2,0,0,0,0,1,0,0,-30,4,-34,6,5,1,-8,-19,-9,7,1,1,0,-8,3,8,0,3,-8,-11,-12,-1,1,-2,2,3,3,0,-2,0,1,3,3,0,-2,0,1,0,0,0,0,0,-78,-6,-72,20,22,-2,-27,-23,7,-10,-15,-11,-15,-7,28,-2,-5,-5,-12,-16,-21,-8,-10,-6,1,6,12,1,0,0,2,6,13,1,0,0,-1,0,-1,0,0,0,-101,-64,-37,-55,-46,-9,-14,-7,-42,-17,-9,-11,-6,-5,-29,-14,-2,-6,-8,-2,-13,-3,-7,-5,-3,-1,-19,-23,-9,0,-1,-1,-16,-23,-5,0,-2,0,-3,0,-4,0,-49,-22,-27,14,9,5,-24,2,-2,-11,0,-13,-16,9,3,-4,-5,-9,-8,-7,-5,-7,5,-4,0,3,9,-2,3,0,0,2,7,-1,0,0,0,1,2,-1,3,0,-105,-55,-50,4,0,4,-16,-19,-27,-20,-8,-11,-7,-10,-17,-7,-7,-6,-9,-9,-10,-13,-1,-5,1,2,2,-2,1,0,2,1,0,-3,0,0,-1,1,2,1,1,0,-66,-39,-27,-2,1,-3,-20,-10,-36,-5,-2,5,-13,-5,-23,-4,0,5,-7,-5,-13,-1,-2,0,-3,3,-4,2,0,0,-3,2,0,2,0,0,0,1,-4,0,0,0,-25,-3,-22,10,10,0,-4,-13,-16,-8,-1,16,-1,4,-7,-3,-2,7,-3,-17,-9,-5,1,9,2,1,0,4,-1,3,1,2,1,4,0,2,1,-1,-1,0,-1,1,-64,-40,-24,-12,-14,2,1,-24,-32,-2,1,-7,1,-13,-22,-3,2,-5,0,-11,-10,1,-1,-2,1,1,-6,-8,-1,0,1,1,-8,-8,-1,0,0,0,2,0,0,0,-26,-28,2,10,1,9,-6,-2,-17,0,2,-6,-9,-6,-10,-2,-4,2,3,4,-7,2,6,-8,-1,8,0,2,2,-1,-1,4,0,0,-2,0,0,4,0,2,4,-1
23,23086,Torre del Campo,12866,144,74,70,13,9,4,28,15,56,38,5,1,14,5,35,20,0,0,14,10,21,18,5,1,1,1,7,3,1,0,1,1,5,2,0,0,0,0,2,1,1,0,75,41,34,23,14,9,-1,18,32,13,12,0,-9,7,30,8,5,0,8,11,2,5,7,0,2,8,8,5,0,0,1,5,5,3,0,0,1,3,3,2,0,0,70,47,23,30,16,14,-4,21,22,14,10,5,2,10,21,6,4,4,-6,11,1,8,6,1,5,6,13,3,1,1,4,0,8,2,1,0,1,6,5,1,0,1,95,57,38,31,18,13,30,8,37,5,9,2,8,8,23,6,5,4,22,0,14,-1,4,-2,7,11,5,5,2,1,1,8,4,3,1,1,6,3,1,2,1,0,98,61,37,39,21,18,10,34,36,0,15,0,4,18,27,3,10,-1,6,16,9,-3,5,1,5,13,10,7,2,1,4,7,4,5,1,0,1,6,6,2,1,1,121,67,54,85,57,28,13,32,53,11,7,6,6,16,30,7,6,3,7,16,23,4,1,3,10,22,30,22,0,1,7,13,22,14,0,1,3,9,8,8,0,0,184,111,73,123,75,48,17,39,66,35,13,11,2,19,54,19,8,7,15,20,12,16,5,4,6,39,39,23,9,4,3,21,27,14,6,3,3,18,12,9,3,1,217,109,108,130,72,58,40,57,55,37,14,9,22,21,34,18,5,6,18,36,21,19,9,3,18,30,48,31,1,1,12,13,28,16,2,0,6,17,20,15,-1,1,16,3,13,19,12,7,8,-4,26,3,-4,-12,2,0,4,2,1,-6,6,-4,22,1,-5,-6,0,6,3,9,0,0,-1,3,2,6,1,0,1,3,1,3,-1,0,-61,-50,-11,-26,-27,1,-20,-3,-3,-33,5,-6,-19,1,-4,-22,0,-5,-1,-4,1,-11,5,-1,4,-1,-11,-19,0,0,1,-3,-13,-13,0,0,3,2,2,-6,0,0,-54,-44,-10,-26,-22,-4,-26,-4,-12,-5,-11,-1,-17,-1,-12,-7,-10,1,-9,-3,0,2,-1,-2,-6,1,-8,-8,-4,-1,-5,2,-8,-6,-4,-1,-1,-1,0,-2,0,0,8,7,1,11,10,1,4,9,15,-6,-4,-6,4,5,19,-10,-5,-3,0,4,-4,4,1,-3,1,3,7,2,0,-2,5,0,8,-1,-1,-1,-4,3,-1,3,1,-1,21,5,16,5,-4,9,4,17,16,-3,-7,-11,5,5,6,-6,-3,-4,-1,12,10,3,-4,-7,2,1,-3,5,1,-1,0,-2,-2,1,1,-2,2,3,-1,4,0,1,-109,-63,-46,-40,-29,-11,-26,-29,-21,-31,-2,-4,-14,-7,-19,-22,-1,-2,-12,-22,-2,-9,-1,-2,-1,-3,-14,-19,-3,-1,-1,-2,-12,-13,-2,0,0,-1,-2,-6,-1,-1,-25,-7,-18,12,8,4,-6,2,-12,-14,2,1,-7,3,2,-4,-5,4,1,-1,-14,-10,7,-3,-1,5,-2,8,0,1,-3,6,-1,9,-4,1,2,-1,-1,-1,4,0,-95,-61,-34,-13,-6,-7,-14,-29,2,-40,-4,-10,-9,-25,-1,-19,-3,-3,-5,-4,3,-21,-1,-7,1,-6,-6,2,-3,-1,2,-7,-1,2,-2,0,-1,1,-5,0,-1,-1,-127,-78,-49,-18,-11,-7,-16,-21,-39,-25,-13,-8,-9,-9,-26,-21,-5,-6,-7,-12,-13,-4,-8,-2,1,-2,-8,-4,-4,-1,1,-1,-5,-3,-2,-1,0,-1,-3,-1,-2,0,-66,-46,-20,-16,-10,-6,5,-18,-16,-12,-17,-9,11,-13,-15,-9,-10,-8,-6,-5,-1,-3,-7,-1,-2,3,-5,-6,-6,0,1,0,-3,-5,-3,0,-3,3,-2,-1,-3,0
24,24008,Astorga,12387,83,28,55,26,13,13,-5,0,-4,-16,25,88,-2,6,-11,-13,13,36,-3,-6,7,-3,12,52,2,5,4,8,6,1,2,2,2,5,2,0,0,3,2,3,4,1,9,9,0,17,9,8,-4,-12,0,-3,14,15,-3,-9,-3,3,13,11,-1,-3,3,-6,1,4,9,1,1,4,1,1,4,1,0,3,1,0,5,0,1,1,0,1,13,-2,15,40,16,24,10,3,-32,-15,17,27,6,7,-19,-11,8,6,4,-4,-13,-4,9,21,9,10,5,7,4,5,5,3,4,1,1,2,4,7,1,6,3,3,48,10,38,16,10,6,15,-11,7,-7,11,33,8,-7,-1,2,6,3,7,-4,8,-9,5,30,7,0,6,1,2,0,4,0,5,1,0,0,3,0,1,0,2,0,24,12,12,28,17,11,2,4,-22,1,16,25,9,5,-18,-3,6,12,-7,-1,-4,4,10,13,8,5,8,3,3,1,6,3,6,0,2,0,2,2,2,3,1,1,43,12,31,43,19,24,14,24,-7,2,-7,13,18,14,-12,-12,-3,3,-4,10,5,14,-4,10,5,16,12,7,0,3,2,8,3,3,1,2,3,8,9,4,-1,1,-68,-36,-32,63,31,32,-27,1,-25,-23,-15,18,-15,0,-13,-9,-10,8,-12,1,-12,-14,-5,10,8,17,14,15,7,1,4,6,6,10,3,1,4,11,8,5,4,0,-79,-32,-47,59,32,27,-3,-2,-54,6,-16,-8,-12,-4,-13,0,-5,2,9,2,-41,6,-11,-10,10,19,12,13,2,2,5,9,10,3,2,2,5,10,2,10,0,0,88,49,39,80,41,39,26,8,32,0,0,15,7,18,12,4,-2,6,19,-10,20,-4,2,9,16,21,29,11,5,-2,6,15,14,5,2,-1,10,6,15,6,3,-1,4,-4,8,28,12,16,-2,8,-48,11,19,8,6,0,-29,1,8,5,-8,8,-19,10,11,3,7,12,6,1,0,0,3,3,6,-2,1,1,4,9,0,3,-1,-1,-69,-41,-28,15,8,7,-1,-22,-30,-18,-5,10,-3,-11,-10,-10,-6,1,2,-11,-20,-8,1,9,3,6,1,4,1,1,1,5,2,1,-1,0,2,1,-1,3,2,1,-1,-5,4,11,3,8,-11,-1,-23,0,-1,33,-4,-4,-8,0,-1,10,-7,3,-15,0,0,23,2,6,1,5,-1,-2,2,2,0,3,-1,-3,0,4,1,2,0,1,-37,-23,-14,1,-2,3,15,-13,-41,2,7,-6,4,-5,-21,-6,7,-4,11,-8,-20,8,0,-2,-5,4,3,-3,1,1,-1,1,0,-1,0,-1,-4,3,3,-2,1,2,47,38,9,6,5,1,18,16,6,7,0,-5,9,9,6,7,2,1,9,7,0,0,-2,-6,4,4,1,-3,1,-1,3,3,1,-1,0,-1,1,1,0,-2,1,0,-137,-72,-65,-5,-3,-2,7,-36,-49,-35,1,-27,1,-23,-30,-19,5,-7,6,-13,-19,-16,-4,-20,-2,-1,-9,-1,4,4,-1,0,-7,-1,4,2,-1,-1,-2,0,0,2,-3,-15,12,6,-1,7,7,-6,-17,-13,16,15,2,-5,-11,-11,6,4,5,-1,-6,-2,10,11,-2,2,0,1,1,3,-1,-1,-1,0,0,1,-1,3,1,1,1,2,-51,-32,-19,-5,-2,-3,-3,-19,-51,-4,3,26,6,-16,-27,-11,7,11,-9,-3,-24,7,-4,15,3,-1,-7,-5,1,4,2,-1,-3,-4,1,3,1,0,-4,-1,0,1,15,7,8,14,8,6,11,-6,-16,-2,6,23,10,-2,-5,1,2,2,1,-4,-11,-3,4,21,2,5,4,1,0,1,2,1,3,1,0,1,0,4,1,0,0,0
24,24010,"Bañeza, La",10311,-17,-14,-3,54,28,26,-19,-7,-12,-17,19,17,-9,-14,-5,-10,10,13,-10,7,-7,-7,9,4,6,13,16,6,8,4,3,5,8,4,5,2,3,8,8,2,3,2,75,30,45,80,35,45,23,13,30,7,-2,3,8,1,16,4,-1,1,15,12,14,3,-1,2,18,16,27,16,3,0,10,5,9,9,2,0,8,11,18,7,1,0,-12,5,-17,71,30,41,-7,-14,0,1,-7,15,-2,-9,2,10,-4,7,-5,-5,-2,-9,-3,8,11,17,21,8,4,10,5,7,7,4,4,3,6,10,14,4,0,7,31,-7,38,42,16,26,33,-22,30,-21,14,-4,17,-25,3,-8,7,-3,16,3,27,-13,7,-1,9,6,16,1,7,3,6,2,5,1,2,0,3,4,11,0,5,3,89,32,57,62,25,37,18,-2,37,5,14,15,11,-2,9,1,4,9,7,0,28,4,10,6,11,17,13,10,6,5,2,8,6,3,4,2,9,9,7,7,2,3,158,65,93,121,67,54,37,43,42,-2,3,32,27,13,17,-4,-1,12,10,30,25,2,4,20,20,36,30,18,7,9,11,19,23,7,4,3,9,17,7,11,3,6,200,94,106,111,62,49,52,39,45,32,14,18,27,11,26,18,6,6,25,28,19,14,8,12,31,30,32,10,2,6,16,14,25,4,0,3,15,16,7,6,2,3,213,95,118,145,74,71,80,33,1,40,27,26,35,14,-3,16,14,16,45,19,4,24,13,10,42,34,36,17,9,5,15,15,24,11,4,4,27,19,12,6,5,1,95,21,74,82,30,52,5,2,31,9,21,31,-9,-8,11,7,11,9,14,10,20,2,10,22,9,28,25,13,4,1,4,6,9,7,2,1,5,22,16,6,2,0,40,35,5,47,19,28,-1,4,4,7,14,19,1,-1,14,10,9,8,-2,5,-10,-3,5,11,8,11,13,4,5,6,2,2,5,1,5,4,6,9,8,3,0,2,-83,-42,-41,28,12,16,-13,-13,-41,-20,-3,10,-4,-6,-28,-8,-1,7,-9,-7,-13,-12,-2,3,5,6,10,5,2,-1,3,5,3,0,1,0,2,1,7,5,1,-1,47,14,33,26,11,15,14,-3,-9,9,9,24,12,-8,-11,4,4,10,2,5,2,5,5,14,4,7,7,3,2,2,2,1,5,1,0,2,2,6,2,2,2,0,13,13,0,11,3,8,-10,-7,-2,2,14,14,-1,3,-6,5,4,8,-9,-10,4,-3,10,6,2,6,4,1,-1,-1,1,2,0,2,-2,0,1,4,4,-1,1,-1,-60,-25,-35,14,7,7,0,-9,-45,-6,6,-6,1,4,-27,-5,7,-3,-1,-13,-18,-1,-1,-3,5,8,1,-3,3,-1,4,4,0,-2,1,0,1,4,1,-1,2,-1,-60,-41,-19,10,4,6,17,-21,-17,-18,-15,-5,-7,-14,-5,-9,-9,4,24,-7,-12,-9,-6,-9,6,4,2,-4,-1,3,2,1,2,-2,0,1,4,3,0,-2,-1,2,39,23,16,22,7,15,14,-19,18,14,-8,22,10,-9,8,14,-8,10,4,-10,10,0,0,12,5,8,5,0,1,2,4,3,-2,0,0,1,1,5,7,0,1,1,-42,-22,-20,17,10,7,-10,-1,-16,-11,2,-6,-7,2,-7,-9,1,-5,-3,-3,-9,-2,1,-1,-3,7,11,-1,3,-1,-3,3,6,1,3,0,0,4,5,-2,0,-1,48,41,7,51,25,26,36,8,-25,8,-3,26,18,13,-3,7,-1,11,18,-5,-22,1,-2,15,10,13,9,10,0,5,4,10,6,3,-1,1,6,3,3,7,1,4
24,24014,Bembibre,11050,-177,-95,-82,43,27,16,-31,-56,-42,-39,-12,2,-15,-31,-24,-26,-2,2,-16,-25,-18,-13,-10,0,9,6,12,10,4,1,6,5,5,5,4,1,3,1,7,5,0,0,-106,-54,-52,14,7,7,-21,-33,-23,-24,-4,-1,-6,-19,-7,-15,-7,0,-15,-14,-16,-9,3,-1,3,3,5,1,1,1,3,2,1,1,0,0,0,1,4,0,1,1,-249,-127,-122,47,20,27,-31,-56,-77,-62,-20,-4,-14,-25,-35,-34,-12,-7,-17,-31,-42,-28,-8,3,18,6,10,6,3,4,8,4,5,2,2,-1,10,2,5,4,1,5,-73,-29,-44,50,28,22,0,-18,-24,-38,5,-1,6,-9,-8,-18,-1,-1,-6,-9,-16,-20,6,0,15,11,11,7,5,1,9,8,8,3,1,-1,6,3,3,4,4,2,-32,-13,-19,54,34,20,-12,-25,20,-5,-10,2,-3,-17,18,-8,-6,4,-9,-8,2,3,-4,-2,5,12,24,13,-1,1,3,6,16,9,-1,1,2,6,8,4,0,0,33,31,2,62,46,16,11,-20,-2,-3,5,39,3,-4,2,8,5,16,8,-16,-4,-11,0,23,10,15,16,13,7,1,6,10,15,9,6,0,4,5,1,4,1,1,11,12,-1,92,58,34,0,19,-22,-1,1,7,10,7,-21,8,2,-3,-10,12,-1,-9,-1,10,16,21,25,21,7,1,14,16,9,15,5,-1,2,5,16,6,2,2,93,77,16,145,100,45,18,19,-13,26,19,19,10,12,7,22,12,12,8,7,-20,4,7,7,25,35,30,41,9,5,18,24,23,25,8,2,7,11,7,16,1,3,-3,-21,18,97,47,50,0,-15,9,-21,9,18,-14,-6,4,-15,3,7,14,-9,5,-6,6,11,17,23,33,16,7,1,2,16,16,11,2,0,15,7,17,5,5,1,31,28,3,50,26,24,16,-15,10,-1,6,12,12,-5,10,0,4,4,4,-10,0,-1,2,8,12,10,14,6,1,5,6,4,12,3,-2,2,6,6,2,3,3,3,41,12,29,36,12,24,4,-1,-14,11,17,17,-1,-1,-5,-1,5,10,5,0,-9,12,12,7,1,6,15,4,6,2,1,-2,7,0,4,0,0,8,8,4,2,2,-68,-33,-35,19,16,3,-15,-7,-50,-18,6,16,-12,-1,-18,-7,-2,8,-3,-6,-32,-11,8,8,2,7,3,2,6,-1,3,4,3,1,5,0,-1,3,0,1,1,-1,-108,-57,-51,19,14,5,5,-19,-48,-18,-15,-10,3,-7,-27,-14,-11,1,2,-12,-21,-4,-4,-11,4,4,6,2,3,0,2,5,5,1,0,1,2,-1,1,1,3,-1,-116,-59,-57,10,13,-3,-26,-24,-47,-26,-9,19,-12,-11,-31,-13,-5,14,-14,-13,-16,-13,-4,5,4,-3,9,-1,0,1,2,-2,11,3,-2,1,2,-1,-2,-4,2,0,-24,-6,-18,28,13,15,12,-14,-25,-13,0,13,3,-7,-7,-12,6,10,9,-7,-18,-1,-6,3,8,6,3,6,3,2,4,2,2,2,1,2,4,4,1,4,2,0,-118,-82,-36,-46,-31,-15,1,-39,-49,-41,-18,31,-2,-19,-31,-23,-15,10,3,-20,-18,-18,-3,21,2,-4,-20,-23,-3,2,2,-4,-14,-14,-3,2,0,0,-6,-9,0,0,-57,-17,-40,-9,-7,-2,-10,-16,-48,6,-11,22,-7,-5,-20,10,-4,9,-3,-11,-28,-4,-7,13,-8,4,-4,-3,-1,2,-4,1,-2,-1,-1,0,-4,3,-2,-2,0,2,-140,-100,-40,-67,-44,-23,-12,-29,-53,-38,-31,22,-11,-13,-30,-30,-29,11,-1,-16,-23,-8,-2,11,-10,-5,-16,-18,-14,-5,-5,-3,-6,-15,-13,-3,-5,-2,-10,-3,-1,-2
24,24015,Benavides,3057,-15,-15,0,9,2,7,1,-3,-13,0,2,0,-2,-4,-7,-2,2,0,3,1,-6,2,0,0,2,3,2,1,0,1,1,0,0,1,0,0,1,3,2,0,0,1,-17,-12,-5,9,4,5,-4,7,-14,-7,0,1,-1,3,-11,-5,0,2,-3,4,-3,-2,0,-1,0,6,1,2,0,0,0,3,0,1,0,0,0,3,1,1,0,0,-32,-14,-18,7,2,5,-1,-9,-21,-2,5,-2,2,0,-13,0,1,-2,-3,-9,-8,-2,4,0,3,0,2,0,1,1,1,0,1,0,0,0,2,0,1,0,1,1,-32,-18,-14,7,4,3,-5,-7,-25,5,2,1,-4,2,-18,3,-2,1,-1,-9,-7,2,4,0,3,0,0,4,0,0,2,0,0,2,0,0,1,0,0,2,0,0,-24,-16,-8,15,6,9,-1,-3,-17,5,-6,1,-2,-1,-10,2,-2,-1,1,-2,-7,3,-4,2,3,3,3,4,1,1,1,2,1,2,0,0,2,1,2,2,1,1,-9,-9,0,23,14,9,-13,1,6,-7,7,-5,-10,5,-1,-7,4,0,-3,-4,7,0,3,-5,2,3,9,3,3,3,1,3,6,1,1,2,1,0,3,2,2,1,1,-3,4,13,11,2,2,8,-21,3,0,10,0,5,-11,0,1,3,2,3,-10,3,-1,7,1,4,2,2,1,3,1,3,3,0,2,2,0,1,-1,2,-1,1,3,5,-2,15,7,8,3,2,-1,-2,2,0,1,1,2,-3,4,1,2,1,-3,1,-2,-1,5,4,3,2,0,1,3,2,2,-1,0,1,2,2,1,3,0,0,1,-11,12,6,3,3,-2,4,-9,-9,0,18,3,1,-10,-7,0,2,-5,3,1,-2,0,16,1,2,2,-1,3,-1,0,1,0,0,2,0,1,1,2,-1,1,-1,23,17,6,5,3,2,6,-4,2,3,3,14,2,-1,2,2,3,10,4,-3,0,1,0,4,0,3,3,0,-1,0,0,2,2,0,-1,0,0,1,1,0,0,0,4,11,-7,0,0,0,3,1,0,-4,9,-6,4,3,2,-2,7,-4,-1,-2,-2,-2,2,-2,-1,-1,1,1,0,0,0,0,-1,1,0,0,-1,-1,2,0,0,0,-33,-17,-16,-2,-1,-1,-5,3,-27,3,-7,2,-5,2,-13,4,-4,-1,0,1,-14,-1,-3,3,1,0,-5,1,0,1,1,0,-2,0,0,0,0,0,-3,1,0,1,18,2,16,0,1,-1,-1,4,0,2,-1,14,0,2,-4,1,-2,5,-1,2,4,1,1,9,1,-1,2,-1,-1,0,1,0,2,-1,-1,0,0,-1,0,0,0,0,-16,-9,-7,4,2,2,-6,3,-12,-8,2,7,-2,3,-11,0,0,2,-4,0,-1,-8,2,5,1,1,-1,1,2,0,0,1,-1,1,1,0,1,0,0,0,1,0,-6,-13,7,0,-4,4,2,-5,-17,-6,8,12,1,-5,-13,-6,7,3,1,0,-4,0,1,9,1,1,-1,0,0,-1,0,-1,-1,-1,0,-1,1,2,0,1,0,0,-3,-10,7,-7,-3,-4,2,0,-3,-8,-5,10,-1,0,-8,-4,-2,4,3,0,5,-4,-3,6,0,0,-1,-6,0,0,0,0,-1,-2,0,0,0,0,0,-4,0,0,-21,-16,-5,-1,0,-1,-6,-8,-9,-10,1,11,-5,-6,-2,-5,-1,3,-1,-2,-7,-5,2,8,2,-1,-1,-3,0,2,1,0,0,-2,0,1,1,-1,-1,-1,0,1,13,10,3,0,0,0,-1,-2,-10,1,4,18,0,-2,-6,1,4,11,-1,0,-4,0,0,7,0,0,-3,2,-1,0,0,-1,-1,1,0,0,0,1,-2,1,-1,0
24,24030,Cacabelos,4849,7,-1,8,29,15,14,4,9,-12,11,-1,-3,0,4,-13,10,1,-2,4,5,1,1,-2,-1,6,8,8,5,1,1,2,5,3,4,1,0,4,3,5,1,0,1,-9,-4,-5,19,13,6,-2,2,-4,-8,-2,5,1,-2,-3,0,0,0,-3,4,-1,-8,-2,5,4,4,6,4,1,0,2,3,3,4,1,0,2,1,3,0,0,0,32,22,10,19,8,11,5,10,9,8,-2,2,5,9,9,-1,2,-1,0,1,0,9,-4,3,4,4,7,4,0,0,2,2,3,1,0,0,2,2,4,3,0,0,65,36,29,13,5,8,15,22,3,7,6,11,4,10,12,-2,3,9,11,12,-9,9,3,2,2,2,1,4,3,1,1,2,1,0,2,-1,1,0,0,4,1,2,108,48,60,48,25,23,18,19,20,35,8,5,8,8,8,14,7,2,10,11,12,21,1,3,7,14,7,16,4,0,5,8,2,8,2,0,2,6,5,8,2,0,76,67,9,54,48,6,11,7,24,21,15,-1,6,12,20,19,11,1,5,-5,4,2,4,-2,3,17,14,11,7,1,2,16,12,11,6,1,1,1,2,0,1,0,156,95,61,82,55,27,23,33,35,32,24,4,18,23,11,22,13,6,5,10,24,10,11,-2,13,14,18,20,14,3,11,14,9,9,9,3,2,0,9,11,5,0,186,102,84,103,66,37,42,38,29,40,15,15,20,24,19,20,6,10,22,14,10,20,9,5,18,32,21,20,9,3,11,21,14,14,4,2,7,11,7,6,5,1,95,57,38,76,45,31,15,25,16,13,6,19,7,17,9,11,3,9,8,8,7,2,3,10,9,26,22,13,5,1,2,16,15,8,4,0,7,10,7,5,1,1,12,-5,17,-17,-9,-8,12,7,-20,-12,9,13,13,5,-20,-13,4,4,-1,2,0,1,5,9,6,-3,-13,-8,0,1,5,1,-11,-4,0,0,1,-4,-2,-4,0,1,22,16,6,39,31,8,-2,-7,15,-12,-4,32,-4,-9,22,-6,-1,13,2,2,-7,-6,-3,19,1,15,20,5,-2,0,1,7,19,3,1,0,0,8,1,2,-3,0,59,29,30,39,16,23,9,11,14,11,0,13,1,10,6,7,1,4,8,1,8,4,-1,9,7,11,10,7,3,1,3,3,4,4,2,0,4,8,6,3,1,1,-6,6,-12,4,4,0,-2,-11,-26,10,9,13,1,-5,-15,7,10,7,-3,-6,-11,3,-1,6,2,7,-10,-2,3,3,3,5,-5,-4,2,2,-1,2,-5,2,1,1,-72,-43,-29,-76,-49,-27,10,-18,-32,-25,-15,6,5,-9,-24,-6,-13,2,5,-9,-8,-19,-2,4,-2,-10,-26,-25,-13,0,0,-6,-22,-13,-10,2,-2,-4,-4,-12,-3,-2,9,-14,23,-36,-25,-11,18,8,-9,-5,-10,7,3,3,-5,-9,-7,0,15,5,-4,4,-3,7,5,-3,-14,-8,-10,-6,0,-2,-7,-7,-7,-2,5,-1,-7,-1,-3,-4,-4,-18,14,-4,-8,4,5,1,-21,-4,0,12,7,-8,-17,-9,2,5,-2,9,-4,5,-2,7,0,2,-7,-2,2,1,-2,2,-9,-2,2,1,2,0,2,0,0,0,-49,-29,-20,-10,-9,-1,-2,-24,-15,-16,9,-1,2,-11,-15,-6,4,-3,-4,-13,0,-10,5,2,2,-5,-5,-7,3,1,1,-2,-4,-5,0,0,1,-3,-1,-2,3,1,3,7,-4,1,1,0,-6,3,-14,-6,9,16,-3,1,-4,-3,7,9,-3,2,-10,-3,2,7,1,2,-5,-2,0,4,2,0,-5,-2,3,2,-1,2,0,0,-3,2
24,24034,Camponaraya,3188,4,2,2,5,2,3,3,0,4,-2,-1,-4,0,0,5,-2,1,-2,3,0,-1,0,-2,-2,0,1,2,2,0,0,0,1,1,0,0,0,0,0,1,2,0,0,81,53,28,11,6,5,22,12,28,19,2,-3,15,3,20,13,1,0,7,9,8,6,1,-3,4,3,2,0,1,0,2,2,1,0,0,0,2,1,1,0,1,0,98,58,40,9,7,2,19,13,28,28,8,-1,11,11,14,17,4,-2,8,2,14,11,4,1,4,1,2,3,1,-3,3,1,1,3,0,-2,1,0,1,0,1,-1,84,49,35,13,7,6,19,23,25,10,3,3,10,19,11,7,2,-1,9,4,14,3,1,4,2,2,2,2,4,1,2,1,0,1,3,0,0,1,2,1,1,1,93,45,48,21,11,10,15,14,36,12,12,3,6,4,16,9,6,4,9,10,20,3,6,-1,2,3,9,1,4,2,1,2,3,0,3,2,1,1,6,1,1,0,-55,-25,-30,6,2,4,-9,-8,-29,-1,0,-2,-6,-3,-13,1,0,0,-3,-5,-16,-2,0,-2,1,1,0,3,1,0,0,0,0,2,0,0,1,1,0,1,1,0,171,97,74,17,8,9,28,49,58,24,5,4,13,27,33,13,6,4,15,22,25,11,-1,0,2,5,7,1,2,0,0,3,3,1,1,0,2,2,4,0,1,0,186,116,70,41,21,20,34,32,63,39,3,5,20,22,34,33,1,1,14,10,29,6,2,4,15,9,11,5,2,-1,9,5,6,1,1,-1,6,4,5,4,1,0,39,35,4,27,24,3,8,13,10,8,4,-6,0,16,7,9,1,1,8,-3,3,-1,3,-7,1,12,8,5,0,1,0,10,10,4,0,0,1,2,-2,1,0,1,11,-11,22,3,2,1,11,10,-8,-4,9,-6,7,1,-10,-12,6,-2,4,9,2,8,3,-4,-1,1,1,1,0,1,-1,0,1,1,0,1,0,1,0,0,0,0,38,27,11,14,7,7,16,13,-1,-1,5,4,14,9,-2,-3,3,3,2,4,1,2,2,1,3,3,3,3,1,1,2,2,2,1,0,0,1,1,1,2,1,1,17,8,9,0,0,0,13,6,-4,-10,6,3,13,4,-4,-12,4,-1,0,2,0,2,2,4,8,-2,-2,-2,-1,-1,6,-2,-2,-1,0,-1,2,0,0,-1,-1,0,-7,7,-14,5,3,2,-6,-1,-7,5,8,-8,-7,4,0,7,7,-4,1,-5,-7,-2,1,-4,1,2,1,0,1,0,0,2,0,0,1,0,1,0,1,0,0,0,-15,-22,7,-6,-2,-4,-10,1,-4,-12,5,1,-10,-2,-8,-2,0,0,0,3,4,-10,5,1,-1,1,-2,-2,0,-2,0,2,-1,-2,0,-1,-1,-1,-1,0,0,-1,-14,4,-18,-7,-2,-5,3,-5,-5,-3,2,-7,4,4,0,-4,2,-2,-1,-9,-5,1,0,-5,-2,-1,1,-5,1,-1,-1,0,1,-2,0,0,-1,-1,0,-3,1,-1,16,8,8,-15,-11,-4,0,10,0,-5,1,8,-3,6,7,-3,-4,4,3,4,-7,-2,5,4,-1,0,-6,-7,-3,2,1,0,-3,-7,-4,2,-2,0,-3,0,1,0,14,12,2,7,2,5,9,-1,0,2,1,0,4,0,5,-2,2,1,5,-1,-5,4,-1,-1,3,1,2,0,1,0,0,1,2,-2,1,0,3,0,0,2,0,0,11,14,-3,6,2,4,4,1,-1,-11,7,6,5,-2,4,-3,4,5,-1,3,-5,-8,3,1,0,1,4,0,0,1,0,0,3,0,-1,0,0,1,1,0,1,1
24,24056,Cistierna,4409,-57,-42,-15,8,3,5,-9,-11,-17,-14,-10,4,-10,-4,-10,-11,-6,-1,1,-7,-7,-3,-4,5,2,2,2,1,1,0,0,2,1,0,0,0,2,0,1,1,1,0,-92,-52,-40,8,5,3,-11,-26,-24,-25,-3,-3,-5,-17,-10,-16,-3,-1,-6,-9,-14,-9,0,-2,1,2,4,1,0,0,1,1,3,0,0,0,0,1,1,1,0,0,-98,-43,-55,-1,-1,0,-13,-29,-16,-21,-4,-16,-8,-8,-9,-8,-5,-6,-5,-21,-7,-13,1,-10,0,2,-1,-1,0,-1,0,1,-1,0,0,-1,0,1,0,-1,0,0,-28,-21,-7,14,9,5,-8,-7,-21,-2,-2,11,-5,-5,-9,-9,1,5,-3,-2,-12,7,-3,6,3,1,6,4,0,0,0,0,6,3,0,0,3,1,0,1,0,0,-49,-3,-46,10,7,3,-8,-10,-26,-6,14,-9,-6,5,-4,-3,10,-2,-2,-15,-22,-3,4,-7,1,2,2,4,1,0,1,2,1,2,1,0,0,0,1,2,0,0,-52,-19,-33,5,3,2,4,-13,-17,-16,2,-10,4,-4,-12,-4,0,-3,0,-9,-5,-12,2,-7,0,3,0,2,0,0,0,2,0,1,0,0,0,1,0,1,0,0,-36,-22,-14,11,5,6,6,-17,1,-22,-1,0,1,-10,0,-15,2,2,5,-7,1,-7,-3,-2,1,1,4,3,1,1,0,1,2,1,0,1,1,0,2,2,1,0,-45,-1,-44,18,12,6,-11,0,-11,-7,-2,-14,-5,7,3,1,-2,-5,-6,-7,-14,-8,0,-9,2,5,4,5,1,0,1,2,3,4,1,0,1,3,1,1,0,0,2,-5,7,2,1,1,7,-5,-7,2,7,-1,1,-4,-4,0,4,0,6,-1,-3,2,3,-1,0,0,0,2,0,0,0,-1,2,0,0,0,0,1,-2,2,0,0,31,20,11,12,7,5,3,2,14,1,-2,11,1,-3,9,4,2,6,2,5,5,-3,-4,5,3,2,4,1,2,0,1,1,3,1,1,0,2,1,1,0,1,0,41,13,28,4,0,4,15,1,4,6,7,7,8,0,2,-3,3,3,7,1,2,9,4,4,0,1,4,-1,0,0,0,0,1,-1,0,0,0,1,3,0,0,0,-8,7,-15,10,6,4,-10,8,-1,-1,-3,1,-6,10,-1,5,-2,2,-4,-2,0,-6,-1,-1,4,5,0,0,1,0,1,2,1,1,0,1,3,3,-1,-1,1,-1,-40,-4,-36,-5,-2,-3,-14,-2,-25,0,4,0,-5,2,-12,1,8,2,-9,-4,-13,-1,-4,-2,1,0,-3,-3,0,0,0,0,-2,-1,1,0,1,0,-1,-2,-1,0,-44,-2,-42,-7,-1,-6,-9,-2,-21,-6,-3,-2,-3,2,-4,-4,6,2,-6,-4,-17,-2,-9,-4,0,-1,-3,-2,-1,0,1,1,-1,-2,0,0,-1,-2,-2,0,-1,0,-88,-49,-39,-8,-5,-3,-5,-8,-39,-33,-8,8,-7,-7,-17,-16,-3,1,2,-1,-22,-17,-5,7,0,-2,-1,-3,-1,-1,0,-2,0,-2,-1,0,0,0,-1,-1,0,-1,-26,-28,2,0,0,0,6,-20,-5,-2,-2,-1,0,-11,-6,-11,1,0,6,-9,1,9,-3,-1,1,2,-2,-1,0,0,1,1,-1,-1,0,0,0,1,-1,0,0,0,-8,-3,-5,-12,-5,-7,6,-3,-14,5,-3,1,2,0,-12,7,2,0,4,-3,-2,-2,-5,1,1,-2,-6,-3,-2,0,0,-1,-4,0,-1,1,1,-1,-2,-3,-1,-1,-41,-28,-13,6,2,4,-9,-3,-21,-7,-4,3,-7,-6,-7,-10,1,1,-2,3,-14,3,-5,2,2,2,1,-1,0,2,1,2,1,-2,0,0,1,0,0,1,0,2
24,24070,Fabero,5997,-122,-64,-58,11,3,8,-29,-33,-29,-14,-10,-6,-12,-20,-15,-7,-6,-3,-17,-13,-14,-7,-4,-3,1,3,2,2,1,2,1,0,0,1,0,1,0,3,2,1,1,1,-97,-56,-41,4,1,3,-26,-23,-25,-16,-4,-4,-16,-17,-10,-8,-4,-2,-10,-6,-15,-8,0,-2,0,0,0,1,3,0,0,0,0,0,1,0,0,0,0,1,2,0,-86,-36,-50,9,5,4,-3,-19,-28,-24,-8,-5,-3,-7,-12,-10,-5,-1,0,-12,-16,-14,-3,-4,2,-1,0,3,4,1,1,0,0,2,1,1,1,-1,0,1,3,0,-108,-57,-51,9,4,5,-25,-6,-40,-16,-12,-8,-11,-6,-25,-7,-4,-4,-14,0,-15,-9,-8,-4,0,2,3,1,3,0,0,0,1,1,2,0,0,2,2,0,1,0,-90,-45,-45,2,1,1,-14,-25,-34,-19,6,-3,-12,-9,-19,-9,2,2,-2,-16,-15,-10,4,-5,0,-1,0,0,3,0,0,-1,0,0,2,0,0,0,0,0,1,0,-15,-32,17,11,1,10,-1,-6,-2,-5,0,0,-2,-11,-7,-6,-1,-4,1,5,5,1,1,4,1,2,2,1,4,1,0,0,0,0,1,0,1,2,2,1,3,1,81,20,61,11,3,8,31,4,16,13,8,7,10,-2,0,4,1,5,21,6,16,9,7,2,2,2,0,2,4,1,0,1,-1,0,3,0,2,1,1,2,1,1,-6,15,-21,12,10,2,-12,-6,-1,15,7,-7,-6,6,9,9,4,-4,-6,-12,-10,6,3,-3,-1,3,2,4,4,0,0,2,5,2,1,0,-1,1,-3,2,3,0,34,23,11,17,9,8,20,8,3,5,2,-7,11,7,8,1,1,-6,9,1,-5,4,1,-1,5,3,3,4,2,0,3,2,2,2,0,0,2,1,1,2,2,0,9,12,-3,5,-1,6,9,13,0,-2,-5,-7,5,8,-2,-1,2,0,4,5,2,-1,-7,-7,0,7,2,-4,0,0,-1,0,1,-2,0,1,1,7,1,-2,0,-1,-62,-46,-16,5,2,3,0,-7,-32,-3,-7,-12,-2,-3,-20,-8,-9,-4,2,-4,-12,5,2,-8,0,1,1,-2,5,0,0,0,1,0,1,0,0,1,0,-2,4,0,-48,-24,-24,-19,-14,-5,7,2,-35,-11,-6,-3,8,3,-23,-6,-2,-4,-1,-1,-12,-5,-4,1,1,-3,-9,-2,-4,-2,0,-1,-6,-3,-3,-1,1,-2,-3,1,-1,-1,-69,-39,-30,-3,1,-4,-9,-15,-17,-16,-8,-6,-12,-8,-8,-6,-6,-1,3,-7,-9,-10,-2,-5,2,0,-4,-2,0,0,2,0,-1,-1,-1,1,0,0,-3,-1,1,-1,-22,-12,-10,-2,1,-3,-4,-1,-7,-2,-9,2,-10,5,-8,5,-5,3,6,-6,1,-7,-4,-1,0,0,-1,-4,2,1,0,1,0,-2,2,0,0,-1,-1,-2,0,1,-96,-37,-59,-3,-1,-2,-14,-32,-34,-14,-2,1,-2,-14,-17,-10,3,2,-12,-18,-17,-4,-5,-1,1,-2,-1,0,-3,2,1,0,-1,0,-2,1,0,-2,0,0,-1,1,-40,-35,-5,0,1,-1,-4,-5,-25,-15,-3,11,-7,-7,-10,-16,2,3,3,2,-15,1,-5,8,0,2,0,0,-2,0,0,2,-1,1,-1,0,0,0,1,-1,-1,0,-56,-29,-27,-3,-3,0,-5,-8,-24,-16,-8,4,-1,-2,-13,-10,-3,0,-4,-6,-11,-6,-5,4,0,-3,-3,-2,0,5,0,-1,-2,-2,0,2,0,-2,-1,0,0,3,-56,-9,-47,4,4,0,-6,-3,-25,-12,6,-14,-5,1,-7,-1,8,-4,-1,-4,-18,-11,-2,-10,2,4,-2,0,0,0,1,3,0,0,0,0,1,1,-2,0,0,0
24,24089,León,139809,-478,-327,-151,502,224,278,-47,-176,-254,-1,-30,49,-16,-133,-147,-21,-31,23,-31,-43,-107,20,1,26,71,128,164,75,37,26,35,52,76,32,15,14,36,76,88,43,22,12,-794,-480,-314,802,354,448,-1,-190,-324,-75,-164,-22,-13,-103,-204,-71,-92,7,12,-87,-120,-4,-72,-29,132,215,274,131,26,13,63,92,121,49,14,6,69,123,153,82,12,7,-470,-405,-65,848,392,456,75,-175,-371,42,-121,86,-3,-116,-272,38,-83,35,78,-59,-99,4,-38,51,163,230,264,123,49,14,78,104,123,69,15,1,85,126,141,54,34,13,280,-50,330,730,364,366,185,52,-264,125,45,133,70,-15,-194,32,-15,77,115,67,-70,93,60,56,108,205,215,99,62,36,51,89,123,52,29,18,57,116,92,47,33,18,77,-107,184,969,460,509,148,-10,-190,47,-66,156,78,-23,-125,-28,-68,56,70,13,-65,75,2,100,171,258,317,138,48,36,94,116,150,69,13,18,77,142,167,69,35,18,526,74,452,1638,826,812,278,72,-129,259,-24,79,130,-22,-137,94,-36,46,148,94,8,165,12,33,166,456,625,291,68,26,82,215,345,149,20,11,84,241,280,142,48,15,-434,-249,-185,1678,910,768,168,41,-437,-58,-170,25,103,24,-223,-73,-97,10,65,17,-214,15,-73,15,263,509,565,258,59,18,127,269,331,143,31,6,136,240,234,115,28,12,865,334,531,1582,839,743,360,188,4,93,55,153,167,81,-18,32,-2,62,193,107,22,61,57,91,259,453,538,236,66,18,125,213,311,144,33,7,134,240,227,92,33,11,662,283,379,1328,601,727,342,109,-51,192,-14,67,194,23,-45,77,-20,49,148,86,-6,115,6,18,230,391,402,231,48,11,115,157,183,114,18,4,115,234,219,117,30,7,-50,-75,25,797,407,390,143,74,-198,-67,-30,17,90,40,-123,-70,-9,-5,53,34,-75,3,-21,22,116,283,229,103,46,12,62,125,132,51,23,8,54,158,97,52,23,4,-455,-370,-85,703,343,360,64,38,-165,-92,-197,-133,27,-27,-153,-81,-127,-25,37,65,-12,-11,-70,-108,98,263,208,90,29,3,47,122,105,48,17,-1,51,141,103,42,12,4,213,0,213,493,235,258,154,10,-52,-3,-3,67,79,-22,-48,-41,-29,31,75,32,-4,38,26,36,81,187,105,62,44,7,43,79,51,31,25,3,38,108,54,31,19,4,47,-153,200,445,192,253,77,68,-163,-22,-55,105,28,23,-166,-52,-49,41,49,45,3,30,-6,64,79,188,82,52,19,18,40,74,33,31,6,6,39,114,49,21,13,12,-44,-62,18,391,189,202,118,36,-238,46,-30,-12,90,4,-124,-9,-26,-13,28,32,-114,55,-4,1,78,179,40,47,27,15,40,73,29,29,13,4,38,106,11,18,14,11,-603,-495,-108,-160,-137,-23,95,77,-279,-304,-140,-55,53,13,-199,-232,-89,-39,42,64,-80,-72,-51,-16,22,158,-107,-179,-44,-16,14,64,-68,-123,-19,-7,8,94,-39,-56,-25,-9,-1270,-755,-515,-773,-396,-377,67,-70,-636,-419,-161,-62,-14,-56,-331,-252,-90,-9,81,-14,-305,-167,-71,-53,11,125,-428,-323,-111,-55,-4,57,-188,-186,-61,-16,15,68,-240,-137,-50,-39,-26,-69,43,109,75,34,207,71,-233,1,-60,-25,93,53,-138,-17,-48,-14,114,18,-95,18,-12,-11,62,198,-93,-65,1,-7,31,116,-43,-32,-3,-1,31,82,-50,-33,4,-6,226,49,177,477,244,233,224,93,-90,-45,7,16,87,43,-32,-71,-8,21,137,50,-58,26,15,-5,111,216,64,26,25,23,57,115,42,4,9,13,54,101,22,22,16,10
24,24094,Mansilla de las Mulas,1773,5,-7,12,14,4,10,2,4,-2,-2,5,-1,-2,3,-8,-1,2,0,4,1,6,-1,3,-1,2,4,6,1,1,0,1,3,0,0,0,0,1,1,6,1,1,0,13,-6,19,27,12,15,-2,-1,7,-1,3,6,-2,-5,0,-1,1,1,0,4,7,0,2,5,4,8,10,5,0,0,3,2,4,3,0,0,1,6,6,2,0,0,-7,-7,0,28,8,20,-18,2,5,-2,5,0,-8,-5,0,2,2,2,-10,7,5,-4,3,-2,0,8,13,5,1,0,0,-1,4,4,1,0,0,9,9,1,0,0,63,32,31,28,10,18,12,2,6,22,8,12,10,1,0,12,6,3,2,1,6,10,2,9,4,7,5,3,4,5,2,1,2,1,2,2,2,6,3,2,2,3,46,17,29,35,17,18,11,4,13,-12,3,26,4,0,2,-6,1,15,7,4,11,-6,2,11,11,7,9,5,3,0,8,3,4,1,1,0,3,4,5,4,2,0,71,55,16,95,55,40,6,18,12,14,16,6,12,11,18,8,6,0,-6,7,-6,6,10,6,9,19,47,13,4,3,9,7,29,8,1,1,0,12,18,5,3,2,18,20,-2,31,13,18,8,9,-17,11,10,-3,8,1,-6,9,7,1,0,8,-11,2,3,-4,9,7,7,5,2,1,7,2,1,2,0,1,2,5,6,3,2,0,35,24,11,42,21,21,11,8,11,6,2,-3,3,8,5,4,0,3,8,0,6,2,2,-6,12,12,10,7,1,0,7,6,4,4,0,0,5,6,6,3,1,0,4,-5,9,28,7,21,-9,-6,-5,13,-2,12,-5,-5,-6,6,0,5,-4,-1,1,7,-2,7,2,5,10,9,2,0,1,1,2,2,1,0,1,4,8,7,1,0,-62,-32,-30,-34,-23,-11,-13,2,-32,-18,-5,2,-6,3,-17,-7,-6,-1,-7,-1,-15,-11,1,3,1,-1,-15,-9,-9,-2,1,-1,-11,-4,-7,-2,0,0,-4,-5,-2,0,42,52,-10,30,33,-3,2,12,3,15,3,4,0,9,11,20,5,5,2,3,-8,-5,-2,-1,-3,4,11,11,6,0,-1,2,11,13,6,1,-2,2,0,-2,0,-1,-21,-23,2,-17,-16,-1,7,-2,-18,4,-12,-2,3,-5,-14,0,-8,0,4,3,-4,4,-4,-2,1,0,-8,-1,-8,-1,-1,1,-8,0,-7,-1,2,-1,0,-1,-1,0,-10,-13,3,-13,-14,1,0,0,-5,-16,6,6,-1,2,-8,-11,3,1,1,-2,3,-5,3,5,1,0,-8,-7,-1,2,0,-1,-6,-6,-1,0,1,1,-2,-1,0,2,-32,-11,-21,0,3,-3,-17,-9,-2,-5,-1,3,-10,-5,0,2,1,2,-7,-4,-2,-7,-2,1,0,-1,1,2,-2,0,-1,0,3,2,-1,0,1,-1,-2,0,-1,0,-28,-22,-6,7,3,4,-7,0,1,-16,-4,-2,-2,-2,-6,-4,-3,-5,-5,2,7,-12,-1,3,5,1,3,-2,1,-1,4,0,1,-1,0,-1,1,1,2,-1,1,0,9,13,-4,4,6,-2,3,12,7,-12,4,-6,2,5,5,-2,2,0,1,7,2,-10,2,-6,-2,6,4,-2,0,-2,0,-1,4,3,0,0,-2,7,0,-5,0,-2,-20,-13,-7,14,8,6,-8,2,-12,-5,-3,6,-7,0,-6,-6,-1,5,-1,2,-6,1,-2,1,4,4,3,2,0,1,1,3,1,0,1,2,3,1,2,2,-1,-1,-6,-7,1,17,6,11,6,-1,-9,4,-2,-3,2,2,-8,0,-2,-1,4,-3,-1,4,0,-2,6,5,3,3,0,0,4,3,-1,0,0,0,2,2,4,3,0,0
24,24105,Onzonilla,1421,16,6,10,5,1,4,4,1,2,4,5,-2,1,0,1,2,2,0,3,1,1,2,3,-2,1,1,2,0,1,0,0,0,1,0,0,0,1,1,1,0,1,0,49,16,33,21,12,9,4,-1,15,2,1,28,2,-1,11,0,-1,5,2,0,4,2,2,23,7,0,8,6,0,0,3,0,5,4,0,0,4,0,3,2,0,0,56,33,23,20,13,7,7,6,10,12,21,0,2,4,7,7,11,2,5,2,3,5,10,-2,6,3,5,4,2,0,4,2,3,3,1,0,2,1,2,1,1,0,24,16,8,19,9,10,7,11,3,10,-4,-3,7,6,1,7,-2,-3,0,5,2,3,-2,0,6,8,4,1,0,0,5,2,2,0,0,0,1,6,2,1,0,0,5,3,2,17,9,8,-7,2,0,7,2,2,-3,1,-2,8,-1,0,-4,1,2,-1,3,2,1,3,1,7,2,3,1,2,0,4,0,2,0,1,1,3,2,1,-16,-9,-7,17,10,7,-6,-4,1,-3,-4,1,-1,-9,4,0,-3,1,-5,5,-3,-3,-1,0,2,5,6,3,0,1,1,1,5,3,0,0,1,4,1,0,0,1,33,18,15,30,16,14,3,9,19,3,-1,-2,4,5,12,-1,-3,1,-1,4,7,4,2,-3,2,8,13,5,0,0,1,2,8,4,0,0,1,6,5,1,0,0,42,36,6,26,16,10,8,12,12,2,6,2,5,8,17,2,3,1,3,4,-5,0,3,1,6,10,6,4,0,0,3,6,4,3,0,0,3,4,2,1,0,0,51,32,19,18,11,7,-2,2,24,13,3,8,6,2,13,7,0,4,-8,0,11,6,3,4,1,4,8,1,3,0,1,2,5,1,2,0,0,2,3,0,1,0,-6,-10,4,4,3,1,-1,-1,-8,-1,1,4,-5,-2,-8,1,2,3,4,1,0,-2,-1,1,1,1,0,1,0,1,0,1,0,1,0,1,1,0,0,0,0,0,8,10,-2,8,6,2,-1,0,-1,4,3,3,4,0,1,3,0,2,-5,0,-2,1,3,1,1,0,1,3,0,2,0,0,1,3,0,1,1,0,0,0,0,1,19,12,7,2,-2,4,5,1,3,2,5,2,1,1,2,1,4,3,4,0,1,1,1,-1,1,0,0,1,0,0,0,-1,-1,0,0,0,1,1,1,1,0,0,8,3,5,3,1,2,0,5,8,-2,-4,1,2,2,6,-4,-3,0,-2,3,2,2,-1,1,1,2,-1,1,0,0,1,0,0,0,0,0,0,2,-1,1,0,0,23,10,13,14,6,8,3,2,15,8,-2,-5,2,0,11,3,-2,-4,1,2,4,5,0,-1,1,2,6,2,0,1,0,0,5,0,0,0,1,2,1,2,0,1,-42,-33,-9,-41,-30,-11,5,-9,-3,-20,-10,-6,1,-5,-7,-16,-4,-2,4,-4,4,-4,-6,-4,-1,0,-7,-22,-8,-3,-1,-1,-3,-15,-8,-2,0,1,-4,-7,0,-1,35,19,16,-7,-5,-2,4,2,9,13,2,4,4,-1,4,8,2,2,0,3,5,5,0,2,-1,0,-3,-1,-2,0,-1,0,-1,-1,-2,0,0,0,-2,0,0,0,-4,-2,-2,5,5,0,0,0,4,-10,2,1,-1,-1,4,-3,2,-2,1,1,0,-7,0,3,0,0,1,1,0,3,0,0,2,1,1,1,0,0,-1,0,-1,2,67,30,37,3,0,3,14,5,31,10,2,1,8,6,9,3,2,1,6,-1,22,7,0,0,2,0,3,0,-1,-1,0,0,1,0,-1,0,2,0,2,0,0,-1
24,24115,Ponferrada,61965,640,197,443,480,165,315,133,83,220,98,47,53,53,25,56,21,7,28,80,58,164,77,40,25,63,109,162,74,38,27,35,31,48,21,14,13,28,78,114,53,24,14,574,293,281,392,188,204,130,81,219,107,28,10,57,38,123,52,18,6,73,43,96,55,10,4,71,89,121,71,21,17,37,34,67,33,10,7,34,55,54,38,11,10,513,233,280,348,153,195,175,56,115,105,18,34,84,-1,81,41,3,14,91,57,34,64,15,20,87,64,79,69,29,14,38,20,34,37,15,4,49,44,45,32,14,10,398,190,208,363,157,206,118,61,83,40,39,49,57,25,46,23,21,16,61,36,37,17,18,33,85,74,89,50,34,26,37,34,34,24,15,12,48,40,55,26,19,14,678,311,367,435,201,234,166,95,105,136,84,93,102,48,4,78,31,48,64,47,101,58,53,45,80,102,120,68,38,23,45,44,43,35,17,15,35,58,77,33,21,8,787,358,429,633,263,370,155,94,282,173,61,27,77,29,136,100,4,16,78,65,146,73,57,11,85,144,219,123,31,29,38,52,97,56,7,11,47,92,122,67,24,18,583,255,328,709,320,389,203,39,183,77,35,29,115,-3,91,20,7,16,88,42,92,57,28,13,147,156,193,138,54,16,67,62,100,58,23,9,80,94,93,80,31,7,1191,687,504,1022,611,411,245,197,332,235,94,80,121,132,175,175,58,20,124,65,157,60,36,60,171,271,293,196,68,15,88,169,174,128,39,8,83,102,119,68,29,7,844,429,415,460,246,214,201,125,222,164,48,52,108,61,116,84,30,18,93,64,106,80,18,34,124,102,96,100,26,5,77,46,51,50,18,1,47,56,45,50,8,4,-3,-71,68,28,-36,64,61,-80,-5,-14,-33,47,32,-62,-36,-11,-27,22,29,-18,31,-3,-6,25,66,-11,6,-32,-19,8,44,-18,-20,-37,-14,4,22,7,26,5,-5,4,-144,-124,-20,-42,-61,19,6,-77,-20,8,-49,-17,23,-58,-34,-15,-32,-4,-17,-19,14,23,-17,-13,-5,13,-16,-23,-13,0,2,-5,-27,-21,-13,3,-7,18,11,-2,0,-3,153,-8,161,-11,-19,8,32,3,28,43,14,13,22,-9,-34,2,8,-2,10,12,62,41,6,15,17,15,-28,-19,-2,1,16,1,-21,-19,1,-1,1,14,-7,0,-3,2,-246,-190,-56,-69,-74,5,50,-46,-150,-55,-24,-23,13,-31,-88,-50,-12,-18,37,-15,-62,-5,-12,-5,28,2,-56,-32,-19,5,10,-1,-35,-32,-18,2,18,3,-21,0,-1,3,-462,-295,-167,-279,-196,-83,-34,-71,-220,-121,-10,-16,6,-30,-137,-111,-26,-5,-40,-41,-83,-10,16,-11,-25,-30,-106,-73,-36,-13,-10,-20,-71,-61,-30,-5,-15,-10,-35,-12,-6,-8,-308,-208,-100,-76,-58,-18,-23,-3,-77,-130,-15,-55,-26,-23,-65,-76,-14,-3,3,20,-12,-54,-1,-52,8,5,-40,-46,-5,-1,-1,6,-28,-29,-7,1,9,-1,-12,-17,2,-2,-266,-137,-129,-115,-57,-58,11,-56,-154,-53,-25,6,12,-18,-88,-34,-26,11,-1,-38,-66,-19,1,-5,-12,-5,-44,-46,-7,1,-3,-1,-19,-30,-4,2,-9,-4,-25,-16,-3,-1,-385,-205,-180,-38,-33,-5,-37,-77,-184,-137,13,41,-16,-51,-102,-75,18,20,-21,-26,-82,-62,-5,21,-6,21,-26,-24,-13,7,1,3,-18,-14,-7,-1,-7,18,-8,-10,-6,8,-284,-175,-109,51,18,33,30,-105,-112,-80,-25,-3,24,-52,-75,-74,-13,3,6,-53,-37,-6,-12,-6,42,15,1,-14,-1,6,21,10,-8,-11,-1,5,21,5,9,-3,0,1
24,24122,Puente de Domingo Flórez,1951,-41,-14,-27,8,4,4,-9,-11,2,-10,-4,-7,-4,-11,8,-5,-2,1,-5,0,-6,-5,-2,-8,0,2,3,1,1,1,0,1,2,0,0,1,0,1,1,1,1,0,5,-6,11,11,4,7,8,3,-7,4,0,-3,5,-3,-9,1,2,-2,3,6,2,3,-2,-1,2,3,2,3,1,0,1,0,1,1,1,0,1,3,1,2,0,0,-7,-14,7,3,1,2,-9,-3,5,4,0,-3,-7,-2,-4,2,-1,-1,-2,-1,9,2,1,-2,0,0,0,1,0,2,0,0,0,0,0,1,0,0,0,1,0,1,-11,-4,-7,6,4,2,6,-4,-5,-1,-2,-5,3,-4,-1,0,0,-2,3,0,-4,-1,-2,-3,1,2,1,1,0,1,1,1,0,1,0,1,0,1,1,0,0,0,-45,-19,-26,6,4,2,-9,-4,-11,-18,2,-6,-1,-5,-7,-8,3,-2,-8,1,-4,-10,-1,-4,1,2,1,0,1,1,1,1,0,0,1,1,0,1,1,0,0,0,-61,-39,-22,0,-1,1,-9,-8,-24,-20,2,-2,-8,-2,-12,-16,1,-1,-1,-6,-12,-4,1,-1,1,0,1,0,-1,-1,0,0,1,0,-1,-1,1,0,0,0,0,0,-12,-21,9,11,4,7,-7,-9,-27,1,6,26,-4,-8,-19,-2,2,11,-3,-1,-8,3,4,15,-1,1,1,0,4,6,0,0,0,0,0,4,-1,1,1,0,4,2,-30,-18,-12,3,-1,4,2,2,-5,-10,-11,-7,0,3,-6,-9,-5,0,2,-1,1,-1,-6,-7,2,1,0,2,-2,0,0,0,0,0,0,-1,2,1,0,2,-2,1,-33,-5,-28,7,5,2,-7,-4,-14,-4,-2,0,-7,0,0,1,0,2,0,-4,-14,-5,-2,-2,1,4,1,1,0,0,0,3,1,1,0,0,1,1,0,0,0,0,-28,-21,-7,7,2,5,-4,-5,-13,-9,2,2,-3,-7,-7,-5,2,0,-1,2,-6,-4,0,2,0,3,1,1,0,2,0,0,0,0,0,2,0,3,1,1,0,0,-21,-16,-5,4,1,3,-2,-4,-12,-5,4,-1,0,-2,-6,-6,-2,1,-2,-2,-6,1,6,-2,0,2,0,1,1,0,0,1,0,0,0,0,0,1,0,1,1,0,-12,-4,-8,1,-1,2,-4,-1,-9,-1,8,-6,2,-3,-3,-2,5,-5,-6,2,-6,1,3,-1,-2,4,-2,-1,2,0,0,2,-1,-2,1,-1,-2,2,-1,1,1,1,-4,3,-7,1,-1,2,4,-2,-9,5,-3,0,5,0,-5,5,-1,-2,-1,-2,-4,0,-2,2,0,-1,0,-1,1,2,0,-1,0,0,0,0,0,0,0,-1,1,2,-18,-7,-11,2,0,2,-5,2,1,-15,1,-2,-3,1,2,-7,2,-2,-2,1,-1,-8,-1,0,0,1,1,0,1,-1,0,-1,0,0,1,0,0,2,1,0,0,-1,10,3,7,2,2,0,-1,-1,-1,8,3,1,-4,-2,0,3,3,3,3,1,-1,5,0,-2,1,2,1,1,-2,-1,1,0,1,1,-1,0,0,2,0,0,-1,-1,-24,-11,-13,-2,-4,2,3,-3,-7,-5,-6,-5,3,0,-5,-3,-2,-4,0,-3,-2,-2,-4,-1,2,1,-2,-2,-1,0,1,0,-2,-2,-1,0,1,1,0,0,0,0,0,-9,9,3,1,2,2,-5,-1,6,-1,-1,-1,-6,-3,4,-2,-1,3,1,2,2,1,0,0,0,1,0,1,1,0,0,0,0,1,0,0,0,1,0,0,1,-9,1,-10,3,2,1,-3,1,-8,1,1,0,-1,2,-4,4,1,-1,-2,-1,-4,-3,0,1,0,1,0,2,0,0,0,1,0,1,0,0,0,0,0,1,0,0
24,24134,"Robla, La",5135,-25,-11,-14,8,4,4,1,-9,9,-14,-4,-9,0,-1,6,-13,0,-4,1,-8,3,-1,-4,-5,3,0,2,1,0,2,2,0,1,0,0,1,1,0,1,1,0,1,-19,-17,-2,15,12,3,-4,-2,-16,8,-4,-1,-4,-2,-16,9,-2,-2,0,0,0,-1,-2,1,1,2,3,8,1,0,1,0,3,7,1,0,0,2,0,1,0,0,-97,-53,-44,6,4,2,-9,-4,-30,-25,-21,-9,-6,0,-18,-14,-14,-1,-3,-4,-12,-11,-7,-8,3,2,0,1,0,0,2,1,-1,1,0,1,1,1,1,0,0,-1,-32,-7,-25,11,5,6,1,3,-10,-16,-6,-5,2,4,-5,-2,-3,-4,-1,-1,-5,-14,-3,-1,0,1,4,1,1,4,0,0,3,1,0,1,0,1,1,0,1,3,-73,-29,-44,21,12,9,-16,-14,-35,-7,-1,-3,-9,-5,-15,-1,1,-1,-7,-9,-20,-6,-2,-2,6,0,6,6,0,2,4,0,3,4,0,0,2,0,3,2,0,2,-22,-2,-20,29,19,10,5,-1,-5,-16,-3,1,1,5,1,-11,-1,2,4,-6,-6,-5,-2,-1,3,10,9,4,2,0,2,5,6,3,2,0,1,5,3,1,0,0,23,45,-22,61,47,14,9,1,-5,21,-1,-1,2,5,15,23,2,-1,7,-4,-20,-2,-3,0,6,21,20,13,1,-1,3,16,17,10,1,-1,3,5,3,3,0,0,-6,9,-15,55,30,25,5,6,-10,2,-6,-5,-1,5,5,6,1,-7,6,1,-15,-4,-7,2,9,13,15,13,3,1,4,6,13,6,2,-1,5,7,2,7,1,2,-57,-15,-42,29,17,12,-6,-17,-8,-14,1,-14,4,-11,6,-9,3,-7,-10,-6,-14,-5,-2,-7,4,1,14,6,3,0,2,0,10,3,2,0,2,1,4,3,1,0,-4,15,-19,30,19,11,0,7,-9,18,-10,-9,1,9,-2,13,-2,-3,-1,-2,-7,5,-8,-6,5,11,7,5,0,1,2,9,4,2,2,-1,3,2,3,3,-2,2,-33,-13,-20,15,8,7,7,-12,-5,-13,4,-14,8,-1,-5,-13,4,-7,-1,-11,0,0,0,-7,1,3,8,1,1,0,1,0,5,0,1,0,0,3,3,1,0,0,31,20,11,45,32,13,22,14,-3,3,3,-7,9,3,-11,13,7,-1,13,11,8,-10,-4,-6,8,11,7,16,3,0,3,7,5,14,3,0,5,4,2,2,0,0,-22,-17,-5,16,8,8,3,1,-10,-9,-2,-5,-1,3,-4,-5,-8,-2,4,-2,-6,-4,6,-3,5,5,4,2,0,0,1,3,2,2,0,0,4,2,2,0,0,0,-42,-18,-24,9,6,3,-2,-9,-26,-9,8,-4,-1,-6,-15,-1,5,-1,-1,-3,-11,-8,3,-3,1,4,2,3,-1,0,1,2,2,2,-1,0,0,2,0,1,0,0,-23,-9,-14,15,10,5,0,4,-21,1,-3,-6,-2,3,-8,0,-2,-1,2,1,-13,1,-1,-5,1,0,7,3,4,-1,1,0,5,1,3,0,0,0,2,2,1,-1,-93,-43,-50,-17,-13,-4,-14,-2,-27,-22,-15,-12,-6,1,-16,-12,-8,-3,-8,-3,-11,-10,-7,-9,3,-1,-6,-8,-4,-1,2,-1,-6,-7,-2,1,1,0,0,-1,-2,-2,-17,-5,-12,0,2,-2,1,-5,-11,-1,-5,2,-1,-1,-5,2,-2,1,2,-4,-6,-3,-3,1,0,0,-1,1,-1,0,-1,1,0,2,0,0,1,-1,-1,-1,-1,0,-268,-197,-71,-229,-173,-56,-31,-23,-58,-87,-65,-5,-14,-13,-41,-74,-51,-2,-17,-10,-17,-13,-14,-3,-23,-17,-50,-75,-60,-4,-12,-10,-35,-66,-46,-4,-11,-7,-15,-9,-14,0
24,24139,Sahagún,3223,-15,-9,-6,21,6,15,-5,0,1,-6,-6,2,-1,0,-6,0,-1,0,-4,0,7,-6,-5,2,2,5,9,5,0,0,0,1,2,3,0,0,2,4,7,2,0,0,2,12,-10,31,17,14,1,1,4,0,-1,-3,2,-1,4,5,2,0,-1,2,0,-5,-3,-3,7,7,9,8,0,0,6,2,5,4,0,0,1,5,4,4,0,0,-21,-10,-11,26,12,14,-3,2,-6,-4,-5,-4,-4,3,-4,-1,-4,0,1,-1,-2,-3,-1,-4,7,10,6,2,0,1,1,5,4,2,0,0,6,5,2,0,0,1,-6,5,-11,43,25,18,5,1,-18,1,7,0,8,-4,-9,6,1,3,-3,5,-9,-5,6,-3,17,11,7,3,4,1,10,6,5,2,1,1,7,5,2,1,3,0,-28,-15,-13,33,15,18,-4,-6,-7,-7,-1,-3,-6,-4,2,-6,2,-3,2,-2,-9,-1,-3,0,6,3,11,11,2,0,2,1,5,6,1,0,4,2,6,5,1,0,-5,0,-5,33,21,12,-5,-6,-5,1,10,0,-1,0,0,-5,7,-1,-4,-6,-5,6,3,1,3,11,13,4,2,0,1,8,9,2,1,0,2,3,4,2,1,0,-17,12,-29,25,17,8,2,-10,-15,4,-3,3,5,-6,-1,10,-1,4,-3,-4,-14,-6,-2,-1,2,13,8,2,-1,0,1,8,6,1,0,0,1,5,2,1,-1,0,45,26,19,29,17,12,7,14,6,6,4,7,4,12,3,4,2,0,3,2,3,2,2,7,3,11,1,7,5,2,3,6,2,2,4,0,0,5,-1,5,1,2,19,-3,22,34,12,22,9,0,-19,-2,11,20,4,-6,-13,-3,5,10,5,6,-6,1,6,10,11,4,11,4,3,1,5,-1,7,1,0,0,6,5,4,3,3,1,31,10,21,5,4,1,-3,-7,4,0,13,24,-6,-2,6,-5,5,12,3,-5,-2,5,8,12,2,2,-4,2,2,1,0,1,-1,2,1,1,2,1,-3,0,1,0,36,16,20,6,4,2,2,0,-1,5,2,25,2,-1,5,-4,2,11,0,1,-6,9,0,14,3,4,0,-1,1,-1,3,2,2,-2,-1,0,0,2,-2,1,2,-1,30,34,-4,53,49,4,2,-5,6,27,3,-2,-4,-2,5,34,3,-3,6,-3,1,-7,0,1,0,1,9,35,7,1,-3,0,7,37,8,0,3,1,2,-2,-1,1,15,10,5,14,6,8,2,6,5,-2,-2,5,2,6,3,-4,-3,4,0,0,2,2,1,1,4,7,4,-1,-1,0,2,4,2,-2,-1,0,2,3,2,1,0,0,21,4,17,-11,-10,-1,9,0,0,3,-3,13,7,0,-7,2,-3,7,2,0,7,1,0,6,-1,0,-3,-1,-6,0,-1,0,-3,-2,-4,0,0,0,0,1,-2,0,-37,-14,-23,5,4,1,-6,-5,-11,-12,-1,-3,-7,-1,-1,-4,-2,0,1,-4,-10,-8,1,-3,4,-1,2,-3,2,1,2,0,1,-2,3,0,2,-1,1,-1,-1,1,-32,-22,-10,-9,-4,-5,-13,-5,-18,0,-1,6,-7,-4,-10,-2,0,2,-6,-1,-8,2,-1,4,-1,-2,-2,-3,0,-1,0,0,-1,-1,-1,-1,-1,-2,-1,-2,1,0,2,-6,8,4,0,4,1,1,1,-8,10,-4,1,0,-4,-6,4,-1,0,1,5,-2,6,-3,3,-1,0,0,1,1,1,-1,0,-2,0,2,2,0,0,2,1,-1,-45,-36,-9,-33,-36,3,7,-3,-6,-23,-20,0,7,1,-6,-23,-17,1,0,-4,0,0,-3,-1,2,3,4,-22,-21,1,2,2,1,-25,-17,1,0,1,3,3,-4,0
24,24142,San Andrés del Rabanedo,23687,335,139,196,66,22,44,61,37,121,100,7,-1,18,30,44,49,-2,-3,43,7,77,51,9,2,11,16,17,13,7,2,3,5,7,5,1,1,8,11,10,8,6,1,557,266,291,98,45,53,85,74,238,89,20,39,51,22,119,48,3,19,34,52,119,41,17,20,18,23,37,15,5,0,12,4,17,9,3,0,6,19,20,6,2,0,1289,654,635,128,55,73,262,184,449,160,123,95,164,96,220,61,61,42,98,88,229,99,62,53,39,23,33,20,8,5,22,10,12,5,4,2,17,13,21,15,4,3,312,155,157,90,45,45,46,49,166,-13,42,18,22,18,75,8,22,10,24,31,91,-21,20,8,26,19,23,5,15,1,13,6,12,3,9,1,13,13,11,2,6,0,694,339,355,110,47,63,123,93,282,124,35,29,70,34,137,67,21,9,53,59,145,57,14,20,24,30,25,19,8,1,12,14,11,6,4,-1,12,16,14,13,4,2,739,346,393,149,67,82,116,66,346,122,31,45,57,29,176,59,8,12,59,37,170,63,23,33,30,28,48,28,10,4,14,15,19,15,0,3,16,13,29,13,10,1,817,394,423,143,78,65,157,110,329,125,53,30,89,52,130,80,23,14,68,58,199,45,30,16,48,21,44,22,2,4,26,13,26,12,0,1,22,8,18,10,2,3,664,326,338,205,108,97,75,67,284,127,35,72,14,33,172,64,12,25,61,34,112,63,23,47,59,38,56,40,7,2,28,15,37,21,3,2,31,23,19,19,4,0,516,291,225,178,80,98,21,83,195,83,77,58,11,53,125,43,36,21,10,30,70,40,41,37,44,33,45,28,16,11,25,16,20,9,6,3,19,17,25,19,10,8,322,148,174,68,30,38,61,61,42,52,47,53,37,14,17,34,16,27,24,47,25,18,31,26,17,16,14,11,6,3,11,10,7,0,1,1,6,6,7,11,5,2,196,93,103,83,47,36,-19,51,16,62,35,52,12,12,19,10,11,24,-31,39,-3,52,24,28,10,25,21,15,7,4,8,14,14,4,4,2,2,11,7,11,3,2,143,60,83,91,50,41,21,21,10,23,29,47,5,21,1,5,13,27,16,0,9,18,16,20,13,16,19,26,9,6,8,8,11,11,4,6,5,8,8,15,5,0,85,6,79,56,21,35,29,19,39,-37,13,21,26,4,-13,-13,-1,3,3,15,52,-24,14,18,17,22,4,4,6,0,10,8,-1,1,2,-1,7,14,5,3,4,1,-84,-86,2,43,28,15,-34,41,-44,-36,-11,8,-26,14,-15,-53,-5,5,-8,27,-29,17,-6,3,9,19,3,6,5,1,7,15,-1,2,4,1,2,4,4,4,1,0,19,-31,50,58,16,42,-3,2,21,0,-12,10,2,-12,-5,-10,-14,5,-5,14,26,10,2,5,7,28,12,1,5,3,0,9,5,0,0,1,7,19,7,1,5,2,-211,-119,-92,-116,-66,-50,17,-28,-96,-58,-27,-16,15,-13,-57,-42,-5,-13,2,-15,-39,-16,-22,-3,-10,-3,-22,-47,-24,-10,-4,-7,-8,-35,-7,-5,-6,4,-14,-12,-17,-5,-287,-167,-120,16,4,12,-89,-57,-80,-64,1,-8,-49,-43,-30,-55,9,-3,-40,-14,-50,-9,-8,-5,13,4,4,-5,-3,3,2,3,1,-3,-1,2,11,1,3,-2,-2,1,-141,-76,-65,59,27,32,-29,-15,-34,-75,-27,29,-14,-11,-15,-11,-31,-1,-15,-4,-19,-64,4,30,9,20,11,6,7,4,3,8,9,0,4,2,6,12,2,6,3,2
24,24157,Santa María del Páramo,3163,17,13,4,2,1,1,5,-3,10,2,6,-3,5,-1,8,1,3,-3,0,-2,2,1,3,0,0,0,0,1,1,0,0,0,0,1,0,0,0,0,0,0,1,0,18,10,8,21,6,15,7,-1,6,0,4,2,4,-2,6,-2,4,0,3,1,0,2,0,2,5,4,8,3,0,1,1,0,4,1,0,0,4,4,4,2,0,1,22,4,18,19,10,9,2,4,10,-7,5,5,2,0,1,-3,0,3,0,4,9,-4,5,2,7,3,4,2,3,0,4,2,1,2,1,0,3,1,3,0,2,0,-14,2,-16,5,2,3,-2,-11,1,-13,3,7,-1,-3,3,-4,0,7,-1,-8,-2,-9,3,0,3,0,1,1,0,0,1,0,0,1,0,0,2,0,1,0,0,0,-10,1,-11,15,8,7,-3,-3,-14,1,7,3,-3,1,-5,3,3,2,0,-4,-9,-2,4,1,5,4,3,1,1,1,3,2,2,0,0,1,2,2,1,1,1,0,12,1,11,13,4,9,2,1,-5,5,5,2,0,-1,0,-1,1,0,2,2,-5,6,4,2,1,3,4,3,2,0,1,1,0,1,1,0,0,2,4,2,1,0,5,6,-1,17,11,6,3,11,6,-14,5,-5,4,0,8,-7,3,-2,-1,11,-2,-7,2,-3,0,3,9,2,2,1,1,0,7,2,1,0,-1,3,2,0,1,1,40,39,1,37,27,10,19,7,-3,13,1,3,18,5,8,9,0,1,1,2,-11,4,1,2,10,8,7,10,1,0,8,4,7,8,0,0,2,4,0,2,1,0,36,23,13,10,6,4,13,-7,18,6,-3,7,5,-1,8,6,-1,4,8,-6,10,0,-2,3,0,2,5,2,1,0,0,1,3,1,1,0,0,1,2,1,0,0,28,8,20,17,3,14,8,3,4,3,4,3,2,3,0,0,0,1,6,0,4,3,4,2,5,2,4,5,0,1,2,1,-1,1,0,0,3,1,5,4,0,1,6,5,1,-3,-1,-2,0,2,-3,3,1,3,-8,4,3,2,4,1,8,-2,-6,1,-3,2,-1,3,-1,-2,-2,0,-1,1,0,-1,0,0,0,2,-1,-1,-2,0,11,-1,12,1,-1,2,6,4,-4,-4,10,3,5,0,-5,-3,4,2,1,4,1,-1,6,1,0,-1,1,-1,4,-2,0,-1,0,0,1,-1,0,0,1,-1,3,-1,14,3,11,6,2,4,-3,-2,2,3,10,3,0,-1,-3,0,4,3,-3,-1,5,3,6,0,3,2,0,-1,1,0,1,1,0,0,0,0,2,1,0,-1,1,0,4,6,-2,-2,1,-3,2,-3,3,-8,9,0,1,-1,2,-4,6,2,1,-2,1,-4,3,-2,2,0,-2,-4,1,0,2,1,-1,-2,1,0,0,-1,-1,-2,0,0,-15,-12,-3,-6,-3,-3,6,-4,-19,-6,2,8,2,-4,-10,-5,3,3,4,0,-9,-1,-1,5,-1,1,-4,-1,-1,0,-1,-1,-1,0,0,0,0,2,-3,-1,-1,0,23,8,15,11,0,11,9,4,3,2,4,-3,5,-5,6,2,1,-2,4,9,-3,0,3,-1,7,1,3,1,-2,0,2,-1,2,-1,-2,0,5,2,1,2,0,0,6,2,4,2,2,0,-1,1,-1,0,5,1,0,4,-6,3,0,1,-1,-3,5,-3,5,0,1,0,0,-1,3,-1,1,1,-1,0,1,0,0,-1,1,-1,2,-1,-9,-1,-8,-4,-3,-1,5,-6,-10,2,-2,1,0,-5,-2,7,-1,0,5,-1,-8,-5,-1,1,-1,2,-7,1,1,0,-2,1,-4,2,0,0,1,1,-3,-1,1,0
24,24162,Santovenia de la Valdoncina,1643,45,24,21,6,1,5,4,5,13,17,2,5,1,3,8,10,-1,4,3,2,5,7,3,1,0,3,3,0,0,0,0,0,1,0,0,0,0,3,2,0,0,0,10,23,-13,5,4,1,-3,1,13,-5,2,0,2,0,13,2,4,1,-5,1,0,-7,-2,-1,1,0,3,0,1,0,1,0,2,0,1,0,0,0,1,0,0,0,24,8,16,4,3,1,-3,0,20,2,2,1,-1,-2,8,1,3,-1,-2,2,12,1,-1,2,1,0,2,0,1,0,1,0,1,1,0,0,0,0,1,-1,1,0,15,7,8,3,2,1,2,2,1,9,3,-4,0,1,-3,6,2,-1,2,1,4,3,1,-3,0,0,2,0,1,0,0,0,1,0,1,0,0,0,1,0,0,0,64,24,40,6,1,5,9,8,22,7,11,3,6,1,10,2,5,1,3,7,12,5,6,2,0,3,3,0,0,0,0,0,1,0,0,0,0,3,2,0,0,0,9,15,-6,5,3,2,-11,5,14,1,0,1,-2,1,7,6,1,2,-9,4,7,-5,-1,-1,0,1,3,1,0,0,0,0,1,2,0,0,0,1,2,-1,0,0,-9,-1,-8,1,0,1,-4,5,1,2,-7,-6,-4,6,-1,4,-3,-2,0,-1,2,-2,-4,-4,0,0,3,0,-2,0,0,0,1,0,-1,0,0,0,2,0,-1,0,21,20,1,11,7,4,5,-4,14,10,1,-4,2,-6,18,9,1,-3,3,2,-4,1,0,-1,0,3,4,2,1,1,0,0,4,2,0,1,0,3,0,0,1,0,18,2,16,4,2,2,3,-3,-2,19,-2,3,-3,-1,-9,13,0,1,6,-2,7,6,-2,2,3,-2,3,1,-1,0,3,0,-1,0,0,0,0,-2,4,1,-1,0,6,-3,9,0,1,-1,1,3,3,-10,10,-1,-1,2,-1,-7,4,0,2,1,4,-3,6,-1,2,1,-1,-2,0,0,2,1,-1,-1,0,0,0,0,0,-1,0,0,8,8,0,8,2,6,4,-6,16,6,-1,-11,-3,-3,11,10,-1,-6,7,-3,5,-4,0,-5,3,1,3,2,0,-1,0,0,3,0,0,-1,3,1,0,2,0,0,5,5,0,-5,-2,-3,2,4,12,-3,-7,-1,5,2,9,-5,-4,0,-3,2,3,2,-3,-1,-2,1,-2,-2,0,0,0,0,-1,-1,0,0,-2,1,-1,-1,0,0,-13,5,-18,-6,-6,0,-15,5,0,-6,9,-4,-7,6,1,1,6,-1,-8,-1,-1,-7,3,-3,0,0,-2,-4,0,0,0,0,-3,-3,0,0,0,0,1,-1,0,0,2,-3,5,3,2,1,-1,3,9,-7,-2,-1,2,6,3,-7,-3,-3,-3,-3,6,0,1,2,2,1,0,0,0,0,2,0,0,1,0,-1,0,1,0,-1,0,1,15,15,0,2,1,1,3,4,-11,11,5,4,4,0,-5,11,2,3,-1,4,-6,0,3,1,-1,1,0,-2,3,1,0,1,0,-1,1,0,-1,0,0,-1,2,1,4,2,2,-7,-5,-2,0,2,2,-1,2,-2,3,-1,3,-2,0,-1,-3,3,-1,1,2,-1,0,0,-1,-5,0,-1,0,0,0,-4,0,-1,0,0,-1,-1,0,0,34,18,16,-6,-1,-5,9,0,12,3,4,4,6,-4,7,5,1,1,3,4,5,-2,3,3,0,0,1,-4,-1,-2,0,0,1,-1,-1,0,0,0,0,-3,0,-2,47,17,30,1,0,1,12,6,13,5,7,4,4,0,4,4,4,1,8,6,9,1,3,3,0,0,0,0,1,0,0,0,0,0,0,0,0,0,0,0,1,0
24,24170,Torre del Bierzo,3240,-60,-23,-37,7,4,3,-15,-7,-9,-18,-1,-9,-4,-3,-2,-11,-1,-1,-11,-4,-7,-7,0,-8,0,3,1,1,2,0,0,2,1,0,1,0,0,1,0,1,1,0,-51,-20,-31,4,2,2,-5,-11,-13,-21,2,-3,0,-5,-7,-10,3,-1,-5,-6,-6,-11,-1,-2,3,0,1,0,0,0,1,0,1,0,0,0,2,0,0,0,0,0,-79,-37,-42,14,5,9,-21,-16,-20,-17,-6,1,-14,-9,-6,-8,-3,3,-7,-7,-14,-9,-3,-2,5,1,1,3,2,2,1,0,2,1,0,1,4,1,-1,2,2,1,-64,-33,-31,4,2,2,-6,-13,-19,-18,-1,-6,-1,-5,-11,-9,-2,-4,-5,-8,-8,-9,1,-2,1,1,0,2,0,0,0,1,0,1,0,0,1,0,0,1,0,0,-54,-35,-19,22,7,15,0,-14,-22,-9,-3,-7,-4,-6,-15,-8,2,-5,4,-8,-7,-1,-5,-2,5,5,3,7,2,0,0,1,2,3,1,0,5,4,1,4,1,0,-31,-9,-22,17,16,1,-2,-7,-8,-4,-4,-6,0,-6,-1,0,-3,0,-2,-1,-7,-4,-1,-6,3,4,3,3,1,3,3,4,3,3,1,2,0,0,0,0,0,1,-39,-16,-23,17,9,8,-6,-6,-12,-11,3,-6,0,-6,-7,-3,1,0,-6,0,-5,-8,2,-6,5,3,2,3,2,2,3,1,2,1,1,1,2,2,0,2,1,1,-72,-43,-29,8,5,3,-10,-23,-18,-8,-1,-13,-9,-10,-13,-6,1,-5,-1,-13,-5,-2,-2,-8,1,1,2,3,1,0,1,0,0,3,1,0,0,1,2,0,0,0,-52,-25,-27,9,5,4,-3,5,-24,-9,-3,-16,-2,6,-9,-12,0,-7,-1,-1,-15,3,-3,-9,2,6,0,1,0,0,2,2,1,0,0,0,0,4,-1,1,0,0,18,11,7,17,10,7,4,7,10,8,1,-12,2,6,2,3,2,-3,2,1,8,5,-1,-9,4,3,4,3,2,1,3,2,2,1,2,0,1,1,2,2,0,1,-10,-1,-9,3,2,1,7,5,-12,-3,0,-7,2,0,-3,1,3,-4,5,5,-9,-4,-3,-3,2,0,1,0,0,0,0,0,1,0,1,0,2,0,0,0,-1,0,-37,-6,-31,4,3,1,-4,-6,-23,-4,10,-9,-3,0,-12,3,8,-3,-1,-6,-11,-7,2,-6,2,1,-1,0,2,0,1,1,-1,1,1,0,1,0,0,-1,1,0,-2,-5,3,10,4,6,2,3,2,-4,1,-5,1,1,-3,-5,2,-1,1,2,5,1,-1,-4,3,3,0,1,2,1,1,1,0,0,1,1,2,2,0,1,1,0,-25,-12,-13,4,1,3,-5,-9,-2,-12,3,0,1,-7,1,-7,-1,2,-6,-2,-3,-5,4,-2,0,0,0,1,1,2,0,0,0,0,0,1,0,0,0,1,1,1,-11,-1,-10,1,1,0,-1,2,-7,-4,-1,1,-2,5,-1,-2,-3,2,1,-3,-6,-2,2,-1,0,0,0,0,0,1,0,1,0,0,0,0,0,-1,0,0,0,1,-11,-11,0,0,-2,2,3,7,-8,-12,-2,2,0,3,-5,-8,0,-1,3,4,-3,-4,-2,3,1,0,1,-1,-2,1,0,0,1,0,-2,-1,1,0,0,-1,0,2,-48,-24,-24,1,0,1,-5,-6,-20,-9,-1,-8,-5,-3,-8,-3,-4,-2,0,-3,-12,-6,3,-6,1,-1,1,-1,1,0,1,0,0,-1,0,0,0,-1,1,0,1,0,-72,-43,-29,-51,-30,-21,-9,-5,-26,-19,-6,-6,-3,-2,-14,-16,-5,-3,-6,-3,-12,-3,-1,-3,-8,-5,-15,-14,-9,0,-4,-2,-10,-9,-5,0,-4,-3,-5,-5,-4,0
24,24175,Valdefresno,1671,52,35,17,6,3,3,12,8,13,17,9,-9,5,7,10,11,7,-6,7,1,3,6,2,-3,1,1,0,1,2,0,0,1,0,1,1,0,1,0,0,0,1,0,59,29,30,6,3,3,9,-1,25,19,9,-2,4,-1,14,11,2,-1,5,0,11,8,7,-1,0,1,3,1,1,0,0,0,2,0,1,0,0,1,1,1,0,0,47,25,22,8,3,5,-2,6,13,17,8,4,-1,2,9,10,0,4,-1,4,4,7,8,0,1,1,3,1,1,1,1,1,1,0,0,0,0,0,2,1,1,1,24,16,8,2,3,-1,-6,9,-3,8,11,8,-4,5,-4,6,8,6,-2,4,1,2,3,2,0,-1,1,2,0,0,0,0,1,2,0,0,0,-1,0,0,0,0,12,9,3,3,1,2,3,1,3,12,6,-13,1,1,5,3,4,-5,2,0,-2,9,2,-8,0,0,1,1,0,1,0,0,0,0,0,1,0,0,1,1,0,0,60,34,26,21,11,10,3,10,16,13,14,5,-1,7,6,10,9,4,4,3,10,3,5,1,1,9,4,6,1,0,1,5,2,2,1,0,0,4,2,4,0,0,40,20,20,14,8,6,3,7,12,3,12,3,-1,6,3,1,10,2,4,1,9,2,2,1,0,7,5,1,0,1,0,4,3,0,0,1,0,3,2,1,0,0,45,20,25,6,5,1,6,8,-5,20,6,8,3,4,-2,11,4,0,3,4,-3,9,2,8,0,3,2,1,0,0,0,2,2,1,0,0,0,1,0,0,0,0,47,32,15,6,6,0,23,1,9,16,2,-4,13,5,4,8,2,-1,10,-4,5,8,0,-3,0,5,1,0,0,0,0,4,2,0,0,0,0,1,-1,0,0,0,-20,-6,-14,-7,-3,-4,-21,-6,-2,3,11,-3,-8,-2,-1,2,5,-2,-13,-4,-1,1,6,-1,-5,-2,0,0,0,0,-1,-1,-1,0,0,0,-4,-1,1,0,0,0,-3,-4,1,2,0,2,5,-5,-2,5,-4,-2,4,-6,-2,-1,-1,2,1,1,0,6,-3,-4,0,-1,3,0,0,0,0,-2,2,0,0,0,0,1,1,0,0,0,2,7,-5,3,2,1,-6,8,-3,4,2,-4,-3,5,3,4,0,-2,-3,3,-6,0,2,-2,3,0,1,0,-1,0,1,0,1,0,0,0,2,0,0,0,-1,0,42,32,10,0,-1,1,1,6,20,11,6,-2,0,3,18,8,5,-2,1,3,2,3,1,0,0,2,-1,0,0,-1,0,1,-1,0,0,-1,0,1,0,0,0,0,47,18,29,-2,-1,-1,14,1,15,7,3,6,5,1,5,3,0,4,9,0,10,4,3,2,0,0,-1,-1,0,0,0,0,0,-1,0,0,0,0,-1,0,0,0,27,18,9,-2,-3,1,-2,0,-9,23,18,0,2,-2,-7,16,10,-2,-4,2,-2,7,8,2,0,-1,0,-1,1,-1,0,-1,0,-1,0,-1,0,0,0,0,1,0,25,12,13,-4,-3,-1,9,3,6,7,-2,2,6,1,3,0,2,0,3,2,3,7,-4,2,0,0,-3,-1,0,0,0,0,-3,0,0,0,0,0,0,-1,0,0,31,10,21,3,2,1,4,3,8,4,8,0,0,2,-2,2,5,1,4,1,10,2,3,-1,0,1,-1,3,0,0,0,1,-1,2,0,0,0,0,0,1,0,0,22,12,10,1,-2,3,6,-1,-1,8,5,3,7,-1,-3,8,-2,3,-1,0,2,0,7,0,1,0,0,-2,2,0,0,0,-1,-1,0,0,1,0,1,-1,2,0
24,24188,Valencia de Don Juan,3980,38,31,7,14,6,8,6,12,15,5,3,-3,2,8,10,5,7,-1,4,4,5,0,-4,-2,5,6,2,1,0,0,3,2,1,0,0,0,2,4,1,1,0,0,65,38,27,15,6,9,13,0,26,11,12,3,8,-2,16,8,6,2,5,2,10,3,6,1,1,1,6,2,4,1,1,0,2,1,1,1,0,1,4,1,3,0,14,9,5,9,3,6,-4,3,10,7,-2,1,0,0,1,8,0,1,-4,3,9,-1,-2,0,2,0,1,4,1,1,1,0,0,1,0,1,1,0,1,3,1,0,61,16,45,19,7,12,8,10,32,-6,5,12,6,0,8,-8,3,7,2,10,24,2,2,5,3,6,5,1,2,2,1,1,2,1,1,1,2,5,3,0,1,1,120,57,63,31,13,18,20,22,41,15,12,10,11,8,24,2,5,7,9,14,17,13,7,3,4,8,9,5,4,1,2,2,4,3,1,1,2,6,5,2,3,0,26,20,6,29,15,14,7,7,9,-6,12,-4,6,1,9,-1,6,-1,1,6,0,-5,6,-3,5,7,6,7,3,0,4,2,4,3,2,0,1,5,2,4,1,0,131,73,58,34,16,18,21,17,57,18,13,4,15,7,30,10,7,3,6,10,27,8,6,1,5,9,14,3,3,0,3,2,8,1,2,0,2,7,6,2,1,0,240,112,128,74,37,37,47,28,62,56,31,14,11,16,27,33,15,9,36,12,35,23,16,5,23,12,16,17,5,0,9,5,12,9,2,0,14,7,4,8,3,0,223,120,103,60,30,30,44,32,57,40,32,15,20,18,28,26,17,10,24,14,29,14,15,5,7,22,12,9,7,3,3,9,8,4,4,2,4,13,4,5,3,1,31,11,20,45,24,21,9,-3,15,8,4,-3,7,-2,10,1,-3,-3,2,-1,5,7,7,0,10,5,19,3,7,1,3,2,12,3,4,0,7,3,7,0,3,1,20,3,17,28,16,12,-1,0,-8,0,12,16,-1,-2,-3,3,-2,8,0,2,-5,-3,14,8,6,6,6,9,2,-1,4,3,3,5,1,0,2,3,3,4,1,-1,85,38,47,47,25,22,20,8,40,12,7,-4,11,5,14,5,2,1,9,3,26,7,5,-5,9,11,12,9,0,5,6,6,5,4,0,3,3,5,7,5,0,2,41,13,28,7,3,4,-1,14,-3,14,6,11,1,0,5,1,0,6,-2,14,-8,13,6,5,0,6,2,1,-1,-1,0,3,2,0,-1,-1,0,3,0,1,0,0,12,3,9,11,2,9,16,12,-8,6,-5,-8,11,8,-8,2,-6,-2,5,4,0,4,1,-6,2,5,1,3,-1,1,0,2,0,1,-2,1,2,3,1,2,1,0,14,9,5,21,8,13,11,3,-7,-3,13,-2,7,3,-10,-1,10,0,4,0,3,-2,3,-2,2,6,4,3,2,3,0,4,1,1,0,2,2,2,3,2,2,1,65,36,29,12,3,9,14,5,13,19,3,8,5,2,12,9,1,5,9,3,1,10,2,3,5,8,-3,-1,1,1,1,2,-2,0,0,2,4,6,-1,-1,1,-1,55,27,28,25,12,13,2,4,34,-8,10,11,2,0,22,-6,5,2,0,4,12,-2,5,9,2,6,13,-2,5,0,1,4,6,-1,1,0,1,2,7,-1,4,0,50,18,32,31,13,18,14,-4,13,14,3,11,13,-9,-5,13,-1,7,1,5,18,1,4,4,5,12,10,2,4,-2,4,2,3,2,2,0,1,10,7,0,2,-2
24,24189,Valverde de la Virgen,4297,48,26,22,8,1,7,-15,23,31,-7,5,6,-2,7,18,-3,1,3,-13,16,13,-4,4,3,1,3,2,1,1,0,0,0,1,0,0,0,1,3,1,1,1,0,116,75,41,7,3,4,15,4,69,10,10,6,10,4,45,6,6,3,5,0,24,4,4,3,0,0,5,1,1,0,0,0,2,1,0,0,0,0,3,0,1,0,66,39,27,15,6,9,15,19,19,4,6,4,13,10,6,4,5,3,2,9,13,0,1,1,5,4,3,3,0,0,1,2,1,2,0,0,4,2,2,1,0,0,178,80,98,18,8,10,3,29,55,43,13,35,-7,19,33,21,8,8,10,10,22,22,5,27,6,3,4,0,2,2,4,1,1,0,1,1,2,2,3,0,1,1,60,35,25,14,3,11,1,13,30,-1,9,7,1,7,21,5,0,1,0,6,9,-6,9,6,1,5,4,0,3,1,1,0,1,0,0,1,0,5,3,0,3,0,185,101,84,64,46,18,19,30,68,28,20,11,11,9,39,19,10,8,8,21,29,9,10,3,8,21,22,11,1,0,5,15,19,7,0,0,3,6,3,4,1,0,332,185,147,56,39,17,46,71,114,59,21,18,23,31,74,34,10,11,23,40,40,25,11,7,4,25,15,11,-1,2,1,15,12,10,-1,2,3,10,3,1,0,0,358,188,170,64,37,27,60,48,172,44,13,15,29,15,98,29,5,7,31,33,74,15,8,8,15,12,22,11,2,1,9,6,11,8,1,1,6,6,11,3,1,0,209,108,101,27,11,16,18,43,72,47,14,8,13,20,35,28,5,4,5,23,37,19,9,4,9,10,6,1,4,-4,3,7,2,-2,1,-1,6,3,4,3,3,-3,136,73,63,9,6,3,0,10,56,28,-2,38,5,8,26,18,0,14,-5,2,30,10,-2,24,7,3,3,-5,1,0,7,3,-2,-3,1,0,0,0,5,-2,0,0,291,178,113,23,10,13,7,70,191,-4,7,16,-2,51,132,-8,2,1,9,19,59,4,5,15,2,9,8,3,1,0,2,2,3,2,1,0,0,7,5,1,0,0,215,120,95,4,-4,8,0,65,140,-12,12,4,-7,50,82,-13,12,-7,7,15,58,1,0,11,1,5,2,-5,0,0,-1,-1,0,-1,-1,0,2,6,2,-4,1,0,22,42,-20,-15,-6,-9,-12,39,-28,0,7,18,0,21,-1,12,4,7,-12,18,-27,-12,3,11,-2,-3,-9,0,-1,0,0,-1,-4,-1,0,0,-2,-2,-5,1,-1,0,73,16,57,-13,-9,-4,-25,61,33,-11,8,6,-18,26,5,-12,8,4,-7,35,28,1,0,2,0,0,-11,-4,-2,4,0,-2,-7,-2,-2,4,0,2,-4,-2,0,0,117,96,21,-15,-8,-7,-18,51,44,-5,15,28,-13,36,41,3,16,12,-5,15,3,-8,-1,16,-3,-1,-3,-8,0,0,-4,1,-2,-4,0,1,1,-2,-1,-4,0,-1,-107,-61,-46,-13,-9,-4,-20,9,-120,3,6,15,-10,19,-66,-4,-2,3,-10,-10,-54,7,8,12,-2,0,-8,-2,-1,0,-2,2,-3,-4,-2,0,0,-2,-5,2,1,0,-38,-21,-17,11,7,4,17,11,-69,-10,-5,13,15,7,-51,-4,1,9,2,4,-18,-6,-6,4,3,2,2,-1,5,-1,3,-1,1,0,3,0,0,3,1,-1,2,-1,-17,-18,1,24,7,17,-13,2,-60,19,11,28,-3,10,-55,14,3,13,-10,-8,-5,5,8,15,3,4,8,3,0,6,1,1,3,0,0,2,2,3,5,3,0,4
24,24209,Villafranca del Bierzo,3941,-12,-8,-4,17,4,13,0,-12,-6,-6,5,7,-1,-5,-7,-4,3,6,1,-7,1,-2,2,1,5,1,6,3,1,1,1,0,2,0,0,1,4,1,4,3,1,0,-5,1,-6,12,4,8,-1,-5,-7,0,7,0,4,-1,-5,-1,3,1,-5,-4,-2,1,4,-1,2,1,1,0,6,2,0,1,0,0,2,1,2,0,1,0,4,1,77,25,52,17,5,12,11,1,16,13,15,18,3,-2,1,7,5,9,8,3,15,6,10,9,4,3,0,1,9,0,1,0,1,0,5,-2,3,3,-1,1,4,2,44,20,24,12,5,7,12,12,16,-3,3,3,8,2,11,-4,2,0,4,10,5,1,1,3,0,5,1,1,2,3,0,1,1,1,1,1,0,4,0,0,1,2,4,1,3,15,9,6,-2,-2,1,-3,13,-2,-3,-4,6,-4,6,0,1,2,-5,1,7,-2,1,1,3,0,8,2,0,0,2,1,5,1,1,1,1,-1,3,1,-14,-14,0,13,8,5,-10,3,-7,0,7,-7,-3,-1,-8,-2,4,-4,-7,4,1,2,3,-3,0,3,2,6,2,0,0,1,1,3,2,1,0,2,1,3,0,-1,-25,-18,-7,24,10,14,-4,-4,-24,-8,17,1,-3,-1,-13,-3,4,0,-1,-3,-11,-5,13,1,3,3,6,2,6,4,1,1,4,0,2,2,2,2,2,2,4,2,-16,17,-33,21,16,5,-13,-1,-1,3,2,-7,-5,8,4,5,4,1,-8,-9,-5,-2,-2,-8,0,9,7,2,4,-1,0,7,5,1,4,-1,0,2,2,1,0,0,16,-6,22,39,17,22,16,11,-11,4,6,-11,5,5,-8,-3,1,-7,11,6,-3,7,5,-4,8,9,10,13,0,-1,3,5,5,5,0,-1,5,4,5,8,0,0,47,20,27,23,12,11,17,4,4,23,3,-3,8,-3,4,16,-2,-3,9,7,0,7,5,0,3,8,5,7,1,-1,2,5,3,2,0,0,1,3,2,5,1,-1,22,24,-2,7,3,4,2,23,-7,3,2,-3,4,10,7,2,1,-2,-2,13,-14,1,1,-1,2,4,0,0,1,0,2,1,0,0,1,-1,0,3,0,0,0,1,3,10,-7,5,2,3,10,-5,3,-2,3,-6,3,-1,6,-5,3,3,7,-4,-3,3,0,-9,2,-1,1,-2,1,4,1,0,1,-1,-2,3,1,-1,0,-1,3,1,-32,-28,-4,-1,1,-2,-7,0,-23,1,-1,-2,-5,-1,-12,-7,0,-3,-2,1,-11,8,-1,1,-3,0,1,1,-1,1,-2,0,1,1,0,1,-1,0,0,0,-1,0,-27,-26,-1,2,1,1,-4,-3,-13,-18,3,11,-5,0,-14,-10,0,4,1,-3,1,-8,3,7,1,1,1,-2,-1,2,2,1,0,-1,-1,0,-1,0,1,-1,0,2,-15,5,-20,19,8,11,14,0,-19,-9,-2,-1,10,0,-4,-1,-4,3,4,0,-15,-8,2,-4,7,3,1,1,4,3,4,1,0,0,1,2,3,2,1,1,3,1,35,21,14,28,16,12,10,6,0,11,4,4,0,2,1,11,3,5,10,4,-1,0,1,-1,11,3,5,8,1,-1,2,1,6,7,0,0,9,2,-1,1,1,-1,-35,-14,-21,6,3,3,-13,-11,-7,-10,7,1,-7,-3,-5,-6,6,2,-6,-8,-2,-4,1,-1,1,2,-1,2,2,1,0,1,0,1,1,1,1,1,-1,1,1,0,0,-3,3,15,7,8,5,1,-11,2,-3,5,3,-1,-3,3,-5,-1,2,2,-8,-1,2,6,2,2,3,7,0,1,0,1,3,3,0,0,2,1,0,4,0,1
24,24222,Villaquilambre,7718,710,371,339,43,18,25,116,97,283,105,74,25,60,43,151,61,40,13,56,54,132,44,34,12,7,12,13,6,4,1,5,2,7,2,2,0,2,10,6,4,2,1,527,248,279,16,5,11,74,79,207,97,61,9,28,33,102,46,35,3,46,46,105,51,26,6,4,4,4,2,2,0,2,1,0,1,1,0,2,3,4,1,1,0,833,410,423,41,19,22,131,113,330,145,66,36,69,44,172,76,33,7,62,69,158,69,33,29,8,6,12,3,7,5,5,5,5,0,2,2,3,1,7,3,5,3,991,518,473,13,6,7,120,154,452,128,56,61,67,71,254,60,33,24,53,83,198,68,23,37,3,3,1,1,4,1,2,0,0,0,3,1,1,3,1,1,1,0,843,390,453,36,12,24,92,134,371,145,54,23,40,54,168,75,27,11,52,80,203,70,27,12,7,10,13,4,3,-1,4,1,4,2,1,0,3,9,9,2,2,-1,704,385,319,55,25,30,63,111,308,116,59,29,35,55,170,71,39,7,28,56,138,45,20,22,12,15,15,11,2,0,7,1,8,8,0,1,5,14,7,3,2,-1,1108,545,563,86,37,49,112,159,505,191,83,41,46,68,274,96,36,17,66,91,231,95,47,24,15,24,27,17,0,3,8,10,14,5,-1,1,7,14,13,12,1,2,812,407,405,80,42,38,62,147,376,127,44,35,42,52,208,66,17,16,20,95,168,61,27,19,13,26,21,18,2,-1,6,7,15,13,1,0,7,19,6,5,1,-1,666,311,355,60,29,31,70,123,316,76,42,28,36,60,143,35,23,8,34,63,173,41,19,20,17,19,13,5,6,0,12,8,5,1,3,0,5,11,8,4,3,0,457,215,242,57,29,28,36,68,205,93,7,37,10,38,100,46,-1,13,26,30,105,47,8,24,12,11,14,16,0,4,3,8,6,12,0,0,9,3,8,4,0,4,205,123,82,44,19,25,5,26,123,9,27,27,6,15,76,13,17,6,-1,11,47,-4,10,21,14,7,21,2,-3,1,7,2,10,2,-2,0,7,5,11,0,-1,1,-95,-53,-42,32,19,13,-75,34,-33,-30,-10,16,-37,13,-14,-13,-8,3,-38,21,-19,-17,-2,13,7,11,4,5,1,2,4,6,1,3,1,2,3,5,3,2,0,0,44,27,17,24,13,11,-3,25,40,-3,-14,6,6,15,26,2,-10,0,-9,10,14,-5,-4,6,6,8,5,2,0,1,4,5,3,0,0,0,2,3,2,2,0,1,30,4,26,4,4,0,-14,28,7,-26,17,28,-6,16,3,-27,9,13,-8,12,4,1,8,15,-4,5,4,-4,2,1,1,1,2,-1,1,0,-5,4,2,-3,1,1,-91,-82,-9,-108,-64,-44,-26,-4,-6,-53,-6,2,-26,0,-2,-43,-1,-9,0,-4,-4,-10,-5,11,-16,-11,-39,-37,-2,-3,-13,-9,-15,-24,-2,-1,-3,-2,-24,-13,0,-2,-176,-137,-39,-100,-59,-41,-14,2,-71,-83,-22,14,-6,-8,-43,-60,-20,1,-8,10,-28,-23,-2,13,-11,1,-37,-33,-15,-5,-6,-2,-23,-20,-7,-1,-5,3,-14,-13,-8,-4,7,-13,20,27,8,19,-36,13,31,-33,9,12,-11,6,3,-24,3,5,-25,7,28,-9,6,7,7,3,7,2,2,4,3,0,2,-1,1,2,4,3,5,3,1,2,23,3,20,48,23,25,-31,5,41,-45,21,38,-15,-3,23,-14,6,11,-16,8,18,-31,15,27,8,9,12,7,4,7,3,4,6,3,2,4,5,5,6,4,2,3
25,25003,Agramunt,4933,-1,3,-4,13,8,5,-6,-4,0,4,0,2,-4,2,-5,6,3,1,-2,-6,5,-2,-3,1,0,5,6,2,0,0,0,3,3,2,0,0,0,2,3,0,0,0,137,90,47,126,79,47,28,34,46,24,1,5,11,19,38,18,1,1,17,15,8,6,0,4,22,39,40,23,2,0,11,23,29,15,1,0,11,16,11,8,1,0,43,43,0,106,65,41,5,30,0,8,-2,1,4,26,3,8,-1,2,1,4,-3,0,-1,-1,17,36,32,17,0,1,8,23,23,10,0,0,9,13,9,7,0,1,105,60,45,83,53,30,24,23,34,22,-1,-2,13,15,24,5,2,-2,11,8,10,17,-3,0,12,20,35,13,0,0,7,12,28,4,0,0,5,8,7,9,0,0,125,105,20,205,144,61,-3,47,62,18,3,2,0,30,66,8,1,0,-3,17,-4,10,2,2,29,50,83,39,3,1,17,31,64,29,2,1,12,19,19,10,1,0,60,26,34,168,120,48,13,15,25,-7,12,3,13,8,10,-9,4,2,0,7,15,2,8,1,30,39,66,28,1,4,15,29,49,23,1,3,15,10,17,5,0,1,64,11,53,96,42,54,30,14,8,-7,2,16,8,7,-6,-12,5,8,22,7,14,5,-3,8,21,23,36,11,4,1,4,12,21,1,4,0,17,11,15,10,0,1,143,64,79,117,63,54,34,21,62,22,9,-3,11,9,30,7,5,2,23,12,32,15,4,-5,20,31,35,25,7,-2,9,21,18,14,1,-1,11,10,17,11,6,-1,21,-15,36,55,18,37,25,26,-36,-3,4,2,9,5,-30,-5,6,0,16,21,-6,2,-2,2,17,30,5,-5,5,1,9,10,0,-6,4,1,8,20,5,1,1,0,-15,-20,5,-19,-29,10,8,9,-14,-20,-4,7,4,4,-8,-10,-6,-1,4,5,-6,-10,2,8,11,15,-19,-18,-8,0,6,3,-19,-11,-6,-2,5,12,0,-7,-2,2,17,7,10,38,19,19,5,9,15,-7,-4,-2,9,6,4,-9,-4,-1,-4,3,11,2,0,-1,11,12,7,8,0,-1,8,5,5,2,-1,-1,3,7,2,6,1,0,-32,-25,-7,-12,-18,6,-4,8,-31,-7,-4,2,-4,2,-21,-5,-2,4,0,6,-10,-2,-2,-2,3,4,-16,-1,-4,1,1,-5,-12,0,-3,1,2,9,-4,-1,-1,0,-38,-25,-13,-9,-10,1,-9,-2,-19,-4,-11,4,-10,4,-12,-1,-10,3,1,-6,-7,-3,-1,1,-1,1,-1,-9,-2,2,-1,0,-1,-8,-2,2,0,1,0,-1,0,0,-87,-63,-24,-58,-38,-20,-12,-7,-23,-15,-21,-7,-6,-10,-20,-12,-12,-2,-6,3,-3,-3,-9,-5,-7,-1,-23,-14,-8,-3,-4,-3,-14,-10,-5,-1,-3,2,-9,-4,-3,-2,-10,-2,-8,9,7,2,7,0,-4,-6,-4,-1,3,3,-3,-4,-1,2,4,-3,-1,-2,-3,-3,1,5,2,-1,2,-1,2,5,-1,-1,2,-1,-1,0,3,0,0,0,-78,-44,-34,-26,-18,-8,-35,-2,-11,-21,-4,-5,-23,2,-5,-13,-4,-3,-12,-4,-6,-8,0,-2,-9,11,-9,-16,-4,-1,-3,4,-3,-14,-3,0,-6,7,-6,-2,-1,-1,2,-8,10,18,10,8,8,8,-14,12,-12,-2,7,7,-12,-2,-4,-4,1,1,-2,14,-8,2,5,8,5,0,-2,1,5,4,3,-3,1,0,0,4,2,3,-3,1,-15,-13,-2,2,0,2,-5,2,-10,-4,-3,7,-4,4,-7,-1,-4,0,-1,-2,-3,-3,1,7,-4,8,-7,4,0,0,-3,8,-8,4,-1,0,-1,0,1,0,1,0
25,25007,Albatàrrec,1096,31,20,11,5,4,1,4,3,5,6,9,3,0,4,3,5,6,0,4,-1,2,1,3,3,1,2,2,0,0,0,1,1,2,0,0,0,0,1,0,0,0,0,17,17,0,13,8,5,3,8,2,2,4,-2,3,7,1,5,1,0,0,1,1,-3,3,-2,5,3,2,2,1,0,3,3,1,1,0,0,2,0,1,1,1,0,53,34,19,7,7,0,14,13,7,13,5,-3,6,10,1,12,2,0,8,3,6,1,3,-3,1,2,2,3,0,-1,0,2,2,3,0,0,1,0,0,0,0,-1,57,36,21,14,6,8,18,1,31,6,1,1,13,3,15,5,-1,1,5,-2,16,1,2,0,3,3,7,0,0,1,2,2,2,0,0,0,1,1,5,0,0,1,19,21,-2,25,20,5,3,-5,11,2,8,0,1,0,11,3,5,1,2,-5,0,-1,3,-1,2,6,10,5,1,1,1,5,9,4,0,1,1,1,1,1,1,0,49,25,24,32,22,10,13,15,18,1,1,0,12,8,5,1,0,-1,1,7,13,0,1,1,4,12,13,3,0,0,3,9,9,1,0,0,1,3,4,2,0,0,126,57,69,6,-3,9,18,29,58,8,3,4,9,13,32,-2,-1,2,9,16,26,10,4,2,2,3,2,-2,1,0,2,0,-3,-2,0,0,0,3,5,0,1,0,87,59,28,25,17,8,0,32,25,8,12,8,3,22,17,5,9,3,-3,10,8,3,3,5,4,8,10,1,1,1,2,6,4,3,1,1,2,2,6,-2,0,0,103,48,55,63,29,34,11,43,28,15,3,2,7,20,15,4,0,0,4,23,13,11,3,2,7,21,17,13,4,0,3,9,8,5,3,0,4,12,9,8,1,0,92,47,45,68,35,33,4,21,33,24,6,-3,-2,9,28,10,1,-1,6,12,5,14,5,-2,1,22,17,26,0,0,1,9,13,13,-1,0,0,13,4,13,1,0,47,18,29,37,21,16,4,10,2,19,3,6,-1,11,-4,9,-1,2,5,-1,6,10,4,4,7,9,10,10,1,0,3,8,6,5,-1,0,4,1,4,5,2,0,28,30,-2,28,20,8,4,0,10,8,5,-3,7,0,7,10,0,2,-3,0,3,-2,5,-5,2,6,10,11,0,-1,0,3,7,10,0,0,2,3,3,1,0,-1,-15,-1,-14,19,4,15,-24,9,-3,-1,-1,6,-7,4,1,-2,0,2,-17,5,-4,1,-1,4,-2,7,5,8,1,0,-1,2,3,0,0,0,-1,5,2,8,1,0,-11,-8,-3,-14,-18,4,-14,11,-12,11,-9,-1,-3,2,-6,6,-8,1,-11,9,-6,5,-1,-2,0,5,-16,1,-4,0,0,-2,-11,-3,-2,0,0,7,-5,4,-2,0,67,42,25,53,37,16,10,21,21,15,-2,2,4,15,12,8,2,1,6,6,9,7,-4,1,1,25,19,5,3,0,1,17,13,4,2,0,0,8,6,1,1,0,58,23,35,57,24,33,4,34,10,4,7,-1,3,12,-2,2,6,1,1,22,12,2,1,-2,2,30,15,4,5,0,2,13,6,-2,4,0,0,17,9,6,1,0,-22,-5,-17,-28,-5,-23,0,-5,0,-20,1,1,-8,-1,10,-9,4,0,8,-4,-10,-11,-3,1,0,-5,-11,-15,2,0,0,-1,1,-7,2,0,0,-4,-12,-8,0,0,52,20,32,44,23,21,16,1,32,5,-2,0,7,1,15,0,-2,0,9,0,17,5,0,0,13,0,15,12,3,1,7,1,9,7,-1,0,6,-1,6,5,4,1
25,25012,Alcoletge,1718,82,53,29,12,8,4,16,11,22,19,6,7,8,9,14,11,5,5,8,2,8,8,1,2,4,0,4,4,0,0,2,0,2,4,0,0,2,0,2,0,0,0,30,20,10,7,5,2,1,7,15,2,0,2,-1,4,13,2,-1,1,2,3,2,0,1,1,0,1,3,2,0,0,0,0,2,2,0,0,0,1,1,0,0,0,41,19,22,9,6,3,19,4,-12,21,1,7,5,0,-8,15,3,3,14,4,-4,6,-2,4,1,1,3,2,2,0,0,0,2,2,2,0,1,1,1,0,0,0,89,49,40,15,12,3,19,0,47,18,-2,0,11,-4,28,12,-1,-2,8,4,19,6,-1,2,3,1,7,4,0,0,1,1,6,4,0,0,2,0,1,0,0,0,116,60,56,33,27,6,20,26,35,26,8,1,11,13,17,18,2,1,9,13,18,8,6,0,2,9,15,7,0,0,1,8,13,5,0,0,1,1,2,2,0,0,143,87,56,28,19,9,41,9,65,24,4,-2,21,10,44,10,2,-1,20,-1,21,14,2,-1,5,5,13,3,0,1,2,5,11,1,0,0,3,0,2,2,0,1,51,22,29,20,12,8,-1,26,19,-1,8,-1,-3,13,8,0,6,-3,2,13,11,-1,2,2,2,3,10,3,2,0,1,2,7,1,1,0,1,1,3,2,1,0,252,118,134,45,18,27,38,50,90,51,16,9,19,22,50,20,5,5,19,28,40,31,11,4,6,9,18,12,0,0,4,4,7,3,0,0,2,5,11,9,0,0,103,59,44,36,21,15,14,33,34,13,10,-4,9,17,18,10,6,-1,5,16,16,3,4,-3,5,11,9,8,1,0,5,4,4,7,0,0,0,7,5,1,1,0,123,57,66,61,24,37,11,30,45,18,9,3,6,18,22,1,5,0,5,12,23,17,4,3,1,17,19,18,4,0,0,11,8,2,2,0,1,6,11,16,2,0,198,118,80,39,24,15,7,40,85,46,17,-2,10,16,46,30,12,0,-3,24,39,16,5,-2,1,13,9,14,3,-1,1,7,5,9,3,-1,0,6,4,5,0,0,156,91,65,31,12,19,27,32,50,20,10,8,25,13,32,8,5,3,2,19,18,12,5,5,7,9,1,11,0,2,6,2,1,3,0,0,1,7,0,8,0,2,0,5,-5,-14,-8,-6,-9,10,6,-5,2,-3,-3,12,0,0,-1,-2,-6,-2,6,-5,3,-1,-2,1,-4,-5,-4,0,0,2,-4,-3,-3,0,-2,-1,0,-2,-1,0,6,-5,11,5,-1,6,-9,11,-10,2,6,1,-12,1,0,2,1,0,3,10,-10,0,5,1,-3,5,2,-1,3,-1,-3,2,2,-2,0,0,0,3,0,1,3,-1,-11,-9,-2,-3,-7,4,-6,3,3,-12,2,0,-1,-6,4,-6,3,-2,-5,9,-1,-6,-1,2,0,0,-1,-2,0,0,0,-6,0,-2,1,0,0,6,-1,0,-1,0,97,37,60,25,10,15,15,22,46,4,2,2,1,9,22,0,2,1,14,13,24,4,0,1,-2,7,5,12,3,0,-1,5,3,2,1,0,-1,2,2,10,2,0,82,50,32,42,27,15,1,26,25,25,5,-1,-5,18,23,10,5,-1,6,8,2,15,0,0,4,13,11,6,5,2,3,9,10,1,3,1,1,4,1,5,2,1,0,4,-4,44,28,16,-15,8,4,9,-12,2,-5,2,5,8,-9,2,-10,6,-1,1,-3,0,5,15,9,10,5,0,5,8,6,7,2,0,0,7,3,3,3,0
25,25016,Alguaire,2798,-6,-4,-2,9,3,6,-5,3,-5,-3,0,3,-1,2,-3,-3,-2,3,-4,1,-2,0,2,0,2,4,3,0,0,0,1,0,2,0,0,0,1,4,1,0,0,0,12,5,7,19,11,8,12,-2,0,7,0,-5,6,1,-4,4,1,-3,6,-3,4,3,-1,-2,7,3,4,5,0,0,5,1,2,3,0,0,2,2,2,2,0,0,39,33,6,44,29,15,10,19,8,11,-4,-7,8,11,14,4,-1,-5,2,8,-6,7,-3,-2,16,8,10,9,1,0,13,5,5,5,1,0,3,3,5,4,0,0,51,36,15,59,39,20,19,5,27,8,-1,-5,10,2,26,3,-2,-1,9,3,1,5,1,-4,16,11,23,6,2,1,9,8,19,3,0,0,7,3,4,3,2,1,83,55,28,90,64,26,11,22,46,2,1,-3,5,18,32,-1,1,-2,6,4,14,3,0,-1,9,30,40,8,1,0,5,21,29,6,1,0,4,9,11,2,0,0,72,39,33,71,48,23,24,9,23,14,3,0,20,1,14,1,4,0,4,8,9,13,-1,0,14,15,29,10,1,2,11,7,23,6,1,0,3,8,6,4,0,2,-1,6,-7,37,25,12,4,2,-14,5,1,2,-2,1,3,2,2,2,6,1,-17,3,-1,0,7,9,9,9,2,0,4,7,5,7,2,0,3,2,4,2,0,0,64,34,30,63,36,27,18,25,15,14,-9,-6,11,17,3,9,-3,-6,7,8,12,5,-6,0,16,20,12,12,1,0,8,15,4,6,1,0,8,5,8,6,0,0,35,30,5,55,35,20,0,6,33,1,-5,-3,5,6,26,-5,-3,-2,-5,0,7,6,-2,-1,7,14,21,8,1,1,5,9,15,3,0,0,2,5,6,5,1,1,-16,0,-16,3,4,-1,-4,18,-9,-14,-6,-2,4,16,-12,-8,-1,1,-8,2,3,-6,-5,-3,5,11,-7,-9,1,-1,5,10,-8,-5,1,0,0,1,1,-4,0,-1,-37,-39,2,-14,-16,2,2,-10,-16,-6,3,-7,-4,-11,-10,-6,1,-5,6,1,-6,0,2,-2,4,1,-7,-10,-2,0,4,-3,-7,-8,-2,0,0,4,0,-2,0,0,-4,9,-13,1,6,-5,4,6,-5,1,2,-13,0,4,4,4,2,-5,4,2,-9,-3,0,-8,4,3,-5,-2,0,0,5,6,-4,-1,-1,0,-1,-3,-1,-1,1,0,-6,2,-8,12,7,5,-1,-3,6,-2,-2,-4,-5,-2,5,5,-1,-1,4,-1,1,-7,-1,-3,3,3,6,-1,0,1,2,1,3,1,0,0,1,2,3,-2,0,1,-10,9,-19,-2,1,-3,1,-6,-8,-4,10,-2,3,-1,4,-1,5,0,-2,-5,-12,-3,5,-2,0,-1,0,-3,2,0,2,0,1,-2,0,0,-2,-1,-1,-1,2,0,-62,-44,-18,-30,-24,-6,-15,-16,-15,-12,-6,2,-10,-12,-13,-9,-3,1,-5,-4,-2,-3,-3,1,-4,-12,-7,-8,1,0,-3,-11,-5,-6,1,0,-1,-1,-2,-2,0,0,21,16,5,20,19,1,16,-1,18,-7,-7,-1,7,-4,17,-3,-2,-1,9,3,1,-4,-5,0,-2,5,13,3,0,0,0,3,12,3,0,0,-2,2,1,0,0,0,4,1,3,10,6,4,-1,-2,0,-1,7,-1,-3,1,2,-3,3,-1,2,-3,-2,2,4,0,-3,3,5,3,1,0,-3,2,5,1,0,0,0,1,0,2,1,0,-30,-9,-21,11,6,5,-20,8,-7,-6,-1,-3,-9,3,2,-1,-1,-1,-11,5,-9,-5,0,-2,2,3,8,-3,1,0,1,-1,9,-3,0,0,1,4,-1,0,1,0
25,25019,Almacelles,5515,55,37,18,36,21,15,14,10,31,7,-5,-2,6,10,24,0,-4,1,8,0,7,7,-1,-3,7,9,18,2,0,0,4,6,10,1,0,0,3,3,8,1,0,0,69,48,21,44,29,15,12,10,29,12,-3,6,8,9,17,9,0,5,4,1,12,3,-3,1,11,8,15,8,0,1,5,5,11,7,0,1,6,3,4,1,0,0,24,28,-4,32,22,10,1,8,10,12,-3,-4,3,8,10,8,0,-1,-2,0,0,4,-3,-3,9,9,9,5,0,0,6,6,7,3,0,0,3,3,2,2,0,0,128,79,49,53,31,22,24,16,51,21,6,8,14,12,31,15,2,5,10,4,20,6,4,3,12,16,17,5,3,0,7,9,11,2,2,0,5,7,6,3,1,0,172,147,25,155,118,37,17,30,84,29,3,5,25,21,58,33,0,7,-8,9,26,-4,3,-2,30,34,60,27,0,3,17,25,47,25,0,3,13,9,13,2,0,0,89,94,-5,136,98,38,12,18,8,27,10,14,18,18,19,25,5,10,-6,0,-11,2,5,4,26,38,46,23,2,0,16,26,37,19,0,0,10,12,9,4,2,0,35,-10,45,67,32,35,23,2,0,3,4,5,-1,3,0,-11,1,-1,24,-1,0,14,3,6,24,18,13,9,2,1,9,14,5,2,2,0,15,4,8,7,0,1,133,85,48,136,84,52,18,42,45,21,11,-6,12,26,31,15,3,-4,6,16,14,6,8,-2,27,43,42,22,1,0,16,27,29,11,0,0,11,16,13,11,1,0,176,116,60,123,76,47,20,50,63,14,23,3,13,30,50,7,18,-4,7,20,13,7,5,7,17,42,39,15,7,0,12,22,26,10,4,-1,5,20,13,5,3,1,73,25,48,37,14,23,15,24,-1,11,5,15,3,7,3,4,-2,9,12,17,-4,7,7,6,20,19,1,-2,-4,-1,10,13,-4,-5,-2,0,10,6,5,3,-2,-1,31,7,24,47,15,32,9,21,-9,10,-2,3,4,13,-12,5,-5,3,5,8,3,5,3,0,18,18,2,12,-1,-2,8,8,-1,4,-3,-1,10,10,3,8,2,-1,43,31,12,27,9,18,11,9,6,16,-7,11,3,7,4,17,-5,5,8,2,2,-1,-2,6,6,13,9,1,-3,1,3,5,4,-1,-2,0,3,8,5,2,-1,1,35,-7,42,36,10,26,23,12,-4,-2,-2,8,9,4,-13,-7,1,-1,14,8,9,5,-3,9,9,19,4,4,1,-2,5,5,-3,0,2,0,4,14,7,4,-1,-2,-19,-13,-6,-2,-1,-1,-12,19,-7,-19,-7,7,-10,13,-1,-12,-5,2,-2,6,-6,-7,-2,5,-6,9,-2,-2,-2,0,-3,3,2,-2,-2,0,-3,6,-4,0,0,0,85,62,23,54,35,19,6,16,20,23,7,15,0,14,10,14,9,14,6,2,10,9,-2,1,4,18,17,11,4,0,1,10,12,8,4,0,3,8,5,3,0,0,62,45,17,61,49,12,-6,27,24,2,4,9,-3,21,13,7,4,2,-3,6,11,-5,0,7,0,27,19,9,6,0,0,21,14,10,4,0,0,6,5,-1,2,0,76,25,51,35,18,17,6,20,1,8,24,14,6,5,-7,10,9,0,0,15,8,-2,15,14,8,18,0,1,4,1,6,10,-2,3,-2,1,2,8,2,-2,6,0,-8,12,-20,58,33,25,-11,2,13,3,-13,-4,-7,5,12,9,-4,-5,-4,-3,1,-6,-9,1,10,14,27,7,1,-1,3,11,17,3,0,-1,7,3,10,4,1,0
25,25023,Alpicat,3813,256,128,128,9,3,6,61,27,83,47,17,15,31,14,48,24,8,2,30,13,35,23,9,13,0,0,3,6,0,0,0,0,1,2,0,0,0,0,2,4,0,0,184,89,95,41,28,13,20,34,46,43,15,26,6,18,24,22,8,11,14,16,22,21,7,15,3,15,11,11,0,1,3,12,8,5,0,0,0,3,3,6,0,1,194,98,96,67,43,24,34,21,73,35,4,24,21,7,41,19,4,7,13,14,32,16,0,17,6,17,27,13,3,0,5,10,19,7,2,0,1,7,8,6,1,0,159,90,69,54,31,23,26,28,47,33,4,17,14,18,32,16,1,6,12,10,15,17,3,11,13,17,13,10,0,0,4,12,10,5,0,0,9,5,3,5,0,0,256,118,138,65,38,27,39,28,84,55,8,36,20,13,38,28,4,12,19,15,46,27,4,24,8,16,26,13,1,1,6,9,14,8,1,0,2,7,12,5,0,1,164,86,78,45,25,20,40,19,48,37,6,15,28,12,25,11,5,6,12,7,23,26,1,9,2,17,13,10,2,1,1,11,7,4,2,0,1,6,6,6,0,1,294,137,157,36,12,24,69,42,75,55,29,12,33,21,20,36,15,3,36,21,55,19,14,9,9,16,5,2,3,0,5,7,0,-2,1,0,4,9,5,4,2,0,216,85,131,46,24,22,34,31,56,44,14,34,9,11,29,18,8,10,25,20,27,26,6,24,5,18,10,9,3,0,1,9,7,5,2,0,4,9,3,4,1,0,159,87,72,24,12,12,69,0,33,34,6,14,48,4,3,19,5,6,21,-4,30,15,1,8,4,4,7,4,4,1,4,2,1,3,2,0,0,2,6,1,2,1,9,9,0,-4,-4,0,14,-9,-2,15,-8,1,8,1,-2,8,-4,1,6,-10,0,7,-4,0,-2,-2,1,0,-1,0,-2,0,0,1,-2,-1,0,-2,1,-1,1,1,31,8,23,-7,-5,-2,17,9,18,1,-13,-4,10,3,-4,6,-9,0,7,6,22,-5,-4,-4,-1,4,-5,-3,-1,-2,-2,3,-3,0,-2,-1,1,1,-2,-3,1,-1,4,5,-1,1,5,-4,2,-6,-15,3,10,12,-6,1,2,-1,9,1,8,-7,-17,4,1,11,-1,9,-6,-1,1,-1,0,5,1,-2,1,0,-1,4,-7,1,0,-1,42,2,40,7,1,6,19,-4,15,16,-16,11,14,-4,1,3,-12,2,5,0,14,13,-4,9,4,1,7,3,-9,1,2,1,3,2,-7,0,2,0,4,1,-2,1,-1,5,-6,-1,2,-3,8,-10,-17,6,0,10,6,1,-12,7,2,0,2,-11,-5,-1,-2,10,1,1,-3,-2,0,2,3,3,-4,0,-1,1,-2,-2,1,-2,1,1,-5,0,-5,-20,-10,-10,4,-1,17,-5,-20,-2,3,-1,5,2,-10,0,1,0,12,-7,-10,-2,-1,0,-6,-5,-7,-3,1,-1,-4,-1,-4,-2,-2,1,-2,-4,-3,-1,-36,-31,-5,-15,-19,4,8,-7,-4,-33,-7,2,4,-12,-9,-17,3,-2,4,5,5,-16,-10,4,1,1,-10,-12,4,1,-1,0,-12,-10,3,1,2,1,2,-2,1,0,28,27,1,0,8,-8,16,-6,26,10,-12,-10,10,1,18,9,-2,-9,6,-7,8,1,-10,-1,1,6,-6,-1,0,-1,4,5,-2,0,1,0,-3,1,-4,-1,-1,-1,-36,-16,-20,-5,-4,-1,9,-6,-12,-8,-18,-3,5,1,-5,-5,-9,-4,4,-7,-7,-3,-9,1,7,-1,1,-6,-5,-2,6,-2,-3,-2,-2,-1,1,1,4,-4,-3,-1
25,25027,Anglesola,1283,10,0,10,13,5,8,7,0,6,3,-1,-4,0,1,1,1,-1,-2,7,-1,5,2,0,-2,5,2,4,2,0,0,2,1,1,1,0,0,3,1,3,1,0,0,15,14,1,10,5,5,2,5,1,0,2,5,1,3,5,0,1,4,1,2,-4,0,1,1,3,3,2,1,0,1,2,0,2,0,0,1,1,3,0,1,0,0,-1,3,-4,16,8,8,-2,-2,5,-5,2,1,-2,2,1,0,1,0,0,-4,4,-5,1,1,2,5,7,2,0,0,1,3,2,2,0,0,1,2,5,0,0,0,41,20,21,16,7,9,3,2,19,8,2,6,4,-2,11,4,1,2,-1,4,8,4,1,4,3,1,7,4,1,0,2,0,3,2,0,0,1,1,4,2,1,0,-2,-2,0,24,13,11,-1,0,-2,2,-2,-1,-1,3,-1,-1,-2,0,0,-3,-1,3,0,-1,7,4,8,4,0,0,3,3,5,2,0,0,4,1,3,2,0,0,10,3,7,12,5,7,6,0,2,-3,6,0,4,0,1,-3,3,-1,2,0,1,0,3,1,4,7,1,-2,2,0,4,2,0,-3,2,0,0,5,1,1,0,0,15,10,5,22,10,12,2,15,-1,-2,0,-1,3,9,0,0,-1,-1,-1,6,-1,-2,1,0,4,8,8,0,1,0,2,3,5,0,0,0,2,5,3,0,1,0,35,25,10,28,15,13,14,3,16,3,4,-5,9,4,12,2,1,-3,5,-1,4,1,3,-2,3,8,11,5,1,0,1,5,8,1,0,0,2,3,3,4,1,0,24,12,12,14,7,7,10,-1,6,7,1,0,6,1,-3,7,1,0,4,-2,9,0,0,0,2,3,4,5,0,0,1,2,1,3,0,0,1,1,3,2,0,0,6,0,6,9,4,5,0,6,1,-6,3,1,1,2,2,-6,1,0,-1,4,-1,0,2,1,-1,6,2,1,1,0,-1,2,2,0,1,0,0,4,0,1,0,0,35,22,13,7,3,4,7,2,16,6,4,-1,4,2,13,2,2,-1,3,0,3,4,2,0,1,2,2,2,0,0,1,2,0,0,0,0,0,0,2,2,0,0,5,0,5,5,3,2,8,-1,0,3,0,-4,2,-2,0,2,-2,-1,6,1,0,1,2,-3,0,2,-1,3,1,0,0,1,0,2,0,0,0,1,-1,1,1,0,4,-1,5,2,2,0,1,4,-3,1,1,0,2,1,-5,0,1,0,-1,3,2,1,0,0,0,2,-1,0,1,0,0,1,0,0,1,0,0,1,-1,0,0,0,-1,1,-2,3,1,2,0,1,4,0,-5,0,0,-1,6,2,-3,-2,0,2,-2,-2,-2,2,0,0,1,1,0,1,0,-1,1,1,0,0,0,1,0,0,0,1,23,12,11,4,2,2,4,5,10,2,-1,2,3,5,3,0,0,1,1,0,7,2,-1,1,1,2,-1,1,0,0,0,2,-1,1,0,0,1,0,0,0,0,0,-28,-10,-18,-6,-3,-3,-11,-4,-14,-5,6,-1,-4,-2,-6,-2,4,0,-7,-2,-8,-3,2,-1,0,-1,-4,0,-1,0,-1,0,-2,0,0,0,1,-1,-2,0,-1,0,-7,-2,-5,9,10,-1,-1,-3,5,-4,-3,-4,0,-4,3,0,-1,-2,-1,1,2,-4,-2,-2,2,1,3,1,0,0,4,1,3,1,0,0,-2,0,0,0,0,0,-12,-3,-9,-3,-1,-2,2,3,-4,-6,-4,-6,2,2,-2,-3,0,-3,0,1,-2,-3,-4,-3,2,6,-1,-4,-5,-2,0,3,1,-3,0,-2,2,3,-2,-1,-5,0
25,25029,Arbeca,2388,66,44,22,101,72,29,-11,35,25,19,0,-2,-10,23,16,16,0,-1,-1,12,9,3,0,-1,2,36,36,27,0,0,0,25,25,22,0,0,2,11,11,5,0,0,42,24,18,60,40,20,10,6,19,7,-3,3,3,2,12,8,-2,1,7,4,7,-1,-1,2,6,14,27,11,2,0,3,8,20,7,2,0,3,6,7,4,0,0,-79,-42,-37,28,13,15,-16,-20,-32,-12,3,-2,-9,-8,-15,-10,1,-1,-7,-12,-17,-2,2,-1,2,6,9,8,3,0,1,1,6,3,2,0,1,5,3,5,1,0,-93,-58,-35,1,-1,2,-10,-15,-29,-25,-6,-6,-6,-9,-18,-17,-4,-3,-4,-6,-11,-8,-2,-3,0,0,1,0,0,0,0,-1,0,0,0,0,0,1,1,0,0,0,78,44,34,100,60,40,14,25,8,16,12,4,11,12,6,9,5,3,3,13,2,7,7,1,15,24,31,22,6,1,10,12,19,14,4,1,5,12,12,8,2,0,9,13,-4,49,33,16,0,7,-1,5,0,-3,3,5,3,2,0,0,-3,2,-4,3,0,-3,3,16,19,9,0,1,2,10,13,7,0,0,1,6,6,2,0,1,12,22,-10,53,35,18,6,8,-9,14,-6,3,7,9,-1,12,-7,5,-1,-1,-8,2,1,-2,9,19,5,19,0,1,5,14,2,15,-2,1,4,5,3,4,2,0,38,23,15,70,42,28,7,22,-5,12,0,-1,3,16,-5,6,1,0,4,6,0,6,-1,-1,9,30,14,14,3,0,3,21,7,8,3,0,6,9,7,6,0,0,27,24,3,24,17,7,-2,12,9,-1,1,7,1,8,8,2,2,4,-3,4,1,-3,-1,3,1,8,6,6,3,0,2,7,3,3,2,0,-1,1,3,3,1,0,16,7,9,24,8,16,-6,8,3,6,9,-4,-4,3,0,4,6,-2,-2,5,3,2,3,-2,2,14,0,4,3,1,1,5,0,1,1,0,1,9,0,3,2,1,15,15,0,26,12,14,0,9,-2,5,5,-2,0,5,0,6,4,0,0,4,-2,-1,1,-2,0,12,4,6,2,1,-1,5,1,5,1,1,1,7,3,1,1,0,19,4,15,33,17,16,7,4,7,2,1,-3,3,-1,3,1,0,-3,4,5,4,1,1,0,5,8,9,7,3,0,3,4,6,2,1,0,2,4,3,5,2,0,-24,-10,-14,-2,-4,2,1,-3,-10,-6,-8,-1,2,-1,-3,-4,-3,0,-1,-2,-7,-2,-5,-1,1,3,-2,-4,-1,-1,0,0,0,-4,0,-1,1,3,-2,0,-1,0,-8,-8,0,11,4,7,-6,-3,10,-8,-3,0,-3,-4,7,-7,-1,-1,-3,1,3,-1,-2,1,2,3,4,1,0,0,1,2,1,0,0,0,1,1,3,1,0,0,-84,-46,-38,-45,-33,-12,-10,-10,-27,-31,-5,-1,-2,-6,-21,-15,-2,0,-8,-4,-6,-16,-3,-1,0,-2,-15,-19,-8,-1,1,-2,-14,-11,-6,-1,-1,0,-1,-8,-2,0,20,14,6,18,10,8,-2,9,13,-3,1,0,0,3,13,-5,2,0,-2,6,0,2,-1,0,0,4,9,3,1,0,0,1,6,1,1,0,0,3,3,2,0,0,42,17,25,28,12,16,17,7,6,9,-1,2,8,2,1,4,0,2,9,5,5,5,-1,0,6,8,5,8,1,0,3,4,2,3,0,0,3,4,3,5,1,0,-7,-3,-4,21,11,10,-9,9,-16,8,3,0,1,4,-10,-2,4,0,-10,5,-6,10,-1,0,1,7,2,8,3,0,1,3,2,3,2,0,0,4,0,5,1,0
25,25034,Artesa de Segre,3171,66,51,15,61,42,19,16,30,10,11,2,-2,13,19,9,8,1,1,3,11,1,3,1,-3,11,28,12,8,2,0,6,20,9,7,0,0,5,8,3,1,2,0,48,27,21,82,53,29,6,7,21,15,-1,1,7,2,8,10,0,1,-1,5,13,5,-1,0,16,20,23,18,5,0,13,11,13,12,4,0,3,9,10,6,1,0,151,89,62,147,91,56,28,23,48,35,11,6,9,13,35,22,9,2,19,10,13,13,2,4,25,27,53,33,8,0,11,17,32,23,8,0,14,10,21,10,0,0,123,75,48,131,78,53,17,40,38,10,7,11,9,22,25,9,3,6,8,18,13,1,4,5,25,35,50,13,6,2,14,21,33,8,2,0,11,14,17,5,4,2,159,90,69,188,112,76,25,48,59,24,2,-2,6,25,37,20,3,-2,19,23,22,4,-1,0,29,56,63,33,5,0,13,32,43,22,2,0,16,24,20,11,3,0,-10,-26,16,72,31,41,7,11,-24,-2,-2,1,3,2,-15,-11,-4,-1,4,9,-9,9,2,2,16,19,18,15,2,0,8,8,10,3,1,0,8,11,8,12,1,0,109,69,40,146,87,59,15,36,35,13,4,3,12,22,19,7,6,2,3,14,16,6,-2,1,30,42,49,20,2,1,15,26,27,14,3,1,15,16,22,6,-1,0,158,112,46,203,134,69,26,67,46,19,0,-4,22,44,37,9,0,-3,4,23,9,10,0,-1,39,65,64,24,4,2,23,43,45,16,2,1,16,22,19,8,2,1,23,-2,25,62,14,48,11,10,2,-9,6,4,0,5,-3,-7,0,4,11,5,5,-2,6,0,21,20,9,7,5,1,7,4,2,2,0,0,14,16,7,5,5,1,26,8,18,20,5,15,11,17,-3,-7,8,0,5,5,-1,-4,5,-2,6,12,-2,-3,3,2,4,13,3,-1,1,0,1,6,-1,-1,0,0,3,7,4,0,1,0,-19,-15,-4,-27,-22,-5,3,6,-26,-7,3,3,1,2,-11,-4,-1,0,2,4,-15,-3,4,3,-2,4,-15,-15,3,-2,1,1,-11,-13,1,-1,-3,3,-4,-2,2,-1,-46,-35,-11,-38,-28,-10,-1,4,-15,-19,-11,-7,-2,-3,-6,-14,-6,-5,1,7,-9,-5,-5,-2,-1,3,-19,-13,-8,-1,1,-1,-12,-10,-5,-1,-2,4,-7,-3,-3,0,-37,-16,-21,-13,-7,-6,-8,-2,-21,-7,2,-3,-2,-2,-9,-2,-1,-1,-6,0,-12,-5,3,-2,-7,4,-5,-10,3,0,-4,2,0,-7,1,0,-3,2,-5,-3,2,0,-20,-17,-3,16,7,9,-10,8,-4,-3,-8,-4,-8,4,3,-7,-5,-3,-2,4,-7,4,-3,-1,6,2,4,2,-1,2,3,0,2,0,1,1,3,2,2,2,-2,1,0,16,-16,18,11,7,6,-3,-2,-4,-1,1,11,-4,3,3,-1,2,-5,1,-5,-7,0,-1,5,6,5,3,-1,0,3,2,4,1,1,0,2,4,1,2,-2,0,-31,-24,-7,0,-1,1,-7,6,-12,-13,-6,0,-5,4,-11,-8,-6,2,-2,2,-1,-5,0,-2,4,8,-4,-4,-3,-1,4,7,-4,-5,-3,0,0,1,0,1,0,-1,14,18,-4,9,11,-2,1,7,2,-2,3,4,5,2,2,6,2,2,-4,5,0,-8,1,2,1,1,1,3,4,-1,3,0,1,5,2,0,-2,1,0,-2,2,-1,-34,-6,-28,23,14,9,-1,1,-14,-6,-7,-9,5,5,-4,-8,-5,-1,-6,-4,-10,2,-2,-8,8,6,3,8,-4,0,6,4,2,3,-2,0,2,2,1,5,-2,0
25,25040,Balaguer,13172,58,36,22,10,4,6,16,8,15,3,2,7,1,5,15,6,-2,6,15,3,0,-3,4,1,3,1,2,3,0,1,2,0,0,2,0,0,1,1,2,1,0,1,11,18,-7,5,4,1,15,20,-20,1,-1,-5,20,12,-9,0,0,-5,-5,8,-11,1,-1,0,2,0,2,0,1,0,2,0,1,0,1,0,0,0,1,0,0,0,57,11,46,-17,-6,-11,7,16,31,-6,-5,13,8,3,13,-11,-5,2,-1,13,18,5,0,11,-3,-1,-14,-3,3,1,-2,0,-7,0,2,1,-1,-1,-7,-3,1,0,130,74,56,-12,-6,-6,31,28,22,32,14,8,9,16,14,24,8,5,22,12,8,8,6,3,-7,0,-4,-3,0,2,-4,0,-2,-2,0,2,-3,0,-2,-1,0,0,591,382,209,550,336,214,109,132,197,113,22,11,44,84,140,95,15,2,65,48,57,18,7,9,102,144,178,94,22,1,48,86,121,64,13,0,54,58,57,30,9,1,445,243,202,458,267,191,79,128,89,92,28,22,33,77,46,52,17,13,46,51,43,40,11,9,79,118,140,90,17,8,45,68,82,56,8,4,34,50,58,34,9,4,172,136,36,349,203,146,15,53,79,22,-13,14,18,38,67,21,-12,7,-3,15,12,1,-1,7,70,87,128,54,7,2,44,52,78,25,4,0,26,35,50,29,3,2,420,230,190,510,276,234,53,154,83,60,20,43,23,83,56,28,13,21,30,71,27,32,7,22,78,170,142,94,16,4,33,95,86,46,10,2,45,75,56,48,6,2,315,222,93,306,200,106,51,83,139,14,12,17,32,57,107,24,-6,12,19,26,32,-10,18,5,46,103,105,37,13,0,25,63,77,28,5,1,21,40,28,9,8,-1,-44,-44,0,1,-23,24,11,6,-43,-18,-9,3,8,5,-41,-19,-5,4,3,1,-2,1,-4,-1,17,20,-23,-14,-8,4,11,10,-35,-10,-4,2,6,10,12,-4,-4,2,2,22,-20,33,3,30,-19,40,9,-31,-14,13,-1,15,14,-15,-1,9,-18,25,-5,-16,-13,4,10,37,6,-6,-10,-9,4,11,2,-12,-2,-3,6,26,4,6,-8,-6,34,5,29,-7,-24,17,3,25,-25,5,6,13,2,6,-14,0,3,5,1,19,-11,5,3,8,2,38,-26,-25,2,0,6,15,-19,-21,-4,-1,-4,23,-7,-4,6,1,-179,-121,-58,21,-18,39,-55,-15,-52,-49,-10,7,-37,-15,-44,-16,-4,-1,-18,0,-8,-33,-6,8,11,12,7,-10,-5,2,4,-2,-15,-8,-1,2,7,14,22,-2,-4,0,-200,-146,-54,-142,-104,-38,-31,-13,-52,-82,-21,3,-11,-12,-42,-56,-20,1,-20,-1,-10,-26,-1,2,-18,-2,-40,-63,-16,-4,-1,-7,-29,-48,-14,-4,-17,5,-11,-15,-2,0,13,-8,21,-49,-33,-16,22,-4,-19,13,-2,-3,5,1,-3,-9,-11,6,17,-5,-16,22,9,-9,-12,2,-15,-21,-2,-5,-8,3,-6,-19,-5,-1,-4,-1,-9,-2,3,-4,15,21,-6,48,26,22,9,26,-23,-23,5,15,24,17,-9,-13,-1,2,-15,9,-14,-10,6,13,16,29,5,-4,-5,5,17,16,1,-8,-3,3,-1,13,4,4,-2,2,110,50,60,36,8,28,29,22,9,20,4,22,26,13,2,1,-5,11,3,9,7,19,9,11,15,25,11,-18,0,1,16,13,2,-16,-10,2,-1,12,9,-2,10,-1,222,128,94,208,125,83,51,70,31,39,10,14,9,51,29,28,6,0,42,19,2,11,4,14,44,73,41,31,9,3,20,54,30,13,6,-1,24,19,11,18,3,4
25,25050,Bellpuig,3984,39,26,13,9,7,2,12,9,-4,11,2,9,6,3,5,8,0,4,6,6,-9,3,2,5,0,3,3,2,1,0,0,2,3,1,1,0,0,1,0,1,0,0,69,57,12,56,37,19,18,17,8,17,7,1,12,14,16,10,4,0,6,3,-8,7,3,1,14,14,20,5,3,0,7,10,15,4,1,0,7,4,5,1,2,0,34,23,11,41,27,14,3,7,13,5,0,8,0,9,12,3,0,1,3,-2,1,2,0,7,3,12,15,8,2,1,2,9,9,6,1,0,1,3,6,2,1,1,39,16,23,74,45,29,6,-1,19,8,4,5,0,0,8,4,4,2,6,-1,11,4,0,3,11,17,33,10,3,0,5,9,22,7,2,0,6,8,11,3,1,0,111,99,12,102,75,27,0,34,75,-4,-2,2,2,24,72,3,-6,3,-2,10,3,-7,4,-1,6,28,54,11,1,0,4,17,47,7,0,0,2,11,7,4,1,0,99,53,46,115,81,34,26,22,11,24,2,9,14,16,2,14,0,5,12,6,9,10,2,4,15,38,33,24,2,1,9,24,26,20,0,1,6,14,7,4,2,0,148,93,55,91,61,30,29,25,32,33,-4,29,17,18,21,29,-2,10,12,7,11,4,-2,19,11,27,37,12,0,2,8,16,25,11,0,1,3,11,12,1,0,1,229,132,97,128,80,48,49,58,64,39,10,2,29,40,35,19,7,-1,20,18,29,20,3,3,26,33,40,24,3,0,17,24,24,11,2,0,9,9,16,13,1,0,131,67,64,102,61,41,15,21,56,27,6,3,3,4,36,15,5,3,12,17,20,12,1,0,14,28,38,19,3,0,6,15,26,11,3,0,8,13,12,8,0,0,34,24,10,74,48,26,7,25,-8,-2,7,5,6,13,0,0,5,0,1,12,-8,-2,2,5,13,27,24,7,2,1,7,15,18,6,1,1,6,12,6,1,1,0,74,64,10,76,48,28,10,22,24,14,8,-5,12,14,32,6,5,-3,-2,8,-8,8,3,-2,13,29,24,4,4,0,10,15,18,3,2,0,3,14,6,1,2,0,24,16,8,38,27,11,-6,10,3,0,10,10,-6,11,0,5,4,2,0,-1,3,-5,6,8,-2,18,14,4,1,2,0,10,12,4,0,1,-2,8,2,0,1,1,32,9,23,26,9,17,9,16,-2,-1,2,6,3,11,-4,-5,2,1,6,5,2,4,0,5,3,18,3,1,0,1,0,9,1,0,-1,0,3,9,2,1,1,1,-4,-3,-1,19,8,11,-17,16,-3,-7,2,2,-6,4,2,-6,-4,5,-11,12,-5,-1,6,-3,3,13,4,-1,-1,-1,4,3,2,-2,-1,0,-1,10,2,1,0,-1,46,29,17,32,17,15,13,9,12,4,3,6,10,8,3,5,1,2,3,1,9,-1,2,4,8,11,7,4,2,0,3,7,2,4,1,0,5,4,5,0,1,0,75,46,29,32,25,7,23,17,27,-1,4,6,13,9,14,0,5,5,10,8,13,-1,-1,1,-3,11,15,3,4,2,-2,7,12,3,4,1,-1,4,3,0,0,1,17,22,-5,49,34,15,-5,14,11,3,-3,-4,-1,9,16,1,2,-3,-4,5,-5,2,-5,-1,8,13,15,13,-2,0,4,10,11,10,-2,0,4,3,4,3,0,0,24,13,11,-20,-4,-16,9,15,9,-1,-6,-1,4,8,17,-14,-3,2,5,7,-8,13,-3,-3,-7,6,1,-14,-4,-3,-2,3,12,-13,-3,-1,-5,3,-11,-1,-1,-2
25,25052,Bellvís,2165,-8,2,-10,11,8,3,5,-6,0,2,-4,-6,4,-3,3,2,1,-4,1,-3,-3,0,-5,-2,0,2,7,1,0,0,0,1,6,1,0,0,0,1,1,0,0,0,24,14,10,35,25,10,2,6,14,4,-4,2,2,4,4,7,-3,0,0,2,10,-3,-1,2,5,7,16,5,2,0,3,6,11,3,2,0,2,1,5,2,0,0,4,5,-1,44,24,20,-4,6,8,3,-2,-5,0,2,4,1,-1,0,-4,4,4,2,-1,-5,4,13,19,8,0,0,3,6,9,6,0,0,1,7,10,2,0,0,44,35,9,82,48,34,8,20,7,11,2,-3,6,8,8,8,4,1,2,12,-1,3,-2,-4,14,22,24,18,3,1,8,9,16,11,3,1,6,13,8,7,0,0,81,48,33,114,66,48,2,16,53,15,-1,-3,-4,8,39,7,-1,1,6,8,14,8,0,-4,6,27,56,24,1,0,1,13,38,13,1,0,5,14,18,11,0,0,39,19,20,79,37,42,10,5,17,9,-4,2,11,4,2,3,-2,1,-1,1,15,6,-2,1,12,20,26,20,1,0,6,11,10,10,0,0,6,9,16,10,1,0,156,39,117,179,49,130,17,78,36,26,-1,-3,16,14,8,1,-1,0,1,64,28,25,0,-3,12,81,43,39,-1,1,8,14,15,12,-2,1,4,67,28,27,1,0,39,38,1,77,53,24,10,24,1,1,2,-3,6,20,4,3,0,3,4,4,-3,-2,2,-6,11,32,19,11,1,2,7,23,14,6,1,1,4,9,5,5,0,1,41,17,24,58,28,30,6,8,27,-6,4,1,2,2,10,-2,1,2,4,6,17,-4,3,-1,13,9,25,7,4,0,8,3,13,2,2,0,5,6,12,5,2,0,47,14,33,59,21,38,0,13,20,14,-1,-1,-2,7,8,2,-2,0,2,6,12,12,1,-1,2,13,22,20,2,0,2,7,10,3,-1,0,0,6,12,17,3,0,-98,-70,-28,-90,-61,-29,2,-27,-33,-35,-7,1,-5,-14,-20,-28,-4,0,7,-13,-13,-7,-3,1,-4,-19,-21,-34,-10,-2,-4,-7,-20,-24,-6,0,0,-12,-1,-10,-4,-2,-6,7,-13,4,2,2,-6,8,-11,-7,8,1,-5,8,0,-3,6,0,-1,0,-11,-4,2,1,0,7,-4,-2,3,0,-1,4,-2,-2,3,0,1,3,-2,0,0,0,-10,-21,11,-13,-19,6,2,-11,-1,-6,0,5,-3,-9,-3,-5,-3,2,5,-2,2,-1,3,3,-2,-2,-2,-7,0,0,-2,-4,-6,-6,-1,0,0,2,4,-1,1,0,-10,4,-14,4,6,-2,5,10,4,-23,-12,5,4,5,5,-3,-7,0,1,5,-1,-20,-5,5,5,3,1,-1,-7,1,5,-1,4,1,-4,0,0,4,-3,-2,-3,1,-60,-31,-29,-46,-26,-20,-7,1,-19,-33,-1,-1,-3,-3,-6,-18,1,-2,-4,4,-13,-15,-2,1,1,-2,-14,-30,0,-1,2,-2,-9,-17,1,-1,-1,0,-5,-13,-1,0,19,19,0,0,7,-7,7,-7,5,6,5,1,2,-1,4,7,6,0,5,-6,1,-1,-1,1,6,-3,2,-4,-1,-1,2,0,4,0,0,0,4,-3,-2,-4,-1,-1,20,12,8,7,4,3,9,7,5,-3,2,0,8,2,5,-3,2,-3,1,5,0,0,0,3,6,2,1,0,-3,0,4,-1,1,1,-2,0,2,3,0,-1,-1,0,-14,-18,4,-2,3,-5,-7,5,-5,-2,-9,3,-2,2,-5,-5,-9,0,-5,3,0,3,0,3,-1,2,-1,2,-4,0,0,3,0,3,-3,0,-1,-1,-1,-1,-1,0
25,25058,"Borges Blanques, Les",5181,71,33,38,49,33,16,10,3,37,12,0,6,2,5,16,6,2,2,8,-2,21,6,-2,4,5,8,24,7,3,0,2,4,18,7,2,0,3,4,6,0,1,0,49,30,19,50,28,22,10,13,16,9,1,2,7,12,13,2,-1,0,3,1,3,7,2,2,6,16,13,12,2,1,3,9,8,7,0,1,3,7,5,5,2,0,95,44,51,76,36,40,31,25,20,2,19,-1,14,16,5,-2,10,4,17,9,15,4,9,-5,27,18,20,5,2,3,13,11,10,-1,1,2,14,7,10,6,1,1,76,42,34,49,27,22,11,15,15,-4,1,33,11,14,8,-1,1,8,0,1,7,-3,0,25,12,12,16,6,2,0,9,10,8,1,0,-1,3,2,8,5,2,1,121,76,45,90,57,33,18,23,34,15,14,13,9,18,25,8,7,8,9,5,9,7,7,5,10,31,32,10,2,1,5,20,21,6,2,1,5,11,11,4,0,0,111,49,62,49,26,23,20,20,26,13,7,18,9,6,13,12,2,4,11,14,13,1,5,14,5,15,17,8,2,0,2,7,10,7,0,0,3,8,7,1,2,0,195,111,84,85,44,41,44,32,28,50,22,16,23,19,20,32,9,6,21,13,8,18,13,10,16,24,14,21,7,1,11,14,6,10,1,1,5,10,8,11,6,0,197,104,93,129,73,56,41,53,70,14,6,9,19,34,39,8,2,2,22,19,31,6,4,7,28,32,43,19,4,2,13,19,27,13,0,0,15,13,16,6,4,2,102,65,37,93,54,39,31,19,27,18,11,-3,25,9,17,12,9,-5,6,10,10,6,2,2,14,23,31,16,7,1,9,14,16,9,5,0,5,9,15,7,2,1,-4,-12,8,13,-2,15,-4,5,-1,1,-7,8,-3,-1,8,-13,0,3,-1,6,-9,14,-7,5,7,6,-2,1,-1,2,4,-2,-3,-1,-2,2,3,8,1,2,1,0,0,-10,10,-36,-26,-10,18,-7,-14,-5,4,5,10,-5,-13,-5,1,3,8,-2,-1,0,3,2,-10,5,-10,-10,-7,-4,-5,1,-10,-7,-2,-3,-5,4,0,-3,-5,-1,46,21,25,-2,-2,0,9,17,9,9,2,4,9,13,-4,9,-3,0,0,4,13,0,5,4,1,2,-1,-2,-1,-1,-2,2,0,0,-1,-1,3,0,-1,-2,0,0,56,26,30,-8,-9,1,35,-4,-2,12,11,3,12,-11,9,1,10,2,23,7,-11,11,1,1,-2,-1,-8,1,2,-1,-3,-3,-4,-1,1,0,1,2,-4,2,1,-1,5,-5,10,-48,-36,-12,11,-4,-5,-3,4,2,5,-3,-11,2,1,2,6,-1,6,-5,3,0,-9,-4,-20,-11,-4,-1,-2,-3,-17,-10,-4,0,-7,-1,-3,-1,0,-1,-51,-29,-22,-47,-33,-14,19,-10,-19,-11,-9,-16,6,1,-16,-10,-3,-4,13,-11,-3,-1,-6,-12,4,-4,-19,-18,-8,-1,2,-1,-14,-15,-4,0,2,-3,-5,-3,-4,-1,-9,16,-25,-10,-6,-4,-11,-1,-1,4,2,-3,1,-2,6,11,0,-3,-12,1,-7,-7,2,0,2,6,-12,1,-6,-2,2,3,-8,2,-4,-2,0,3,-4,-1,-2,0,11,9,2,11,11,0,11,12,-7,2,2,-9,14,1,-1,1,3,-9,-3,11,-6,1,-1,0,2,13,2,-2,-3,-2,2,5,6,-2,0,-1,0,8,-4,0,-3,-1,11,-11,22,-6,-9,3,0,-8,15,-4,5,-4,-1,-1,-10,3,4,-6,1,-7,25,-7,1,2,2,-2,0,-9,4,0,5,0,-5,-8,1,-1,-3,-2,5,-1,3,1
25,25072,Cervera,7330,210,130,80,181,126,55,28,64,75,35,1,4,7,46,58,19,-1,0,21,18,17,16,2,4,19,48,84,24,3,0,10,32,65,17,0,0,9,16,19,7,3,0,348,247,101,339,247,92,43,84,137,56,16,9,19,60,107,48,6,4,24,24,30,8,10,5,35,82,152,57,6,3,17,61,117,45,3,2,18,21,35,12,3,1,286,198,88,354,252,102,30,103,112,32,-3,5,19,82,73,24,-2,-1,11,21,39,8,-1,6,42,116,126,52,15,0,21,85,96,38,11,0,21,31,30,14,4,0,188,101,87,279,194,85,25,75,55,12,4,12,5,54,27,11,1,-1,20,21,28,1,3,13,42,92,97,40,4,1,23,67,70,30,1,0,19,25,27,10,3,1,374,241,133,359,244,115,53,130,122,54,14,-6,29,83,93,35,0,-2,24,47,29,19,14,-4,46,113,130,57,7,4,22,75,102,40,2,2,24,38,28,17,5,2,75,15,60,251,158,93,58,27,-29,-4,9,6,30,13,-30,-11,7,2,28,14,1,7,2,4,54,65,97,26,5,1,26,43,66,17,3,1,28,22,31,9,2,0,30,16,14,190,100,90,9,34,-5,-6,2,0,25,23,-16,-12,1,-3,-16,11,11,6,1,3,59,55,60,14,1,0,41,34,22,3,0,0,18,21,38,11,1,0,122,74,48,221,132,89,26,47,46,4,-7,4,17,38,26,-8,-1,2,9,9,20,12,-6,2,34,53,81,40,10,1,14,33,59,20,4,1,20,20,22,20,6,0,66,15,51,142,77,65,32,45,-2,6,1,-12,21,9,-18,7,1,-4,11,36,16,-1,0,-8,37,42,46,19,-3,-1,20,16,27,13,0,-1,17,26,19,6,-3,0,-75,-67,-8,-35,-55,20,-5,18,-48,-36,-9,-1,2,2,-34,-31,-11,1,-7,16,-14,-5,2,-2,10,19,-27,-25,-12,-4,9,4,-33,-26,-10,-2,1,15,6,1,-2,-2,-3,-22,19,67,35,32,-6,-10,1,5,-4,4,-8,-11,-15,11,-2,1,2,1,16,-6,-2,3,10,17,28,8,4,-2,4,6,14,9,1,0,6,11,14,-1,3,-2,-1,-37,36,34,1,33,42,-5,-28,-7,-12,9,13,0,-27,-18,-2,-1,29,-5,-1,11,-10,10,27,18,1,-9,-8,3,10,13,-4,-16,-4,0,17,5,5,7,-4,3,-87,-46,-41,-11,-2,-9,-30,1,-42,-9,-10,2,-12,3,-33,-1,-4,2,-18,-2,-9,-8,-6,0,-5,10,-7,-4,-7,1,2,7,-9,0,-4,1,-7,3,2,-4,-3,0,-144,-83,-61,-118,-70,-48,-16,-17,-35,-46,-34,4,-10,-9,-25,-20,-22,2,-6,-8,-10,-26,-12,2,-20,-5,-34,-40,-16,-3,-5,-1,-24,-27,-12,-1,-15,-4,-10,-13,-4,-2,-137,-95,-42,-50,-48,-2,-18,-8,-41,-59,-10,-1,-22,-3,-24,-42,-4,-1,4,-5,-17,-17,-6,0,-11,12,-16,-25,-8,0,-12,5,-11,-20,-8,-1,1,7,-5,-5,0,1,-41,-7,-34,-3,-2,-1,4,-14,-13,-7,-19,13,15,3,-7,-5,-15,6,-11,-17,-6,-2,-4,7,1,4,-2,-4,-6,3,3,4,-1,-5,-3,0,-2,0,-1,1,-3,3,54,29,25,51,20,31,-6,8,19,23,-1,8,-11,3,17,11,5,2,5,5,2,12,-6,6,3,18,22,6,-4,4,-1,7,10,3,-2,2,4,11,12,3,-2,2,86,75,11,58,42,16,15,2,41,23,3,-1,1,6,35,23,4,2,14,-4,6,0,-1,-3,15,9,26,7,2,-2,3,9,20,7,2,0,12,0,6,0,0,-2
25,25077,Coll de Nargó,617,5,2,3,4,1,3,-1,6,-1,0,2,-2,-1,1,1,1,2,-2,0,5,-2,-1,0,0,0,1,3,0,0,0,0,0,1,0,0,0,0,1,2,0,0,0,8,1,7,4,2,2,5,-2,2,3,1,-1,1,1,-1,0,0,0,4,-3,3,3,1,-1,0,1,2,1,0,0,0,1,1,0,0,0,0,0,1,1,0,0,-5,2,-7,5,3,2,-4,3,2,-5,-1,0,-2,1,3,0,-1,1,-2,2,-1,-5,0,-1,2,1,0,1,1,0,0,1,0,1,1,0,2,0,0,0,0,0,14,1,13,7,2,5,1,3,4,7,0,-1,0,1,-1,0,1,0,1,2,5,7,-1,-1,0,1,2,4,0,0,0,1,1,0,0,0,0,0,1,4,0,0,11,16,-5,11,8,3,-1,5,4,2,0,1,2,5,6,2,0,1,-3,0,-2,0,0,0,2,3,1,5,0,0,1,2,2,3,0,0,1,1,-1,2,0,0,25,20,5,17,10,7,0,6,11,6,0,2,-1,5,9,4,1,2,1,1,2,2,-1,0,2,5,5,5,0,0,0,3,5,2,0,0,2,2,0,3,0,0,17,4,13,18,7,11,5,6,-1,3,-3,5,4,3,-2,0,-3,1,1,3,1,3,0,4,4,8,0,4,-1,1,3,5,-1,0,-1,0,1,3,1,4,0,1,12,9,3,11,5,6,-4,4,0,7,3,1,-1,2,2,4,0,1,-3,2,-2,3,3,0,0,6,0,2,2,0,0,3,0,1,0,0,0,3,0,1,2,0,10,1,9,10,1,9,4,2,2,1,-1,2,1,1,1,-1,-1,0,3,1,1,2,0,2,2,2,1,1,2,2,0,0,0,0,0,1,2,2,1,1,2,1,-11,-6,-5,-1,0,-1,-1,-1,-5,-4,0,0,-1,1,-4,-3,1,0,0,-2,-1,-1,-1,0,0,0,2,-4,0,1,0,1,1,-3,0,1,0,-1,1,-1,0,0,0,5,-5,2,2,0,1,4,-3,1,-2,-1,2,3,-2,3,-1,-1,-1,1,-1,-2,-1,0,0,0,0,1,1,0,0,0,0,1,0,1,0,0,0,0,1,-1,-6,-2,-4,1,-1,2,0,2,-6,-3,1,0,-2,-1,1,-1,1,0,2,3,-7,-2,0,0,1,1,0,0,-1,0,0,0,0,0,-1,0,1,1,0,0,0,0,-6,-6,0,-6,-6,0,-3,-1,0,1,-1,-1,-1,-1,0,-1,-2,-1,-2,0,0,2,1,0,-3,-2,0,-2,0,1,-2,-2,0,-1,-1,0,-1,0,0,-1,1,1,7,2,5,2,1,1,5,-1,1,0,2,-1,2,-1,1,-1,1,-1,3,0,0,1,1,0,3,1,-1,-2,0,0,2,0,0,-2,0,0,1,1,-1,0,0,0,-8,-2,-6,0,2,-2,0,1,-3,-1,-5,0,0,1,-1,-1,-1,0,0,0,-2,0,-4,0,1,0,0,1,-2,0,1,0,1,0,0,0,0,0,-1,1,-2,0,3,0,3,0,0,0,1,5,-3,5,-2,-2,1,4,-2,-2,0,0,0,1,-1,7,-2,-2,3,0,-1,1,-2,-1,1,0,0,0,-1,0,2,0,-1,1,-1,-1,-13,-6,-7,1,2,-1,-5,2,-4,-4,-2,0,-4,3,-2,-1,-2,0,-1,-1,-2,-3,0,0,1,0,0,-1,0,1,0,1,0,0,0,1,1,-1,0,-1,0,0,-3,0,-3,4,2,2,4,0,-4,-4,0,0,3,0,-2,-1,-1,0,1,0,-2,-3,1,0,2,1,1,0,0,0,1,1,0,0,0,0,1,0,1,0,0,0
25,25099,Golmés,1311,22,25,-3,33,29,4,-5,9,14,3,1,0,-1,9,12,4,1,0,-4,0,2,-1,0,0,0,15,14,3,1,0,0,12,13,3,1,0,0,3,1,0,0,0,60,40,20,40,30,10,8,25,15,11,4,-3,7,18,8,7,1,-1,1,7,7,4,3,-2,4,22,5,7,2,0,3,15,4,7,1,0,1,7,1,0,1,0,24,14,10,19,8,11,6,6,13,4,0,-4,0,2,11,4,-1,-2,6,4,2,0,1,-2,4,10,3,1,1,0,1,5,2,0,0,0,3,5,1,1,1,0,9,2,7,18,10,8,0,1,2,1,2,3,0,2,2,-3,1,0,0,-1,0,4,1,3,6,4,5,3,0,0,4,3,3,0,0,0,2,1,2,3,0,0,60,32,28,11,5,6,15,7,11,18,4,5,10,-1,7,13,3,1,5,8,4,5,1,4,0,5,3,2,0,1,0,1,2,2,0,0,0,4,1,0,0,1,47,31,16,11,10,1,13,2,25,4,-1,1,8,1,18,0,1,1,5,1,7,4,-2,0,1,2,5,3,0,0,1,2,5,2,0,0,0,0,0,1,0,0,37,33,4,16,11,5,14,-1,14,9,-2,5,12,5,11,8,-3,2,2,-6,3,1,1,3,2,4,8,0,1,0,2,3,6,0,0,0,0,1,2,0,1,0,38,4,34,27,8,19,9,14,6,16,-3,-1,1,5,-2,5,-2,-1,8,9,8,11,-1,0,5,13,7,1,1,0,2,4,1,0,1,0,3,9,6,1,0,0,37,24,13,10,8,2,12,8,2,12,3,0,6,6,8,4,1,-1,6,2,-6,8,2,1,2,5,2,0,1,0,2,5,2,-1,0,0,0,0,0,1,1,0,9,3,6,5,-3,8,8,-6,-10,18,2,-2,4,-3,-8,12,2,-2,4,-3,-2,6,0,0,6,0,-5,0,3,0,2,1,-7,-2,2,0,4,-1,2,2,1,0,11,1,10,-2,-4,2,12,-3,1,-5,1,4,6,-3,2,-5,1,2,6,0,-1,0,0,2,3,-1,-1,-3,-2,1,1,-3,0,-1,-1,0,2,2,-1,-2,-1,1,40,26,14,10,6,4,14,10,-1,12,7,-1,9,2,2,7,4,1,5,8,-3,5,3,-2,1,2,4,3,1,-1,1,0,2,2,1,0,0,2,2,1,0,-1,14,13,1,-26,-16,-10,-5,0,15,-3,8,-2,-5,8,10,-4,6,-2,0,-8,5,1,2,0,-11,-1,-7,-6,0,-1,-7,1,-5,-3,-1,-1,-4,-2,-2,-3,1,0,-33,-8,-25,-11,-5,-6,-6,-3,-7,-10,-1,-6,-2,2,-3,-5,1,-1,-4,-5,-4,-5,-2,-5,-2,0,-7,0,-2,0,0,1,-5,-1,0,0,-2,-1,-2,1,-2,0,27,17,10,7,5,2,7,-1,22,-4,2,1,4,-1,14,1,-1,0,3,0,8,-5,3,1,2,1,4,-1,1,0,2,0,3,-1,1,0,0,1,1,0,0,0,66,23,43,-1,-6,5,26,-1,15,24,1,0,13,-1,0,8,1,0,13,0,15,16,0,0,-3,0,3,-3,2,0,-4,0,0,-3,1,0,1,0,3,0,1,0,21,12,9,7,-1,8,5,8,12,-10,3,1,5,3,8,-7,1,1,0,5,4,-3,2,0,-2,1,5,-2,3,0,-1,-1,2,-2,1,0,-1,2,3,0,2,0,7,18,-11,-2,2,-4,3,3,3,-3,4,-3,8,3,5,-3,3,1,-5,0,-2,0,1,-4,-2,2,-1,0,-1,1,0,1,0,0,0,1,-2,1,-1,0,-1,0
25,25110,Guissona,3164,67,37,30,42,27,15,18,16,19,15,5,-4,11,6,11,10,2,-3,7,10,8,5,3,-1,8,6,22,5,1,0,4,3,16,4,0,0,4,3,6,1,1,0,279,204,75,246,176,70,26,59,136,51,-2,8,14,34,113,39,-1,5,12,25,23,12,-1,3,17,62,125,39,3,0,8,39,97,29,3,0,9,23,28,10,0,0,382,218,164,346,213,133,53,73,206,32,5,12,30,40,128,14,1,5,23,33,78,18,4,7,41,84,186,31,3,0,21,49,122,18,2,0,20,35,64,13,1,0,290,190,100,348,222,126,37,68,139,22,8,14,22,38,107,16,1,5,15,30,32,6,7,9,41,77,181,36,9,2,18,38,136,24,4,1,23,39,45,12,5,1,376,227,149,510,323,187,58,78,231,5,1,2,43,33,150,-5,3,2,15,45,81,10,-2,0,75,104,299,27,3,0,50,48,207,17,0,0,25,56,92,10,3,0,263,121,142,390,197,193,97,50,86,13,4,10,42,18,46,8,0,3,55,32,40,5,4,7,120,81,144,36,5,1,51,34,85,21,3,0,69,47,59,15,2,1,172,57,115,290,149,141,82,43,49,-18,3,10,52,19,10,-24,-2,1,30,24,39,6,5,9,95,61,122,5,3,0,53,29,66,0,-1,0,42,32,56,5,4,0,403,195,208,483,243,240,96,94,143,58,-1,7,34,44,75,39,0,1,62,50,68,19,-1,6,124,101,179,64,7,2,56,45,99,38,2,0,68,56,80,26,5,2,483,317,166,431,291,140,44,130,157,77,7,64,27,88,119,59,3,18,17,42,38,18,4,46,63,119,163,66,12,4,38,72,125,49,4,1,25,47,38,17,8,3,94,11,83,103,4,99,46,31,17,-19,11,2,25,2,3,-21,1,-1,21,29,14,2,10,3,50,41,19,-19,12,-2,19,8,5,-27,0,-1,31,33,14,8,12,-1,227,91,136,110,17,93,74,52,80,19,-6,6,37,26,39,-8,-3,0,37,26,41,27,-3,6,60,37,25,-6,-10,0,33,15,-3,-27,-3,0,27,22,28,21,-7,0,155,72,83,94,31,63,53,44,40,16,-6,3,24,16,16,13,1,-1,29,28,24,3,-7,4,38,34,17,4,-4,1,17,11,6,-4,0,0,21,23,11,8,-4,1,-33,-10,-23,-38,-28,-10,-14,9,16,-40,-7,2,4,0,18,-28,-9,3,-18,9,-2,-12,2,-1,-11,8,3,-27,-9,-3,-1,2,1,-22,-8,-1,-10,6,2,-5,-1,-2,-16,-39,23,-68,-65,-3,-14,16,-7,-21,0,7,-7,0,-15,-17,-1,1,-7,16,8,-4,1,6,-11,-3,-22,-36,1,1,-6,-8,-25,-26,-1,0,-5,5,3,-10,2,1,-40,-8,-32,-49,-28,-21,-14,21,-17,-22,-5,-3,-5,13,-4,-8,-2,-1,-9,8,-13,-14,-3,-2,-12,12,-22,-22,-6,-2,-7,3,-11,-12,-2,0,-5,9,-11,-10,-4,-2,-22,-27,5,60,16,44,-11,23,-25,-9,-2,5,8,1,-15,-19,-6,4,-19,22,-10,10,4,1,11,32,5,9,3,0,12,10,-3,-3,-1,0,-1,22,8,12,4,0,76,55,21,102,64,38,22,14,28,-3,-4,17,15,13,16,2,-4,8,7,1,12,-5,0,9,41,20,29,3,-1,7,25,21,16,1,-4,2,16,-1,13,2,3,5,-1,12,-13,72,33,39,-6,2,25,-24,7,-5,-2,8,22,-22,8,-2,-4,-6,3,-2,-1,-3,17,15,34,-1,6,1,7,8,24,-10,4,0,10,7,10,9,2,1
25,25120,Lleida,112207,-494,-232,-262,685,365,320,-145,-1,-40,-87,-106,-90,-71,-21,11,-41,-61,-33,-74,20,-51,-46,-45,-57,86,197,282,92,17,6,40,90,165,55,8,3,46,107,117,37,9,3,1381,778,603,1524,817,707,241,388,568,186,-12,-8,132,193,353,95,-10,0,109,195,215,91,-2,-8,229,416,583,240,38,9,130,202,327,134,16,2,99,214,256,106,22,7,1774,927,847,1916,997,919,305,493,753,262,-28,-25,143,189,443,176,-38,9,162,304,310,86,10,-34,327,538,706,270,56,3,159,230,413,158,27,1,168,308,293,112,29,2,2157,1123,1034,2342,1248,1094,382,596,825,311,-20,44,177,264,508,171,-21,13,205,332,317,140,1,31,427,623,855,337,67,11,208,299,505,186,34,6,219,324,350,151,33,5,3665,2321,1344,3916,2433,1483,380,1057,1501,616,77,26,177,577,1098,418,43,6,203,480,403,198,34,20,456,1102,1545,661,100,31,246,602,1078,430,48,16,210,500,467,231,52,15,2201,1144,1057,3728,2206,1522,364,833,660,271,3,45,157,408,399,158,-1,6,207,425,261,113,4,39,539,1100,1337,585,104,30,291,594,861,382,48,12,248,506,476,203,56,18,2908,1600,1308,3703,2054,1649,440,838,1148,397,6,93,242,452,691,206,-7,33,198,386,457,191,13,60,639,1007,1307,575,116,34,344,531,783,322,55,9,295,476,524,253,61,25,3758,2222,1536,4513,2611,1902,534,1200,1153,666,142,53,285,641,744,432,68,40,249,559,409,234,74,13,677,1332,1477,789,165,36,344,705,955,479,90,13,333,627,522,310,75,23,2411,1241,1170,2648,1448,1200,351,905,628,402,95,22,131,485,419,169,14,9,220,420,209,233,81,13,409,908,855,365,82,5,192,496,532,192,23,-2,217,412,323,173,59,7,680,68,612,963,362,601,141,516,-4,-9,-17,40,70,231,-96,-103,-45,-2,71,285,92,94,28,42,178,523,202,28,11,-2,84,264,64,-59,0,-4,94,259,138,87,11,2,595,104,491,916,320,596,122,331,-63,86,63,26,65,114,-117,3,7,22,57,217,54,83,56,4,195,393,116,114,61,4,104,159,6,16,15,-1,91,234,110,98,46,5,367,82,285,513,165,348,79,227,-112,51,12,97,41,104,-157,23,16,51,38,123,45,28,-4,46,97,279,2,92,7,12,60,124,-42,11,0,1,37,155,44,81,7,11,153,92,61,114,-54,168,-34,274,-97,-74,25,54,-3,151,-54,-55,11,34,-31,123,-43,-19,14,20,53,275,-106,-104,-11,-5,40,132,-122,-101,-15,3,13,143,16,-3,4,-8,-771,-488,-283,-774,-509,-265,-94,19,-425,-225,-81,33,-30,11,-272,-168,-40,9,-64,8,-153,-57,-41,24,-89,68,-415,-221,-109,-20,-34,31,-273,-171,-63,-4,-55,37,-142,-50,-46,-16,-470,-407,-63,-581,-478,-103,-80,212,-356,-162,-99,-26,-41,95,-243,-166,-45,-23,-39,117,-113,4,-54,-3,-120,177,-308,-236,-107,-16,-58,66,-226,-203,-60,-14,-62,111,-82,-33,-47,-2,-639,-314,-325,-679,-394,-285,-156,176,-391,-178,-151,76,-84,81,-147,-116,-101,61,-72,95,-244,-62,-50,15,-130,198,-263,-295,-185,-19,-72,88,-110,-189,-108,-9,-58,110,-153,-106,-77,-10,-415,-216,-199,-354,-178,-176,-39,152,-355,-156,-35,-6,12,101,-140,-144,-49,-4,-51,51,-215,-12,14,-2,-30,148,-215,-198,-66,-11,11,78,-78,-136,-44,-15,-41,70,-137,-62,-22,4,5,-54,59,24,-7,31,170,178,-19,-238,-105,5,109,89,23,-232,-64,14,61,89,-42,-6,-41,-9,99,218,17,-187,-134,-4,58,111,35,-139,-80,-3,41,107,-18,-48,-54,-1
25,25137,Mollerussa,9481,179,88,91,122,64,58,53,49,68,18,-1,-5,28,22,37,8,-1,-4,25,27,31,10,0,-1,30,33,40,18,1,0,17,15,22,10,0,0,13,18,18,8,1,0,245,151,94,254,150,104,42,59,66,42,23,8,27,29,47,31,11,3,15,30,19,11,12,5,54,59,86,38,12,2,29,37,52,24,4,1,25,22,34,14,8,1,307,203,104,228,136,92,31,78,138,42,8,1,13,43,104,34,-1,0,18,35,34,8,9,1,40,61,87,27,9,1,21,34,57,17,3,1,19,27,30,10,6,0,453,264,189,316,189,127,70,105,146,71,28,25,46,68,87,39,14,7,24,37,59,32,14,18,52,85,119,43,12,2,28,50,72,29,6,1,24,35,47,14,6,1,627,380,247,514,331,183,78,158,252,107,23,3,33,87,178,65,14,0,45,71,74,42,9,3,69,140,187,99,12,4,36,81,136,68,6,1,33,59,51,31,6,3,604,338,266,416,258,158,107,186,173,101,19,7,58,103,95,72,7,-2,49,83,78,29,12,9,67,125,134,80,7,1,34,85,81,53,4,0,33,40,53,27,3,1,619,345,274,409,211,198,126,125,236,109,24,-8,75,56,142,66,13,-7,51,69,94,43,11,-1,97,109,136,62,3,-1,55,45,74,36,0,0,42,64,62,26,3,-1,392,250,142,313,185,128,39,94,146,71,25,6,28,56,109,33,8,5,11,38,37,38,17,1,52,109,84,50,11,2,29,59,54,29,7,2,23,50,30,21,4,0,480,234,246,388,189,199,15,184,143,80,33,14,0,89,74,45,13,5,15,95,69,35,20,9,56,131,126,50,19,4,37,66,61,18,7,-1,19,65,65,32,12,5,270,134,136,221,124,97,74,90,84,19,-5,8,50,47,48,-2,-15,8,24,43,36,21,10,0,66,74,58,23,-1,1,43,41,38,5,-4,1,23,33,20,18,3,0,-76,-57,-19,115,54,61,-27,48,-63,-29,1,0,-8,6,-30,-30,6,1,-19,42,-33,1,-5,-1,24,53,21,9,5,1,12,19,17,2,2,1,12,34,4,7,3,0,98,-3,101,185,97,88,-3,58,-1,34,-4,6,-6,12,-13,8,-8,1,3,46,12,26,4,5,31,62,42,27,13,5,19,26,29,14,6,0,12,36,13,13,7,5,69,21,48,64,30,34,-2,14,27,0,13,10,3,-6,10,7,2,6,-5,20,17,-7,11,4,15,24,13,7,5,-1,10,9,4,6,3,-2,5,15,9,1,2,1,-42,-23,-19,-20,-22,2,-8,27,-24,-17,-8,-10,13,8,-11,-22,-1,-8,-21,19,-13,5,-7,-2,2,16,-11,-19,-9,-2,6,0,-11,-15,-3,0,-4,16,0,-4,-6,-2,72,58,14,157,81,76,-1,36,12,22,14,-7,3,19,6,18,12,2,-4,17,6,4,2,-9,26,37,50,33,9,1,12,11,29,22,6,0,14,26,21,11,3,1,58,61,-3,152,98,54,-14,32,37,16,-8,1,10,16,28,15,-7,4,-24,16,9,1,-1,-3,25,38,54,25,4,5,20,23,34,15,3,3,5,15,20,10,1,2,163,75,88,149,74,75,33,24,35,52,1,9,12,5,11,40,0,3,21,19,24,12,1,6,44,26,34,28,6,9,23,14,12,20,1,2,21,12,22,8,5,7,184,124,60,186,121,65,26,47,75,40,-5,-2,24,27,49,26,3,-5,2,20,26,14,-8,3,33,27,77,41,8,-1,27,17,47,23,7,-1,6,10,30,18,1,0
25,25149,Oliana,1869,11,-3,14,7,4,3,5,-2,1,0,3,5,2,-2,-5,1,3,-1,3,0,6,-1,0,6,1,1,2,2,0,1,1,0,1,1,0,1,0,1,1,1,0,0,21,12,9,16,9,7,6,1,6,-2,2,8,3,-1,4,1,2,3,3,2,2,-3,0,5,3,2,7,2,2,0,2,0,5,1,1,0,1,2,2,1,1,0,5,6,-1,22,9,13,1,4,-15,7,2,7,0,6,-6,3,1,3,1,-2,-9,4,1,4,4,5,6,4,1,2,1,2,4,2,0,0,3,3,2,2,1,2,32,27,5,25,13,12,0,12,5,7,5,2,0,8,6,6,5,1,0,4,-1,1,0,1,4,3,6,10,0,2,2,2,3,5,0,1,2,1,3,5,0,1,78,35,43,44,23,21,15,10,20,23,6,2,7,7,4,14,2,-1,8,3,16,9,4,3,6,9,15,12,1,0,2,4,5,10,1,0,4,5,10,2,0,0,43,12,31,57,24,33,4,20,16,2,-3,3,0,5,9,-2,-1,0,4,15,7,4,-2,3,7,20,19,10,1,0,3,8,9,4,0,0,4,12,10,6,1,0,11,-9,20,32,13,19,8,-1,-10,6,3,6,-2,-2,-10,3,2,1,10,1,0,3,1,5,2,8,14,4,3,1,0,4,6,1,2,0,2,4,8,3,1,1,38,13,25,44,19,25,12,15,2,-3,2,7,4,6,-1,-1,1,3,8,9,3,-2,1,4,13,11,10,4,4,1,7,5,4,1,2,0,6,6,6,3,2,1,36,20,16,40,14,26,-2,16,-4,8,12,7,-1,5,2,6,8,1,-1,11,-6,2,4,6,8,11,9,7,4,1,4,1,3,5,1,0,4,10,6,2,3,1,-13,-2,-11,8,5,3,0,0,-14,-1,-2,2,1,2,-8,-1,-1,4,-1,-2,-6,0,-1,-2,4,6,-4,2,0,0,4,2,-2,1,0,0,0,4,-2,1,0,0,17,5,12,25,10,15,13,3,-3,1,1,0,6,2,0,-6,1,1,7,1,-3,7,0,-1,8,11,0,4,1,0,4,6,-1,-1,1,0,4,5,1,5,0,0,-1,-13,12,16,3,13,-9,10,-4,-9,3,6,-5,2,-5,-8,0,2,-4,8,1,-1,3,4,0,8,5,-1,0,3,0,5,1,-4,0,1,0,3,4,3,0,2,6,-2,8,1,-1,2,5,-6,4,-2,0,4,1,-2,-1,-1,-2,2,4,-4,5,-1,2,2,3,-2,-1,0,0,0,2,-1,-2,-1,0,0,1,-1,1,1,0,0,5,12,-7,4,5,-1,0,-1,7,-6,2,1,3,-1,8,-1,1,2,-3,0,-1,-5,1,-1,-1,5,-1,-1,0,1,1,2,2,-1,0,1,-2,3,-3,0,0,0,-51,-17,-34,-47,-23,-24,-8,-3,-17,-15,-9,1,-2,3,-7,-4,-7,0,-6,-6,-10,-11,-2,1,-10,3,-19,-15,-6,0,-7,5,-9,-7,-4,-1,-3,-2,-10,-8,-2,1,9,9,0,-20,-8,-12,-5,-6,6,8,6,-2,-4,0,-1,6,7,0,-1,-6,7,2,-1,-2,-1,-5,-7,-5,-3,-1,0,-2,-6,-1,0,0,-1,-3,-1,-4,-3,-1,2,1,1,18,11,7,-5,4,-1,-5,5,3,-2,3,-2,-2,1,2,-3,1,1,-3,4,1,2,6,6,-1,4,0,3,4,3,-2,2,0,-1,2,3,1,2,0,-20,-11,-9,-5,-4,-1,-8,1,-12,-2,-2,2,-5,-1,-9,4,-2,2,-3,2,-3,-6,0,0,-3,2,-2,0,-2,0,0,-1,-3,0,0,0,-3,3,1,0,-2,0
25,25185,Ribera d'Urgellet,748,20,11,9,15,10,5,-2,-2,9,9,2,2,-1,-1,2,6,2,1,-1,-1,7,3,0,1,2,0,6,2,3,1,2,0,3,1,2,1,0,0,3,1,1,0,20,10,10,9,5,4,5,7,10,3,0,-5,2,4,2,2,1,-1,3,3,8,1,-1,-4,0,3,1,3,1,1,0,2,0,2,0,1,0,1,1,1,1,0,-26,-15,-11,2,0,2,-7,2,-10,-4,-3,-4,-4,0,-4,-3,-1,-3,-3,2,-6,-1,-2,-1,3,1,-1,1,-1,-1,1,1,-1,0,-1,0,2,0,0,1,0,-1,30,23,7,27,17,10,3,15,8,11,-1,-4,1,8,7,8,3,-2,2,7,1,3,-4,-2,3,7,10,5,2,0,1,4,7,3,2,0,2,3,3,2,0,0,61,41,20,35,17,18,0,12,32,15,-1,1,2,6,23,8,1,-1,-2,6,9,7,-2,2,1,12,15,6,1,0,1,3,8,5,0,0,0,9,7,1,1,0,49,23,26,43,24,19,8,17,3,14,3,2,7,5,5,3,1,2,1,12,-2,11,2,0,8,8,12,9,1,4,6,2,11,2,0,2,2,6,1,7,1,2,-16,-14,-2,29,20,9,1,4,-11,2,-7,-5,-1,0,-6,-2,-2,-3,2,4,-5,4,-5,-2,4,11,7,8,-1,0,2,8,4,6,0,0,2,3,3,2,-1,0,45,30,15,58,36,22,10,12,14,7,2,1,2,12,11,6,1,-1,8,0,3,1,1,2,6,17,22,10,2,0,3,8,16,6,2,0,3,9,6,4,0,0,-16,-5,-11,17,9,8,5,-12,-1,2,-4,-3,5,-3,-4,-2,0,0,0,-9,3,4,-4,-3,8,-3,6,5,1,0,7,0,0,1,1,0,1,-3,6,4,0,0,29,14,15,2,1,1,4,6,8,5,8,-1,0,4,6,1,5,-1,4,2,2,4,3,0,2,2,-6,0,4,0,2,1,-1,-2,2,-1,0,1,-5,2,2,1,-4,-9,5,-6,-11,5,-8,2,-1,3,-1,1,-3,-2,-3,-1,-1,0,-5,4,2,4,0,1,-2,0,0,-1,-3,0,-3,-1,-3,-2,-1,-1,1,1,3,1,-2,1,28,14,14,11,7,4,5,4,9,2,8,0,2,5,2,1,4,0,3,-1,7,1,4,0,4,5,2,4,-4,0,2,5,1,1,-2,0,2,0,1,3,-2,0,-31,-17,-14,-9,-8,-1,-3,-1,1,-10,-14,-1,0,0,3,-6,-10,-1,-3,-1,-2,-4,-4,0,0,-2,-4,-2,-2,0,-1,-1,-3,-1,-2,0,1,-1,-1,-1,0,0,-3,10,-13,0,4,-4,-1,3,0,2,-2,-1,-2,0,5,5,3,-1,1,3,-5,-3,-5,0,2,1,-1,-1,-1,0,2,1,0,0,1,0,0,0,-1,-1,-2,0,19,14,5,0,5,-5,10,2,10,2,-4,1,10,0,7,0,-3,2,0,2,3,2,-1,-1,1,2,0,1,-2,-1,2,1,1,2,-1,1,-1,1,-1,-1,-1,-2,-10,-6,-4,-4,0,-4,-6,-4,1,-3,0,0,-6,-1,0,-2,3,-1,0,-3,1,-1,-3,1,-3,0,-1,-3,2,0,-2,0,0,-3,4,0,-1,0,-1,0,-2,0,-11,-5,-6,-11,-5,-6,-7,12,-12,1,-6,-1,3,4,-2,-5,-6,0,-10,8,-10,6,0,-1,-2,3,-7,1,-6,0,1,1,-2,-1,-4,0,-3,2,-5,2,-2,0,-5,-8,3,2,-2,4,2,7,-7,1,-3,-4,0,1,-3,-1,-3,-3,2,6,-4,2,0,-1,3,0,-2,-2,2,1,1,0,-2,0,-1,0,2,0,0,-2,3,1
25,25189,Rosselló,1796,56,31,25,5,3,2,18,5,20,5,1,6,8,3,11,3,2,4,10,2,9,2,-1,2,0,2,2,0,1,0,0,1,1,0,1,0,0,1,1,0,0,0,60,37,23,30,19,11,7,14,14,19,-1,7,0,12,14,9,-2,4,7,2,0,10,1,3,3,12,7,7,1,0,2,8,5,3,1,0,1,4,2,4,0,0,33,20,13,30,17,13,8,0,6,11,4,-2,8,-5,1,10,2,1,0,5,5,1,2,-3,3,5,14,5,0,0,2,1,9,4,0,0,1,4,5,1,0,0,105,61,44,37,19,18,15,19,37,15,11,7,6,10,28,5,7,4,9,9,9,10,4,3,8,6,13,8,1,0,4,2,8,4,1,0,4,4,5,4,0,0,146,95,51,42,24,18,23,12,47,29,4,31,22,13,23,25,0,13,1,-1,24,4,4,18,6,7,15,9,2,2,4,4,9,5,1,1,2,3,6,4,1,1,185,141,44,48,34,14,34,30,86,13,13,8,22,20,72,16,6,3,12,10,14,-3,7,5,8,13,17,5,5,0,7,8,14,4,1,0,1,5,3,1,4,0,154,94,60,43,20,23,37,22,60,18,11,7,23,17,35,10,6,3,14,5,25,8,5,4,9,8,12,7,3,3,7,4,4,1,1,2,2,4,8,6,2,1,110,81,29,44,30,14,14,16,52,15,10,2,10,8,33,18,8,3,4,8,19,-3,2,-1,4,9,20,8,2,1,5,3,11,8,3,0,-1,6,9,0,-1,1,119,77,42,24,14,10,17,15,49,14,2,21,7,6,35,10,3,14,10,9,14,4,-1,7,7,4,8,3,4,-3,4,1,6,2,1,-1,3,3,2,1,3,-2,40,31,9,21,12,9,0,25,12,-5,2,10,-1,18,18,-8,4,3,1,7,-6,3,-2,7,1,13,9,-2,0,0,-1,9,6,-2,0,0,2,4,3,0,0,0,70,50,20,23,10,13,2,12,14,15,7,18,2,9,15,7,4,11,0,3,-1,8,3,7,2,3,7,3,4,3,2,1,2,1,2,2,0,2,5,2,2,1,41,20,21,20,11,9,0,17,19,1,-2,6,-1,7,9,2,-1,3,1,10,10,-1,-1,3,4,12,2,2,-1,1,3,4,1,2,0,1,1,8,1,0,-1,0,-16,7,-23,-3,-7,4,-10,4,2,-11,-3,5,1,2,7,-7,0,5,-11,2,-5,-4,-3,0,2,-5,0,0,0,0,-1,-4,-1,0,-1,0,3,-1,1,0,1,0,-61,-29,-32,-46,-25,-21,-24,-2,-24,-15,-1,4,-12,-2,-4,-8,-1,-3,-12,0,-20,-7,0,7,-6,-3,-18,-13,-6,0,-3,-1,-8,-11,-2,0,-3,-2,-10,-2,-4,0,32,15,17,14,3,11,5,8,17,3,-4,5,-4,5,9,6,-3,2,9,3,8,-3,-1,3,3,9,5,1,-3,-1,0,4,1,0,-2,0,3,5,4,1,-1,-1,-37,-25,-12,-17,-11,-6,-17,-1,-6,-15,-6,6,-11,-4,-5,-7,-2,2,-6,3,-1,-8,-4,4,-6,-1,-3,-6,-2,0,-1,-3,-1,-5,-2,0,-5,2,-2,-1,0,0,52,20,32,23,10,13,14,8,12,20,3,-1,6,3,10,8,-3,0,8,5,2,12,6,-1,4,4,10,4,1,0,0,3,6,1,0,0,4,1,4,3,1,0,41,16,25,8,4,4,-6,5,24,-8,7,21,5,-1,15,-11,5,3,-11,6,9,3,2,18,-3,7,4,-5,2,3,-1,4,3,-3,1,0,-2,3,1,-2,1,3
25,25192,Sant Guim de Freixenet,1055,-22,-9,-13,5,2,3,-5,1,-10,-2,-3,-2,-2,1,-6,-1,-1,0,-3,0,-4,-1,-2,-2,2,2,0,1,0,0,1,1,0,0,0,0,1,1,0,1,0,0,15,12,3,19,11,8,-4,13,4,2,2,-1,-2,6,6,2,1,-1,-2,7,-2,0,1,0,1,7,8,3,0,0,0,3,6,2,0,0,1,4,2,1,0,0,2,3,-1,37,27,10,3,-1,-6,8,-4,0,2,-1,-3,7,-3,0,1,0,-3,1,-1,0,2,11,8,14,0,0,2,6,7,10,0,0,0,5,1,4,0,0,43,33,10,54,38,16,6,14,13,5,-1,-1,4,8,8,6,0,0,2,6,5,-1,-1,-1,4,13,19,16,0,0,2,8,12,14,0,0,2,5,7,2,0,0,-13,-8,-5,21,11,10,-4,-7,8,-9,-1,-1,-3,-4,3,-5,1,0,-1,-3,5,-4,-2,-1,3,2,13,3,0,0,1,2,6,2,0,0,2,0,7,1,0,0,10,5,5,33,16,17,4,2,7,-1,-1,-1,3,4,1,-1,-1,0,1,-2,6,0,0,-1,15,5,9,3,1,0,8,2,4,1,1,0,7,3,5,2,0,0,0,0,0,22,11,11,3,-8,6,-5,3,2,1,-6,5,-2,1,1,2,-2,1,-3,2,1,5,2,11,2,2,0,1,2,6,1,1,0,4,0,5,1,1,0,27,18,9,27,17,10,8,12,6,4,4,-5,5,9,5,0,2,-2,3,3,1,4,2,-3,8,8,7,3,1,0,4,5,5,2,1,0,4,3,2,1,0,0,12,13,-1,35,22,13,5,1,9,4,-4,-3,3,1,6,6,-1,-2,2,0,3,-2,-3,-1,7,6,11,9,0,2,3,5,6,7,0,1,4,1,5,2,0,1,-18,-6,-12,8,6,2,-5,-3,-9,-2,3,0,-4,-1,2,-2,0,0,-1,-2,-11,0,3,0,4,1,0,3,0,0,3,0,0,3,0,0,1,1,0,0,0,0,-4,-5,1,12,8,4,0,-2,4,-7,1,1,-1,0,-3,-2,2,0,1,-2,7,-5,-1,1,2,2,4,3,1,0,2,0,3,2,1,0,0,2,1,1,0,0,-2,7,-9,4,2,2,-3,-1,-2,6,0,-3,-3,2,1,6,1,-1,0,-3,-3,0,-1,-2,2,1,1,2,-1,-1,1,0,0,2,0,-1,1,1,1,0,-1,0,4,5,-1,7,5,2,4,3,-2,0,-5,4,5,1,-1,0,-3,3,-1,2,-1,0,-2,1,4,3,1,-2,1,0,4,2,1,-3,1,0,0,1,0,1,0,0,1,2,-1,5,2,3,1,2,-1,0,2,-1,2,0,1,-1,0,1,-1,2,-2,1,2,-2,1,4,1,-1,0,0,0,3,1,-2,0,0,1,1,0,1,0,0,-24,-15,-9,-6,-3,-3,-7,-1,-6,-2,-6,-2,-2,-2,-1,-1,-8,-1,-5,1,-5,-1,2,-1,0,-1,-2,-1,-2,0,0,-1,-1,0,-1,0,0,0,-1,-1,-1,0,-11,3,-14,10,6,4,1,3,0,-3,-11,-2,0,6,1,-1,-3,0,1,-3,-1,-2,-8,-2,4,4,2,2,-2,0,1,4,1,2,-2,0,3,0,1,0,0,0,-22,-13,-9,0,-4,4,-4,-4,-7,-4,-2,0,-5,1,-4,-4,1,-1,1,-5,-3,0,-3,1,2,4,-1,-4,-1,0,0,2,-2,-4,0,0,2,2,1,0,-1,0,19,11,8,3,-1,4,7,7,7,1,-2,-2,6,2,7,-1,-2,-1,1,5,0,2,0,-1,0,0,2,1,0,0,-1,-1,2,-1,0,0,1,1,0,2,0,0
25,25193,Sant Llorenç de Morunys,892,16,9,7,10,5,5,1,4,2,3,2,5,-1,2,4,1,0,4,2,2,-2,2,2,1,2,4,2,2,0,0,0,3,2,0,0,0,2,1,0,2,0,0,6,2,4,10,5,5,-6,4,3,2,3,0,-5,3,0,3,2,-1,-1,1,3,-1,1,1,0,3,3,2,2,0,0,2,1,1,1,0,0,1,2,1,1,0,15,5,10,12,5,7,2,5,4,-4,5,3,-1,4,2,-3,2,1,3,1,2,-1,3,2,2,4,4,2,0,0,0,1,3,1,0,0,2,3,1,1,0,0,22,12,10,27,14,13,2,12,-5,10,1,3,3,5,-3,6,0,2,-1,7,-2,4,1,1,6,13,1,6,1,0,4,7,0,3,0,0,2,6,1,3,1,0,38,20,18,24,11,13,13,9,2,10,3,1,8,4,0,6,2,0,5,5,2,4,1,1,7,8,3,3,3,0,2,4,2,1,2,0,5,4,1,2,1,0,3,8,-5,18,11,7,-7,6,5,0,-3,2,-2,5,7,0,-3,1,-5,1,-2,0,0,1,1,7,7,2,0,1,0,4,5,1,0,1,1,3,2,1,0,0,58,28,30,32,17,15,14,14,15,11,1,3,5,8,9,5,-1,2,9,6,6,6,2,1,9,11,8,4,0,0,4,6,6,1,0,0,5,5,2,3,0,0,62,29,33,31,13,18,6,13,14,11,8,9,3,7,5,3,6,4,3,6,9,8,2,5,6,16,8,1,1,-2,1,8,4,-1,1,-1,5,8,4,2,0,-1,22,10,12,20,9,11,4,3,-3,7,2,9,0,0,0,4,1,5,4,3,-3,3,1,4,6,5,3,5,1,0,3,4,0,2,0,0,3,1,3,3,1,0,5,-3,8,-1,-4,3,3,2,-3,0,-1,4,0,-1,0,-2,-3,3,3,3,-3,2,2,1,4,-1,-1,0,-3,0,2,-2,-1,-1,-2,0,2,1,0,1,-1,0,-35,-24,-11,2,0,2,-9,-1,-12,-14,-3,3,-5,2,-9,-8,-4,0,-4,-3,-3,-6,1,3,0,0,3,0,-1,0,0,0,1,0,-1,0,0,0,2,0,0,0,25,9,16,-5,-5,0,4,-2,5,3,1,13,2,-2,2,0,-1,7,2,0,3,3,2,6,-3,-1,0,-2,1,0,-2,-2,0,-1,0,0,-1,1,0,-1,1,0,-28,-21,-7,-8,-4,-4,-5,-1,-12,-9,-2,3,0,-1,-11,-6,-1,-1,-5,0,-1,-3,-1,4,3,-1,-8,-1,0,0,4,0,-6,-2,1,0,-1,-1,-2,1,-1,0,-2,-6,4,-6,-4,-2,-2,1,-3,-3,2,2,-3,1,-1,-3,1,-2,1,0,-2,0,1,4,-1,1,-1,-2,-2,-1,-1,0,1,-1,-2,-1,0,1,-2,-1,0,0,-4,-11,7,-16,-8,-8,-3,-3,-8,0,-5,14,-2,0,-7,-2,-1,0,-1,-3,-1,2,-4,14,-6,-2,-4,-4,0,0,-3,0,-3,-2,0,0,-3,-2,-1,-2,0,0,13,7,6,8,2,6,-2,5,2,-1,1,8,0,2,0,1,-1,5,-2,3,2,-2,2,3,0,2,5,1,-1,1,0,2,1,0,-1,0,0,0,4,1,0,1,6,9,-3,2,1,1,4,1,-1,0,-1,4,3,5,-1,2,1,0,1,-4,0,-2,-2,4,1,0,0,1,0,0,-2,2,0,1,0,0,3,-2,0,0,0,0,5,-6,11,2,1,1,0,-5,0,-2,6,5,-1,-5,-3,-2,4,0,1,0,3,0,2,5,0,1,-1,0,1,1,0,1,-1,-1,1,1,0,0,0,1,0,0
25,25204,Seròs,1760,-7,-4,-3,3,1,2,-3,1,-5,-3,2,1,-1,2,-5,-1,1,0,-2,-1,0,-2,1,1,1,0,2,0,0,0,1,0,0,0,0,0,0,0,2,0,0,0,2,2,0,12,7,5,4,0,-3,1,-2,2,4,-1,-1,0,-1,1,0,1,-2,1,-1,1,4,2,3,2,0,1,4,0,1,1,0,1,0,2,2,1,0,0,25,18,7,15,13,2,-1,6,10,8,0,3,2,6,5,5,0,1,-3,0,5,3,0,2,0,4,6,5,0,0,0,3,6,4,0,0,0,1,0,1,0,0,63,55,8,40,33,7,7,16,32,14,-4,-2,5,11,32,12,-4,-1,2,5,0,2,0,-1,5,11,19,5,0,0,4,7,19,3,0,0,1,4,0,2,0,0,66,56,10,78,60,18,2,19,40,6,1,-2,-2,17,35,5,2,-1,4,2,5,1,-1,-1,4,23,41,9,1,0,0,19,33,7,1,0,4,4,8,2,0,0,11,11,0,40,31,9,-4,12,-1,4,0,-1,-4,10,2,4,0,-2,0,2,-3,0,0,1,1,12,16,11,0,0,0,9,12,10,0,0,1,3,4,1,0,0,-2,-3,1,20,10,10,9,6,-13,3,0,-8,8,5,-13,1,0,-5,1,1,0,2,0,-3,2,8,5,5,0,0,1,5,1,3,0,0,1,3,4,2,0,0,-8,-13,5,30,16,14,0,7,0,-8,-4,-3,-1,8,-7,-9,-4,0,1,-1,7,1,0,-3,6,15,8,-1,-1,3,2,10,6,-2,-1,1,4,5,2,1,0,2,-35,-32,-3,-3,-13,10,5,-1,-20,-14,2,-6,0,0,-20,-13,3,-2,5,-1,0,-1,-1,-4,3,4,-4,-6,1,-1,0,1,-8,-6,1,-1,3,3,4,0,0,0,13,12,1,-4,-6,2,0,11,-8,3,7,-2,0,7,-8,6,6,0,0,4,0,-3,1,-2,2,0,-2,-5,2,-1,1,-2,-3,-3,1,0,1,2,1,-2,1,-1,39,19,20,34,13,21,-4,25,7,9,2,-1,-3,6,10,5,-1,1,-1,19,-3,4,3,-2,3,14,8,7,2,0,1,4,5,3,0,0,2,10,3,4,2,0,6,-3,9,10,-2,12,9,0,-4,3,-4,0,5,-2,-3,-2,-1,-2,4,2,-1,5,-3,2,4,2,2,3,-2,0,2,0,-2,-2,-1,0,2,2,4,5,-1,0,3,8,-5,14,2,12,0,6,12,-11,-1,-3,0,6,10,-7,0,-1,0,0,2,-4,-1,-2,3,8,6,-1,-2,-1,2,4,2,-3,-2,-1,1,4,4,2,0,0,-25,-18,-7,-25,-18,-7,-10,3,-7,-13,-1,1,-10,4,-2,-11,-1,1,0,-1,-5,-2,0,0,-11,2,-4,-10,-3,0,-7,3,-1,-11,-2,0,-4,-1,-3,1,-1,0,4,-5,9,27,10,17,3,12,-12,6,0,-3,-1,7,-7,0,-2,-1,4,5,-5,6,2,-2,5,13,5,5,0,-1,1,6,2,3,-1,-1,4,7,3,2,1,0,19,7,12,6,-5,11,6,13,4,-2,-3,0,3,4,1,-1,-1,0,3,9,3,-1,-2,0,2,5,6,-7,0,0,2,2,1,-9,-1,0,0,3,5,2,1,0,4,5,-1,14,2,12,5,1,-6,9,-2,-3,2,1,-3,8,-2,-1,3,0,-3,1,0,-2,5,4,4,2,-2,1,2,1,0,1,-2,0,3,3,4,1,0,1,-3,-2,-1,12,14,-2,-6,8,-4,2,0,-3,-5,2,-3,4,0,0,-1,6,-1,-2,0,-3,-1,9,2,1,0,0,0,5,4,3,1,0,-1,4,-2,-2,-1,0
25,25203,"Seu d'Urgell, La",10733,90,61,29,24,14,10,7,39,39,6,-1,4,1,32,14,5,1,7,6,7,25,1,-2,-3,2,2,8,6,2,4,1,2,3,4,2,2,1,0,5,2,0,2,130,69,61,32,17,15,14,47,12,28,15,12,16,19,9,10,6,5,-2,28,3,18,9,7,15,0,6,4,5,1,8,0,4,2,1,1,7,0,2,2,4,0,132,50,82,6,8,-2,8,50,37,18,10,10,10,9,15,6,3,5,-2,41,22,12,7,5,8,-5,-2,-2,6,1,8,1,-4,-1,2,2,0,-6,2,-1,4,-1,135,80,55,3,7,-4,8,39,43,8,-4,33,-3,25,44,7,-8,9,11,14,-1,1,4,24,8,-8,-5,5,2,0,1,-2,4,1,2,0,7,-6,-9,4,0,0,350,163,187,270,142,128,49,71,87,84,24,34,31,26,34,51,8,12,18,45,53,33,16,22,53,55,80,50,22,8,26,30,39,30,11,4,27,25,41,20,11,4,241,148,93,353,195,158,43,61,74,25,10,24,28,42,45,17,2,12,15,19,29,8,8,12,75,84,86,74,15,14,44,42,48,41,9,7,31,42,38,33,6,7,245,136,109,361,189,172,34,97,38,38,22,15,13,60,21,16,18,7,21,37,17,22,4,8,78,88,89,67,30,4,34,44,52,38,16,2,44,44,37,29,14,2,285,146,139,384,203,181,50,69,56,63,26,17,22,26,29,45,17,7,28,43,27,18,9,10,90,79,102,76,26,9,46,44,50,49,10,3,44,35,52,27,16,6,76,27,49,136,57,79,11,42,7,11,0,6,-2,19,1,11,0,-1,13,23,6,0,0,7,38,42,36,25,2,-8,19,14,14,14,2,-5,19,28,22,11,0,-3,28,-15,43,29,19,10,22,36,-27,-27,6,12,18,17,-29,-25,0,3,4,19,2,-2,6,9,14,19,-11,-1,5,2,11,8,-4,-2,5,0,3,11,-7,1,0,2,-41,-32,-9,-41,-15,-26,-8,-23,-22,-16,-8,32,-9,-9,-23,-6,-2,16,1,-14,1,-10,-6,16,-11,7,-21,-17,-6,8,-3,2,-6,-5,-2,0,-8,5,-15,-12,-4,8,-431,-255,-176,-391,-238,-153,-79,-30,-137,-112,-64,-13,-46,-13,-85,-70,-41,-3,-33,-17,-52,-42,-23,-10,-45,-33,-122,-117,-54,-21,-25,-12,-79,-80,-38,-5,-20,-21,-43,-37,-16,-16,-17,-12,-5,-77,-61,-16,-7,20,-27,-19,-12,14,-5,9,-29,2,-5,6,-2,11,2,-21,-7,8,-14,11,-28,-33,-7,-6,-14,3,-15,-26,-7,-3,0,8,-13,-7,0,-3,-77,-89,12,-166,-115,-51,-24,27,-35,-64,-6,13,-11,5,-32,-43,-20,3,-13,22,-3,-21,14,10,-23,5,-57,-68,-19,-3,-19,-2,-36,-36,-20,-2,-4,7,-21,-32,1,-1,-88,-36,-52,-24,-12,-12,7,2,-31,-40,-18,-11,6,5,-4,-25,-10,-7,1,-3,-27,-15,-8,-4,10,6,-23,-10,-10,2,5,4,-8,-6,-9,1,5,2,-15,-4,-1,1,-4,-1,-3,-23,-8,-15,-7,1,-29,0,12,17,0,-1,-11,-3,7,7,-7,2,-18,3,5,10,-6,5,-20,-5,4,-2,-1,1,-4,-5,1,0,-5,4,-16,0,3,-2,-121,-42,-79,-98,-65,-33,-10,0,-45,-47,-33,9,-2,2,-4,-24,-19,3,-8,-2,-41,-23,-14,6,3,6,-34,-46,-26,-3,-1,-1,-14,-31,-17,0,4,7,-20,-15,-9,-3,96,69,27,60,41,19,16,35,23,-6,9,17,14,32,19,-8,4,4,2,3,4,2,5,13,10,28,17,-1,3,1,5,27,12,-6,2,-1,5,1,5,5,1,2
25,25207,Solsona,7211,159,99,60,104,71,33,23,36,36,40,9,14,10,28,23,28,2,6,13,8,13,12,7,8,19,33,29,16,4,1,8,23,22,13,3,0,11,10,7,3,1,1,169,109,60,130,87,43,33,28,47,29,15,19,18,18,35,21,10,7,15,10,12,8,5,12,22,30,44,26,8,0,12,16,34,21,4,0,10,14,10,5,4,0,274,165,109,146,97,49,51,59,89,33,11,25,30,38,58,22,6,8,21,21,31,11,5,17,29,38,44,29,4,0,17,25,29,21,3,1,12,13,15,8,1,-1,293,153,140,169,90,79,51,72,87,31,18,23,34,30,49,18,9,7,17,42,38,13,9,16,45,48,41,22,7,3,24,23,26,13,2,0,21,25,15,9,5,3,396,243,153,216,125,91,75,97,122,70,15,14,36,59,98,40,0,7,39,38,24,30,15,7,47,49,74,37,5,1,25,23,55,19,0,1,22,26,19,18,5,0,263,161,102,274,158,116,47,61,90,38,21,4,26,33,54,32,7,8,21,28,36,6,14,-4,65,72,73,43,15,4,32,43,45,30,6,2,33,29,28,13,9,2,221,114,107,226,136,90,41,80,44,13,24,15,13,41,33,7,12,5,28,39,11,6,12,10,50,67,69,23,8,4,26,40,48,16,1,1,24,27,21,7,7,3,252,125,127,271,135,136,58,67,38,60,25,4,25,39,17,30,7,5,33,28,21,30,18,-1,51,77,68,55,16,2,21,35,37,33,7,1,30,42,31,22,9,1,-39,-29,-10,26,3,23,-24,28,-8,-28,-12,-1,-6,13,-7,-25,-6,-2,-18,15,-1,-3,-6,1,5,31,9,-11,-4,-7,2,14,1,-13,-2,-2,3,17,8,2,-2,-5,-86,-61,-25,-23,-28,5,-16,2,-43,-28,-13,16,-8,-5,-32,-21,0,5,-8,7,-11,-7,-13,11,0,14,-13,-10,-12,-1,5,2,-18,-10,-5,-2,-5,12,5,0,-7,1,18,-32,50,49,-1,50,12,15,-32,8,7,8,3,-1,-24,-11,-1,4,9,16,-8,19,8,4,9,30,2,5,2,0,3,8,-6,-5,-1,0,6,22,8,10,3,0,-108,-67,-41,-46,-39,-7,-33,-33,-25,-30,1,15,-18,-16,-19,-14,1,2,-15,-17,-6,-16,0,13,0,-5,-29,-11,-6,3,-3,-5,-19,-9,-4,0,3,0,-10,-2,-2,3,-11,-3,-8,0,-5,5,-29,4,15,-10,2,9,-16,-3,15,-7,4,5,-13,7,0,-3,-2,4,-14,8,13,-6,-1,0,-10,0,9,-5,1,0,-4,8,4,-1,-2,0,-77,-28,-49,-116,-71,-45,-29,-2,-23,-37,10,0,-16,-5,-4,-17,5,5,-13,3,-19,-20,5,-5,-19,-21,-30,-46,-3,-1,-12,-8,-19,-34,-2,1,-7,-13,-11,-12,-1,-2,-32,-9,-23,-45,-10,-35,-4,18,-16,-8,-8,-13,6,5,-4,-8,-7,-2,-10,13,-12,0,-1,-11,-16,4,-17,-10,-6,0,-7,3,-1,-3,-2,0,-9,1,-16,-7,-4,0,-23,-30,7,-80,-41,-39,-21,2,-3,12,-15,-1,-21,-4,-11,13,-9,1,0,6,8,-1,-6,-2,-14,-2,-29,-19,-12,-8,-9,2,-14,-12,-6,-4,-5,-4,-15,-7,-6,-4,36,8,28,22,13,9,-35,19,36,-6,-3,20,-16,15,17,-14,-3,7,-19,4,19,8,0,13,-9,14,14,-1,-1,2,-3,6,11,-5,0,2,-6,8,3,4,-1,0,68,44,24,70,37,33,18,10,16,-4,4,26,14,18,-3,-7,7,16,4,-8,19,3,-3,10,6,19,21,9,8,6,4,17,8,3,1,3,2,2,13,6,7,3
25,25209,Sort,1755,47,29,18,17,9,8,1,18,19,8,-5,4,1,14,11,4,-4,1,0,4,8,4,-1,3,1,4,9,1,1,1,1,2,4,1,1,0,0,2,5,0,0,1,67,33,34,39,19,20,15,18,9,12,5,5,5,5,7,10,1,4,10,13,2,2,4,1,14,10,6,6,0,1,7,4,3,3,0,1,7,6,3,3,0,0,52,39,13,46,28,18,5,23,22,1,-2,0,5,11,19,4,-1,-1,0,12,3,-3,-1,1,10,14,17,6,-1,0,8,6,10,5,0,-1,2,8,7,1,-1,1,100,53,47,40,20,20,14,8,28,29,11,13,3,8,12,17,8,5,11,0,16,12,3,8,2,9,14,7,3,5,1,5,6,4,1,3,1,4,8,3,2,2,90,50,40,47,29,18,8,28,34,11,7,-1,3,14,21,5,4,-1,5,14,13,6,3,0,9,17,17,3,1,0,5,11,10,2,1,0,4,6,7,1,0,0,116,67,49,92,50,42,29,23,33,24,5,-1,24,11,19,12,0,0,5,12,14,12,5,-1,19,12,40,14,4,1,13,5,19,11,1,0,6,7,21,3,3,1,61,30,31,72,34,38,2,31,23,11,-8,-1,-2,15,11,7,-4,1,4,16,12,4,-4,-2,14,18,26,12,1,1,5,8,13,7,0,1,9,10,13,5,1,0,87,32,55,87,47,40,20,23,17,22,10,-8,6,11,7,8,2,-4,14,12,10,14,8,-4,14,19,29,16,6,0,5,10,20,7,3,0,9,9,9,9,3,0,-12,-9,-3,17,11,6,-6,6,-2,-11,-2,2,-7,0,9,-6,-4,1,1,6,-11,-5,2,1,5,11,5,-4,0,0,2,4,6,0,-1,0,3,7,-1,-4,1,0,-5,-14,9,-2,-7,5,11,16,-9,-23,5,-4,7,4,-6,-17,1,-3,4,12,-3,-6,4,-1,7,5,-8,-7,1,0,5,0,-6,-4,-2,0,2,5,-2,-3,3,0,-22,-8,-14,-39,-24,-15,-10,10,-12,-8,-4,1,0,3,-2,-3,-6,0,-10,7,-10,-5,2,1,-10,-1,-11,-12,-3,-2,-2,0,-10,-7,-4,-1,-8,-1,-1,-5,1,-1,-29,-22,-7,9,3,6,-16,-7,-3,-10,6,3,-9,-6,-2,-8,1,3,-7,-1,-1,-2,5,0,1,2,0,0,6,0,1,0,1,-1,2,0,0,2,-1,1,4,0,-33,-22,-11,10,-1,11,-9,4,-13,-6,-2,-8,-4,0,-9,-3,-1,-5,-5,4,-4,-3,-1,-3,3,5,-1,1,2,-1,1,-1,-1,-1,1,0,2,6,0,2,1,-1,-40,-31,-9,-60,-37,-23,1,6,-32,-7,-8,2,-3,6,-17,-11,-6,0,4,0,-15,4,-2,2,-8,-3,-29,-11,-8,-2,-7,-1,-16,-8,-5,-1,-1,-2,-13,-3,-3,-1,-31,-21,-10,-20,-10,-10,-6,6,-12,-14,-1,-3,-4,3,-9,-9,-1,0,-2,3,-3,-5,0,-3,-9,2,-5,-11,1,2,-2,1,-2,-9,1,1,-7,1,-3,-2,0,1,-59,-22,-37,-31,-10,-21,-3,-17,-14,-15,-6,-4,0,-6,-7,-6,-2,-1,-3,-11,-7,-9,-4,-3,-2,-10,-4,-5,-6,-4,0,-3,-2,-2,-1,-2,-2,-7,-2,-3,-5,-2,6,1,5,8,-1,9,-3,3,6,-5,8,-1,0,-1,1,-2,2,1,-3,4,5,-3,6,-2,2,-3,3,2,3,0,2,-2,0,-1,0,0,0,-1,3,3,3,0,43,20,23,12,11,1,8,17,2,3,2,8,7,9,0,-3,1,4,1,8,2,6,1,4,3,11,-1,-4,-1,2,1,9,2,-3,-1,2,2,2,-3,-1,0,0
25,25210,Soses,1531,5,1,4,18,10,8,3,-2,4,-7,5,2,0,0,3,-5,3,0,3,-2,1,-2,2,2,4,3,11,0,0,0,2,1,7,0,0,0,2,2,4,0,0,0,24,13,11,26,15,11,8,7,7,5,-1,-3,4,5,4,2,-1,-2,4,2,3,3,0,-1,6,6,9,4,0,0,3,2,7,2,0,0,3,4,2,2,0,0,27,26,1,36,23,13,11,6,2,7,-2,2,8,8,3,6,0,1,3,-2,-1,1,-2,1,10,9,10,5,0,1,5,5,7,5,0,1,5,4,3,0,0,0,36,27,9,45,21,24,13,5,14,2,4,-2,9,4,8,4,2,1,4,1,6,-2,2,-3,18,9,15,1,0,1,9,3,8,1,0,0,9,6,7,0,0,1,61,48,13,59,43,16,9,6,25,15,6,-2,5,9,20,10,5,-2,4,-3,5,5,1,0,7,13,24,9,4,1,4,11,17,7,3,0,3,2,7,2,1,1,9,6,3,41,34,7,-1,6,0,-2,6,0,0,4,3,-5,5,-1,-1,2,-3,3,1,1,2,11,18,8,2,0,1,9,16,7,1,0,1,2,2,1,1,0,51,14,37,35,11,24,23,15,9,14,-5,-4,11,2,4,7,-4,-5,12,13,5,7,-1,1,12,7,9,8,0,-1,5,1,2,4,0,-1,7,6,7,4,0,0,-23,-15,-8,26,10,16,-19,-3,5,-1,-4,1,-13,-3,3,-2,-2,4,-6,0,2,1,-2,-3,5,5,14,3,0,-1,2,1,7,0,0,0,3,4,7,3,0,-1,35,11,24,32,15,17,14,7,5,9,1,0,6,2,-1,2,3,0,8,5,6,7,-2,0,11,9,7,5,0,0,5,4,4,2,0,0,6,5,3,3,0,0,34,14,20,15,8,7,10,6,12,6,-4,2,2,2,3,7,-3,2,8,4,9,-1,-1,0,2,3,8,4,-2,0,1,1,4,3,-1,0,1,2,4,1,-1,0,-2,-11,9,14,0,14,3,1,-5,-1,0,0,0,-2,-2,-4,0,-3,3,3,-3,3,0,3,2,5,8,-1,0,0,2,0,2,-3,-1,0,0,5,6,2,1,0,5,8,-3,20,10,10,-7,8,1,6,-3,0,-2,7,1,5,-3,0,-5,1,0,1,0,0,1,5,10,7,-3,0,1,3,5,4,-3,0,0,2,5,3,0,0,-20,-8,-12,4,-1,5,-2,-3,-3,-7,-3,-3,-2,1,-1,-5,-2,0,0,-4,-2,-2,-1,-3,3,2,-1,1,-1,0,0,2,-1,-1,-1,0,3,0,0,2,0,0,-4,2,-6,8,7,1,-3,3,-10,3,2,2,0,3,-4,1,1,2,-3,0,-6,2,1,0,2,1,-1,6,0,0,3,0,1,2,1,0,-1,1,-2,4,-1,0,-36,-23,-13,-5,0,-5,-5,-2,-16,-12,1,-3,-4,-1,-14,-5,1,0,-1,-1,-2,-7,0,-3,-3,2,-3,-2,0,1,-2,3,-3,0,1,1,-1,-1,0,-2,-1,0,-24,-15,-9,1,0,1,-6,0,-5,-9,2,-6,-3,0,-5,-7,1,-1,-3,0,0,-2,1,-5,2,2,-3,-2,2,0,2,1,-2,-1,0,0,0,1,-1,-1,2,0,12,11,1,22,17,5,3,8,-2,4,-4,2,0,8,1,2,-2,1,3,0,-3,2,-2,1,6,9,3,4,0,0,3,7,2,4,1,0,3,2,1,0,-1,0,43,36,7,46,35,11,12,-3,16,16,2,2,8,-2,11,19,0,1,4,-1,5,-3,2,1,9,4,15,14,4,0,5,3,13,13,1,0,4,1,2,1,3,0
25,25217,Tàrrega,12259,156,127,29,172,105,67,2,48,59,36,10,0,11,32,42,31,8,3,-9,16,17,5,2,-3,30,41,65,33,1,0,12,28,42,21,1,0,18,13,23,12,0,0,404,226,178,321,182,139,62,68,146,98,17,6,20,41,86,55,10,5,42,27,60,43,7,1,61,66,102,69,12,3,25,40,62,42,5,1,36,26,40,27,7,2,328,215,113,282,169,113,48,91,134,54,4,-5,27,60,84,50,-4,-3,21,31,50,4,8,-2,44,76,86,61,8,5,24,43,51,44,4,2,20,33,35,17,4,3,440,264,176,282,179,103,81,97,119,84,27,19,43,49,87,65,13,5,38,48,32,19,14,14,48,55,92,77,9,0,28,32,61,52,6,0,20,23,31,25,3,0,572,340,232,370,229,141,135,106,165,102,44,16,82,49,116,65,19,6,53,57,49,37,25,10,73,85,116,72,19,5,45,45,74,52,9,3,28,40,42,20,10,2,463,270,193,310,184,126,119,126,148,40,27,-4,63,85,97,-1,24,-1,56,41,51,41,3,-3,70,72,112,41,7,2,41,46,68,19,8,0,29,26,44,22,-1,2,484,224,260,385,189,196,92,138,129,48,45,22,50,67,58,15,19,8,42,71,71,33,26,14,98,101,112,53,14,5,56,41,59,25,6,1,42,60,53,28,8,4,421,224,197,353,189,164,62,159,96,87,11,2,56,74,44,41,6,-4,6,85,52,46,5,6,69,132,86,58,-1,4,51,61,51,23,-2,2,18,71,35,35,1,2,199,94,105,196,89,107,50,82,28,12,16,2,18,33,24,-2,9,9,32,49,4,14,7,-7,43,95,40,12,7,-4,20,42,18,3,4,1,23,53,22,9,3,-5,230,131,99,247,125,122,52,68,61,33,2,12,29,43,44,10,-7,10,23,25,17,23,9,2,58,74,61,37,12,4,34,40,29,16,5,0,24,34,32,21,7,4,-147,-111,-36,-58,-44,-14,6,-20,-62,-40,-7,-27,-10,-5,-52,-26,-7,-13,16,-15,-10,-14,0,-14,11,-1,-37,-21,1,-11,12,5,-38,-15,-2,-5,-1,-6,1,-6,3,-6,-445,-249,-196,-306,-200,-106,-48,-39,-191,-96,-56,-17,-7,-31,-126,-55,-22,-7,-41,-8,-65,-41,-34,-10,-39,-16,-112,-91,-42,-9,-14,-24,-84,-60,-19,-1,-25,8,-28,-31,-23,-8,25,19,6,19,6,13,-32,39,12,-6,2,7,-13,21,6,-2,7,-1,-19,18,6,-4,-5,8,-1,15,12,-4,-4,3,4,6,5,-6,-2,0,-5,9,7,2,-2,3,-112,-85,-27,-114,-74,-40,4,-4,-78,-28,-16,6,13,-15,-43,-33,-16,5,-9,11,-35,5,0,1,0,-2,-64,-31,-19,-1,7,-8,-35,-26,-13,-1,-7,6,-29,-5,-6,0,-174,-114,-60,-148,-106,-42,-59,22,-40,-55,-35,-1,-24,6,-19,-43,-24,-7,-35,16,-21,-12,-11,6,-27,11,-47,-53,-32,0,-11,2,-30,-42,-23,-1,-16,9,-17,-11,-9,1,49,31,18,-54,-42,-12,-1,15,19,21,-5,-2,-1,4,2,37,-8,1,0,11,17,-16,3,-3,-23,12,-19,-10,-14,0,-13,2,-14,-4,-11,-2,-10,10,-5,-6,-3,2,153,49,104,-32,-56,24,78,31,31,17,-20,8,26,11,18,-3,-13,6,52,20,13,20,-7,2,2,16,-11,-24,-22,2,-8,2,-17,-22,-15,1,10,14,6,-2,-7,1,212,106,106,90,41,49,51,50,79,15,12,0,20,20,34,19,8,-1,31,30,45,-4,4,1,28,44,15,-2,5,-2,12,16,11,-4,4,1,16,28,4,2,1,-3
25,25223,Torà,1168,21,11,10,4,2,2,3,4,8,-2,2,6,0,3,5,0,0,3,3,1,3,-2,2,3,1,0,2,1,0,0,0,0,1,1,0,0,1,0,1,0,0,0,45,33,12,55,35,20,3,13,19,5,3,2,5,5,16,5,2,0,-2,8,3,0,1,2,8,13,22,11,0,1,6,6,16,7,0,0,2,7,6,4,0,1,4,1,3,33,20,13,1,-7,6,0,4,3,-4,1,3,-2,2,3,5,-8,3,2,2,0,7,9,14,3,0,0,3,6,10,1,0,0,4,3,4,2,0,0,12,10,2,32,19,13,2,1,11,-3,2,-2,3,2,4,1,0,0,-1,-1,7,-4,2,-2,10,5,10,5,2,0,6,3,4,5,1,0,4,2,6,0,1,0,61,34,27,38,20,18,16,13,17,11,0,2,13,5,8,5,-1,2,3,8,9,6,1,0,9,9,12,7,1,0,7,3,6,3,1,0,2,6,6,4,0,0,44,31,13,28,15,13,5,9,14,6,4,1,1,6,14,6,3,0,4,3,0,0,1,1,3,10,7,3,2,0,1,5,4,3,1,0,2,5,3,0,1,0,25,11,14,31,13,18,1,9,6,7,3,-2,-4,4,6,6,1,-1,5,5,0,1,2,-1,8,13,2,4,2,0,2,7,1,2,1,0,6,6,1,2,1,0,40,28,12,64,38,26,-1,5,15,13,2,6,-1,8,11,5,2,3,0,-3,4,8,0,3,9,18,21,14,1,0,4,12,14,8,0,0,5,6,7,6,1,0,20,7,13,34,12,22,13,6,2,-5,0,4,6,3,0,-4,0,2,7,3,2,-1,0,2,11,9,8,5,1,0,4,5,1,2,0,0,7,4,7,3,1,0,3,-5,8,0,-5,5,0,3,-13,7,5,2,0,3,-13,4,1,1,0,0,0,3,4,1,3,2,-4,-2,1,0,-2,1,-3,-1,0,0,5,1,-1,-1,1,0,-10,-13,3,-15,-12,-3,5,-5,1,-3,-7,-1,0,-2,1,-5,-6,-1,5,-3,0,2,-1,0,-1,-6,-4,-3,-1,0,-2,-3,-4,-3,0,0,1,-3,0,0,-1,0,2,-6,8,3,-1,4,1,1,-9,4,5,1,-1,-1,-4,-2,3,-1,2,2,-5,6,2,2,-1,2,0,1,3,-2,-2,0,0,0,2,-1,1,2,0,1,1,-1,-30,-21,-9,-5,-3,-2,-5,-7,-12,-10,5,-1,-3,-5,-9,-5,3,-2,-2,-2,-3,-5,2,1,-1,0,-2,-2,0,0,0,0,-2,-1,0,0,-1,0,0,-1,0,0,-37,-23,-14,-3,-2,-1,-7,-3,-13,-8,-3,-2,-4,-1,-9,-7,0,-1,-3,-2,-4,-1,-3,-1,1,0,-1,-1,-2,0,1,0,-1,-1,-1,0,0,0,0,0,-1,0,15,9,6,5,3,2,4,4,-3,8,3,-2,5,1,-1,3,2,-1,-1,3,-2,5,1,-1,2,2,0,1,1,-1,2,0,1,0,1,-1,0,2,-1,1,0,0,-12,-5,-7,4,1,3,-3,-3,-7,-7,1,9,-2,1,-1,-5,1,2,-1,-4,-6,-2,0,7,0,0,3,0,1,0,0,0,1,0,0,0,0,0,2,0,1,0,14,10,4,11,5,6,5,3,10,0,-1,-2,4,-1,9,-3,2,-1,1,4,1,3,-3,-1,5,5,2,1,-3,1,2,2,2,0,-1,0,3,3,0,1,-2,1,28,14,14,10,5,5,12,10,8,2,-6,2,4,5,7,1,-4,1,8,5,1,1,-2,1,2,4,2,1,0,0,0,4,1,0,0,0,2,0,1,1,0,0
25,25239,"Valls de Valira, Les",751,24,13,11,19,11,8,7,8,3,6,-1,0,1,6,3,3,-1,0,6,2,0,3,0,0,6,4,6,3,0,0,1,4,4,2,0,0,5,0,2,1,0,0,23,8,15,18,5,13,7,5,8,-1,2,1,4,-2,5,-2,3,0,3,7,3,1,-1,1,6,3,7,0,1,0,2,1,1,0,1,0,4,2,6,0,0,0,10,3,7,5,4,1,1,3,2,4,0,-1,-1,1,0,3,0,0,2,2,2,1,0,-1,0,1,1,3,-1,0,0,0,1,3,0,0,0,1,0,0,-1,0,24,11,13,13,7,6,3,4,10,9,-1,-1,3,4,2,3,-1,0,0,0,8,6,0,-1,1,2,5,4,1,0,0,2,3,2,0,0,1,0,2,2,1,0,24,19,5,20,14,6,0,-1,13,14,0,-3,1,0,6,13,2,-3,-1,-1,7,1,-2,0,-1,4,8,9,0,-1,-1,3,5,8,0,-1,0,1,3,1,0,0,-47,-24,-23,-2,0,-2,-10,-3,-15,-11,-4,-4,-7,-1,-6,-6,-2,-2,-3,-2,-9,-5,-2,-2,-1,2,1,-3,-1,0,-1,1,1,-1,0,0,0,1,0,-2,-1,0,65,44,21,56,33,23,14,17,27,9,3,-4,12,8,15,9,3,-2,2,9,12,0,0,-2,8,18,15,11,5,-1,6,9,9,5,5,-1,2,9,6,6,0,0,1,2,-1,16,12,4,-5,0,6,6,-1,-4,-4,3,7,-3,1,-2,-1,-3,-1,9,-2,-2,1,3,7,5,1,-1,0,3,4,4,1,0,1,0,3,1,0,-1,0,0,0,40,21,19,-6,12,-5,8,-1,-6,-5,6,3,1,0,-3,-1,6,-8,7,-1,-3,3,14,14,12,2,-5,1,7,8,6,2,-3,2,7,6,6,0,-2,2,-5,7,3,3,0,3,4,10,-5,-4,-4,1,1,4,-3,-4,-3,2,3,6,-2,0,-1,0,2,3,2,0,-3,0,2,1,2,0,-1,0,0,2,0,0,-2,63,30,33,29,15,14,10,9,22,19,0,1,7,0,12,10,1,-1,3,9,10,9,-1,2,5,3,11,8,3,-2,5,-1,4,5,1,0,0,4,7,3,2,-2,16,8,8,0,-1,1,12,5,6,1,-7,-3,9,0,1,3,-3,-2,3,5,5,-2,-4,-1,0,6,-1,1,-4,-3,0,1,-1,3,-3,-1,0,5,0,-2,-1,-2,25,11,14,18,10,8,0,12,4,10,-3,2,0,5,3,6,-3,0,0,7,1,4,0,2,-3,11,6,4,-1,1,-1,6,3,3,-1,0,-2,5,3,1,0,1,-30,-23,-7,-23,-12,-11,7,1,-5,-12,-19,0,5,0,-5,-7,-13,-2,2,1,0,-5,-6,2,-1,2,-5,-7,-10,-2,2,1,-5,-2,-6,-2,-3,1,0,-5,-4,0,12,7,5,10,4,6,0,1,3,0,9,-2,0,1,-1,3,6,-3,0,0,4,-3,3,1,0,3,2,3,2,0,-1,1,1,3,1,-1,1,2,1,0,1,1,-10,-5,-5,9,3,6,6,-1,-2,-3,-6,-3,1,0,2,-1,-6,-1,5,-1,-4,-2,0,-2,1,2,2,3,0,1,-1,1,2,4,-2,-1,2,1,0,-1,2,2,23,14,9,17,8,9,-5,13,5,9,2,-1,-1,4,3,6,1,1,-4,9,2,3,1,-2,0,7,6,5,-1,0,0,1,3,5,-1,0,0,6,3,0,0,0,23,13,10,17,12,5,7,8,5,3,-1,1,6,4,2,1,0,0,1,4,3,2,-1,1,3,5,4,6,-1,0,2,1,5,5,-1,0,1,4,-1,1,0,0
25,25243,Vielha e Mijaran,4017,15,26,-11,31,10,21,-18,25,20,1,-5,-5,-4,17,20,2,-4,-2,-14,8,0,-1,-1,-3,3,7,18,2,0,1,1,1,6,1,0,1,2,6,12,1,0,0,79,58,21,67,39,28,-8,28,43,14,-1,4,-1,27,26,10,0,-3,-7,1,17,4,-1,7,9,13,28,12,2,3,6,7,16,7,2,1,3,6,12,5,0,2,182,136,46,128,70,58,-6,90,74,9,18,-1,12,55,43,13,12,-2,-18,35,31,-4,6,1,11,43,53,12,8,0,5,22,29,10,3,0,6,21,24,2,5,0,237,120,117,129,66,63,36,78,58,46,15,1,17,35,39,21,2,2,19,43,19,25,13,-1,23,31,39,22,9,1,8,16,23,12,2,1,15,15,16,10,7,0,135,97,38,173,111,62,3,64,70,8,-10,3,9,45,36,10,-3,2,-6,19,34,-2,-7,1,14,57,79,23,-1,0,9,31,51,18,1,0,5,26,28,5,-2,0,172,90,82,213,119,94,-10,77,75,36,-7,-1,-11,25,53,24,-2,-2,1,52,22,12,-5,1,17,78,67,44,4,0,9,38,44,25,0,0,8,40,23,19,4,0,199,130,69,214,122,92,-2,63,96,44,-9,0,-2,38,75,20,-5,-2,0,25,21,24,-4,2,19,70,78,40,4,2,8,37,53,19,2,2,11,33,25,21,2,0,176,117,59,271,154,117,18,79,64,14,0,2,12,46,44,11,4,2,6,33,20,3,-4,0,45,67,107,36,11,6,26,34,60,21,10,4,19,33,47,15,1,2,37,14,23,149,78,71,-5,53,22,-30,-1,5,0,27,6,-16,-3,3,-5,26,16,-14,2,2,28,65,40,8,5,0,18,33,22,1,3,0,10,32,18,7,2,0,-102,-74,-28,-15,-29,14,-23,12,-23,-40,-26,-1,-12,1,-30,-22,-15,2,-11,11,7,-18,-11,-3,8,21,-14,-24,-4,-3,3,2,-18,-13,-2,-2,5,19,4,-11,-2,-1,-41,-31,-10,-10,-29,19,4,8,-30,-19,-8,0,1,5,-21,-11,-4,-3,3,3,-9,-8,-4,3,-1,15,-17,-6,-3,0,-6,5,-15,-7,-4,-3,5,10,-2,1,1,3,-176,-125,-51,-100,-72,-28,-41,-5,-39,-63,-23,1,-23,2,-34,-51,-13,-2,-18,-7,-5,-12,-10,3,-10,0,-47,-38,-5,0,-5,-3,-31,-28,-4,-1,-5,3,-16,-10,-1,1,-16,13,-29,-45,-35,-10,-18,20,-9,-17,-2,6,-4,9,12,-5,-6,2,-14,11,-21,-12,4,4,3,3,-24,-17,-6,-3,1,0,-16,-16,-5,0,2,3,-8,-1,-1,-3,-66,-63,-3,-101,-62,-39,4,2,-40,-16,-15,-3,-6,4,-37,-10,-13,-3,10,-2,-3,-6,-2,0,-2,-7,-52,-26,-12,-3,0,-3,-32,-17,-8,-3,-2,-4,-20,-9,-4,0,-38,-1,-37,-38,-21,-17,-20,23,-18,-9,-18,-2,-1,18,3,-10,-8,-5,-19,5,-21,1,-10,3,-13,6,-14,-16,1,-3,-6,1,-6,-7,-1,-3,-7,5,-8,-9,2,0,-9,-5,-4,25,11,14,-17,13,16,-14,-1,-8,-6,-1,13,-2,-3,-5,-11,14,3,-12,2,-3,5,12,1,-2,6,1,3,2,4,1,0,0,2,10,-3,-3,6,1,40,35,5,-4,-3,-1,-13,33,-5,16,1,3,-6,26,7,4,1,0,-7,7,-12,12,0,3,-6,23,-14,-14,2,5,-3,14,-6,-9,-1,2,-3,9,-8,-5,3,3,-32,-24,-8,23,15,8,-1,13,-20,-1,-20,-3,-7,13,-23,8,-9,-4,6,0,3,-9,-11,1,4,17,-1,1,-1,1,2,15,2,-1,-2,-1,2,2,-3,2,1,2
26,26002,Agoncillo,892,12,7,5,7,4,3,-2,10,4,-3,4,-1,-2,6,2,1,1,-1,0,4,2,-4,3,0,0,3,1,2,1,0,0,2,1,1,0,0,0,1,0,1,1,0,32,18,14,27,17,10,4,16,7,4,-1,1,2,6,5,4,0,0,2,10,2,0,-1,1,5,8,7,5,1,0,4,4,4,4,0,0,1,4,3,1,1,0,17,12,5,33,17,16,3,7,3,3,1,-1,1,3,7,0,1,0,2,4,-4,3,0,-1,10,8,8,6,1,0,3,4,5,4,1,0,7,4,3,2,0,0,23,14,9,27,11,16,5,-4,-1,17,5,0,2,-1,-1,10,4,0,3,-3,0,7,1,0,8,2,5,7,5,0,2,0,3,3,3,0,6,2,2,4,2,0,40,27,13,48,35,13,2,18,8,5,8,0,4,12,8,2,3,-1,-2,6,0,3,5,1,4,15,13,12,4,0,2,8,12,10,3,0,2,7,1,2,1,0,145,97,48,61,50,11,19,29,50,25,13,5,10,17,38,19,9,4,9,12,12,6,4,1,4,9,25,20,2,1,2,6,22,18,2,0,2,3,3,2,0,1,14,7,7,4,-1,5,8,-2,-1,1,10,-1,5,0,-1,0,6,-2,3,-2,0,1,4,1,-1,-2,4,-1,3,1,-2,-2,0,0,3,0,1,0,4,-1,0,1,-7,10,-17,46,29,17,-16,12,-1,2,-1,-4,-10,11,1,7,1,-1,-6,1,-2,-5,-2,-3,8,9,15,11,4,-1,6,6,8,7,2,0,2,3,7,4,2,-1,54,42,12,28,18,10,8,6,19,15,9,-3,6,1,16,8,11,0,2,5,3,7,-2,-3,3,7,11,3,4,0,1,5,8,1,3,0,2,2,3,2,1,0,-97,-78,-19,-78,-69,-9,-12,-8,-29,-30,-16,-2,-11,-5,-18,-28,-17,0,-1,-3,-11,-2,1,-2,-2,-9,-23,-28,-15,-2,-1,-8,-19,-27,-14,-1,-1,-1,-4,-1,-1,-1,63,33,30,18,10,8,17,3,25,20,0,-3,12,3,10,10,-1,-1,5,0,15,10,1,-2,4,2,5,6,-1,0,3,2,2,4,-1,0,1,0,3,2,0,0,3,7,-4,-18,-12,-6,-7,1,11,-5,5,-3,-3,-1,9,-3,5,-1,-4,2,2,-2,0,-2,-4,1,-4,-9,-1,-1,-2,0,-2,-8,0,0,-2,1,-2,-1,-1,-1,13,12,1,-3,-3,0,-7,17,-5,0,1,6,-2,14,-3,-1,-1,3,-5,3,-2,1,2,3,-1,3,-4,-3,1,0,0,2,-4,-2,0,0,-1,1,0,-1,1,0,8,2,6,-2,1,-3,19,4,2,-12,-6,0,12,1,3,-9,-4,0,7,3,-1,-3,-2,0,6,6,-7,-3,-5,0,5,4,-1,-2,-5,0,1,2,-6,-1,0,0,-48,-27,-21,-16,-8,-8,-20,-7,-9,-7,-6,4,-9,-2,-6,-6,-4,2,-11,-5,-3,-1,-2,2,-3,-1,-3,-4,-5,0,0,0,-3,-3,-2,0,-3,-1,0,-1,-3,0,-13,-23,10,-3,-8,5,-10,4,-11,1,1,1,-10,0,-13,1,-1,-1,0,4,2,0,2,2,-5,-1,0,1,3,-1,-6,-2,-1,0,2,-1,1,1,1,1,1,0,-29,-29,0,-4,-8,4,-5,-2,-5,-6,-9,-2,-7,0,-8,-4,-7,-3,2,-2,3,-2,-2,1,2,0,-2,-3,-1,0,0,0,-2,-4,-2,0,2,0,0,1,1,0,40,21,19,17,7,10,4,11,-1,19,4,3,2,3,0,8,5,3,2,8,-1,11,-1,0,2,3,4,1,2,4,0,1,2,0,2,1,2,2,2,1,0,3
26,26006,Alberite,2005,25,21,4,25,16,9,-4,11,4,9,7,-3,-3,9,5,7,3,-1,-1,2,-1,2,4,-2,1,10,9,3,1,0,1,5,6,3,0,0,0,5,3,0,1,0,52,37,15,35,25,10,6,17,15,10,5,-1,9,8,11,6,4,-1,-3,9,4,4,1,0,5,13,11,3,1,2,4,7,10,2,1,1,1,6,1,1,0,1,57,33,24,42,18,24,13,18,4,18,4,0,6,17,-3,10,3,0,7,1,7,8,1,0,5,18,16,2,0,0,2,11,4,1,0,0,3,7,12,1,0,0,60,24,36,38,16,22,20,18,16,7,1,0,7,4,15,0,0,0,13,14,1,7,1,0,11,15,10,1,1,0,3,6,7,0,0,0,8,9,3,1,1,0,39,27,12,34,20,14,8,20,8,-2,4,3,5,13,5,4,2,0,3,7,3,-6,2,3,4,12,10,5,1,2,3,8,5,4,0,0,1,4,5,1,1,2,90,34,56,50,23,27,23,10,29,16,6,2,6,2,14,9,2,1,17,8,15,7,4,1,16,7,14,10,2,0,7,2,6,7,0,0,9,5,8,3,2,0,74,46,28,32,16,16,8,14,40,5,5,3,1,9,25,6,2,4,7,5,15,-1,3,-1,5,10,9,6,1,1,2,4,7,1,1,1,3,6,2,5,0,0,139,69,70,78,42,36,33,37,43,20,-2,2,20,13,23,9,-2,3,13,24,20,11,0,-1,20,22,24,9,2,0,11,10,15,4,1,0,9,12,9,5,1,0,47,17,30,45,20,25,6,16,0,12,6,4,6,7,-4,5,3,1,0,9,4,7,3,3,7,11,18,7,1,1,3,4,11,2,0,0,4,7,7,5,1,1,13,4,9,3,-3,6,-2,-6,0,10,10,0,2,-12,0,5,7,1,-4,6,0,5,3,-1,2,1,-3,0,1,1,1,-1,-6,0,2,0,1,2,3,0,-1,1,-14,-7,-7,-5,1,-6,4,2,-20,4,-1,-3,4,1,-16,3,3,-1,0,1,-4,1,-4,-2,0,6,-5,-5,1,-2,1,2,1,-3,1,-1,-1,4,-6,-2,0,-1,-11,-6,-5,-14,-13,-1,-5,10,-4,-22,8,2,-2,5,4,-20,4,3,-3,5,-8,-2,4,-1,-3,3,-12,-2,0,0,-1,1,-8,-3,-2,0,-2,2,-4,1,2,0,-105,-43,-62,-14,-7,-7,-25,-18,-23,-20,-14,0,-13,-3,-11,-10,-4,1,-12,-15,-12,-10,-10,-1,-2,-1,-5,-5,-1,0,-1,0,-4,-1,-1,0,-1,-1,-1,-4,0,0,-40,-15,-25,-23,-13,-10,-8,-12,-10,-4,-8,-2,-1,-5,-4,-2,-6,0,-7,-7,-6,-2,-2,-2,-9,-3,-5,-4,-2,-1,-4,-2,-3,-4,-1,0,-5,-1,-2,0,-1,-1,-75,-40,-35,-35,-20,-15,-14,-11,-22,-12,-4,-8,-11,-9,-10,-7,2,-4,-3,-2,-12,-5,-6,-4,-3,-3,-10,-16,-2,0,-4,-2,-4,-9,0,0,1,-1,-6,-7,-2,0,-41,-17,-24,-20,-9,-11,-21,1,-4,-17,6,-8,-9,6,-3,-12,3,-3,-12,-5,-1,-5,3,-5,-9,0,-5,-6,1,-1,-4,1,-2,-6,1,1,-5,-1,-3,0,0,-2,-11,-14,3,4,-4,8,-5,5,3,-11,-4,1,-1,1,0,-4,-7,-2,-4,4,3,-7,3,3,-3,5,-2,0,0,4,-3,2,-3,0,-1,1,0,3,1,0,1,3,18,13,5,8,3,5,-6,5,7,3,1,6,-5,5,4,1,3,5,-1,0,3,2,-2,1,-2,4,2,0,4,0,0,2,-1,0,1,1,-2,2,3,0,3,-1
26,26008,Aldeanueva de Ebro,2486,16,8,8,45,31,14,3,0,14,5,-2,-5,2,-2,6,5,-3,-1,1,2,8,0,1,-4,11,10,13,11,0,0,9,6,7,9,0,0,2,4,6,2,0,0,50,35,15,55,37,18,16,10,15,9,1,-2,10,8,9,7,3,-2,6,2,6,2,-2,0,17,15,14,8,1,0,9,11,10,6,1,0,8,4,4,2,0,0,31,20,11,51,33,18,5,9,-4,18,2,2,2,9,-2,11,1,0,3,0,-2,7,1,2,13,11,17,8,1,0,6,9,11,5,1,0,7,2,6,3,0,0,-8,2,-10,22,13,9,-4,2,-11,4,2,-3,-1,0,-4,6,1,-1,-3,2,-7,-2,1,-2,2,10,8,3,-1,0,1,5,5,3,-1,0,1,5,3,0,0,0,-26,-11,-15,32,21,11,-8,4,-2,-13,-2,-2,-5,2,5,-11,0,-1,-3,2,-7,-2,-2,-1,6,7,13,5,1,0,2,5,10,3,1,0,4,2,3,2,0,0,70,48,22,34,23,11,20,26,18,6,0,0,10,24,11,3,1,-2,10,2,7,3,-1,2,9,19,2,4,0,0,4,15,1,3,0,0,5,4,1,1,0,0,86,40,46,73,37,36,30,22,22,4,7,1,14,10,12,0,5,1,16,12,10,4,2,0,26,19,22,4,1,0,13,10,13,0,1,0,13,9,9,4,0,0,36,28,8,81,57,24,4,31,-4,6,3,-2,1,23,-6,10,2,-1,3,8,2,-4,1,-1,12,38,20,8,3,0,7,28,13,6,3,0,5,10,7,2,0,0,35,13,22,68,30,38,14,19,15,-8,1,-2,2,8,9,-5,-1,1,12,11,6,-3,2,-3,23,21,19,3,2,-1,10,9,8,3,1,-1,13,12,11,0,1,0,20,11,9,16,5,11,8,9,6,-5,3,-2,9,4,1,-3,2,-1,-1,5,5,-2,1,-1,7,4,4,-1,2,0,3,1,0,0,1,0,4,3,4,-1,1,0,-15,-14,-1,6,0,6,-8,-1,2,-7,1,-3,-7,-1,2,-7,-3,0,-1,0,0,0,4,-3,0,1,2,-1,1,0,-2,1,1,-1,-1,0,2,0,1,0,2,0,0,-16,16,5,-8,13,6,-4,10,-5,-2,-4,-1,-10,5,-9,1,-1,7,6,5,4,-3,-3,8,-1,3,-5,0,0,4,-8,3,-8,1,0,4,7,0,3,-1,0,-4,-4,0,7,1,6,4,9,-9,-1,-4,-3,4,3,-7,-1,-1,-2,0,6,-2,0,-3,-1,1,8,2,-2,-2,0,0,2,3,-3,-1,0,1,6,-1,1,-1,0,-7,-12,5,13,6,7,1,-4,-3,1,0,-1,-1,-3,-5,0,-2,0,2,-1,2,1,2,-1,2,4,1,9,-3,0,1,1,1,5,-2,0,1,3,0,4,-1,0,-20,-9,-11,5,0,5,-4,5,-14,-10,1,-1,-1,4,-3,-7,0,-2,-3,1,-11,-3,1,1,-1,4,-1,-4,3,1,-2,1,2,-3,1,0,1,3,-3,-1,2,1,-26,-1,-25,18,14,4,-25,11,-4,-9,0,1,-12,9,-1,-2,2,1,-13,2,-3,-7,-2,0,0,14,1,1,0,1,2,7,1,2,0,1,-2,7,0,-1,0,0,-3,1,-4,39,23,16,-1,20,-16,-8,5,2,2,14,-12,-2,2,1,-3,6,-4,-6,3,1,7,20,5,5,2,0,4,12,2,4,1,0,3,8,3,1,1,0,2,7,-5,25,17,8,-5,7,0,4,-2,-4,-6,8,5,2,-1,-2,1,-1,-5,2,-1,-2,1,15,5,1,0,0,-1,10,8,0,-1,0,2,5,-3,1,1,0
26,26011,Alfaro,9124,210,154,56,184,135,49,18,61,94,18,7,9,13,42,75,17,2,5,5,19,19,1,5,4,14,57,80,22,5,3,9,40,65,16,3,0,5,17,15,6,2,3,77,48,29,109,56,53,21,14,22,21,-4,2,14,11,12,11,-3,1,7,3,10,10,-1,1,19,30,37,17,3,2,10,17,19,8,1,0,9,13,18,9,2,2,35,37,-2,121,70,51,26,24,-9,-3,2,-5,8,21,2,5,2,-1,18,3,-11,-8,0,-4,47,39,22,11,0,1,21,26,11,10,0,1,26,13,11,1,0,0,77,43,34,95,57,38,39,21,24,2,1,-13,24,7,17,-2,-1,-4,15,14,7,4,2,-9,28,30,25,3,6,1,19,12,21,2,1,1,9,18,4,1,5,0,76,66,10,91,57,34,15,30,31,2,6,-10,8,21,27,0,5,2,7,9,4,2,1,-12,17,30,31,10,1,1,11,17,20,6,1,0,6,13,11,4,0,1,-12,10,-22,57,35,22,1,0,-12,-12,5,1,4,8,-3,-5,3,2,-3,-8,-9,-7,2,-1,12,13,18,6,5,1,5,8,14,5,3,0,7,5,4,1,2,1,153,121,32,131,77,54,54,23,58,24,3,-11,35,14,45,27,-1,-2,19,9,13,-3,4,-9,21,37,48,21,2,0,9,20,33,12,1,0,12,17,15,9,1,0,212,125,87,127,70,57,52,20,79,41,17,3,20,16,58,19,9,5,32,4,21,22,8,-2,30,22,34,27,6,6,20,11,19,13,2,3,10,11,15,14,4,3,79,61,18,61,31,30,15,38,22,6,-3,-2,14,21,21,5,-1,-1,1,17,1,1,-2,-1,8,32,5,17,-5,3,7,13,1,9,-2,2,1,19,4,8,-3,1,12,-12,24,80,29,51,10,15,-13,-8,3,6,1,8,-6,-20,1,3,9,7,-7,12,2,3,22,23,22,9,4,1,7,9,10,4,-1,0,15,14,12,5,5,1,-19,-1,-18,-6,-10,4,15,8,-38,2,-2,-5,7,3,-17,4,1,1,8,5,-21,-2,-3,-6,5,7,-12,-5,0,-2,-2,3,-8,-4,2,-1,7,4,-4,-1,-2,-1,18,10,8,29,16,13,14,9,12,-4,-3,-11,5,1,9,0,-4,-1,9,8,3,-4,1,-10,9,9,17,0,-4,-2,5,4,13,-3,-2,-1,4,5,4,3,-2,-1,-61,-36,-25,-42,-32,-10,-10,-20,-8,-7,-8,-9,-10,-11,-2,-6,-1,-5,0,-9,-6,-1,-7,-4,-7,-11,-13,-8,-2,-2,-5,-7,-10,-7,-2,-1,-2,-4,-3,-1,0,-1,-125,-71,-54,-66,-44,-22,-19,-12,-45,-26,-16,-4,-7,-10,-28,-14,-12,-3,-12,-2,-17,-12,-4,-1,-15,1,-22,-20,-11,1,-9,0,-16,-13,-8,1,-6,1,-6,-7,-3,0,-119,-58,-61,-55,-27,-28,-18,-33,-23,-34,-11,-2,-6,-12,-14,-22,-7,2,-12,-21,-9,-12,-4,-4,-15,-9,-8,-20,-2,-1,-6,-2,-6,-13,0,0,-9,-7,-2,-7,-2,-1,-7,-9,2,33,13,20,-5,2,-5,-12,-1,8,-5,-6,6,-11,2,3,0,8,-11,-1,-3,5,5,10,9,3,0,0,2,3,8,-1,0,-1,3,7,1,4,0,1,2,-10,12,28,-2,30,2,-7,12,0,3,-10,-6,-8,5,1,0,-1,8,1,7,-1,3,-9,1,10,10,4,1,-1,-6,3,4,-2,0,-1,7,7,6,6,1,0,3,12,-9,25,17,8,-3,7,9,-15,7,-1,5,6,-4,-2,7,2,-8,1,13,-13,0,-3,7,15,13,-8,0,-2,8,9,2,-1,-1,0,-1,6,11,-7,1,-2
26,26018,Arnedo,12796,215,129,86,246,136,110,27,62,90,47,-3,-8,18,33,68,16,0,-6,9,29,22,31,-3,-2,29,64,93,55,3,2,14,34,59,25,3,1,15,30,34,30,0,1,334,183,151,358,202,156,77,78,96,68,13,-2,41,39,55,45,4,-1,36,39,41,23,9,-1,61,88,109,76,18,2,30,51,61,51,7,1,31,37,48,25,11,1,170,98,72,267,154,113,36,54,28,30,12,7,16,34,21,14,12,2,20,20,7,16,0,5,58,79,60,53,13,2,31,49,33,30,11,0,27,30,27,23,2,2,277,167,110,228,123,105,72,83,79,38,15,-11,34,48,65,18,6,-3,38,35,14,20,9,-8,50,52,74,36,12,3,26,26,46,18,5,1,24,26,28,18,7,2,120,82,38,180,109,71,7,53,27,35,1,-6,6,30,21,26,-1,-1,1,23,6,9,2,-5,21,54,58,36,7,3,14,29,40,21,2,2,7,25,18,15,5,1,93,71,22,178,106,72,18,29,30,8,9,-2,11,19,25,11,5,1,7,10,5,-3,4,-3,28,55,56,24,12,2,17,32,33,15,7,2,11,23,23,9,5,0,98,58,40,207,106,101,21,13,40,32,-3,-6,6,17,28,12,-5,0,15,-4,12,20,2,-6,36,44,73,41,11,-1,20,21,42,18,2,1,16,23,31,23,9,-2,169,49,120,242,100,142,73,60,1,15,8,11,23,25,0,1,-1,3,50,35,1,14,9,8,70,79,38,39,10,5,20,42,18,18,2,0,50,37,20,21,8,5,120,67,53,164,76,88,20,43,36,2,-3,18,12,23,22,5,-7,7,8,20,14,-3,4,11,31,54,44,20,2,7,19,24,16,12,-2,3,12,30,28,8,4,4,-81,-59,-22,-22,-33,11,8,6,-55,-36,-8,-2,3,-14,-30,-23,-2,2,5,20,-25,-13,-6,-4,3,7,-11,-26,2,-4,0,-6,-12,-22,2,0,3,13,1,-4,0,-4,5,-22,27,37,-9,46,17,10,0,-28,-3,6,4,2,-10,-24,1,4,13,8,10,-4,-4,2,13,12,14,-3,-1,0,2,2,-3,-9,-2,1,11,10,17,6,1,-1,92,38,54,64,21,43,27,29,-2,18,8,7,19,10,2,2,-2,3,8,19,-4,16,10,4,12,33,11,4,5,-3,8,15,3,-4,-2,-1,4,18,8,8,7,-2,-83,-63,-20,-2,-20,18,-8,-3,-29,-34,-2,-3,-1,-7,-19,-27,-5,-5,-7,4,-10,-7,3,2,9,14,-17,-11,7,-4,8,1,-14,-14,2,-3,1,13,-3,3,5,-1,-30,-36,6,-41,-31,-10,24,-2,-13,-27,-17,2,7,-3,-10,-22,-5,-2,17,1,-3,-5,-12,4,7,-9,-17,-12,-10,-3,2,-8,-10,-12,-5,0,5,-1,-7,0,-5,-3,41,14,27,26,16,10,17,6,-15,34,5,-6,0,4,-5,15,3,-3,17,2,-10,19,2,-3,7,4,7,8,-2,2,3,1,9,5,-1,-1,4,3,-2,3,-1,3,14,27,-13,62,31,31,22,18,-5,-7,-15,0,21,6,4,0,-3,0,1,12,-9,-7,-12,0,8,25,37,-4,-6,0,1,10,25,-4,-2,0,7,15,12,0,-4,0,119,58,61,140,76,64,38,6,42,20,-1,10,25,4,16,9,-3,3,13,2,26,11,2,7,27,27,38,31,14,-1,20,14,19,17,4,-1,7,13,19,14,10,0,80,56,24,146,74,72,-5,16,28,12,13,10,-2,13,26,4,6,8,-3,3,2,8,7,2,25,33,41,22,12,9,12,18,21,13,2,6,13,15,20,9,10,3
26,26021,Autol,3368,196,132,64,222,149,73,31,59,68,46,3,-9,12,44,48,30,3,-3,19,15,20,16,0,-6,24,60,85,47,4,0,10,44,61,30,4,0,14,16,24,17,0,0,216,143,73,212,146,66,28,56,79,35,9,7,10,34,62,26,6,4,18,22,17,9,3,3,23,53,88,34,10,2,11,35,65,25,7,2,12,18,23,9,3,0,64,54,10,120,73,47,-2,39,9,10,2,5,7,23,16,6,0,1,-9,16,-7,4,2,4,17,34,43,21,5,0,11,20,27,13,2,0,6,14,16,8,3,0,85,47,38,105,71,34,21,42,13,5,5,-1,12,25,9,-3,5,-1,9,17,4,8,0,0,19,32,33,17,3,1,12,21,23,12,3,0,7,11,10,5,0,1,86,58,28,89,54,35,13,29,17,16,8,0,10,19,11,13,1,0,3,10,6,3,7,0,6,30,33,11,7,0,6,18,21,6,1,0,0,12,12,5,6,0,136,76,60,112,55,57,36,38,19,30,9,2,14,17,16,18,8,2,22,21,3,12,1,0,19,37,30,19,7,0,10,13,20,7,4,1,9,24,10,12,3,-1,108,51,57,101,42,59,24,39,3,23,14,3,13,22,-2,6,6,3,11,17,5,17,8,0,17,35,21,18,9,1,7,16,10,5,4,0,10,19,11,13,5,1,152,83,69,145,70,75,40,34,35,24,13,5,22,20,19,13,6,1,18,14,16,11,7,4,33,42,42,21,6,0,18,21,20,8,2,0,15,21,22,13,4,0,136,70,66,144,71,73,42,37,49,10,-2,-4,24,16,31,0,0,-3,18,21,18,10,-2,-1,34,34,52,14,4,3,18,18,29,4,1,0,16,16,23,10,3,3,-29,-29,0,17,-10,27,-4,10,-7,-17,-5,-5,-4,4,-4,-18,-3,-1,0,6,-3,1,-2,-4,7,25,1,-10,-6,0,2,11,-6,-14,-3,0,5,14,7,4,-3,0,32,25,7,46,31,15,16,17,-2,2,4,-6,15,5,-1,4,0,0,1,12,-1,-2,4,-6,14,16,14,2,2,-3,13,5,8,3,1,0,1,11,6,-1,1,-3,-92,-66,-26,-52,-43,-9,-21,-4,-19,-43,-1,-3,-12,-7,-16,-34,3,1,-9,3,-3,-9,-4,-4,-3,-5,-14,-27,-3,0,0,-8,-14,-22,1,0,-3,3,0,-5,-4,0,-69,-77,8,-63,-55,-8,1,-3,4,-47,-15,-9,-5,-10,1,-42,-16,-6,6,7,3,-5,1,-3,5,5,-15,-44,-10,-4,4,1,-10,-37,-10,-3,1,4,-5,-7,0,-1,-62,-47,-15,-33,-22,-11,-14,5,-35,-17,6,-3,-3,-3,-23,-13,0,-3,-11,8,-12,-4,6,0,-6,3,-10,-16,-3,-1,-2,-1,-9,-8,-1,-1,-4,4,-1,-8,-2,0,51,9,42,17,-8,25,8,11,13,24,-4,-2,-2,3,4,9,-3,-1,10,8,9,15,-1,-1,2,14,3,1,-1,-1,-3,2,-5,-1,-1,0,5,12,8,2,0,-1,16,-10,26,-38,-31,-7,10,12,9,-13,2,-7,-1,4,0,-10,0,-4,11,8,9,-3,2,-3,-10,0,0,-23,-4,-1,-6,-3,0,-17,-4,-1,-4,3,0,-6,0,0,36,22,14,53,24,29,15,18,14,-15,6,-2,9,10,13,-12,3,-1,6,8,1,-3,3,-1,4,23,13,5,5,3,4,12,6,1,0,1,0,11,7,4,5,2,-43,-25,-18,0,-7,7,-18,6,-2,-20,-11,0,-7,0,-1,-11,-8,1,-11,6,-1,-9,-3,-1,0,10,2,-9,-5,1,-2,3,4,-9,-5,2,2,7,-2,0,0,-1
26,26036,Calahorra,19057,856,465,391,457,242,215,151,206,301,124,34,38,82,113,153,87,15,15,69,93,148,37,19,23,52,138,207,45,13,0,24,74,107,30,7,0,28,64,100,15,6,0,847,455,392,696,361,335,180,204,304,134,25,-1,85,116,160,81,11,3,95,88,144,53,14,-4,146,185,221,118,19,4,79,95,117,57,10,2,67,90,104,61,9,2,534,301,233,401,216,185,174,140,136,68,9,3,88,79,72,46,5,5,86,61,64,22,4,-2,105,128,87,55,17,5,57,69,50,27,7,3,48,59,37,28,10,2,668,378,290,350,194,156,129,145,219,81,22,65,83,77,139,35,11,29,46,68,80,46,11,36,80,90,114,41,9,11,54,50,66,15,3,3,26,40,48,26,6,8,732,381,351,428,208,220,141,192,220,93,34,52,68,94,136,42,19,27,73,98,84,51,15,25,92,129,121,63,12,7,45,63,65,29,2,3,47,66,56,34,10,4,469,230,239,345,174,171,140,80,163,59,14,10,78,44,73,27,9,-2,62,36,90,32,5,12,76,97,119,45,6,1,39,55,60,16,3,-1,37,42,59,29,3,2,491,244,247,434,208,226,56,157,154,70,30,11,21,74,96,31,15,1,35,83,58,39,15,10,70,153,118,56,30,2,35,69,58,32,12,0,35,84,60,24,18,2,509,308,201,511,264,247,102,127,100,94,37,46,52,77,67,67,23,23,50,50,33,27,14,23,112,136,149,68,29,8,61,63,81,41,11,3,51,73,68,27,18,5,356,181,175,341,165,176,71,94,98,51,19,19,42,37,56,24,7,13,29,57,42,27,12,6,81,94,83,51,17,5,50,36,42,22,5,3,31,58,41,29,12,2,-15,-27,12,143,54,89,16,14,-58,-33,0,46,22,1,-38,-32,-1,21,-6,13,-20,-1,1,25,50,45,20,18,-1,6,30,17,0,4,-2,3,20,28,20,14,1,3,-111,-115,4,38,6,32,-16,33,-57,-63,-18,-5,-25,14,-59,-44,-11,1,9,19,2,-19,-7,-6,9,43,-3,-3,-6,-4,10,22,-9,-13,-3,-3,-1,21,6,10,-3,-1,35,4,31,26,-5,31,5,31,-21,1,9,9,2,21,6,-27,-1,1,3,10,-27,28,10,8,2,37,-12,-10,8,-3,-5,20,-9,-16,1,0,7,17,-3,6,7,-3,-291,-179,-112,-176,-122,-54,-36,-28,-118,-86,-32,14,-23,-21,-72,-52,-13,3,-13,-7,-46,-34,-19,11,-19,-11,-62,-59,-21,-4,-11,-18,-45,-35,-12,-1,-8,7,-17,-24,-9,-3,-248,-175,-73,-182,-121,-61,-53,-32,-90,-50,-23,-4,-33,-29,-67,-33,-12,-4,-20,-3,-23,-17,-11,0,-30,-19,-51,-62,-16,-6,-20,-13,-35,-43,-9,-2,-10,-6,-16,-19,-7,-4,-134,-84,-50,-51,-43,-8,-15,-23,-60,-70,11,12,-8,-12,-40,-41,0,6,-7,-11,-20,-29,11,6,-1,1,-27,-31,3,-1,-1,-1,-25,-20,0,1,0,2,-2,-11,3,-2,-14,-9,-5,55,21,34,-24,16,-8,-7,-8,15,-19,6,-5,4,-7,11,-5,10,-3,-11,-1,4,13,16,19,10,-6,-1,11,5,7,2,-7,0,2,11,12,8,1,-1,52,22,30,83,31,52,-5,44,-14,20,-9,11,4,25,-6,-1,-10,4,-9,19,-8,21,1,7,12,43,11,13,0,2,12,17,1,4,-3,0,0,26,10,9,3,2,240,118,122,252,112,140,50,31,67,32,27,22,29,10,23,33,9,10,21,21,44,-1,18,12,46,59,71,45,22,6,22,24,29,24,8,3,24,35,42,21,14,3
26,26046,Cenicero,2076,14,18,-4,21,12,9,6,7,4,-1,5,-6,4,3,8,0,4,-1,2,4,-4,-1,1,-5,0,8,9,2,0,2,0,5,6,0,0,1,0,3,3,2,0,1,-8,-6,-2,11,6,5,-5,-4,-2,-2,2,3,-2,-3,0,-1,1,-1,-3,-1,-2,-1,1,4,1,3,4,1,1,1,1,1,2,1,1,0,0,2,2,0,0,1,22,17,5,14,5,9,6,3,6,5,4,-3,5,1,3,2,5,0,1,2,3,3,-1,-3,3,3,6,3,0,-1,2,1,1,1,0,0,1,2,5,2,0,-1,18,12,6,15,12,3,4,10,6,5,1,-8,3,7,6,1,1,-5,1,3,0,4,0,-3,1,6,6,2,1,-1,1,5,5,1,1,-1,0,1,1,1,0,0,47,34,13,51,35,16,-1,12,17,23,-1,-2,0,9,13,14,-1,-1,-1,3,4,9,0,-1,7,11,16,14,3,0,4,8,10,12,1,0,3,3,6,2,2,0,45,43,2,63,50,13,2,11,19,9,5,1,3,13,15,9,3,0,-1,-2,4,0,2,1,5,21,24,8,4,1,4,18,18,7,3,0,1,3,6,1,1,1,104,65,39,73,48,25,26,37,23,23,5,-7,9,25,17,12,6,-3,17,12,6,11,-1,-4,8,29,12,15,10,-1,4,19,9,10,6,0,4,10,3,5,4,-1,67,47,20,57,42,15,4,21,24,8,8,0,4,11,17,9,6,-1,0,10,7,-1,2,1,3,22,17,8,5,1,2,15,12,9,4,0,1,7,5,-1,1,1,-48,-53,5,-44,-48,4,7,-18,-12,-11,-9,-4,4,-23,-12,-15,-4,-2,3,5,0,4,-5,-2,6,-18,-10,-11,-10,-1,2,-18,-13,-13,-6,0,4,0,3,2,-4,-1,-60,-39,-21,-43,-30,-13,-2,-1,-36,-7,-8,-7,-3,-3,-16,-10,-4,-2,1,2,-20,3,-4,-5,-6,-1,-15,-17,-2,-1,-5,-2,-9,-13,-1,0,-1,1,-6,-4,-1,-1,-25,-19,-6,-14,-16,2,-8,2,-17,-7,-3,3,-8,7,-13,-3,-5,1,0,-5,-4,-4,2,2,-4,3,-5,-4,-6,0,-2,1,-6,-4,-5,-1,-2,2,1,0,-1,1,17,19,-2,-4,1,-5,2,-2,14,-3,3,3,9,-1,2,1,4,4,-7,-1,12,-4,-1,-1,2,-2,1,-2,-1,-2,3,-1,0,0,-1,0,-1,-1,1,-2,0,-2,-24,-12,-12,-11,-3,-8,-14,3,-9,-4,-5,6,-7,1,0,-5,0,0,-7,2,-9,1,-5,6,-3,1,-5,-1,-2,-1,0,1,-1,-1,-1,-1,-3,0,-4,0,-1,0,9,-14,23,-19,-16,-3,-9,-13,-3,-8,-2,43,-7,-4,-6,-7,-4,13,-2,-9,3,-1,2,30,-3,-7,-1,-3,-4,-1,-3,-3,-3,-3,-3,-1,0,-4,2,0,-1,0,1,0,1,10,4,6,5,1,-11,1,0,6,4,2,-8,1,2,-1,1,-1,-3,0,-2,7,7,2,-2,2,-1,2,3,1,-1,0,0,1,4,1,-1,2,-1,1,-3,3,-6,-3,-2,-1,-5,3,7,2,-4,-4,-2,-2,9,3,-4,0,-3,5,-2,-1,0,-4,-3,3,-2,-3,1,1,-2,1,-1,-1,1,0,-1,2,-1,-2,0,1,29,14,15,5,2,3,9,-1,5,6,0,9,4,0,4,3,0,3,5,-1,1,3,0,6,0,0,-3,4,2,2,-1,0,-1,2,1,1,1,0,-2,2,1,1,39,35,4,26,18,8,9,2,7,12,0,10,4,2,8,13,3,6,5,0,-1,-1,-3,4,6,4,9,8,-1,0,1,2,8,8,-1,0,5,2,1,0,0,0
26,26047,Cervera del Río Alhama,3038,9,12,-3,28,19,9,3,5,6,2,-5,-4,1,10,5,0,-2,-3,2,-5,1,2,-3,-1,2,7,14,3,1,1,1,5,11,2,0,0,1,2,3,1,1,1,5,0,5,42,21,21,12,12,-21,1,7,-7,5,4,-14,3,3,-2,7,8,-7,-2,4,-5,15,11,8,5,1,0,8,5,3,3,0,0,7,6,5,2,1,0,25,14,11,33,16,17,16,-2,6,2,2,3,5,4,2,-3,1,6,11,-6,4,5,1,-3,16,9,7,1,1,-1,7,5,3,0,1,0,9,4,4,1,0,-1,34,16,18,35,14,21,12,8,3,11,1,-2,4,1,2,9,-1,0,8,7,1,2,2,-2,7,11,8,6,3,0,3,3,4,3,1,0,4,8,4,3,2,0,20,2,18,29,11,18,10,0,-10,5,11,1,7,-2,-9,-4,8,0,3,2,-1,9,3,1,9,7,6,4,2,-1,4,3,1,1,1,0,5,4,5,3,1,-1,9,10,-1,35,21,14,7,7,-8,2,5,-3,5,3,1,3,4,-5,2,4,-9,-1,1,2,11,13,5,3,3,0,6,7,4,2,2,0,5,6,1,1,1,0,-1,6,-7,37,20,17,12,15,-16,0,2,-13,7,9,-4,-1,3,-7,5,6,-12,1,-1,-6,14,11,6,4,1,1,10,5,3,1,1,0,4,6,3,3,0,1,58,33,25,75,42,33,25,14,8,11,-1,-1,17,6,5,4,-1,1,8,8,3,7,0,-2,33,14,15,9,0,3,18,8,10,4,0,2,15,6,5,5,0,1,26,22,4,30,16,14,8,6,12,-1,-3,1,5,9,5,2,-2,0,3,-3,7,-3,-1,1,10,11,5,4,0,0,4,5,4,3,0,0,6,6,1,1,0,0,-56,-36,-20,12,1,11,-2,-9,-17,-19,0,-8,-1,-7,-11,-10,-1,-5,-1,-2,-6,-9,1,-3,8,2,3,0,-1,0,2,0,0,-1,0,0,6,2,3,1,-1,0,-26,-16,-10,7,3,4,-8,0,-17,-7,7,-1,-7,0,-3,-8,0,1,-1,0,-14,1,7,-2,1,3,4,0,0,-2,0,1,2,0,0,-1,1,2,2,0,0,-1,-29,-22,-7,3,2,1,-1,-2,-13,-7,-5,-2,-1,0,-11,-8,-5,2,0,-2,-2,1,0,-4,0,3,0,0,0,0,0,2,0,0,0,0,0,1,0,0,0,0,-35,-10,-25,-15,-10,-5,-8,-1,-13,-2,-4,-7,-4,0,-4,3,-1,-4,-4,-1,-9,-5,-3,-3,-2,1,-8,-4,-1,-1,-2,0,-5,-2,-1,0,0,1,-3,-2,0,-1,-15,-4,-11,1,-2,3,-7,2,-7,1,-1,-2,-5,0,-5,3,2,1,-2,2,-2,-2,-3,-3,-2,2,0,0,0,1,-1,0,0,-1,0,0,-1,2,0,1,0,1,-28,-26,-2,-7,-4,-3,-1,-11,-4,-6,0,-7,-2,-2,-4,-8,-3,-7,1,-9,0,2,3,0,2,-6,1,-3,0,-1,1,-3,0,-2,0,0,1,-3,1,-1,0,-1,7,6,1,12,2,10,3,5,-7,7,5,-6,4,1,-4,1,4,0,-1,4,-3,6,1,-6,-2,5,2,3,2,2,-2,2,1,0,1,0,0,3,1,3,1,2,-28,-4,-24,2,-1,3,-12,-3,-1,-2,-3,-8,-6,0,0,1,0,0,-6,-3,-1,-3,-3,-8,-4,2,2,-1,2,1,-2,0,1,-1,1,0,-2,2,1,0,1,1,-5,2,-7,13,6,7,-1,-12,7,-3,1,2,1,-4,6,1,-1,-1,-2,-8,1,-4,2,3,2,4,2,2,3,0,1,2,1,1,1,0,1,2,1,1,2,0
26,26061,Ezcaray,1833,21,15,6,10,7,3,2,12,7,1,-3,1,4,3,10,-1,-1,-1,-2,9,-3,2,-2,2,0,3,3,2,0,2,0,1,3,2,0,1,0,2,0,0,0,1,55,35,20,51,30,21,2,10,16,19,7,0,2,8,8,14,4,-2,0,2,8,5,3,2,5,11,22,10,2,0,3,6,13,6,1,0,2,5,9,4,1,0,47,34,13,48,30,18,0,22,10,12,2,-1,0,14,9,7,3,0,0,8,1,5,-1,-1,9,13,15,10,1,-1,4,9,8,7,1,0,5,4,7,3,0,-1,69,45,24,32,18,14,23,1,36,-4,8,3,17,1,19,2,5,1,6,0,17,-6,3,2,9,4,15,1,1,1,8,0,9,1,0,0,1,4,6,0,1,1,15,5,10,38,20,18,-6,-1,5,12,2,3,-7,4,2,6,1,-2,1,-5,3,6,1,5,6,9,14,8,0,1,2,4,11,3,0,0,4,5,3,5,0,1,-11,-13,2,31,13,18,-1,-15,-7,11,5,-4,3,-8,-11,2,3,-2,-4,-7,4,9,2,-2,8,4,10,9,0,0,5,2,4,2,0,0,3,2,6,7,0,0,46,22,24,37,14,23,24,7,-1,12,4,-1,15,4,-6,8,2,-1,9,3,5,4,2,0,13,10,8,2,4,0,9,2,1,1,1,0,4,8,7,1,3,0,-20,-8,-12,36,26,10,-3,4,-5,-12,1,-3,-2,2,-3,-5,3,-1,-1,2,-2,-7,-2,-2,7,10,8,7,3,1,5,9,6,4,2,0,2,1,2,3,1,1,40,18,22,31,13,18,-1,6,20,9,5,3,-5,4,12,6,0,1,4,2,8,3,5,2,5,8,13,5,1,-1,2,4,6,3,0,-2,3,4,7,2,1,1,9,0,9,23,7,16,13,8,-10,-6,2,1,11,-1,-5,-8,2,0,2,9,-5,2,0,1,15,3,2,5,-2,0,9,-3,1,1,-1,0,6,6,1,4,-1,0,1,2,-1,12,4,8,1,2,-6,-1,-1,3,-1,6,-7,4,-1,1,2,-4,1,-5,0,2,7,1,2,0,0,0,5,1,0,-2,0,0,2,0,2,2,0,0,-25,-16,-9,6,-2,8,-6,5,-12,-8,-1,-1,-5,0,-5,-5,-2,2,-1,5,-7,-3,1,-3,3,5,-7,2,3,1,3,0,-7,2,0,0,0,5,0,0,3,1,-14,-5,-9,-10,0,-10,12,-10,-3,-10,0,-2,10,-3,-1,-8,1,-2,2,-7,-2,-2,-1,0,7,-3,-2,-8,-3,-1,5,1,0,-5,-1,0,2,-4,-2,-3,-2,-1,22,16,6,-15,-11,-4,8,-6,9,2,1,7,4,-2,6,1,3,3,4,-4,3,1,-2,4,-4,-4,-7,1,-2,1,-3,-3,-6,2,-1,0,-1,-1,-1,-1,-1,1,7,8,-1,-2,-5,3,6,-5,-5,11,-2,-1,2,-4,-1,9,-1,1,4,-1,-4,2,-1,-2,0,-2,2,-2,1,-1,-1,-3,1,-3,1,0,1,1,1,1,0,-1,29,16,13,7,5,2,13,4,3,1,5,3,8,6,2,-3,0,4,5,-2,1,4,5,-1,0,1,4,3,-1,-1,0,1,3,1,0,0,0,0,1,2,-1,-1,-14,-8,-6,7,5,2,-11,-1,-2,-8,1,6,-4,-4,0,-2,-1,3,-7,3,-2,-6,2,3,-1,3,4,1,-1,0,0,0,3,1,0,0,-1,3,1,0,-1,0,1,-9,10,4,-3,7,-1,-3,7,-5,5,0,-5,-6,5,1,-2,-1,4,3,2,-6,7,1,2,-3,5,0,0,0,0,-2,1,-1,-1,0,2,-1,4,1,1,0
26,26064,Fuenmayor,2210,84,50,34,30,17,13,15,1,30,32,4,-1,9,0,25,15,2,-1,6,1,5,17,2,0,5,4,11,7,3,0,3,4,5,3,2,0,2,0,6,4,1,0,137,73,64,30,15,15,30,19,58,19,8,3,19,10,28,12,3,1,11,9,30,7,5,2,7,5,12,5,1,0,3,1,7,3,1,0,4,4,5,2,0,0,151,77,74,24,13,11,18,35,49,30,12,3,9,16,29,16,6,0,9,19,20,14,6,3,7,3,3,6,3,2,4,1,2,4,2,0,3,2,1,2,1,2,15,13,2,22,10,12,-8,13,4,8,2,1,-4,8,6,5,-2,2,-4,5,-2,3,4,-1,8,4,4,6,0,0,3,2,2,3,0,0,5,2,2,3,0,0,146,88,58,44,30,14,29,20,53,30,8,1,15,12,29,22,8,-2,14,8,24,8,0,3,10,12,10,9,2,-1,6,8,9,6,0,-1,4,4,1,3,2,0,47,15,32,20,3,17,-8,14,17,18,1,0,-10,7,14,3,-2,0,2,7,3,15,3,0,0,11,5,2,1,-2,-1,4,1,-3,1,-1,1,7,4,5,0,-1,60,43,17,38,13,25,13,10,3,15,12,5,11,2,19,1,7,2,2,8,-16,14,5,3,10,8,9,3,4,3,7,0,5,-3,1,2,3,8,4,6,3,1,56,30,26,30,16,14,4,14,21,22,-5,-2,6,5,8,13,-2,-3,-2,9,13,9,-3,1,5,9,2,13,1,-1,3,7,-1,6,1,-1,2,2,3,7,0,0,66,54,12,19,16,3,-2,7,36,23,9,-4,-1,8,23,20,8,-2,-1,-1,13,3,1,-2,-2,8,9,4,0,0,-3,7,6,5,1,0,1,1,3,-1,-1,0,-40,-24,-16,-9,-6,-3,-3,-4,-8,-22,-4,0,-5,1,-7,-10,-3,-2,2,-5,-1,-12,-1,2,1,-3,-1,-4,-1,-1,2,-1,-3,-2,-1,-1,-1,-2,2,-2,0,0,-43,-29,-14,-24,-19,-5,-18,3,-2,-28,1,4,-16,3,2,-22,4,-1,-2,0,-4,-6,-3,5,-3,0,-8,-12,-2,0,-4,1,-8,-7,-1,-1,1,-1,0,-5,-1,1,39,24,15,15,8,7,-2,12,18,-1,5,3,-1,3,13,0,5,3,-1,9,5,-1,0,0,1,8,3,0,2,1,0,2,3,2,1,0,1,6,0,-2,1,1,-29,-25,-4,-14,-9,-5,-11,-6,-11,-4,-2,7,-4,-4,-3,-7,-6,0,-7,-2,-8,3,4,7,-2,-5,1,-5,-3,1,0,-3,0,-4,-3,1,-2,-2,1,-1,0,0,-15,-7,-8,-3,-1,-2,5,-5,-11,2,-6,-1,-3,1,-5,3,-4,-1,8,-6,-6,-1,-2,0,-1,2,-1,-2,-1,0,1,0,1,-2,-1,0,-2,2,-2,0,0,0,-8,11,-19,1,3,-2,0,-1,-5,5,-7,-1,3,3,-3,7,-3,3,-3,-4,-2,-2,-4,-4,3,1,2,-6,2,-1,1,3,2,-5,1,1,2,-2,0,-1,1,-2,-25,-11,-14,-12,-6,-6,-7,-10,-4,-5,2,-3,-3,-4,-8,-2,5,0,-4,-6,4,-3,-3,-3,-6,1,0,-6,0,-1,-2,0,0,-4,0,0,-4,1,0,-2,0,-1,-10,-7,-3,5,3,2,-1,1,2,-5,-3,-4,4,-2,-3,-5,0,-1,-5,3,5,0,-3,-3,0,5,0,0,1,-1,2,2,-1,-1,2,-1,-2,3,1,1,-1,0,29,26,3,15,13,2,13,-2,11,6,2,-1,13,1,8,8,0,-3,0,-3,3,-2,2,2,6,0,2,6,-1,1,6,1,3,4,0,-1,0,-1,-1,2,-1,2
26,26089,Logroño,127093,2590,1350,1240,1901,1007,894,308,647,938,481,70,138,172,350,462,284,18,58,136,297,476,197,52,80,253,521,663,366,62,27,134,282,337,216,23,10,119,239,326,150,39,17,3203,1661,1542,2780,1503,1277,514,855,1142,492,45,145,244,466,624,254,15,57,270,389,518,238,30,88,463,795,920,458,90,38,228,440,534,240,36,18,235,355,386,218,54,20,2759,1409,1350,2860,1500,1360,525,781,890,435,47,75,271,378,491,220,10,34,254,403,399,215,37,41,502,808,904,466,126,39,263,403,513,239,59,15,239,405,391,227,67,24,2327,1045,1282,2699,1411,1288,418,674,740,343,45,89,202,305,360,154,-31,43,216,369,380,189,76,46,478,751,857,438,114,30,252,387,479,224,38,14,226,364,378,214,76,16,2727,1484,1243,3040,1691,1349,450,851,861,387,44,135,246,449,557,190,-9,46,204,402,304,197,53,89,495,869,1005,496,123,32,244,457,640,277,54,9,251,412,365,219,69,23,1393,638,755,2350,1321,1029,384,427,316,111,23,125,182,237,137,49,-18,47,202,190,179,62,41,78,487,630,709,389,105,20,238,353,458,215,43,8,249,277,251,174,62,12,379,102,277,1400,636,764,298,208,-23,-29,-148,55,129,70,-22,-10,-90,11,169,138,-1,-19,-58,44,451,409,316,165,31,11,217,161,152,78,17,3,234,248,164,87,14,8,3536,1592,1944,2889,1384,1505,830,927,812,581,137,162,412,460,329,210,50,78,418,467,483,371,87,84,697,913,726,393,116,8,360,455,329,166,51,0,337,458,397,227,65,8,1981,880,1101,1535,783,752,394,500,495,325,85,157,194,222,238,145,6,58,200,278,257,180,79,99,359,422,411,239,64,18,185,200,228,127,21,6,174,222,183,112,43,12,-118,-315,197,103,-106,209,128,117,-204,-213,-58,115,85,63,-269,-208,-38,51,43,54,65,-5,-20,64,106,143,-89,-88,2,15,66,46,-114,-104,-8,4,40,97,25,16,10,11,-409,-536,127,-4,-216,212,364,3,-338,-354,-145,37,237,-37,-308,-331,-117,15,127,40,-30,-23,-28,22,376,162,-211,-236,-83,-39,245,53,-194,-240,-76,-15,131,109,-17,4,-7,-24,464,-26,490,645,202,443,214,-2,46,-27,28,193,117,-48,-102,-64,-3,68,97,46,148,37,31,125,273,168,90,49,44,6,147,52,5,-15,10,-6,126,116,85,64,34,12,-394,-478,84,-516,-364,-152,-35,-122,-185,-179,-46,137,-9,-116,-198,-180,-53,56,-26,-6,13,1,7,81,-45,-17,-206,-193,-49,-17,-11,-37,-132,-148,-40,-4,-34,20,-74,-45,-9,-13,-1065,-777,-288,-1178,-720,-458,-184,-198,-363,-352,-106,139,-130,-128,-224,-262,-78,53,-54,-70,-139,-90,-28,86,-125,-100,-448,-353,-143,-18,-61,-56,-271,-249,-82,-8,-64,-44,-177,-104,-61,-10,-674,-568,-106,-867,-522,-345,-20,-146,-255,-242,-108,74,-18,-140,-183,-199,-79,40,-2,-6,-72,-43,-29,34,-123,-51,-309,-275,-94,-22,-64,-38,-185,-187,-50,-2,-59,-13,-124,-88,-44,-20,-202,-210,8,-402,-257,-145,-49,-25,-175,-185,3,190,-39,-13,-109,-115,-31,81,-10,-12,-66,-70,34,109,-73,53,-159,-184,-36,-14,-49,13,-89,-108,-25,-3,-24,40,-70,-76,-11,-11,274,12,262,79,-21,100,21,30,28,-55,33,210,6,-28,-19,-63,7,94,15,58,47,8,26,116,32,121,-28,-52,-4,-4,26,47,-35,-49,-13,-1,6,74,7,-3,9,-3,587,235,352,262,90,172,77,80,145,8,49,182,40,2,76,-27,32,84,37,78,69,35,17,98,44,126,91,-35,2,17,26,52,48,-43,-7,4,18,74,43,8,9,13
26,26102,Nájera,7063,63,22,41,50,28,22,5,7,49,-10,3,7,-4,5,26,-8,0,2,9,2,23,-2,3,5,8,8,22,7,4,0,3,2,15,4,3,0,5,6,7,3,1,0,64,48,16,54,31,23,3,10,30,12,-3,8,1,9,20,14,0,3,2,1,10,-2,-3,5,4,12,24,12,1,1,0,8,14,7,1,1,4,4,10,5,0,0,112,63,49,85,52,33,-5,16,61,28,15,-4,-4,9,30,21,9,-3,-1,7,31,7,6,-1,5,26,36,16,4,-3,3,15,21,11,3,-2,2,11,15,5,1,-1,98,56,42,93,45,48,20,23,38,12,-4,10,11,8,30,6,-4,5,9,15,8,6,0,5,13,29,35,13,1,2,4,12,24,5,0,0,9,17,11,8,1,2,148,92,56,114,64,50,20,47,41,33,0,4,13,21,36,23,-3,2,7,26,5,10,3,2,11,32,45,21,3,0,7,14,29,12,2,0,4,18,16,9,1,0,100,44,56,110,61,49,17,58,14,10,-3,8,14,27,6,-1,-2,2,3,31,8,11,-1,6,18,45,30,15,1,1,12,25,15,8,0,1,6,20,15,7,1,0,203,95,108,114,45,69,64,50,27,16,24,17,38,21,18,2,7,6,26,29,9,14,17,11,38,36,13,18,6,3,17,16,3,7,1,1,21,20,10,11,5,2,217,125,92,165,82,83,48,49,86,21,14,-1,30,28,51,12,5,-2,18,21,35,9,9,1,39,44,50,23,7,2,18,23,29,10,2,0,21,21,21,13,5,2,153,87,66,120,61,59,33,41,43,18,8,7,14,19,25,12,5,9,19,22,18,6,3,-2,36,35,22,19,6,2,21,17,12,7,3,1,15,18,10,12,3,1,-76,-56,-20,-41,-25,-16,-16,-14,-51,-18,1,23,-11,-2,-27,-17,-6,8,-5,-12,-24,-1,7,15,-11,-1,-17,-19,5,2,-6,-1,-9,-12,2,2,-5,0,-8,-7,3,0,49,3,46,55,7,48,27,6,2,-4,6,9,12,-9,1,-9,3,3,15,15,1,5,3,6,25,8,7,6,6,1,13,-6,0,-3,1,0,12,14,7,9,5,1,-48,-32,-16,-2,-4,2,-7,6,-55,-1,9,4,8,1,-35,-3,0,1,-15,5,-20,2,9,3,6,7,-16,1,-1,0,7,4,-11,0,-5,1,-1,3,-5,1,4,-1,-48,-27,-21,-36,-16,-20,-15,4,-22,-14,-3,-2,-16,3,-7,-11,-3,3,1,1,-15,-3,0,-5,-9,2,-16,-3,-6,-4,-10,1,-2,-3,-1,-1,1,1,-14,0,-5,-3,-100,-55,-45,-16,-9,-7,-17,-6,-37,-16,-18,-3,-4,-4,-20,-12,-13,0,-13,-2,-17,-4,-5,-3,11,-3,-18,-4,-4,1,10,1,-16,-3,-3,1,1,-4,-2,-1,-1,0,-75,-43,-32,-28,-14,-14,-11,-12,-21,-32,-2,3,3,-5,-16,-18,-4,-2,-14,-7,-5,-14,2,5,-1,-1,-16,-8,-2,0,2,1,-10,-4,-2,-1,-3,-2,-6,-4,0,1,-50,-31,-19,16,2,14,-16,-1,-27,2,-7,3,-15,2,-15,0,3,-3,-1,-3,-12,2,-10,6,6,3,3,3,0,0,1,0,-3,2,3,-1,5,3,6,1,-3,1,-45,-28,-17,-9,-14,5,-11,-5,-27,0,-1,1,-6,-6,-8,-2,0,-3,-5,1,-19,2,-1,4,-3,8,-9,-6,1,0,0,3,-3,-9,-2,-3,-3,5,-6,3,3,3,-38,-21,-17,15,4,11,-14,-5,1,-17,-2,-2,-6,1,-1,-8,2,-7,-8,-6,2,-9,-4,5,5,7,4,-5,0,2,1,5,1,-3,0,0,4,2,3,-2,0,2
26,26105,Navarrete,2048,55,32,23,38,16,22,13,11,7,13,7,5,5,6,8,9,2,2,8,5,-1,4,5,3,12,6,11,7,2,0,4,3,6,3,0,0,8,3,5,4,2,0,64,36,28,28,18,10,7,10,20,18,8,0,6,4,13,10,2,0,1,6,7,8,6,0,6,9,7,4,0,1,4,5,5,3,0,0,2,4,2,1,0,1,119,62,57,23,12,11,22,30,44,21,3,-2,15,11,22,14,1,-1,7,19,22,7,2,-1,5,7,7,1,0,1,3,2,5,1,0,1,2,5,2,0,0,0,109,64,45,7,5,2,16,10,63,4,11,3,11,4,37,5,3,3,5,6,26,-1,8,0,2,2,3,0,0,0,3,1,1,0,0,0,-1,1,2,0,0,0,136,81,55,16,12,4,31,18,37,32,2,10,19,10,25,18,1,6,12,8,12,14,1,4,5,5,1,5,0,0,4,3,1,4,0,0,1,2,0,1,0,0,49,28,21,6,2,4,12,8,26,3,0,1,10,4,11,4,-1,0,2,4,15,-1,1,1,-1,8,2,-2,-1,0,-2,6,1,-2,-1,0,1,2,1,0,0,0,47,28,19,17,9,8,14,3,30,8,-3,-4,9,3,16,3,0,-2,5,0,14,5,-3,-2,7,1,7,0,2,0,4,2,2,0,1,0,3,-1,5,0,1,0,20,15,5,26,11,15,7,6,8,6,-2,-3,5,2,5,2,1,0,2,4,3,4,-3,-3,4,4,8,8,2,0,3,-1,4,3,2,0,1,5,4,5,0,0,66,42,24,19,11,8,21,19,7,10,7,3,8,14,3,10,5,1,13,5,4,0,2,2,1,14,-1,6,-1,0,1,7,-1,4,0,0,0,7,0,2,-1,0,7,5,2,-18,-16,-2,3,-8,15,-1,0,-3,3,-7,15,-4,-1,-2,0,-1,0,3,1,-1,-2,-2,-5,-10,0,1,-2,-1,-4,-9,0,0,0,-1,-1,-1,0,1,15,-5,20,-7,-11,4,9,7,13,-13,-2,-2,4,5,3,-15,-1,-2,5,2,10,2,-1,0,3,-2,-2,-5,-2,0,-1,0,-1,-7,-2,0,4,-2,-1,2,0,0,2,4,-2,-5,-6,1,-1,6,-8,1,2,-1,1,3,-9,5,0,1,-2,3,1,-4,2,-2,-3,-1,-1,0,1,-1,-3,-1,-1,0,-1,0,0,0,0,0,2,-1,49,9,40,4,2,2,11,5,1,10,8,13,3,-2,-6,2,3,9,8,7,7,8,5,4,1,1,-1,1,0,2,1,-1,0,1,0,1,0,2,-1,0,0,1,0,2,-2,-8,-4,-4,4,0,-11,-1,8,-1,7,-2,-8,0,6,-1,-3,2,-3,-1,2,0,1,0,-2,-3,-4,0,0,-1,-2,-1,0,0,1,1,0,-2,-4,0,-18,-8,-10,0,0,0,-8,-5,1,-2,-1,-3,-7,0,-4,4,-1,2,-1,-5,5,-6,0,-5,1,-1,-2,1,1,0,1,1,-2,1,0,-1,0,-2,0,0,1,1,-20,-7,-13,-2,-1,-1,-7,-2,-9,-1,5,-4,-2,0,-2,0,3,-4,-5,-2,-7,-1,2,0,-1,1,-1,0,0,0,0,1,0,-1,0,0,-1,0,-1,1,0,0,22,21,1,8,5,3,5,-1,11,-6,8,2,7,1,11,-6,5,1,-2,-2,0,0,3,1,3,1,-4,3,3,1,2,1,-1,1,1,0,1,0,-3,2,2,1,18,7,11,2,-1,3,-3,7,7,-1,5,1,-3,3,4,-2,3,1,0,4,3,1,2,0,1,0,2,-1,0,0,1,0,0,-2,0,0,0,0,2,1,0,0
26,26117,Pradejón,2964,210,152,58,272,188,84,4,71,98,35,0,1,-3,50,75,32,-1,0,7,21,23,3,1,1,23,79,112,53,1,1,10,56,78,42,1,0,13,23,34,11,0,1,257,183,74,319,214,105,32,72,107,44,3,-2,19,57,73,34,1,-1,13,15,34,10,2,-1,39,94,129,51,4,0,17,69,86,40,1,0,22,25,43,11,3,0,128,66,62,292,174,118,30,65,27,11,-3,-5,18,41,6,4,-3,-2,12,24,21,7,0,-3,55,97,88,45,3,1,33,60,48,30,2,0,22,37,40,15,1,1,29,15,14,193,116,77,6,45,-15,-4,3,-4,5,36,-16,-14,4,1,1,9,1,10,-1,-5,36,73,48,28,5,3,25,48,24,12,4,3,11,25,24,16,1,0,63,42,21,195,117,78,-1,51,21,-11,3,0,3,35,10,-8,2,-1,-4,16,11,-3,1,1,19,78,66,25,7,0,8,50,39,16,3,0,11,28,27,9,4,0,113,61,52,221,127,94,8,69,26,-5,13,3,-4,37,30,-5,4,0,12,32,-4,0,9,3,41,76,58,25,17,4,22,43,39,15,7,1,19,33,19,10,10,3,70,45,25,203,118,85,11,40,8,9,8,-4,12,34,-2,1,3,-1,-1,6,10,8,5,-3,32,73,57,31,8,2,20,44,34,17,3,1,12,29,23,14,5,1,97,55,42,175,92,83,32,53,2,11,2,-3,19,27,5,4,-1,2,13,26,-3,7,3,-5,37,69,34,27,7,1,17,40,23,10,1,1,20,29,11,17,6,0,65,32,33,85,46,39,12,15,17,17,4,0,6,1,12,12,3,-1,6,14,5,5,1,1,15,23,29,14,3,1,8,7,20,8,2,1,7,16,9,6,1,0,41,21,20,55,28,27,0,34,14,1,-2,-7,3,19,4,-2,-1,-3,-3,15,10,3,-1,-4,5,32,11,7,0,-1,4,15,6,2,1,-1,1,17,5,5,-1,0,69,31,38,94,40,54,9,24,26,6,5,-1,5,7,18,3,2,-1,4,17,8,3,3,0,16,32,25,14,4,0,7,10,13,8,2,0,9,22,12,6,2,0,89,40,49,86,42,44,22,34,22,8,4,-2,13,11,14,8,-3,-2,9,23,8,0,7,0,14,28,25,7,9,2,12,10,13,5,2,0,2,18,12,2,7,2,2,1,1,13,3,10,3,7,-15,6,0,0,6,-3,-8,9,-3,-1,-3,10,-7,-3,3,1,3,16,-3,-2,-1,-1,3,3,0,-1,-2,-1,0,13,-3,-1,1,0,-41,-28,-13,-40,-25,-15,-10,10,-5,-23,-9,-3,-7,1,-6,-13,-2,0,-3,9,1,-10,-7,-3,-8,8,-9,-20,-10,-1,-6,1,-4,-13,-3,0,-2,7,-5,-7,-7,-1,-201,-122,-79,-164,-108,-56,-11,6,-58,-87,-39,-11,-5,2,-37,-56,-22,-3,-6,4,-21,-31,-17,-8,0,3,-51,-75,-34,-7,0,-2,-37,-46,-21,-2,0,5,-14,-29,-13,-5,-79,-50,-29,-19,-19,0,-8,2,-40,-24,-2,-5,-8,3,-19,-19,-4,-2,0,-1,-21,-5,2,-3,4,11,-17,-16,-3,2,0,4,-8,-12,-4,1,4,7,-9,-4,1,1,24,4,20,58,29,29,10,8,2,13,-6,-1,2,-2,0,11,-4,-2,8,10,2,2,-2,1,10,17,13,15,1,3,5,3,8,9,4,1,5,14,5,6,-3,2,-119,-52,-67,-16,-8,-8,-18,-10,-41,-32,-12,-5,-8,-1,-16,-19,-6,-2,-10,-9,-25,-13,-6,-3,3,6,-12,-9,-2,-2,2,6,-6,-8,-1,-1,1,0,-6,-1,-1,-1
26,26125,Rincón de Soto,2562,42,40,2,44,30,14,16,8,10,10,-1,-1,11,6,15,7,0,1,5,2,-5,3,-1,-2,12,10,17,4,0,1,10,7,11,1,0,1,2,3,6,3,0,0,115,84,31,83,49,34,25,37,39,6,3,0,18,24,27,8,1,1,7,13,12,-2,2,-1,15,22,31,10,2,1,8,13,21,5,0,0,7,9,10,5,2,1,31,13,18,44,28,16,7,9,8,-1,3,6,-1,5,9,-6,3,4,8,4,-1,5,0,2,9,16,14,1,1,2,3,11,12,0,0,1,6,5,2,1,1,1,51,40,11,43,23,20,-5,28,13,13,5,-4,0,19,11,10,3,-3,-5,9,2,3,2,-1,7,15,11,5,3,0,6,7,6,3,1,0,1,8,5,2,2,0,70,62,8,71,50,21,31,5,25,12,-2,-5,20,8,18,13,0,1,11,-3,7,-1,-2,-6,15,19,19,11,6,1,10,11,12,10,6,1,5,8,7,1,0,0,28,25,3,59,39,20,-6,9,16,7,2,-1,0,6,12,6,0,0,-6,3,4,1,2,-1,7,18,22,8,2,2,5,10,16,6,1,1,2,8,6,2,1,1,35,-9,44,71,15,56,36,9,-15,1,10,-2,8,8,-13,-9,2,-3,28,1,-2,10,8,1,32,26,13,1,-1,-1,15,13,1,-8,-5,-2,17,13,12,9,4,1,102,45,57,45,21,24,31,35,22,18,-2,-2,13,20,3,9,0,-1,18,15,19,9,-2,-1,4,14,10,13,2,1,-1,7,3,7,3,1,5,7,7,6,-1,0,80,40,40,53,21,32,26,13,6,23,0,4,12,6,6,14,-2,3,14,7,0,9,2,1,19,11,10,7,0,1,10,4,2,1,1,1,9,7,8,6,-1,0,-17,-25,8,9,-9,18,6,-10,0,-2,4,-16,-3,-3,-8,-5,2,-7,9,-7,8,3,2,-9,11,-3,5,-9,3,1,6,-1,-6,-9,0,1,5,-2,11,0,3,0,17,19,-2,23,15,8,10,-1,10,2,-8,1,14,0,7,3,-3,-3,-4,-1,3,-1,-5,4,3,8,7,3,2,0,6,1,3,3,2,0,-3,7,4,0,0,0,-4,-13,9,-15,-7,-8,7,-1,-18,9,1,-2,11,-10,-8,-1,-2,-4,-4,9,-10,10,3,2,-4,-3,-6,2,-2,-1,5,-7,-2,0,-2,-1,-9,4,-4,2,0,0,-27,-14,-13,-9,-11,2,-9,5,2,-16,-5,-6,-10,4,5,-10,-2,-1,1,1,-3,-6,-3,-5,-3,1,-1,-5,-1,0,-6,0,0,-4,-1,0,3,1,-1,-1,0,0,-24,-8,-16,1,-2,3,-14,-2,-1,-12,0,2,-4,0,-1,-9,0,4,-10,-2,0,-3,0,-2,2,0,2,-2,-1,0,0,-2,2,-3,1,0,2,2,0,1,-2,0,-22,-1,-21,14,10,4,-9,5,-9,-9,-2,4,-6,4,1,-2,-1,4,-3,1,-10,-7,-1,0,0,4,6,5,-1,0,-1,2,7,2,0,0,1,2,-1,3,-1,0,29,11,18,9,5,4,3,5,8,9,2,-1,4,0,4,6,-1,-3,-1,5,4,3,3,2,-5,8,7,-2,1,0,-3,4,6,-2,0,0,-2,4,1,0,1,0,-11,2,-13,55,27,28,-14,5,3,-10,2,3,-7,3,6,0,-2,0,-7,2,-3,-10,4,3,11,14,18,8,1,3,5,5,8,7,0,1,6,9,10,1,1,2,-12,6,-18,15,7,8,-7,4,2,-9,-3,0,2,0,4,-5,1,3,-9,4,-2,-4,-4,-3,14,11,4,-15,1,-2,9,3,2,-7,0,0,5,8,2,-8,1,-2
26,26138,Santo Domingo de la Calzada,5676,30,23,7,45,18,27,1,13,-3,14,5,-1,5,2,1,6,5,3,-4,11,-4,8,0,-4,5,13,10,13,2,1,4,3,4,5,1,1,1,10,6,8,1,0,51,44,7,81,52,29,2,26,18,10,-1,-5,4,16,12,11,1,0,-2,10,6,-1,-2,-5,13,24,28,12,4,0,8,14,18,9,3,0,5,10,10,3,1,0,135,92,43,93,52,41,29,42,41,21,3,1,14,27,31,16,2,1,15,15,10,5,1,0,23,27,27,11,3,2,12,13,18,7,1,1,11,14,9,4,2,1,221,122,99,125,72,53,48,46,81,26,9,5,23,22,56,13,2,2,25,24,25,13,7,3,23,36,39,17,4,1,10,17,24,16,2,0,13,19,15,1,2,1,163,119,44,142,88,54,22,52,65,11,12,1,9,37,57,8,6,2,13,15,8,3,6,-1,20,44,50,20,7,0,7,29,38,13,1,0,13,15,12,7,6,0,159,104,55,164,98,66,31,44,39,45,7,-11,14,30,21,32,7,-2,17,14,18,13,0,-9,34,54,42,29,3,2,18,38,20,19,1,2,16,16,22,10,2,0,209,146,63,204,126,78,48,77,28,38,16,-2,20,57,27,25,11,5,28,20,1,13,5,-7,49,62,50,31,9,1,25,41,33,19,7,1,24,21,17,12,2,0,170,95,75,164,75,89,33,33,58,28,14,1,18,9,40,18,6,1,15,24,18,10,8,0,33,57,44,21,8,-1,13,26,23,7,5,0,20,31,21,14,3,-1,81,52,29,65,27,38,17,13,3,17,12,17,16,9,2,20,1,3,1,4,1,-3,11,14,6,27,18,9,1,2,5,10,8,3,-1,2,1,17,10,6,2,0,-60,-56,-4,17,-4,21,12,-12,-21,-44,-1,3,8,-9,-12,-42,-3,1,4,-3,-9,-2,2,2,15,11,-2,-9,-1,2,10,3,-4,-11,-2,0,5,8,2,2,1,2,-38,-5,-33,-12,-7,-5,-6,3,-10,-13,-11,1,-6,18,3,-15,-2,-3,0,-15,-13,2,-9,4,4,12,-7,-11,-7,-2,0,15,-3,-13,-3,-2,4,-3,-4,2,-4,0,-11,-13,2,35,14,21,13,-15,-11,0,-4,9,5,-5,-13,-3,-1,5,8,-10,2,3,-3,4,14,5,17,-3,0,2,8,0,6,-2,1,1,6,5,11,-1,-1,1,-41,-49,8,1,-8,9,0,-18,-19,-12,3,0,4,-14,-21,-17,1,-4,-4,-4,2,5,2,4,4,-4,-6,4,0,-2,3,-6,-5,-1,-1,-1,1,2,-1,5,1,-1,-70,-33,-37,-7,-14,7,-11,1,-24,-19,-13,-4,-4,-5,-7,-9,-6,-3,-7,6,-17,-10,-7,-1,0,14,-9,-7,-7,2,1,5,-8,-9,-3,0,-1,9,-1,2,-4,2,-73,-43,-30,-42,-35,-7,-8,-2,-18,-12,-31,-2,-2,3,-13,-10,-23,2,-6,-5,-5,-2,-8,-4,-1,4,-17,-9,-18,0,0,1,-11,-11,-13,0,-1,3,-6,2,-5,0,-27,-28,1,-42,-35,-7,1,-15,1,-8,-15,10,-2,-5,-7,-7,-10,3,3,-10,8,-1,-5,7,-6,3,-5,-14,-16,-4,-2,1,-10,-9,-13,-2,-4,2,5,-5,-3,-2,-86,-67,-19,-16,-21,5,-24,9,-30,-40,3,-5,-15,0,-18,-26,-1,-8,-9,9,-12,-14,4,3,-8,13,0,-16,-3,-2,-9,6,-3,-11,-3,-1,1,7,3,-5,0,-1,-38,-20,-18,-2,-6,4,0,-2,-21,0,-17,4,-1,4,-18,1,-7,1,1,-6,-3,-1,-10,3,0,5,5,-6,-6,0,-1,3,1,-5,-2,-2,1,2,4,-1,-4,2
26,26168,Villamediana de Iregua,2128,157,83,74,42,25,17,33,24,63,23,12,-2,20,9,32,14,6,0,13,15,31,9,6,-2,6,11,18,6,0,0,4,7,12,2,0,0,2,4,6,4,0,0,141,72,69,23,13,10,22,29,60,17,10,1,5,17,28,10,10,0,17,12,32,7,0,1,4,7,9,2,1,0,1,4,6,1,1,0,3,3,3,1,0,0,231,143,88,36,21,15,29,29,101,50,22,-2,23,10,69,27,15,-2,6,19,32,23,7,0,6,12,13,3,2,0,4,6,9,1,1,0,2,6,4,2,1,0,454,258,196,38,23,15,53,73,194,83,31,10,25,42,113,50,18,5,28,31,81,33,13,5,2,10,15,6,4,0,3,6,9,3,1,0,-1,4,6,3,3,0,594,305,289,44,19,25,88,87,242,121,35,12,43,38,133,64,18,7,45,49,109,57,17,5,4,10,12,11,4,3,0,6,6,3,2,2,4,4,6,8,2,1,672,353,319,49,26,23,104,86,313,112,39,12,57,37,177,53,18,8,47,49,136,59,21,4,12,9,10,7,8,2,7,4,9,3,3,0,5,5,1,4,5,2,789,422,367,79,41,38,75,144,354,142,47,19,39,66,200,83,26,4,36,78,154,59,21,15,11,18,22,18,11,-1,4,12,11,13,1,0,7,6,11,5,10,-1,463,266,197,80,41,39,47,97,205,75,28,13,29,47,135,35,20,4,18,50,70,40,8,9,11,17,30,11,5,4,11,8,14,3,3,1,0,9,16,8,2,3,275,141,134,54,12,42,20,82,147,24,3,6,12,33,80,26,-4,3,8,49,67,-2,7,3,9,18,19,2,4,2,2,7,5,-2,-1,1,7,11,14,4,5,1,208,117,91,-8,-15,7,2,61,111,10,22,6,1,26,71,-3,12,8,1,35,40,13,10,-2,5,9,-3,-15,-4,0,-1,3,-2,-12,-3,0,6,6,-1,-3,-1,0,141,81,60,-6,-13,7,46,58,23,24,-3,-4,25,23,21,15,0,-5,21,35,2,9,-3,1,3,6,-6,-3,-4,-3,-1,3,-7,-5,-2,-2,4,3,1,2,-2,-1,167,85,82,-22,-17,-5,41,26,51,38,9,1,25,15,18,23,3,0,16,11,33,15,6,1,-2,-2,-13,-7,1,1,-2,-1,-9,-5,-1,1,0,-1,-4,-2,2,0,48,28,20,-14,-13,-1,19,6,15,-2,-1,13,15,4,15,-2,-7,3,4,2,0,0,6,10,-1,-1,-4,-10,-2,3,-1,-3,0,-9,-1,0,0,2,-4,-1,-1,3,80,52,28,-18,-12,-6,22,-2,15,24,20,2,22,-2,15,5,13,-1,0,0,0,19,7,3,-3,0,-3,-9,-1,-2,-3,1,-2,-5,0,-3,0,-1,-1,-4,-1,1,10,8,2,-36,-16,-20,-4,-9,37,-14,-10,8,-1,9,10,-5,-9,4,-3,-18,27,-9,-1,4,-6,-2,-6,-10,-11,-1,-3,1,-2,-5,-6,-1,-3,-3,-4,-5,-5,0,-8,-2,-6,0,3,-3,-13,20,15,-21,2,-8,1,14,0,-16,1,-4,-14,6,15,-5,1,-4,4,2,-2,-5,1,-1,4,1,-4,-2,3,0,0,1,2,-3,-2,-1,108,30,78,-3,-9,6,34,7,25,31,15,-9,24,-7,4,9,4,-5,10,14,21,22,11,-4,-2,3,1,-3,-1,-2,-1,0,-2,-5,-1,0,-1,3,3,2,0,-2,71,34,37,19,3,16,-9,34,43,-30,29,11,-7,20,29,-24,14,7,-2,14,14,-6,15,4,5,4,5,3,1,-1,1,-1,1,2,0,-1,4,5,4,1,1,0
27,27003,Antas de Ulla,2800,-7,-6,-1,7,4,3,-3,0,-2,-3,0,1,0,-2,-3,-3,0,3,-3,2,1,0,0,-2,3,0,2,1,0,1,1,0,1,1,0,1,2,0,1,0,0,0,24,12,12,4,1,3,3,-2,4,-3,9,13,3,-2,2,-4,7,6,0,0,2,1,2,7,0,0,0,1,2,1,0,0,0,0,1,0,0,0,0,1,1,1,-1,1,-2,2,-1,3,-4,0,-3,-1,5,2,-3,-2,0,0,2,5,-1,2,-3,-1,3,-3,0,2,1,-1,-1,1,0,0,-1,-1,0,1,0,2,2,0,-1,0,-4,-4,0,6,4,2,-3,1,-12,1,5,5,-4,3,-5,-1,1,3,1,-2,-7,2,4,2,0,0,0,4,0,2,0,0,0,3,-1,2,0,0,0,1,1,0,-14,-3,-11,5,0,5,0,1,-5,-4,7,-10,-2,3,-2,-4,6,-3,2,-2,-3,0,1,-7,4,0,1,0,0,0,0,0,0,0,0,0,4,0,1,0,0,0,25,9,16,8,4,4,6,-5,5,7,6,6,3,-6,-1,1,5,7,3,1,6,6,1,-1,0,1,1,3,0,3,1,1,1,0,0,1,-1,0,0,3,0,2,14,13,1,7,3,4,10,5,-5,8,8,-12,4,2,-1,3,8,-3,6,3,-4,5,0,-9,2,0,1,2,1,1,0,0,0,2,0,1,2,0,1,0,1,0,1,13,-12,9,6,3,4,-4,-11,3,6,5,4,-1,-4,8,3,4,0,-3,-7,-5,3,1,3,1,0,2,-1,4,2,1,0,1,0,2,1,0,0,1,-1,2,-46,-13,-33,-2,0,-2,-14,-6,-9,-5,-2,-8,-7,-2,-2,-2,-1,1,-7,-4,-7,-3,-1,-9,-4,1,1,1,1,-2,-3,1,1,1,0,0,-1,0,0,0,1,-2,-16,-8,-8,-4,-1,-3,0,-1,-5,-7,3,-5,-1,-1,-2,-5,0,0,1,0,-3,-2,3,-5,-1,0,1,0,0,-4,0,0,1,0,0,-2,-1,0,0,0,0,-2,0,9,-9,6,4,2,-3,1,-9,1,12,-1,-1,1,-3,3,6,4,-2,0,-6,-2,6,-5,1,0,-1,2,2,2,0,0,1,0,2,1,1,0,-2,2,0,1,-26,-18,-8,4,1,3,-1,-1,-5,-6,-2,-10,-1,1,-5,-5,-1,-6,0,-2,0,-1,-1,-4,0,0,1,1,2,0,0,0,1,0,0,0,0,0,0,1,2,0,-17,1,-18,-4,-3,-1,-5,3,-6,1,2,-12,-3,1,1,3,3,-4,-2,2,-7,-2,-1,-8,0,0,0,0,-2,-2,0,0,0,0,-1,-2,0,0,0,0,-1,0,30,15,15,4,4,0,4,2,12,9,6,-3,-1,1,7,6,3,-1,5,1,5,3,3,-2,1,0,1,0,3,-1,0,0,1,0,2,1,1,0,0,0,1,-2,-9,-2,-7,4,1,3,1,2,-8,3,-2,-3,2,2,-3,-1,-2,0,-1,0,-5,4,0,-3,0,3,0,-1,0,2,0,1,0,-1,0,1,0,2,0,0,0,1,0,5,-5,2,1,1,-2,6,-5,0,4,-3,-1,5,-3,4,0,0,-1,1,-2,-4,4,-3,0,1,0,0,2,-1,0,1,0,0,0,0,0,0,0,0,2,-1,2,2,0,5,4,1,4,-7,-1,1,9,-5,0,-5,-2,1,7,1,4,-2,1,0,2,-6,1,-1,0,1,5,-1,0,0,0,1,3,0,1,-1,0,0,2,-1,-3,0,-3,6,2,4,6,-3,-7,1,3,-1,3,1,-2,-2,2,0,3,-4,-5,3,1,-1,0,1,0,2,1,2,0,1,0,0,0,1,0,0,0,2,1,1
27,27901,Baralla,3414,26,11,15,3,1,2,1,-4,12,4,2,8,-1,0,6,1,0,3,2,-4,6,3,2,5,2,0,1,0,0,0,1,0,0,0,0,0,1,0,1,0,0,0,-13,-6,-7,8,1,7,5,1,-4,-7,5,-13,2,2,-7,0,2,-5,3,-1,3,-7,3,-8,3,1,2,1,1,0,1,0,0,0,0,0,2,1,2,1,1,0,-15,-9,-6,1,0,1,-4,3,-8,-6,2,-2,-4,1,-3,-3,1,-1,0,2,-5,-3,1,-1,1,0,0,0,0,0,0,0,0,0,0,0,1,0,0,0,0,0,-2,0,-2,3,3,0,0,-3,-9,-1,9,2,-1,-3,-7,-2,8,5,1,0,-2,1,1,-3,1,0,0,2,0,0,1,0,0,1,0,1,0,0,0,1,0,-1,-15,-15,0,3,2,1,2,-7,-17,0,6,0,-1,-3,-8,-2,0,-2,3,-4,-9,2,6,2,1,1,0,0,1,0,1,0,0,0,1,0,0,1,0,0,0,0,-5,-1,-4,2,1,1,-5,4,-12,1,4,2,-3,0,-1,-1,4,0,-2,4,-11,2,0,2,0,0,0,1,2,-1,0,0,0,1,1,-1,0,0,0,0,1,0,-19,3,-22,17,12,5,-2,-4,-6,-4,17,-17,-1,1,-1,-1,10,-3,-1,-5,-5,-3,7,-14,1,1,9,3,1,2,0,1,7,2,0,2,1,0,2,1,1,0,-5,10,-15,43,37,6,-6,2,-2,2,6,-7,-5,6,5,4,1,0,-1,-4,-7,-2,5,-7,0,8,17,13,3,2,1,6,17,10,1,2,-1,2,0,3,2,0,-2,2,-4,12,6,6,9,1,-18,-3,7,1,7,4,-10,-3,5,-2,2,-3,-8,0,2,3,1,6,4,1,1,-1,1,4,1,0,1,-1,0,2,3,1,0,0,5,13,-8,10,5,5,-2,0,3,-3,9,-2,0,-2,8,3,4,1,-2,2,-5,-6,5,-3,2,3,4,2,-1,0,1,1,3,1,-1,0,1,2,1,1,0,0,7,6,1,8,4,4,5,3,-6,0,9,-3,1,3,-4,-1,5,2,4,0,-2,1,4,-5,1,1,3,1,0,2,0,0,2,1,0,1,1,1,1,0,0,1,-12,-18,6,-8,-12,4,-3,3,-11,-10,8,2,-2,-3,-4,-13,4,0,-1,6,-7,3,4,2,1,0,-2,-8,2,-1,0,-1,-2,-8,0,-1,1,1,0,0,2,0,-4,-3,-1,3,2,1,-1,-2,-6,-9,0,16,-3,-2,3,-3,-1,4,2,0,-9,-6,1,12,0,0,2,1,0,0,0,0,1,1,0,0,0,0,1,0,0,0,9,9,0,-3,-4,1,-4,-1,1,0,10,2,-3,-4,2,2,7,3,-1,3,-1,-2,3,-1,0,0,-2,-2,0,0,0,-1,-2,-1,0,-1,0,1,0,-1,0,1,-1,1,-2,-1,3,-4,1,8,-7,2,-4,0,3,7,-6,2,-5,1,-2,1,-1,0,1,-1,-1,-1,1,1,-1,0,0,0,1,3,-1,0,-1,-1,0,-2,0,0,-1,8,-9,8,6,2,-1,0,-11,-3,8,6,0,1,-4,0,5,5,-1,-1,-7,-3,3,1,0,2,2,4,0,-1,0,1,3,2,0,-1,0,1,-1,2,0,0,8,11,-3,7,5,2,6,3,-6,-6,1,12,2,4,-1,-3,2,9,4,-1,-5,-3,-1,3,2,0,1,2,0,2,1,0,0,2,1,1,1,0,1,0,-1,1,5,5,0,13,7,6,10,-7,-7,1,7,0,9,-6,-5,0,3,4,1,-1,-2,1,4,-4,5,3,1,3,0,0,3,2,0,2,0,0,2,1,1,1,0,0
27,27902,Burela,7939,47,43,4,35,17,18,-2,-3,14,5,1,28,-3,1,19,10,0,14,1,-4,-5,-5,1,14,7,2,9,7,4,6,3,1,5,3,1,4,4,1,4,4,3,2,56,26,30,46,24,22,-2,7,23,10,-3,17,2,5,13,2,-3,5,-4,2,10,8,0,12,6,10,19,2,3,5,4,3,13,0,0,3,2,7,6,2,3,2,114,70,44,79,50,29,18,-6,66,13,3,13,19,-11,38,13,1,8,-1,5,28,0,2,5,19,4,31,14,8,3,10,3,20,10,6,1,9,1,11,4,2,2,32,10,22,61,30,31,3,24,7,-3,-7,11,4,12,0,-5,-5,6,-1,12,7,2,-2,5,12,13,12,10,8,6,8,8,3,5,4,2,4,5,9,5,4,4,157,78,79,103,66,37,23,17,51,38,6,16,15,4,32,22,-3,6,8,13,19,16,9,10,20,20,32,24,1,6,14,8,25,15,0,4,6,12,7,9,1,2,192,106,86,174,95,79,47,39,71,9,5,16,24,6,54,5,6,10,23,33,17,4,-1,6,43,34,65,27,2,2,17,16,41,18,2,1,26,18,24,9,0,1,121,70,51,159,96,63,25,28,36,19,-7,23,11,22,27,11,-7,9,14,6,9,8,0,14,39,38,41,26,10,4,22,23,30,14,4,2,17,15,11,12,6,2,289,165,124,211,138,73,64,55,111,64,1,-6,29,40,59,43,5,-8,35,15,52,21,-4,2,38,47,85,33,4,2,18,35,59,21,5,0,20,12,26,12,-1,2,197,99,98,205,120,85,45,42,78,8,-2,19,15,15,55,12,-3,3,30,27,23,-4,1,16,50,46,69,29,5,1,18,26,49,24,2,-1,32,20,20,5,3,2,149,100,49,127,77,50,24,26,65,18,3,13,15,21,36,17,2,8,9,5,29,1,1,5,36,25,47,10,7,2,17,18,28,9,2,3,19,7,19,1,5,-1,60,40,20,86,49,37,4,11,21,10,-1,12,4,15,12,11,-1,0,0,-4,9,-1,0,12,24,17,26,11,4,3,13,8,19,8,0,1,11,9,7,3,4,2,75,63,12,88,53,35,9,19,50,-11,-13,19,9,6,42,4,-4,3,0,13,8,-15,-9,16,23,20,31,11,-1,4,14,10,22,7,0,0,9,10,9,4,-1,4,42,-6,48,23,6,17,15,5,-13,-6,-10,45,7,-6,-20,0,-9,17,8,11,7,-6,-1,28,13,14,-1,-3,0,0,11,5,-5,-3,-2,0,2,9,4,0,2,0,52,1,51,49,20,29,15,31,2,14,2,-13,3,13,-5,-4,1,-8,12,18,7,18,1,-5,8,23,13,3,0,2,4,10,5,2,-1,0,4,13,8,1,1,2,-170,-116,-54,-105,-75,-30,-10,-24,-57,-69,-15,6,-3,-16,-47,-49,-7,6,-7,-8,-10,-20,-8,0,2,-12,-39,-37,-12,-9,2,-6,-29,-32,-8,-3,0,-6,-10,-5,-4,-6,-33,-22,-11,-3,-10,7,1,2,-28,-2,-9,4,1,5,-14,-8,-8,3,0,-3,-14,6,-1,1,6,10,-13,-6,-2,1,4,2,-8,-6,-3,0,2,8,-5,0,1,1,-17,8,-25,34,23,11,-2,-8,-11,-6,0,6,6,3,-2,7,-6,-2,-8,-11,-9,-13,6,8,13,14,3,-2,5,1,12,10,4,-2,-1,0,1,4,-1,0,6,1,15,13,2,16,1,15,8,8,-4,-2,2,1,6,3,0,4,0,-1,2,5,-4,-6,2,2,9,15,-3,-6,-1,0,4,7,-3,-4,-4,-1,5,8,0,-2,3,1
27,27010,Castro de Rei,5952,67,27,40,6,3,3,-1,6,6,8,17,31,-3,3,-3,3,12,14,2,3,9,5,5,17,1,0,2,1,1,1,0,0,0,1,1,1,1,0,2,0,0,0,90,38,52,15,5,10,6,-5,10,5,9,64,5,3,-2,1,8,22,1,-8,12,4,1,42,4,3,5,3,0,0,2,1,1,1,0,0,2,2,4,2,0,0,79,38,41,5,2,3,5,8,6,-3,18,45,2,-2,14,2,5,18,3,10,-8,-5,13,27,0,1,1,1,1,1,0,0,0,1,0,1,0,1,1,0,1,0,37,24,13,10,5,5,5,-3,0,3,3,26,0,1,9,0,1,12,5,-4,-9,3,2,14,2,0,5,0,1,2,2,0,2,0,0,1,0,0,3,0,1,1,31,25,6,14,9,5,2,-7,-15,15,9,28,5,4,-5,9,4,9,-3,-11,-10,6,5,19,3,3,5,2,1,0,1,2,3,2,1,0,2,1,2,0,0,0,90,41,49,23,21,2,18,13,14,5,2,37,5,9,10,3,1,13,13,4,4,2,1,24,0,9,7,6,1,0,0,9,6,5,1,0,0,0,1,1,0,0,50,28,22,16,9,7,-1,-1,7,10,3,33,3,-1,1,6,5,15,-4,0,6,4,-2,18,1,4,7,1,1,2,0,2,5,0,0,2,1,2,2,1,1,0,55,28,27,22,7,15,20,9,-11,10,2,24,7,7,-7,6,4,10,13,2,-4,4,-2,14,4,5,6,6,1,0,1,1,2,2,1,0,3,4,4,4,0,0,63,22,41,22,10,12,4,6,5,8,-2,42,1,-4,7,6,-4,16,3,10,-2,2,2,26,1,6,10,5,0,0,0,3,5,3,-1,0,1,3,5,2,1,0,-19,-18,-1,-6,-7,1,-19,-9,-23,-9,4,36,-9,-4,-6,-11,0,12,-10,-5,-17,2,4,24,2,-5,0,-2,-1,0,2,-4,-2,-2,-1,0,0,-1,2,0,0,0,4,9,-5,8,3,5,-5,-6,-12,2,-2,28,-1,-3,-3,6,0,10,-4,-3,-9,-4,-2,18,2,2,4,0,-1,1,1,1,2,-1,-1,1,1,1,2,1,0,0,16,-1,17,9,5,4,3,2,-20,-3,24,7,1,-1,-11,-2,13,-3,2,3,-9,-1,11,10,4,0,1,-1,1,2,1,0,0,0,1,1,3,0,1,-1,0,1,-60,-50,-10,7,4,3,1,13,-6,-13,-32,-23,0,7,-2,-6,-26,-20,1,6,-4,-7,-6,-3,1,3,2,0,1,0,1,1,1,0,1,0,0,2,1,0,0,0,58,33,25,8,4,4,16,3,-8,16,5,21,8,3,0,6,6,5,8,0,-8,10,-1,16,2,4,2,1,0,-1,2,2,1,0,0,-1,0,2,1,1,0,0,12,-12,24,1,-4,5,3,-11,9,-20,0,30,-3,-6,2,-13,-1,9,6,-5,7,-7,1,21,0,1,2,-3,-1,2,0,0,0,-4,-1,1,0,1,2,1,0,1,-4,-8,4,6,1,5,-2,-5,-8,-3,-3,16,-7,-7,-4,0,0,9,5,2,-4,-3,-3,7,0,4,1,1,1,-1,-1,1,1,0,1,-1,1,3,0,1,0,0,47,32,15,3,0,3,3,4,13,-12,9,27,4,3,10,-6,6,14,-1,1,3,-6,3,13,1,1,3,-3,-1,2,0,0,2,-1,-2,1,1,1,1,-2,1,1,84,48,36,9,5,4,11,5,6,7,16,40,9,1,3,1,11,23,2,4,3,6,5,17,2,2,3,1,1,0,2,1,1,0,1,0,0,1,2,1,0,0
27,27013,Cervo,5092,4,-14,18,11,2,9,5,-13,10,-13,4,10,-3,-11,0,-7,2,4,8,-2,10,-6,2,6,1,1,4,0,2,3,0,0,0,0,1,1,1,1,4,0,1,2,-20,-10,-10,2,1,1,1,-3,-9,-5,-5,1,-1,-1,-1,-4,-2,-1,2,-2,-8,-1,-3,2,0,0,0,0,2,0,0,0,0,0,1,0,0,0,0,0,1,0,27,15,12,8,3,5,-4,12,3,1,4,10,-6,16,3,-5,3,3,2,-4,0,6,1,7,1,2,1,1,1,2,0,2,-1,1,1,0,1,0,2,0,0,2,-47,-25,-22,-3,-4,1,6,-16,-28,-9,-6,8,7,-11,-12,-5,-5,3,-1,-5,-16,-4,-1,5,0,-1,0,0,-1,-1,0,-1,0,-1,-1,-1,0,0,0,1,0,0,-15,-7,-8,24,12,12,5,-1,-5,-8,-11,1,0,-1,1,-2,-7,0,5,0,-6,-6,-4,1,5,3,9,3,2,1,2,0,6,1,1,1,3,3,3,2,1,0,-73,-44,-29,7,6,1,-13,-14,-34,-8,-6,2,-10,-7,-18,-3,-6,1,-3,-7,-16,-5,0,1,0,1,4,2,0,-1,0,1,3,2,0,0,0,0,1,0,0,-1,-39,-16,-23,4,1,3,-1,-4,-32,-8,2,4,-1,2,-18,-1,0,1,0,-6,-14,-7,2,3,1,1,3,-1,0,0,-1,2,1,-1,0,0,2,-1,2,0,0,0,-33,-1,-32,45,38,7,-14,-8,-10,-1,3,-3,-7,-1,0,5,3,-2,-7,-7,-10,-6,0,-1,2,4,29,7,2,1,1,4,24,7,1,1,1,0,5,0,1,0,-2,26,-28,62,54,8,12,0,-8,1,-6,2,11,-1,13,1,0,2,1,1,-21,0,-6,0,5,12,34,10,2,-1,4,8,33,8,2,-1,1,4,1,2,0,0,-56,-28,-28,18,5,13,6,-15,-38,-15,11,-4,3,-6,-16,-8,4,-4,3,-9,-22,-7,7,0,13,4,-5,2,4,0,7,3,-8,2,1,0,6,1,3,0,3,0,-9,-40,31,-18,-22,4,7,-5,-45,18,9,3,-1,-10,-39,4,5,-1,8,5,-6,14,4,4,3,-2,-16,-5,1,0,0,-1,-16,-5,0,0,3,-1,0,0,1,0,-59,-32,-27,7,4,3,-14,0,-15,-22,-6,-1,-4,4,-19,-8,-3,-1,-10,-4,4,-14,-3,0,2,3,5,1,-4,0,2,2,2,1,-3,0,0,1,3,0,-1,0,-20,6,-26,7,4,3,9,2,-10,-9,-4,-6,8,5,-3,0,0,-4,1,-3,-7,-9,-4,-2,6,4,-1,-1,0,-1,6,3,-3,-1,0,-1,0,1,2,0,0,0,-27,-15,-12,-12,-5,-7,-3,-3,-17,-1,0,-1,0,-3,-10,0,0,-1,-3,0,-7,-1,0,0,-1,-4,-5,-2,0,0,0,-1,-3,-1,0,0,-1,-3,-2,-1,0,0,-15,-13,-2,-7,-3,-4,8,-2,-4,-7,-9,-1,6,-1,-5,-5,-7,-1,2,-1,1,-2,-2,0,-1,0,-1,-1,-4,0,0,1,-1,0,-3,0,-1,-1,0,-1,-1,0,-24,-17,-7,2,0,2,-5,-6,-2,-14,3,-1,-3,-1,-2,-11,2,-2,-2,-5,0,-3,1,1,2,0,1,-1,0,0,1,0,0,-1,0,0,1,0,1,0,0,0,8,8,0,3,0,3,5,4,2,6,-2,-9,2,2,-1,4,1,-1,3,2,3,2,-3,-8,1,1,0,1,0,0,0,0,0,0,0,0,1,1,0,1,0,0,-19,-9,-10,6,2,4,2,-1,-8,-4,0,-10,-1,5,-3,-4,-4,-3,3,-6,-5,0,4,-7,1,2,1,-3,3,0,0,1,1,-1,0,0,1,1,0,-2,3,0
27,27016,Chantada,9871,35,9,26,39,16,23,7,4,2,9,10,3,2,-4,-2,5,6,2,5,8,4,4,4,1,6,5,9,6,5,8,2,3,3,3,2,3,4,2,6,3,3,5,-11,-7,-4,31,13,18,-1,0,-13,-2,2,2,3,-4,-7,0,-1,1,-4,4,-6,-2,3,1,9,3,8,5,3,2,4,1,1,4,1,1,5,2,7,1,2,1,31,17,14,49,24,25,12,-9,-1,-11,27,12,9,-6,-7,-6,16,10,3,-3,6,-5,11,2,17,2,9,6,6,8,11,0,2,2,5,3,6,2,7,4,1,5,-59,-37,-22,12,7,5,-7,-5,-11,-30,-3,-1,-2,-2,-8,-17,-3,-3,-5,-3,-3,-13,0,2,3,1,0,7,0,1,2,1,0,4,-1,1,1,0,0,3,1,0,-5,-6,1,29,13,16,-5,-4,-28,2,1,29,-8,-1,-11,3,1,13,3,-3,-17,-1,0,16,2,2,4,6,7,7,1,1,0,6,1,4,1,1,4,0,6,3,30,9,21,14,5,9,11,-5,9,-1,11,3,6,-5,-1,-3,8,3,5,0,10,2,3,0,3,-1,8,1,3,0,2,-1,4,0,1,-1,1,0,4,1,2,1,29,-8,37,36,13,23,-6,6,-10,23,10,5,-11,1,-11,9,7,-2,5,5,1,14,3,7,2,11,4,10,6,2,1,3,0,5,4,0,1,8,4,5,2,2,11,7,4,46,19,27,3,-1,-6,9,5,-1,-2,1,-1,4,2,3,5,-2,-5,5,3,-4,12,1,16,8,1,6,5,1,4,5,1,2,7,0,12,3,0,4,-8,0,-8,43,21,22,8,7,5,1,-2,-24,5,-2,7,0,-1,-7,3,9,-2,1,-1,-17,10,13,17,3,3,-4,5,3,10,2,1,-1,5,10,7,1,2,-3,26,21,5,18,10,8,-1,7,10,3,28,-23,4,1,1,5,19,-11,-5,6,9,-2,9,-12,1,5,6,3,5,-3,1,2,2,2,4,-2,0,3,4,1,1,-1,60,24,36,20,12,8,8,13,-3,-6,13,33,3,12,-6,-1,3,12,5,1,3,-5,10,21,3,6,3,7,-2,2,3,4,1,4,-2,1,0,2,2,3,0,1,45,24,21,33,17,16,10,-6,7,10,19,-1,3,-5,1,14,5,3,7,-1,6,-4,14,-4,8,4,7,10,4,-1,4,1,3,6,4,-2,4,3,4,4,0,1,-17,-2,-15,22,9,13,-12,-4,10,-1,5,-14,-6,-5,14,1,2,-7,-6,1,-4,-2,3,-7,6,4,8,2,3,-1,3,2,3,-2,2,1,3,2,5,4,1,-2,26,8,18,16,8,8,12,6,10,-7,7,-1,3,-2,2,4,7,-5,9,8,8,-11,0,4,6,4,2,2,2,0,0,3,4,1,2,-2,6,1,-2,1,0,2,26,-2,28,24,7,17,10,4,-19,9,12,10,5,2,-13,3,6,-3,5,2,-6,6,6,13,6,6,2,4,4,2,2,3,-1,2,1,0,4,3,3,2,3,2,47,17,30,19,9,10,6,8,4,-4,8,25,4,4,3,-6,3,10,2,4,1,2,5,15,13,2,0,-2,2,3,7,0,1,-1,0,2,6,2,-1,-1,2,1,42,24,18,36,19,17,18,0,-10,8,17,6,15,-3,-4,3,4,6,3,3,-6,5,13,0,7,3,13,5,4,2,6,2,6,1,-1,3,1,1,7,4,5,-1,61,12,49,33,12,21,18,18,5,1,4,13,6,6,1,-5,1,2,12,12,4,6,3,11,13,1,8,7,1,2,5,-1,4,4,-1,0,8,2,4,3,2,2
27,27015,Cospeito,5971,-26,-13,-13,6,2,4,-9,-4,-13,-1,7,-6,-4,-3,-3,-5,4,-2,-5,-1,-10,4,3,-4,1,2,0,2,0,1,0,1,0,1,0,0,1,1,0,1,0,1,-48,-23,-25,4,3,1,-12,0,-14,-15,0,-7,-12,4,-5,-9,-1,0,0,-4,-9,-6,1,-7,0,1,2,0,0,1,0,1,2,0,0,0,0,0,0,0,0,1,-3,-10,7,9,6,3,3,-12,-2,1,7,1,-3,-5,-4,-4,4,1,6,-7,2,5,3,0,3,1,1,1,1,2,3,1,1,-1,0,2,0,0,0,2,1,0,-9,8,-17,3,1,2,-4,-9,-5,3,7,1,1,0,-4,5,5,4,-5,-9,-1,-2,2,-3,0,0,0,0,2,1,0,0,0,0,0,1,0,0,0,0,2,0,18,9,9,6,6,0,-7,4,-8,6,15,9,-3,-2,-2,3,7,7,-4,6,-6,3,8,2,2,0,2,2,0,0,2,1,2,1,0,0,0,-1,0,1,0,0,-23,-7,-16,4,2,2,-7,6,-7,3,-2,-15,-3,9,-11,0,2,-5,-4,-3,4,3,-4,-10,0,2,1,1,0,0,0,1,0,0,0,1,0,1,1,1,0,-1,-7,6,-13,9,5,4,3,0,-8,-2,3,-3,6,0,-1,0,1,0,-3,0,-7,-2,2,-3,2,1,2,2,2,0,2,0,1,2,1,-1,0,1,1,0,1,1,-22,-5,-17,17,10,7,2,-6,-4,1,-2,-13,0,-2,3,2,-1,-6,2,-4,-7,-1,-1,-7,0,7,3,5,1,1,-1,5,2,4,1,-1,1,2,1,1,0,2,9,13,-4,13,8,5,11,-1,-1,2,2,-3,7,4,-3,2,-2,6,4,-5,2,0,4,-9,5,2,5,3,0,-2,4,0,4,1,0,-1,1,2,1,2,0,-1,-6,2,-8,7,4,3,0,-2,-6,10,-2,-4,-2,1,2,4,-2,0,2,-3,-8,6,0,-4,-1,1,2,2,2,1,-1,0,1,2,1,1,0,1,1,0,1,0,2,0,2,3,2,1,9,1,-18,8,10,-8,3,0,-11,2,10,-4,6,1,-7,6,0,-4,1,0,1,0,0,1,1,0,0,0,0,1,0,0,1,0,0,0,13,12,1,-2,-1,-1,10,6,2,5,5,-16,2,5,7,1,1,-5,8,1,-5,4,4,-11,-3,0,-2,-1,3,1,-3,1,-1,0,2,0,0,-1,-1,-1,1,1,-34,-9,-25,1,0,1,-6,-3,-8,-1,-5,-14,-2,-1,-6,5,-3,-3,-4,-2,-2,-6,-2,-11,0,0,0,1,0,0,0,-1,0,1,0,0,0,1,0,0,0,0,20,14,6,1,-3,4,10,-4,4,9,-1,1,6,-3,2,7,-3,1,4,-1,2,2,2,0,0,1,0,0,0,0,-1,0,-1,0,-1,0,1,1,1,0,1,0,-18,-11,-7,2,1,1,2,-4,-7,-1,5,-13,-1,-4,-2,0,1,-4,3,0,-5,-1,4,-9,0,2,0,0,0,0,0,1,0,0,0,0,0,1,0,0,0,0,-2,-3,1,3,2,1,5,0,-12,-6,9,2,4,1,-6,-2,1,-1,1,-1,-6,-4,8,3,1,-1,2,0,1,0,1,-1,1,0,1,0,0,0,1,0,0,0,-28,-16,-12,5,3,2,-8,-3,-4,-9,6,-9,-5,-4,-4,-8,7,-1,-3,1,0,-1,-1,-8,1,2,-1,0,1,1,1,0,-1,0,1,1,0,2,0,0,0,0,-10,-1,-9,6,3,3,-1,-4,-8,7,11,-15,-4,-1,-1,5,3,-4,3,-3,-7,2,8,-11,1,1,1,0,3,0,0,0,2,0,1,0,1,1,-1,0,2,0
27,27019,Foz,9527,149,85,64,45,24,21,15,17,40,30,27,18,16,14,22,9,15,9,-1,3,18,21,12,9,8,12,9,9,3,4,5,9,5,1,2,2,3,3,4,8,1,2,1,-2,3,23,15,8,13,1,-8,14,-9,-9,7,-4,-12,13,0,-6,6,5,4,1,-9,-3,5,6,10,1,0,1,4,5,4,1,0,1,1,1,6,0,0,0,38,16,22,37,15,22,18,-11,1,19,12,-1,3,-5,-5,13,11,-1,15,-6,6,6,1,0,8,1,8,7,6,6,3,1,1,3,4,2,5,0,7,4,2,4,77,30,47,43,21,22,26,5,14,13,11,4,16,-5,-2,9,3,3,10,10,16,4,8,1,12,12,10,6,3,0,8,4,6,2,1,0,4,8,4,4,2,0,92,56,36,67,32,35,16,14,13,16,9,19,10,12,4,8,7,13,6,2,9,8,2,6,12,26,14,12,3,0,5,10,9,6,2,0,7,16,5,6,1,0,153,128,25,68,41,27,3,22,33,35,34,23,6,25,32,27,19,15,-3,-3,1,8,15,8,4,22,25,11,2,3,2,13,14,9,0,2,2,9,11,2,2,1,138,74,64,86,48,38,31,24,42,19,13,6,7,17,28,11,9,1,24,7,14,8,4,5,11,27,29,12,4,1,3,18,18,6,1,1,8,9,11,6,3,0,101,61,40,115,64,51,0,27,20,19,22,12,3,14,7,17,10,11,-3,13,13,2,12,1,18,20,41,20,8,5,12,8,20,15,5,2,6,12,21,5,3,3,141,71,70,126,54,72,37,33,33,19,11,8,21,20,19,6,1,4,16,13,14,13,10,4,42,27,22,23,7,3,18,11,9,13,2,1,24,16,13,10,5,2,93,31,62,-2,-9,7,30,-3,-1,16,22,23,8,-8,-2,10,15,4,22,5,1,6,7,19,3,-4,-2,1,0,-1,-3,-4,-3,1,0,-1,6,0,1,0,0,0,33,27,6,-10,-11,1,11,6,8,10,7,-2,16,10,-3,3,6,-1,-5,-4,11,7,1,-1,-1,8,-6,-7,-3,-1,-1,6,-4,-10,-1,-1,0,2,-2,3,-2,0,79,41,38,-8,-13,5,24,16,17,29,6,-16,14,6,7,13,8,-8,10,10,10,16,-2,-8,-1,4,-1,-6,-2,-2,-1,-2,-2,-7,-1,0,0,6,1,1,-1,-2,33,31,2,-8,-4,-4,31,-18,1,25,13,-20,23,-7,16,1,8,-9,8,-11,-15,24,5,-11,1,-4,-11,-3,7,2,0,-3,-2,-3,3,1,1,-1,-9,0,4,1,-14,5,-19,-23,-21,-2,-17,2,-13,6,6,2,-5,5,-13,12,1,4,-12,-3,0,-6,5,-2,-7,1,-16,-5,-1,5,-8,0,-14,0,-2,3,1,1,-2,-5,1,2,32,7,25,-2,-8,6,13,-12,-3,6,8,15,5,-7,-13,4,8,5,8,-5,10,2,0,10,-4,2,1,-1,-3,3,-4,0,-2,0,-2,0,0,2,3,-1,-1,3,72,43,29,19,10,9,10,4,-5,21,23,16,5,-5,-1,17,15,6,5,9,-4,4,8,10,5,7,-7,6,7,-1,4,-1,-2,2,4,1,1,8,-5,4,3,-2,70,29,41,15,12,3,4,3,18,21,7,11,-2,-2,22,-5,4,11,6,5,-4,26,3,0,6,3,2,3,0,0,6,1,2,2,-1,1,0,2,0,1,1,-1,115,44,71,29,12,17,8,10,18,26,18,28,-7,6,14,12,7,7,15,4,4,14,11,21,3,6,6,3,7,3,1,2,3,2,5,-2,2,4,3,1,2,5
27,27022,Guitiriz,6451,-5,-4,-1,5,2,3,-3,-2,-14,-1,11,4,-3,-4,-7,2,6,2,0,2,-7,-3,5,2,0,0,1,0,3,1,0,0,0,0,1,1,0,0,1,0,2,0,-29,-22,-7,3,2,1,-7,-10,-4,-8,5,-2,-4,-4,-4,-9,2,-1,-3,-6,0,1,3,-1,1,0,0,2,0,0,1,0,0,1,0,0,0,0,0,1,0,0,-32,-13,-19,3,1,2,0,-13,-6,-4,-3,-4,0,-7,-4,0,-1,1,0,-6,-2,-4,-2,-5,0,0,0,0,3,0,0,0,0,0,1,0,0,0,0,0,2,0,-9,1,-10,8,6,2,-5,-3,-2,-4,0,4,1,2,2,-4,0,0,-6,-5,-4,0,0,4,2,0,0,0,4,2,2,0,1,0,3,0,0,0,-1,0,1,2,7,8,-1,18,6,12,5,-7,-18,8,8,10,4,-3,-10,7,4,5,1,-4,-8,1,4,5,2,1,6,4,3,1,1,0,0,3,1,0,1,1,6,1,2,1,8,-7,15,1,0,1,2,5,-1,0,2,-3,-3,4,-10,0,0,0,5,1,9,0,2,-3,1,1,1,-1,0,-1,0,0,0,0,0,0,1,1,1,-1,0,-1,27,33,-6,14,9,5,-2,1,-8,22,10,5,6,-3,1,22,5,3,-8,4,-9,0,5,2,3,1,2,5,3,0,2,0,2,3,2,0,1,1,0,2,1,0,-1,4,-5,9,6,3,0,-5,2,0,15,-14,0,0,2,-4,11,-5,0,-5,0,4,4,-9,1,1,1,2,3,1,1,1,1,1,1,1,0,0,0,1,2,0,34,28,6,16,8,8,11,10,11,5,1,-6,8,8,9,2,-2,2,3,2,2,3,3,-8,-1,5,4,6,0,1,0,3,2,3,0,0,-1,2,2,3,0,1,-4,-5,1,5,2,3,7,-4,2,-6,10,-11,3,-3,1,-5,4,-5,4,-1,1,-1,6,-6,3,2,3,-3,1,-1,2,2,1,-2,0,-1,1,0,2,-1,1,0,-30,-6,-24,3,3,0,-2,-2,-9,-9,2,-11,-4,-2,-1,-2,3,0,2,0,-8,-7,-1,-11,2,-2,2,-1,2,0,1,-2,2,0,2,0,1,0,0,-1,0,0,-10,5,-15,0,0,0,2,6,-3,-5,1,-9,-1,7,4,-5,1,3,3,-1,-7,0,0,-12,0,3,-3,1,-1,0,0,3,-2,0,-1,0,0,0,-1,1,0,0,24,8,16,-7,-6,-1,9,0,-7,6,9,6,6,-2,-7,4,4,2,3,2,0,2,5,4,-1,1,-1,-4,-1,-1,-2,0,-1,-2,-1,0,1,1,0,-2,0,-1,14,9,5,-1,1,-2,7,0,11,2,2,-13,2,1,2,2,3,-3,5,-1,9,0,-1,-10,1,1,0,0,-3,0,1,0,0,1,-1,0,0,1,0,-1,-2,0,5,12,-7,9,4,5,1,-2,5,5,5,-8,0,-3,9,3,6,-3,1,1,-4,2,-1,-5,0,2,5,0,1,1,0,1,2,-1,1,1,0,1,3,1,0,0,17,5,12,11,5,6,7,3,0,0,9,-2,0,3,-6,2,5,0,7,0,6,-2,4,-2,1,3,2,1,2,1,0,0,3,0,1,0,1,3,-1,1,1,1,49,29,20,48,18,30,3,4,34,12,-1,-4,2,5,14,8,0,-1,1,-1,20,4,-1,-3,5,10,21,12,-2,1,2,6,6,5,-2,0,3,4,15,7,0,1,47,22,25,74,30,44,-2,13,22,24,3,-14,-4,6,9,9,3,-2,2,7,13,15,0,-12,1,19,29,23,1,0,0,9,12,7,1,0,1,10,17,16,0,0
27,27027,Lourenzá,2884,-7,1,-8,16,9,7,-2,-3,-10,1,3,4,-2,2,-3,-2,2,3,0,-5,-7,3,1,1,2,3,0,4,4,3,1,1,0,2,3,2,1,2,0,2,1,1,-4,5,-9,15,11,4,2,-2,-6,6,0,-4,1,1,1,2,0,0,1,-3,-7,4,0,-4,1,3,3,5,2,1,1,2,3,3,1,1,0,1,0,2,1,0,-14,-10,-4,1,0,1,3,-4,-6,-8,1,-1,0,-2,-7,-4,3,-1,3,-2,1,-4,-2,0,0,-1,2,0,0,0,0,-1,1,0,0,0,0,0,1,0,0,0,15,9,6,12,7,5,1,7,8,1,0,-2,1,3,9,1,-2,-3,0,4,-1,0,2,1,2,3,5,2,0,0,1,2,4,1,-1,0,1,1,1,1,1,0,6,10,-4,21,16,5,-1,7,-2,-6,9,1,1,6,5,-4,5,-1,-2,1,-7,-2,4,2,4,8,3,1,3,2,4,5,3,1,2,1,0,3,0,0,1,1,-3,10,-13,25,21,4,3,-2,3,3,-2,-8,0,5,4,2,0,-1,3,-7,-1,1,-2,-7,8,5,8,4,0,0,4,6,8,3,0,0,4,-1,0,1,0,0,8,1,7,26,18,8,9,6,0,-1,-1,-5,4,2,-1,0,0,-4,5,4,1,-1,-1,-1,2,10,10,2,1,0,1,6,8,2,1,0,1,4,2,0,0,0,-15,-2,-13,17,11,6,2,-2,-4,-6,-3,-1,1,0,1,-5,-1,2,1,-2,-5,-1,-2,-3,2,8,3,3,0,1,1,6,2,1,0,1,1,2,1,2,0,0,0,0,0,24,13,11,17,-3,-6,-5,-3,0,9,-5,-4,1,-2,1,8,2,-2,-6,-1,-1,11,7,5,1,0,0,7,2,3,1,0,0,4,5,2,0,0,0,-10,-11,1,7,2,5,-8,2,2,0,-1,-9,-5,-1,-2,-2,1,-2,-3,3,4,2,-2,-7,2,1,3,1,0,-1,0,1,1,1,0,-1,2,0,2,0,0,0,-34,-16,-18,-10,-8,-2,2,-4,-15,-12,-1,-4,1,-4,-3,-7,-2,-1,1,0,-12,-5,1,-3,0,-1,-4,-4,0,-1,0,-1,-4,-3,0,0,0,0,0,-1,0,-1,-22,-18,-4,5,1,4,-8,-7,0,-7,0,1,-3,-3,-6,-6,-2,3,-5,-4,6,-1,2,-2,1,0,1,2,1,0,0,0,0,1,0,0,1,0,1,1,1,0,-9,-8,-1,-1,-2,1,-2,-1,-2,6,-3,-6,-2,0,-4,3,-2,-3,0,-1,2,3,-1,-3,0,0,-1,-1,1,0,0,0,-1,-1,0,0,0,0,0,0,1,0,11,5,6,5,0,5,1,2,-4,2,7,3,3,-2,-4,3,3,2,-2,4,0,-1,4,1,1,1,0,1,1,1,0,-1,-1,1,0,1,1,2,1,0,1,0,-9,-6,-3,2,1,1,-1,0,-6,-8,4,1,-2,-2,0,-4,2,0,1,2,-6,-4,2,1,0,0,-1,0,2,0,0,0,1,-1,1,0,0,0,-2,1,1,0,-28,-3,-25,6,5,1,0,-5,-7,-5,-2,-9,2,-3,3,-1,0,-4,-2,-2,-10,-4,-2,-5,0,2,3,1,0,-1,1,0,3,1,0,-1,-1,2,0,0,0,0,-6,-6,0,-4,-3,-1,2,1,-4,3,-4,-4,1,0,-3,1,-4,-1,1,1,-1,2,0,-3,-2,1,1,-3,-1,0,-1,1,0,-2,-1,0,-1,0,1,-1,0,0,-2,0,-2,4,2,2,0,6,-2,-1,-2,-3,3,4,-6,2,0,-1,-3,2,4,-3,-2,-2,1,2,1,0,-1,1,1,2,-2,1,0,0,0,0,3,-1,-1,1
27,27028,Lugo,87480,156,72,84,71,34,37,117,-59,114,22,-34,0,56,-46,42,27,-18,14,61,-13,72,-5,-16,-14,6,7,13,16,11,17,1,4,5,8,4,12,5,3,8,8,7,5,110,2,108,33,15,18,88,-39,61,41,-23,-20,41,-39,12,19,-21,-9,47,0,49,22,-2,-11,11,5,4,3,6,3,2,3,2,2,3,2,9,2,2,1,3,1,646,238,408,456,195,261,239,88,123,159,-21,51,111,50,15,58,-12,15,128,38,108,101,-9,36,96,99,112,81,37,26,47,49,38,32,20,7,49,50,74,49,17,19,601,269,332,498,222,276,218,34,239,30,50,29,110,10,66,16,35,27,108,24,173,14,15,2,119,100,129,73,52,23,59,45,47,35,23,12,60,55,82,38,29,11,898,427,471,560,260,300,279,137,304,128,14,22,176,44,137,57,-2,7,103,93,167,71,16,15,135,142,129,93,32,21,85,52,52,40,18,10,50,90,77,53,14,11,1169,477,692,671,287,384,264,173,375,221,39,76,116,59,154,102,2,36,148,114,221,119,37,40,131,182,181,110,37,24,68,69,68,50,19,11,63,113,113,60,18,13,894,311,583,839,347,492,194,151,345,132,6,51,72,44,129,41,-12,29,122,107,216,91,18,22,199,186,252,136,42,18,92,76,102,54,15,5,107,110,150,82,27,13,1363,650,713,831,429,402,221,225,449,219,80,147,98,113,211,125,31,54,123,112,238,94,49,93,169,229,229,134,53,9,80,118,129,71,20,4,89,111,100,63,33,5,1176,541,635,635,314,321,231,131,461,167,80,88,94,47,237,82,39,36,137,84,224,85,41,52,140,168,189,99,23,4,63,66,107,55,11,7,77,102,82,44,12,-3,909,411,498,320,114,206,138,120,387,169,8,82,51,48,197,89,-8,29,87,72,190,80,16,53,115,76,81,33,9,3,46,27,27,12,0,0,69,49,54,21,9,3,359,156,203,304,143,161,65,74,159,47,-12,34,42,22,63,24,-20,19,23,52,96,23,8,15,80,84,44,56,29,5,36,37,21,26,18,1,44,47,23,30,11,4,468,172,296,150,62,88,68,23,220,72,-3,82,33,-9,78,25,7,38,35,32,142,47,-10,44,56,59,12,3,-3,18,37,27,-4,-4,-6,11,19,32,16,7,3,7,361,99,262,162,69,93,53,89,106,95,14,22,12,47,7,51,-8,2,41,42,99,44,22,20,42,85,1,5,24,3,12,45,1,-3,12,0,30,40,0,8,12,3,-17,-58,41,-52,-26,-26,22,-11,2,-11,-12,3,31,-12,-28,-34,-21,12,-9,1,30,23,9,-9,3,23,-46,-40,0,4,13,6,-18,-27,-4,3,-10,17,-28,-13,4,1,-181,-191,10,-68,-56,-12,-14,-49,-33,-74,-39,19,-11,-33,-59,-58,-35,-3,-3,-16,26,-16,-4,22,32,12,-69,-40,5,-11,10,0,-36,-24,-7,-2,22,12,-33,-16,12,-9,419,119,300,182,73,109,47,65,190,32,26,47,23,7,75,-17,7,16,24,58,115,49,19,31,56,27,40,25,19,10,33,13,4,5,9,8,23,14,36,20,10,2,108,-21,129,307,139,168,-19,56,-21,23,-13,98,-12,41,-42,-16,-28,38,-7,15,21,39,15,60,61,87,57,51,20,22,32,45,21,16,5,13,29,42,36,35,15,9,375,110,265,377,174,203,81,82,70,32,-23,125,28,29,31,-10,-26,56,53,53,39,42,3,69,66,102,106,42,32,21,36,38,50,21,12,14,30,64,56,21,20,7
27,27030,Mondoñedo,5139,-10,-10,0,11,4,7,-2,-1,-8,-2,4,-1,-2,-1,-6,-3,1,1,0,0,-2,1,3,-2,2,0,1,3,4,1,1,0,0,1,1,1,1,0,1,2,3,0,20,11,9,9,3,6,4,0,-6,6,8,8,4,0,-3,5,4,1,0,0,-3,1,4,7,1,0,1,1,5,1,0,0,1,1,1,0,1,0,0,0,4,1,19,9,10,5,2,3,1,7,-12,1,8,14,0,-1,-4,2,4,8,1,8,-8,-1,4,6,1,1,1,1,1,0,0,0,1,1,0,0,1,1,0,0,1,0,52,25,27,10,7,3,4,10,12,3,3,16,7,5,6,0,2,4,-3,5,6,3,1,12,0,3,1,2,0,3,0,1,1,1,1,2,0,2,0,1,-1,1,16,12,4,18,11,7,5,-2,-5,-2,12,9,2,-1,-1,-1,10,4,3,-1,-4,-1,2,5,6,1,5,1,1,4,4,1,4,0,0,2,2,0,1,1,1,2,-24,-4,-20,21,15,6,-3,-2,-10,0,1,-6,-1,0,-1,2,-1,-2,-2,-2,-9,-2,2,-4,4,7,3,5,4,-2,2,6,2,4,2,-1,2,1,1,1,2,-1,1,14,-13,33,29,4,3,0,8,1,3,-15,2,1,14,0,4,-7,1,-1,-6,1,-1,-8,3,10,13,6,1,0,2,10,13,3,1,0,1,0,0,3,0,0,-31,-12,-19,13,11,2,-6,-10,-16,-4,-2,4,-3,-2,-7,-3,-2,4,-3,-8,-9,-1,0,0,-1,2,7,3,0,1,-1,1,8,2,0,1,0,1,-1,1,0,0,-15,-2,-13,15,7,8,5,1,-20,5,3,-8,5,0,-8,0,2,0,0,1,-12,5,1,-8,3,3,6,4,-1,0,2,2,3,1,-1,0,1,1,3,3,0,0,-27,-11,-16,3,-1,4,7,-6,-18,1,2,-14,4,-1,-13,4,1,-6,3,-5,-5,-3,1,-8,2,0,-2,2,0,1,1,-1,-3,1,0,1,1,1,1,1,0,0,-41,-23,-18,8,7,1,-6,0,-15,-9,-2,-8,-4,5,-10,-6,-1,-7,-2,-5,-5,-3,-1,-1,0,5,3,1,-1,0,0,2,3,2,0,0,0,3,0,-1,-1,0,-38,-15,-23,8,4,4,-7,5,-29,-13,1,6,-1,0,-18,-3,1,7,-6,5,-11,-10,0,-1,3,3,0,2,1,-1,2,1,-1,2,0,0,1,2,1,0,1,-1,-40,-21,-19,5,-1,6,-2,1,-14,-9,-1,-14,-3,0,-7,-5,-1,-4,1,1,-7,-4,0,-10,1,1,1,0,2,0,0,0,-1,-1,1,0,1,1,2,1,1,0,-27,-12,-15,-7,-1,-6,-7,-7,-8,-9,2,-2,-4,-3,1,-6,0,-1,-3,-4,-9,-3,2,-1,-2,-2,1,-2,0,-2,-1,0,2,-1,0,-1,-1,-2,-1,-1,0,-1,-48,-16,-32,2,1,1,-9,0,-11,-9,0,-17,-4,-1,-2,-4,-1,-3,-5,1,-9,-5,1,-14,-2,1,0,-1,1,3,-2,-1,1,-1,1,3,0,2,-1,0,0,0,6,3,3,-3,0,-3,0,5,-9,-2,2,8,2,2,-4,-3,-1,6,-2,3,-5,1,3,2,-1,1,-1,0,0,-2,0,1,0,0,0,-1,-1,0,-1,0,0,-1,-40,-19,-21,-2,-2,0,-1,-8,-11,-16,4,-7,0,-1,-9,-7,0,-1,-1,-7,-2,-9,4,-6,0,-1,0,-3,2,0,0,0,-1,-2,0,1,0,-1,1,-1,2,-1,-42,-17,-25,0,1,-1,-3,-10,-8,-4,-4,-11,-2,-8,-1,3,-3,-5,-1,-2,-7,-7,-1,-6,0,0,-1,2,0,-1,0,0,0,2,0,-1,0,0,-1,0,0,0
27,27031,Monforte de Lemos,20007,67,22,45,64,30,34,28,-2,-8,-10,40,24,18,-8,-10,-9,20,14,10,6,2,-1,20,10,16,8,14,6,13,7,10,4,3,2,5,6,6,4,11,4,8,1,131,48,83,83,40,43,18,20,18,10,29,34,3,1,16,-2,13,15,15,19,2,12,16,19,30,10,15,17,7,4,15,3,10,7,2,3,15,7,5,10,5,1,-12,-40,28,86,36,50,11,-17,-18,-2,4,3,-7,-12,-20,-6,0,4,18,-5,2,4,4,-1,20,23,18,3,7,10,8,9,5,3,1,7,12,14,13,0,6,3,67,40,27,114,53,61,17,-13,-3,3,35,28,14,-4,0,-2,16,17,3,-9,-3,5,19,11,26,10,38,19,11,9,17,3,20,6,4,3,9,7,18,13,7,6,137,56,81,109,51,58,22,15,15,7,30,45,10,6,-7,7,24,15,12,9,22,0,6,30,27,22,16,17,15,11,14,8,4,11,10,4,13,14,12,6,5,7,112,51,61,109,47,62,13,25,7,21,38,6,6,-2,-2,13,26,8,7,27,9,8,12,-2,21,21,29,13,14,9,11,5,14,3,6,7,10,16,15,10,8,2,150,89,61,140,72,68,35,7,-2,21,39,46,20,10,-7,15,19,29,15,-3,5,6,20,17,28,34,19,25,23,8,14,15,9,16,10,6,14,19,10,9,13,2,292,195,97,190,111,79,53,42,59,60,39,38,39,27,56,31,24,17,14,15,3,29,15,21,32,46,57,31,15,10,22,19,40,17,8,5,10,27,17,14,7,5,236,170,66,185,109,76,33,47,52,55,50,1,21,44,35,37,28,8,12,3,17,18,22,-7,27,39,60,32,27,-1,16,25,34,22,13,-1,11,14,26,10,14,0,184,68,116,110,48,62,43,34,35,21,25,19,17,9,8,5,8,18,26,25,27,16,17,1,29,20,27,18,8,5,13,9,12,8,1,4,16,11,15,10,7,1,147,40,107,90,36,54,21,28,17,14,8,54,9,5,0,-6,5,26,12,23,17,20,3,28,22,27,17,21,-5,7,10,12,6,8,-1,1,12,15,11,13,-4,6,296,145,151,122,63,59,49,27,17,42,30,131,25,16,17,27,11,51,24,11,0,15,19,80,35,31,26,15,12,2,20,16,11,10,5,1,15,15,15,5,7,1,116,50,66,-21,-20,-1,26,20,-19,-13,21,81,22,5,-10,-18,16,34,4,15,-9,5,5,47,16,12,-12,-20,-4,-14,10,7,-8,-16,-6,-8,6,5,-4,-4,2,-6,20,-1,21,-21,-14,-7,1,-6,-22,-2,25,27,1,-12,-16,2,10,15,0,6,-6,-4,15,12,4,4,-18,-19,6,2,4,0,-10,-12,3,1,0,4,-8,-7,3,1,55,1,54,16,4,12,5,10,-32,10,12,44,-3,-1,-19,-8,6,23,8,11,-13,18,6,21,6,14,-9,-2,8,-2,3,7,-4,-7,5,-1,3,7,-5,5,3,-1,134,69,65,59,21,38,21,-14,-3,-21,54,96,4,-11,11,-17,34,48,17,-3,-14,-4,20,48,9,15,20,-8,10,11,-1,9,12,-10,6,5,10,6,8,2,4,6,157,117,40,56,39,17,14,36,-27,13,17,107,15,21,4,7,19,51,-1,15,-31,6,-2,56,1,31,1,11,3,7,1,24,4,8,1,0,0,7,-3,3,2,7,118,49,69,132,65,67,15,-1,2,7,8,91,2,-1,3,1,-2,48,13,0,-1,6,10,43,22,28,36,26,13,6,9,15,22,12,4,3,13,13,14,14,9,3
27,27032,Monterroso,4265,-8,-10,2,13,5,8,-7,-3,-12,-7,17,3,-2,-4,-9,-3,7,1,-5,1,-3,-4,10,2,1,3,2,1,3,3,1,1,0,0,2,1,0,2,2,1,1,2,68,64,4,51,46,5,7,13,17,10,25,-4,6,11,21,11,16,-1,1,2,-4,-1,9,-3,4,9,18,13,7,0,3,9,17,13,4,0,1,0,1,0,3,0,9,6,3,21,15,6,8,-7,-3,4,4,2,5,-7,-3,6,4,-1,3,0,0,-2,0,3,4,1,5,7,4,0,2,1,2,6,3,1,2,0,3,1,1,-1,20,17,3,14,7,7,1,5,-3,9,-1,9,6,-1,-1,4,-1,9,-5,6,-2,5,0,0,0,2,0,3,1,8,0,0,1,1,0,5,0,2,-1,2,1,3,7,0,7,14,5,9,6,-8,-4,-2,4,9,3,-9,-3,1,3,5,3,1,-1,-3,1,4,2,2,5,1,1,3,2,-1,3,1,0,0,0,3,2,0,1,3,13,22,-9,32,21,11,3,7,1,-3,15,-7,6,5,8,-1,9,-2,-3,2,-7,-2,6,-5,6,6,5,8,3,4,4,4,4,5,2,2,2,2,1,3,1,2,24,14,10,8,8,0,11,-7,-7,11,9,3,6,2,-4,3,3,2,5,-9,-3,8,6,1,3,0,-1,3,0,3,3,1,-2,3,0,3,0,-1,1,0,0,0,22,2,20,24,6,18,-5,7,10,-3,11,4,-5,7,7,-9,8,-4,0,0,3,6,3,8,7,5,4,5,3,-1,2,2,-1,0,2,0,5,3,5,5,1,-1,177,166,11,114,103,11,3,42,63,49,25,-6,8,34,55,51,16,-1,-5,8,8,-2,9,-5,3,27,41,30,12,1,1,25,39,27,10,1,2,2,2,3,2,0,-7,-1,-6,-9,-3,-6,-14,6,-7,3,10,-5,-9,4,4,-1,4,-2,-5,2,-11,4,6,-3,-4,0,1,-3,0,-3,-2,-1,2,-1,0,-1,-2,1,-1,-2,0,-2,-50,-53,3,-15,-16,1,6,0,-28,-22,2,-11,1,-5,-24,-19,-4,-5,5,5,-4,-3,6,-6,1,-1,-6,-3,-2,-4,1,-1,-8,-3,-3,-2,0,0,2,0,1,-2,-4,-16,12,-3,-9,6,2,3,-15,1,-6,9,-3,0,-11,-8,-1,6,5,3,-4,9,-5,3,1,-1,-5,2,-3,3,0,-2,-6,0,-2,1,1,1,1,2,-1,2,-36,-35,-1,6,2,4,6,-5,-9,-19,-2,-10,3,-7,-9,-20,-2,-1,3,2,0,1,0,-9,0,2,-2,-2,3,5,-1,2,-2,-1,1,3,1,0,0,-1,2,2,-51,-24,-27,0,-5,5,-10,-7,-9,-13,4,-13,-5,-5,-1,-9,1,-3,-5,-2,-8,-4,3,-10,0,1,0,-2,3,-2,-1,0,0,-3,1,-2,1,1,0,1,2,0,38,27,11,-2,-1,-1,8,-4,8,5,15,2,9,-2,2,3,7,6,-1,-2,6,2,8,-4,0,1,-1,-1,2,-3,0,0,-1,0,1,-1,0,1,0,-1,1,-2,-10,-2,-8,-9,-4,-5,7,11,-3,-8,-12,-4,4,10,-2,-6,-7,1,3,1,-1,-2,-5,-5,-1,1,-2,-5,-2,0,0,1,-1,-3,-1,0,-1,0,-1,-2,-1,0,-37,-15,-22,16,10,6,-3,1,-8,-11,0,-17,0,1,2,-5,-1,-12,-3,0,-10,-6,1,-5,3,6,3,0,2,1,3,4,1,0,1,0,0,2,2,0,1,1,10,-3,13,2,-2,4,3,-1,4,0,5,-1,5,-6,-1,2,2,-5,-2,5,5,-2,3,4,-2,-1,2,2,2,-1,-4,0,-1,1,2,0,2,-1,3,1,0,-1
27,27039,Outeiro de Rei,4134,91,53,38,6,3,3,4,8,32,18,17,11,8,3,18,9,9,6,-4,5,14,9,8,5,0,1,1,2,2,0,0,1,0,1,1,0,0,0,1,1,1,0,65,32,33,3,1,2,-3,11,7,25,20,4,-3,11,2,9,9,3,0,0,5,16,11,1,0,1,0,1,0,0,0,1,0,0,0,0,0,0,0,1,0,0,87,62,25,3,2,1,17,10,11,30,9,7,18,10,7,19,5,1,-1,0,4,11,4,6,0,1,0,1,1,0,0,1,0,1,0,0,0,0,0,0,1,0,83,45,38,9,4,5,-12,18,25,26,18,11,-10,6,19,21,8,3,-2,12,6,5,10,8,0,1,1,1,2,4,0,0,1,1,1,1,0,1,0,0,1,3,129,60,69,1,-1,2,11,16,19,45,17,19,9,1,13,22,10,4,2,15,6,23,7,15,0,1,0,0,0,0,0,0,0,-1,0,0,0,1,0,1,0,0,100,67,33,2,2,0,12,13,26,22,14,8,9,7,12,21,9,5,3,6,14,1,5,3,0,0,-1,1,0,1,0,1,-1,0,0,1,0,-1,0,1,0,0,363,272,91,26,23,3,2,1,89,133,48,90,-2,9,82,121,38,24,4,-8,7,12,10,66,0,1,11,5,6,3,0,1,11,5,3,3,0,0,0,0,3,0,-1,-19,18,0,-4,4,9,-4,-25,13,13,-3,-3,-3,-18,0,8,0,12,-1,-7,13,5,-3,2,2,-1,-2,0,-2,0,0,-2,-2,0,-1,2,2,1,0,0,-1,46,30,16,8,5,3,18,3,6,14,1,4,12,2,7,5,0,4,6,1,-1,9,1,0,0,2,3,2,1,0,0,1,3,1,0,0,0,1,0,1,1,0,127,50,77,-1,1,-2,38,5,29,31,19,0,24,-3,10,5,12,0,14,8,19,26,7,0,0,1,0,0,0,-2,0,1,0,0,1,-1,0,0,0,0,-1,-1,106,41,65,1,0,1,35,12,22,5,12,15,15,7,6,-3,8,7,20,5,16,8,4,8,1,1,1,0,0,-2,1,0,1,0,0,-2,0,1,0,0,0,0,69,39,30,10,3,7,13,1,14,24,4,11,5,-3,7,18,8,5,8,4,7,6,-4,6,0,1,1,3,4,1,0,0,1,1,0,1,0,1,0,2,4,0,64,32,32,2,0,2,6,2,17,22,12,3,6,1,14,3,9,0,0,1,3,19,3,3,0,0,0,1,0,1,0,-1,0,1,0,0,0,1,0,0,0,1,20,20,0,3,2,1,4,6,5,6,-5,3,5,0,1,10,1,2,-1,6,4,-4,-6,1,0,0,1,2,0,0,0,0,1,1,0,0,0,0,0,1,0,0,33,21,12,3,2,1,6,6,18,7,-2,-4,5,0,11,5,-4,3,1,6,7,2,2,-7,1,0,0,2,0,0,1,0,0,1,0,0,0,0,0,1,0,0,22,15,7,6,2,4,0,9,9,11,-1,-9,0,5,5,11,-4,-3,0,4,4,0,3,-6,0,1,3,1,0,0,0,0,1,1,0,0,0,1,2,0,0,0,42,19,23,-12,-8,-4,12,4,13,18,-2,-6,6,3,4,10,-2,-3,6,1,9,8,0,-3,0,0,-5,-1,-4,-2,0,0,-4,-1,-2,-1,0,0,-1,0,-2,-1,76,40,36,12,9,3,12,-5,21,21,9,15,5,-2,4,20,3,7,7,-3,17,1,6,8,2,3,1,3,3,0,1,2,1,2,3,0,1,1,0,1,0,0
27,27041,Pantón,3604,-20,-5,-15,13,6,7,-12,-7,-14,-4,20,-4,-6,2,-7,-5,11,0,-6,-9,-7,1,9,-4,1,3,1,1,5,1,0,2,0,0,3,1,1,1,1,1,2,0,-19,-9,-10,14,6,8,1,-7,-6,1,-2,-7,0,-3,-2,0,-3,-1,1,-4,-4,1,1,-6,2,4,4,1,1,1,2,0,1,1,1,1,0,4,3,0,0,0,-54,-20,-34,8,3,5,-10,-13,-16,0,-4,-10,-1,-8,-7,1,-3,-2,-9,-5,-9,-1,-1,-8,1,3,0,4,1,-1,1,0,0,1,0,1,0,3,0,3,1,-2,33,14,19,26,9,17,3,9,-3,2,27,-5,1,4,-5,4,11,-1,2,5,2,-2,16,-4,4,2,3,7,9,1,0,1,0,3,4,1,4,1,3,4,5,0,-7,6,-13,23,14,9,-1,-4,-10,12,13,-15,-1,-4,-7,8,14,-3,0,0,-3,4,-1,-12,3,2,6,3,6,3,2,0,3,2,5,2,1,2,3,1,1,1,20,19,1,18,13,5,-3,9,-11,12,14,0,-1,5,-1,8,4,4,-2,4,-10,4,10,-4,2,2,1,7,6,0,2,2,0,6,3,0,0,0,1,1,3,0,-9,1,-10,15,5,10,-1,0,2,-6,4,-9,4,-2,-2,-3,5,-1,-5,2,4,-3,-1,-8,1,2,4,1,4,3,1,0,0,0,2,2,0,2,4,1,2,1,6,8,-2,23,13,10,2,-3,-11,7,21,-10,2,-3,-8,4,17,-4,0,0,-3,3,4,-6,1,3,3,6,9,1,0,2,3,3,5,0,1,1,0,3,4,1,-5,-1,-4,9,6,3,-6,10,-7,5,16,-23,-4,4,-4,5,7,-9,-2,6,-3,0,9,-14,0,1,1,2,3,2,0,1,1,3,0,1,0,0,0,-1,3,1,22,14,8,22,8,14,-5,7,-19,11,23,3,-3,5,-6,6,10,0,-2,2,-13,5,13,3,1,4,-1,9,6,2,-1,1,-1,6,0,2,2,3,0,3,6,0,53,33,20,19,8,11,14,10,13,28,9,-22,7,8,5,18,1,-7,7,2,8,10,8,-15,6,3,3,4,3,0,3,1,0,3,1,0,3,2,3,1,2,0,-5,-3,-2,3,-2,5,-1,6,3,-3,5,-14,-5,4,1,0,6,-8,4,2,2,-3,-1,-6,-1,6,0,0,0,-2,-1,1,0,-1,1,-2,0,5,0,1,-1,0,-40,-12,-28,7,4,3,-8,-7,-9,-7,7,-16,-3,-5,-2,0,3,-5,-5,-2,-7,-7,4,-11,0,0,2,2,4,-1,0,0,1,2,2,-1,0,0,1,0,2,0,-7,-13,6,-23,-23,0,5,3,9,-18,5,-10,-2,4,8,-19,-1,-3,7,-1,1,1,6,-7,-3,-3,-5,-11,-1,0,-3,-1,-5,-12,-2,0,0,-2,0,1,1,0,24,9,15,10,8,2,7,2,-2,4,10,1,4,3,-3,-2,6,0,3,-1,1,6,4,1,2,0,0,0,6,2,1,2,-1,1,3,2,1,-2,1,-1,3,0,-13,-3,-10,0,-4,4,3,0,-7,-1,19,-27,-1,2,0,-6,14,-12,4,-2,-7,5,5,-15,0,-1,0,-1,5,-3,0,-1,0,-3,3,-3,0,0,0,2,2,0,14,13,1,1,3,-2,8,4,2,7,6,-12,3,1,6,3,1,0,5,3,-4,4,5,-12,0,0,-4,3,2,0,0,0,0,2,2,-1,0,0,-4,1,0,1,16,11,5,20,11,9,11,-5,8,6,6,-12,10,0,1,1,2,-3,1,-5,7,5,4,-9,7,1,0,4,5,2,5,1,1,0,2,2,2,0,-1,4,3,0
27,27047,"Pobra do Brollón, A",2675,2,-1,3,9,2,7,1,-1,-7,8,5,-5,0,-1,-2,3,2,-4,1,0,-5,5,3,-1,1,2,4,2,0,0,1,0,1,0,0,0,0,2,3,2,0,0,10,12,-2,15,10,5,8,-2,-2,4,3,0,6,-3,-1,5,1,4,2,1,-1,-1,2,-4,4,1,0,4,3,2,4,0,0,3,1,1,0,1,0,1,2,1,-44,-18,-26,7,5,2,-3,-11,-16,-3,-2,-8,-1,-1,-10,-3,-2,0,-2,-10,-6,0,0,-8,0,1,2,6,-1,-1,0,1,1,3,0,0,0,0,1,3,-1,-1,-11,-5,-6,5,2,3,5,-7,-9,3,2,-6,3,-3,-3,0,1,-4,2,-4,-6,3,1,-2,1,0,1,1,1,1,1,0,0,1,0,0,0,0,1,0,1,1,-27,-8,-19,9,4,5,-2,-4,-3,-10,-4,-3,2,-1,-5,-4,-4,4,-4,-3,2,-6,0,-7,0,2,0,2,3,2,0,1,0,1,1,1,0,1,0,1,2,1,-21,-14,-7,6,5,1,-2,-3,-2,1,-8,-7,-2,2,0,-2,-6,-6,0,-5,-2,3,-2,-1,0,2,0,3,0,1,0,1,0,3,0,1,0,1,0,0,0,0,-38,-22,-16,13,7,6,-4,-18,-10,-5,-1,1,-4,-9,-7,-6,-1,5,0,-9,-3,1,0,-4,0,2,3,5,-2,5,0,1,2,2,-2,4,0,1,1,3,0,1,6,0,6,15,7,8,-3,5,-7,-1,9,2,-1,1,-6,-1,6,1,-2,4,-1,0,3,1,0,0,6,3,4,1,0,0,4,2,1,0,0,0,2,1,3,1,-12,5,-17,10,8,2,-3,-17,5,-4,13,-8,0,-6,7,-1,5,-2,-3,-11,-2,-3,8,-6,2,0,4,1,2,1,2,0,3,1,1,1,0,0,1,0,1,0,9,12,-3,2,-3,5,7,-4,7,-2,10,-10,4,-2,2,-1,7,1,3,-2,5,-1,3,-11,1,-2,3,-5,5,0,0,-1,0,-4,1,1,1,-1,3,-1,4,-1,-8,-9,1,8,4,4,7,-3,-8,5,3,-10,1,-3,-2,2,3,-9,6,0,-6,3,0,-1,2,0,2,3,1,0,1,0,1,1,1,0,1,0,1,2,0,0,2,9,-7,2,2,0,1,8,-2,-3,6,-9,0,1,1,-1,7,1,1,7,-3,-2,-1,-10,1,2,3,0,-2,-3,1,2,1,0,0,-2,0,0,2,0,-2,-1,-24,-5,-19,5,6,-1,2,-3,-8,1,-2,-15,-1,0,-1,1,0,-5,3,-3,-7,0,-2,-10,1,1,4,1,0,-3,2,1,3,0,0,-1,-1,0,1,1,0,-2,-28,-15,-13,-8,-5,-3,-4,-1,-4,-9,-5,-5,-3,-2,0,-4,-4,-2,-1,1,-4,-5,-1,-3,-2,0,-1,-2,-2,-1,-1,0,-1,-2,0,-1,-1,0,0,0,-2,0,5,-2,7,-4,-5,1,1,1,-2,3,3,-2,-1,0,-4,2,4,-4,2,1,2,1,-1,2,-2,1,-3,-3,1,1,-1,0,-2,-2,0,-1,-1,1,-1,-1,1,2,-26,-20,-6,-3,-3,0,-2,2,-16,3,-5,-8,-4,3,-13,1,-3,-5,2,-1,-3,2,-2,-3,-1,1,-3,-2,-2,3,-1,1,-3,-2,-1,2,0,0,0,0,-1,1,-13,6,-19,6,4,2,-5,0,2,-3,3,-8,-1,-1,4,2,3,0,-4,1,-2,-5,0,-8,0,1,2,1,0,2,0,0,2,1,0,1,0,1,0,0,0,1,13,14,-1,12,9,3,4,12,1,-2,3,-6,3,9,-2,1,4,-2,1,3,3,-3,-1,-4,1,5,1,2,2,1,1,4,0,2,2,0,0,1,1,0,0,1
27,27048,"Pontenova, A",3426,-6,-8,2,3,2,1,0,-4,2,-1,3,-6,-1,-7,-2,2,0,0,1,3,4,-3,3,-6,0,0,1,0,1,1,0,0,1,0,0,1,0,0,0,0,1,0,-29,-11,-18,4,1,3,-6,-6,-12,-4,-1,1,-3,-5,-1,-2,2,-1,-3,-1,-11,-2,-3,2,2,1,0,0,1,0,0,1,0,0,0,0,2,0,0,0,1,0,-22,-11,-11,7,4,3,-4,-3,-12,-1,1,-2,-2,-4,-8,4,1,-1,-2,1,-4,-5,0,-1,1,1,0,3,1,1,0,0,0,2,1,1,1,1,0,1,0,0,-38,-21,-17,6,3,3,-1,-9,-20,-8,-1,1,-1,-7,-12,-3,0,2,0,-2,-8,-5,-1,-1,1,0,-1,0,3,3,1,0,-1,-2,2,3,0,0,0,2,1,0,-23,-10,-13,15,10,5,0,-5,-6,-4,3,-10,-3,-3,-1,-1,1,-3,3,-2,-5,-3,2,-7,5,1,7,0,2,0,3,1,4,1,1,0,2,0,3,-1,1,0,-21,-2,-19,9,9,0,1,-7,-5,-5,-2,-3,1,-1,0,-4,1,1,0,-6,-5,-1,-3,-4,2,-1,5,2,1,0,2,0,5,2,0,0,0,-1,0,0,1,0,-12,-12,0,29,18,11,3,-6,2,-2,0,-8,1,-5,0,-2,-1,-4,2,-1,2,0,1,-4,7,1,14,6,0,1,3,0,10,5,0,0,4,1,4,1,0,1,-19,1,-20,23,13,10,-2,3,-3,-5,-5,-9,-1,0,3,0,1,-3,-1,3,-6,-5,-6,-6,4,5,9,5,0,0,2,2,6,3,0,0,2,3,3,2,0,0,5,12,-7,23,18,5,1,5,-2,5,0,-3,1,5,4,6,0,-4,0,0,-6,-1,0,1,1,8,8,5,2,-1,1,5,7,5,1,-1,0,3,1,0,1,0,-49,-27,-22,-3,-5,2,6,-12,-26,-12,5,-11,3,-3,-17,-10,1,-1,3,-9,-9,-2,4,-10,4,-2,0,-5,0,0,2,-1,0,-6,0,0,2,-1,0,1,0,0,-10,-11,1,8,7,1,-3,6,-15,1,7,-6,-1,1,-10,-3,5,-3,-2,5,-5,4,2,-3,0,6,-1,3,1,-1,-1,4,0,3,1,0,1,2,-1,0,0,-1,-13,-3,-10,3,-1,4,-7,-2,-1,-4,1,1,-3,-2,-1,0,2,1,-4,0,0,-4,-1,0,0,3,2,-2,-1,1,0,0,0,-1,-1,1,0,3,2,-1,0,0,-17,-15,-2,0,-2,2,4,3,-14,-3,-2,-5,2,1,-8,-7,0,-4,2,2,-6,4,-2,-1,0,1,-1,0,0,0,0,0,-3,0,0,1,0,1,2,0,0,-1,-34,-14,-20,1,0,1,-3,-2,-19,-10,2,-3,-2,1,-8,-7,0,2,-1,-3,-11,-3,2,-5,0,1,-2,0,1,1,0,0,-1,-1,1,1,0,1,-1,1,0,0,-13,-5,-8,2,3,-1,-1,5,-15,-4,2,2,2,3,-2,-7,0,0,-3,2,-13,3,2,2,0,4,-1,1,-2,0,0,3,2,0,-2,0,0,1,-3,1,0,0,-39,-19,-20,-4,-6,2,-4,4,-14,-11,-4,-8,-3,3,-5,-4,-4,-4,-1,1,-9,-7,0,-4,0,4,-1,-4,-3,0,-1,2,-2,-3,-2,0,1,2,1,-1,-1,0,-18,-8,-10,1,4,-3,-5,4,-17,0,-2,0,-4,5,-7,1,-2,-2,-1,-1,-10,-1,0,2,-1,1,-2,1,2,0,1,1,0,1,0,1,-2,0,-2,0,2,-1,-16,1,-17,-8,-5,-3,-4,-2,-14,-6,10,-2,-3,-1,-1,-4,9,1,-1,-1,-13,-2,1,-3,-5,-2,0,-2,0,1,-3,-2,0,-2,1,1,-2,0,0,0,-1,0
27,27050,Quiroga,4458,-2,-1,-1,13,10,3,-12,1,-13,-3,-1,26,-9,2,-5,-5,0,16,-3,-1,-8,2,-1,10,0,1,0,3,5,4,0,1,0,1,5,3,0,0,0,2,0,1,27,8,19,9,6,3,-5,3,2,-2,9,20,1,1,1,1,3,1,-6,2,1,-3,6,19,0,1,3,1,2,2,0,1,3,1,1,0,0,0,0,0,1,2,-51,-30,-21,3,0,3,-11,-9,-11,-16,5,-7,-6,-5,-4,-12,1,-2,-5,-4,-7,-4,4,-5,4,-2,0,3,-1,-1,2,-1,0,1,-3,1,2,-1,0,2,2,-2,50,24,26,4,2,2,7,4,-3,2,12,29,5,4,-6,3,6,13,2,0,3,-1,6,16,0,3,-2,1,-1,3,1,1,-1,1,-1,1,-1,2,-1,0,0,2,40,18,22,17,7,10,3,0,5,14,4,16,-2,-1,4,14,1,3,5,1,1,0,3,13,-2,3,1,8,5,2,-2,0,3,5,1,0,0,3,-2,3,4,2,-19,-8,-11,12,5,7,-5,-9,-9,-9,5,7,-3,-4,-5,-7,7,4,-2,-5,-4,-2,-2,3,2,1,1,4,6,-2,0,0,0,2,4,-1,2,1,1,2,2,-1,-9,3,-12,6,5,1,1,-3,-7,-3,-3,7,2,-3,-4,1,0,8,-1,0,-3,-4,-3,-1,2,2,1,0,1,0,2,1,0,1,0,1,0,1,1,-1,1,-1,12,-2,14,15,10,5,5,6,-5,-1,9,-2,0,4,-5,-6,7,-2,5,2,0,5,2,0,2,1,5,5,0,2,2,0,3,2,1,2,0,1,2,3,-1,0,-11,7,-18,12,5,7,-7,-5,-15,4,7,6,-2,-10,-2,8,6,7,-5,5,-13,-4,1,-1,1,3,3,2,0,3,0,0,1,1,1,2,1,3,2,1,-1,1,12,24,-12,-1,-6,5,9,2,-6,-3,11,1,8,5,5,0,4,1,1,-3,-11,-3,7,0,1,3,-1,-6,1,1,1,0,-1,-4,-2,0,0,3,0,-2,3,1,-2,7,-9,5,5,0,-2,6,-12,6,14,-15,-1,5,-7,1,13,-5,-1,1,-5,5,1,-10,3,0,0,1,2,-1,1,0,1,1,1,1,2,0,-1,0,1,-2,-27,-15,-12,0,2,-2,0,-6,-11,-4,6,-12,2,-7,-10,0,4,-3,-2,1,-1,-4,2,-9,0,0,0,0,2,-2,1,0,0,1,1,-1,-1,0,0,-1,1,-1,21,9,12,3,6,-3,6,3,-1,-7,9,9,5,1,-3,-4,2,6,1,2,2,-3,7,3,1,1,-1,-1,3,0,2,0,0,0,3,1,-1,1,-1,-1,0,-1,20,14,6,12,8,4,1,3,2,-2,4,15,-2,0,6,5,1,7,3,3,-4,-7,3,8,1,2,4,2,2,1,0,2,3,2,0,1,1,0,1,0,2,0,-7,-2,-5,7,2,5,-5,2,-12,-15,5,19,-2,-4,-4,-7,3,13,-3,6,-8,-8,2,6,2,1,0,1,0,3,0,0,1,1,-1,1,2,1,-1,0,1,2,5,7,-2,7,5,2,-4,0,-14,6,5,12,-2,-1,-1,7,3,1,-2,1,-13,-1,2,11,0,2,0,2,-2,4,0,2,1,1,-2,2,0,0,-1,1,0,2,31,18,13,11,3,8,3,7,0,-4,13,13,3,5,-3,-1,5,11,0,2,3,-3,8,2,1,3,0,0,1,6,0,1,-1,-1,0,4,1,2,1,1,1,2,0,-7,7,0,-3,3,-1,-5,5,-15,9,6,-1,-2,3,-15,9,-2,0,-3,2,0,0,8,1,-1,3,-3,1,-1,0,-2,2,-2,0,-1,1,1,1,-1,1,0
27,27051,Ribadeo,8953,153,62,91,46,18,28,29,28,40,21,15,13,15,4,22,8,8,4,14,24,18,13,7,9,10,6,12,7,7,4,4,3,5,2,2,2,6,3,7,5,5,2,110,53,57,33,10,23,18,19,44,5,20,4,4,9,21,7,10,2,14,10,23,-2,10,2,7,8,10,3,4,1,2,1,2,1,4,0,5,7,8,2,0,1,31,24,7,36,18,18,-6,-6,-9,-3,31,25,-4,-4,3,-7,18,18,-2,-2,-12,4,13,7,8,3,12,3,3,7,3,2,7,2,2,2,5,1,5,1,1,5,109,48,61,49,20,29,6,21,13,27,25,17,5,7,2,10,12,13,1,14,11,17,13,4,9,12,6,8,4,10,3,4,2,5,1,5,6,8,4,3,3,5,128,59,69,73,28,45,15,29,19,37,11,18,8,14,9,13,7,9,7,15,10,24,4,9,9,24,17,13,9,1,3,8,10,3,4,0,6,16,7,10,5,1,194,98,96,59,25,34,19,25,77,24,21,16,5,8,41,22,7,10,14,17,36,2,14,6,5,19,18,8,6,2,2,9,4,5,3,1,3,10,14,3,3,1,170,87,83,80,36,44,26,39,50,21,25,8,18,16,33,9,9,1,8,23,17,12,16,7,22,26,18,6,4,3,10,10,9,3,2,1,12,16,9,3,2,2,202,117,85,106,57,49,22,17,88,41,22,7,11,11,57,21,17,-2,11,6,31,20,5,9,6,22,40,22,14,2,2,5,28,12,10,0,4,17,12,10,4,2,183,97,86,80,38,42,33,21,51,38,28,4,26,7,25,10,17,7,7,14,26,28,11,-3,17,12,25,18,3,3,8,5,9,9,2,3,9,7,16,9,1,0,51,32,19,3,2,1,4,1,39,-9,6,7,1,-2,22,9,-1,1,3,3,17,-18,7,6,4,-1,0,-1,-2,2,-1,1,3,-1,-2,1,5,-2,-3,0,0,1,39,14,25,30,16,14,11,5,13,-1,6,1,-10,-1,19,-5,10,-2,21,6,-6,4,-4,3,14,-1,12,2,-1,3,4,0,11,0,0,1,10,-1,1,2,-1,2,99,30,69,19,4,15,24,21,4,33,7,7,15,11,-4,11,-6,6,9,10,8,22,13,1,1,11,1,3,0,2,1,6,-3,-1,-2,2,0,5,4,4,2,0,22,14,8,9,4,5,15,-7,8,2,4,-1,13,-1,0,-1,1,2,2,-6,8,3,3,-3,4,2,3,3,-4,1,1,1,1,2,-2,1,3,1,2,1,-2,0,91,60,31,-11,-8,-3,25,8,27,10,3,8,19,6,7,11,4,8,6,2,20,-1,-1,0,1,3,-7,-8,-3,2,3,2,-7,-4,-2,0,-2,1,0,-4,-1,2,-62,-30,-32,-22,-16,-6,-16,1,-8,-19,-11,-6,-7,2,1,-10,-14,-1,-9,-1,-9,-9,3,-5,0,16,-11,-16,-10,-1,4,9,-5,-13,-11,0,-4,7,-6,-3,1,-1,128,62,66,46,22,24,19,33,35,16,7,17,11,21,11,5,7,6,8,12,24,11,0,11,9,19,8,5,4,0,1,14,0,3,2,1,8,5,8,2,2,-1,87,37,50,83,39,44,10,14,29,17,9,6,-2,13,6,9,2,4,12,1,23,8,7,2,15,25,12,17,7,5,7,10,4,12,1,3,8,15,8,5,6,2,10,-1,11,43,21,22,-16,-13,-4,1,19,19,-4,-12,1,-1,6,7,-12,-1,-5,2,13,12,0,11,13,10,3,4,0,1,10,6,1,2,0,10,3,4,2,2
27,27057,Sarria,12972,86,47,39,48,15,33,15,12,16,13,20,12,6,7,10,6,10,9,9,5,6,7,10,3,6,3,10,13,8,8,2,2,0,4,3,4,4,1,10,9,5,4,101,59,42,47,28,19,16,14,36,14,14,7,9,8,20,10,5,7,7,6,16,4,9,0,5,7,19,9,5,2,4,4,10,7,2,1,1,3,9,2,3,1,159,77,82,90,49,41,26,37,32,14,22,28,15,15,14,3,9,22,11,22,18,11,13,6,14,19,14,18,12,13,7,13,8,8,3,10,7,6,6,10,9,3,60,40,20,81,44,37,4,6,1,-1,22,24,6,3,7,5,7,11,-2,3,-6,-6,15,13,14,17,20,10,14,6,10,8,11,6,6,3,4,9,9,4,8,3,64,27,37,46,22,24,-9,0,29,-5,30,26,-3,-5,20,-6,13,13,-6,5,9,1,17,13,6,6,10,5,11,8,1,3,5,4,6,3,5,3,5,1,5,5,248,105,143,81,39,42,54,43,55,33,27,34,34,15,12,16,16,10,20,28,43,17,11,24,14,11,30,11,11,4,8,9,13,5,5,-1,6,2,17,6,6,5,208,94,114,109,54,55,37,50,43,31,23,26,18,23,24,10,5,15,19,27,19,21,18,11,16,27,40,12,13,1,10,12,19,7,6,0,6,15,21,5,7,1,163,84,79,106,55,51,26,28,30,28,35,13,12,13,17,17,17,7,14,15,13,11,18,6,22,20,28,22,10,4,12,8,15,15,5,0,10,12,13,7,5,4,145,98,47,86,45,41,14,23,19,31,24,34,9,11,19,22,17,19,5,12,0,9,7,15,20,21,19,9,8,8,12,7,12,4,5,4,8,14,7,5,3,4,188,110,78,55,33,22,30,24,58,24,34,15,20,13,29,11,23,12,10,11,29,13,11,3,7,15,15,8,8,2,2,7,8,6,7,3,5,8,7,2,1,-1,28,19,9,28,4,24,19,20,-7,9,1,-10,13,7,5,0,-1,-3,6,13,-12,9,2,-7,14,11,-7,10,3,-3,4,4,-5,2,3,-4,10,7,-2,8,0,1,15,7,8,26,21,5,4,5,-12,11,3,-1,-1,2,-2,4,3,-2,5,3,-10,7,0,1,12,0,1,6,-2,9,5,1,7,4,2,2,7,-1,-6,2,-4,7,102,50,52,34,14,20,35,12,5,13,16,18,17,-3,-3,8,18,12,18,15,8,5,-2,6,9,8,6,3,5,3,3,1,4,0,3,3,6,7,2,3,2,0,74,51,23,28,18,10,14,30,3,5,26,-2,10,17,2,5,14,3,4,13,1,0,12,-5,13,9,4,0,4,-3,8,6,0,-1,5,-1,5,3,4,1,-1,-2,-45,-44,-1,-33,-29,-4,-1,-3,-27,-11,-24,19,-1,-9,-24,-2,-18,7,0,6,-3,-9,-6,12,1,3,-18,-13,-11,5,1,1,-14,-6,-11,0,0,2,-4,-7,0,5,88,49,39,30,17,13,6,8,8,25,20,19,-2,8,4,14,17,7,8,0,4,11,3,12,8,5,5,11,3,-2,5,3,2,5,3,-1,3,2,3,6,0,-1,126,64,62,76,52,24,15,21,26,18,14,26,13,14,13,-1,8,13,2,7,13,19,6,13,16,14,22,5,8,9,13,8,16,1,7,6,3,6,6,4,1,3,115,86,29,107,59,48,16,16,10,41,20,10,11,8,15,27,12,10,5,8,-5,14,8,0,22,23,9,25,20,7,9,11,9,14,11,5,13,12,0,11,9,2
27,27058,"Saviñao, O",5163,18,7,11,28,16,12,4,-1,-3,-2,14,4,2,-1,-3,0,6,3,2,0,0,-2,8,1,7,2,1,4,5,9,4,2,1,2,4,3,3,0,0,2,1,6,13,10,3,27,16,11,-2,-3,5,2,10,1,1,-4,3,-1,5,6,-3,1,2,3,5,-5,4,5,6,5,3,4,4,1,4,3,1,3,0,4,2,2,2,1,44,36,8,15,10,5,1,9,9,6,15,5,4,8,7,-1,13,5,-3,1,2,7,2,0,2,0,3,5,5,0,2,0,3,1,4,0,0,0,0,4,1,0,1,2,-1,20,6,14,11,-3,-8,4,10,-14,6,1,-4,4,2,-8,5,-4,-4,0,8,-6,6,4,6,-1,4,1,-1,3,2,0,1,1,7,1,4,-1,3,0,-7,-2,-5,15,7,8,-1,4,-13,-2,21,-15,-2,-1,-6,-1,8,1,1,5,-7,-1,13,-16,3,3,3,3,4,-1,1,0,2,3,1,0,2,3,1,0,3,-1,-9,5,-14,21,9,12,3,0,-5,-3,3,-5,3,3,-3,-3,4,3,0,-3,-2,0,-1,-8,6,1,4,4,3,3,2,1,1,2,1,2,4,0,3,2,2,1,-10,2,-12,15,12,3,3,-1,-9,5,8,-14,-1,1,1,-1,6,-3,4,-2,-10,6,2,-11,1,6,3,5,0,0,1,3,3,5,0,0,0,3,0,0,0,0,7,12,-5,30,18,12,7,2,3,11,3,-20,6,-3,5,9,-2,-4,1,5,-2,2,5,-16,8,6,6,5,4,1,4,2,4,5,2,1,4,4,2,0,2,0,4,9,-5,15,9,6,7,4,-17,6,13,-9,7,1,-4,1,6,-2,0,3,-13,5,7,-7,3,2,6,3,1,-1,2,1,4,1,1,-1,1,1,2,2,0,0,-66,-22,-44,-11,-6,-5,-4,-13,-18,-22,9,-16,-1,-5,-5,-11,7,-6,-3,-8,-13,-11,2,-10,0,-2,1,-7,2,-5,-1,-1,2,-3,1,-4,1,-1,-1,-4,1,-1,-2,16,-18,17,10,7,6,7,-5,10,9,-29,8,4,1,8,6,-12,-2,3,-6,2,3,-17,2,2,6,8,-2,0,2,0,4,4,-1,0,0,2,2,4,-1,0,-10,4,-14,8,5,3,4,6,-3,7,3,-28,5,3,4,4,2,-15,-1,3,-7,3,1,-13,1,1,4,3,0,-2,1,1,2,2,0,-2,0,0,2,1,0,0,-30,-2,-28,2,2,0,1,4,-22,-5,1,-8,2,3,-9,2,-3,3,-1,1,-13,-7,4,-11,0,2,2,1,-1,-2,-1,1,1,2,-1,0,1,1,1,-1,0,-2,-24,-2,-22,3,2,1,-5,-4,-1,-3,0,-11,-1,-3,-2,-3,6,1,-4,-1,1,0,-6,-12,1,1,0,-1,1,1,1,1,0,0,0,0,0,0,0,-1,1,1,4,8,-4,-5,-3,-2,0,3,8,1,-3,-4,1,3,7,0,-2,0,-1,0,1,1,-1,-4,-1,2,-3,-3,1,-1,0,2,-1,-2,-1,-1,-1,0,-2,-1,2,0,-56,-19,-37,21,12,9,-5,4,-14,-7,-2,-30,-3,5,-7,-4,1,-10,-2,-1,-7,-3,-3,-20,6,2,8,3,2,-1,3,1,3,2,2,1,3,1,5,1,0,-2,-8,0,-8,0,1,-1,-1,-2,-22,-1,13,5,-3,1,-10,4,4,4,2,-3,-12,-5,9,1,0,5,-3,-4,-1,3,0,4,-1,-3,-2,3,0,1,-2,-1,1,0,-11,7,-18,6,8,-2,-1,5,-9,4,6,-15,-1,3,2,3,5,-5,0,2,-11,1,1,-10,-5,2,2,2,4,1,-3,1,2,4,4,0,-2,1,0,-2,0,1
27,27060,Taboada,4249,1,-1,2,7,4,3,-1,3,-4,1,1,0,-1,1,-2,1,0,0,0,2,-2,0,1,0,0,2,0,1,3,1,0,0,0,1,2,1,0,2,0,0,1,0,-34,-16,-18,13,6,7,-5,-13,-11,-3,5,-6,-7,-2,-6,-5,5,-1,2,-11,-5,2,0,-5,3,3,1,2,0,4,1,2,1,0,0,2,2,1,0,2,0,2,-31,-12,-19,11,8,3,-10,-5,-11,-4,-1,0,-9,-4,-3,2,2,0,-1,-1,-8,-6,-3,0,0,0,1,3,3,4,0,0,1,3,2,2,0,0,0,0,1,2,-17,-3,-14,4,-3,7,5,-9,-16,5,3,-5,3,-2,-8,3,2,-1,2,-7,-8,2,1,-4,4,1,-1,-1,1,0,0,0,-2,-1,0,0,4,1,1,0,1,0,-62,-26,-36,6,6,0,-14,-13,-16,-5,1,-12,-6,-5,-8,-2,0,-5,-8,-8,-8,-3,1,-7,0,0,1,3,4,-2,0,0,2,1,3,0,0,0,-1,2,1,-2,-19,-9,-10,10,4,6,-2,1,-11,1,0,-7,1,3,-8,-3,0,-1,-3,-2,-3,4,0,-6,0,1,3,5,0,1,0,1,1,2,0,0,0,0,2,3,0,1,-7,-14,7,12,4,8,-1,1,-10,-4,14,-5,2,-2,-9,-6,4,-1,-3,3,-1,2,10,-4,0,2,2,3,5,0,0,0,1,0,3,0,0,2,1,3,2,0,-19,-13,-6,19,12,7,7,-2,-7,-11,4,-10,5,0,-9,-5,0,-5,2,-2,2,-6,4,-5,1,5,5,3,5,-1,0,2,3,3,3,0,1,3,2,0,2,-1,44,33,11,26,18,8,4,9,-10,15,5,19,4,4,-3,12,5,11,0,5,-7,3,0,8,5,2,8,10,0,1,5,1,5,7,0,0,0,1,3,3,0,1,6,6,0,2,-1,3,6,-2,2,-9,5,5,4,-2,0,0,4,2,2,0,2,-9,1,3,2,-2,3,0,1,-2,2,-1,0,1,0,-3,0,-1,3,-1,1,1,-10,-2,-8,3,4,-1,1,-1,-6,-7,8,-3,2,-1,-2,-5,9,-4,-1,0,-4,-2,-1,1,2,2,1,-1,0,-1,2,1,1,-1,1,0,0,1,0,0,-1,-1,0,-3,3,3,1,2,0,-2,-4,-3,5,5,0,0,-5,-3,2,3,0,-2,1,0,3,2,0,0,2,0,1,0,0,0,0,0,1,0,0,0,2,0,0,0,15,10,5,11,7,4,8,-4,-4,-2,4,12,3,-7,2,3,3,5,5,3,-6,-5,1,7,2,0,1,3,3,2,0,0,0,3,1,3,2,0,1,0,2,-1,-7,-4,-3,-3,-2,-1,-2,4,-4,0,-2,-2,3,1,-2,0,-2,-2,-5,3,-2,0,0,0,-1,0,0,1,-1,-2,0,0,0,0,0,-2,-1,0,0,1,-1,0,-2,5,-7,7,3,4,3,3,-7,0,-5,5,-2,4,2,4,-5,3,5,-1,-9,-4,0,2,2,2,1,2,0,0,0,1,1,1,0,0,2,1,0,1,0,0,-54,-27,-27,-18,-15,-3,-5,0,-19,-18,1,-12,-1,-2,-10,-9,0,-4,-4,2,-9,-9,1,-8,3,2,-4,-11,-5,-3,1,-1,-2,-9,-4,0,2,3,-2,-2,-1,-3,-3,-13,10,6,4,2,-4,-1,-7,-7,10,7,-1,0,-8,-8,6,-2,-3,-1,1,1,4,9,0,3,1,0,2,0,0,3,1,0,0,0,0,0,0,0,2,0,9,8,1,10,4,6,6,-2,-2,1,0,7,4,-2,-4,6,0,5,2,0,2,-5,0,2,4,4,1,-1,1,0,3,0,-1,-1,1,1,1,4,2,0,0,-1
27,27063,"Valadouro, O",2487,-12,-11,-1,4,1,3,-1,2,-3,-3,2,-8,-1,-1,-4,-2,0,-3,0,3,1,-1,2,-5,0,1,3,0,0,0,0,0,1,0,0,0,0,1,2,0,0,0,5,9,-4,2,1,1,-1,2,-9,3,3,6,2,1,-3,3,1,5,-3,1,-6,0,2,1,0,0,1,0,1,0,0,0,1,0,0,0,0,0,0,0,1,0,-8,-5,-3,5,3,2,-3,0,-7,-2,2,1,-2,2,-4,-4,2,0,-1,-2,-3,2,0,1,0,0,1,1,2,1,0,0,1,0,1,1,0,0,0,1,1,0,-5,-1,-4,7,5,2,-3,-5,-4,1,8,-2,-1,-1,-3,-1,5,1,-2,-4,-1,2,3,-3,0,1,2,1,2,1,0,1,1,1,1,1,0,0,1,0,1,0,-4,-11,7,4,2,2,4,6,-3,0,-5,-5,2,1,-3,-3,-4,-3,2,5,0,3,-1,-2,1,1,0,2,0,0,1,0,0,1,0,0,0,1,0,1,0,0,-11,-10,-1,5,1,4,-1,5,-12,2,3,-7,-2,1,-8,0,1,-1,1,4,-4,2,2,-6,0,1,0,1,3,0,0,0,0,0,1,0,0,1,0,1,2,0,30,22,8,18,11,7,3,5,8,1,8,6,0,6,3,3,3,7,3,-1,5,-2,5,-1,2,4,7,2,0,3,1,3,3,1,0,3,1,1,4,1,0,0,19,14,5,18,11,7,2,-4,10,2,5,7,3,0,3,0,3,5,-1,-4,7,2,2,2,1,1,8,5,1,2,0,1,6,3,1,0,1,0,2,2,0,2,36,24,12,24,15,9,11,0,9,6,1,9,7,-2,4,9,0,6,4,2,5,-3,1,3,7,2,9,6,1,-1,3,2,5,6,0,-1,4,0,4,0,1,0,7,7,0,2,3,-1,1,9,-12,1,-1,9,5,2,-7,1,-1,6,-4,7,-5,0,0,3,0,3,0,-1,-1,1,0,2,2,-1,-1,1,0,1,-2,0,0,0,20,11,9,-10,-9,-1,0,7,-8,2,8,13,-2,4,-4,-1,7,7,2,3,-4,3,1,6,-2,2,-4,-3,-2,0,-2,1,-3,-4,-1,0,0,1,-1,1,-1,0,-17,-7,-10,1,0,1,-4,-6,-15,2,1,4,0,-2,-8,0,0,2,-4,-4,-7,2,1,2,2,0,-2,0,0,1,2,0,-2,0,1,-1,0,0,0,0,-1,2,5,0,5,2,2,0,0,4,-2,-1,-2,6,-2,3,0,1,-2,0,2,1,-2,-2,0,6,1,-1,1,-1,1,1,1,-1,1,0,1,0,0,0,0,-1,0,1,0,-12,12,-9,-4,-5,3,1,-8,-11,4,10,-2,-2,-2,-10,1,3,5,3,-6,-1,3,7,0,1,-3,-5,0,-2,0,1,1,-5,0,-1,0,0,-4,0,0,-1,-1,-3,2,6,2,4,3,3,-3,-1,2,-6,0,3,-2,-5,1,0,3,0,-1,4,1,-6,2,2,2,0,0,0,0,1,1,0,0,0,2,1,1,0,0,0,-15,-15,0,1,-3,4,6,-1,-17,-10,1,10,-1,0,-9,-4,-1,3,7,-1,-8,-6,2,7,2,0,-1,-1,0,1,0,-1,-2,-1,0,1,2,1,1,0,0,0,8,5,3,-1,-1,0,-2,7,1,1,4,-3,1,3,-2,1,3,-1,-3,4,3,0,1,-2,-1,1,-1,1,0,-1,0,0,-1,1,0,-1,-1,1,0,0,0,0,30,3,27,-3,-3,0,6,4,6,7,2,4,4,2,-3,0,2,-2,2,2,9,7,0,6,0,0,-1,-1,-1,-1,0,1,-2,-2,1,-1,0,-1,1,1,-2,0
27,27065,Vilalba,15658,-22,-24,2,22,10,12,-16,2,-15,-10,17,2,-7,-3,-11,-6,4,1,-9,5,-4,-4,13,1,3,3,4,2,4,6,3,1,0,2,2,2,0,2,4,0,2,4,14,11,3,18,5,13,6,-8,1,15,6,-6,0,-1,4,5,5,-3,6,-7,-3,10,1,-3,3,0,5,4,4,2,0,0,1,2,2,0,3,0,4,2,2,2,-24,-15,-9,19,12,7,9,-22,-8,-11,11,-1,2,-18,-1,-8,9,0,7,-4,-7,-3,2,-1,4,1,7,-1,3,5,1,1,4,1,2,3,3,0,3,-2,1,2,25,11,14,10,4,6,1,-4,-10,5,19,13,0,0,-14,5,12,7,1,-4,4,0,7,6,1,0,-1,1,2,5,0,-1,-1,0,2,2,1,1,0,1,0,3,14,2,12,29,13,16,8,8,-6,0,8,-6,5,-2,-6,1,6,-2,3,10,0,-1,2,-4,10,6,2,9,1,1,4,3,1,3,1,1,6,3,1,6,0,0,127,80,47,43,29,14,24,7,25,6,20,39,17,3,14,11,13,18,7,4,11,-5,7,21,3,13,10,11,6,0,2,10,5,8,4,0,1,3,5,3,2,0,44,6,38,71,41,30,-3,24,3,-2,13,10,-6,10,-7,-4,6,10,3,14,10,2,7,0,7,21,13,12,10,7,3,11,8,7,6,5,4,10,5,5,4,2,179,126,53,141,94,47,34,30,38,38,16,16,30,22,29,24,8,9,4,8,9,14,8,7,15,36,47,29,9,2,13,23,30,20,5,0,2,13,17,9,4,2,103,72,31,89,50,39,28,15,0,29,25,4,18,8,8,18,11,6,10,7,-8,11,14,-2,16,18,17,27,4,6,10,9,12,15,1,3,6,9,5,12,3,3,29,-13,42,24,-3,27,-4,7,15,-4,12,-2,0,-9,5,-7,1,-7,-4,16,10,3,11,5,7,4,3,4,1,3,4,-2,-3,-4,-2,2,3,6,6,8,3,1,0,15,-15,16,3,13,11,4,-10,-6,-6,6,6,6,-7,12,-6,1,5,-2,-3,-18,0,5,11,2,-1,2,-2,2,5,1,-6,2,-1,1,6,1,5,0,-1,1,8,7,1,19,11,8,-1,8,1,6,-6,2,-4,7,-2,-4,1,7,3,1,3,10,-7,-5,3,7,4,5,-3,3,1,7,1,2,-2,2,2,0,3,3,-1,1,24,13,11,-32,-28,-4,18,1,-9,1,5,6,14,1,-4,-7,3,6,4,0,-5,8,2,0,-7,3,-27,-5,2,2,-3,0,-16,-10,1,0,-4,3,-11,5,1,2,-49,-19,-30,-8,-13,5,13,7,-28,-22,-6,-12,9,0,-9,-14,-2,-2,4,7,-19,-8,-4,-10,-1,4,0,-8,-6,2,-3,2,0,-6,-7,1,2,2,0,-2,1,1,-44,-20,-24,-39,-22,-17,-2,3,-28,-13,-5,2,-6,3,-13,-5,0,3,4,0,-15,-8,-5,-1,-3,-1,-14,-16,-3,-2,-3,0,-6,-10,-2,-1,0,-1,-8,-6,-1,-1,12,17,-5,12,4,8,-4,-2,-14,17,0,17,-7,-1,-3,5,4,18,3,-1,-11,12,-4,-1,1,5,0,8,-3,0,0,3,-2,3,-1,0,1,2,2,5,-2,0,11,2,9,42,18,24,8,-2,-11,-12,8,17,2,3,-7,-5,-1,8,6,-5,-4,-7,9,9,9,14,13,-1,2,4,2,8,8,-3,1,2,7,6,5,2,1,2,18,2,16,47,21,26,9,10,-16,3,1,8,-6,4,-4,6,1,-1,15,6,-12,-3,0,9,11,16,2,12,4,2,6,8,0,5,2,0,5,8,2,7,2,2
27,27066,Viveiro,15425,15,16,-1,25,15,10,5,-38,10,10,13,13,-5,-17,11,5,7,15,10,-21,-1,5,6,-2,4,1,5,5,6,4,2,0,4,2,3,4,2,1,1,3,3,0,51,9,42,15,5,10,14,-3,-9,6,17,24,4,-1,-11,5,3,7,10,-2,2,1,14,17,2,2,0,2,5,3,0,1,0,2,1,0,2,1,0,0,4,3,5,-4,9,23,9,14,3,-25,-13,-4,17,29,0,-13,-7,-5,8,15,3,-12,-6,1,9,14,6,2,2,5,2,6,2,1,1,4,-1,2,4,1,1,1,3,4,88,42,46,47,23,24,-17,-2,37,4,11,53,-3,-6,26,2,4,19,-14,4,11,2,7,34,7,2,7,9,10,11,3,1,3,5,7,4,4,1,4,4,3,7,145,81,64,115,76,39,12,7,23,18,22,61,1,7,17,13,12,29,11,0,6,5,10,32,21,24,27,22,6,13,12,14,21,15,4,8,9,10,6,7,2,5,147,77,70,96,53,43,27,22,22,24,13,39,18,11,14,5,8,22,9,11,8,19,5,17,19,18,26,23,9,1,9,8,15,15,4,2,10,10,11,8,5,-1,179,113,66,198,116,82,18,35,71,10,14,28,6,26,58,8,2,9,12,9,13,2,12,19,32,40,78,24,19,5,14,21,55,15,9,2,18,19,23,9,10,3,270,203,67,326,247,79,19,81,141,11,15,6,6,59,123,6,4,4,13,22,18,5,11,2,22,102,171,31,3,-3,14,76,142,14,2,-1,8,26,29,17,1,-2,180,142,38,207,136,71,25,33,78,-7,19,33,17,23,69,11,4,21,8,10,9,-18,15,12,40,48,87,14,5,11,23,30,70,11,-1,2,17,18,17,3,6,9,42,24,18,69,52,17,43,14,-14,-7,5,0,27,13,-17,-11,9,2,16,1,3,4,-4,-2,22,10,37,-8,7,1,10,7,31,-4,5,3,12,3,6,-4,2,-2,-35,-34,-1,67,19,48,17,0,-59,-15,20,5,13,-6,-45,-11,11,7,4,6,-14,-4,9,-2,21,19,6,5,15,1,13,3,-3,-3,9,0,8,16,9,8,6,1,116,39,77,55,32,23,18,-4,-19,34,9,76,11,3,-23,18,6,24,7,-7,4,16,3,52,17,10,9,18,-1,2,12,5,6,11,-3,1,5,5,3,7,2,1,13,-6,19,24,14,10,17,-16,-23,2,5,26,2,-16,-17,2,4,18,15,0,-6,0,1,8,15,-1,1,3,3,4,9,-1,0,1,1,5,6,0,1,2,2,-1,26,-1,27,-20,-16,-4,1,-4,-12,-15,8,53,1,-5,-15,-9,8,21,0,1,3,-6,0,32,4,4,-24,-7,5,-1,2,2,-16,-8,4,1,2,2,-8,1,1,-2,-90,-46,-44,-35,-27,-8,-19,-3,-61,-32,0,22,-7,5,-39,-22,1,14,-12,-8,-22,-10,-1,8,-7,5,-22,-18,-1,8,-5,4,-14,-12,-4,4,-2,1,-8,-6,3,4,10,6,4,43,13,30,18,15,-12,-15,4,0,6,2,3,-10,1,6,12,13,-15,-5,3,-6,19,12,5,-2,3,5,5,5,2,-4,2,3,14,7,3,2,1,2,94,72,22,64,36,28,24,0,12,37,7,17,21,-3,18,26,7,5,3,3,-6,11,0,12,14,15,19,2,8,4,9,4,13,1,7,1,5,11,6,1,1,3,114,57,57,77,30,47,27,24,30,10,-1,22,20,8,14,3,-4,15,7,16,16,7,3,7,20,20,16,15,1,5,11,6,4,6,-2,5,9,14,12,9,3,0
28,28004,"Álamo, El",4429,182,80,102,24,12,12,25,28,63,17,26,23,8,11,33,10,14,4,17,17,30,7,12,19,4,5,7,3,5,0,2,2,3,2,3,0,2,3,4,1,2,0,264,134,130,68,34,34,39,55,81,54,20,13,17,24,48,30,10,5,22,31,33,24,10,8,21,7,25,12,3,0,11,4,12,6,1,0,10,3,13,6,2,0,547,296,251,131,81,50,109,97,179,54,54,51,68,43,101,26,32,23,41,54,78,28,22,28,35,37,40,14,2,2,28,19,24,7,1,1,7,18,16,7,1,1,396,215,181,95,58,37,57,90,132,59,36,19,29,48,72,38,18,7,28,42,60,21,18,12,11,29,30,8,14,2,6,16,26,3,7,0,5,13,4,5,7,2,308,164,144,122,62,60,43,43,90,61,25,44,25,31,49,31,14,14,18,12,41,30,11,30,13,33,37,18,12,9,5,21,20,6,6,4,8,12,17,12,6,5,361,181,180,112,59,53,47,52,116,66,33,40,34,11,64,39,22,8,13,41,52,27,11,32,18,41,22,20,8,3,10,16,18,10,4,1,8,25,4,10,4,2,356,153,203,158,84,74,41,61,78,67,24,87,21,36,34,32,18,13,20,25,44,35,6,74,22,39,52,30,12,3,13,21,27,17,5,1,9,18,25,13,7,2,353,116,237,167,91,76,-7,42,71,17,22,200,-15,17,43,10,13,45,8,25,28,7,9,155,23,43,58,30,11,1,13,25,34,15,4,0,10,18,24,15,7,1,310,104,206,110,49,61,48,26,59,15,6,156,27,9,25,0,2,40,21,17,34,15,4,116,21,35,27,18,5,2,9,12,14,10,3,0,12,23,13,8,2,2,275,124,151,61,33,28,38,22,37,43,11,121,32,6,29,14,4,41,6,16,8,29,7,80,15,21,8,14,2,0,15,4,7,5,1,0,0,17,1,9,1,0,416,167,249,29,13,16,51,21,90,47,21,179,29,6,39,33,12,42,22,15,51,14,9,137,6,10,-1,12,2,0,3,3,0,6,1,0,3,7,-1,6,1,0,228,98,130,48,25,23,28,44,16,15,29,100,15,15,12,7,19,33,13,29,4,8,10,67,14,16,11,4,1,0,9,8,5,2,0,0,5,8,6,2,1,0,194,78,116,19,11,8,33,10,21,21,16,94,7,8,16,1,16,29,26,2,5,20,0,65,4,15,2,-3,0,1,0,7,3,-1,2,0,4,8,-1,-2,-2,1,29,28,1,-128,-62,-66,4,-13,-1,-27,-8,68,0,0,7,-9,-12,35,4,-13,-8,-18,4,33,-7,-13,-21,-50,-23,-15,-2,-5,-10,-26,-13,-6,-5,-8,-11,-24,-10,-9,157,55,102,-3,-8,5,14,-5,-3,7,2,139,17,-5,5,-5,-1,40,-3,0,-8,12,3,99,3,2,0,-8,-2,2,1,-3,3,-9,-1,1,2,5,-3,1,-1,1,79,13,66,-27,-23,-4,-16,16,19,-10,-1,72,-3,6,3,-15,-4,25,-13,10,16,5,3,47,-3,1,2,-16,-4,-7,2,0,-2,-14,-4,-5,-5,1,4,-2,0,-2,189,75,114,28,20,8,37,21,1,23,-5,116,28,8,2,12,-10,36,9,13,-1,11,5,80,10,11,2,8,-2,-1,8,7,5,5,-3,-2,2,4,-3,3,1,1,299,96,203,107,50,57,45,44,22,44,20,116,10,16,11,16,-1,41,35,28,11,28,21,75,27,21,29,10,14,5,13,11,16,5,3,2,14,10,13,5,11,3
28,28005,Alcalá de Henares,164463,5442,2961,2481,4440,2456,1984,758,1312,2108,984,76,175,419,664,1181,583,18,75,339,648,927,401,58,100,475,1188,1663,897,161,31,253,627,963,514,69,15,222,561,700,383,92,16,6256,3230,3026,5243,2801,2442,968,1551,2358,1079,92,185,504,746,1316,591,4,59,464,805,1042,488,88,126,817,1431,1815,927,186,46,413,717,1048,514,83,16,404,714,767,413,103,30,6375,3278,3097,6168,3238,2930,982,1840,2387,999,-11,134,492,909,1306,547,-30,36,490,931,1081,452,19,98,1016,1790,2016,1020,247,43,510,895,1108,578,113,18,506,895,908,442,134,25,3669,1943,1726,5241,2806,2435,439,1316,1290,490,14,153,234,660,790,240,-18,56,205,656,500,250,32,97,753,1569,1732,893,230,47,400,773,1016,481,106,20,353,796,716,412,124,27,3577,2088,1489,5527,3152,2375,144,1421,1246,598,20,141,8,768,852,417,-4,41,136,653,394,181,24,100,609,1789,1889,941,222,55,298,964,1173,582,98,26,311,825,716,359,124,29,2219,1288,931,5282,2880,2402,203,1072,514,489,-155,137,90,650,387,263,-111,31,113,422,127,226,-44,106,700,1635,1709,915,234,64,360,882,1029,479,96,25,340,753,680,436,138,39,2205,1130,1075,5987,3192,2795,206,1397,383,291,-159,111,119,792,246,105,-117,5,87,605,137,186,-42,106,793,2026,1889,955,255,42,417,1048,1113,481,110,11,376,978,776,474,145,31,2694,1577,1117,6301,3501,2800,263,1643,236,446,43,102,134,901,301,238,-23,42,129,742,-65,208,66,60,803,2230,1870,1034,310,18,415,1171,1163,582,141,12,388,1059,707,452,169,6,-352,-402,50,2343,1100,1243,2,305,-608,-79,-120,173,-17,115,-365,-83,-82,40,19,190,-243,4,-38,133,338,783,687,409,102,4,173,361,332,175,48,-1,165,422,355,234,54,5,-1018,-768,-250,900,265,635,-141,261,-727,-340,-91,35,-74,50,-465,-220,-53,5,-67,211,-262,-120,-38,30,124,524,135,52,49,-3,59,196,13,-21,8,6,65,328,122,73,41,-9,-293,-222,-71,2211,1060,1151,-58,301,-389,-171,-68,118,-58,135,-202,-70,-77,57,0,166,-187,-101,9,61,278,632,702,380,159,39,138,270,354,211,62,10,140,362,348,169,97,29,-545,-439,-106,716,246,470,-186,212,-498,-201,-77,202,-79,45,-298,-144,-59,84,-107,167,-200,-57,-18,118,16,406,158,68,48,1,13,145,57,15,8,-2,3,261,101,53,40,3,1125,405,720,1306,504,802,192,613,105,-11,16,188,150,175,18,-36,-8,83,42,438,87,25,24,105,170,674,273,92,50,27,97,242,115,21,14,5,73,432,158,71,36,22,-121,-228,107,156,-46,202,31,267,-296,-173,-88,117,16,75,-154,-135,-70,30,15,192,-142,-38,-18,87,10,320,-102,-79,-20,11,2,85,-67,-58,-17,4,8,235,-35,-21,-3,7,678,125,553,1187,460,727,177,432,39,-71,-45,127,49,148,15,-63,-61,37,128,284,24,-8,16,90,152,609,279,49,50,22,73,220,129,9,6,8,79,389,150,40,44,14,276,26,250,644,259,385,99,260,-145,-60,28,62,74,164,-150,-60,-33,3,25,96,5,0,61,59,118,305,74,40,51,21,73,156,-21,9,23,2,45,149,95,31,28,19,973,194,779,1448,562,886,165,474,77,37,18,164,54,156,-9,-39,-30,57,111,318,86,76,48,107,242,589,326,112,103,54,116,230,143,23,27,16,126,359,183,89,76,38,1278,428,850,1697,724,973,169,514,301,70,29,172,85,188,122,5,-29,52,84,326,179,65,58,120,255,568,456,230,110,55,116,211,239,104,36,12,139,357,217,126,74,43
28,28006,Alcobendas,87924,2597,1255,1342,2590,1268,1322,574,553,887,468,-6,87,328,273,404,227,-13,20,246,280,483,241,7,67,490,520,945,505,92,20,266,238,457,246,49,4,224,282,488,259,43,16,1972,836,1136,2356,1062,1294,577,357,543,429,-14,42,273,147,230,174,-13,9,304,210,313,255,-1,33,528,447,769,455,104,30,275,179,346,196,48,7,253,268,423,259,56,23,2162,935,1227,2138,973,1165,534,500,732,326,-51,47,263,199,316,154,-49,11,271,301,416,172,-2,36,554,440,599,399,104,17,281,176,275,181,41,6,273,264,324,218,63,11,2599,1181,1418,1851,854,997,637,509,837,480,-49,139,315,219,408,228,-44,36,322,290,429,252,-5,103,408,421,543,352,72,28,193,199,259,158,22,11,215,222,284,194,50,17,1920,783,1137,1799,752,1047,362,490,660,364,-92,115,153,228,281,148,-76,38,209,262,379,216,-16,77,278,398,547,417,107,40,145,149,211,179,45,20,133,249,336,238,62,20,1955,824,1131,2140,970,1170,429,456,638,386,-33,40,197,202,284,156,-49,9,232,254,354,230,16,31,413,470,657,446,98,36,202,201,303,198,39,17,211,269,354,248,59,19,1230,400,830,2131,884,1247,280,541,310,117,-96,39,141,197,96,21,-92,8,139,344,214,96,-4,31,417,536,649,410,69,19,205,217,244,164,28,10,212,319,405,246,41,9,546,209,337,2533,1171,1362,132,445,-76,156,-154,50,51,237,-72,45,-54,15,81,208,-4,111,-100,35,435,660,848,481,70,14,210,332,359,219,28,7,225,328,489,262,42,7,789,354,435,2019,949,1070,198,447,-66,168,-41,46,123,222,-25,41,-2,-18,75,225,-41,127,-39,64,387,537,579,386,85,10,210,243,285,159,44,-8,177,294,294,227,41,18,281,-89,370,729,273,456,27,179,48,104,-119,26,-32,69,-76,10,-55,-13,59,110,124,94,-64,39,140,214,225,119,-2,7,61,89,74,26,8,2,79,125,151,93,-10,5,-798,-466,-332,-738,-422,-316,-152,55,-8,-380,-298,-36,-52,0,-8,-237,-168,-26,-100,55,0,-143,-130,-10,-186,42,-44,-365,-167,-39,-68,-20,-19,-213,-96,-18,-118,62,-25,-152,-71,-21,572,218,354,143,-25,168,214,135,104,27,-31,80,120,-4,47,36,-44,34,94,139,57,-9,13,46,69,143,-10,-92,13,-6,33,26,-27,-63,-10,5,36,117,17,-29,23,-11,595,182,413,56,6,50,299,107,-42,140,-88,133,186,16,-51,40,-57,31,113,91,9,100,-31,102,76,86,-54,-43,-27,0,56,31,-35,-33,-22,-2,20,55,-19,-10,-5,2,-478,-380,-98,-726,-438,-288,73,30,-108,-323,-201,6,15,-6,-93,-207,-101,-16,58,36,-15,-116,-100,22,-105,18,-175,-339,-114,-30,-66,-6,-91,-202,-67,-17,-39,24,-84,-137,-47,-13,311,61,250,128,5,123,310,148,-31,49,-172,-9,162,65,-30,-9,-101,-42,148,83,-1,58,-71,33,109,151,-32,-28,-63,-15,60,54,-26,-31,-44,-12,49,97,-6,3,-19,-3,-147,-171,24,185,-12,197,29,125,-55,-224,-135,81,3,54,-31,-134,-90,13,26,71,-24,-90,-45,68,27,157,61,-67,-35,20,16,68,8,-81,-46,7,11,89,53,14,11,13,926,290,636,807,284,523,398,243,181,110,-116,63,202,104,14,5,-69,-9,196,139,167,105,-47,72,245,262,155,79,7,35,122,106,29,19,-12,7,123,156,126,60,19,28,1013,301,712,1241,499,742,378,375,118,184,-98,24,160,153,1,47,-53,-25,218,222,117,137,-45,49,309,380,297,199,-5,27,162,174,100,50,-7,2,147,206,197,149,2,25
28,28007,Alcorcón,142048,2171,1107,1064,2087,1093,994,389,566,772,347,-22,97,218,239,450,185,-39,36,171,327,322,162,17,61,289,539,780,343,89,32,152,251,456,181,32,12,137,288,324,162,57,20,2200,1121,1079,2199,1158,1041,592,567,656,342,-70,91,311,304,370,141,-52,39,281,263,286,201,-18,52,415,535,760,341,98,34,222,267,441,166,38,17,193,268,319,175,60,17,2138,981,1157,2542,1295,1247,432,683,703,358,-130,101,194,341,365,156,-95,27,238,342,338,202,-35,74,494,675,790,396,135,42,252,324,440,206,54,16,242,351,350,190,81,26,2939,1499,1440,2422,1295,1127,365,692,1001,618,30,229,216,381,539,285,-13,85,149,311,462,333,43,144,363,666,771,411,140,53,195,364,448,214,46,22,168,302,323,197,94,31,1234,574,660,2510,1346,1164,75,694,185,267,-88,115,23,352,155,110,-80,26,52,342,30,157,-8,89,345,680,837,457,131,46,177,360,494,241,48,19,168,320,343,216,83,27,253,38,215,2191,1172,1019,-24,530,-210,75,-135,43,-39,264,-93,16,-97,3,15,266,-117,59,-38,40,338,615,693,373,125,33,169,318,398,214,52,15,169,297,295,159,73,18,1166,359,807,2474,1263,1211,168,734,190,200,-162,43,62,346,38,36,-103,-6,106,388,152,164,-59,49,375,716,766,470,98,33,190,350,426,240,38,13,185,366,340,230,60,20,664,259,405,2826,1455,1371,-4,726,-104,114,-111,86,-27,389,-6,8,-99,14,23,337,-98,106,-12,72,471,807,876,479,146,29,232,410,494,242,58,11,239,397,382,237,88,18,-2682,-1566,-1116,-720,-449,-271,-355,62,-1209,-830,-321,-36,-190,46,-671,-544,-191,-22,-165,16,-538,-286,-130,-14,-13,219,-249,-416,-178,-105,-6,117,-138,-302,-98,-33,-7,102,-111,-114,-80,-72,-777,-547,-230,412,105,307,-1,192,-565,-167,-212,23,0,53,-352,-120,-109,-3,-1,139,-213,-47,-103,26,116,169,50,68,9,-10,46,64,-2,-3,-1,-3,70,105,52,71,10,-7,-33,-150,117,1102,548,554,-34,314,-100,-75,-68,-53,15,126,-58,-108,-67,-45,-49,188,-42,33,-1,-8,117,322,357,191,93,14,63,151,203,89,28,5,54,171,154,102,65,9,290,-94,384,782,350,432,36,266,33,-84,-17,64,-19,123,-114,-94,-12,30,55,143,147,10,-5,34,118,271,195,106,50,31,58,126,78,46,18,13,60,145,117,60,32,18,584,169,415,504,236,268,57,197,191,-30,37,132,7,94,74,-47,2,43,50,103,117,17,35,89,83,161,112,70,51,23,38,75,63,33,17,10,45,86,49,37,34,13,230,66,164,375,140,235,54,165,-8,22,18,-13,26,72,-50,32,13,-20,28,93,42,-10,5,7,69,137,130,0,17,8,34,55,53,-10,-4,5,35,82,77,10,21,3,-3158,-1942,-1216,-2424,-1391,-1033,-458,-171,-996,-1034,-372,-128,-219,-126,-649,-643,-227,-70,-239,-45,-347,-391,-145,-58,-254,-205,-833,-752,-287,-101,-102,-131,-488,-478,-157,-40,-152,-74,-345,-274,-130,-61,518,89,429,949,433,516,63,255,114,22,40,28,-19,103,55,-30,-6,-6,82,152,59,52,46,34,151,237,272,134,88,49,58,113,139,66,32,15,93,124,133,68,56,34,769,253,516,1103,496,607,65,317,265,-16,106,23,2,175,107,-32,22,-29,63,142,158,16,84,52,186,282,285,200,94,36,77,148,132,93,27,11,109,134,153,107,67,25,960,339,621,962,447,515,223,259,201,89,93,96,120,83,57,-2,33,44,103,176,144,91,60,52,159,233,259,166,92,43,92,85,119,94,35,15,67,148,140,72,57,28
28,28008,Aldea del Fresno,1396,46,32,14,27,14,13,7,8,6,17,5,3,5,5,9,10,2,0,2,3,-3,7,3,3,7,7,7,4,1,1,2,6,2,4,0,0,5,1,5,0,1,1,103,51,52,29,19,10,15,13,40,19,13,3,6,8,22,10,5,1,9,5,18,9,8,2,6,5,14,4,0,0,3,3,11,2,0,0,3,2,3,2,0,0,222,126,96,42,30,12,40,25,43,51,37,26,21,17,22,28,21,16,19,8,21,23,16,10,7,17,12,3,2,1,7,11,9,1,1,1,0,6,3,2,1,0,95,49,46,47,27,20,-1,32,23,22,-1,19,-10,24,20,11,-4,9,9,8,3,11,3,10,7,19,14,6,0,1,2,15,7,3,0,0,5,4,7,3,0,1,126,80,46,39,27,12,8,30,44,10,15,17,11,12,31,13,6,7,-3,18,13,-3,9,10,3,10,18,6,1,1,3,8,12,3,1,0,0,2,6,3,0,1,128,61,67,35,18,17,11,26,68,14,-4,10,-3,12,41,4,2,4,14,14,27,10,-6,6,3,6,15,8,1,1,2,3,10,3,0,0,1,3,5,5,1,1,141,69,72,40,27,13,39,35,33,25,5,5,16,22,22,15,-4,-1,23,13,11,10,9,6,4,11,16,5,2,1,2,10,11,2,0,1,2,1,5,3,2,0,175,115,60,88,55,33,25,46,60,44,4,-2,17,21,44,28,3,1,8,25,16,16,1,-3,12,30,33,9,1,2,8,14,25,6,1,1,4,16,8,3,0,1,68,47,21,59,28,31,18,23,9,12,6,1,16,12,7,9,2,2,2,11,2,3,4,-1,10,15,22,9,0,2,8,5,12,4,-1,0,2,10,10,5,1,2,44,27,17,32,15,17,8,1,18,2,14,4,2,2,14,0,9,-1,6,-1,4,2,5,5,5,6,14,6,1,0,3,2,7,3,0,0,2,4,7,3,1,0,29,14,15,21,12,9,9,-6,-2,5,14,12,12,-11,2,1,8,5,-3,5,-4,4,6,7,10,1,7,4,-1,0,6,-1,6,1,0,0,4,2,1,3,-1,0,12,3,9,18,8,10,-8,10,-4,3,12,-1,-3,8,-3,-3,7,-3,-5,2,-1,6,5,2,1,3,10,2,1,1,1,3,5,-3,1,1,0,0,5,5,0,0,32,1,31,7,4,3,20,0,12,2,-6,5,6,-2,-4,3,-6,5,14,2,16,-1,0,0,-2,1,4,0,4,0,0,0,4,-2,2,0,-2,1,0,2,2,0,-47,-19,-28,-20,-16,-4,-13,-7,-19,-11,-1,6,-3,-6,-7,-4,-1,3,-10,-1,-12,-7,0,3,0,-1,-11,-7,0,-1,0,-2,-7,-5,-2,0,0,1,-4,-2,2,-1,16,17,-1,1,-3,4,3,-7,8,6,-8,12,8,-5,4,7,-5,6,-5,-2,4,-1,-3,6,2,0,-1,1,-1,0,2,-1,-1,-2,-1,0,0,1,0,3,0,0,44,16,28,-1,-2,1,-18,8,21,6,16,8,-7,-1,9,3,6,3,-11,9,12,3,10,5,-4,-1,0,3,0,-1,-3,0,-2,2,0,-1,-1,-1,2,1,0,0,24,-2,26,6,4,2,7,-4,-12,16,3,12,-6,3,-10,8,-4,6,13,-7,-2,8,7,6,4,0,-2,5,-1,0,2,2,-1,2,-1,0,2,-2,-1,3,0,0,69,33,36,-3,-7,4,7,13,0,24,13,10,10,2,-4,16,5,5,-3,11,4,8,8,5,5,5,-4,-4,-5,0,4,0,-4,-3,-4,0,1,5,0,-1,-1,0
28,28009,Algete,14033,441,182,259,155,50,105,34,90,192,46,38,23,5,18,104,22,15,11,29,72,88,24,23,12,37,24,48,33,7,4,11,3,15,15,5,1,26,21,33,18,2,3,300,122,178,105,50,55,45,51,145,31,16,5,9,22,65,19,7,-4,36,29,80,12,9,9,21,18,32,21,6,6,11,10,16,6,3,3,10,8,16,15,3,3,421,156,265,177,71,106,119,57,144,23,19,37,53,21,68,-5,3,10,66,36,76,28,16,27,47,34,53,29,4,8,22,13,23,8,0,3,25,21,30,21,4,5,357,154,203,197,81,116,97,45,170,24,-19,21,45,12,94,1,-10,4,52,33,76,23,-9,17,34,40,63,43,8,7,19,13,26,17,2,3,15,27,37,26,6,4,-226,-118,-108,131,60,71,-64,-28,-47,-60,-33,4,-43,-11,-23,-27,-20,4,-21,-17,-24,-33,-13,0,21,39,35,28,6,2,12,19,17,9,3,0,9,20,18,19,3,2,-72,-46,-26,202,86,116,-14,25,-41,-32,-31,5,-10,10,-8,-28,-16,4,-4,15,-33,-4,-15,1,42,49,45,53,2,6,20,20,19,22,0,2,22,29,26,31,2,4,440,189,251,391,164,227,95,84,132,92,4,17,49,21,72,31,7,-2,46,63,60,61,-3,19,64,91,98,106,21,3,36,38,39,38,11,0,28,53,59,68,10,3,331,205,126,420,194,226,33,137,115,12,6,7,25,82,79,-5,11,1,8,55,36,17,-5,6,53,133,121,86,22,1,25,60,63,36,8,1,28,73,58,50,14,0,284,171,113,275,140,135,76,61,61,70,-13,17,23,48,52,39,-2,6,53,13,9,31,-11,11,72,73,73,50,7,-2,36,44,29,24,4,0,36,29,44,26,3,-2,134,86,48,167,75,92,46,16,9,20,-5,25,50,13,-22,20,-2,16,-4,3,31,0,-3,9,37,31,37,26,10,8,19,13,9,11,6,6,18,18,28,15,4,2,190,87,103,119,43,76,87,2,26,26,-4,28,49,5,-15,25,-2,12,38,-3,41,1,-2,16,21,26,25,11,6,4,4,12,3,4,2,3,17,14,22,7,4,1,-86,-57,-29,5,-3,8,24,-19,-52,-43,-28,9,6,-4,-54,-11,-11,5,18,-15,2,-32,-17,4,-3,18,-10,-10,-1,-6,0,13,-17,-7,-2,0,-3,5,7,-3,1,-6,-2,-25,23,38,7,31,36,-22,-50,5,-7,21,7,-11,-18,-16,-1,6,29,-11,-32,21,-6,15,8,-1,18,-4,-2,7,2,-3,6,-6,-1,3,6,2,12,2,-1,4,-43,-34,-9,15,5,10,10,-13,-39,-12,-15,2,1,-9,-22,0,-11,-5,9,-4,-17,-12,-4,7,3,8,-10,3,-1,-3,-3,0,-1,6,-1,-3,6,8,-9,-3,0,0,81,42,39,15,4,11,112,-16,-2,-22,-16,10,48,-8,-6,-2,-2,4,64,-8,4,-20,-14,6,1,4,4,-9,4,0,-4,-4,8,1,-1,1,5,8,-4,-10,5,-1,-223,-41,-182,12,32,-20,26,-34,-89,-86,-49,-5,66,-12,-29,-41,-31,0,-40,-22,-60,-45,-18,-5,38,2,-9,-24,-4,-3,43,-4,6,-15,-3,-1,-5,6,-15,-9,-1,-2,54,53,1,-5,32,-37,64,10,-41,-20,-7,28,39,13,-26,16,0,0,25,-3,-15,-36,-7,28,12,12,-27,-28,-1,10,25,5,-12,0,-1,7,-13,7,-15,-28,0,3,247,80,167,289,125,164,106,33,10,45,-9,25,54,18,-11,1,-10,14,52,15,21,44,1,11,50,59,56,59,29,14,27,30,21,27,7,5,23,29,35,32,22,9
28,28010,Alpedrete,6337,826,405,421,184,97,87,158,97,304,148,78,38,84,50,138,78,40,15,74,47,166,70,38,23,38,43,57,35,6,4,22,25,26,19,4,1,16,18,31,16,2,3,633,315,318,203,101,102,98,79,269,118,37,25,58,29,141,59,14,13,40,50,128,59,23,12,28,41,75,49,8,0,15,20,36,26,4,0,13,21,39,23,4,0,605,298,307,185,95,90,88,71,265,82,65,34,37,34,137,51,33,6,51,37,128,31,32,28,48,28,58,34,12,5,26,11,34,16,7,1,22,17,24,18,5,4,668,328,340,171,73,98,140,97,216,137,31,47,83,37,121,68,5,18,57,60,95,69,26,29,43,51,39,32,4,1,19,19,21,13,1,0,24,32,18,19,3,1,634,308,326,170,86,84,112,91,229,119,44,44,69,39,107,56,13,24,43,52,122,63,31,20,22,41,61,26,10,3,13,20,36,6,4,2,9,21,25,20,6,1,484,224,260,167,69,98,65,49,229,54,45,25,30,31,107,17,21,6,35,18,122,37,24,19,21,33,55,34,12,6,4,15,26,12,4,3,17,18,29,22,8,3,358,154,204,184,75,109,68,49,145,34,28,22,35,12,72,13,15,1,33,37,73,21,13,21,43,37,47,34,14,7,24,17,14,13,3,3,19,20,33,21,11,4,249,84,165,214,104,110,-1,57,126,19,20,28,-17,23,55,6,8,11,16,34,71,13,12,17,33,50,84,35,9,1,16,28,41,16,3,0,17,22,43,19,6,1,245,105,140,82,37,45,44,37,41,72,21,33,40,17,14,28,5,6,4,20,27,44,16,27,7,28,22,12,6,6,6,17,9,-2,3,3,1,11,13,14,3,3,254,116,138,14,5,9,90,10,45,63,20,34,38,2,30,29,9,11,52,8,15,34,11,23,-1,11,4,-4,-1,1,0,2,3,-4,2,-1,-1,9,1,0,-3,2,96,52,44,32,5,27,27,19,4,30,-9,19,21,17,-1,12,-7,7,6,2,5,18,-2,12,3,11,8,8,0,-1,-2,4,3,0,0,0,5,7,5,8,0,-1,6,-20,26,29,18,11,-41,14,8,-4,19,8,-35,6,5,-12,7,7,-6,8,3,8,12,1,-9,15,11,4,6,-1,-5,12,7,-1,3,0,-4,3,4,5,3,-1,86,24,62,36,6,30,12,-1,72,9,-12,0,-11,-10,33,8,-2,3,23,9,39,1,-10,-3,8,13,10,8,-5,1,2,0,6,-1,-1,0,6,13,4,9,-4,1,-90,-45,-45,-108,-57,-51,-3,2,-43,-47,-9,8,5,-3,-11,-30,-8,1,-8,5,-32,-17,-1,7,-5,-10,-34,-36,-19,-6,1,-4,-19,-22,-8,-5,-6,-6,-15,-14,-11,-1,39,-5,44,-108,-71,-37,24,6,-11,-1,-10,28,15,15,-13,-27,-9,14,9,-9,2,26,-1,14,-23,-5,-31,-34,-14,-2,-21,-1,-19,-25,-6,1,-2,-4,-12,-9,-8,-3,90,39,51,12,13,-1,12,6,20,-24,22,52,9,9,-2,-10,17,15,3,-3,22,-14,5,37,1,10,4,-5,-3,1,3,5,4,0,-2,1,-2,5,0,-5,-1,0,22,-1,23,58,14,44,-4,-9,-10,12,2,28,14,-17,-20,11,-1,9,-18,8,10,1,3,19,23,18,1,7,4,5,14,4,-7,-1,1,3,9,14,8,8,3,2,230,101,129,47,26,21,58,12,57,34,23,41,39,2,26,13,9,10,19,10,31,21,14,31,6,3,17,6,7,5,5,2,9,5,4,-1,1,1,8,1,3,6
28,28013,Aranjuez,39326,383,175,208,196,84,112,115,53,141,56,0,2,49,17,79,21,-6,8,66,36,62,35,6,-6,30,46,73,35,6,2,12,13,38,15,2,1,18,33,35,20,4,1,1078,557,521,667,351,316,213,206,384,198,30,32,119,128,192,94,12,5,94,78,192,104,18,27,137,160,220,117,23,5,78,89,113,57,8,2,59,71,107,60,15,3,1421,728,693,685,355,330,271,231,509,264,87,43,140,105,276,152,40,6,131,126,233,112,47,37,141,158,220,125,30,5,76,78,120,64,13,0,65,80,100,61,17,5,830,399,431,499,272,227,215,130,224,152,37,62,106,54,128,88,14,5,109,76,96,64,23,57,103,121,165,78,21,7,53,62,93,49,11,1,50,59,72,29,10,6,1311,688,623,794,423,371,220,270,454,251,48,59,96,128,267,151,20,18,124,142,187,100,28,41,130,221,261,141,27,11,64,101,156,82,14,4,66,120,105,59,13,7,1469,728,741,692,307,385,248,316,565,295,29,13,128,150,284,160,-1,9,120,166,281,135,30,4,114,213,201,116,36,9,48,94,102,54,9,0,66,119,99,62,27,9,1942,982,960,1063,532,531,358,391,697,284,141,28,187,225,329,154,63,4,171,166,368,130,78,24,201,319,301,176,50,6,113,161,150,88,16,-1,88,158,151,88,34,7,2354,1236,1118,1309,677,632,385,528,739,427,157,95,209,251,418,238,80,27,176,277,321,189,77,68,252,384,362,216,68,23,126,187,215,114,27,8,126,197,147,102,41,15,1481,700,781,778,389,389,227,349,476,233,115,50,125,156,227,111,59,11,102,193,249,122,56,39,144,246,210,117,37,10,79,124,96,63,18,2,65,122,114,54,19,8,572,206,366,270,96,174,132,41,206,98,42,56,47,-10,90,42,22,17,85,51,116,56,20,39,48,67,77,42,17,14,19,13,33,16,8,6,29,54,44,26,9,8,365,135,230,247,104,143,100,120,118,1,25,16,83,45,38,-32,-3,8,17,75,80,33,28,8,14,92,79,24,33,6,12,32,42,10,7,1,2,60,37,14,26,5,517,125,392,-4,-44,40,60,141,121,106,49,29,2,73,4,24,22,1,58,68,117,82,27,28,10,49,6,-60,-7,-7,9,18,-17,-41,-11,-2,1,31,23,-19,4,-5,634,362,272,45,6,39,120,54,217,123,39,96,71,33,106,89,17,56,49,21,111,34,22,40,-4,37,25,-14,-4,5,-10,20,4,-7,-1,2,6,17,21,-7,-3,3,278,109,169,-221,-131,-90,1,60,16,-13,80,133,21,11,28,-32,39,46,-20,49,-12,19,41,87,-24,-10,-81,-80,-25,-7,-2,-18,-46,-50,-15,-1,-22,8,-35,-30,-10,-6,470,195,275,134,63,71,38,95,91,37,88,131,21,40,33,7,43,53,17,55,58,30,45,78,-7,66,50,-6,13,13,-3,34,30,-5,-1,5,-4,32,20,-1,14,8,214,120,94,-9,4,-13,38,32,15,28,42,62,32,14,0,28,30,20,6,18,15,0,12,42,-10,8,2,-13,1,-1,6,3,5,-11,-2,1,-16,5,-3,-2,3,-2,451,179,272,203,59,144,45,90,104,61,77,53,40,48,17,16,21,26,5,42,87,45,56,27,26,84,45,6,26,5,10,34,18,-12,2,0,16,50,27,18,24,5,935,428,507,518,238,280,167,159,221,160,118,103,80,74,123,56,56,39,87,85,98,104,62,64,85,126,127,80,63,27,50,59,75,25,17,10,35,67,52,55,46,17
28,28014,Arganda del Rey,30231,936,640,296,1078,682,396,56,268,370,171,35,36,32,162,275,135,22,13,24,106,95,36,13,23,94,297,431,216,26,5,42,176,288,157,11,3,52,121,143,59,15,2,1453,891,562,1339,831,508,203,448,502,239,30,34,107,262,315,173,20,14,96,186,187,66,10,20,176,414,477,241,27,4,84,251,307,172,16,1,92,163,170,69,11,3,1946,1042,904,1778,954,824,403,535,632,321,45,4,231,273,365,159,10,-3,172,262,267,162,35,7,341,551,522,301,49,9,194,287,300,147,20,4,147,264,222,154,29,5,1904,1079,825,1515,849,666,261,593,604,306,62,70,145,341,357,176,28,24,116,252,247,130,34,46,219,530,456,233,56,9,113,293,274,133,27,2,106,237,182,100,29,7,2753,1534,1219,1689,1003,686,332,703,1104,436,81,71,173,373,642,264,43,28,159,330,462,172,38,43,165,613,565,283,52,7,89,344,356,177,32,2,76,269,209,106,20,5,3374,1709,1665,1600,862,738,542,694,1277,474,132,220,266,384,664,238,62,74,276,310,613,236,70,146,263,522,495,242,57,7,138,296,268,124,26,3,125,226,227,118,31,4,3497,1878,1619,2249,1205,1044,531,908,1216,595,123,86,255,457,714,330,77,23,276,451,502,265,46,63,321,763,660,374,96,18,155,382,411,193,53,3,166,381,249,181,43,15,2327,1313,1014,2106,1235,871,203,780,712,429,143,51,118,427,446,240,59,18,85,353,266,189,84,33,251,751,596,392,107,-3,136,429,386,227,53,-3,115,322,210,165,54,0,677,342,335,461,268,193,94,189,261,85,4,43,48,85,147,40,5,6,46,104,114,45,-1,37,62,148,172,71,4,3,33,76,124,30,1,4,29,72,48,41,3,-1,1229,521,708,461,191,270,171,292,361,180,45,151,97,128,152,61,11,58,74,164,209,119,34,93,74,188,101,51,25,6,42,83,39,16,-2,2,32,105,62,35,27,4,724,239,485,207,61,146,89,237,251,45,5,76,26,108,65,17,-5,20,63,129,186,28,10,56,79,186,-34,-22,-19,4,44,90,-40,-29,-13,3,35,96,6,7,-6,1,892,436,456,475,216,259,68,300,268,107,65,64,52,139,141,32,27,32,16,161,127,75,38,32,46,219,88,61,44,7,15,102,61,9,20,2,31,117,27,52,24,5,-4,-34,30,-162,-125,-37,-27,57,4,-64,1,24,-8,29,4,-62,4,0,-19,28,0,-2,-3,24,-27,15,-97,-51,-8,-2,-6,-14,-64,-43,-4,0,-21,29,-33,-8,-4,-2,-814,-546,-268,-972,-594,-378,-54,-37,-363,-224,-152,10,-45,-26,-238,-162,-83,-1,-9,-11,-125,-62,-69,11,-107,-51,-332,-272,-173,-41,-64,-28,-204,-191,-94,-17,-43,-23,-128,-81,-79,-24,-1006,-670,-336,-1119,-721,-398,-17,-59,-492,-378,-159,83,5,-58,-298,-269,-90,34,-22,-1,-194,-109,-69,49,-85,-16,-455,-394,-154,-25,-43,-18,-295,-266,-93,-12,-42,2,-160,-128,-61,-13,455,159,296,366,174,192,89,69,151,33,34,71,29,32,44,28,21,3,60,37,107,5,13,68,78,90,98,56,27,9,43,41,46,26,11,0,35,49,52,30,16,9,-1026,-622,-404,-1452,-811,-641,-150,-15,-402,-436,-133,78,-68,8,-242,-269,-89,24,-82,-23,-160,-167,-44,54,-188,-41,-537,-496,-181,-25,-81,-4,-297,-316,-112,-10,-107,-37,-240,-180,-69,-15,-25,-88,63,-537,-324,-213,-23,85,-101,-82,-2,88,-14,50,-69,-77,-7,23,-9,35,-32,-5,5,65,-81,24,-223,-194,-67,-1,-41,16,-110,-144,-42,-7,-40,8,-113,-50,-25,6
28,28015,Arroyomolinos,3101,682,348,334,8,4,4,163,88,213,161,32,16,82,46,101,91,18,4,81,42,112,70,14,12,2,2,3,1,0,0,1,1,2,0,0,0,1,1,1,1,0,0,580,298,282,19,11,8,113,68,227,113,39,19,52,42,113,60,21,10,61,26,114,53,18,9,6,2,6,2,3,0,3,2,3,1,2,0,3,0,3,1,1,0,542,246,296,-1,-1,0,110,72,196,96,44,15,50,30,91,48,18,7,60,42,105,48,26,8,1,-1,-1,0,0,0,0,0,-1,0,0,0,1,-1,0,0,0,0,664,363,301,19,11,8,150,75,231,132,35,25,88,38,127,71,21,9,62,37,104,61,14,16,4,1,8,2,3,1,2,1,3,2,3,0,2,0,5,0,0,1,1022,551,471,105,58,47,216,163,363,184,66,17,122,83,204,102,25,8,94,80,159,82,41,9,15,33,39,13,4,1,10,13,23,8,3,1,5,20,16,5,1,0,632,308,324,85,34,51,102,98,276,98,30,18,48,41,134,58,15,8,54,57,142,40,15,10,11,23,30,9,9,2,6,6,12,6,3,1,5,17,18,3,6,1,625,331,294,87,41,46,131,89,229,113,24,26,71,48,124,55,16,8,60,41,105,58,8,18,15,24,28,17,2,0,10,8,11,13,0,-1,5,16,17,4,2,1,1854,945,909,111,57,54,393,175,770,326,109,34,199,86,399,178,47,14,194,89,371,148,62,20,7,32,52,10,5,4,4,15,31,3,0,3,3,17,21,7,5,1,1782,884,898,55,22,33,367,148,791,310,97,32,192,70,393,162,43,9,175,78,398,148,54,23,11,8,24,11,3,-3,4,-1,15,4,1,-2,7,9,9,7,2,-1,2107,1092,1015,24,3,21,442,124,982,406,84,23,233,48,515,208,51,11,209,76,467,198,33,12,14,11,-13,1,5,5,6,0,-11,1,4,2,8,11,-2,0,1,3,2980,1519,1461,5,-4,9,527,230,1495,533,80,24,252,103,761,309,35,7,275,127,734,224,45,17,-3,9,-7,1,-2,6,-5,6,-8,1,-3,4,2,3,1,0,1,2,2493,1250,1243,71,38,33,604,254,1005,442,112,29,301,133,489,236,46,20,303,121,516,206,66,9,29,20,18,-4,9,-2,15,10,9,-2,3,1,14,10,9,-2,6,-3,1383,693,690,9,-3,12,258,86,579,314,79,36,128,38,276,181,37,15,130,48,303,133,42,21,4,11,-2,1,-2,-4,2,6,-7,-2,1,-3,2,5,5,3,-3,-1,629,298,331,-17,-14,-3,90,43,350,85,19,33,41,12,164,53,9,15,49,31,186,32,10,18,-3,2,-1,-16,-3,3,3,-1,-7,-8,-3,2,-6,3,6,-8,0,1,983,399,584,72,19,53,170,74,322,226,119,52,87,21,152,87,34,16,83,53,170,139,85,36,5,15,12,14,13,13,1,5,0,6,4,4,4,10,12,8,9,9,853,407,446,61,30,31,175,59,258,211,67,64,111,29,105,98,30,20,64,30,153,113,37,44,8,23,11,7,6,7,9,10,5,6,0,0,-1,13,6,1,6,7,501,224,277,63,25,38,140,25,146,136,32,6,64,2,89,47,18,0,76,23,57,89,14,6,15,20,0,10,8,7,10,7,1,1,4,2,5,13,-1,9,4,5,530,259,271,126,53,73,88,27,190,125,48,47,46,14,80,89,15,16,42,13,110,36,33,31,26,26,33,16,11,13,7,11,21,7,0,7,19,15,12,9,11,6
28,28018,Becerril de la Sierra,3055,233,126,107,93,50,43,36,36,80,55,16,7,23,15,40,34,7,6,13,21,40,21,9,1,16,25,24,22,2,4,8,12,16,11,0,3,8,13,8,11,2,1,241,132,109,98,53,45,48,46,80,44,21,0,27,23,41,30,9,0,21,23,39,14,12,0,28,29,26,11,2,0,16,17,11,7,0,0,12,12,15,4,2,0,189,101,88,91,45,46,22,37,61,29,18,15,9,22,37,7,12,9,13,15,24,22,6,6,29,18,29,12,1,2,11,11,17,4,1,1,18,7,12,8,0,1,214,123,91,46,22,24,36,24,72,36,32,11,32,13,36,24,14,4,4,11,36,12,18,7,17,12,9,6,2,-1,11,6,5,0,0,0,6,6,4,6,2,-1,177,67,110,58,22,36,10,24,64,34,27,12,2,6,27,14,10,4,8,18,37,20,17,8,14,9,18,6,8,3,7,2,8,0,4,1,7,7,10,6,4,2,129,55,74,41,20,21,16,17,27,37,31,6,7,0,11,16,24,-1,9,17,16,21,7,7,7,12,9,10,4,0,5,6,5,3,1,0,2,6,4,7,3,0,127,51,76,61,27,34,24,2,49,43,-9,12,8,-1,27,13,-5,5,16,3,22,30,-4,7,18,13,20,10,-2,0,11,4,10,2,0,0,7,9,10,8,-2,0,95,36,59,53,21,32,14,24,-4,19,27,17,-1,7,0,11,16,3,15,17,-4,8,11,14,13,16,9,10,5,-1,2,8,4,4,4,-2,11,8,5,6,1,1,31,5,26,11,-2,13,-13,8,27,-3,-3,11,-9,5,-2,3,0,3,-4,3,29,-6,-3,8,3,3,4,-1,0,2,1,2,-1,-4,-1,1,2,1,5,3,1,1,51,2,49,13,0,13,25,-8,18,1,2,7,5,-11,7,-4,-2,5,20,3,11,5,4,2,6,6,6,-2,-3,0,3,0,0,-2,-1,0,3,6,6,0,-2,0,46,22,24,-9,-9,0,25,-3,18,21,-15,-3,13,3,1,12,-8,-1,12,-6,17,9,-7,-2,-3,0,-8,-1,1,2,-2,0,-6,-1,-1,1,-1,0,-2,0,2,1,95,53,42,18,11,7,8,22,21,41,3,-4,5,10,16,16,3,2,3,12,5,25,0,-6,3,4,-2,8,5,0,3,2,-1,3,4,0,0,2,-1,5,1,0,0,5,-5,1,-3,4,-13,1,12,-6,-7,5,-10,3,9,2,-1,0,-3,-2,3,-8,-6,5,-2,8,-6,2,-5,2,-1,3,-4,0,-3,1,-1,5,-2,2,-2,1,-64,-58,-6,-32,-23,-9,-17,-2,-28,1,-16,3,-17,-2,-20,-7,-11,2,0,0,-8,8,-5,1,-4,-1,-8,-7,-9,-3,-4,-1,-3,-8,-6,-1,0,0,-5,1,-3,-2,48,19,29,-18,-14,-4,15,-4,6,12,11,5,12,-8,-2,11,4,-1,3,4,8,1,7,6,-5,0,-5,-4,-4,0,-5,0,-2,-1,-5,-1,0,0,-3,-3,1,1,20,1,19,-2,-3,1,8,-12,2,26,-6,3,2,-6,2,6,-1,-4,6,-6,0,20,-5,7,5,-3,-1,-1,-2,0,1,-2,-1,0,-1,0,4,-1,0,-1,-1,0,11,19,-8,-13,-6,-7,-27,2,34,-11,6,8,-7,0,24,2,2,-3,-20,2,10,-13,4,11,-4,-2,3,-9,0,0,-1,-1,4,-7,-1,0,-3,-1,-1,-2,1,0,99,71,28,2,12,-10,-4,3,30,27,19,24,11,7,15,19,7,12,-15,-4,15,8,12,12,-4,3,7,0,-3,-2,3,3,5,2,-1,-1,-7,0,2,-2,-2,-1
28,28022,Boadilla del Monte,19300,2592,1286,1306,241,90,151,643,142,1146,480,56,43,330,64,535,266,29,20,313,78,611,214,27,23,47,44,68,61,12,5,20,11,25,24,5,3,27,33,43,37,7,2,2345,1151,1194,28,11,17,538,91,1049,486,101,56,263,34,504,262,49,25,275,57,545,224,52,31,3,3,7,11,4,0,2,1,4,3,1,0,1,2,3,8,3,0,1971,970,1001,-44,-20,-24,472,106,840,370,90,57,227,38,411,205,52,23,245,68,429,165,38,34,-2,-12,-19,-8,-1,-2,-1,-6,-8,-3,-1,-1,-1,-6,-11,-5,0,-1,1296,640,656,100,49,51,282,26,622,269,39,44,138,-6,294,159,28,23,144,32,328,110,11,21,16,19,32,24,6,1,7,7,16,12,5,1,9,12,16,12,1,0,1623,699,924,521,202,319,344,204,577,373,66,37,148,78,248,184,25,7,196,126,329,189,41,30,72,131,181,95,29,12,39,48,69,31,12,3,33,83,112,64,17,9,1912,886,1026,608,246,362,467,148,619,438,122,95,251,41,284,213,38,45,216,107,335,225,84,50,106,131,180,133,30,19,58,38,76,53,8,8,48,93,104,80,22,11,1300,508,792,707,234,473,254,133,455,309,55,89,96,48,169,140,21,31,158,85,286,169,34,58,129,162,216,155,26,8,55,51,65,49,9,1,74,111,151,106,17,7,1399,542,857,766,258,508,227,171,491,317,37,195,105,88,160,154,-4,56,122,83,331,163,41,139,121,190,219,180,37,17,54,72,58,57,9,7,67,118,161,123,28,10,1022,440,582,431,168,263,250,93,265,254,50,126,159,35,84,118,18,40,91,58,181,136,32,86,71,93,129,104,20,6,45,28,43,38,7,3,26,65,86,66,13,3,653,286,367,315,121,194,148,26,202,201,14,83,80,-6,78,105,13,30,68,32,124,96,1,53,74,62,85,68,17,3,35,18,27,26,12,2,39,44,58,42,5,1,1084,521,563,316,113,203,328,61,333,323,5,58,167,21,155,181,-1,15,161,40,178,142,6,43,60,50,79,88,25,11,24,17,20,34,12,6,36,33,59,54,13,5,585,242,343,261,100,161,173,36,214,96,0,94,71,21,85,46,12,18,102,15,129,50,-12,76,72,51,85,24,17,8,33,17,37,0,8,4,39,34,48,24,9,4,413,208,205,83,16,67,150,6,134,116,-15,60,78,14,74,56,-11,12,72,-8,60,60,-4,48,15,18,22,7,10,7,10,1,6,-2,2,0,5,17,16,9,8,7,333,91,242,7,-30,37,92,8,23,118,-39,129,41,8,-14,32,-15,37,51,0,37,86,-24,92,-18,12,0,-10,8,9,-14,-3,-7,-8,-5,5,-4,15,7,-2,13,4,795,415,380,49,43,6,345,2,120,213,-23,118,175,1,65,116,3,41,170,1,55,97,-26,77,23,31,-3,-5,-2,0,9,23,5,-2,3,2,14,8,-8,-3,-5,-2,544,280,264,-341,-201,-140,229,-36,70,194,-100,153,134,-26,7,125,-41,57,95,-10,63,69,-59,96,-43,-13,-103,-115,-64,-6,-22,-12,-57,-69,-38,-4,-21,-1,-46,-46,-26,-2,1495,703,792,173,60,113,542,30,267,509,-3,121,283,15,78,264,12,37,259,15,189,245,-15,84,61,26,54,21,0,3,38,3,10,5,-2,3,23,23,44,16,2,0,1019,470,549,315,120,195,382,14,188,305,-12,116,188,15,80,138,-2,39,194,-1,108,167,-10,77,73,60,84,51,30,8,18,30,32,21,10,2,55,30,52,30,20,6
28,28023,"Boalo, El",2845,368,203,165,99,57,42,54,37,124,71,49,25,31,19,71,41,25,12,23,18,53,30,24,13,22,25,32,13,3,0,13,14,17,7,2,0,9,11,15,6,1,0,311,168,143,121,57,64,33,34,127,78,37,1,16,16,72,40,23,1,17,18,55,38,14,0,24,26,41,24,3,2,10,10,23,11,2,1,14,16,18,13,1,1,470,256,214,138,78,60,71,55,172,91,46,32,29,42,96,54,22,13,42,13,76,37,24,19,25,36,41,25,5,4,13,25,19,15,3,2,12,11,22,10,2,2,384,203,181,161,75,86,48,71,177,78,14,-5,25,42,88,44,9,-5,23,29,89,34,5,0,33,57,43,22,5,1,11,30,18,13,2,1,22,27,25,9,3,0,417,186,231,170,82,88,88,66,187,53,15,8,44,25,84,30,4,2,44,41,103,23,11,6,31,58,41,33,4,4,16,30,21,15,2,0,15,28,20,18,2,4,295,192,103,149,94,55,28,67,137,51,4,3,21,44,77,44,1,1,7,23,60,7,3,2,19,45,48,30,5,1,11,31,30,18,3,0,8,14,18,12,2,1,266,134,132,164,92,72,25,59,121,30,18,6,10,33,57,14,10,5,15,26,64,16,8,1,22,47,67,20,9,-1,13,23,39,11,6,0,9,24,28,9,3,-1,402,221,181,171,94,77,48,60,137,79,45,16,27,28,76,41,32,8,21,32,61,38,13,8,20,58,49,40,1,1,12,32,26,20,2,1,8,26,23,20,-1,0,157,58,99,53,28,25,12,20,62,41,2,19,3,6,33,15,-5,7,9,14,29,26,7,12,8,10,14,17,-1,2,5,9,3,6,1,2,3,1,11,11,-2,0,116,62,54,50,22,28,15,11,52,33,3,1,14,11,28,14,-4,-1,1,0,24,19,7,2,7,11,18,9,4,0,5,5,9,2,1,0,2,6,9,7,3,0,148,64,84,37,6,31,14,25,44,35,18,11,2,11,21,14,14,3,12,14,23,21,4,8,4,17,-2,8,8,2,-3,6,-5,3,4,1,7,11,3,5,4,1,106,65,41,35,17,18,24,13,33,22,13,-10,12,8,18,13,10,-6,12,5,15,9,3,-4,5,11,7,6,6,-1,6,3,7,-1,2,-1,-1,8,0,7,4,0,-19,-25,6,-24,-24,0,-11,-20,2,20,1,-14,-3,-2,-12,3,-4,-5,-8,-18,14,17,5,-9,-4,-2,-11,-8,0,-2,-3,-1,-10,-7,-2,-1,-1,-1,-1,-1,2,-1,-107,-76,-31,-98,-64,-34,-8,-9,-52,-34,4,-7,-4,-9,-39,-22,-2,-1,-4,0,-13,-12,6,-6,-8,0,-42,-37,-5,-6,-8,-3,-23,-24,-5,-1,0,3,-19,-13,0,-5,113,48,65,-70,-46,-24,23,12,31,26,8,10,9,3,13,11,8,3,14,9,18,15,0,7,-8,-3,-14,-33,-11,-2,-6,-2,-8,-20,-9,-2,-2,-1,-6,-13,-2,0,25,5,20,-32,-22,-10,-7,4,12,25,-5,0,-4,4,-4,13,-6,2,-3,0,16,12,1,-2,-7,3,-19,-9,0,-1,-5,2,-15,-4,-1,1,-2,1,-4,-5,1,-2,145,66,79,-13,-9,-4,62,-1,33,30,7,6,31,-6,11,7,10,12,31,5,22,23,-3,-6,12,-6,-3,-13,-4,0,11,-7,-4,-10,1,0,1,1,1,-3,-5,0,25,-1,26,-23,-13,-10,4,-6,21,-6,-1,4,0,-1,1,1,-7,1,4,-5,20,-7,6,3,-5,3,-1,-20,3,-3,-2,4,-3,-11,0,-1,-3,-1,2,-9,3,-2
28,28026,Brunete,4931,400,191,209,127,65,62,53,40,159,61,22,58,23,19,84,40,11,13,30,21,75,21,11,45,26,20,33,43,2,2,12,10,20,21,1,1,14,10,13,22,1,1,688,342,346,225,115,110,115,106,276,109,50,29,66,52,142,50,19,10,49,54,134,59,31,19,38,51,86,42,7,0,20,30,44,19,1,0,18,21,42,23,6,0,574,303,271,252,140,112,71,93,216,77,43,73,53,44,121,46,20,17,18,49,95,31,23,56,31,60,102,49,6,3,21,32,59,24,3,0,10,28,43,25,3,3,412,213,199,225,119,106,40,114,149,77,21,16,21,48,89,43,12,-1,19,66,60,34,9,17,31,74,67,40,9,3,16,36,39,23,4,0,15,38,28,17,5,3,478,221,257,196,99,97,22,65,203,92,25,69,9,32,96,54,14,14,13,33,107,38,11,55,26,51,71,39,10,0,11,31,32,18,7,1,15,20,39,21,3,-1,455,205,250,252,113,139,58,102,181,75,15,18,19,61,75,46,1,2,39,41,106,29,14,16,40,78,70,46,9,7,18,42,31,19,1,2,22,36,39,27,8,5,489,199,290,287,126,161,64,111,182,71,21,34,24,44,80,34,-3,17,40,67,102,37,24,17,58,75,101,36,10,4,27,23,54,12,5,3,31,52,47,24,5,1,189,107,82,263,135,128,10,65,50,18,23,16,-2,33,44,8,13,7,12,32,6,10,10,9,37,79,80,50,18,-1,14,45,45,25,7,-1,23,34,35,25,11,0,109,63,46,112,52,60,6,25,45,17,5,9,11,14,39,-1,-3,5,-5,11,6,18,8,4,22,34,35,10,10,-1,12,16,13,6,5,0,10,18,22,4,5,-1,222,92,130,73,32,41,27,70,69,7,14,24,10,26,22,10,11,8,17,44,47,-3,3,16,16,28,15,14,0,-4,8,9,8,8,1,-2,8,19,7,6,-1,-2,76,32,44,62,27,35,6,38,11,7,-1,12,1,17,8,0,6,-3,5,21,3,7,-7,15,16,23,25,1,-10,6,6,8,13,0,-4,4,10,15,12,1,-6,2,-1,-21,20,18,-5,23,-23,36,-34,9,-15,26,-9,24,-38,2,-7,6,-14,12,4,7,-8,20,-5,38,-2,-12,0,-1,4,15,-10,-11,0,-3,-9,23,8,-1,0,2,-42,-29,-13,-40,-21,-19,-28,3,2,-30,-23,26,-16,3,-2,-10,-17,8,-12,0,4,-20,-6,18,-5,8,-12,-12,-16,-4,-3,3,-6,-9,-7,0,-2,5,-6,-3,-9,-4,99,29,70,8,1,7,-5,8,2,48,12,30,-5,-5,10,10,2,11,0,13,-8,38,10,19,2,8,-5,3,-1,1,0,1,1,1,-1,-1,2,7,-6,2,0,2,248,101,147,78,40,38,47,35,91,11,13,41,18,16,50,5,2,5,29,19,41,6,11,36,16,18,16,21,6,1,9,11,9,9,2,0,7,7,7,12,4,1,50,27,23,-24,-10,-14,-18,20,4,4,-12,44,0,8,5,6,-6,9,-18,12,-1,-2,-6,35,-13,18,-5,-14,-8,-4,-6,7,2,-6,-6,-2,-7,11,-7,-8,-2,-2,71,19,52,38,10,28,0,10,13,0,8,36,-16,4,19,-2,-2,11,16,6,-6,2,10,25,12,13,5,7,-1,2,2,0,6,4,-1,-1,10,13,-1,3,0,3,-46,-66,20,-94,-71,-23,-20,15,-28,-57,-9,55,-5,5,-33,-52,1,20,-15,10,5,-5,-10,35,0,8,-23,-56,-24,-2,1,2,-19,-40,-16,0,-1,6,-4,-16,-8,-2
28,28027,Buitrago del Lozoya,1419,3,-15,18,6,4,2,-8,-1,-4,8,2,7,-11,-7,-1,3,0,1,3,6,-3,5,2,6,0,3,2,1,0,0,0,1,2,1,0,0,0,2,0,0,0,0,103,56,47,130,65,65,23,19,36,18,6,1,12,11,22,8,1,3,11,8,14,10,5,-2,36,27,36,25,6,0,17,15,19,12,2,0,19,12,17,13,4,0,38,22,16,85,40,45,-4,26,10,-8,3,9,2,16,5,-5,0,2,-6,10,5,-3,3,7,21,27,26,8,2,0,10,12,11,5,1,0,11,15,15,3,1,0,73,49,24,83,49,34,16,18,16,13,9,4,4,13,10,13,6,4,12,5,6,0,3,0,16,26,23,15,1,2,9,15,17,7,0,1,7,11,6,8,1,1,87,41,46,74,37,37,11,21,26,19,0,6,5,11,11,11,1,2,6,10,15,8,-1,4,12,28,21,10,1,1,3,16,14,4,0,0,9,12,7,6,1,1,77,33,44,82,46,36,7,21,19,27,5,-1,-6,11,14,12,4,-2,13,10,5,15,1,1,9,26,21,23,2,0,5,13,15,12,2,-1,4,13,6,11,0,1,40,34,6,89,60,29,8,13,7,13,-6,0,6,14,7,6,-3,0,2,-1,0,7,-3,0,14,30,25,16,3,-1,7,19,20,9,3,0,7,11,5,7,0,-1,125,73,52,129,84,45,9,23,19,27,6,41,4,12,22,18,3,14,5,11,-3,9,3,27,19,33,39,26,7,2,9,21,27,19,4,1,10,12,12,7,3,1,11,11,0,41,19,22,4,-2,-3,3,0,8,0,3,2,4,-5,7,4,-5,-5,-1,5,1,13,11,18,2,-2,-2,6,5,9,2,-3,-1,7,6,9,0,1,-1,-5,-4,-1,18,6,12,-16,0,-2,-5,-3,14,-13,-2,-2,-3,-2,14,-3,2,0,-2,-1,0,1,7,8,2,-2,0,0,3,4,0,-3,1,1,4,4,2,1,-1,26,4,22,13,1,12,17,-7,5,-3,3,3,13,-6,-5,-2,-1,-1,4,-1,10,-1,4,4,3,6,2,-1,1,-1,2,1,-1,0,-1,-1,1,5,3,-1,2,0,-71,-46,-25,-57,-46,-11,-2,-11,-44,-15,-5,3,-2,-5,-28,-12,-2,0,0,-6,-16,-3,-3,3,-2,-4,-28,-18,-4,-1,0,-7,-24,-13,-2,0,-2,3,-4,-5,-2,-1,-69,-28,-41,-15,-13,-2,-20,-11,-7,-2,-7,-26,-12,-7,-4,0,-2,-6,-8,-4,-3,-2,-5,-20,2,-5,-4,-5,-4,1,1,-3,-5,-5,-2,1,1,-2,1,0,-2,0,-4,-26,22,-37,-25,-12,-3,-4,-16,-14,-6,41,5,-2,-9,-12,-7,2,-8,-2,-7,-2,1,39,-1,-1,-13,-11,-6,-5,0,0,-9,-9,-5,-2,-1,-1,-4,-2,-1,-3,-69,-34,-35,-43,-27,-16,-9,-17,-22,-19,-16,11,-7,-3,-15,-11,-6,7,-2,-14,-7,-8,-10,4,-5,-6,-12,-11,-7,-2,-4,-4,-7,-8,-2,-2,-1,-2,-5,-3,-5,0,18,-3,21,25,12,13,9,5,10,-24,-3,18,9,0,3,-13,-1,1,0,5,7,-11,-2,17,8,14,12,-9,-1,-1,5,7,7,-5,-1,-1,3,7,5,-4,0,0,-3,-13,10,4,0,4,-14,3,-6,4,-13,24,-8,1,-1,-1,-8,6,-6,2,-5,5,-5,18,-7,6,3,0,-1,3,-1,1,0,-1,0,1,-6,5,3,1,-1,2,26,14,12,25,7,18,17,8,-13,3,-7,18,18,2,-4,4,-9,3,-1,6,-9,-1,2,15,11,17,-3,4,-6,2,4,8,-3,2,-5,1,7,9,0,2,-1,1
28,28028,Bustarviejo,1390,69,37,32,10,4,6,5,7,12,28,10,5,-1,5,9,15,7,1,6,2,3,13,3,4,1,3,2,4,0,0,1,1,1,1,0,0,0,2,1,3,0,0,67,38,29,39,20,19,21,11,13,12,6,3,16,7,6,7,3,0,5,4,7,5,3,3,15,6,9,6,1,1,10,3,3,3,0,1,5,3,6,3,1,0,72,49,23,34,23,11,1,10,43,16,2,-1,2,8,26,13,-1,0,-1,2,17,3,3,-1,4,8,18,3,1,0,3,4,13,3,0,0,1,4,5,0,1,0,68,42,26,32,20,12,13,4,32,10,3,7,13,2,21,5,1,1,0,2,11,5,2,6,11,5,9,5,1,1,8,3,5,3,1,0,3,2,4,2,0,1,115,41,74,37,19,18,24,20,46,16,6,2,4,7,21,4,4,2,20,13,25,12,2,0,11,6,13,3,3,1,5,2,8,1,2,1,6,4,5,2,1,0,74,32,42,25,8,17,13,11,11,32,6,-1,9,5,-1,17,1,1,4,6,12,15,5,-2,3,6,9,5,2,0,0,2,4,2,0,0,3,4,5,3,2,0,49,42,7,25,13,12,4,17,10,6,6,4,5,10,12,5,6,4,-1,7,-2,1,0,0,-5,15,9,0,4,2,-1,6,5,-1,3,1,-4,9,4,1,1,1,61,29,32,32,16,16,7,-1,25,14,10,4,4,-2,9,8,6,3,3,1,16,6,4,1,8,7,11,7,-1,0,5,1,7,3,0,0,3,6,4,4,-1,0,15,4,11,41,20,21,-11,-2,11,6,3,8,-5,-3,6,3,-1,3,-6,1,5,3,4,5,13,5,14,5,2,1,5,2,10,2,0,0,8,3,4,3,2,1,57,33,24,13,9,4,23,2,29,16,-8,-5,15,1,13,8,-1,-2,8,1,16,8,-7,-3,8,5,0,2,-1,-1,5,3,0,1,0,0,3,2,0,1,-1,-1,78,34,44,7,0,7,18,5,27,19,13,-2,6,2,16,10,3,0,12,3,11,9,10,-2,2,1,2,0,2,0,2,0,0,-2,0,0,0,1,2,2,2,0,53,24,29,2,2,0,7,5,16,6,9,5,1,0,8,6,3,3,6,5,8,0,6,2,-1,1,-1,2,0,0,0,0,-1,1,1,0,-1,1,0,1,-1,0,93,41,52,13,4,9,17,3,32,32,5,0,9,3,8,16,3,0,8,0,24,16,2,0,1,2,3,3,3,0,-1,2,1,1,1,0,2,0,2,2,2,0,-18,-6,-12,0,-2,2,-13,-6,3,3,0,-6,-5,-2,4,-1,-1,-2,-8,-4,-1,4,1,-4,-3,2,3,-2,0,0,-1,0,1,-2,0,0,-2,2,2,0,0,0,29,16,13,6,4,2,13,1,9,-5,5,6,11,-2,4,-3,4,3,2,3,5,-2,1,3,4,1,0,0,1,0,4,-1,0,1,0,0,0,2,0,-1,1,0,-53,-32,-21,-55,-29,-26,-17,-7,-3,-23,-1,-1,-10,-3,-8,-11,0,0,-7,-4,5,-12,-1,-1,-5,-6,-14,-18,-8,-4,-2,-3,-7,-11,-4,-2,-3,-3,-7,-7,-4,-2,43,12,31,16,7,9,15,-7,-1,29,0,6,3,-7,-3,17,1,1,12,0,2,12,-1,5,1,3,3,7,0,2,1,1,0,4,0,1,0,2,3,3,0,1,66,34,32,-10,-9,-1,14,10,7,27,6,-3,10,6,4,14,-2,-2,4,4,3,13,8,-1,-1,1,-2,-6,-1,-1,0,0,0,-4,-4,-1,-1,1,-2,-2,3,0
28,28030,"Cabrera, La",1591,101,40,61,25,13,12,26,12,28,9,15,7,12,6,7,5,5,2,14,6,21,4,10,5,3,8,9,4,0,1,1,6,3,3,0,0,2,2,6,1,0,1,77,40,37,44,25,19,4,18,22,17,1,17,4,12,6,10,-1,10,0,6,16,7,2,7,5,16,16,4,2,0,4,8,10,1,1,0,1,8,6,3,1,0,100,66,34,74,46,28,22,11,42,25,-1,-2,12,6,30,17,-1,0,10,5,12,8,0,-2,14,16,29,14,-1,0,8,10,20,7,-1,0,6,6,9,7,0,0,118,73,45,110,61,49,32,8,51,11,12,2,23,5,29,9,3,3,9,3,22,2,9,-1,39,16,36,17,1,1,23,9,18,10,0,1,16,7,18,7,1,0,40,14,26,53,31,22,-3,6,21,7,2,7,-6,5,13,0,0,3,3,1,8,7,2,4,10,10,22,10,0,1,5,7,14,5,0,0,5,3,8,5,0,1,83,61,22,87,50,37,5,17,17,20,21,3,3,8,18,15,12,5,2,9,-1,5,9,-2,19,25,21,12,8,2,9,14,13,8,4,2,10,11,8,4,4,0,58,39,19,89,49,40,17,18,17,9,-5,0,9,10,16,11,-5,-1,8,8,1,-2,0,1,17,27,23,18,2,1,10,12,15,12,0,0,7,15,8,6,2,1,161,93,68,90,54,36,26,42,39,39,8,4,15,28,27,12,5,4,11,14,12,27,3,0,13,33,20,20,4,0,7,23,14,9,1,0,6,10,6,11,3,0,55,46,9,41,29,12,1,20,26,3,-2,5,1,19,14,10,0,2,0,1,12,-7,-2,3,2,21,8,6,3,1,0,16,5,5,2,1,2,5,3,1,1,0,13,-8,21,19,7,12,-7,4,13,2,-9,11,-6,0,1,1,-4,0,-1,4,12,1,-5,11,2,7,9,2,-1,0,0,2,4,1,0,0,2,5,5,1,-1,0,-4,1,-5,23,13,10,1,12,-13,6,-5,-6,4,7,-8,2,-3,-2,-3,5,-5,4,-2,-4,3,11,6,1,1,0,2,5,4,1,0,0,1,6,2,0,1,0,-8,-19,11,2,-2,4,3,-10,-4,-1,6,-1,0,-6,-9,-3,1,0,3,-4,5,2,5,-1,1,1,4,-2,-2,0,0,1,0,-1,-2,0,1,0,4,-1,0,0,-3,-14,11,-66,-47,-19,4,1,-10,-13,-6,17,2,-2,-7,-12,-1,3,2,3,-3,-1,-5,14,-5,1,-28,-20,-12,-2,-2,-1,-19,-16,-7,-2,-3,2,-9,-4,-5,0,4,-9,13,-3,-6,3,1,2,3,-15,6,8,-2,-1,2,-10,4,-2,3,3,1,-5,2,10,5,1,-4,-5,-1,0,2,0,-2,-4,-2,0,3,1,-2,-1,1,0,21,6,15,17,6,11,-3,5,-3,3,3,16,-1,7,-3,0,-1,3,-2,-2,0,3,4,13,6,7,1,3,0,0,4,3,-1,1,-1,0,2,4,2,2,1,0,27,20,7,11,10,1,3,5,20,-8,-2,10,8,4,14,-6,-1,2,-5,1,6,-2,-1,8,2,2,8,-6,5,0,4,3,5,-3,1,0,-2,-1,3,-3,4,0,31,18,13,13,10,3,1,2,15,1,3,9,1,1,3,6,4,3,0,1,12,-5,-1,6,0,2,6,2,1,2,1,1,3,3,1,1,-1,1,3,-1,0,1,79,32,47,29,10,19,17,5,22,10,9,17,6,4,6,5,3,9,11,1,16,5,6,8,5,4,11,6,4,-1,-1,2,4,3,2,0,6,2,7,3,2,-1
28,28031,Cadalso de los Vidrios,2223,53,25,28,22,10,12,15,-1,24,12,5,-3,3,0,11,3,4,3,12,-1,13,9,1,-6,8,3,10,1,0,0,4,2,4,0,0,0,4,1,6,1,0,0,22,8,14,33,16,17,-2,7,16,-1,1,1,1,0,10,-3,-2,2,-3,7,6,2,3,-1,4,9,11,6,1,2,2,4,7,2,0,1,2,5,4,4,1,1,115,73,42,94,62,32,19,35,39,26,2,-8,13,21,25,20,-2,-6,6,14,14,6,4,-2,13,32,31,15,2,0,10,20,23,8,0,0,3,12,8,7,2,0,125,74,51,88,49,39,25,27,29,27,6,6,15,12,21,16,7,1,10,15,8,11,-1,5,19,28,21,17,3,0,10,13,13,10,3,0,9,15,8,7,0,0,122,91,31,58,42,16,15,23,38,15,24,3,18,18,22,16,15,0,-3,5,16,-1,9,3,8,20,14,16,0,0,5,17,8,12,0,0,3,3,6,4,0,0,54,29,25,46,19,27,8,10,13,24,5,-8,2,5,5,15,3,-1,6,5,8,9,2,-7,8,15,18,4,0,0,6,7,6,0,0,0,2,8,12,4,0,0,114,69,45,108,58,50,17,35,26,21,10,4,11,23,21,5,4,4,6,12,5,16,6,0,14,50,19,18,4,1,8,24,15,8,1,1,6,26,4,10,3,0,73,53,20,86,56,30,1,18,28,18,9,-2,0,19,14,13,8,0,1,-1,14,5,1,-2,14,31,25,14,2,0,8,22,17,8,1,0,6,9,8,6,1,0,40,6,34,42,23,19,10,-5,-1,15,4,15,5,-6,-4,4,1,4,5,1,3,11,3,11,9,9,6,13,5,0,5,7,4,5,2,0,4,2,2,8,3,0,37,10,27,24,9,15,13,1,17,1,2,3,4,-1,7,-1,1,2,9,2,10,2,1,1,4,9,6,2,0,3,2,2,3,1,-1,2,2,7,3,1,1,1,-42,-13,-29,18,12,6,-14,-6,-6,-18,5,-5,-10,-1,-6,-5,5,1,-4,-5,0,-13,0,-6,1,6,6,3,0,1,1,2,4,2,2,0,0,4,2,1,-2,1,8,-4,12,9,4,5,-10,12,-5,-6,9,6,-4,3,-8,-2,3,3,-6,9,3,-4,6,3,2,3,3,0,2,-1,2,2,0,0,1,-1,0,1,3,0,1,0,26,14,12,8,2,6,4,10,5,0,4,5,3,2,2,1,3,2,1,8,3,-1,1,3,3,2,2,0,1,-1,1,0,0,0,1,-1,2,2,2,0,0,0,-5,3,-8,1,1,0,2,-7,-11,0,5,8,-3,-2,-1,0,4,5,5,-5,-10,0,1,3,-1,2,-2,1,1,0,-1,1,0,1,0,0,0,1,-2,0,1,0,4,-2,6,8,1,7,-5,-4,-3,1,-4,18,1,-5,1,-5,-2,9,-6,1,-4,6,-2,9,0,2,4,0,1,0,0,0,1,-1,0,0,0,2,3,1,1,0,26,21,5,3,2,1,-3,7,-11,-4,15,24,1,3,-2,2,8,10,-4,4,-9,-6,7,14,1,1,0,-1,2,0,0,1,0,0,1,0,1,0,0,-1,1,0,84,39,45,6,-2,8,6,5,-7,6,11,65,3,0,-1,5,8,25,3,5,-6,1,3,40,1,2,1,3,-2,1,-1,-1,-1,2,-1,0,2,3,2,1,-1,1,-53,-27,-26,-64,-49,-15,7,-3,-28,-28,-11,7,4,-4,-11,-22,-6,11,3,1,-17,-6,-5,-4,-1,5,-16,-41,-12,-1,1,0,-11,-32,-7,0,-2,5,-5,-9,-5,-1
28,28033,Campo Real,2644,100,50,50,46,19,27,5,26,22,31,2,11,1,11,13,17,-1,5,4,15,9,14,3,6,3,12,12,15,4,0,1,4,6,6,2,0,2,8,6,9,2,0,100,61,39,45,22,23,14,19,21,22,10,13,11,6,16,15,6,6,3,13,5,7,4,7,6,12,14,12,1,0,1,4,10,6,1,0,5,8,4,6,0,0,205,104,101,120,57,63,28,37,89,28,13,7,16,15,48,16,5,4,12,22,41,12,8,3,30,29,35,23,3,0,15,11,17,13,1,0,15,18,18,10,2,0,233,114,119,84,42,42,17,48,71,28,26,36,5,19,40,16,13,16,12,29,31,12,13,20,13,38,19,9,4,1,8,17,10,4,2,1,5,21,9,5,2,0,215,103,112,95,39,56,35,43,61,31,15,25,8,23,32,16,7,14,27,20,29,15,8,11,24,23,21,18,5,3,7,14,8,8,0,2,17,9,13,10,5,1,356,177,179,75,35,40,68,68,121,68,18,4,35,27,64,34,8,2,33,41,57,34,10,2,9,37,17,9,3,0,7,19,8,0,1,0,2,18,9,9,2,0,384,219,165,88,47,41,53,92,130,62,24,22,41,49,77,29,13,11,12,43,53,33,11,11,6,35,22,15,6,4,6,16,15,4,3,3,0,19,7,11,3,1,361,202,159,120,68,52,40,69,137,70,23,17,15,36,77,47,17,5,25,33,60,23,6,12,10,48,29,19,12,2,0,29,19,12,7,1,10,19,10,7,5,1,195,85,110,27,9,18,14,27,105,27,5,10,5,1,61,10,3,4,9,26,44,17,2,6,10,4,20,-1,-3,-2,7,-3,11,-2,-2,-1,3,7,9,1,-1,-1,198,114,84,14,9,5,40,17,103,41,-3,4,27,4,57,29,1,-2,13,13,46,12,-4,6,11,4,9,-1,-7,-4,7,1,5,1,-3,-3,4,3,4,-2,-4,-1,149,66,83,12,2,10,24,27,61,12,13,13,13,11,24,7,11,3,11,16,37,5,2,10,-4,7,1,-1,6,2,0,1,-2,-3,4,1,-4,6,3,2,2,1,181,93,88,28,14,14,27,31,50,41,12,9,26,15,22,17,4,-1,1,16,28,24,8,10,9,8,4,2,5,-1,7,3,2,0,1,0,2,5,2,2,4,-1,34,13,21,18,8,10,-15,1,12,16,15,-3,-7,-4,5,15,3,-4,-8,5,7,1,12,1,6,0,12,1,-1,0,4,-1,9,0,-4,0,2,1,3,1,3,0,-2,-11,9,3,-1,4,-15,-8,4,-9,4,28,-12,-6,1,-3,1,10,-3,-2,3,-6,3,18,2,2,-6,4,-1,2,1,1,-6,2,0,1,1,1,0,2,-1,1,80,36,44,9,-2,11,-3,26,61,-23,2,13,0,10,36,-8,-4,3,-3,16,25,-15,6,10,6,4,-2,-2,3,-3,1,2,-6,1,1,-1,5,2,4,-3,2,-2,88,30,58,2,-4,6,6,9,10,12,16,33,0,0,5,0,10,10,6,9,5,12,6,23,-3,2,2,-3,4,-1,-4,-1,1,-2,2,-1,1,3,1,-1,2,0,131,45,86,-16,-15,-1,24,-8,51,9,13,36,6,-7,25,-1,8,14,18,-1,26,10,5,22,0,1,6,-14,-9,-2,1,0,4,-13,-6,-1,-1,1,2,-1,-3,-1,106,46,60,69,32,37,13,19,17,-1,17,38,-5,12,14,-4,11,14,18,7,3,3,6,24,13,13,16,9,10,6,3,9,11,4,2,2,10,4,5,5,8,4
28,28035,Carabaña,1149,32,18,14,14,5,9,-3,1,10,7,6,11,0,3,7,4,3,1,-3,-2,3,3,3,10,5,2,4,2,0,1,1,1,2,1,0,0,4,1,2,1,0,1,31,14,17,16,6,10,5,9,10,6,3,-3,-2,5,5,3,3,-1,7,4,5,3,0,-2,2,4,6,3,0,1,1,2,2,1,0,0,1,2,4,2,0,1,137,80,57,78,36,42,28,28,40,29,9,2,19,12,28,14,4,2,9,16,12,15,5,0,18,21,25,11,3,0,9,8,15,3,1,0,9,13,10,8,2,0,97,52,45,72,35,37,13,30,24,18,13,2,3,20,14,10,5,1,10,10,10,8,8,1,11,26,18,13,4,0,3,14,9,8,1,0,8,12,9,5,3,0,70,30,40,44,25,19,11,21,25,3,8,2,6,7,11,5,2,-1,5,14,14,-2,6,3,3,19,11,6,4,1,3,7,7,5,2,1,0,12,4,1,2,0,66,38,28,30,13,17,2,15,16,23,8,1,0,5,4,20,5,3,2,10,12,3,3,-2,3,9,11,6,0,1,1,2,6,3,0,1,2,7,5,3,0,0,136,59,77,35,15,20,21,28,52,10,15,7,9,15,23,0,8,3,12,13,29,10,7,4,8,14,9,4,0,-1,5,7,4,0,0,-1,3,7,5,4,0,0,134,72,62,44,27,17,31,29,42,25,4,0,17,13,28,14,0,-2,14,16,14,11,4,2,9,17,9,8,1,-1,7,8,9,3,0,0,2,9,0,5,1,-1,65,31,34,3,1,2,-1,21,33,8,-3,6,-4,9,19,5,-2,4,3,12,14,3,-1,2,-2,4,2,-1,0,0,-1,2,0,0,0,0,-1,2,2,-1,0,0,58,15,43,6,-3,9,7,8,22,8,5,9,-4,1,13,4,0,2,11,7,9,4,5,7,-1,3,-1,2,3,1,-2,0,-1,0,1,0,1,3,0,2,2,1,27,15,12,14,8,6,-1,-1,15,6,10,-3,4,0,10,-3,4,-1,-5,-1,5,9,6,-2,2,2,4,5,1,0,1,1,4,2,0,0,1,1,0,3,1,0,13,7,6,11,3,8,6,2,3,7,-2,-5,3,0,-3,6,0,1,3,2,6,1,-2,-6,2,4,4,0,1,0,1,0,2,0,0,0,1,4,2,0,1,0,41,30,11,13,8,5,25,6,8,1,0,0,19,2,3,1,1,2,6,4,5,0,-1,-2,1,2,9,0,1,0,1,1,5,1,0,0,0,1,4,-1,1,0,-36,-18,-18,1,-1,2,-19,-10,5,-4,-2,-3,-11,0,4,-5,0,-5,-8,-10,1,1,-2,2,0,0,2,-1,0,0,0,0,0,-1,0,0,0,0,2,0,0,0,29,12,17,20,11,9,5,6,2,-1,17,2,1,5,-1,-2,11,-1,4,1,3,1,6,3,4,4,3,5,3,1,3,3,1,1,3,0,1,1,2,4,0,1,-52,-28,-24,0,-1,1,-19,3,-10,-19,-6,-2,-11,3,-5,-14,-3,1,-8,0,-5,-5,-3,-3,2,2,-2,-2,1,-2,0,1,-2,-2,1,0,2,1,0,0,0,-2,6,8,-2,19,9,10,-1,5,-13,3,11,-1,1,3,-2,0,5,0,-2,2,-11,3,6,-1,4,3,10,-1,3,0,0,1,6,-1,3,0,4,2,4,0,0,0,-9,-7,-2,20,8,12,-7,2,5,-13,-1,5,-4,-2,8,-7,-3,1,-3,4,-3,-6,2,4,5,5,6,0,3,1,1,2,2,1,1,1,4,3,4,-1,2,0
28,28036,Casarrubuelos,668,80,39,41,3,2,1,17,13,22,21,3,3,10,6,12,8,1,2,7,7,10,13,2,1,0,0,3,0,0,0,0,0,2,0,0,0,0,0,1,0,0,0,206,105,101,13,7,6,46,31,58,49,17,4,21,15,28,29,11,1,25,16,30,20,6,3,5,2,3,2,1,0,3,1,2,0,1,0,2,1,1,2,0,0,345,184,161,2,2,0,76,50,94,86,23,9,40,32,47,44,12,4,36,18,47,42,11,5,1,1,-1,1,0,0,1,1,0,0,0,0,0,0,-1,1,0,0,325,156,169,12,5,7,60,40,128,58,24,5,31,15,61,27,15,2,29,25,67,31,9,3,2,1,3,4,2,0,0,0,2,2,1,0,2,1,1,2,1,0,294,151,143,15,10,5,53,41,141,49,8,1,23,21,71,29,6,0,30,20,70,20,2,1,2,1,9,2,1,0,0,2,6,1,1,0,2,-1,3,1,0,0,392,196,196,11,4,7,83,48,145,73,24,10,39,23,78,34,12,5,44,25,67,39,12,5,3,3,1,2,1,1,1,2,0,1,0,0,2,1,1,1,1,1,286,162,124,30,12,18,59,52,104,42,13,9,35,29,58,23,10,5,24,23,46,19,3,4,5,10,5,6,4,0,1,5,1,3,2,0,4,5,4,3,2,0,105,51,54,19,7,12,18,25,39,13,9,5,7,16,16,10,3,1,11,9,23,3,6,4,6,6,3,6,-2,0,2,3,-1,4,-1,0,4,3,4,2,-1,0,-8,12,-20,2,1,1,-5,-8,7,-3,4,-5,5,0,7,-1,2,-3,-10,-8,0,-2,2,-2,1,-2,1,2,2,-3,0,-2,1,1,1,-1,1,0,0,1,1,-2,31,-12,43,11,1,10,11,6,7,2,6,2,-2,3,-12,-5,7,0,13,3,19,7,-1,2,2,-1,4,3,2,0,0,-2,1,2,0,0,2,1,3,1,2,0,26,20,6,-3,-3,0,2,6,19,-7,3,7,7,-1,14,-4,-1,6,-5,7,5,-3,4,1,-1,-2,1,-2,0,1,-1,-3,2,-2,0,1,0,1,-1,0,0,0,14,-5,19,8,1,7,-5,10,-5,3,8,0,-7,9,-11,-5,5,0,2,1,6,8,3,0,6,0,2,-1,0,0,3,0,0,-3,0,0,3,0,2,2,0,0,36,18,18,6,5,1,1,2,15,5,9,4,-3,0,7,4,7,3,4,2,8,1,2,1,2,0,2,3,-1,1,2,1,2,2,-1,0,0,-1,0,1,0,1,66,36,30,-10,-6,-4,-1,17,34,13,6,-7,3,9,17,3,4,-3,-4,8,17,10,2,-4,-1,2,-4,-2,-1,-4,0,1,-2,-2,-2,-1,-1,1,-2,0,1,-3,64,27,37,19,11,8,17,6,18,18,-3,6,9,3,11,3,-1,2,8,3,7,15,-2,4,6,1,3,4,5,0,3,3,0,2,2,1,3,-2,3,2,3,-1,27,22,5,3,4,-1,4,3,0,10,10,1,2,6,1,6,9,0,2,-3,-1,4,1,1,-3,4,1,1,-1,1,0,3,0,0,0,1,-3,1,1,1,-1,0,36,24,12,6,2,4,7,4,14,-12,18,5,12,3,4,-5,10,1,-5,1,10,-7,8,4,-2,4,4,-4,2,2,-1,2,3,-3,1,0,-1,2,1,-1,1,2,42,6,36,11,2,9,-3,0,21,11,7,10,-13,-3,15,4,2,4,10,3,6,7,5,6,-1,3,1,5,2,0,-1,1,1,0,-1,1,0,2,0,5,3,-1
28,28038,Cercedilla,5488,104,45,59,108,60,48,14,7,33,34,-5,19,0,0,17,21,-1,6,14,7,16,13,-4,13,21,25,38,18,3,2,9,16,22,9,2,1,12,9,16,9,1,1,200,108,92,174,106,68,43,45,79,22,7,5,21,26,52,9,7,-5,22,19,27,13,0,10,47,44,54,21,5,3,26,30,37,10,3,0,21,14,17,11,2,3,193,107,86,125,77,48,22,13,92,18,22,22,4,6,60,17,12,6,18,7,32,1,10,16,22,28,51,20,4,0,10,18,32,16,1,0,12,10,19,4,3,0,140,61,79,2,0,2,8,25,46,25,12,15,-2,14,25,5,10,4,10,11,21,20,2,11,0,1,0,0,1,0,0,1,-1,0,0,0,0,0,1,0,1,0,155,60,95,130,74,56,-14,37,79,31,20,-4,-5,27,23,8,6,-2,-9,10,56,23,14,-2,19,24,44,33,7,2,11,18,18,23,3,0,8,6,26,10,4,2,138,58,80,99,51,48,-14,44,75,5,19,8,-9,13,39,-1,9,4,-5,31,36,6,10,4,9,26,31,24,3,5,4,15,18,11,0,2,5,11,13,13,3,3,59,-3,62,102,42,60,11,22,31,-11,3,7,6,9,0,-6,-6,-4,5,13,31,-5,9,11,16,30,34,14,7,1,7,14,14,5,1,1,9,16,20,9,6,0,165,84,81,101,57,44,-16,33,56,-4,10,87,-8,10,47,-6,7,37,-8,23,9,2,3,50,17,31,34,10,10,-2,7,9,26,7,6,1,10,22,8,3,4,-3,74,21,53,35,9,26,-21,14,-13,2,1,93,-15,2,-6,2,-1,39,-6,12,-7,0,2,54,14,18,6,-6,1,2,5,8,0,-5,0,1,9,10,6,-1,1,1,66,31,35,28,18,10,16,1,-13,7,-11,66,16,4,-7,3,-6,21,0,-3,-6,4,-5,45,14,10,0,0,3,2,9,8,-1,0,2,0,5,2,1,0,1,2,-17,-45,28,-34,-17,-17,-38,2,-33,-36,-16,105,-21,2,-27,-13,-15,27,-17,0,-6,-23,-1,78,-8,3,-15,-6,-7,-3,-3,2,-11,-3,-3,-1,-5,1,-4,-3,-4,-2,-46,-13,-33,8,-2,10,-11,5,-24,-9,-10,3,-4,0,-6,-4,-2,5,-7,5,-18,-5,-8,-2,-1,12,-2,2,0,-3,-1,4,-2,-2,0,-1,0,8,0,4,0,-2,-67,-38,-29,-15,-14,-1,-39,6,-9,-23,1,0,-24,-1,-6,-16,4,5,-15,7,-3,-7,-3,-5,-10,4,-5,-6,1,1,-4,3,-4,-9,-1,1,-6,1,-1,3,2,0,-28,-2,-26,-11,-8,-3,28,-4,-20,-4,-14,-12,15,1,-14,-3,1,-1,13,-5,-6,-1,-15,-11,9,4,-6,-6,-13,2,6,3,-5,-3,-8,0,3,1,-1,-3,-5,2,-39,-21,-18,-31,-22,-9,4,-8,2,-17,-25,8,-1,-11,5,-9,-12,8,5,3,-3,-8,-13,0,-6,3,-7,-12,-8,-1,-8,-4,-5,-2,-3,0,2,7,-2,-10,-5,-1,38,3,35,24,12,12,28,0,1,15,-7,-1,8,-7,-7,12,-4,-2,20,7,8,3,-3,1,12,5,8,-1,1,0,6,2,2,0,2,0,6,3,6,-1,-1,0,139,70,69,21,-1,22,19,23,32,39,5,13,10,17,25,15,-6,7,9,6,7,24,11,6,2,10,10,-1,-1,-1,-2,2,3,-3,-2,0,4,8,7,2,1,-1,102,42,60,69,33,36,18,24,22,15,2,20,3,13,4,12,8,3,15,11,18,3,-6,17,17,17,11,14,6,3,7,9,8,6,2,1,10,8,3,8,4,2
28,28051,Chapinería,1304,79,38,41,10,5,5,15,15,25,7,11,1,7,6,12,4,5,1,8,9,13,3,6,0,0,1,5,2,1,0,0,0,3,1,1,0,0,1,2,1,0,0,77,42,35,37,19,18,33,3,18,21,3,-1,15,8,11,11,1,-3,18,-5,7,10,2,2,13,8,4,8,3,1,8,5,3,2,1,0,5,3,1,6,2,1,115,52,63,29,10,19,26,21,41,16,4,3,12,8,20,7,2,2,14,13,21,9,2,1,9,8,6,3,0,2,4,2,2,1,0,1,5,6,4,2,0,1,120,74,46,18,9,9,26,6,31,28,20,11,22,3,13,17,12,7,4,3,18,11,8,4,3,2,10,1,2,0,2,0,7,0,0,0,1,2,3,1,2,0,41,15,26,25,13,12,-8,13,25,10,7,-5,-6,6,9,8,1,-3,-2,7,16,2,6,-2,1,8,6,9,1,0,0,4,5,5,-1,0,1,4,1,4,2,0,17,17,0,20,12,8,-5,5,15,-5,4,0,-1,7,11,1,0,-2,-4,-2,4,-6,4,2,2,7,4,5,2,0,0,6,3,3,0,0,2,1,1,2,2,0,125,66,59,44,20,24,20,13,49,20,15,6,16,4,29,8,8,1,4,9,20,12,7,5,8,10,14,10,1,0,6,3,8,3,0,0,2,7,6,7,1,0,24,13,11,41,20,21,-1,12,10,0,-7,6,-1,3,7,-1,0,2,0,9,3,1,-7,4,5,20,11,5,0,0,3,6,6,5,0,0,2,14,5,0,0,0,116,60,56,33,19,14,23,10,34,11,15,17,10,9,23,3,8,5,13,1,11,8,7,12,11,9,3,8,2,0,8,6,2,3,0,0,3,3,1,5,2,0,54,5,49,22,6,16,6,7,26,2,0,6,-4,1,7,5,-1,-4,10,6,19,-3,1,10,5,6,7,2,0,1,3,0,3,0,0,0,2,6,4,2,0,1,14,9,5,14,7,7,2,-5,17,-2,-3,2,1,2,8,2,-5,-1,1,-7,9,-4,2,3,1,6,3,2,0,0,1,2,2,1,0,0,0,4,1,1,0,0,-16,-7,-9,7,4,3,-19,-7,-1,-7,7,10,-7,-3,0,-6,1,7,-12,-4,-1,-1,6,3,2,5,-2,2,0,0,0,2,0,2,0,0,2,3,-2,0,0,0,50,23,27,-2,-3,1,11,4,0,17,13,2,9,-2,0,7,7,1,2,6,0,10,6,1,1,3,-2,-3,0,-1,1,0,-3,-1,0,0,0,3,1,-2,0,-1,-80,-35,-45,-58,-31,-27,-32,-6,-17,-23,-7,5,-11,1,-11,-11,-6,3,-21,-7,-6,-12,-1,2,-9,-6,-14,-16,-11,-2,-5,0,-10,-9,-7,0,-4,-6,-4,-7,-4,-2,7,1,6,-14,-11,-3,4,6,-6,3,-8,8,0,6,-5,3,-3,1,4,0,-1,0,-5,7,-8,-1,-3,-1,-1,0,-5,-1,-3,0,-2,0,-3,0,0,-1,1,0,58,24,34,1,-3,4,4,-2,7,25,4,18,-1,1,-3,13,5,9,5,-3,10,12,-1,9,-2,1,1,-2,2,1,-2,1,-1,-2,1,0,0,0,2,0,1,1,24,12,12,2,2,0,5,-6,5,10,-1,9,8,-6,-2,6,3,1,-3,0,7,4,-4,8,0,2,1,0,0,-1,2,0,-1,1,1,-1,-2,2,2,-1,-1,0,25,7,18,2,-1,3,5,-1,2,-3,11,11,-3,3,4,-6,3,4,8,-4,-2,3,8,7,-1,3,0,-4,1,3,0,2,-1,-3,-1,2,-1,1,1,-1,2,1
28,28052,Chinchón,3991,57,33,24,52,29,23,6,-5,38,9,3,6,7,-5,19,4,4,2,-1,0,19,5,-1,4,10,6,31,4,0,1,5,3,18,3,0,0,5,3,13,1,0,1,80,36,44,69,34,35,13,17,21,33,0,-7,1,10,11,15,1,-3,12,7,10,18,-1,-4,6,18,30,12,1,0,1,12,15,4,1,0,5,6,15,8,0,0,238,123,115,163,80,83,37,36,80,44,27,14,14,17,49,20,12,10,23,19,31,24,15,4,31,41,62,24,3,2,16,20,31,11,0,2,15,21,31,13,3,0,161,95,66,89,51,38,31,53,35,24,19,-2,13,28,25,17,13,-2,18,25,10,7,6,0,15,25,27,19,2,1,6,15,15,14,1,0,9,10,12,5,1,1,138,68,70,75,35,40,29,30,41,22,-6,16,15,10,22,8,0,9,14,20,19,14,-6,7,14,28,19,11,0,2,7,13,11,3,0,1,7,15,8,8,0,1,157,90,67,95,47,48,24,22,71,31,14,-7,15,7,39,22,8,-2,9,15,32,9,6,-5,14,29,27,16,4,3,5,12,14,11,2,2,9,17,13,5,2,1,114,69,45,98,56,42,14,22,48,19,16,-6,15,11,23,14,7,-3,-1,11,25,5,9,-3,17,28,29,13,8,2,12,12,17,10,3,2,5,16,12,3,5,0,124,61,63,126,60,66,37,38,20,50,1,-16,14,19,11,20,7,-8,23,19,9,30,-6,-8,25,42,33,22,4,0,14,16,19,10,2,-1,11,26,14,12,2,1,128,76,52,70,35,35,26,8,46,19,18,7,16,8,24,12,9,5,10,0,22,7,9,2,17,13,22,6,10,0,12,4,11,2,5,0,5,9,11,4,5,0,44,16,28,37,21,16,21,11,5,0,6,4,13,0,3,-7,5,3,8,11,2,7,1,1,9,15,13,0,1,-1,9,4,7,0,1,0,0,11,6,0,0,-1,55,26,29,21,7,14,8,9,2,17,4,17,1,10,1,7,6,1,7,-1,1,10,-2,16,-2,5,8,7,2,1,-1,3,3,1,0,1,-1,2,5,6,2,0,-40,-22,-18,-16,-4,-12,-23,5,-8,-7,-2,-5,-5,-8,4,-6,-4,-3,-18,13,-12,-1,2,-2,0,3,-9,-8,-1,-2,3,1,-3,-2,-2,-2,-3,2,-6,-6,1,0,47,41,6,22,8,14,19,-4,7,18,17,-13,10,3,12,15,6,-6,9,-7,-5,3,11,-7,5,2,9,6,0,0,2,1,3,3,-1,0,3,1,6,3,1,0,31,-8,39,1,-6,7,7,-1,19,-20,7,12,3,-6,1,-14,4,1,4,5,18,-6,3,11,-1,1,4,-6,1,1,-1,-2,2,-5,-1,1,0,3,2,-1,2,0,27,12,15,20,8,12,16,-7,11,2,-3,7,10,-5,6,5,-7,2,6,-2,5,-3,4,5,6,5,2,4,1,2,4,2,0,1,0,1,2,3,2,3,1,1,-17,-14,-3,16,4,12,-19,6,16,-22,5,-3,-7,1,4,-9,-2,-3,-12,5,12,-13,7,0,1,5,8,0,1,1,1,2,0,1,-1,1,0,3,8,-1,2,0,45,17,28,10,1,9,14,9,7,7,-7,14,9,7,2,-1,-2,2,5,2,5,8,-5,12,3,5,9,-4,-3,0,1,2,6,-6,-2,0,2,3,3,2,-1,0,21,13,8,-17,-6,-11,8,3,-14,3,0,19,6,3,-13,8,-1,10,2,0,-1,-5,1,9,-3,1,-4,-3,-7,-1,-1,1,-2,0,-2,-2,-2,0,-2,-3,-5,1
28,28040,Ciempozuelos,13231,271,150,121,3,2,1,35,55,82,25,34,31,21,24,52,16,20,10,14,31,30,9,14,21,0,0,1,0,1,1,0,0,1,0,1,0,0,0,0,0,0,1,683,337,346,129,71,58,77,159,241,99,64,40,53,64,122,54,29,14,24,95,119,45,35,26,29,28,39,22,9,2,20,13,24,10,3,1,9,15,15,12,6,1,903,466,437,364,192,172,116,218,351,135,36,43,62,91,201,76,12,20,54,127,150,59,24,23,93,88,107,57,12,4,58,39,59,27,7,2,35,49,48,30,5,2,743,368,375,307,169,138,70,164,345,83,47,18,19,74,196,42,21,7,51,90,149,41,26,11,58,83,99,43,15,5,31,41,62,26,6,1,27,42,37,17,9,4,830,443,387,322,171,151,49,218,378,76,50,40,30,109,208,59,13,15,19,109,170,17,37,25,43,106,109,42,16,3,24,54,66,22,5,0,19,52,43,20,11,3,845,446,399,373,180,193,95,197,313,124,66,28,50,81,189,67,25,15,45,116,124,57,41,13,70,97,99,64,31,10,29,43,53,35,14,4,41,54,46,29,17,6,1352,705,647,489,272,217,198,290,506,176,53,118,119,159,285,74,31,35,79,131,221,102,22,83,101,155,147,54,27,-2,61,86,86,20,15,0,40,69,61,34,12,-2,1154,547,607,549,315,234,101,248,395,127,48,228,49,128,194,69,18,84,52,120,201,58,30,144,95,163,156,97,28,5,57,87,95,53,17,3,38,76,61,44,11,2,829,413,416,232,104,128,78,168,219,92,78,196,52,93,121,47,31,75,26,75,98,45,47,121,66,67,43,31,17,1,31,26,30,11,5,-1,35,41,13,20,12,2,455,219,236,41,-13,54,39,97,136,29,29,115,20,40,72,24,16,47,19,57,64,5,13,68,23,41,-14,-20,1,8,16,12,-19,-20,-5,2,7,29,5,0,6,6,738,317,421,105,40,65,52,126,203,68,66,211,29,52,104,25,30,73,23,74,99,43,36,138,4,49,37,-6,14,7,1,24,18,-9,4,2,3,25,19,3,10,5,404,150,254,67,23,44,-18,43,56,32,46,247,-30,17,9,7,26,122,12,26,47,25,20,125,7,24,15,5,6,6,4,9,-3,4,4,4,3,15,18,1,2,2,222,63,159,-56,-52,-4,-7,34,-11,42,12,160,-5,6,-11,15,10,51,-2,28,0,27,2,109,-16,3,-26,-17,-2,0,-9,-3,-26,-16,0,1,-7,6,0,-1,-2,-1,-62,-45,-17,-162,-87,-75,-62,14,-36,-92,13,100,-30,-7,-11,-37,6,34,-32,21,-25,-55,7,66,-22,-7,-54,-61,-16,-5,-12,-9,-19,-38,-10,0,-10,2,-35,-23,-6,-5,-15,69,-84,-36,-32,-4,-23,13,-11,-46,17,35,7,10,-6,4,36,20,-30,3,-5,-50,-19,15,-11,18,-17,-27,2,-3,-2,7,-13,-15,-6,-4,-9,11,-4,-12,8,1,125,113,12,-168,-87,-81,31,69,0,-54,28,62,37,47,14,-36,17,42,-6,22,-14,-18,11,20,-12,14,-51,-76,-35,-9,0,12,-34,-51,-13,-1,-12,2,-17,-25,-22,-8,19,-42,61,-206,-127,-79,-29,46,-23,-46,22,61,-21,6,-3,-28,-8,22,-8,40,-20,-18,30,39,-19,4,-66,-95,-25,-6,-6,-5,-30,-58,-27,-1,-13,9,-36,-37,2,-5,285,139,146,67,16,51,7,84,46,-3,58,103,2,34,57,-17,18,48,5,50,-11,14,40,55,25,43,-1,-4,-6,8,6,23,10,-10,-14,0,19,20,-11,6,8,8
28,28041,Cobeña,2624,220,99,121,72,23,49,35,33,101,27,12,7,17,12,45,14,6,4,18,21,56,13,6,3,8,23,26,12,1,0,4,6,9,4,0,0,4,17,17,8,1,0,116,62,54,56,18,38,27,16,55,0,11,5,15,8,33,-3,6,2,12,8,22,3,5,3,11,15,13,7,9,1,4,3,6,1,4,0,7,12,7,6,5,1,105,55,50,56,23,33,10,-2,65,26,10,2,8,4,29,14,3,0,2,-6,36,12,7,2,5,8,27,12,4,0,3,5,9,5,1,0,2,3,18,7,3,0,154,72,82,102,45,57,21,19,67,30,2,13,25,8,19,18,0,4,-4,11,48,12,2,9,19,24,35,21,3,0,13,7,15,8,2,0,6,17,20,13,1,0,166,85,81,127,63,64,32,26,89,23,-1,0,9,12,49,16,0,0,23,14,40,7,-1,0,16,36,47,26,2,0,7,17,24,14,1,0,9,19,23,12,1,0,248,111,137,114,43,71,55,38,89,56,2,4,23,22,43,18,2,2,32,16,46,38,0,2,21,36,23,26,5,1,6,19,6,6,4,1,15,17,17,20,1,0,507,250,257,209,101,108,74,81,196,107,13,29,33,40,94,64,7,13,41,41,102,43,6,16,37,61,62,39,9,1,14,30,35,18,4,0,23,31,27,21,5,1,529,279,250,200,103,97,65,72,215,97,33,31,44,44,112,52,13,5,21,28,103,45,20,26,9,72,57,38,22,1,5,38,35,16,9,0,4,34,22,22,13,1,371,171,200,93,38,55,76,32,115,100,24,7,34,15,61,35,17,1,42,17,54,65,7,6,16,23,20,27,3,3,8,14,10,4,1,1,8,9,10,23,2,2,288,123,165,76,26,50,43,25,98,71,19,31,17,11,36,33,12,12,26,14,62,38,7,19,10,21,15,20,7,3,4,10,5,4,2,1,6,11,10,16,5,2,329,150,179,46,20,26,53,21,161,55,10,20,24,10,83,17,5,3,29,11,78,38,5,17,4,13,17,10,-1,2,1,7,8,3,-1,1,3,6,9,7,0,1,183,100,83,37,10,27,21,36,74,25,12,17,16,10,57,10,1,7,5,26,17,15,11,10,2,13,12,2,6,1,-1,1,8,0,2,-1,3,12,4,2,4,2,62,35,27,-93,-43,-50,29,-2,36,2,-15,-5,13,-9,15,11,-1,-4,16,7,21,-9,-14,-1,-6,-7,-27,-39,-12,-5,1,-5,-15,-18,-6,-2,-7,-2,-12,-21,-6,-3,-72,-49,-23,-100,-55,-45,-12,-17,4,-45,-31,27,-1,-10,-10,-19,-18,9,-11,-7,14,-26,-13,18,-11,-1,-42,-27,-18,-1,-5,-1,-25,-14,-10,0,-6,0,-17,-13,-8,-1,-39,-15,-24,-61,-25,-36,-3,-7,-13,-29,-13,22,1,-3,-6,-5,-11,4,-4,-4,-7,-24,-2,18,-9,7,-22,-30,-7,0,-2,4,-11,-12,-5,1,-7,3,-11,-18,-2,-1,-78,-49,-29,-122,-72,-50,-20,1,-21,-26,-12,-1,-15,-5,-26,0,4,-8,-5,6,5,-26,-16,7,-22,4,-40,-43,-19,-3,-9,0,-29,-25,-7,-3,-13,4,-11,-18,-12,0,110,55,55,35,6,29,14,-1,20,43,8,22,8,-1,14,23,-2,12,6,0,6,20,10,10,12,2,2,10,-3,11,-1,1,0,4,-3,5,13,1,2,6,0,6,71,27,44,6,9,-3,56,-11,4,9,-8,17,23,-1,7,-9,-5,9,33,-10,-3,18,-3,8,5,7,0,0,-5,-1,7,5,4,-2,-4,-1,-2,2,-4,2,-1,0
28,28046,Collado Mediano,4341,231,137,94,173,103,70,10,44,99,10,11,19,13,22,59,16,1,7,-3,22,40,-6,10,12,33,43,60,26,2,5,16,25,41,19,0,1,17,18,19,7,2,4,247,125,122,203,116,87,37,63,86,27,22,6,11,37,58,10,8,-1,26,26,28,17,14,7,45,57,64,26,7,0,25,29,43,16,2,0,20,28,21,10,5,0,206,119,87,155,84,71,26,21,106,38,-6,18,12,16,63,25,-2,5,14,5,43,13,-4,13,39,27,50,31,4,3,17,15,31,17,2,2,22,12,19,14,2,1,296,150,146,149,79,70,48,15,134,63,14,12,35,8,54,36,4,6,13,7,80,27,10,6,27,29,37,40,13,1,15,18,18,20,6,1,12,11,19,20,7,0,129,45,84,145,64,81,19,16,65,22,1,-1,9,-2,27,3,-1,3,10,18,38,19,2,-4,29,26,56,23,5,5,17,7,29,7,1,2,12,19,27,16,4,3,297,174,123,157,88,69,41,38,117,67,18,5,20,16,78,43,3,7,21,22,39,24,15,-2,33,39,33,30,17,3,19,20,24,15,6,3,14,19,9,15,11,0,151,70,81,156,74,82,18,16,43,61,10,1,1,15,21,32,6,-4,17,1,22,29,4,5,30,34,42,33,14,0,11,17,23,15,7,0,19,17,19,18,7,0,195,108,87,148,77,71,6,49,56,43,9,29,7,32,30,31,8,1,-1,17,26,12,1,28,22,42,40,28,10,4,11,21,22,16,6,1,11,21,18,12,4,3,-5,10,-15,18,10,8,8,-1,3,2,-10,1,14,7,1,-5,-2,-2,-6,-8,2,7,-8,3,13,17,-1,0,-6,-4,8,8,-1,-2,-1,-2,5,9,0,2,-5,-2,-4,-11,7,-38,-26,-12,9,-18,20,-14,-1,4,2,-11,-4,-4,-1,8,7,-7,24,-10,0,-4,-16,-2,-7,-11,-1,-1,-5,-1,-6,-10,-3,-1,-11,-1,-1,-1,2,0,55,13,42,-8,-12,4,35,-13,12,15,-6,8,30,-11,-4,2,-9,2,5,-2,16,13,3,6,0,5,-6,-6,-2,-1,-2,0,-7,-4,1,-1,2,5,1,-2,-3,0,54,17,37,-3,-7,4,28,0,-3,9,8,14,17,-1,-1,-4,3,6,11,1,-2,13,5,8,5,-5,2,-10,2,3,1,-2,2,-8,0,0,4,-3,0,-2,2,3,36,3,33,-9,-13,4,12,-3,24,6,-10,6,10,-5,13,-5,-7,-4,2,2,11,11,-3,10,5,4,-2,-13,-3,-1,1,2,-3,-9,-2,-2,4,2,1,-4,-1,1,16,-1,17,-34,-24,-10,21,0,7,4,-6,-4,10,-1,-2,2,-6,-2,11,1,9,2,0,-2,1,5,-8,-24,-6,-1,1,1,-6,-16,-4,0,0,4,-2,-8,-2,-1,-230,-121,-109,-80,-45,-35,-79,-28,-75,-47,0,4,-38,-21,-48,-13,1,2,-41,-7,-27,-34,-1,2,-10,-12,-24,-22,-8,-4,-4,-9,-15,-12,-3,-2,-6,-3,-9,-10,-5,-2,-30,-14,-16,-25,-12,-13,-9,-15,16,-3,-16,-5,-7,-5,14,-3,-12,-2,-2,-10,2,0,-4,-3,-3,-3,-6,-7,-12,4,-2,0,0,-4,-8,1,-1,-3,-6,-3,-4,3,89,42,47,-53,-33,-20,12,23,14,17,26,-7,-1,10,11,8,17,-6,13,13,3,9,9,-1,-10,-4,-13,-14,-8,-5,-6,-2,-11,-9,-3,-2,-4,-2,-2,-5,-5,-3,97,19,78,31,9,22,8,15,17,4,37,16,-3,12,0,-6,18,3,11,3,17,10,19,13,6,9,16,-7,1,4,2,2,8,-4,-1,2,4,7,8,-3,2,2
28,28047,Collado Villalba,40872,1537,814,723,1479,778,701,101,378,652,195,99,87,59,180,387,87,42,41,42,198,265,108,57,46,233,359,522,282,58,14,126,180,291,144,26,5,107,179,231,138,32,9,2190,1093,1097,1628,831,797,382,474,805,304,120,81,185,237,449,140,38,39,197,237,356,164,82,42,390,349,508,285,70,14,195,176,284,141,25,5,195,173,224,144,45,9,1700,820,880,1541,792,749,298,358,655,170,94,103,160,166,348,69,21,47,138,192,307,101,73,56,428,331,425,255,64,23,233,172,225,123,25,6,195,159,200,132,39,17,456,250,206,1063,557,506,-64,173,216,-3,28,98,-26,102,140,-9,3,28,-38,71,76,6,25,70,235,238,309,186,50,34,131,129,160,101,16,16,104,109,149,85,34,18,446,234,212,1011,524,487,-129,179,288,-4,53,48,-32,89,169,-11,6,3,-97,90,119,7,47,45,146,256,329,196,52,25,91,123,178,103,21,5,55,133,151,93,31,20,453,180,273,796,421,375,10,160,216,-53,51,71,1,81,135,-58,3,24,9,79,81,5,48,47,169,189,231,148,38,13,96,103,125,76,14,5,73,86,106,72,24,8,973,385,588,939,492,447,141,214,392,8,80,115,33,87,209,-6,8,53,108,127,183,14,72,62,242,235,242,135,50,26,109,131,139,79,18,12,133,104,103,56,32,14,1450,692,758,1234,642,592,145,349,562,201,71,90,68,165,306,73,33,28,77,184,256,128,38,62,232,349,348,215,61,18,117,183,184,120,30,3,115,166,164,95,31,15,1067,539,528,919,483,436,54,255,440,142,52,95,15,152,211,95,23,29,39,103,229,47,29,66,178,239,256,165,49,18,93,134,138,85,22,4,85,105,118,80,27,14,927,402,525,500,211,289,89,226,324,140,56,74,77,88,140,47,13,27,12,138,184,93,43,47,130,140,109,85,28,7,68,61,35,36,6,4,62,79,74,49,22,3,354,110,244,110,36,74,-8,101,132,56,-17,91,-16,39,84,1,-12,17,8,62,48,55,-5,74,16,73,28,-14,-4,2,9,24,11,-10,-4,0,7,49,17,-4,0,2,560,124,436,176,31,145,82,125,240,44,33,43,50,39,96,-56,-8,11,32,86,144,100,41,32,23,79,55,5,3,10,10,30,9,-12,-7,0,13,49,46,17,10,10,617,227,390,43,-3,46,39,226,167,86,31,66,21,85,67,46,-21,25,18,141,100,40,52,41,-14,73,-1,4,-18,-12,-1,30,-7,-11,-16,-5,-13,43,6,15,-2,-7,-158,-144,-14,71,3,68,-96,42,-70,-95,-17,77,-77,22,-58,-42,4,8,-19,20,-12,-53,-21,69,15,66,7,-15,-10,6,1,22,3,-15,-6,-2,14,44,4,0,-4,8,-955,-480,-475,-785,-446,-339,-131,-117,-316,-304,-115,15,-79,-66,-123,-179,-41,7,-52,-51,-193,-125,-74,8,-107,-83,-214,-237,-106,-39,-62,-57,-111,-153,-53,-8,-45,-26,-103,-84,-53,-31,340,162,178,305,150,155,130,98,87,-66,7,84,77,42,26,-37,18,32,53,56,61,-29,-11,52,72,66,80,38,21,20,37,26,47,11,11,10,35,40,33,27,10,10,-10,-90,80,-117,-67,-50,3,89,-22,-185,14,79,1,40,-44,-111,-5,35,2,49,22,-74,19,44,6,54,-25,-124,-34,2,6,29,-16,-67,-22,2,0,25,-9,-57,-12,0,1035,501,534,803,377,426,110,225,250,178,90,166,49,114,117,82,30,94,61,111,133,96,60,72,160,174,196,155,73,37,82,91,98,72,17,12,78,83,98,83,56,25
28,28042,Colmenar del Arroyo,862,65,19,46,15,9,6,6,1,7,9,7,35,3,-1,4,4,5,4,3,2,3,5,2,31,6,0,7,1,1,0,5,0,3,0,1,0,1,0,4,1,0,0,72,32,40,20,12,8,4,14,22,7,6,19,2,5,17,5,3,0,2,9,5,2,3,19,0,6,8,6,0,0,0,3,6,3,0,0,0,3,2,3,0,0,104,67,37,35,25,10,17,11,32,18,7,18,14,8,22,14,4,4,3,3,10,4,3,14,4,9,14,9,0,-1,1,6,10,8,0,0,3,3,4,1,0,-1,105,52,53,27,15,12,22,26,22,12,6,15,8,15,11,7,5,4,14,11,11,5,1,11,2,10,10,3,0,2,1,5,7,1,0,1,1,5,3,2,0,1,87,41,46,29,17,12,1,5,28,4,4,45,5,8,15,4,1,8,-4,-3,13,0,3,37,7,10,7,4,0,1,5,6,2,3,0,1,2,4,5,1,0,0,96,38,58,24,13,11,16,6,26,12,5,32,8,-1,12,5,3,11,8,7,14,7,2,21,4,8,8,2,1,1,2,5,5,1,0,0,2,3,3,1,1,1,76,29,47,32,16,16,-4,5,16,22,9,26,-6,1,11,10,5,6,2,4,5,12,4,20,7,10,4,11,0,0,5,5,2,4,0,0,2,5,2,7,0,0,102,47,55,28,17,11,7,10,28,5,15,31,3,1,19,5,9,8,4,9,9,0,6,23,4,6,11,5,2,0,4,3,9,1,0,0,0,3,2,4,2,0,33,7,26,3,2,1,1,-1,0,-9,5,36,-1,-1,6,-2,1,2,2,0,-6,-7,4,34,0,1,4,-2,-1,-1,0,2,2,-1,0,-1,0,-1,2,-1,-1,0,45,32,13,-10,-8,-2,-4,3,7,15,8,13,4,0,6,10,6,6,-8,3,1,5,2,7,0,-1,-5,-4,-1,1,0,0,-5,-2,-1,0,0,-1,0,-2,0,1,72,24,48,-10,-12,2,2,7,6,22,-1,37,-1,-2,2,12,0,12,3,9,4,10,-1,25,-1,-1,-6,1,-1,-2,-1,-3,-5,-1,-1,-1,0,2,-1,2,0,-1,65,24,41,8,3,5,10,10,25,4,6,8,4,7,11,0,2,-1,6,3,14,4,4,9,2,0,3,2,1,-1,0,0,2,1,0,0,2,0,1,1,1,-1,29,19,10,-3,-1,-2,-1,7,5,1,1,11,2,5,1,3,2,4,-3,2,4,-2,-1,7,-2,-1,1,-1,1,-1,0,-1,0,0,0,0,-2,0,1,-1,1,-1,-5,-2,-3,-5,-7,2,-2,-8,-3,-7,-1,14,2,-8,1,-8,-1,8,-4,0,-4,1,0,6,2,0,-1,-6,0,-1,1,-2,-2,-5,0,0,1,2,1,-1,0,-1,38,22,16,-8,-4,-4,13,-2,8,9,10,1,6,-1,3,6,6,3,7,-1,5,3,4,-2,-2,0,-5,-2,0,0,-1,0,-3,-1,0,0,-1,0,-2,-1,0,0,28,7,21,8,-1,9,-5,11,5,3,7,4,-3,6,-2,4,1,0,-2,5,7,-1,6,4,2,3,2,-2,2,1,0,1,0,-2,0,0,2,2,2,0,2,1,11,7,4,7,2,5,-2,12,-6,3,-8,7,1,4,-4,5,-1,0,-3,8,-2,-2,-7,7,5,3,1,-1,-3,1,3,0,-1,0,0,0,2,3,2,-1,-3,1,66,48,18,22,7,15,7,6,11,15,13,12,6,6,4,12,9,11,1,0,7,3,4,1,5,5,6,3,0,2,2,2,1,1,0,0,3,3,5,2,0,2
28,28045,Colmenar Viejo,31445,1566,803,763,998,516,482,260,315,569,278,61,69,134,149,311,134,26,44,126,166,258,144,35,25,138,284,361,169,32,11,72,141,202,83,11,5,66,143,159,86,21,6,1250,650,600,906,489,417,242,288,424,209,55,19,133,163,206,106,27,10,109,125,218,103,28,9,196,249,286,132,31,7,105,140,154,76,11,1,91,109,132,56,20,6,1641,846,795,1092,554,538,358,280,594,246,51,72,173,139,346,125,10,35,185,141,248,121,41,37,259,270,326,172,39,12,123,132,186,87,12,5,136,138,140,85,27,7,1162,587,575,884,439,445,242,237,410,181,2,64,123,114,218,95,-9,29,119,123,192,86,11,35,196,239,233,144,50,19,97,121,116,72,23,9,99,118,117,72,27,10,401,259,142,613,323,290,5,147,156,44,-12,67,10,87,104,20,6,26,-5,60,52,24,-18,41,76,194,199,102,31,6,41,105,110,49,12,3,35,89,89,53,19,3,836,423,413,796,409,387,96,227,308,76,14,103,42,110,183,26,6,42,54,117,125,50,8,61,144,233,249,110,41,12,72,111,151,43,17,10,72,122,98,67,24,2,925,453,472,928,483,445,129,270,291,152,9,73,63,128,177,69,-11,28,66,142,114,83,20,45,146,298,261,164,34,18,76,148,143,92,11,8,70,150,118,72,23,10,800,384,416,738,374,364,167,261,210,107,-2,50,95,132,85,61,-4,16,72,129,125,46,2,34,142,267,195,101,23,4,84,125,112,45,8,-4,58,142,83,56,15,8,716,337,379,616,284,332,145,206,135,109,35,78,80,86,65,46,17,39,65,120,70,63,18,39,118,185,169,115,16,6,49,87,78,55,8,4,69,98,91,60,8,2,834,402,432,143,54,89,178,121,308,159,-5,43,79,62,152,83,-4,18,99,59,156,76,-1,25,19,68,19,19,10,4,17,24,1,3,4,4,2,44,18,16,6,0,783,367,416,20,11,9,111,84,300,123,58,78,53,60,124,67,25,19,58,24,176,56,33,59,-2,46,-28,8,2,-8,0,32,-25,1,3,-1,-2,14,-3,7,-1,-7,589,341,248,-16,-55,39,66,71,272,44,20,82,25,39,161,30,20,43,41,32,111,14,0,39,2,35,-24,-39,-2,5,-14,5,-25,-25,-1,-1,16,30,1,-14,-1,6,773,373,400,82,26,56,91,65,404,78,42,76,40,41,197,50,25,19,51,24,207,28,17,57,-1,39,39,-20,22,5,-3,28,12,-21,9,3,2,11,27,1,13,2,429,273,156,156,69,87,76,49,149,67,-2,80,43,15,141,29,-5,43,33,34,8,38,3,37,24,60,17,22,24,7,5,30,12,11,5,4,19,30,5,11,19,3,354,241,113,142,84,58,48,45,146,16,-21,109,51,25,94,28,-13,48,-3,20,52,-12,-8,61,37,38,30,16,13,7,29,19,23,7,1,5,8,19,7,9,12,2,427,249,178,184,81,103,30,57,125,36,58,110,1,27,89,22,32,68,29,30,36,14,26,42,11,47,57,15,35,17,3,18,34,1,17,6,8,29,23,14,18,11,691,293,398,297,124,173,172,30,151,193,57,88,92,-2,47,87,45,27,80,32,104,106,12,61,64,61,83,45,34,9,39,22,29,14,16,4,25,39,54,31,18,5,949,476,473,511,261,250,196,115,290,195,43,101,86,62,162,108,14,38,110,53,128,87,29,63,102,111,126,96,47,25,62,55,67,44,18,13,40,56,59,52,29,12
28,28049,Coslada,76538,1351,822,529,2278,1307,971,79,420,580,232,-55,71,55,245,349,171,-25,20,24,175,231,61,-30,51,256,604,843,478,64,13,131,336,486,297,39,8,125,268,357,181,25,5,982,593,389,2304,1329,975,83,305,513,102,-43,17,31,185,339,73,-30,-4,52,120,174,29,-13,21,299,580,844,466,96,10,161,326,501,280,54,3,138,254,343,186,42,7,1467,695,772,2590,1345,1245,301,557,401,85,-2,100,143,276,231,27,-21,27,158,281,170,58,19,73,389,786,882,415,86,15,191,382,490,227,46,3,198,404,392,188,40,12,726,298,428,1981,1011,970,116,243,295,39,-24,27,53,118,138,10,-33,-2,63,125,157,29,9,29,308,550,667,317,108,20,165,258,358,168,49,7,143,292,309,149,59,13,423,238,185,2022,1076,946,1,331,174,-20,-94,36,-3,180,102,-4,-50,19,4,151,72,-16,-44,17,261,593,741,329,73,18,131,304,406,190,32,11,130,289,335,139,41,7,312,124,188,2013,1033,980,-48,403,66,-56,-84,24,1,203,27,-44,-61,-5,-49,200,39,-12,-23,29,279,620,658,358,75,11,137,318,357,178,33,4,142,302,301,180,42,7,1155,581,574,2781,1503,1278,117,658,243,204,-98,28,44,329,198,91,-72,-6,73,329,45,113,-26,34,394,849,855,521,135,21,204,437,520,268,63,9,190,412,335,253,72,12,2120,1284,836,3395,1955,1440,257,921,421,458,5,56,146,572,310,255,-5,6,111,349,111,203,10,50,406,1153,1018,629,150,18,190,651,655,369,75,3,216,502,363,260,75,15,-272,-119,-153,878,437,441,71,69,-222,-29,-113,-45,70,31,-114,-26,-69,-10,1,38,-108,-3,-44,-35,171,252,259,153,35,0,100,113,159,53,6,0,71,139,100,100,29,0,-59,-125,66,584,239,345,-6,279,-339,53,-59,5,-15,119,-215,-2,-30,6,9,160,-124,55,-29,-1,72,328,106,70,17,-18,29,146,43,13,3,-3,43,182,63,57,14,-15,222,83,139,875,396,479,118,301,-215,87,-81,-6,86,129,-104,32,-59,-8,32,172,-111,55,-22,2,107,352,216,134,42,9,56,151,112,58,11,2,51,201,104,76,31,7,-234,-204,-30,910,405,505,16,163,-420,-34,36,21,29,64,-239,-42,-14,3,-13,99,-181,8,50,18,120,342,182,167,79,9,67,143,97,62,26,6,53,199,85,105,53,3,-792,-406,-386,120,22,98,-70,-58,-468,-162,-79,45,-41,-25,-217,-91,-59,19,-29,-33,-251,-71,-20,26,7,108,-8,4,2,-1,11,37,-6,-14,-10,-2,-4,71,-2,18,12,1,-1195,-663,-532,-349,-218,-131,-124,-62,-553,-278,-169,-23,-47,-8,-340,-162,-88,-15,-77,-54,-213,-116,-81,-8,-22,60,-108,-158,-77,-51,3,34,-71,-112,-52,-23,-25,26,-37,-46,-25,-28,-277,-203,-74,412,211,201,24,17,-221,-66,-49,16,-17,31,-117,-58,-27,-8,41,-14,-104,-8,-22,24,50,122,97,85,41,3,27,67,55,38,15,0,23,55,42,47,26,3,-2534,-1486,-1048,-1637,-1004,-633,-233,-41,-896,-874,-396,-91,-127,-20,-487,-576,-224,-52,-106,-21,-409,-298,-172,-39,-127,25,-501,-667,-279,-99,-64,6,-292,-444,-167,-49,-63,19,-209,-223,-112,-50,-2641,-1585,-1056,-1951,-1281,-670,-136,7,-973,-973,-468,-102,-61,-6,-568,-621,-270,-61,-75,13,-405,-352,-198,-41,-69,55,-660,-793,-384,-109,-34,12,-435,-542,-232,-53,-35,43,-225,-251,-152,-56,-2331,-1255,-1076,-1794,-998,-796,-214,-48,-798,-829,-371,-74,-113,-21,-413,-472,-189,-51,-101,-27,-385,-357,-182,-23,-145,5,-625,-678,-308,-56,-90,5,-322,-405,-162,-31,-55,0,-303,-273,-146,-25
28,28050,Cubas de la Sagra,1563,104,64,40,28,16,12,23,25,39,15,3,-1,14,15,23,7,3,2,9,10,16,8,0,-3,5,3,9,9,1,0,3,2,3,6,1,0,2,1,6,3,0,0,234,119,115,9,4,5,38,42,81,41,13,16,22,22,41,22,8,3,16,20,40,19,5,13,0,4,5,0,0,0,0,2,2,0,0,0,0,2,3,0,0,0,322,162,160,27,14,13,49,53,131,48,29,11,22,22,71,28,15,2,27,31,60,20,14,9,6,6,5,4,4,1,4,2,4,0,3,0,2,4,1,4,1,1,223,100,123,16,8,8,23,36,96,33,7,27,6,16,51,13,6,7,17,20,45,20,1,20,3,4,3,4,0,2,2,3,0,2,0,1,1,1,3,2,0,1,179,104,75,14,10,4,35,32,57,21,13,18,23,18,34,11,4,12,12,14,23,10,9,6,2,5,3,4,0,0,3,2,2,3,0,0,-1,3,1,1,0,0,274,142,132,11,4,7,44,28,108,43,30,16,21,10,63,25,15,6,23,18,45,18,15,10,0,2,3,4,1,1,0,1,0,3,0,0,0,1,3,1,1,1,477,238,239,30,10,20,81,50,206,69,25,34,41,30,100,36,15,10,40,20,106,33,10,24,1,8,14,3,1,3,-1,2,9,0,0,0,2,6,5,3,1,3,378,172,206,24,0,24,88,30,143,58,24,22,51,12,63,29,12,2,37,18,80,29,12,20,3,5,11,-3,4,2,0,2,2,-5,1,0,3,3,9,2,3,2,339,175,164,29,23,6,78,24,97,74,23,38,42,10,46,44,13,17,36,14,51,30,10,21,1,3,12,6,6,0,1,2,8,6,4,1,0,1,4,0,2,-1,188,89,99,-7,-10,3,39,17,69,37,7,21,18,5,42,18,5,1,21,12,27,19,2,20,8,3,-11,-5,0,-2,4,1,-8,-7,-1,1,4,2,-3,2,1,-3,199,96,103,19,7,12,43,13,60,23,26,32,28,9,31,5,11,13,15,4,29,18,15,19,0,6,9,2,0,2,-1,3,4,0,0,1,1,3,5,2,0,1,272,107,165,6,-1,7,37,39,61,56,18,54,11,20,16,31,6,18,26,19,45,25,12,36,4,7,-5,1,1,-2,3,2,-3,-2,-1,0,1,5,-2,3,2,-2,146,71,75,2,0,2,32,14,43,16,16,20,15,12,16,8,10,9,17,2,27,8,6,11,-3,2,-2,-1,4,2,-2,1,-1,0,1,1,-1,1,-1,-1,3,1,147,61,86,-8,-4,-4,9,11,23,25,9,66,2,6,20,9,4,18,7,5,3,16,5,48,-3,2,-5,-4,-1,3,0,1,0,-5,-1,1,-3,1,-5,1,0,2,140,65,75,12,7,5,20,18,37,5,6,46,10,4,16,9,-2,25,10,14,21,-4,8,21,8,6,-1,0,-3,1,2,3,0,3,-2,1,6,3,-1,-3,-1,0,77,33,44,-14,-12,-2,14,-10,41,2,-9,28,14,-9,17,5,-4,4,0,-1,24,-3,-5,24,-2,-1,-6,-3,0,-2,-2,-3,-5,-2,0,0,0,2,-1,-1,0,-2,149,71,78,12,7,5,39,5,9,36,17,37,15,1,3,24,13,14,24,4,6,12,4,23,1,0,3,4,3,1,-1,2,2,1,3,0,2,-2,1,3,0,1,163,87,76,11,8,3,41,15,27,26,8,46,26,13,11,16,5,15,15,2,16,10,3,31,-6,7,5,1,2,2,-2,5,1,1,2,1,-4,2,4,0,0,1
28,28053,Daganzo de Arriba,3483,216,99,117,35,17,18,33,24,88,46,17,4,10,4,43,26,9,1,23,20,45,20,8,3,7,7,13,5,3,0,4,2,6,4,1,0,3,5,7,1,2,0,397,201,196,41,20,21,47,66,197,49,30,8,30,29,96,31,16,1,17,37,101,18,14,7,8,6,14,8,4,1,4,3,9,2,2,0,4,3,5,6,2,1,466,248,218,77,40,37,72,42,242,64,26,13,48,27,130,32,8,4,24,15,112,32,18,9,19,17,23,13,5,0,10,9,12,8,1,0,9,8,11,5,4,0,880,447,433,83,41,42,135,93,451,120,38,21,66,38,237,69,19,9,69,55,214,51,19,12,9,18,39,9,3,4,7,6,20,5,1,2,2,12,19,4,2,2,450,243,207,70,33,37,54,44,243,65,21,14,34,28,127,37,6,5,20,16,116,28,15,9,20,16,22,11,1,0,10,8,9,5,1,0,10,8,13,6,0,0,390,203,187,65,36,29,97,25,186,54,14,11,55,13,96,31,5,5,42,12,90,23,9,6,11,16,22,10,4,1,9,9,11,6,1,0,2,7,11,4,3,1,401,189,212,103,45,58,74,36,188,78,5,16,26,14,91,50,2,5,48,22,97,28,3,11,22,23,26,23,7,2,8,11,9,15,2,0,14,12,17,8,5,2,415,212,203,119,56,63,81,60,175,54,16,24,45,27,81,31,10,11,36,33,94,23,6,13,23,34,26,20,11,5,13,14,10,9,8,2,10,20,16,11,3,3,172,80,92,45,24,21,48,18,82,34,-7,-5,25,5,47,15,-3,-7,23,13,35,19,-4,2,6,14,17,11,-3,-1,0,4,12,8,0,0,6,10,5,3,-3,-1,37,1,36,45,18,27,-7,-10,57,3,-2,0,-5,-2,24,-3,-7,-2,-2,-8,33,6,5,2,5,7,14,8,5,4,4,2,7,3,0,1,1,5,7,5,5,3,143,40,103,1,-4,5,20,16,113,-7,-4,4,5,1,49,-15,-3,3,15,15,64,8,-1,1,-2,12,7,-7,-5,-4,-3,3,3,-4,-3,0,1,9,4,-3,-2,-4,181,82,99,22,3,19,31,27,57,42,6,11,15,10,26,18,4,6,16,17,31,24,2,5,2,14,4,-3,3,2,-4,6,0,-1,1,1,6,8,4,-2,2,1,115,69,46,15,7,8,18,19,46,21,1,6,17,14,20,15,0,2,1,5,26,6,1,4,-1,7,3,1,3,1,-1,3,1,1,2,1,0,4,2,0,1,0,7,5,2,5,3,2,-7,4,-5,5,0,11,4,1,0,-4,-1,9,-11,3,-5,9,1,2,-6,10,-4,0,4,0,-3,5,1,-2,1,0,-3,5,-5,2,3,0,18,-17,35,-12,-16,4,11,1,11,-10,-2,2,-8,1,8,-14,-9,1,19,0,3,4,7,1,-1,-1,-1,-6,-2,-2,-3,-1,-2,-4,-5,-2,2,0,1,-2,3,0,29,10,19,-33,-19,-14,22,-20,-4,20,-11,13,8,-11,0,17,-11,2,14,-9,-4,3,0,11,-1,-2,-13,-15,-7,5,1,-1,-6,-8,-6,1,-2,-1,-7,-7,-1,4,71,22,49,8,8,0,24,-13,47,-1,-20,21,25,-14,8,-2,-8,8,-1,1,39,1,-12,13,7,5,6,-6,-6,0,7,3,3,-1,-4,0,0,2,3,-5,-2,0,-69,-53,-16,1,-7,8,-14,-19,24,-34,-25,-8,-17,-14,10,-13,-18,-4,3,-5,14,-21,-7,-4,-1,8,-1,-12,7,1,-1,1,0,-10,2,2,0,7,-1,-2,5,-1
28,28054,"Escorial, El",10053,592,325,267,272,140,132,93,61,221,144,46,21,45,50,127,80,15,6,48,11,94,64,31,15,40,50,99,68,13,1,24,29,49,31,5,1,16,21,50,37,8,0,585,311,274,299,162,137,96,107,197,142,39,2,50,52,103,81,19,5,46,55,94,61,20,-3,52,59,87,85,11,4,29,30,43,49,7,3,23,29,44,36,4,1,606,321,285,295,164,131,96,135,177,86,67,34,60,74,89,47,26,15,36,61,88,39,41,19,47,90,80,59,17,2,26,48,49,35,6,0,21,42,31,24,11,2,495,265,230,230,110,120,74,72,142,100,59,44,49,31,75,53,34,24,25,41,67,47,25,20,38,63,78,33,9,8,19,27,43,15,3,3,19,36,35,18,6,5,693,321,372,207,93,114,195,53,183,167,49,27,96,20,82,80,28,10,99,33,101,87,21,17,28,43,73,45,10,5,15,16,38,20,1,2,13,27,35,25,9,3,280,110,170,209,90,119,82,43,89,43,1,13,25,11,26,31,1,8,57,32,63,12,0,5,38,53,45,46,19,5,16,21,18,24,7,1,22,32,27,22,12,4,289,140,149,270,123,147,32,55,79,88,23,3,14,31,40,33,13,4,18,24,39,55,10,-1,44,76,84,48,18,-1,16,34,40,23,10,0,28,42,44,25,8,-1,342,198,144,218,112,106,20,75,121,52,41,30,24,46,75,18,17,9,-4,29,46,34,24,21,39,65,65,31,12,5,24,30,38,13,5,2,15,35,27,18,7,3,112,53,59,172,88,84,4,25,39,-10,24,18,-4,17,19,-3,10,8,8,8,20,-7,14,10,22,47,40,40,22,-2,13,22,26,18,8,-1,9,25,14,22,14,-1,-134,-118,-16,-65,-101,36,-29,-3,-19,-100,0,9,-15,-7,-16,-87,-7,10,-14,4,-3,-13,7,-1,15,19,3,-85,-14,-4,8,7,-10,-89,-18,0,7,12,13,4,4,-4,-138,-53,-85,-13,-7,-6,-46,-23,-45,-31,-13,13,-4,-6,-16,-23,-7,3,-42,-17,-29,-8,-6,10,0,6,-4,-14,1,-6,0,4,-1,-8,-1,-2,0,2,-3,-6,2,-4,-126,-103,-23,-114,-62,-52,-49,-25,-18,-62,-48,66,-13,-22,-20,-45,-24,14,-36,-3,2,-17,-24,52,-6,-7,-16,-41,-31,-14,3,-8,-12,-22,-17,-8,-9,1,-4,-19,-14,-6,-14,5,-19,-50,-34,-16,11,-22,-23,0,-8,29,10,-14,-1,0,-4,18,1,-8,-22,0,-4,11,0,0,-13,-15,-20,-1,-1,-1,-7,-16,-8,0,1,1,-6,1,-12,-1,185,80,105,-5,-7,2,56,13,13,71,-1,24,24,5,3,30,7,8,32,8,10,41,-8,16,7,3,-6,-1,-9,-2,-2,3,-3,-2,-6,1,9,0,-3,1,-3,-3,171,88,83,23,6,17,-2,13,61,60,8,32,4,6,13,40,4,18,-6,7,48,20,4,14,6,4,1,8,0,4,2,-1,0,2,1,2,4,5,1,6,-1,2,144,61,83,32,9,23,35,29,8,-11,48,34,21,15,-1,-7,23,10,14,14,9,-4,25,24,8,20,0,0,2,1,2,10,2,-4,-2,0,6,10,-2,4,4,1,209,108,101,48,21,27,35,8,31,43,33,52,20,-4,19,29,19,20,15,12,12,14,14,32,5,12,18,7,2,2,6,3,4,6,0,1,-1,9,14,1,2,1,320,170,150,87,44,43,41,37,54,68,58,59,27,19,29,45,30,16,14,18,25,23,28,43,16,19,17,18,11,5,10,9,7,8,6,3,6,10,10,10,5,2
28,28055,Estremera,1004,13,5,8,24,15,9,0,6,4,2,1,0,-1,1,1,3,1,0,1,5,3,-1,0,0,1,6,15,2,0,0,1,3,9,2,0,0,0,3,6,0,0,0,24,18,6,28,18,10,-1,5,11,5,6,-2,2,4,4,5,4,-1,-3,1,7,0,2,-1,3,4,17,3,1,0,3,3,9,3,0,0,0,1,8,0,1,0,83,63,20,105,70,35,-5,25,45,22,5,-8,-1,12,34,18,3,-3,-4,13,11,4,2,-5,3,32,51,19,0,0,2,17,36,15,0,0,1,15,15,4,0,0,38,22,16,59,32,27,14,16,-2,4,5,0,9,12,-4,1,4,-1,5,4,2,3,1,1,10,23,17,8,1,0,2,12,11,6,1,0,8,11,6,2,0,0,83,59,24,93,59,34,15,22,28,12,8,-3,12,16,16,10,4,0,3,6,12,2,4,-3,11,27,41,12,1,1,6,16,26,11,0,0,5,11,15,1,1,1,80,45,35,88,52,36,17,24,11,15,8,5,11,13,8,9,4,2,6,11,3,6,4,3,11,29,24,19,3,1,7,17,13,13,2,0,4,12,11,6,1,1,154,73,81,40,23,17,12,20,39,13,43,23,1,10,21,7,19,14,11,10,18,6,24,9,4,14,16,4,1,1,0,8,12,2,0,1,4,6,4,2,1,0,40,-11,51,59,38,21,-9,-1,-13,-6,-10,80,-5,-3,-8,0,-4,10,-4,2,-5,-6,-6,70,6,18,23,7,2,1,3,9,18,5,2,0,3,9,5,2,0,1,16,-9,25,12,4,8,12,-3,0,-5,-10,20,2,0,-3,-8,-5,4,10,-3,3,3,-5,16,2,4,3,3,0,0,0,3,0,1,0,0,2,1,3,2,0,0,12,8,4,16,6,10,-1,4,-3,6,1,5,1,0,3,4,-2,2,-2,4,-6,2,3,3,3,3,1,3,6,0,1,1,1,2,1,0,2,2,0,1,5,0,-14,-14,0,0,-4,4,-3,-2,-5,-4,-2,1,-3,-2,-1,-4,-2,-3,0,0,-4,0,0,4,1,3,-2,-1,0,-1,1,1,-2,-2,-1,-1,0,2,0,1,1,0,17,8,9,-3,-3,0,4,1,-7,3,0,16,5,-1,-4,1,0,7,-1,2,-3,2,0,9,2,0,-2,0,-2,-1,1,-1,-2,0,-1,0,1,1,0,0,-1,-1,-25,-6,-19,-20,-16,-4,1,-6,-19,-3,-9,12,5,1,-13,0,-2,3,-4,-7,-6,-3,-7,9,-1,-1,-12,-3,-3,0,0,0,-10,-4,-2,0,-1,-1,-2,1,-1,0,33,20,13,4,3,1,7,1,5,9,-7,19,7,2,5,3,-3,7,0,-1,0,6,-4,12,2,1,-1,1,0,1,2,1,0,0,0,0,0,0,-1,1,0,1,-20,0,-20,2,1,1,-13,-6,-4,-8,7,4,-6,1,-4,4,2,3,-7,-7,0,-12,5,1,-1,0,0,1,1,1,0,0,-1,1,1,0,-1,0,1,0,0,1,13,1,12,-5,-4,-1,6,4,4,-11,-2,11,4,-2,-2,-8,0,8,2,6,6,-3,-2,3,-1,2,-5,-2,0,0,1,1,-5,-2,0,0,-2,1,0,0,0,0,-18,-5,-13,1,3,-2,-11,-4,-7,-5,-8,17,-2,-3,1,-5,-4,9,-9,-1,-8,0,-4,8,1,3,1,2,-4,-2,3,3,0,0,-2,-1,-2,0,1,2,-2,-1,6,11,-5,-9,-5,-4,-5,-2,-6,-4,1,22,-3,0,-3,3,1,13,-2,-2,-3,-7,0,9,-3,1,-4,-2,-1,0,-2,1,-2,-1,-1,0,-1,0,-2,-1,0,0
28,28056,Fresnedillas de la Oliva,697,86,61,25,48,27,21,15,13,27,27,6,-2,10,7,21,18,4,1,5,6,6,9,2,-3,12,6,23,6,1,0,7,2,16,2,0,0,5,4,7,4,1,0,63,35,28,45,24,21,17,8,10,20,1,6,9,4,5,12,1,3,8,4,5,8,0,3,15,8,12,8,0,1,7,5,6,5,0,0,8,3,6,3,0,1,138,77,61,49,21,28,45,26,28,26,4,4,25,12,14,16,4,2,20,14,14,10,0,2,12,14,12,9,1,0,4,5,6,5,1,0,8,9,6,4,0,0,12,-1,13,46,24,22,2,15,3,-9,3,-2,-2,7,3,-8,1,-1,4,8,0,-1,2,-1,20,14,5,7,0,0,13,6,2,3,0,0,7,8,3,4,0,0,26,3,23,46,19,27,5,-1,10,4,4,0,-3,0,1,4,1,0,8,-1,9,0,3,0,18,8,11,5,3,0,9,3,5,2,0,0,9,5,6,3,3,0,59,22,37,31,16,15,12,12,15,7,10,2,2,7,8,0,3,1,10,5,7,7,7,1,7,11,5,4,3,0,4,7,1,2,1,0,3,4,4,2,2,0,99,50,49,56,30,26,19,27,40,12,2,-2,6,14,23,7,1,0,13,13,17,5,1,-2,6,22,20,6,2,0,2,12,12,2,1,1,4,10,8,4,1,-1,86,49,37,80,48,32,21,11,29,18,4,3,18,7,12,7,4,1,3,4,17,11,0,2,22,18,28,12,1,-1,15,11,14,7,1,0,7,7,14,5,0,-1,38,21,17,47,20,27,10,-2,16,8,6,0,5,-4,15,3,2,0,5,2,1,5,4,0,19,9,7,12,0,0,10,5,4,2,-1,0,9,4,3,10,1,0,95,49,46,44,16,28,19,13,20,20,17,4,11,8,8,10,8,2,8,5,12,10,9,2,15,9,11,5,3,0,9,2,6,-1,0,0,6,7,5,6,3,0,51,25,26,11,5,6,6,5,14,16,5,3,1,4,7,8,1,2,5,1,7,8,4,1,0,5,1,4,1,0,-1,5,-1,1,1,0,1,0,2,3,0,0,7,3,4,7,3,4,4,5,1,-6,0,2,6,2,3,-7,-1,0,-2,3,-2,1,1,2,3,4,-3,1,4,-2,2,3,-2,0,1,-1,1,1,-1,1,3,-1,-17,-8,-9,-1,2,-3,-5,-4,0,-4,2,-6,-4,-2,1,-1,1,-3,-1,-2,-1,-3,1,-3,0,-2,3,-2,0,0,1,-1,2,1,0,-1,-1,-1,1,-3,0,1,-24,-14,-10,-11,-6,-5,3,-14,-14,5,-2,-3,0,-7,-9,7,-1,-3,3,-7,-5,-2,-1,0,-1,-4,-2,-4,-1,1,0,-2,0,-2,-2,0,-1,-2,-2,-2,1,1,23,9,14,11,4,7,9,-1,11,-2,5,0,6,0,7,-2,2,-4,3,-1,4,0,3,4,1,4,5,0,1,0,2,1,2,-2,1,0,-1,3,3,2,0,0,-19,-11,-8,-24,-8,-16,-1,-6,-7,-4,0,-5,3,-8,-3,-1,-3,0,-4,2,-4,-3,3,-5,-11,-2,-4,-7,-2,2,-1,0,-4,-3,-2,2,-10,-2,0,-4,0,0,9,6,3,9,0,9,-15,-1,14,8,1,2,-10,1,8,4,0,2,-5,-2,6,4,1,0,2,0,3,0,4,0,1,-1,1,-3,2,0,1,1,2,3,2,0,-33,-20,-13,-18,-9,-9,-4,2,-8,-15,-5,-1,-3,6,-8,-13,-2,1,-1,-4,0,-2,-3,-2,5,1,-1,-14,-10,1,3,3,-2,-10,-4,1,2,-2,1,-4,-6,0
28,28058,Fuenlabrada,171173,2545,1308,1237,1276,693,583,19,807,1422,-96,176,217,-17,370,877,-55,57,77,36,437,545,-41,119,140,229,343,432,196,45,22,120,175,260,110,18,6,109,168,172,86,27,16,-674,-352,-322,1186,661,525,-298,211,85,-608,-121,46,-183,124,123,-348,-89,16,-115,87,-38,-260,-32,30,247,328,381,173,36,16,121,169,243,104,14,7,126,159,138,69,22,9,1151,701,450,2289,1206,1083,-291,747,937,-382,-39,169,-122,347,654,-188,-64,61,-169,400,283,-194,25,108,455,604,747,340,95,33,231,303,423,188,42,11,224,301,324,152,53,22,195,223,-28,2324,1215,1109,-457,504,560,-393,-125,107,-198,242,412,-195,-104,56,-259,262,148,-198,-21,51,381,699,726,360,119,28,190,357,405,202,43,13,191,342,321,158,76,15,-553,-212,-341,2276,1269,1007,-539,338,122,-417,-147,98,-275,202,167,-239,-102,33,-264,136,-45,-178,-45,65,292,721,750,366,105,28,145,383,463,206,48,15,147,338,287,160,57,13,148,188,-40,2541,1381,1160,-355,497,381,-231,-163,51,-195,287,362,-127,-133,6,-160,210,19,-104,-30,45,409,743,775,439,127,31,228,404,445,239,43,10,181,339,330,200,84,21,-55,-11,-44,3123,1660,1463,-437,665,175,-353,-217,149,-263,377,190,-164,-177,48,-174,288,-15,-189,-40,101,473,920,983,544,134,51,235,463,579,302,54,15,238,457,404,242,80,36,1005,555,450,3709,2016,1693,-56,812,330,-140,-100,181,-26,434,279,-53,-121,67,-30,378,51,-87,21,114,609,1084,1174,612,171,39,319,569,700,336,71,15,290,515,474,276,100,24,705,374,331,2849,1548,1301,31,552,188,37,-209,99,15,312,154,-9,-133,16,16,240,34,46,-76,83,468,820,963,460,95,14,257,418,560,252,38,6,211,402,403,208,57,8,-675,-503,-172,1267,590,677,-99,213,-438,-292,-198,118,-71,95,-219,-214,-122,13,-28,118,-219,-78,-76,105,201,396,401,128,72,33,105,168,232,32,22,10,96,228,169,96,50,23,-1812,-1146,-666,639,250,389,-188,-114,-864,-531,-234,84,-80,-125,-512,-337,-154,42,-108,11,-352,-194,-80,42,89,279,174,18,41,11,52,106,78,-20,11,8,37,173,96,38,30,3,-1535,-1053,-482,261,61,200,-148,-53,-888,-372,-185,75,-92,-91,-540,-227,-114,-3,-56,38,-348,-145,-71,78,39,230,18,-40,-22,7,23,99,-14,-41,-19,0,16,131,32,1,-3,7,-1774,-1109,-665,-61,-99,38,-236,-41,-901,-578,-192,134,-98,-50,-474,-439,-88,20,-138,9,-427,-139,-104,114,-38,148,-35,-129,-20,-4,-21,67,-33,-106,-8,-4,-17,81,-2,-23,-12,0,-2110,-1257,-853,-545,-346,-199,-254,-225,-922,-552,-256,76,-70,-140,-546,-321,-180,0,-184,-85,-376,-231,-76,76,-92,40,-207,-218,-60,-26,-33,-5,-127,-138,-39,-11,-59,45,-80,-80,-21,-15,-1561,-940,-621,-41,-55,14,-203,-20,-636,-473,-264,46,-118,-10,-361,-302,-145,4,-85,-10,-275,-171,-119,42,5,120,-49,-97,-23,-14,10,51,-26,-73,-17,-10,-5,69,-23,-24,-6,-4,-2048,-1274,-774,-951,-624,-327,-67,-10,-784,-835,-350,-23,17,-53,-462,-560,-227,1,-84,43,-322,-275,-123,-24,-31,84,-205,-557,-159,-97,0,16,-110,-384,-116,-34,-31,68,-95,-173,-43,-63,-347,-385,38,553,239,314,-5,157,-200,-267,-113,92,-13,37,-120,-211,-103,32,8,120,-80,-56,-10,60,104,216,106,19,60,29,43,105,75,-20,11,12,61,111,31,39,49,17,118,-82,200,995,441,554,134,59,-11,-121,-74,120,51,35,-64,-60,-82,23,83,24,53,-61,8,97,149,272,305,146,74,27,63,126,140,72,18,9,86,146,165,74,56,18
28,28059,Fuente el Saz de Jarama,3720,174,88,86,12,7,5,48,7,66,24,15,10,22,13,23,16,5,7,26,-6,43,8,10,3,2,6,3,1,0,0,1,5,1,0,0,0,1,1,2,1,0,0,382,191,191,149,80,69,60,66,143,73,24,11,28,33,69,44,12,4,32,33,74,29,12,7,30,35,51,25,6,0,16,23,22,16,3,0,14,12,29,9,3,0,240,132,108,139,71,68,47,54,72,28,18,15,26,31,48,13,6,4,21,23,24,15,12,11,42,32,34,23,6,2,22,15,20,11,3,0,20,17,14,12,3,2,123,70,53,76,35,41,19,28,21,34,11,3,7,20,12,23,4,1,12,8,9,11,7,2,14,23,19,15,4,1,7,11,11,6,0,0,7,12,8,9,4,1,185,99,86,93,49,44,-14,60,65,30,24,18,-9,30,39,11,15,11,-5,30,26,19,9,7,8,36,24,19,6,0,5,19,11,11,3,0,3,17,13,8,3,0,135,69,66,92,44,48,10,64,43,8,9,0,12,29,16,7,9,-2,-2,35,27,1,0,2,21,31,25,8,6,1,9,14,13,4,4,0,12,17,12,4,2,1,166,80,86,171,98,73,43,59,55,20,-10,-8,27,32,21,14,-9,-7,16,27,34,6,-1,-1,38,46,54,30,3,-1,21,23,34,22,-1,-1,17,23,20,8,4,0,162,77,85,179,91,88,12,32,54,39,23,7,6,10,33,14,14,3,6,22,21,25,9,4,30,44,52,38,13,1,11,22,32,20,5,0,19,22,20,18,8,1,163,82,81,112,53,59,20,16,69,22,17,16,12,5,51,1,5,8,8,11,18,21,12,8,24,26,24,28,7,3,16,10,13,9,3,2,8,16,11,19,4,1,-14,-19,5,8,-10,18,-11,2,-2,-21,2,12,-5,-5,-6,-4,-6,4,-6,7,4,-17,8,8,5,4,-3,-2,3,0,1,-4,-4,-3,0,-1,4,8,1,1,3,1,42,4,38,-31,-33,2,14,2,33,-24,-6,14,15,-11,2,-11,-1,3,-1,13,31,-13,-5,11,9,-9,-7,-8,-15,-1,7,-9,-10,-10,-10,-1,2,0,3,2,-5,0,-46,-28,-18,17,0,17,-15,1,-22,-19,0,13,-12,3,-2,-19,-3,7,-3,-2,-20,0,3,6,8,2,-1,8,-3,2,4,-4,-1,3,-2,0,4,6,0,5,-1,2,-65,-35,-30,-70,-37,-33,-11,-17,-1,-28,-10,2,-7,0,-6,-18,1,-3,-4,-17,5,-10,-11,5,-21,0,-16,-20,-8,-5,-11,1,-8,-15,-2,-2,-10,-1,-8,-5,-6,-3,62,27,35,-13,-8,-5,21,17,-8,15,-4,19,16,10,-3,6,-5,3,5,7,-5,9,1,16,7,13,-11,-7,-12,-3,3,10,-6,-5,-10,0,4,3,-5,-2,-2,-3,-9,-4,-5,3,5,-2,-3,-5,3,-14,0,13,3,-4,2,-5,3,-1,-6,-1,1,-9,-3,14,8,3,-5,-2,-1,0,5,3,-3,-3,4,-1,3,0,-2,1,-5,1,-11,-11,0,-38,-22,-16,-19,1,-5,-8,-1,17,-14,1,-2,-4,-1,9,-5,0,-3,-4,0,8,-19,-2,-4,-3,-9,0,-9,-2,-6,1,-3,-2,-10,0,2,-4,-6,2,23,-5,28,17,-5,22,5,-2,10,0,-3,12,-7,-3,3,0,-3,5,12,1,7,0,0,7,14,9,2,-5,-1,-1,6,1,-4,-3,-4,-1,8,8,6,-2,3,0,148,70,78,63,27,36,25,6,-1,63,16,32,16,3,0,36,4,7,9,3,-1,27,12,25,13,16,8,26,0,1,9,7,0,10,0,2,4,9,8,16,0,-1
28,28060,Fuentidueña de Tajo,1447,28,14,14,17,6,11,5,6,0,10,0,9,3,2,-4,6,1,6,2,4,4,4,-1,3,2,6,3,6,0,0,2,2,0,2,0,0,0,4,3,4,0,0,8,9,-1,14,7,7,-6,1,8,-2,7,0,-1,2,6,-1,3,0,-5,-1,2,-1,4,0,0,2,9,2,1,0,0,2,2,2,1,0,0,0,7,0,0,0,25,10,15,14,7,7,8,1,9,6,2,-1,2,-1,8,1,4,-4,6,2,1,5,-2,3,2,3,5,3,1,0,1,2,2,1,1,0,1,1,3,2,0,0,101,67,34,59,35,24,2,31,28,23,13,3,4,24,18,11,7,2,-2,7,10,12,6,1,5,20,17,17,0,0,2,12,12,10,-1,0,3,8,5,7,1,0,147,79,68,66,39,27,29,34,44,26,3,8,11,23,21,18,0,2,18,11,23,8,3,6,5,27,22,11,1,0,2,18,11,8,0,0,3,9,11,3,1,0,62,39,23,43,27,16,12,16,9,16,4,3,6,7,12,9,4,0,6,9,-3,7,0,3,8,11,7,11,2,4,5,7,5,5,2,3,3,4,2,6,0,1,110,65,45,48,27,21,18,17,33,16,12,12,10,7,20,12,5,10,8,10,13,4,7,2,7,15,11,11,0,4,1,7,9,7,0,3,6,8,2,4,0,1,75,50,25,59,35,24,6,11,33,15,6,-1,1,6,21,14,4,1,5,5,12,1,2,-2,9,19,19,11,1,0,3,8,17,8,1,-2,6,11,2,3,0,2,48,23,25,48,27,21,7,6,2,15,16,-1,0,2,5,4,10,2,7,4,-3,11,6,-3,9,12,17,6,2,0,6,7,10,3,1,0,3,5,7,3,1,0,27,13,14,10,6,4,-4,14,9,4,6,-2,-2,8,4,1,5,-3,-2,6,5,3,1,1,0,8,1,0,1,0,0,5,0,0,1,0,0,3,1,0,0,0,-41,-30,-11,-13,-11,-2,-17,6,-24,-8,1,2,-7,3,-15,-11,0,1,-10,3,-9,3,1,1,-2,6,-6,-9,-2,0,0,3,-5,-8,-1,0,-2,3,-1,-1,-1,0,38,27,11,3,3,0,6,13,0,4,11,1,-1,7,4,7,7,2,7,6,-4,-3,4,-1,0,2,-1,0,2,0,1,3,0,-1,0,0,-1,-1,-1,1,2,0,26,5,21,-7,-9,2,24,-7,4,5,-5,3,18,-7,-3,-2,-4,1,6,0,7,7,-1,2,1,0,-1,-2,-4,-1,1,-1,-2,-4,-3,0,0,1,1,2,-1,-1,-24,-9,-15,-6,-6,0,-15,7,-4,-1,-6,-5,-10,5,-4,3,-3,0,-5,2,0,-4,-3,-5,-1,5,-5,-1,-3,-1,-1,0,-2,-1,-1,-1,0,5,-3,0,-2,0,-54,-33,-21,-36,-22,-14,-10,-12,-20,-14,0,1,-9,-11,-8,-10,4,0,-1,-1,-12,-4,-4,1,-8,-1,-13,-7,-6,-1,-5,0,-8,-4,-4,-1,-3,-1,-5,-3,-2,0,-7,-7,0,-20,-14,-6,-1,3,-4,-16,8,3,0,1,1,-12,3,1,-1,2,-5,-4,5,2,1,-2,-7,-12,1,-1,1,-1,-6,-8,0,0,0,-1,-1,-4,1,-1,44,37,7,-2,-3,1,16,3,4,9,10,0,13,5,4,3,8,2,3,-2,0,6,2,-2,2,1,-6,-2,2,0,1,1,-5,-2,1,0,1,0,-1,0,1,0,10,-4,14,8,0,8,1,-5,-5,10,6,6,-1,-6,-2,1,5,1,2,1,-3,9,1,5,4,1,1,1,-2,3,1,0,1,-2,-1,1,3,1,0,3,-1,2
28,28061,Galapagar,20534,-29,-2,-27,10,4,6,-99,-6,46,-4,0,31,-47,1,40,-1,-3,8,-52,-7,6,-3,3,23,4,0,4,2,0,0,2,0,0,2,0,0,2,0,4,0,0,0,-66,-50,-16,18,9,9,-103,18,31,-52,14,19,-57,2,42,-48,5,1,-46,16,-11,-4,9,18,3,1,3,6,3,1,3,0,1,3,1,0,0,1,2,3,2,1,48,63,-15,-16,-12,-4,-106,8,140,-4,9,25,-42,7,86,5,8,8,-64,1,54,-9,1,17,10,-3,-7,-14,-3,0,7,-2,-5,-10,-2,0,3,-1,-2,-4,-1,0,-78,-57,-21,207,103,104,-111,8,14,-42,4,51,-68,8,14,-27,5,14,-43,0,0,-15,-1,37,53,43,44,39,19,9,27,21,23,21,8,3,26,22,21,18,11,6,477,225,252,575,276,299,12,132,238,29,41,51,-15,74,135,4,14,22,27,58,103,25,27,29,98,128,186,118,33,12,47,64,93,54,14,4,51,64,93,64,19,8,556,237,319,703,348,355,29,166,261,65,12,29,23,89,108,21,2,-5,6,77,153,44,10,34,148,165,227,119,30,9,83,92,98,61,9,2,65,73,129,58,21,7,573,287,286,688,372,316,-7,198,256,64,54,20,-15,111,133,24,41,-8,8,87,123,40,13,28,105,171,239,135,27,6,63,87,134,75,13,-2,42,84,105,60,14,8,420,241,179,537,305,232,78,125,192,-11,9,24,62,77,89,12,-13,12,16,48,103,-23,22,12,128,161,175,55,5,6,79,90,86,37,5,4,49,71,89,18,0,2,420,161,259,594,307,287,45,146,58,72,54,46,16,64,38,7,19,21,29,82,20,65,35,25,106,158,174,106,44,2,48,85,96,53,21,2,58,73,78,53,23,0,302,103,199,402,149,253,28,112,53,41,40,25,19,25,-6,12,51,-2,9,87,59,29,-11,27,60,134,100,58,34,10,25,38,36,28,15,5,35,96,64,30,19,5,173,29,144,251,78,173,-5,105,-14,12,42,29,-16,49,-29,12,2,10,11,56,15,0,40,19,29,85,55,46,21,7,12,23,15,23,3,0,17,62,40,23,18,7,275,75,200,233,82,151,84,70,58,56,-1,21,50,8,38,-2,-7,-1,34,62,20,58,6,22,41,64,68,36,16,7,21,20,25,11,5,1,20,44,43,25,11,6,-463,-273,-190,-337,-229,-108,-39,-69,-154,-129,-78,10,-1,-40,-88,-94,-52,2,-38,-29,-66,-35,-26,8,-31,-21,-111,-117,-50,-6,-22,-15,-70,-82,-34,-6,-9,-6,-41,-35,-16,0,-112,-107,-5,-57,-67,10,26,7,-80,-68,-29,28,20,-27,-42,-57,-11,7,6,34,-38,-11,-18,21,11,23,-14,-58,-17,-6,5,-4,-13,-41,-12,-3,6,27,-1,-17,-5,-3,-88,-93,5,-8,-28,20,-1,12,-74,-32,-25,35,-7,10,-48,-27,-18,1,6,2,-26,-5,-7,34,3,21,-7,-26,-2,2,-3,-2,-12,-5,-6,0,6,23,5,-21,4,2,143,50,93,10,-19,29,41,65,-41,72,-25,23,23,-6,-14,43,-9,4,18,71,-27,29,-16,19,-5,50,-11,-13,-18,3,-9,9,-7,-7,-7,0,4,41,-4,-6,-11,3,362,131,231,15,-40,55,105,79,108,49,2,7,56,43,20,33,-20,-11,49,36,88,16,22,18,28,35,24,-58,-10,-9,12,6,-1,-44,-13,-3,16,29,25,-14,3,-6,373,139,234,122,37,85,116,66,73,62,-9,53,58,30,12,14,9,13,58,36,61,48,-18,40,68,56,27,-36,-10,9,34,14,4,-20,0,0,34,42,23,-16,-10,9
28,28065,Getafe,145371,2578,1330,1248,2588,1373,1215,521,639,882,547,-48,27,241,304,505,287,-8,-5,280,335,377,260,-40,32,352,646,968,477,105,23,179,333,554,242,47,9,173,313,414,235,58,14,2618,1421,1197,3247,1811,1436,613,867,717,443,-113,74,354,494,418,231,-81,0,259,373,299,212,-32,74,581,895,1090,504,117,46,311,522,635,270,46,20,270,373,455,234,71,26,1349,709,640,2948,1608,1340,361,599,147,406,-149,-19,184,327,105,209,-102,-10,177,272,42,197,-47,-9,477,814,919,514,153,52,245,451,542,286,56,20,232,363,377,228,97,32,676,331,345,2545,1345,1200,296,589,-221,195,-160,-19,151,316,-87,77,-100,-22,145,273,-134,118,-60,3,460,664,816,425,129,37,235,328,472,238,49,17,225,336,344,187,80,20,100,-8,108,2036,1046,990,39,486,-358,140,-205,21,-4,230,-160,52,-108,-5,43,256,-198,88,-97,26,301,642,615,338,104,26,143,299,363,184,41,9,158,343,252,154,63,17,756,397,359,2338,1272,1066,142,629,-156,295,-165,41,73,359,-27,138,-109,-23,69,270,-129,157,-56,64,327,675,724,439,119,37,170,356,439,241,49,8,157,319,285,198,70,29,1962,987,975,3002,1622,1380,305,935,457,364,-104,17,127,474,262,210,-58,-17,178,461,195,154,-46,34,504,859,918,500,162,41,255,456,520,285,80,18,249,403,398,215,82,23,1896,1030,866,1576,850,726,563,923,122,410,-133,7,317,469,83,258,-92,2,246,454,39,152,-41,5,357,821,332,95,-25,-25,189,428,197,62,-23,-17,168,393,135,33,-2,-8,1711,676,1035,1139,524,615,559,611,273,380,-97,-22,290,293,66,133,-63,-48,269,318,207,247,-34,26,288,484,303,86,-9,-36,169,229,158,-15,-11,-22,119,255,145,101,2,-14,1342,487,855,1131,436,695,325,452,196,276,13,35,203,125,62,55,9,6,122,327,134,221,4,29,276,362,291,121,45,19,153,132,138,2,1,2,123,230,153,119,44,17,-1026,-658,-368,-628,-480,-148,-57,121,-625,-191,-207,-69,-15,37,-389,-148,-107,-39,-42,84,-236,-43,-100,-30,-110,50,-303,-199,-52,-28,-57,-23,-211,-162,-34,-1,-53,73,-92,-37,-18,-27,503,193,310,406,95,311,65,418,95,-3,-55,11,84,185,64,-32,-87,-5,-19,233,31,29,32,16,55,304,34,-10,-5,12,29,116,5,-31,-37,6,26,188,29,21,32,6,932,148,784,-365,-359,-6,75,240,574,-117,-25,122,40,17,185,-126,-38,36,35,223,389,9,13,86,-47,129,-210,-186,-50,-21,-14,21,-178,-147,-37,-9,-33,108,-32,-39,-13,-12,1337,605,732,-497,-325,-172,233,267,829,0,-52,-9,136,103,390,-31,-21,-12,97,164,439,31,-31,3,-14,135,-242,-269,-93,-38,-3,65,-147,-184,-52,-17,-11,70,-95,-85,-41,-21,1393,598,795,9,-85,94,268,407,525,113,-54,42,149,195,253,5,-43,-6,119,212,272,108,-11,48,51,251,-133,-149,-37,0,22,101,-88,-111,-22,1,29,150,-45,-38,-15,-1,1429,495,934,-121,-198,77,157,448,732,148,-120,-3,71,159,338,25,-117,-14,86,289,394,123,-3,11,-48,326,-25,-212,-131,-55,-33,131,-29,-154,-109,-19,-15,195,4,-58,-22,-36,2355,1044,1311,1273,557,716,308,614,841,409,111,-10,172,266,397,169,14,-18,136,348,444,240,97,8,169,518,290,150,75,45,84,227,149,57,12,18,85,291,141,93,63,27,3120,1565,1555,2099,1060,1039,512,675,868,742,175,31,251,333,467,386,58,14,261,342,401,356,117,17,339,630,555,332,143,63,196,321,303,151,49,23,143,309,252,181,94,40
28,28066,Griñón,4009,309,152,157,25,13,12,69,42,96,59,22,15,40,18,47,30,9,6,29,24,49,29,13,9,6,3,14,1,1,0,2,2,8,1,0,0,4,1,6,0,1,0,489,261,228,27,13,14,101,66,126,119,38,39,57,37,61,66,22,19,44,29,65,53,16,20,7,6,7,3,2,2,3,3,4,0,2,1,4,3,3,3,0,1,375,186,189,37,21,16,94,43,106,75,25,25,51,17,53,36,13,11,43,26,53,39,12,14,16,2,12,5,0,2,11,2,5,3,0,0,5,0,7,2,0,2,391,197,194,50,25,25,69,72,131,70,22,25,42,36,59,39,8,14,27,36,72,31,14,11,10,9,17,10,2,2,5,5,10,5,0,0,5,4,7,5,2,2,547,268,279,34,15,19,93,94,179,109,38,31,47,43,86,59,19,12,46,51,93,50,19,19,5,5,12,7,2,3,2,2,5,4,0,2,3,3,7,3,2,1,540,262,278,32,15,17,109,89,119,118,24,73,65,30,64,54,19,24,44,59,55,64,5,49,4,9,8,8,2,1,2,4,4,4,1,0,2,5,4,4,1,1,510,228,282,93,43,50,87,57,114,85,24,134,44,24,54,46,7,46,43,33,60,39,17,88,18,19,30,17,8,1,11,9,13,7,3,0,7,10,17,10,5,1,329,127,202,108,46,62,65,32,33,82,16,90,24,16,15,25,8,32,41,16,18,57,8,58,15,29,32,24,5,2,5,13,16,7,3,1,10,16,16,17,2,1,227,66,161,66,30,36,29,32,37,47,12,66,3,8,9,25,9,11,26,24,28,22,3,55,13,21,17,10,2,2,7,6,6,9,1,0,6,15,11,1,1,2,114,62,52,4,-2,6,25,7,23,-4,-2,62,24,6,15,5,-2,13,1,1,8,-9,0,49,1,11,-8,0,3,-4,0,6,-7,-1,2,-2,1,5,-1,1,1,-2,175,40,135,27,11,16,28,21,30,11,7,77,6,-3,-2,9,0,29,22,24,32,2,7,48,9,11,8,0,-1,0,3,7,4,-3,0,0,6,4,4,3,-1,0,57,47,10,20,7,13,5,-13,-2,-19,-2,96,20,-9,7,-20,1,51,-15,-4,-9,1,-3,45,5,8,3,1,-1,4,5,2,-1,0,-2,3,0,6,4,1,1,1,116,45,71,32,15,17,32,3,8,35,-13,56,23,-9,-2,29,-8,13,9,12,10,6,-5,43,5,12,12,1,2,0,3,3,8,0,2,-1,2,9,4,1,0,1,31,-14,45,4,1,3,-1,9,6,0,7,13,-8,-2,-4,-7,10,-3,7,11,10,7,-3,16,-1,4,2,0,-3,2,-1,-1,2,0,-1,2,0,5,0,0,-2,0,-49,-24,-25,-84,-38,-46,28,-22,-35,-28,-16,31,14,-11,-28,1,-6,13,14,-11,-7,-29,-10,18,1,-12,-24,-31,-13,-6,3,-7,-9,-18,-5,-2,-2,-5,-15,-13,-8,-4,56,-1,57,9,5,4,23,-16,-27,4,11,63,8,-4,-21,-6,4,18,15,-12,-6,10,7,45,10,0,8,-6,-5,0,7,1,2,-3,-3,0,3,-1,6,-3,-2,0,154,90,64,20,12,8,21,8,32,48,-5,47,17,8,19,21,-1,23,4,0,13,27,-4,24,7,-1,-1,10,4,3,6,-3,1,4,2,3,1,2,-2,6,2,0,127,43,84,60,24,36,36,-7,12,48,-33,61,18,-6,-4,33,-17,18,18,-1,16,15,-16,43,13,6,22,12,1,2,6,5,8,3,1,0,7,1,14,9,0,2
28,28067,Guadalix de la Sierra,2844,229,128,101,81,49,32,30,34,85,43,19,10,12,24,55,25,10,0,18,10,30,18,9,10,9,22,31,17,1,0,2,14,25,8,0,0,7,8,6,9,1,0,258,150,108,120,86,34,22,62,109,30,8,26,14,41,65,18,2,9,8,21,44,12,6,17,19,38,38,21,2,1,14,30,26,14,1,0,5,8,12,7,1,1,489,258,231,143,86,57,106,75,154,99,33,17,51,45,84,48,22,7,55,30,70,51,11,10,23,44,40,31,4,1,11,28,24,20,3,0,12,16,16,11,1,1,461,248,213,106,57,49,83,49,192,80,39,11,43,17,109,45,17,8,40,32,83,35,22,3,20,26,27,21,7,4,9,15,14,15,1,2,11,11,13,6,6,2,345,180,165,110,60,50,38,38,132,68,37,23,21,18,74,33,17,10,17,20,58,35,20,13,26,22,28,20,9,4,15,8,21,8,4,3,11,14,7,12,5,1,242,108,134,73,40,33,53,51,64,62,7,10,23,24,27,28,9,2,30,27,37,34,-2,8,16,20,16,18,5,-1,10,9,9,10,3,0,6,11,7,8,2,-1,216,94,122,107,54,53,39,46,77,23,15,9,27,14,31,3,7,6,12,32,46,20,8,3,25,33,28,14,4,3,10,15,17,9,2,1,15,18,11,5,2,2,168,94,74,128,69,59,14,15,72,23,17,32,8,8,41,21,5,13,6,7,31,2,12,19,31,24,37,32,1,2,15,8,21,25,-2,2,16,16,16,7,3,0,17,-9,26,87,42,45,13,10,6,-17,3,-2,1,4,3,-10,-3,-7,12,6,3,-7,6,5,25,24,19,12,3,1,10,14,8,7,0,1,15,10,11,5,3,0,42,12,30,10,-2,12,9,0,25,-10,4,9,9,-9,13,-11,5,3,0,9,12,1,-1,6,2,6,1,-1,-3,3,2,0,-1,-3,-1,1,0,6,2,2,-2,2,36,1,35,16,1,15,2,7,-11,19,6,11,-4,6,-19,8,1,9,6,1,8,11,5,2,4,2,3,4,0,0,2,-2,2,0,0,-1,2,4,1,4,0,1,69,30,39,27,17,10,8,5,18,23,2,4,-1,2,11,12,8,-6,9,3,7,11,-6,10,4,12,5,5,0,1,3,8,2,1,2,1,1,4,3,4,-2,0,-5,5,-10,1,-5,6,-4,-2,-2,-1,9,-5,9,-1,9,-8,6,-6,-13,-1,-11,7,3,1,2,1,-1,0,2,-2,2,-2,-3,-1,1,-1,0,3,2,1,1,-1,20,2,18,1,-6,7,-1,6,3,-14,-7,29,1,-5,-5,-1,-4,14,-2,11,8,-13,-3,15,2,4,0,-5,-1,1,2,-1,-1,-3,-2,0,0,5,1,-2,1,1,0,0,0,-7,-5,-2,1,-18,7,-4,4,11,6,-10,1,-1,4,0,-5,-8,6,-3,0,11,-2,2,1,-7,0,-1,-3,0,1,-4,2,-1,1,2,0,-3,-2,0,-116,-71,-45,-105,-65,-40,-9,-13,-19,-55,-29,11,-6,-1,-14,-32,-24,6,-3,-12,-5,-23,-5,5,-6,-9,-16,-40,-25,-9,-2,-7,-10,-25,-17,-4,-4,-2,-6,-15,-8,-5,-87,-52,-35,-128,-78,-50,-13,-18,-33,-28,-13,14,-3,-3,-20,-21,-11,5,-10,-15,-13,-7,-2,9,-19,-14,-37,-34,-23,-2,-11,-3,-22,-26,-15,-1,-8,-11,-15,-8,-8,-1,83,58,25,-24,-11,-13,-7,-8,32,28,9,28,4,0,29,15,-1,12,-11,-8,3,13,10,16,-10,3,0,-10,-5,-2,-5,3,1,-6,-4,0,-5,0,-1,-4,-1,-2
28,28068,Guadarrama,8805,782,402,380,300,165,135,139,112,268,132,70,55,75,61,139,71,31,21,64,51,129,61,39,34,55,69,114,52,3,5,30,40,62,30,1,1,25,29,52,22,2,4,804,445,359,397,215,182,142,101,290,176,57,36,83,58,153,102,30,17,59,43,137,74,27,19,72,85,139,80,12,6,34,51,75,46,5,3,38,34,64,34,7,3,725,382,343,324,170,154,132,124,217,138,52,51,69,74,113,72,30,17,63,50,104,66,22,34,71,72,91,58,20,10,35,45,47,29,8,5,36,27,44,29,12,5,564,259,305,318,171,147,77,72,221,64,44,79,39,27,115,37,11,28,38,45,106,27,33,51,56,85,101,55,12,9,31,43,58,32,3,4,25,42,43,23,9,5,446,265,181,252,139,113,69,84,124,62,57,48,59,47,71,41,25,22,10,37,53,21,32,26,36,64,69,45,23,8,23,30,41,28,8,4,13,34,28,17,15,4,295,167,128,142,68,74,1,62,89,74,33,34,-5,31,72,31,13,19,6,31,17,43,20,15,15,31,52,26,12,3,8,16,30,7,4,1,7,15,22,19,8,2,436,176,260,150,67,83,77,99,123,58,34,42,30,37,47,26,16,18,47,62,76,32,18,24,43,44,43,10,6,1,16,19,24,-2,6,2,27,25,19,12,0,-1,606,237,369,243,109,134,184,88,145,117,34,25,69,32,45,57,14,12,115,56,100,60,20,13,40,68,70,53,10,2,18,32,30,29,0,0,22,36,40,24,10,2,368,153,215,129,61,68,69,53,112,57,18,46,34,25,36,18,13,20,35,28,76,39,5,26,16,31,59,9,2,10,10,16,29,1,-2,5,6,15,30,8,4,5,374,175,199,156,81,75,59,55,97,76,37,54,38,24,40,44,21,10,21,31,57,32,16,44,32,32,47,35,10,0,13,15,25,25,4,-1,19,17,22,10,6,1,130,66,64,-18,-13,-5,16,0,22,32,6,52,0,-7,9,37,8,16,16,7,13,-5,-2,36,8,0,-28,-2,7,-4,7,-3,-20,1,4,-3,1,3,-8,-3,3,-1,112,72,40,-57,-31,-26,-6,47,34,-53,22,65,17,26,14,-28,15,28,-23,21,20,-25,7,37,-20,9,-9,-26,-4,-6,-7,2,-3,-15,-5,-2,-13,7,-6,-11,1,-4,155,48,107,-33,-15,-18,56,11,-25,53,3,57,32,6,-40,19,-1,31,24,5,15,34,4,26,-11,3,-18,-8,-2,3,-3,5,-16,-4,0,3,-8,-2,-2,-4,-2,0,-116,-60,-56,-73,-42,-31,-77,12,-38,-59,-25,64,-39,0,-8,-26,-13,17,-38,12,-30,-33,-12,47,-13,4,-34,-20,-12,-1,-7,-1,-22,-8,-6,0,-6,5,-12,-12,-6,-1,-85,-49,-36,-131,-85,-46,-37,-18,-31,-57,-7,63,-13,-2,-14,-34,-9,23,-24,-16,-17,-23,2,40,-8,-1,-47,-50,-17,-9,-3,3,-27,-41,-14,-4,-5,-4,-20,-9,-3,-5,19,-10,29,-76,-52,-24,12,11,-45,-6,-30,70,2,0,-13,6,-16,7,10,11,-32,-12,-14,63,-10,-3,-33,-9,-19,-3,-9,-3,-21,-4,-12,-3,-1,0,-12,-5,-7,0,192,69,123,-10,-20,10,3,11,5,35,27,109,3,0,-2,10,6,47,0,11,7,25,21,62,4,5,-13,-7,2,-1,2,-2,-9,-5,-5,-1,2,7,-4,-2,7,0,273,117,156,60,36,24,58,35,32,50,23,69,28,34,6,25,8,11,30,1,26,25,15,58,21,28,-4,9,1,3,18,19,-10,3,4,-1,3,9,6,6,-3,4
28,28073,Humanes de Madrid,9039,349,199,150,108,55,53,84,71,100,65,7,19,48,42,56,37,3,7,36,29,44,28,4,12,20,18,39,24,4,2,9,11,19,14,1,1,11,7,20,10,3,1,491,265,226,142,74,68,49,137,108,146,42,5,37,53,63,84,21,5,12,84,45,62,21,0,30,43,48,17,3,0,14,23,25,9,2,0,16,20,23,8,1,0,844,472,372,229,113,116,104,231,262,157,62,23,54,108,176,89,31,9,50,123,86,68,31,14,56,51,64,42,9,6,21,27,37,20,4,3,35,24,27,22,5,3,1014,567,447,247,136,111,37,313,421,131,86,23,19,158,262,71,46,11,18,155,159,60,40,12,44,65,80,37,11,8,22,32,52,22,2,5,22,33,28,15,9,3,1306,693,613,288,165,123,123,342,628,128,50,29,51,155,357,82,26,19,72,187,271,46,24,10,41,89,109,37,2,5,18,49,69,22,0,3,23,40,40,15,2,2,1281,645,636,341,177,164,81,354,636,131,33,35,48,153,358,62,7,13,33,201,278,69,26,22,68,110,93,49,12,4,41,44,61,24,4,1,27,66,32,25,8,3,801,456,345,371,228,143,96,175,390,81,42,10,50,92,248,42,18,2,46,83,142,39,24,8,78,97,114,54,17,9,49,57,82,31,3,5,29,40,32,23,14,4,672,339,333,459,253,206,-9,243,308,73,32,24,-17,138,159,45,9,7,8,105,149,28,23,17,67,142,133,82,25,10,35,78,81,46,9,4,32,64,52,36,16,6,469,241,228,364,188,176,84,87,169,49,10,73,62,37,90,29,0,28,22,50,79,20,10,45,84,96,113,52,11,6,53,47,58,25,4,1,31,49,55,27,7,5,243,115,128,170,80,90,-35,60,138,19,7,54,-27,9,110,-4,6,20,-8,51,28,23,1,34,24,38,68,19,10,9,8,15,41,8,2,5,16,23,27,11,8,4,-13,-29,16,94,49,45,-71,51,-22,-49,42,44,-31,18,-13,-32,16,12,-40,33,-9,-17,26,32,5,36,17,13,17,4,3,20,8,5,8,2,2,16,9,8,9,2,-248,-162,-86,-52,-37,-15,-122,27,-139,-39,20,6,-87,9,-84,-9,9,6,-35,18,-55,-30,11,0,-16,8,-54,-1,9,-1,-11,8,-32,-6,3,-1,-5,0,-22,5,6,0,59,5,54,62,35,27,8,52,40,-46,-16,17,19,17,-3,-34,-13,9,-11,35,43,-12,-3,8,25,21,15,-6,3,-1,18,8,9,-3,1,-1,7,13,6,-3,2,0,-117,-106,-11,-202,-131,-71,-13,10,-2,-85,-27,2,-12,8,8,-76,-20,-2,-1,2,-10,-9,-7,4,-17,-10,-68,-67,-29,-13,-10,-3,-44,-51,-16,-6,-7,-7,-24,-16,-13,-7,-166,-102,-64,-136,-70,-66,-52,41,-99,-47,-18,13,-33,25,-62,-24,-6,-2,-19,16,-37,-23,-12,15,-16,-6,-54,-38,-14,-12,-6,3,-37,-20,-5,-7,-10,-9,-17,-18,-9,-5,-6,-55,49,-17,-48,31,-14,16,44,-60,-6,7,-28,1,26,-43,-13,0,14,15,18,-17,7,7,3,19,-13,-14,-10,-6,-5,1,-17,-12,-12,-4,8,18,4,-2,2,-2,-73,-48,-25,31,7,24,-17,27,23,-91,-11,-2,-4,8,16,-58,-7,-7,-13,19,7,-33,-4,5,13,18,9,-5,-7,1,5,4,4,-2,-5,0,8,14,5,-3,-2,1,-107,-75,-32,-26,-13,-13,-43,12,35,-88,-42,40,-19,-2,24,-51,-28,12,-24,14,11,-37,-14,28,1,16,-21,-14,-11,1,6,4,-7,-12,-7,1,-5,12,-14,-2,-4,0
28,28074,Leganés,173163,1920,954,966,2754,1446,1308,453,607,574,344,-100,27,243,305,291,198,-100,12,210,302,283,146,0,15,383,800,988,444,102,16,204,379,560,250,39,4,179,421,428,194,63,12,937,489,448,2749,1488,1261,276,411,168,229,-173,-3,118,233,131,130,-128,-18,158,178,37,99,-45,15,448,767,890,495,103,28,226,414,502,279,41,12,222,353,388,216,62,16,572,373,199,2800,1517,1283,349,458,-129,167,-254,-6,150,260,-4,123,-149,0,199,198,-125,44,-105,-6,510,769,898,469,107,33,242,412,534,266,39,16,268,357,364,203,68,17,290,73,217,2530,1334,1196,189,480,-364,126,-200,37,122,261,-213,20,-126,-3,67,219,-151,106,-74,40,453,716,811,389,106,36,241,370,460,202,39,16,212,346,351,187,67,20,643,339,304,2123,1132,991,85,470,14,251,-231,34,43,259,25,127,-144,8,42,211,-11,124,-87,26,281,652,702,355,91,22,129,340,411,194,38,8,152,312,291,161,53,14,1589,929,660,2425,1323,1102,290,716,335,344,-181,46,205,390,212,224,-108,-27,85,326,123,120,-73,73,340,736,755,420,126,27,178,398,452,221,49,12,162,338,303,199,77,15,1515,700,815,2921,1514,1407,333,798,365,316,-246,-30,162,431,201,114,-148,-59,171,367,164,202,-98,29,467,862,926,488,126,35,238,455,511,245,48,8,229,407,415,243,78,27,452,269,183,2721,1513,1208,142,799,-318,68,-235,29,85,440,-191,68,-124,1,57,359,-127,0,-111,28,443,866,865,398,115,12,238,499,498,216,45,8,205,367,367,182,70,4,800,179,621,1784,914,870,206,527,-13,219,-99,-6,93,194,-50,53,-92,-4,113,333,37,166,-7,-2,325,568,511,266,69,25,162,278,322,110,19,9,163,290,189,156,50,16,819,221,598,1037,444,593,227,367,102,141,-84,79,120,120,13,39,-66,10,107,247,89,102,-18,69,211,382,263,122,42,-3,113,172,107,40,1,1,98,210,156,82,41,-4,-1367,-856,-511,-546,-464,-82,-152,22,-716,-215,-169,-115,-88,21,-470,-170,-89,-53,-64,1,-246,-45,-80,-62,-94,33,-281,-139,-50,-27,-61,-20,-188,-148,-40,-13,-33,53,-93,9,-10,-14,-214,-372,158,394,105,289,-1,241,-341,-99,-63,96,-24,81,-206,-160,-71,26,23,160,-135,61,8,70,47,251,105,-33,10,5,15,119,40,-73,-5,3,32,132,65,40,15,2,-1251,-847,-404,-1227,-793,-434,-2,25,-728,-280,-252,-18,8,2,-498,-222,-134,-4,-10,23,-230,-58,-118,-14,-164,8,-468,-383,-165,-66,-84,-15,-314,-278,-86,-19,-80,23,-154,-105,-79,-47,-919,-647,-272,-1062,-667,-395,122,73,-558,-326,-173,-63,89,49,-417,-228,-104,-38,33,24,-141,-98,-69,-25,-67,-13,-442,-372,-144,-37,-37,-1,-290,-250,-80,-16,-30,-12,-152,-122,-64,-21,118,-59,177,430,150,280,95,107,-85,37,-62,7,44,51,-70,-15,-54,-13,51,56,-15,52,-8,20,87,136,101,26,26,26,53,56,30,-16,2,15,34,80,71,42,24,11,-531,-319,-212,-760,-454,-306,-14,114,-271,-289,-70,-9,4,54,-163,-149,-53,-25,-18,60,-108,-140,-17,16,-78,23,-287,-325,-99,-11,-33,3,-165,-198,-60,-8,-45,20,-122,-127,-39,-3,510,130,380,629,207,422,168,370,10,-94,-14,50,104,165,-59,-55,-44,17,64,205,69,-39,30,33,169,274,151,-61,25,35,82,133,59,-63,-21,1,87,141,92,2,46,34,790,250,540,643,218,425,181,453,228,-35,-50,14,110,264,73,-112,-70,0,71,189,155,77,20,14,163,366,151,-37,-24,6,105,202,27,-88,-38,3,58,164,124,51,14,3
28,28076,Lozoya,442,24,15,9,16,12,4,0,9,15,-8,6,2,3,4,9,-4,4,-1,-3,5,6,-4,2,3,1,2,13,0,0,0,1,1,10,0,0,0,0,1,3,0,0,0,23,11,12,18,7,11,6,8,2,8,0,-2,3,3,-1,5,1,0,3,5,3,3,-1,-2,3,6,6,3,0,0,1,2,3,1,0,0,2,4,3,2,0,0,43,22,21,59,27,32,7,13,19,-1,5,1,3,8,9,-1,3,0,4,5,10,0,2,1,11,21,19,5,2,1,3,12,8,2,2,0,8,9,11,3,0,1,31,26,5,20,11,9,2,6,4,8,6,5,2,8,4,6,3,3,0,-2,0,2,3,2,6,6,6,2,0,0,2,4,3,2,0,0,4,2,3,0,0,0,47,30,17,38,20,18,11,5,15,14,1,1,6,2,11,8,2,1,5,3,4,6,-1,0,9,5,15,5,3,1,4,1,9,4,2,0,5,4,6,1,1,1,43,22,21,22,10,12,2,11,8,12,9,1,0,4,7,6,4,1,2,7,1,6,5,0,2,10,4,4,2,0,1,5,3,1,0,0,1,5,1,3,2,0,-1,5,-6,25,15,10,-7,3,7,-2,-1,-1,-2,3,6,-1,-2,1,-5,0,1,-1,1,-2,4,5,10,5,1,0,2,3,7,3,0,0,2,2,3,2,1,0,12,10,2,10,8,2,4,4,1,1,2,0,3,3,0,2,3,-1,1,1,1,-1,-1,1,1,3,6,1,-1,0,1,3,4,1,-1,0,0,0,2,0,0,0,7,4,3,4,1,3,0,2,-3,7,1,0,2,1,-4,3,1,1,-2,1,1,4,0,-1,0,3,0,0,1,0,0,1,0,0,0,0,0,2,0,0,1,0,20,8,12,-1,-2,1,1,-2,-3,15,7,4,2,-3,-5,10,5,0,-1,1,2,5,2,4,0,1,0,-1,-1,0,0,-1,-1,0,0,0,0,2,1,-1,-1,0,-32,-14,-18,-4,-5,1,-5,-2,-3,-9,-5,-6,-3,-1,-1,-4,-2,-2,-2,-1,-2,-5,-3,-4,1,-2,1,-2,-1,-1,0,-2,-1,-2,0,0,1,0,2,0,-1,-1,-8,-8,0,-2,-2,0,0,-2,5,-6,-5,0,-1,-2,2,-4,-4,1,1,0,3,-2,-1,-1,-1,1,-1,-1,-1,1,0,0,0,-1,-1,0,-1,1,-1,0,0,1,2,-1,3,4,1,3,0,1,-3,2,3,-1,-3,0,-4,2,3,1,3,1,1,0,0,-2,-1,1,0,3,1,0,-1,0,0,2,0,0,0,1,0,1,1,0,-3,4,-7,4,4,0,-1,3,-1,-3,0,0,0,6,-1,-1,-1,2,-1,-3,0,-2,1,-2,0,3,1,0,1,-1,0,2,1,0,1,0,0,1,0,0,0,-1,4,4,0,0,1,-1,4,0,3,1,2,-6,2,-1,5,0,1,-3,2,1,-2,1,1,-3,0,0,1,0,0,-1,0,0,1,0,0,0,0,0,0,0,0,-1,2,1,1,2,0,2,1,1,3,-6,0,3,1,1,-1,-4,0,4,0,0,4,-2,0,-1,0,2,-1,0,1,0,0,1,-1,0,0,0,0,1,0,0,1,0,-51,-21,-30,-59,-32,-27,-4,-6,-12,-18,-6,-4,0,-1,-3,-14,-3,0,-4,-5,-9,-4,-3,-4,-5,-8,-14,-20,-9,-3,-2,-3,-5,-14,-6,-2,-3,-5,-9,-6,-3,-1,11,5,6,5,1,4,3,-2,-1,7,3,1,-1,-1,-1,5,2,1,4,-1,0,2,1,0,1,-2,1,4,0,1,0,-1,0,1,0,1,1,-1,1,3,0,0
28,28079,Madrid,2879052,69345,31918,37427,100784,48128,52656,6295,24508,28692,14057,-522,-3234,3031,11219,13768,6075,-627,-1317,3264,13289,14924,7982,105,-1917,11402,26327,38905,19185,3613,963,5721,12133,19350,8952,1394,374,5681,14194,19555,10233,2219,589,63220,30646,32574,93521,45926,47595,10759,22671,22770,10089,-152,-2960,5392,10765,11385,4648,-412,-1160,5367,11906,11385,5441,260,-1800,15581,24654,32326,15839,3620,1027,7914,11678,16441,7817,1448,379,7667,12976,15885,8022,2172,648,46542,22538,24004,86930,43135,43795,10043,20061,15758,6742,-1289,-4161,4902,9669,7992,3068,-976,-1772,5141,10392,7766,3674,-313,-2389,16792,23325,27241,13972,3872,1249,8412,11228,14441,6880,1489,452,8380,12097,12800,7092,2383,797,30283,14349,15934,77104,38300,38804,5910,16210,9916,3997,-1322,-3804,2874,7802,5119,1480,-1007,-1559,3036,8408,4797,2517,-315,-2245,13836,20814,24412,12748,3666,1146,6950,9990,12970,6267,1418,440,6886,10824,11442,6481,2248,706,14997,7756,7241,61439,31367,30072,-1063,12060,7426,2683,-1186,-3935,-714,6026,4142,1127,-778,-1539,-349,6034,3284,1556,-408,-2396,7132,16421,22245,11311,3098,968,3575,8055,12149,5808,1257,386,3557,8366,10096,5503,1841,582,22819,10756,12063,63201,32019,31182,707,14301,8880,3274,-751,-2763,248,6773,4791,1178,-712,-1092,459,7528,4089,2096,-39,-1671,8216,17233,21898,11507,3143,913,4120,8267,11980,5889,1279,345,4096,8966,9918,5618,1864,568,38039,18587,19452,73647,36581,37066,1809,19992,15951,4733,-505,-3180,737,9655,8259,1915,-403,-1167,1072,10337,7692,2818,-102,-2013,9739,21782,25054,12620,3278,782,4823,10515,13227,6160,1357,312,4916,11267,11827,6460,1921,470,29422,12797,16625,59475,29151,30324,1525,19691,11617,1687,-930,-3466,552,9064,5639,-335,-677,-1119,973,10627,5978,2022,-253,-2347,8548,20824,19023,8661,1791,215,4302,9915,9968,3896,712,140,4246,10909,9055,4765,1079,75,18509,7820,10689,41128,20429,20699,1370,13983,9161,-447,-1617,-3462,631,6196,4118,-712,-970,-1211,739,7787,5043,265,-647,-2251,6449,14286,14034,4969,914,117,3312,6623,7441,2382,412,61,3137,7663,6593,2587,502,56,-805,-3820,3015,15747,5057,10690,-1088,7303,1948,-2932,-2217,-3406,-605,2448,-477,-2480,-1376,-1094,-483,4855,2425,-452,-841,-2312,2997,6947,4633,629,148,83,1517,2463,1384,-393,-91,27,1480,4484,3249,1022,239,56,-15663,-11958,-3705,-1371,-4407,3036,-4084,5337,-2590,-6439,-3183,-4462,-2288,1396,-2932,-4674,-1844,-1496,-1796,3941,342,-1765,-1339,-2966,-448,4157,-1353,-3052,-902,-140,-258,1083,-1998,-2747,-674,4,-190,3074,645,-305,-228,-144,-31961,-20407,-11554,-27322,-18220,-9102,-5644,4563,-8707,-12827,-5324,-3962,-2953,1079,-5840,-8337,-2990,-1331,-2691,3484,-2867,-4490,-2334,-2631,-3162,2764,-10605,-11383,-4247,-1050,-1672,246,-6748,-7512,-2349,-359,-1490,2518,-3857,-3871,-1898,-691,-11114,-8319,-2795,-12547,-9294,-3253,-3520,8347,-3611,-7641,-2571,-2207,-1767,3155,-2635,-4965,-1536,-626,-1753,5192,-976,-2676,-1035,-1581,-1418,5182,-6767,-7243,-2281,-370,-675,1714,-4306,-4763,-1284,-171,-743,3468,-2461,-2480,-997,-199,-20203,-11412,-8791,-26884,-15388,-11496,-3517,5951,-7497,-8930,-3431,-2674,-1879,2253,-3669,-5511,-1788,-771,-1638,3698,-3828,-3419,-1643,-1903,-2125,2492,-12844,-10309,-3603,-771,-1041,595,-6760,-6187,-1834,-300,-1084,1897,-6084,-4122,-1769,-471,-2045,-2102,57,-11587,-7576,-4011,-877,8438,334,-5141,-1745,-3076,-546,3311,492,-3314,-1090,-951,-331,5127,-158,-1827,-655,-2125,5,4088,-6916,-6985,-1932,-222,-33,1354,-3545,-4410,-1074,-50,38,2734,-3371,-2575,-858,-172,28979,13881,15098,15777,6328,9449,1948,13291,12577,1606,1395,-1838,945,5756,6626,675,243,-363,1003,7535,5951,931,1152,-1475,3429,7847,3141,-207,679,438,1783,3333,1349,-477,-31,163,1646,4514,1792,270,710,275,28599,13228,15371,23199,9442,13757,2469,13771,12785,689,1360,-2508,1425,6055,6491,-276,169,-699,1044,7716,6294,965,1191,-1809,4805,9156,5823,835,1187,796,2594,3910,2530,-342,136,282,2211,5246,3293,1177,1051,514,48983,23001,25982,44701,19943,24758,3997,19791,19720,4654,2538,-1610,2060,8742,9874,1870,881,-375,1937,11049,9846,2784,1657,-1235,7407,14023,12861,5802,2809,1194,3842,6158,5905,2279,970,458,3565,7865,6956,3523,1839,736
28,28080,Majadahonda,43955,-1174,-578,-596,24,12,12,-253,-178,-359,-252,-112,-16,-127,-84,-165,-121,-59,-14,-126,-94,-194,-131,-53,-2,5,0,9,7,3,0,3,0,3,4,2,0,2,0,6,3,1,0,1206,580,626,134,80,54,350,43,410,249,33,91,170,7,171,145,27,42,180,36,239,104,6,49,51,13,27,24,10,5,32,8,13,17,4,2,19,5,14,7,6,3,768,401,367,16,14,2,250,-60,352,95,12,86,141,-1,176,48,-5,27,109,-59,176,47,17,59,44,-22,-33,14,6,5,20,-11,-13,11,3,4,24,-11,-20,3,3,1,720,301,419,82,48,34,198,74,84,125,119,96,90,29,26,73,39,37,108,45,58,52,80,59,31,7,6,24,11,2,18,5,4,12,8,1,13,2,2,12,3,1,1990,874,1116,1305,522,783,265,346,493,491,148,192,154,139,210,221,52,71,111,207,283,270,96,121,149,345,411,283,66,36,73,137,165,107,19,15,76,208,246,176,47,21,1362,586,776,1408,590,818,173,308,371,345,66,66,66,145,109,193,24,24,107,163,262,152,42,42,217,359,449,274,67,32,92,148,187,116,32,8,125,211,262,158,35,24,1762,731,1031,1850,726,1124,389,414,427,296,96,99,197,151,179,107,25,37,192,263,248,189,71,62,328,469,569,343,90,25,148,169,221,132,33,10,180,300,348,211,57,15,1669,746,923,1591,636,955,221,413,480,269,100,140,113,184,221,115,46,45,108,229,259,154,54,95,214,418,539,307,71,25,92,170,225,113,20,8,122,248,314,194,51,17,791,329,462,804,306,498,120,173,216,163,21,53,50,55,95,77,8,9,70,118,121,86,13,44,91,246,271,146,26,6,50,79,104,62,3,0,41,167,167,84,23,6,323,125,198,72,20,52,85,100,20,-10,22,79,61,21,-17,1,7,36,24,79,37,-11,15,43,-10,102,23,-60,3,5,8,31,-7,-29,6,7,-18,71,30,-31,-3,-2,-74,-118,44,207,33,174,-22,14,-39,-98,-44,108,-8,14,-55,-86,-34,38,-14,0,16,-12,-10,70,39,86,35,13,7,15,9,30,2,-15,-3,4,30,56,33,28,10,11,-517,-374,-143,-135,-120,-15,-63,20,-254,-135,-94,7,-35,-5,-183,-98,-61,3,-28,25,-71,-37,-33,4,-30,69,-41,-75,-49,-20,-12,9,-46,-48,-29,-2,-18,60,5,-27,-20,-18,-55,-50,-5,19,-9,28,-13,19,-25,-104,18,69,8,1,-35,-53,18,26,-21,18,10,-51,0,43,1,39,1,-49,20,1,14,8,-9,-36,10,3,-13,31,10,-13,10,-2,114,55,59,-2,-55,53,28,35,21,3,-36,72,32,-23,11,27,-18,26,-4,58,10,-24,-18,46,8,37,-5,-38,-12,5,3,-6,-18,-27,-8,1,5,43,13,-11,-4,4,44,-4,48,121,1,120,102,16,-138,40,-60,75,55,18,-91,24,-23,13,47,-2,-47,16,-37,62,19,80,3,10,-8,4,-3,25,-12,-7,-8,-2,22,55,15,17,0,6,-56,-101,45,150,41,109,-17,86,-84,-1,-104,52,-1,8,-74,13,-68,14,-16,78,-10,-14,-36,38,25,90,51,-27,-21,14,13,19,7,-16,-1,7,12,71,44,-11,-20,7,190,-19,209,481,159,322,99,81,-58,54,-82,111,29,34,-56,22,-61,25,70,47,-2,32,-21,86,90,153,112,64,14,37,40,57,27,16,0,13,50,96,85,48,14,24,-320,-228,-92,-55,-136,81,-19,85,-42,-221,-155,17,-11,18,-41,-122,-95,15,-8,67,-1,-99,-60,2,56,132,59,-166,-93,-59,10,34,-10,-105,-62,-14,46,98,69,-61,-31,-45
28,28082,Manzanares el Real,3453,368,193,175,105,61,44,44,60,140,64,43,15,30,28,71,33,23,8,14,32,69,31,20,7,11,24,43,20,5,1,9,13,25,11,2,0,2,11,18,9,3,1,272,136,136,96,48,48,44,33,111,53,19,14,23,11,57,30,11,6,21,22,54,23,8,8,14,21,39,19,2,0,8,8,21,10,1,0,6,13,18,9,1,0,411,194,217,142,73,69,51,69,142,73,38,34,33,23,67,34,17,19,18,46,75,39,21,15,28,28,50,25,8,2,16,12,25,15,4,1,12,16,25,10,4,1,488,248,240,164,77,87,71,57,222,100,25,7,32,23,115,62,13,2,39,34,107,38,12,5,43,33,54,26,8,0,19,11,30,12,5,0,24,22,24,14,3,0,345,180,165,138,69,69,1,57,165,51,47,15,3,24,86,33,20,9,-2,33,79,18,27,6,26,43,37,16,12,2,10,22,23,5,7,1,16,21,14,11,5,1,172,106,66,121,63,58,13,33,90,24,3,13,9,13,54,18,4,7,4,20,36,6,-1,6,25,37,43,12,3,1,11,21,21,9,1,0,14,16,22,3,2,1,247,145,102,180,102,78,34,54,123,25,3,10,31,32,64,16,0,5,3,22,59,9,3,5,41,54,55,24,5,1,21,31,34,13,3,0,20,23,21,11,2,1,242,115,127,147,81,66,25,37,126,38,0,13,4,19,65,25,-1,7,21,18,61,13,1,6,22,39,58,18,4,5,14,24,32,6,2,3,8,15,26,12,2,2,211,104,107,62,27,35,17,19,110,31,23,10,-1,17,56,19,6,6,18,2,54,12,17,4,14,22,24,3,-2,1,5,10,13,-1,-1,1,9,12,11,4,-1,0,151,54,97,8,-4,12,43,5,65,36,-2,3,24,-6,16,13,4,1,19,11,49,23,-6,2,4,3,4,-2,2,-4,0,0,0,-3,-1,-1,4,3,4,1,3,-3,227,108,119,59,26,33,-14,31,114,47,36,5,-2,15,53,17,21,0,-12,16,61,30,15,5,14,8,13,16,9,-1,9,4,4,6,5,-2,5,4,9,10,4,1,149,75,74,13,3,10,1,11,73,42,12,10,7,1,37,24,2,5,-6,10,36,18,10,5,-3,5,-1,8,4,1,-4,2,1,2,2,0,1,3,-2,6,2,1,102,41,61,16,13,3,-7,-3,57,29,13,14,-6,-1,23,20,3,8,-1,-2,34,9,10,6,-2,5,2,7,0,4,1,4,4,1,1,1,-3,1,-2,6,-1,3,118,58,60,-4,0,-4,11,16,35,44,7,6,10,11,8,31,-1,2,1,5,27,13,8,4,-9,1,2,-3,2,1,-8,3,1,0,0,2,-1,-2,1,-3,2,-1,-82,-72,-10,-154,-86,-68,-17,-6,-20,-47,-8,16,-18,0,-22,-30,-12,6,1,-6,2,-17,4,10,-29,-8,-71,-38,-8,-2,-11,-3,-43,-25,-5,-1,-18,-5,-28,-13,-3,-1,61,18,43,12,-4,16,4,7,20,7,20,-6,5,7,7,-5,6,-3,-1,0,13,12,14,-3,-1,0,7,4,1,-1,-1,-1,3,-2,-2,-1,0,1,4,6,3,0,122,70,52,51,21,30,13,3,41,59,6,4,17,4,7,40,9,-3,-4,-1,34,19,-3,7,15,7,13,9,4,2,7,6,0,4,3,1,8,1,13,5,1,1,37,16,21,2,1,1,-9,13,49,-25,2,1,-7,4,20,-4,2,-3,-2,9,29,-21,0,4,6,8,5,-17,-3,1,2,4,6,-9,-4,1,4,4,-1,-8,1,0
28,28083,Meco,5667,497,273,224,101,66,35,70,112,185,80,36,5,43,48,105,54,17,2,27,64,80,26,19,3,11,27,39,21,3,0,7,13,29,15,2,0,4,14,10,6,1,0,881,464,417,139,75,64,164,126,299,198,66,22,90,58,159,108,38,8,74,68,140,90,28,14,29,40,44,24,2,0,13,19,26,15,2,0,16,21,18,9,0,0,943,479,464,258,142,116,164,219,324,126,80,21,80,102,177,64,41,9,84,117,147,62,39,12,60,70,75,42,7,1,28,35,51,24,2,1,32,35,24,18,5,0,708,386,322,258,135,123,122,138,307,107,30,8,73,68,167,61,17,0,49,70,140,46,13,8,46,78,75,44,10,5,21,42,43,26,3,0,25,36,32,18,7,5,610,352,258,265,156,109,43,174,243,92,28,25,37,101,132,52,16,9,6,73,111,40,12,16,34,88,89,36,13,5,20,51,47,28,8,2,14,37,42,8,5,3,405,195,210,278,148,130,40,111,174,62,6,10,24,45,83,38,0,4,16,66,91,24,6,6,46,89,78,48,11,4,27,42,43,24,8,2,19,47,35,24,3,2,287,112,175,310,156,154,25,91,113,21,10,29,-5,46,59,-3,2,16,30,45,54,24,8,13,48,98,90,49,16,5,22,47,51,26,7,2,26,51,39,23,9,3,237,133,104,172,89,83,58,75,19,68,1,13,45,27,18,42,-3,3,13,48,1,26,4,10,31,88,15,42,2,-8,15,41,15,19,2,-4,16,47,0,23,0,-4,46,-1,47,-1,-12,11,-9,-17,59,5,-13,17,0,-8,27,-15,-14,7,-9,-9,32,20,1,10,11,15,-15,-10,-9,5,11,7,-15,-9,-8,2,0,8,0,-1,-1,3,52,1,51,-88,-58,-30,-3,9,26,-1,7,15,2,-3,12,-11,1,2,-5,12,14,10,6,13,-15,-12,-24,-28,-7,-1,-9,-10,-16,-18,-3,0,-6,-2,-8,-10,-4,-1,-94,-69,-25,-250,-127,-123,-42,-27,5,-28,-8,-5,-32,-28,0,-6,-2,-3,-10,1,5,-22,-6,-2,-66,-22,-69,-59,-27,-6,-38,-17,-36,-23,-12,-1,-28,-5,-33,-36,-15,-5,129,36,93,-16,-10,-6,28,9,65,6,-1,16,3,6,24,-6,3,1,25,3,41,12,-4,15,-3,7,-16,-4,3,-6,-6,9,-10,-7,3,-2,3,-2,-6,3,0,-4,68,24,44,-48,-37,-11,18,-10,66,-26,-17,33,20,-5,37,-19,-20,13,-2,-5,29,-7,3,20,5,2,-12,-28,-11,-4,5,3,-9,-25,-9,-2,0,-1,-3,-3,-2,-2,155,29,126,-93,-75,-18,76,5,21,20,4,21,25,2,-13,-2,-5,16,51,3,34,22,9,5,-3,-2,-58,-27,-7,2,-4,1,-47,-16,-9,0,1,-3,-11,-11,2,2,38,6,32,-128,-69,-59,39,8,-16,5,-20,18,27,10,-21,5,-20,3,12,-2,5,0,0,15,-9,-11,-42,-39,-19,-9,-5,-5,-17,-24,-13,-6,-4,-6,-25,-15,-6,-3,89,54,35,23,14,9,31,2,38,3,-7,19,9,6,27,6,-3,8,22,-4,11,-3,-4,11,9,11,11,-8,-4,2,6,8,9,-8,-4,2,3,3,2,0,0,0,113,81,32,28,16,12,39,15,16,63,-11,-8,34,1,14,41,-7,-4,5,14,2,22,-4,-4,1,7,7,8,1,3,3,1,4,6,0,1,-2,6,3,2,1,2,329,158,171,17,-1,18,104,44,59,71,10,29,45,16,38,41,1,14,59,28,21,30,9,15,6,16,-23,7,-1,11,3,3,-8,0,-2,3,3,13,-15,7,1,8
28,28084,Mejorada del Campo,15500,673,353,320,212,112,100,124,98,266,87,29,54,72,47,154,36,12,25,52,51,112,51,17,29,34,47,72,45,8,5,15,21,42,26,4,3,19,26,30,19,4,2,812,431,381,377,201,176,98,164,336,137,48,27,39,79,204,78,23,12,59,85,132,59,25,15,62,97,126,73,13,3,26,42,81,46,6,0,36,55,45,27,7,3,774,431,343,487,263,224,110,171,361,104,1,17,46,98,208,67,6,0,64,73,153,37,-5,17,82,136,171,74,18,2,44,72,90,45,9,0,38,64,81,29,9,2,641,332,309,451,248,203,68,163,259,82,36,22,25,88,139,47,15,10,43,75,120,35,21,12,57,147,143,86,11,4,28,81,80,51,5,2,29,66,63,35,6,2,868,437,431,521,282,239,141,206,348,114,7,42,64,105,181,63,5,13,77,101,167,51,2,29,62,159,201,79,14,5,27,87,119,42,7,2,35,72,82,37,7,3,620,307,313,448,227,221,119,147,191,112,42,11,61,63,100,70,20,-2,58,84,91,42,22,13,76,142,125,78,24,4,36,67,72,43,8,2,40,75,53,35,16,2,478,255,223,516,262,254,60,137,201,67,0,15,53,76,98,27,0,-1,7,61,103,40,0,16,84,146,171,87,24,2,44,74,91,35,16,1,40,72,80,52,8,1,689,349,340,574,309,265,81,241,206,106,12,37,38,126,130,33,8,12,43,115,76,73,4,25,88,201,172,87,24,1,37,115,101,43,13,-1,51,86,71,44,11,2,74,-11,85,104,47,57,37,-1,53,-1,-19,0,11,-18,12,-2,-14,-1,26,17,41,1,-5,1,36,38,23,13,-10,1,24,18,3,5,-5,1,12,20,20,8,-5,0,149,70,79,-22,-44,22,55,46,43,-5,5,1,47,3,38,-13,-7,3,8,43,5,8,12,-2,9,15,-14,-28,-6,1,6,-6,-9,-22,-12,0,3,21,-5,-6,6,1,-229,-153,-76,-310,-182,-128,-16,-51,-59,-79,-34,-2,-21,-32,-38,-59,-16,4,5,-19,-21,-20,-18,-6,-43,-33,-121,-79,-29,-10,-20,-26,-79,-47,-11,-3,-23,-7,-42,-32,-18,-7,80,19,61,0,-19,19,5,58,-7,8,-15,20,14,20,-18,4,-16,11,-9,38,11,4,1,9,-1,30,-22,-10,-8,6,5,16,-17,-17,-10,3,-6,14,-5,7,2,3,15,-8,23,20,-10,30,-14,58,-20,-36,13,15,-8,26,-3,-39,10,2,-6,32,-17,3,3,13,7,5,6,-9,4,2,1,2,-2,-14,0,0,6,3,8,5,4,2,-371,-179,-192,-293,-158,-135,-19,-65,-131,-98,-64,9,-10,-28,-77,-53,-24,12,-9,-37,-54,-45,-40,-3,-60,-28,-97,-70,-35,-3,-28,-21,-55,-41,-10,-2,-32,-7,-42,-29,-25,-1,-17,-9,-8,-12,-1,-11,5,17,-13,-24,-10,8,19,5,-17,-5,-5,-5,-14,12,4,-19,-5,13,-10,13,-7,-14,5,-2,-5,8,-7,0,1,-1,-5,5,0,-14,4,-1,-56,-31,-25,-44,-16,-28,9,0,-22,-60,-4,11,15,9,-26,-33,-11,9,-6,-9,4,-27,7,2,5,14,-12,-44,-8,-6,10,6,-6,-27,-2,-1,-5,8,-6,-17,-6,-5,6,7,-1,-69,-39,-30,26,24,-18,-29,-7,11,9,9,-1,-16,-8,8,17,15,-17,-13,1,3,-11,8,-18,-36,-9,-6,-12,2,-11,-16,-5,0,1,6,-7,-20,-4,-6,186,90,96,123,67,56,43,42,38,6,6,30,24,21,28,-4,-2,14,19,21,10,10,8,16,35,32,42,6,2,5,21,13,36,-7,2,1,14,19,6,13,0,4
28,28085,Miraflores de la Sierra,3606,118,53,65,91,44,47,15,12,47,16,9,12,11,3,19,10,2,3,4,9,28,6,7,9,19,14,38,16,2,1,11,4,20,9,0,0,8,10,18,7,2,1,89,39,50,76,39,37,8,15,30,10,12,12,2,8,20,-2,4,5,6,7,10,12,8,7,11,22,25,14,3,0,5,8,19,6,0,0,6,14,6,8,3,0,245,125,120,134,76,58,28,60,105,34,9,6,13,33,57,15,6,1,15,27,48,19,3,5,21,33,56,15,4,3,7,18,39,9,2,0,14,15,17,6,2,3,368,184,184,134,69,65,65,77,93,82,34,12,30,44,46,38,14,8,35,33,47,44,20,4,32,35,42,19,3,3,13,21,25,8,2,0,19,14,17,11,1,3,276,159,117,124,66,58,32,67,106,34,21,13,14,32,68,29,14,3,18,35,38,5,7,10,21,39,41,16,6,2,8,18,25,12,3,1,13,21,16,4,3,1,267,105,162,98,49,49,45,37,51,88,26,16,7,20,21,35,14,8,38,17,30,53,12,8,14,36,17,24,6,0,6,20,10,12,1,0,8,16,7,12,5,0,275,121,154,170,67,103,53,45,116,53,3,-4,15,22,47,35,-4,2,38,23,69,18,7,-6,22,48,64,27,9,-1,8,22,26,11,1,-1,14,26,38,16,8,0,276,154,122,234,117,117,36,67,87,53,20,4,26,33,56,27,9,0,10,34,31,26,11,4,40,69,72,39,10,0,20,33,35,22,7,-1,20,36,37,17,3,1,146,73,73,72,45,27,28,11,36,48,19,0,7,-3,22,29,16,1,21,14,14,19,3,-1,11,15,24,17,2,0,8,7,17,11,0,0,3,8,7,6,2,0,-2,-8,6,43,20,23,-9,6,-13,5,8,-9,5,1,-19,1,0,-2,-14,5,6,4,8,-7,2,17,12,6,1,-1,2,8,7,1,0,0,0,9,5,5,1,-1,19,5,14,30,17,13,-4,10,-15,4,-1,1,-2,7,-12,-5,2,2,-2,3,-3,9,-3,-1,-1,2,3,1,3,0,-2,2,1,1,0,0,1,0,2,0,3,0,6,20,-14,37,15,22,-10,4,-6,6,-1,6,-6,11,-3,13,-1,3,-4,-7,-3,-7,0,3,8,13,7,5,2,0,3,6,1,2,2,-1,5,7,6,3,0,1,-66,-20,-46,22,14,8,-8,-18,-13,4,-27,1,-12,-5,5,7,-12,1,4,-13,-18,-3,-15,0,1,8,4,7,3,-1,-1,4,4,6,1,0,2,4,0,1,2,-1,32,30,2,-16,-15,-1,-2,7,14,-6,14,6,1,6,18,-2,11,-3,-3,1,-4,-4,3,9,-5,-2,1,-11,-1,1,-5,-1,1,-9,0,-1,0,-1,0,-2,-1,2,-33,-7,-26,24,14,10,-26,12,-7,-6,-6,1,-6,10,-4,-1,-9,4,-20,2,-3,-5,3,-3,4,7,9,-2,3,1,5,2,5,-1,1,1,-1,5,4,-1,2,0,-93,-52,-41,-87,-57,-30,-23,-15,-18,-46,-1,4,-12,-6,-8,-32,-3,6,-11,-9,-10,-14,2,-2,-6,-7,-17,-40,-14,-2,-6,-3,-11,-24,-15,2,0,-4,-6,-16,1,-4,74,51,23,6,-1,7,1,26,11,3,19,12,1,19,2,13,10,6,0,7,9,-10,9,6,1,7,5,-7,-4,2,0,2,2,-1,-3,-1,1,5,3,-6,-1,3,102,61,41,34,12,22,18,1,52,33,-5,1,19,-1,23,14,0,4,-1,2,29,19,-5,-3,4,5,16,6,-1,3,5,0,3,1,-1,2,-1,5,13,5,0,1
28,28086,"Molar, El",3628,201,116,85,162,84,78,27,54,64,43,14,-1,19,23,45,22,6,0,8,31,19,21,8,-1,29,40,51,36,5,0,15,20,28,19,2,0,14,20,23,17,3,0,336,169,167,225,109,116,47,86,114,43,19,22,32,44,58,19,8,5,15,42,56,24,11,17,48,57,71,43,3,1,27,29,33,18,1,0,21,28,38,25,2,1,344,173,171,195,92,103,69,73,120,65,22,-8,30,37,59,38,10,-1,39,36,61,27,12,-7,40,57,53,29,11,3,19,29,26,13,2,2,21,28,27,16,9,1,248,141,107,174,108,66,30,54,62,70,14,11,14,28,44,41,8,4,16,26,18,29,6,7,29,45,51,39,8,2,15,29,33,24,6,1,14,16,18,15,2,1,142,57,85,137,73,64,19,44,52,27,9,-4,11,20,11,15,4,-3,8,24,41,12,5,-1,18,47,38,29,5,0,11,24,19,17,2,0,7,23,19,12,3,0,391,217,174,201,110,91,34,87,147,97,-1,20,16,45,81,65,-1,6,18,42,66,32,0,14,25,74,51,44,5,2,17,34,28,29,1,1,8,40,23,15,4,1,700,364,336,284,156,128,61,145,291,133,43,18,27,65,172,64,23,8,34,80,119,69,20,10,34,93,83,59,11,4,15,50,48,33,8,2,19,43,35,26,3,2,620,306,314,214,104,110,97,122,252,104,18,13,48,56,131,54,9,3,49,66,121,50,9,10,58,77,44,34,2,-1,28,33,27,16,0,0,30,44,17,18,2,-1,403,208,195,196,103,93,69,72,190,51,5,8,42,28,105,28,-4,4,27,44,85,23,9,4,50,56,51,30,3,3,25,28,29,18,0,1,25,28,22,12,3,2,258,106,152,151,66,85,51,77,61,33,22,11,30,25,17,21,8,5,21,52,44,12,14,6,36,42,28,30,8,4,19,17,8,16,3,1,17,25,20,14,5,3,261,121,140,96,37,59,30,30,95,49,33,10,20,22,51,13,5,7,10,8,44,36,28,3,13,23,26,18,14,-3,8,9,12,4,3,-1,5,14,14,14,11,-2,90,23,67,-14,-36,22,13,39,5,-13,21,7,4,15,8,-22,4,3,9,24,-3,9,17,4,8,19,-21,-19,-1,-5,-1,3,-20,-17,-3,-1,9,16,-1,-2,2,-4,80,39,41,30,20,10,4,22,43,-8,1,2,4,3,20,0,0,0,0,19,23,-8,1,2,10,14,14,-9,-3,-2,8,7,7,-6,-1,0,2,7,7,-3,-2,-2,31,14,17,4,-14,18,-38,21,-1,1,10,24,-21,7,2,3,9,9,-17,14,-3,-2,1,15,2,5,0,-6,1,2,0,-4,-4,-5,-1,0,2,9,4,-1,2,2,105,37,68,18,8,10,5,20,16,16,11,24,0,6,8,2,7,9,5,14,8,14,4,15,-1,23,3,-4,-8,2,3,12,0,-3,-4,0,-4,11,3,-1,-4,2,-106,-94,-12,-304,-189,-115,16,18,-30,-85,-54,6,10,-1,-26,-54,-37,5,6,19,-4,-31,-17,1,-14,-5,-90,-113,-73,-14,-7,-8,-51,-73,-47,-5,-7,3,-39,-40,-26,-9,261,142,119,142,82,60,40,32,54,66,27,27,24,15,47,25,5,17,16,17,7,41,22,10,36,29,30,27,9,7,23,14,20,15,3,4,13,15,10,12,6,3,148,88,60,84,42,42,-1,48,60,-26,25,20,3,28,37,-11,8,7,-4,20,23,-15,17,13,9,43,15,-6,13,3,6,23,6,-4,3,3,3,20,9,-2,10,0
28,28087,"Molinos, Los",3165,178,91,87,57,34,23,25,21,56,48,15,9,8,12,26,26,12,6,17,9,30,22,3,3,2,16,26,12,0,1,2,8,15,9,0,0,0,8,11,3,0,1,208,106,102,96,52,44,29,40,69,48,8,12,16,20,42,20,6,2,13,20,27,28,2,10,18,24,28,23,3,0,9,12,20,9,2,0,9,12,8,14,1,0,197,116,81,115,64,51,48,26,47,45,17,10,27,19,24,30,10,5,21,7,23,15,7,5,29,26,34,19,3,1,18,16,19,7,2,1,11,10,15,12,1,0,95,74,21,101,57,44,5,32,25,19,8,5,8,16,19,19,5,6,-3,16,6,0,3,-1,25,25,26,20,4,0,15,12,14,13,3,0,10,13,12,7,1,0,41,77,-36,99,66,33,-16,12,34,-3,-7,23,9,18,36,6,-1,11,-25,-6,-2,-9,-6,12,17,27,44,6,3,2,12,18,30,4,1,1,5,9,14,2,2,1,180,121,59,149,87,62,5,60,54,36,13,8,8,39,35,25,6,7,-3,21,19,11,7,1,19,46,52,22,8,1,13,25,32,11,5,0,6,21,20,11,3,1,140,127,13,177,104,73,46,37,34,11,-8,14,35,20,36,15,2,15,11,17,-2,-4,-10,-1,39,42,54,25,9,7,20,27,34,11,7,4,19,15,20,14,2,3,131,117,14,153,97,56,-2,35,29,19,38,10,7,24,33,16,27,6,-9,11,-4,3,11,4,24,50,52,17,7,3,15,24,38,13,4,3,9,26,14,4,3,0,9,7,2,59,31,28,-4,-5,11,1,-3,8,-2,0,12,-3,-1,-3,-2,-5,-1,4,-2,11,4,19,20,10,5,-1,1,11,12,4,3,-1,3,8,8,6,2,0,17,6,11,48,22,26,14,-4,0,11,1,-3,9,1,-9,0,-1,5,5,-5,9,11,2,-8,11,13,13,7,5,-1,8,5,6,0,3,0,3,8,7,7,2,-1,3,9,-6,24,12,12,-10,9,-6,16,-4,0,-3,8,-1,8,1,0,-7,1,-5,8,-5,0,0,15,4,4,1,0,1,9,1,1,0,0,-1,6,3,3,1,0,9,1,8,30,10,20,15,-3,-11,-2,0,9,7,-1,-10,-3,3,6,8,-2,-1,1,-3,3,6,7,10,2,4,0,4,3,4,-1,0,0,2,4,6,3,4,0,57,32,25,7,6,1,22,3,3,19,3,7,11,-3,4,16,3,2,11,6,-1,3,0,5,-4,3,4,4,2,-2,-3,1,4,3,1,0,-1,2,0,1,1,-2,-64,-34,-30,8,2,6,0,-9,-17,-24,-6,-6,-1,-2,-4,-17,-5,-2,1,-7,-13,-7,-1,-4,-2,-1,5,5,-1,2,1,-1,2,0,0,0,-3,0,3,5,-1,2,5,6,-1,43,23,20,-6,8,0,-13,5,11,0,-1,3,-4,1,7,-6,9,-3,-9,4,4,15,3,16,4,3,1,8,1,7,5,0,1,7,2,9,-1,3,0,-99,-56,-43,-71,-47,-24,-13,-11,-22,-25,-24,-4,-5,-1,-15,-16,-14,-5,-8,-10,-7,-9,-10,1,-3,-6,-15,-25,-21,-1,-4,-3,-10,-15,-14,-1,1,-3,-5,-10,-7,0,-9,-13,4,7,2,5,-13,3,-3,-10,9,5,-12,0,3,-10,3,3,-1,3,-6,0,6,2,3,3,6,-5,2,-2,3,2,3,-5,-1,0,0,1,3,0,3,-2,6,14,-8,15,5,10,-16,-5,-2,1,10,17,-7,-8,5,6,5,13,-9,3,-7,-5,5,4,3,4,1,4,2,1,1,0,-2,3,2,1,2,4,3,1,0,0
28,28089,Moraleja de Enmedio,2878,120,62,58,18,11,7,33,17,45,19,3,1,17,5,31,11,-1,-1,16,12,14,8,4,2,5,8,3,1,1,0,3,4,3,1,0,0,2,4,0,0,1,0,171,83,88,39,21,18,29,41,42,42,19,-1,15,19,23,19,8,0,14,22,19,23,11,-1,7,12,11,9,0,0,1,8,8,4,0,0,6,4,3,5,0,0,144,65,79,52,25,27,49,24,24,37,10,1,24,7,11,19,5,-1,25,17,13,18,5,2,24,10,15,3,0,0,13,4,7,1,0,0,11,6,8,2,0,0,248,126,122,24,10,14,45,42,72,52,30,5,22,18,35,29,19,2,23,24,37,23,11,3,6,6,7,4,0,0,3,1,4,2,0,0,3,5,3,2,0,0,307,148,159,50,21,29,52,62,104,59,23,4,21,28,51,28,18,1,31,34,53,31,5,3,9,12,18,10,1,0,5,3,8,4,1,0,4,9,10,6,0,0,118,63,55,35,21,14,31,37,25,25,-5,9,11,22,12,17,-2,4,20,15,13,8,-3,5,7,11,11,5,1,0,1,7,8,4,1,0,6,4,3,1,0,0,98,61,37,66,37,29,18,15,37,24,4,1,13,0,33,14,2,-1,5,15,4,10,2,2,6,20,25,8,7,0,4,11,18,2,2,0,2,9,7,6,5,0,64,17,47,27,15,12,5,3,24,1,0,31,2,-1,10,3,2,2,3,4,14,-2,-2,29,3,4,10,5,4,1,1,2,4,5,3,0,2,2,6,0,1,1,71,31,40,53,24,29,30,3,6,16,8,8,14,11,-4,12,0,1,16,-8,10,4,8,7,11,9,19,7,6,1,5,7,8,2,2,0,6,2,11,5,4,1,74,24,50,21,7,14,15,15,14,18,8,1,14,2,9,5,-3,0,1,13,5,13,11,1,3,5,8,2,3,0,3,1,3,0,0,0,0,4,5,2,3,0,37,28,9,15,9,6,4,16,-1,7,0,8,5,10,2,6,-4,6,-1,6,-3,1,4,2,2,7,2,2,1,1,0,4,1,2,0,2,2,3,1,0,1,-1,66,12,54,33,16,17,7,15,12,12,5,10,-2,7,-3,4,2,2,9,8,15,8,3,8,5,13,3,6,1,4,3,5,2,3,1,2,2,8,1,3,0,2,-57,-28,-29,16,9,7,-24,-17,-1,-12,-3,1,-14,-6,-2,-4,-1,-2,-10,-11,1,-8,-2,3,4,3,5,4,0,0,3,2,3,1,0,0,1,1,2,3,0,0,10,4,6,17,13,4,17,6,5,-7,-8,3,9,-1,9,-10,-1,2,8,7,-4,3,-7,1,3,4,6,3,1,0,1,4,6,0,2,0,2,0,0,3,-1,0,-59,-22,-37,-63,-30,-33,-11,-6,-11,-8,-19,-8,-5,-6,-2,-1,-9,-5,-6,0,-9,-7,-10,-3,-2,-7,-24,-15,-9,-7,2,-4,-12,-12,-2,-3,-4,-3,-12,-3,-7,-4,-65,-43,-22,-1,2,-3,-10,-16,-24,-17,-13,13,-3,-3,-21,-6,-8,-3,-7,-13,-3,-11,-5,16,3,1,-3,1,-4,0,2,0,-1,1,-1,0,1,1,-2,0,-3,0,-125,-67,-58,-2,-1,-1,-25,-11,-46,-29,-23,4,-11,-6,-26,-17,-11,0,-14,-5,-20,-12,-12,4,1,0,-3,-1,1,0,1,0,-1,-1,0,0,0,0,-2,0,1,0,21,6,15,8,3,5,4,9,-6,8,-4,9,5,5,-2,2,-3,-1,-1,4,-4,6,-1,10,5,6,-5,5,-3,0,2,3,0,1,-3,0,3,3,-5,4,0,0
28,28090,Moralzarzal,4449,523,265,258,6,2,4,73,65,203,78,67,26,38,29,103,52,30,8,35,36,100,26,37,18,1,0,4,0,0,1,1,0,1,0,0,0,0,0,3,0,0,1,523,259,264,4,2,2,99,25,198,102,59,36,68,11,83,50,37,9,31,14,115,52,22,27,1,0,1,0,0,2,0,0,1,0,0,1,1,0,0,0,0,1,789,417,372,169,93,76,151,85,277,159,69,29,83,51,129,88,40,14,68,34,148,71,29,15,28,47,49,34,6,5,15,28,25,20,3,2,13,19,24,14,3,3,855,423,432,145,68,77,135,92,355,137,73,45,73,38,177,79,30,18,62,54,178,58,43,27,36,34,34,26,11,3,19,15,19,12,3,0,17,19,15,14,8,3,579,294,285,132,60,72,60,115,207,105,42,42,37,52,115,60,14,10,23,63,92,45,28,32,18,33,44,28,7,2,11,8,27,12,2,0,7,25,17,16,5,2,471,230,241,136,60,76,102,39,154,114,29,29,70,17,58,60,12,14,32,22,96,54,17,15,30,36,43,22,5,0,15,14,20,10,1,0,15,22,23,12,4,0,435,185,250,177,83,94,82,51,127,98,41,30,27,17,67,52,12,7,55,34,60,46,29,23,47,28,50,41,8,0,24,14,24,18,1,0,23,14,26,23,7,0,183,84,99,132,58,74,3,39,60,20,27,37,7,19,20,6,13,19,-4,20,40,14,14,18,28,38,38,16,7,3,16,15,17,4,2,3,12,23,21,12,5,0,112,42,70,44,23,21,64,3,-13,12,25,23,34,-4,-10,6,10,7,30,7,-3,6,15,16,12,18,8,2,5,-1,7,7,3,4,2,0,5,11,5,-2,3,-1,119,64,55,34,11,23,7,10,56,-2,5,42,7,8,22,6,-1,22,0,2,34,-8,6,20,8,18,6,-1,3,0,6,4,4,-2,-2,1,2,14,2,1,5,-1,111,45,66,11,-2,13,6,6,42,32,8,11,0,5,28,13,-4,0,6,1,14,19,12,11,0,3,-4,8,2,1,-3,2,-6,0,4,1,3,1,2,8,-2,0,88,28,60,6,-4,10,-6,3,38,25,-4,22,-13,-2,18,5,0,12,7,5,20,20,-4,10,3,1,-1,1,-2,1,0,-4,-2,-1,1,0,3,5,1,2,-3,1,7,-1,8,6,-4,10,-20,-11,-7,-9,12,33,0,-6,-7,-6,9,2,-20,-5,0,-3,3,31,-1,8,0,-1,0,1,-1,4,-4,-2,1,-1,0,4,4,1,-1,2,166,82,84,2,6,-4,37,8,21,56,13,26,5,10,20,29,7,10,32,-2,1,27,6,16,0,7,0,-9,4,-1,2,5,2,-7,3,1,-2,2,-2,-2,1,-2,60,36,24,-15,-10,-5,20,-14,25,-4,6,24,12,-9,9,4,7,11,8,-5,16,-8,-1,13,-4,-4,-4,-2,-1,-1,-3,-4,-3,-2,1,0,-1,0,-1,0,-2,-1,146,62,84,-18,-15,-3,33,-1,3,46,25,37,18,7,-5,25,9,7,15,-8,8,21,16,30,-19,0,3,-15,6,7,-6,-1,-1,-9,0,2,-13,1,4,-6,6,5,99,29,70,20,7,13,34,-1,12,31,-7,18,20,-6,2,9,-10,8,14,5,10,22,3,10,2,-2,6,12,0,1,2,-1,0,5,-2,2,0,-1,6,7,2,-1,251,129,122,46,24,22,34,13,61,82,8,49,24,3,30,44,6,22,10,10,31,38,2,27,3,13,15,6,3,5,4,4,8,7,-1,2,-1,9,7,-1,4,3
28,28091,Morata de Tajuña,5420,105,61,44,77,42,35,11,27,29,20,3,4,8,13,21,9,4,1,3,14,8,11,-1,3,11,19,27,14,2,1,8,10,16,6,1,0,3,9,11,8,1,1,161,94,67,79,48,31,26,29,62,27,4,12,10,17,38,20,3,5,16,12,24,7,1,7,9,24,29,14,2,1,5,14,16,11,2,0,4,10,13,3,0,1,202,114,88,127,74,53,48,79,37,22,11,3,32,44,15,14,9,-1,16,35,22,8,2,4,27,51,31,14,3,0,16,31,16,8,2,0,11,20,15,6,1,0,70,37,33,63,32,31,2,17,16,12,13,7,-5,10,12,6,9,3,7,7,4,6,4,4,16,20,13,10,2,0,7,13,3,6,1,0,9,7,10,4,1,0,183,103,80,118,64,54,26,52,76,9,9,7,14,29,44,4,5,3,12,23,32,5,4,4,21,38,45,8,3,1,6,20,28,6,3,0,15,18,17,2,0,1,123,49,74,85,39,46,17,45,51,6,-5,3,3,22,30,-2,-6,0,14,23,21,8,1,3,13,26,36,7,1,1,5,13,19,1,0,1,8,13,17,6,1,0,361,166,195,133,64,69,48,96,118,51,27,12,15,54,57,25,10,5,33,42,61,26,17,7,18,47,27,32,8,1,5,26,14,15,4,0,13,21,13,17,4,1,285,159,126,170,97,73,40,79,80,57,23,12,32,43,50,33,8,-1,8,36,30,24,15,13,28,54,39,36,14,-1,19,28,27,19,5,-1,9,26,12,17,9,0,204,82,122,64,35,29,36,21,50,33,3,61,12,8,24,23,2,13,24,13,26,10,1,48,14,12,24,13,-3,3,9,5,9,12,-2,1,5,7,15,1,-1,2,113,59,54,20,-5,25,13,10,20,2,13,53,13,15,7,-2,8,17,0,-5,13,4,5,36,3,8,7,0,0,0,3,1,-1,-8,0,0,0,7,8,8,0,0,100,10,90,-48,-30,-18,12,10,-24,16,-2,85,0,2,-8,-2,0,17,12,8,-16,18,-2,68,-6,4,-30,-11,-2,-6,-4,1,-14,-12,0,-3,-2,3,-16,1,-2,-3,76,19,57,1,-5,6,-13,3,21,-12,18,62,-6,-5,13,-5,8,17,-7,8,8,-7,10,45,-13,6,-1,4,3,2,-6,-2,-1,3,1,0,-7,8,0,1,2,2,35,-13,48,-118,-84,-34,-7,8,-30,-27,3,89,3,4,-29,-26,0,37,-10,4,-1,-1,3,52,-16,-11,-39,-31,-17,-3,-7,-8,-35,-22,-10,-1,-9,-3,-4,-9,-7,-2,-65,-74,9,-95,-61,-34,-29,-18,-48,-33,3,59,-17,-9,-36,-26,3,12,-12,-9,-12,-7,0,47,-16,-7,-40,-27,-6,1,-6,-4,-27,-20,-4,0,-10,-3,-13,-7,-2,1,0,-15,15,-37,-31,-6,-16,1,-23,-16,1,49,-10,6,-10,-12,-5,16,-6,-5,-13,-4,6,33,-3,0,-21,-11,-2,-1,1,-4,-11,-12,-4,-1,-4,4,-10,1,2,0,157,71,86,45,23,22,39,5,20,15,22,52,19,5,21,6,8,10,20,0,-1,9,14,42,14,5,5,13,6,1,5,2,3,9,3,1,9,3,2,4,3,0,36,26,10,7,8,-1,19,13,12,-6,-14,10,19,2,10,-7,3,0,0,11,2,1,-17,10,6,14,-12,2,-5,0,3,8,-8,3,1,-1,3,6,-4,-1,-6,1,174,47,127,8,-10,18,15,12,17,15,9,107,8,-4,4,3,4,32,7,16,13,12,5,75,2,10,6,-8,-3,1,-2,1,2,-9,-4,2,4,9,4,1,1,-1
28,28092,Móstoles,195351,1627,803,824,2839,1479,1360,112,498,787,157,-70,140,15,246,464,88,-60,47,97,252,323,69,-10,93,392,723,1027,492,136,57,199,362,579,257,57,22,193,361,448,235,79,35,919,534,385,2745,1451,1294,123,477,386,-85,-139,152,36,299,285,-35,-102,40,87,178,101,-50,-37,112,482,710,921,443,129,45,232,384,509,244,59,13,250,326,412,199,70,32,434,224,210,2939,1520,1419,-11,452,183,-85,-239,164,-16,276,163,-61,-174,57,5,176,20,-24,-65,107,540,747,892,527,168,52,274,378,504,277,63,16,266,369,388,250,105,36,1338,822,516,3246,1775,1471,111,788,449,70,-155,89,62,477,321,55,-116,28,49,311,128,15,-39,61,499,875,1031,573,192,62,266,496,598,305,79,27,233,379,433,268,113,35,661,426,235,3054,1713,1341,-24,633,210,34,-270,99,-53,385,224,17,-138,13,29,248,-14,17,-132,86,383,877,1033,570,133,54,188,484,635,327,54,25,195,393,398,243,79,29,-233,-56,-177,3065,1649,1416,-9,376,-162,-112,-338,60,11,194,2,-53,-222,36,-20,182,-164,-59,-116,24,464,867,1011,511,135,60,240,426,629,275,44,25,224,441,382,236,91,35,395,292,103,3672,2039,1633,125,788,-207,57,-323,-15,44,488,8,25,-196,-56,81,300,-215,32,-127,41,593,1066,1159,625,182,29,297,592,723,342,71,5,296,474,436,283,111,24,153,125,28,3566,1883,1683,-11,868,-448,1,-274,28,-21,514,-155,-47,-163,4,10,354,-293,48,-111,24,540,1091,1084,623,167,37,251,604,628,304,74,9,289,487,456,319,93,28,-825,-626,-199,1920,959,961,-16,360,-794,-75,-346,67,-53,126,-464,-43,-186,14,37,234,-330,-32,-160,53,382,582,613,272,53,-8,183,273,324,139,26,-1,199,309,289,133,27,-7,-1738,-1232,-506,310,-63,373,-130,133,-1235,-374,-176,34,-60,-8,-771,-242,-118,-21,-70,141,-464,-132,-58,55,97,260,-33,-74,26,4,49,65,-84,-105,-1,-2,48,195,51,31,27,6,-1755,-1155,-600,415,61,354,-50,119,-1280,-263,-307,44,-30,38,-745,-218,-182,-5,-20,81,-535,-45,-125,49,55,250,57,3,14,14,48,75,3,-68,-12,5,7,175,54,71,26,9,9,-308,317,185,-35,220,-21,336,-389,-25,-72,108,19,90,-312,-106,-72,39,-40,246,-77,81,0,69,46,242,-88,-17,4,-25,23,99,-78,-67,-15,-8,23,143,-10,50,19,-17,-114,-316,202,-409,-293,-116,14,169,-157,-247,-80,158,-11,-16,-127,-159,-65,57,25,185,-30,-88,-15,101,-79,89,-218,-171,-40,-7,-56,22,-140,-104,-27,2,-23,67,-78,-67,-13,-9,-1406,-849,-557,-1268,-723,-545,-67,-13,-712,-472,-239,102,-70,4,-358,-308,-151,44,3,-17,-354,-164,-88,58,-123,-58,-469,-375,-183,-70,-76,-24,-257,-241,-108,-23,-47,-34,-212,-134,-75,-47,-280,-302,22,149,36,113,-46,217,-257,-265,-123,143,-8,79,-144,-169,-94,13,-38,138,-113,-96,-29,130,38,143,0,-60,-13,21,25,52,-4,-48,-1,2,13,91,4,-12,-12,19,-673,-570,-103,-888,-650,-238,84,268,-471,-378,-200,29,46,123,-340,-268,-149,22,38,145,-131,-110,-51,7,5,156,-389,-426,-194,-57,-2,83,-269,-319,-132,-15,7,73,-120,-107,-62,-42,19,-119,138,163,-62,225,129,315,-61,-169,-193,-27,61,159,-62,-126,-163,7,68,156,1,-43,-30,-34,152,193,2,-170,-39,4,77,93,-44,-142,-62,4,75,100,46,-28,23,0,-296,-405,109,-46,-149,103,-22,312,-271,-362,-136,179,-17,152,-161,-303,-107,29,-5,160,-110,-59,-29,150,87,213,-20,-242,-110,4,52,117,-47,-194,-87,-4,35,96,27,-48,-23,8
28,28093,Navacerrada,1824,38,14,24,22,15,7,5,3,8,7,13,2,1,3,3,0,6,1,4,0,5,7,7,1,2,5,7,6,1,1,2,4,5,2,1,1,0,1,2,4,0,0,41,22,19,45,27,18,7,10,20,10,-3,-4,3,7,9,4,1,-3,4,3,11,6,-4,-1,9,11,11,10,3,1,7,7,6,5,2,0,2,4,5,5,1,1,169,81,88,55,25,30,18,34,71,31,8,6,4,18,38,14,5,3,14,16,33,17,3,3,9,16,21,6,0,2,4,8,8,3,0,1,5,8,13,3,0,1,81,32,49,39,22,17,15,16,23,13,3,7,3,6,11,5,1,4,12,10,12,8,2,3,9,10,4,11,2,2,5,6,1,7,1,1,4,4,3,4,1,1,69,42,27,37,20,17,4,7,50,6,2,-4,5,2,23,9,4,-2,-1,5,27,-3,-2,-2,4,9,11,6,3,0,4,4,7,3,1,0,0,5,4,3,2,0,113,57,56,25,10,15,19,5,29,30,17,2,12,5,13,17,4,0,7,0,16,13,13,2,0,5,5,5,2,0,0,2,0,2,0,0,0,3,5,3,2,0,75,35,40,62,27,35,22,6,13,28,2,0,9,7,3,14,-2,3,13,-1,10,14,4,-3,9,14,17,14,4,2,1,10,7,5,2,1,8,4,10,9,2,1,91,27,64,64,23,41,19,16,25,14,11,0,1,3,11,5,6,-3,18,13,14,9,5,3,13,16,14,9,5,2,1,6,6,2,3,2,12,10,8,7,2,0,35,25,10,60,28,32,5,15,3,12,-8,2,6,9,6,7,-2,-3,-1,6,-3,5,-6,5,10,13,17,11,-1,3,7,7,6,6,-1,0,3,6,11,5,0,3,29,24,5,31,12,19,-8,4,21,4,-1,0,-1,1,4,13,0,2,-7,3,17,-9,-1,-2,2,5,12,2,2,1,1,2,4,1,1,1,1,3,8,1,1,0,-5,4,-9,9,3,6,-12,-12,-3,-2,9,12,-10,-4,2,5,3,6,-2,-8,-5,-7,6,6,1,1,0,-1,3,1,0,0,0,-1,1,1,1,1,0,0,2,0,13,10,3,22,6,16,-13,9,5,-1,10,-6,-7,4,4,5,3,-3,-6,5,1,-6,7,-3,4,5,1,5,-1,0,1,2,0,0,-1,0,3,3,1,5,0,0,58,17,41,26,10,16,16,7,12,-7,18,6,5,5,0,-9,6,5,11,2,12,2,12,1,6,4,7,2,3,0,2,2,2,0,0,0,4,2,5,2,3,0,25,14,11,11,8,3,6,-11,-1,14,1,10,6,-6,0,10,-3,3,0,-5,-1,4,4,7,3,-1,2,1,2,0,1,0,1,1,2,0,2,-1,1,0,0,0,11,24,-13,15,7,8,6,-10,3,10,-2,2,8,-3,3,6,8,1,-2,-7,0,4,-10,1,1,3,5,0,1,2,-1,1,4,-1,1,2,2,2,1,1,0,0,31,9,22,-32,-14,-18,-1,12,8,6,-4,2,-4,9,-1,3,-3,-1,3,3,9,3,-1,3,0,-3,-10,-11,-3,-8,1,-1,-3,-7,-3,-4,-1,-2,-7,-4,0,-4,13,0,13,6,1,5,-9,2,6,-3,11,1,-5,-1,-2,0,6,-1,-4,3,8,-3,5,2,1,3,1,-1,-1,-1,1,2,0,-3,-1,-1,0,1,1,2,0,0,33,23,10,12,4,8,5,11,0,6,-2,9,2,5,1,6,3,4,3,6,-1,0,-5,5,4,5,3,-2,-2,1,2,2,1,-1,-1,0,2,3,2,-1,-1,1
28,28094,Navalafuente,496,39,22,17,17,13,4,9,9,7,6,7,1,4,6,5,4,3,0,5,3,2,2,4,1,0,9,4,4,0,0,0,7,4,2,0,0,0,2,0,2,0,0,22,10,12,11,6,5,0,6,4,9,3,0,0,4,0,7,0,-1,0,2,4,2,3,1,2,1,4,2,2,0,1,0,4,0,1,0,1,1,0,2,1,0,67,32,35,19,11,8,10,8,29,15,5,0,5,3,14,7,3,0,5,5,15,8,2,0,4,4,7,4,0,0,2,2,4,3,0,0,2,2,3,1,0,0,60,27,33,20,9,11,12,10,15,8,6,9,6,5,1,7,5,3,6,5,14,1,1,6,3,4,10,3,0,0,1,2,4,2,0,0,2,2,6,1,0,0,54,34,20,27,19,8,12,5,14,16,7,-1,7,4,8,10,6,-1,5,1,6,6,1,0,5,7,7,7,1,0,3,5,4,6,1,0,2,2,3,1,0,0,1,-6,7,8,3,5,8,0,4,-3,-8,-1,3,-3,3,-1,-6,-2,5,3,1,-2,-2,1,1,4,2,0,0,0,0,1,2,0,0,0,1,3,0,0,0,0,64,26,38,38,20,18,10,13,22,17,-1,1,2,3,10,12,0,-1,8,10,12,5,-1,2,8,12,10,8,0,0,3,4,8,5,0,0,5,8,2,3,0,0,110,57,53,44,19,25,18,25,41,16,7,-2,8,8,23,12,5,-1,10,17,18,4,2,-1,12,13,11,7,1,0,5,4,5,5,0,0,7,9,6,2,1,0,124,70,54,36,18,18,26,12,42,32,1,3,11,3,23,25,4,1,15,9,19,7,-3,2,10,1,12,11,0,0,4,1,6,7,-1,0,6,0,6,4,1,0,6,7,-1,5,3,2,-2,3,5,-8,4,3,3,2,1,-5,4,2,-5,1,4,-3,0,1,1,2,1,-1,2,0,1,1,1,-1,1,0,0,1,0,0,1,0,50,22,28,11,6,5,8,6,13,18,4,0,6,2,4,7,0,0,2,4,9,11,4,0,2,7,1,0,1,0,1,4,1,0,0,0,1,3,0,0,1,0,-32,-18,-14,8,3,5,-9,-1,-14,-3,0,-1,-5,-3,-3,-1,-1,-2,-4,2,-11,-2,1,1,0,1,3,2,1,1,0,0,3,0,0,0,0,1,0,2,1,1,-11,-12,1,5,-1,6,-6,0,-2,-6,-1,6,-8,-3,1,0,-4,2,2,3,-3,-6,3,4,4,2,0,0,-1,0,1,1,-1,0,-2,0,3,1,1,0,1,0,-35,-25,-10,-7,-3,-4,-10,-6,-1,-5,-8,-3,-9,-1,0,-5,-6,-2,-1,-5,-1,0,-2,-1,-1,0,-3,-2,-1,0,0,0,-2,-1,0,0,-1,0,-1,-1,-1,0,-1,7,-8,-5,-2,-3,2,0,-4,10,-4,-5,0,3,3,8,-2,-5,2,-3,-7,2,-2,0,0,-1,0,-2,-2,0,0,0,-1,0,-1,0,0,-1,1,-2,-1,0,43,23,20,-12,-8,-4,2,3,7,15,6,8,2,0,1,8,7,4,0,3,6,7,-1,4,-4,-2,0,-5,-2,1,-2,-1,0,-2,-3,0,-2,-1,0,-3,1,1,59,21,38,-1,-1,0,3,11,19,21,11,-6,1,6,7,5,5,-3,2,5,12,16,6,-3,-5,6,0,-2,0,0,-3,4,2,-4,0,0,-2,2,-2,2,0,0,49,33,16,-1,3,-4,15,0,21,9,-2,4,12,-2,12,7,-1,1,3,2,9,2,-1,3,-1,4,3,-3,-2,-3,2,1,2,-1,-1,-1,-3,3,1,-2,-1,-2
28,28099,Navas del Rey,1583,121,78,43,35,17,18,35,19,37,7,12,9,23,15,21,5,8,6,12,4,16,2,4,3,7,9,12,4,1,1,4,6,3,2,1,1,3,3,9,2,0,0,98,62,36,64,36,28,19,25,23,25,7,-1,9,19,15,15,3,1,10,6,8,10,4,-2,16,17,14,13,4,0,9,12,9,5,1,0,7,5,5,8,3,0,207,108,99,88,45,43,46,46,44,48,10,12,21,25,27,28,3,4,25,21,17,20,7,8,21,29,16,17,1,2,10,18,9,5,1,1,11,11,7,12,0,1,116,81,35,68,42,26,11,29,34,12,18,10,10,21,23,10,11,5,1,8,11,2,7,5,19,18,21,6,3,0,13,12,12,3,1,0,6,6,9,3,2,0,83,31,52,50,21,29,24,13,19,4,14,7,14,1,12,-5,7,0,10,12,7,9,7,7,15,15,11,6,2,1,8,6,7,0,0,0,7,9,4,6,2,1,104,53,51,57,21,36,20,16,36,20,7,6,18,4,18,7,3,5,2,12,18,13,4,1,17,15,10,9,4,0,13,3,0,2,2,1,4,12,10,7,2,-1,26,19,7,44,26,18,6,6,3,10,2,1,1,2,0,14,3,-1,5,4,3,-4,-1,2,9,15,15,2,3,-1,5,7,10,1,2,0,4,8,5,1,1,-1,77,33,44,55,26,29,2,19,22,13,15,6,6,9,7,0,7,3,-4,10,15,13,8,3,11,17,22,4,1,-1,7,8,10,1,-1,0,4,9,12,3,2,-1,75,17,58,-10,-15,5,11,3,-1,7,14,42,-4,-5,-7,8,7,18,15,8,6,-1,7,24,4,-1,-7,-5,1,-2,0,-2,-9,-4,1,-1,4,1,2,-1,0,-1,102,59,43,36,15,21,31,0,24,20,-1,24,24,-5,5,15,-1,18,7,5,19,5,0,6,9,7,11,6,-2,4,6,2,3,3,-2,2,3,5,8,3,0,2,52,25,27,-1,-2,1,9,14,18,3,2,5,12,1,7,2,4,0,-3,13,11,1,-2,5,2,-1,-2,-1,1,0,2,-1,-3,-1,1,0,0,0,1,0,0,0,-18,4,-22,-7,2,-9,-21,6,-9,2,4,2,-19,3,8,7,2,2,-2,3,-17,-5,2,0,-10,3,0,2,0,0,-6,2,4,2,1,0,-4,1,-4,0,-1,0,18,-2,20,-19,-19,0,9,7,-2,4,-6,9,-1,1,0,-2,0,2,10,6,-2,6,-6,7,2,2,-15,-6,-3,0,-1,0,-10,-5,-3,0,3,2,-5,-1,0,0,-33,-11,-22,-16,-14,-2,-10,-7,-24,6,2,1,-7,-3,-11,10,0,0,-3,-4,-13,-4,2,1,-9,-1,-1,-3,-2,0,-6,-1,-1,-4,-2,0,-3,0,0,1,0,0,22,9,13,-16,-5,-11,-5,-1,13,-4,5,13,1,-2,6,-5,5,4,-6,1,7,1,0,9,-2,0,-7,-5,-3,1,-1,1,-3,-2,0,0,-1,-1,-4,-3,-3,1,32,23,9,5,0,5,-7,-4,4,13,4,23,-7,-5,12,12,1,12,0,1,-8,1,3,11,3,2,4,0,-3,-1,3,0,2,-3,-2,0,0,2,2,3,-1,-1,90,40,50,12,3,9,10,15,20,17,12,15,6,4,9,6,12,1,4,11,11,11,0,14,0,1,4,7,0,0,-3,1,3,2,0,0,3,0,1,5,0,0,71,37,34,25,10,15,1,16,-4,14,17,26,1,7,3,2,10,16,0,9,-7,12,7,10,12,7,2,3,0,0,6,1,4,-2,0,0,6,6,-2,5,0,0
28,28100,Nuevo Baztán,2624,235,120,115,67,30,37,49,20,93,51,17,1,26,11,45,25,15,-2,23,9,48,26,2,3,16,15,22,11,1,1,10,6,8,5,1,0,6,9,14,6,0,1,219,99,120,76,36,40,51,28,43,56,30,8,17,15,28,21,13,3,34,13,15,35,17,5,19,10,31,8,5,3,6,7,18,4,1,0,13,3,13,4,4,3,215,106,109,95,52,43,39,27,79,36,14,15,15,14,39,18,13,3,24,13,40,18,1,12,25,28,20,12,7,2,12,17,10,6,6,0,13,11,10,6,1,2,397,198,199,104,62,42,69,38,143,85,51,8,28,17,82,43,24,4,41,21,61,42,27,4,15,25,30,25,8,0,7,13,23,14,4,0,8,12,7,11,4,0,298,150,148,114,55,59,57,54,128,40,20,-5,33,28,62,13,16,-4,24,26,66,27,4,-1,11,41,30,24,6,0,6,19,15,11,3,0,5,22,15,13,3,0,203,118,85,105,59,46,37,36,90,26,10,2,21,25,53,16,5,-1,16,11,37,10,5,3,14,38,35,15,2,1,8,26,15,8,2,0,6,12,20,7,0,1,223,82,141,127,58,69,14,59,53,59,23,10,-4,23,24,22,14,-1,18,36,29,37,9,11,6,49,27,24,14,6,2,23,14,11,6,2,4,26,13,13,8,4,214,121,93,168,79,89,46,24,59,52,22,9,26,24,26,35,6,5,20,0,33,17,16,4,26,46,44,36,10,6,11,25,23,16,2,2,15,21,21,20,8,4,30,35,-5,64,31,33,0,-18,33,4,6,1,6,-8,22,11,5,-1,-6,-10,11,-7,1,2,10,17,25,10,3,-2,6,8,12,5,1,-1,4,9,13,5,2,-1,84,38,46,6,1,5,13,-4,46,19,-5,8,5,-10,25,16,-4,-1,8,6,21,3,-1,9,-1,3,5,-1,-1,-1,-3,-3,4,2,1,0,2,6,1,-3,-2,-1,-32,-10,-22,10,5,5,-17,-12,13,-17,7,0,-12,-8,11,-11,7,7,-5,-4,2,-6,0,-7,1,9,2,-4,3,-1,4,5,-1,-3,1,-1,-3,4,3,-1,2,0,10,3,7,15,13,2,-6,-9,-4,5,7,21,-9,-8,2,9,7,4,3,-1,-6,-4,0,17,-5,7,4,5,1,4,-2,3,6,3,0,3,-3,4,-2,2,1,1,63,28,35,15,6,9,8,12,-1,5,17,15,13,17,-9,-9,6,7,-5,-5,8,14,11,8,1,2,0,3,7,2,1,2,-1,-1,4,1,0,0,1,4,3,1,12,-10,22,26,11,15,13,-9,10,4,-10,3,-1,-5,-2,0,-3,0,14,-4,12,4,-7,3,6,4,2,6,6,2,0,1,2,3,4,1,6,3,0,3,2,1,-52,-12,-40,19,4,15,-10,-16,-1,-8,-11,-9,-4,-7,10,-6,-4,-4,-6,-9,-11,-2,-7,-5,3,4,3,5,3,0,2,-2,1,1,1,0,1,6,2,4,2,0,96,46,50,25,8,17,19,-1,36,28,10,-3,5,3,8,15,14,-1,14,-4,28,13,-4,-2,5,11,3,2,5,-2,3,8,-2,-4,2,0,2,3,5,6,3,-2,66,58,8,34,17,17,8,19,22,1,23,-10,14,2,17,8,15,-1,-6,17,5,-7,8,-9,2,11,5,8,6,2,3,4,3,3,3,1,-1,7,2,5,3,1,64,30,34,16,4,12,18,-2,13,28,4,-1,4,-3,7,22,-2,1,14,1,6,6,6,-2,10,-12,9,0,8,1,4,-9,5,-1,5,0,6,-3,4,1,3,1
28,28102,Orusco de Tajuña,665,6,8,-2,2,1,1,1,2,-2,1,-1,5,2,4,-2,0,1,3,-1,-2,0,1,-2,2,0,1,0,1,0,0,0,1,0,0,0,0,0,0,0,1,0,0,3,2,1,2,1,1,-3,6,0,2,-1,-1,-2,1,2,3,-1,-1,-1,5,-2,-1,0,0,0,0,2,0,0,0,0,0,1,0,0,0,0,0,1,0,0,0,40,24,16,10,7,3,7,7,7,10,7,2,2,7,6,5,3,1,5,0,1,5,4,1,1,3,4,2,0,0,1,3,2,1,0,0,0,0,2,1,0,0,20,12,8,13,6,7,-1,3,6,3,2,6,1,2,4,2,1,2,-2,1,2,1,1,4,1,4,7,1,0,0,0,2,3,1,0,0,1,2,4,0,0,0,35,6,29,2,1,1,-2,2,3,-4,0,37,-3,1,2,-5,0,12,1,1,1,1,0,25,0,1,1,0,0,0,0,0,1,0,0,0,0,1,0,0,0,0,95,50,45,29,16,13,19,16,23,5,5,25,10,7,14,5,3,10,9,9,9,0,2,15,7,11,6,3,2,0,3,7,4,2,0,0,4,4,2,1,2,0,51,21,30,27,9,18,-3,12,14,12,17,-2,-3,5,5,6,9,-2,0,7,9,6,8,0,1,8,6,8,1,2,1,3,1,3,0,0,0,5,5,5,1,2,62,33,29,35,15,20,5,1,25,23,8,0,2,2,9,17,3,-1,3,-1,16,6,5,1,7,9,11,4,4,0,3,4,4,2,2,0,4,5,7,2,2,0,87,38,49,10,5,5,6,7,7,20,8,38,5,1,4,7,4,18,1,6,3,13,4,20,1,2,4,3,0,0,1,1,2,1,0,0,0,1,2,2,0,0,33,17,16,8,4,4,2,-1,0,6,7,16,4,0,-6,6,2,9,-2,-1,6,0,5,7,1,3,0,2,1,0,1,0,0,1,1,0,0,3,0,1,0,0,102,39,63,4,2,2,12,6,15,14,6,50,5,-1,8,7,4,17,7,7,7,7,2,33,1,1,0,1,0,1,1,0,0,1,0,0,0,1,0,0,0,1,20,8,12,3,2,1,-3,0,5,-13,8,22,-1,3,3,-8,2,9,-2,-3,2,-5,6,13,0,0,1,1,1,0,0,0,1,1,0,0,0,0,0,0,1,0,14,11,3,6,4,2,1,-7,10,3,3,3,2,-2,3,2,5,1,-1,-5,7,1,-2,2,1,2,2,0,1,0,1,1,1,0,1,0,0,1,1,0,0,0,8,-6,14,2,-1,3,-5,7,-1,3,6,-2,-9,-1,0,0,2,0,4,8,-1,3,4,-2,1,0,1,0,0,0,0,0,0,-1,0,0,1,0,1,1,0,0,6,-9,15,9,3,6,-8,1,-4,0,3,14,-5,0,-3,-3,0,3,-3,1,-1,3,3,11,2,2,0,3,2,0,2,1,-1,1,0,0,0,1,1,2,2,0,-13,1,-14,-13,-7,-6,-4,-6,-16,-1,-3,16,-4,1,-7,2,-2,10,0,-7,-9,-3,-1,6,-2,-1,-3,-5,-1,-1,-1,0,-3,-3,0,0,-1,-1,0,-2,-1,-1,24,5,19,2,1,1,-4,6,10,4,3,3,-6,4,9,0,-2,-1,2,2,1,4,5,4,1,0,1,0,0,0,1,0,0,0,0,0,0,0,1,0,0,0,16,15,1,5,5,0,-1,-8,-6,12,2,18,3,-4,-4,9,4,8,-4,-4,-2,3,-2,10,0,0,0,5,0,0,1,0,1,3,0,0,-1,0,-1,2,0,0
28,28106,Parla,72975,1420,833,587,1529,899,630,116,434,515,228,29,85,45,257,364,117,9,30,71,177,151,111,20,55,228,414,541,278,38,16,123,244,340,160,17,6,105,170,201,118,21,10,2238,1301,937,1941,1118,823,349,616,781,365,38,76,198,335,517,205,-1,40,151,281,264,160,39,36,337,544,618,335,60,30,189,326,373,187,25,11,148,218,245,148,35,19,3190,1807,1383,2249,1238,1011,580,861,1166,399,57,70,313,464,724,239,13,30,267,397,442,160,44,40,464,636,675,328,100,30,233,359,392,191,45,13,231,277,283,137,55,17,3070,1710,1360,2318,1260,1058,586,853,1025,434,75,74,279,465,628,264,27,27,307,388,397,170,48,47,469,645,684,370,98,29,239,358,388,202,46,16,230,287,296,168,52,13,2652,1653,999,2046,1264,782,306,767,1008,384,38,78,177,487,691,211,12,32,129,280,317,173,26,46,277,615,701,325,83,22,163,379,457,204,40,7,114,236,244,121,43,15,3251,1784,1467,2223,1276,947,407,889,1360,399,44,86,225,437,831,243,1,26,182,452,529,156,43,60,350,661,752,314,92,31,182,366,473,191,39,16,168,295,279,123,53,15,4958,2852,2106,3265,1906,1359,765,1309,1794,793,124,93,391,706,1072,533,55,34,374,603,722,260,69,59,508,990,1049,535,125,24,283,544,666,320,58,11,225,446,383,215,67,13,9210,5028,4182,3854,2190,1664,1197,1848,4268,1273,317,192,631,989,2400,731,141,67,566,859,1868,542,176,125,662,1203,1176,602,159,37,353,645,746,346,80,8,309,558,430,256,79,29,5455,2905,2550,2381,1330,1051,878,1147,2411,682,183,37,450,579,1369,374,79,-4,428,568,1042,308,104,41,537,779,709,268,42,-2,281,437,435,139,13,-1,256,342,274,129,29,-1,4093,1990,2103,1946,971,975,772,821,1589,565,181,83,382,347,868,252,59,18,390,474,721,313,122,65,410,500,608,256,119,33,200,239,342,123,43,14,210,261,266,133,76,19,-422,-703,281,-1156,-908,-248,-21,60,-119,-293,-102,15,-64,-66,-221,-301,-79,4,43,126,102,8,-23,11,-129,-22,-513,-380,-103,-33,-87,-53,-370,-336,-70,-10,-42,31,-143,-44,-33,-23,1758,746,1012,1204,608,596,259,394,616,253,133,90,138,112,284,95,83,28,121,282,332,158,50,62,185,307,377,211,79,24,99,144,206,104,33,12,86,163,171,107,46,12,408,142,266,595,273,322,-12,159,151,-69,66,108,-25,83,92,-42,7,37,13,76,59,-27,59,71,32,198,234,59,47,11,14,81,127,26,14,2,18,117,107,33,33,9,-15,-54,39,159,41,118,56,93,-87,-120,-49,86,25,29,-57,-57,-23,18,31,64,-30,-63,-26,68,45,107,48,-34,-22,-4,18,47,13,-28,-17,-4,27,60,35,-6,-5,0,-715,-560,-155,-438,-353,-85,-109,40,-418,-244,-70,87,-40,-24,-261,-197,-60,14,-69,64,-157,-47,-10,73,-37,64,-173,-196,-76,-34,-18,16,-140,-151,-47,-20,-19,48,-33,-45,-29,-14,44,-172,216,113,-21,134,-8,243,-99,-176,-18,95,-25,104,-80,-166,-38,28,17,139,-19,-10,20,67,51,129,14,-81,-24,3,26,70,-7,-84,-33,-4,25,59,21,3,9,7,-2599,-1717,-882,-3083,-1962,-1121,-437,168,-691,-1161,-404,-78,-217,58,-373,-836,-304,-42,-220,110,-318,-325,-100,-36,-408,-31,-848,-1219,-460,-140,-193,-50,-492,-860,-320,-59,-215,19,-356,-359,-140,-81,-1122,-657,-465,-1342,-831,-511,-258,288,-291,-712,-199,5,-114,139,-149,-408,-145,1,-144,149,-142,-304,-54,4,-165,127,-413,-623,-263,-33,-77,34,-211,-410,-169,-14,-88,93,-202,-213,-94,-19
28,28109,Pelayos de la Presa,1328,131,69,62,46,29,17,36,18,31,27,10,9,22,10,12,13,5,7,14,8,19,14,5,2,10,12,14,9,1,0,8,7,9,5,0,0,2,5,5,4,1,0,163,99,64,103,64,39,7,41,54,23,15,21,5,22,35,15,7,14,2,19,19,8,8,7,16,34,37,14,2,0,9,22,24,8,1,0,7,12,13,6,1,0,233,137,96,103,69,34,31,41,61,43,34,19,18,27,39,25,20,7,13,14,22,18,14,12,11,30,36,16,5,4,4,23,25,12,2,2,7,7,11,4,3,2,211,118,93,74,44,30,29,42,48,49,20,16,13,18,39,30,9,6,16,24,9,19,11,10,10,24,25,12,2,0,2,13,19,9,1,-1,8,11,6,3,1,1,62,25,37,46,28,18,17,-5,18,21,17,-5,10,0,0,9,8,-1,7,-5,18,12,9,-4,1,16,14,10,5,0,0,10,8,8,2,0,1,6,6,2,3,0,144,85,59,86,48,38,10,43,45,21,8,13,12,27,24,11,1,8,-2,16,21,10,7,5,16,37,22,10,1,0,11,24,11,2,0,0,5,13,11,8,1,0,134,49,85,81,39,42,35,26,29,15,8,23,18,14,14,0,3,3,17,12,15,15,5,20,24,20,20,15,1,1,11,7,14,4,2,1,13,13,6,11,-1,0,152,64,88,83,37,46,10,18,44,26,2,52,1,6,30,17,-1,11,9,12,14,9,3,41,15,27,26,8,4,2,4,14,14,2,2,0,11,13,12,6,2,2,139,63,76,78,42,36,25,19,24,18,3,52,14,6,13,11,0,20,11,13,11,7,3,32,28,15,19,14,0,2,15,8,10,8,0,1,13,7,9,6,0,1,49,29,20,30,8,22,7,10,3,5,3,18,3,7,4,3,-2,11,4,3,-1,2,5,7,5,14,10,1,1,-1,1,4,4,-1,0,0,4,10,6,2,1,-1,-57,-21,-36,-77,-42,-35,-14,-6,-46,-13,3,23,-3,-1,-21,-7,4,7,-11,-5,-25,-6,-1,16,-15,-7,-28,-21,-4,-2,-5,-6,-17,-11,-2,-1,-10,-1,-11,-10,-2,-1,72,36,36,6,7,-1,12,-10,7,14,6,43,6,-1,-2,15,5,14,6,-9,9,-1,1,29,2,-1,2,3,3,-3,4,3,1,0,1,-2,-2,-4,1,3,2,-1,-23,-2,-21,-20,-23,3,-11,-9,-16,-2,19,0,-7,-3,-6,4,11,1,-4,-6,-10,-6,8,-1,-2,-3,-12,-2,-3,2,-2,-3,-11,-3,-4,0,0,0,-1,1,1,2,-31,-25,-6,-20,-11,-9,-14,-5,2,-22,10,-2,-7,-15,4,-15,8,-2,-7,10,-2,-7,2,0,-5,-2,-7,-7,0,1,-2,-3,-3,-4,0,1,-3,1,-4,-3,0,0,-20,-33,13,-12,-15,3,-6,7,-19,-4,-10,10,-7,0,-14,-2,-11,0,1,7,-5,-2,1,10,-2,-1,-2,-4,-4,0,-4,0,-4,-2,-4,-1,2,-1,2,-2,0,1,35,18,17,14,5,9,8,-2,18,5,4,4,3,4,3,2,6,1,5,-6,15,3,-2,3,-1,4,7,0,3,2,-2,1,3,0,2,1,1,3,4,0,1,1,38,23,15,18,6,12,11,6,-5,12,10,3,6,7,3,4,2,1,5,-1,-8,8,8,2,2,4,6,5,2,-1,0,3,2,1,1,-1,2,1,4,4,1,0,54,30,24,32,14,18,5,6,20,2,16,4,10,3,8,-2,8,2,-5,3,12,4,8,2,1,8,12,5,4,2,2,1,7,1,2,1,-1,7,5,4,2,1
28,28110,Perales de Tajuña,2054,28,14,14,18,12,6,-1,7,10,3,9,-1,-4,5,7,3,4,-1,3,2,3,0,5,0,4,7,6,1,0,0,1,5,5,1,0,0,3,2,1,0,0,0,10,5,5,22,9,13,0,8,5,-6,0,3,2,5,2,-4,-1,1,-2,3,3,-2,1,2,8,6,6,2,0,0,4,2,3,0,0,0,4,4,3,2,0,0,118,67,51,85,43,42,27,25,32,25,8,-1,18,12,16,18,4,-2,9,13,16,7,4,1,22,21,23,13,6,0,13,9,12,7,2,0,9,12,11,6,4,0,118,76,42,72,38,34,16,26,48,11,10,3,8,13,33,10,9,0,8,13,15,1,1,3,9,25,26,9,2,1,2,14,16,4,1,1,7,11,10,5,1,0,82,55,27,59,32,27,3,26,39,8,1,1,7,18,25,0,2,0,-4,8,14,8,-1,1,5,18,24,12,0,0,3,13,13,4,-1,0,2,5,11,8,1,0,99,60,39,76,44,32,17,21,21,31,6,4,14,10,11,19,1,4,3,11,10,12,5,0,17,17,22,14,4,2,12,9,11,10,1,1,5,8,11,4,3,1,120,64,56,76,38,38,-1,33,54,15,12,8,-2,16,35,9,3,3,1,17,19,6,9,5,7,28,28,11,1,0,2,14,17,4,0,0,5,14,11,7,1,0,88,47,41,78,42,36,10,35,20,20,3,-3,6,15,11,11,5,-1,4,20,9,9,-2,-2,12,30,23,4,6,3,6,13,13,4,4,2,6,17,10,0,2,1,90,44,46,41,17,24,20,20,35,6,10,-4,12,6,21,-2,7,-1,8,14,14,8,3,-3,11,10,10,4,4,1,4,3,5,2,2,0,7,7,5,2,2,1,23,11,12,4,-6,10,6,6,24,1,-6,-7,-5,5,11,6,-5,-2,11,1,13,-5,-1,-5,3,7,-4,1,-3,1,-2,2,-3,0,-3,1,5,5,-1,1,0,0,-24,-7,-17,0,4,-4,0,-2,-1,-5,-3,-11,1,3,-3,-1,-2,-4,-1,-5,2,-4,-1,-7,-2,2,0,-2,2,0,0,3,1,-1,1,0,-2,-1,-1,-1,1,0,-5,3,-8,3,-1,4,1,-4,9,-5,8,-10,-2,1,4,-2,5,-2,3,-5,5,-3,3,-8,0,3,2,-1,2,-3,-2,2,0,0,1,-2,2,1,2,-1,1,-1,99,55,44,2,3,-1,28,9,25,23,11,2,15,7,21,8,5,-1,13,2,4,15,6,3,-2,2,-2,2,1,0,-1,3,1,0,0,0,-1,-1,-3,2,1,0,0,-2,2,17,7,10,8,-4,-11,-1,6,-5,10,-5,-7,-7,5,-3,-2,1,-4,6,1,-2,8,0,4,0,3,0,4,0,1,-1,2,0,4,0,3,1,1,0,-72,-45,-27,4,2,2,-34,2,-16,-22,7,-8,-21,1,-14,-12,2,-1,-13,1,-2,-10,5,-7,4,-1,1,0,1,-1,3,-1,2,-1,0,-1,1,0,-1,1,1,0,-6,5,-11,17,9,8,-16,1,-8,15,7,-4,-8,-1,0,12,1,1,-8,2,-8,3,6,-5,1,4,5,6,3,-2,-1,2,2,6,0,0,2,2,3,0,3,-2,-88,-52,-36,-102,-65,-37,1,-1,-14,-52,-14,-9,3,-2,-6,-38,-3,-7,-2,1,-8,-14,-11,-2,-8,-7,-20,-48,-17,-5,-2,-5,-12,-33,-9,-5,-6,-2,-8,-15,-8,0,-19,-8,-11,-33,-20,-13,-3,-2,-4,-9,2,0,-5,-2,1,3,-3,0,2,0,-5,-12,5,0,-8,0,-10,-11,-7,2,-5,-1,-5,-4,-5,0,-3,1,-5,-7,-2,2
28,28113,Pinto,27204,1128,616,512,306,164,142,148,199,506,156,62,43,86,78,298,97,37,14,62,121,208,59,25,29,56,82,83,65,15,5,33,41,47,36,6,1,23,41,36,29,9,4,1287,660,627,485,263,222,207,234,539,193,61,43,98,117,273,119,36,12,109,117,266,74,25,31,106,114,144,90,22,7,59,64,72,53,12,1,47,50,72,37,10,6,1142,547,595,436,229,207,160,232,505,131,56,47,76,105,270,55,23,14,84,127,235,76,33,33,87,129,111,71,31,6,46,69,66,34,9,4,41,60,45,37,22,2,1293,634,659,409,212,197,172,248,584,178,76,35,79,106,327,82,27,14,93,142,257,96,49,21,76,104,120,64,30,12,37,49,72,36,13,4,39,55,48,28,17,8,1866,960,906,437,253,184,235,278,885,295,94,70,106,149,471,169,39,26,129,129,414,126,55,44,67,105,139,87,23,12,31,67,89,54,7,4,36,38,50,33,16,8,1534,782,752,519,271,248,167,323,690,193,82,56,89,132,379,109,36,25,78,191,311,84,46,31,91,148,157,78,29,10,43,65,97,51,10,3,48,83,60,27,19,7,1307,664,643,677,362,315,173,269,594,158,52,45,101,140,297,74,21,19,72,129,297,84,31,26,128,184,199,113,43,7,63,104,115,60,16,3,65,80,84,53,27,4,1098,601,497,720,415,305,98,363,394,158,43,33,40,198,234,101,9,17,58,165,160,57,34,16,114,222,203,131,43,1,56,134,124,77,20,0,58,88,79,54,23,1,726,356,370,500,266,234,67,240,256,108,-6,55,29,105,142,69,-1,9,38,135,114,39,-5,46,109,117,156,83,22,7,53,55,89,54,11,1,56,62,67,29,11,6,702,295,407,347,145,202,84,140,355,81,-1,19,60,47,158,24,-9,6,24,93,197,57,8,13,75,80,108,51,20,4,34,30,51,16,7,1,41,50,57,35,13,3,663,294,369,108,25,83,37,133,385,13,35,39,5,56,212,5,1,10,32,77,173,8,34,29,22,41,41,-5,1,3,12,8,12,-8,-1,0,10,33,29,3,2,3,434,155,279,-245,-149,-96,-20,102,348,-34,-5,36,10,42,138,-44,-4,9,-30,60,210,10,-1,27,-54,14,-85,-94,-23,-8,-20,13,-70,-66,-8,-1,-34,1,-15,-28,-15,-7,214,68,146,70,25,45,-27,62,175,-30,21,19,-37,38,101,-31,3,-1,10,24,74,1,18,20,8,36,6,-3,7,9,3,19,2,-4,-2,2,5,17,4,1,9,7,96,40,56,-188,-122,-66,-25,41,102,-60,4,30,-21,3,74,-39,1,19,-4,38,28,-21,3,11,-33,0,-67,-73,-10,-7,-24,-5,-36,-50,-8,0,-9,5,-31,-23,-2,-7,823,377,446,150,82,68,99,123,398,95,34,67,34,42,211,45,18,25,65,81,187,50,16,42,20,38,67,3,6,13,13,18,36,7,0,6,7,20,31,-4,6,7,765,307,458,24,-14,38,103,152,236,145,46,71,14,73,100,76,22,16,89,79,136,69,24,55,17,58,-32,-26,-7,9,2,36,-29,-23,-6,2,15,22,-3,-3,-1,7,723,326,397,219,80,139,102,91,288,102,55,81,52,51,128,46,22,21,50,40,160,56,33,60,36,66,55,17,25,15,19,23,21,6,5,4,17,43,34,11,20,11,15,-86,101,-557,-347,-210,78,32,36,-126,-72,54,38,27,-5,-108,-66,20,40,5,41,-18,-6,34,-9,2,-159,-258,-95,-39,-14,9,-89,-174,-63,-16,5,-7,-70,-84,-32,-23
28,28115,Pozuelo de Alarcón,64778,1914,795,1119,1233,519,714,495,264,536,434,70,61,218,87,199,217,32,17,277,177,337,217,38,44,247,228,400,280,52,16,120,91,161,120,20,5,127,137,239,160,32,11,1602,646,956,1485,584,901,407,276,465,397,-39,68,206,76,172,183,-14,9,201,200,293,214,-25,59,270,324,470,337,54,23,132,114,183,117,22,11,138,210,287,220,32,12,1660,686,974,1374,537,837,636,188,309,434,-35,69,329,80,70,208,-40,3,307,108,239,226,5,66,314,298,380,259,72,37,153,110,145,84,24,16,161,188,235,175,48,21,1848,783,1065,1474,578,896,539,310,450,430,35,27,263,105,156,226,20,-4,276,205,294,204,15,31,297,350,440,281,69,25,137,118,175,108,27,8,160,232,265,173,42,17,1675,699,976,1452,520,932,421,276,303,489,63,65,237,112,74,222,23,8,184,164,229,267,40,57,184,329,452,354,87,33,86,96,156,130,28,16,98,233,296,224,59,17,1056,391,665,1257,437,820,305,274,144,278,-41,58,115,101,20,138,-23,19,190,173,124,140,-18,39,205,313,377,247,76,27,101,104,115,83,20,11,104,209,262,164,56,16,690,147,543,1162,393,769,338,163,-6,256,-115,24,145,43,-75,88,-55,-7,193,120,69,168,-60,31,217,321,317,249,39,6,103,84,107,79,17,1,114,237,210,170,22,5,685,225,460,1146,375,771,249,236,-44,156,-82,157,138,73,-66,71,-37,44,111,163,22,85,-45,113,164,326,365,237,33,1,71,101,97,76,22,-2,93,225,268,161,11,3,584,171,413,662,218,444,159,87,75,179,-34,113,49,30,-12,108,-26,23,110,57,87,71,-8,90,102,175,228,119,23,-3,40,42,67,57,5,-2,62,133,161,62,18,-1,-45,-141,96,3,-65,68,120,19,-94,-94,-83,52,88,-16,-101,-83,-60,1,32,35,7,-11,-23,51,24,46,24,-84,-21,-11,15,-11,-13,-56,-14,-4,9,57,37,-28,-7,-7,-171,-225,54,-249,-147,-102,116,-45,-203,27,-106,56,49,-41,-105,-27,-78,-15,67,-4,-98,54,-28,71,-25,-1,-97,-92,-33,-15,-2,-15,-39,-64,-25,-9,-23,14,-58,-28,-8,-6,465,165,300,131,31,100,285,64,-109,194,-19,76,140,-7,-51,110,-14,-5,145,71,-58,84,-5,81,73,77,-4,-5,-19,-5,43,8,1,-12,-18,0,30,69,-5,7,-1,-5,278,95,183,-189,-113,-76,317,-7,-183,150,-32,30,153,-26,-114,69,7,13,164,19,-69,81,-39,17,-10,29,-120,-69,-26,-9,-6,3,-64,-44,-6,-4,-4,26,-56,-25,-20,-5,-386,-282,-104,-196,-106,-90,64,-86,-287,-17,-110,44,-28,-20,-156,-6,-61,-17,92,-66,-131,-11,-49,61,24,16,-108,-85,-53,-6,-2,12,-54,-41,-27,-4,26,4,-54,-44,-26,-2,-98,-83,-15,-201,-153,-48,157,-33,-116,14,-164,34,89,-28,-73,-2,-56,-4,68,-5,-43,16,-108,38,-11,28,-61,-103,-62,-9,-15,0,-54,-59,-31,-4,4,28,-7,-44,-31,-5,215,71,144,12,-14,26,274,4,-158,121,-108,48,159,10,-102,55,-63,-1,115,-6,-56,66,-45,49,9,48,-26,-39,-18,13,27,15,-46,-18,-10,5,-18,33,20,-21,-8,8,470,191,279,286,93,193,346,-47,-66,246,-143,69,200,-47,-31,134,-87,-10,146,0,-35,112,-56,79,121,65,40,11,-1,24,71,14,18,-15,-15,6,50,51,22,26,14,18,573,214,359,379,139,240,335,49,-107,241,-53,60,195,28,-74,95,-33,-23,140,21,-33,146,-20,83,99,119,49,62,18,8,55,52,-5,14,11,-1,44,67,54,48,7,9
28,28119,Quijorna,1001,123,61,62,38,20,18,27,20,29,29,10,5,13,9,9,22,4,3,14,11,20,7,6,2,8,9,8,11,2,0,5,5,2,8,0,0,3,4,6,3,2,0,122,56,66,64,28,36,24,21,48,21,2,4,9,10,25,8,1,3,15,11,23,13,1,1,13,20,17,12,2,0,6,8,8,5,1,0,7,12,9,7,1,0,231,111,120,55,34,21,49,28,91,39,13,3,18,14,50,21,4,0,31,14,41,18,9,3,10,14,18,10,2,0,6,7,12,7,1,0,4,7,6,3,1,0,232,106,126,30,11,19,43,23,88,33,25,9,20,11,40,14,11,4,23,12,48,19,14,5,15,3,5,6,1,0,8,0,1,2,0,0,7,3,4,4,1,0,146,88,58,38,17,21,12,11,64,34,14,5,10,4,39,17,8,5,2,7,25,17,6,0,7,7,10,9,0,1,2,0,6,5,0,1,5,7,4,4,0,0,202,97,105,48,22,26,30,17,94,36,2,14,17,5,40,26,-1,5,13,12,54,10,3,9,7,8,19,9,0,2,2,5,7,6,0,0,5,3,12,3,0,2,189,85,104,33,17,16,30,19,84,12,12,15,14,8,34,5,5,10,16,11,50,7,7,5,5,6,10,4,0,0,2,3,4,2,0,0,3,3,6,2,0,0,211,89,122,53,19,34,33,23,71,25,26,16,11,9,34,13,15,2,22,14,37,12,11,14,16,15,13,5,1,1,7,4,6,2,0,0,9,11,7,3,1,1,46,24,22,0,-6,6,-4,6,28,14,2,-1,-4,2,17,9,1,-1,0,4,11,5,1,0,-5,5,2,1,-4,-2,-3,1,1,-4,-2,-1,-2,4,1,5,-2,-1,16,4,12,13,7,6,-11,0,13,-13,8,16,-10,1,9,-7,3,10,-1,-1,4,-6,5,6,7,3,4,-3,1,0,5,1,2,-2,1,0,2,2,2,-1,0,0,126,66,60,24,12,12,23,17,33,29,13,8,11,7,22,15,6,3,12,10,11,14,7,5,6,4,6,5,0,2,3,1,5,1,0,1,3,3,1,4,0,1,103,52,51,-13,-5,-8,25,11,34,10,10,2,15,1,17,7,3,1,10,10,17,3,7,1,0,1,0,-13,-4,0,0,-1,0,-6,-1,0,0,2,0,-7,-3,0,43,24,19,4,2,2,6,5,15,14,0,3,10,2,2,6,2,1,-4,3,13,8,-2,2,-2,3,4,1,-1,-1,0,3,1,0,-2,0,-2,0,3,1,1,-1,3,4,-1,-4,-1,-3,-10,4,3,-6,5,7,-1,4,2,-7,5,2,-9,0,1,1,0,5,3,0,1,-5,-2,-1,4,1,0,-4,-1,-1,-1,-1,1,-1,-1,0,-41,-36,-5,-22,-10,-12,-19,4,-15,-1,-13,5,-13,0,-3,-3,-10,-3,-6,4,-12,2,-3,8,-6,3,-7,-11,-2,1,-4,1,-1,-5,-1,0,-2,2,-6,-6,-1,1,32,22,10,-10,-9,-1,13,4,11,-5,2,8,5,1,9,-1,4,4,8,3,2,-4,-2,4,-3,4,-4,-6,0,-1,-3,2,-3,-5,0,0,0,2,-1,-1,0,-1,44,12,32,-7,-7,0,-4,12,16,-8,17,10,0,9,6,-13,5,3,-4,3,10,5,12,7,1,-1,-2,-8,2,1,0,0,-2,-6,0,1,1,-1,0,-2,2,0,50,22,28,17,10,7,12,11,10,22,-3,-2,5,4,5,12,-1,-2,7,7,5,10,-2,0,7,10,-5,0,5,0,5,9,-2,-3,2,-1,2,1,-3,3,3,1
28,28120,Rascafría,1621,39,19,20,38,25,13,0,5,14,11,3,5,-1,4,5,6,1,4,1,1,9,5,2,1,10,11,9,5,1,0,7,8,5,3,1,0,3,3,4,2,0,0,6,5,1,23,16,7,-3,-3,2,9,2,-2,-3,-1,3,6,0,0,0,-2,-1,3,2,-2,4,5,8,5,1,0,3,4,6,3,0,0,1,1,2,2,1,0,64,36,28,54,27,27,6,14,19,9,12,3,4,5,12,8,7,0,2,9,7,1,5,3,10,14,17,9,4,0,5,8,8,5,1,0,5,6,9,4,3,0,-26,-8,-18,32,19,13,6,-13,-15,-1,-1,-3,7,-5,-10,1,0,-1,-1,-8,-5,-2,-1,-2,16,6,7,3,0,0,8,5,4,2,0,0,8,1,3,1,0,0,-42,-16,-26,18,12,6,-12,-2,-3,-8,-12,-4,-6,1,0,-4,-5,-2,-6,-3,-3,-4,-7,-2,2,8,6,1,1,0,1,5,5,0,1,0,1,3,1,1,0,0,-67,-38,-29,18,7,11,-16,-8,-24,-9,-7,-3,-8,-2,-13,-8,-6,-1,-8,-6,-11,-1,-1,-2,3,6,6,2,0,0,1,4,2,0,0,0,2,2,4,2,0,0,145,78,67,180,97,83,29,25,33,44,9,4,9,15,19,29,5,0,20,10,14,15,4,4,35,45,55,35,6,2,10,27,31,24,3,1,25,18,24,11,3,1,43,24,19,127,60,67,2,26,18,0,3,-5,-1,12,12,1,3,-2,3,14,6,-1,0,-3,20,44,38,19,6,0,7,20,21,10,2,0,13,24,17,9,4,0,-33,-8,-25,34,22,12,-12,-1,-10,-10,7,-5,-6,2,-3,-1,3,-1,-6,-3,-7,-9,4,-4,3,6,9,11,4,1,2,4,5,8,3,0,1,2,4,3,1,1,20,21,-1,22,10,12,0,3,11,9,-7,0,0,3,8,8,-4,4,0,0,3,1,-3,-4,1,12,5,1,1,-1,-1,4,4,0,1,0,2,8,1,1,0,-1,8,10,-2,8,2,6,1,2,-9,0,13,-2,1,0,1,-1,8,-1,0,2,-10,1,5,-1,4,4,1,-2,1,0,0,1,2,-2,1,0,4,3,-1,0,0,0,-22,-16,-6,17,10,7,-5,3,-21,-5,1,5,-2,0,-14,-4,1,3,-3,3,-7,-1,0,2,4,8,0,2,3,0,2,6,0,0,2,0,2,2,0,2,1,0,-42,-20,-22,-2,-1,-1,-9,-6,-17,-3,-2,-6,-5,0,-15,2,0,-3,-4,-6,-2,-5,-2,-3,1,1,-1,-3,0,0,0,0,0,-1,0,0,1,1,-1,-2,0,0,-24,-17,-7,-6,-6,0,-13,2,0,-11,3,-7,-8,-2,1,-8,2,-3,-5,4,-1,-3,1,-4,-6,1,3,-3,-1,0,-4,1,0,-2,-1,0,-2,0,3,-1,0,0,-27,-7,-20,11,8,3,-7,-1,-6,-1,-9,-3,-5,1,1,1,-4,-1,-2,-2,-7,-2,-5,-2,0,6,2,3,0,0,0,4,2,2,0,0,0,2,0,1,0,0,-67,-40,-27,-59,-35,-24,1,-5,-10,-17,-27,-10,1,-2,-3,-14,-14,-9,0,-3,-7,-3,-13,-1,1,-8,-9,-14,-21,-8,0,-4,-3,-12,-12,-4,1,-4,-6,-2,-9,-4,-8,6,-14,-6,0,-6,0,-6,5,-2,-5,0,-2,-1,5,0,2,2,2,-5,0,-2,-7,-2,-1,-3,5,-3,-3,-1,-1,0,4,-1,-2,0,0,-3,1,-2,-1,-1,-10,-4,-6,-3,-3,0,-4,2,-5,-3,0,0,0,3,-4,-4,0,1,-4,-1,-1,1,0,-1,-1,3,-3,-2,0,0,-1,2,-3,-1,0,0,0,1,0,-1,0,0
28,28123,Rivas-Vaciamadrid,27422,1936,995,941,14,5,9,406,162,807,367,88,71,227,79,390,204,43,28,179,83,417,163,45,43,4,0,3,5,2,0,1,0,1,2,1,0,3,0,2,3,1,0,2299,1127,1172,11,5,6,504,194,904,517,68,83,262,83,423,278,37,29,242,111,481,239,31,54,1,3,0,4,3,0,1,0,0,2,2,0,0,3,0,2,1,0,2402,1240,1162,-10,-5,-5,581,203,830,533,111,102,313,102,430,270,60,41,268,101,400,263,51,61,1,-2,-5,-7,3,0,1,0,-3,-5,2,0,0,-2,-2,-2,1,0,4041,2043,1998,129,74,55,909,442,1490,828,188,116,479,240,732,425,93,43,430,202,758,403,95,73,12,33,42,23,10,9,7,22,22,13,5,5,5,11,20,10,5,4,3848,1929,1919,814,421,393,706,626,1450,723,139,143,368,307,728,392,51,55,338,319,722,331,88,88,109,266,273,123,30,9,59,138,148,62,9,2,50,128,125,61,21,7,3175,1614,1561,752,382,370,616,517,1097,636,165,93,302,265,559,335,85,47,314,252,538,301,80,46,105,229,231,120,49,10,44,117,126,64,23,5,61,112,105,56,26,5,5897,2896,3001,1002,511,491,1061,948,1572,1478,460,290,525,460,790,732,229,116,536,488,782,746,231,174,180,293,284,185,38,16,81,149,156,103,14,5,99,144,128,82,24,11,4438,2202,2236,1269,637,632,835,793,1688,728,208,133,419,378,859,381,95,45,416,415,829,347,113,88,175,424,346,228,66,20,90,213,186,115,17,11,85,211,160,113,49,9,2749,1337,1412,685,300,385,390,449,1156,436,94,170,205,191,591,233,39,53,185,258,565,203,55,117,124,193,205,102,38,14,47,75,110,43,14,6,77,118,95,59,24,8,1582,766,816,284,130,154,298,226,586,274,85,60,193,97,262,143,28,20,105,129,324,131,57,40,53,98,83,16,19,6,33,42,40,10,1,1,20,56,43,6,18,5,1266,607,659,320,120,200,274,154,465,222,12,73,168,74,215,99,-7,23,106,80,250,123,19,50,71,126,49,28,35,-5,33,53,12,3,15,-4,38,73,37,25,20,-1,1802,859,943,297,112,185,278,199,798,240,107,154,141,95,407,122,40,51,137,104,391,118,67,103,55,98,36,59,44,0,16,42,25,20,5,1,39,56,11,39,39,-1,1951,905,1046,-349,-229,-120,327,205,1001,288,-20,76,171,85,485,134,-2,6,156,120,516,154,-18,70,-47,10,-135,-108,-51,-22,-39,-1,-79,-81,-22,-9,-8,11,-56,-27,-29,-13,1558,758,800,-227,-132,-95,250,74,814,265,-6,113,139,25,416,125,1,40,111,49,398,140,-7,73,-26,2,-79,-64,-34,-32,-13,-4,-42,-47,-13,-15,-13,6,-37,-17,-21,-17,186,-17,203,-645,-410,-235,173,13,61,-77,-107,80,80,6,-29,-71,-63,39,93,7,90,-6,-44,41,-39,13,-262,-266,-77,-22,-16,6,-169,-186,-41,-8,-23,7,-93,-80,-36,-14,1199,528,671,248,111,137,319,84,378,242,7,105,179,28,174,117,-16,17,140,56,204,125,23,88,26,45,67,26,46,24,16,23,30,9,18,6,10,22,37,17,28,18,223,-19,242,-347,-237,-110,182,15,-36,-6,-66,86,71,36,-71,-52,-54,26,111,-21,35,46,-12,60,20,39,-172,-190,-51,-5,5,26,-112,-128,-33,1,15,13,-60,-62,-18,-6,1483,687,796,261,106,155,461,46,388,369,7,135,282,0,192,144,-11,47,179,46,196,225,18,88,68,76,53,17,18,16,43,42,36,-32,-3,12,25,34,17,49,21,4
28,28125,Robledo de Chavela,2180,58,45,13,43,25,18,2,9,10,19,10,6,6,10,9,11,3,4,-4,-1,1,8,7,2,5,9,14,13,1,1,4,4,9,7,0,1,1,5,5,6,1,0,185,91,94,85,46,39,30,28,56,53,16,2,13,17,27,27,8,-1,17,11,29,26,8,3,15,17,26,25,1,1,5,11,17,12,0,1,10,6,9,13,1,0,166,92,74,31,9,22,35,13,37,35,29,10,13,8,30,24,9,4,22,5,7,11,20,6,16,4,6,1,1,2,5,1,2,1,0,0,11,3,4,0,1,2,252,127,125,91,53,38,59,29,58,55,34,16,26,15,31,31,18,5,33,14,27,24,16,11,28,15,25,19,3,0,16,9,14,11,3,0,12,6,11,8,0,0,202,109,93,51,26,25,23,37,53,58,18,14,13,17,30,34,9,6,10,20,23,24,9,8,11,17,12,8,3,0,6,7,9,3,1,0,5,10,3,5,2,0,229,125,104,48,22,26,37,36,48,58,23,26,22,20,16,37,16,12,15,16,32,21,7,14,15,12,12,5,3,1,7,8,2,3,2,0,8,4,10,2,1,1,274,144,130,50,26,24,57,31,100,56,8,17,21,24,51,34,8,3,36,7,49,22,0,14,13,16,14,9,-3,0,3,8,8,5,0,1,10,8,6,4,-3,-1,127,63,64,16,6,10,7,1,26,30,22,37,-7,-2,11,26,16,17,14,3,15,4,6,20,9,2,4,3,-2,0,6,1,0,0,-1,0,3,1,4,3,-1,0,114,51,63,37,15,22,8,14,34,21,2,31,5,10,17,15,-1,5,3,4,17,6,3,26,7,13,12,4,0,0,3,5,6,2,0,-1,4,8,6,2,0,1,44,28,16,7,8,-1,3,5,14,10,10,7,10,-1,7,9,5,0,-7,6,7,1,5,7,4,0,7,0,0,-1,7,-1,4,-1,0,0,-3,1,3,1,0,-1,109,70,39,1,1,0,36,10,7,24,9,27,24,2,8,9,10,18,12,8,-1,15,-1,9,-3,2,-3,1,0,4,0,0,0,-1,-1,3,-3,2,-3,2,1,1,18,30,-12,-7,-1,-6,5,-18,1,2,11,15,10,-1,3,0,8,8,-5,-17,-2,2,3,7,-4,0,2,-3,1,-3,0,2,1,-2,1,-3,-4,-2,1,-1,0,0,99,59,40,8,5,3,20,-3,10,18,10,48,18,-1,6,8,4,22,2,-2,4,10,6,26,3,1,4,2,-4,2,1,0,1,1,-1,3,2,1,3,1,-3,-1,32,33,-1,0,1,-1,8,-14,-8,0,23,24,10,-5,-5,2,18,13,-2,-9,-3,-2,5,11,2,1,0,-1,0,-2,2,1,0,-1,0,-1,0,0,0,0,0,-1,-21,-11,-10,-4,1,-5,-16,-6,-17,-6,6,17,-1,1,-9,-8,2,6,-15,-7,-8,2,4,11,0,0,1,-2,0,-3,0,0,0,1,0,0,0,0,1,-3,0,-3,53,9,44,-34,-22,-12,33,-11,3,4,10,8,14,-11,-3,-3,8,2,19,0,6,7,2,6,-1,-7,-6,-13,-5,-2,-1,-6,-4,-6,-4,-1,0,-1,-2,-7,-1,-1,105,55,50,17,12,5,32,-8,42,10,13,20,12,-7,17,13,11,9,20,-1,25,-3,2,11,6,2,2,5,0,2,4,3,0,5,0,0,2,-1,2,0,0,2,93,46,47,-2,-9,7,17,3,18,28,7,18,12,-6,10,19,1,8,5,9,8,9,6,10,-2,-1,-1,1,-4,3,-3,0,-3,-1,-6,2,1,-1,2,2,2,1
28,28127,"Rozas de Madrid, Las",51650,4582,2149,2433,1400,571,829,869,518,1883,786,202,232,493,218,876,353,84,70,376,300,1007,433,118,162,264,289,479,285,51,22,145,102,186,114,17,4,119,187,293,171,34,18,3099,1404,1695,1291,545,746,555,295,1504,426,73,207,297,126,694,203,10,51,258,169,810,223,63,156,230,275,414,268,64,28,124,108,167,103,27,9,106,167,247,165,37,19,2494,1140,1354,1180,494,686,466,297,973,428,92,165,222,124,443,227,44,43,244,173,530,201,48,122,256,222,354,236,57,40,128,81,139,97,27,14,128,141,215,139,30,26,1575,666,909,995,378,617,192,213,638,240,20,257,98,90,279,121,-2,69,94,123,359,119,22,188,162,222,304,206,66,30,71,85,119,74,20,9,91,137,185,132,46,21,3301,1531,1770,1039,369,670,518,304,1534,600,87,200,290,116,714,282,27,79,228,188,820,318,60,121,126,256,333,225,71,19,65,78,119,74,26,3,61,178,214,151,45,16,2481,1129,1352,1112,452,660,387,256,1101,501,87,108,189,99,520,248,35,11,198,157,581,253,52,97,162,254,348,234,80,27,79,81,145,100,37,8,83,173,203,134,43,19,2692,1253,1439,1450,524,926,458,368,1119,425,-15,285,235,163,535,215,-30,100,223,205,584,210,15,185,206,342,479,297,84,35,93,114,167,107,27,12,113,228,312,190,57,23,2041,862,1179,1413,526,887,335,316,778,361,-8,226,157,98,362,167,-5,68,178,218,416,194,-3,158,203,370,457,267,76,33,106,124,166,82,33,10,97,246,291,185,43,23,1163,564,599,678,280,398,160,213,417,156,-28,232,118,97,187,74,-10,91,42,116,230,82,-18,141,45,196,285,133,-5,15,43,69,113,44,-2,10,2,127,172,89,-3,5,694,305,389,240,52,188,128,100,365,-63,-64,190,94,20,192,-12,-44,36,34,80,173,-51,-20,154,50,133,102,-15,-25,-8,33,34,23,-28,-13,2,17,99,79,13,-12,-10,428,206,222,-476,-251,-225,13,-26,293,-48,-125,271,23,-30,158,0,-38,66,-10,4,135,-48,-87,205,-100,16,-130,-176,-75,-21,-43,-17,-61,-92,-34,-9,-57,33,-69,-84,-41,-12,641,256,385,68,-44,112,37,58,271,-53,-55,333,47,22,100,-24,-18,107,-10,36,171,-29,-37,226,3,94,-1,-50,18,-4,-2,23,-20,-44,4,-7,5,71,19,-6,14,3,815,312,503,89,5,84,57,84,247,36,40,324,17,26,119,19,28,98,40,58,128,17,12,226,13,61,0,-10,14,8,3,16,-1,-14,0,4,10,45,1,4,14,4,395,136,259,-262,-187,-75,166,-26,84,-84,-42,242,97,-33,28,-55,-21,92,69,7,56,-29,-21,150,19,-3,-129,-119,-29,-13,4,-19,-77,-86,-9,-5,15,16,-52,-33,-20,-8,280,98,182,-192,-111,-81,142,39,8,-11,-122,206,56,45,15,-36,-91,91,86,-6,-7,25,-31,115,10,67,-137,-124,-18,-3,0,36,-53,-90,-15,4,10,31,-84,-34,-3,-7,846,372,474,316,117,199,95,41,294,131,-19,278,62,-1,145,81,-7,81,33,42,149,50,-12,197,26,97,102,25,39,21,26,27,40,6,2,13,0,70,62,19,37,8,808,282,526,515,204,311,209,83,207,51,-47,277,86,23,88,15,-24,70,123,60,119,36,-23,207,97,123,136,64,54,21,53,39,57,22,16,4,44,84,79,42,38,17,296,108,188,504,185,319,92,75,51,-153,-38,266,39,33,26,-72,-14,95,53,42,25,-81,-24,171,115,128,131,12,58,43,52,43,50,-13,26,22,63,85,81,25,32,21
28,28129,San Agustín del Guadalix,5673,359,177,182,180,86,94,63,75,131,73,-4,10,38,28,64,42,-3,3,25,47,67,31,-1,7,25,46,63,34,6,3,16,19,29,19,2,0,9,27,34,15,4,3,398,194,204,231,108,123,55,62,177,84,12,5,27,33,83,40,9,-1,28,29,94,44,3,6,35,51,83,48,10,2,21,22,35,23,6,1,14,29,48,25,4,1,360,174,186,228,106,122,53,78,168,32,18,11,25,36,94,14,6,1,28,42,74,18,12,10,44,68,63,37,9,5,24,30,30,18,3,0,20,38,33,19,6,5,231,121,110,174,74,100,-3,52,147,2,23,10,1,13,90,5,11,2,-4,39,57,-3,12,8,23,54,56,32,8,1,13,20,27,13,1,0,10,34,29,19,7,1,323,193,130,177,90,87,27,58,153,45,15,15,22,33,90,30,6,10,5,25,63,15,9,5,12,52,72,30,6,2,6,30,36,15,2,1,6,22,36,15,4,1,567,320,247,208,100,108,129,69,220,93,28,18,75,37,128,57,9,8,54,32,92,36,19,10,34,61,69,32,9,3,13,33,33,18,2,1,21,28,36,14,7,2,599,331,268,340,166,174,149,106,199,113,4,18,88,54,109,55,7,10,61,52,90,58,-3,8,63,105,96,62,10,3,29,47,55,27,5,2,34,58,41,35,5,1,803,437,366,499,277,222,177,142,233,155,40,40,105,73,129,87,19,17,72,69,104,68,21,23,82,135,149,99,25,6,48,75,85,53,13,2,34,60,64,46,12,4,620,312,308,286,134,152,138,63,178,167,36,25,64,37,84,89,21,8,74,26,94,78,15,17,50,67,92,49,20,4,33,32,40,15,9,2,17,35,52,34,11,2,636,318,318,195,92,103,101,98,226,167,20,25,49,44,110,91,13,6,52,54,116,76,7,19,36,61,45,42,6,4,22,24,23,17,3,3,14,37,22,25,3,1,426,216,210,117,58,59,99,19,153,92,35,21,55,15,71,50,17,5,44,4,82,42,18,16,17,32,47,15,6,0,11,10,27,6,3,1,6,22,20,9,3,-1,252,120,132,99,44,55,55,21,88,55,12,18,24,18,24,45,4,5,31,3,64,10,8,13,14,26,31,19,6,1,3,12,10,14,4,0,11,14,21,5,2,1,133,66,67,80,33,47,54,9,-6,62,-7,14,34,1,-14,38,0,3,20,8,8,24,-7,11,14,29,10,13,12,2,9,5,1,11,6,1,5,24,9,2,6,1,122,51,71,44,20,24,56,-30,16,57,-1,21,31,-7,12,8,0,9,25,-23,4,49,-1,12,8,10,12,0,10,2,3,7,8,-1,2,-1,5,3,4,1,8,3,106,40,66,59,24,35,46,2,-5,35,11,17,12,9,-14,28,1,-3,34,-7,9,7,10,20,7,17,16,7,5,3,-1,8,9,4,0,0,8,9,7,3,5,3,82,31,51,67,36,31,27,-12,32,0,-7,32,25,-3,4,-3,-7,11,2,-9,28,3,0,21,17,14,20,7,3,4,12,7,9,6,0,1,5,7,11,1,3,3,208,94,114,111,47,64,92,-3,56,48,-18,29,31,-7,21,36,-7,17,61,4,35,12,-11,12,36,14,25,18,10,6,15,5,9,9,5,4,21,9,16,9,5,2,205,78,127,122,51,71,69,18,28,37,6,41,39,10,8,7,3,9,30,8,20,30,3,32,29,25,34,21,8,2,14,15,13,6,2,0,15,10,21,15,6,2
28,28130,San Fernando de Henares,32144,195,106,89,23,13,10,-65,88,149,-15,-5,44,-29,35,94,-4,-8,13,-36,53,55,-11,3,31,7,4,3,4,1,3,5,4,1,1,1,1,2,0,2,3,0,2,336,133,203,17,9,8,17,114,139,-15,39,51,-6,60,68,-22,14,25,23,54,71,7,25,26,6,1,4,4,0,1,2,1,2,3,0,1,4,0,2,1,0,0,1212,620,592,1018,526,492,147,391,462,108,52,43,58,192,267,57,29,14,89,199,195,51,23,29,185,288,351,155,31,4,85,142,195,84,17,1,100,146,156,71,14,3,512,289,223,1081,556,525,-57,308,232,-19,34,30,-20,140,171,-14,11,11,-37,168,61,-5,23,19,139,359,390,139,47,5,71,168,226,69,19,2,68,191,164,70,28,3,245,91,154,1012,552,460,-87,219,188,-75,-25,23,-43,107,100,-52,-24,4,-44,112,88,-23,-1,19,118,328,373,155,26,11,68,181,205,86,8,4,50,147,168,69,18,7,-190,-110,-80,715,396,319,-101,64,-100,-104,-14,73,-28,31,-42,-76,-14,22,-73,33,-58,-28,0,51,113,214,228,122,34,1,72,108,131,66,17,-1,41,106,97,56,17,2,49,1,48,1016,533,483,-63,144,-25,-47,-14,55,-21,80,-31,-40,-9,21,-42,64,6,-7,-5,34,147,315,321,176,36,15,79,155,174,97,19,7,68,160,147,79,17,8,547,284,263,1132,648,484,-31,289,195,8,-13,104,-41,149,114,27,-7,44,10,140,81,-19,-6,60,147,353,359,211,49,13,74,191,221,131,26,6,73,162,138,80,23,7,111,-13,124,324,151,173,-31,99,6,-36,-3,65,-8,33,-1,-55,-5,18,-23,66,7,19,2,47,44,101,89,68,14,5,20,52,46,25,5,0,24,49,43,43,9,5,265,78,187,301,114,187,-6,150,48,10,-3,52,-27,54,48,-2,-11,10,21,96,0,12,8,42,44,111,63,39,33,7,19,43,25,10,13,1,25,68,38,29,20,6,-190,-120,-70,203,63,140,-30,51,-128,-54,-44,18,-4,22,-56,-39,-29,-7,-26,29,-72,-15,-15,25,42,106,18,34,6,-11,22,45,1,0,-2,-7,20,61,17,34,8,-4,-208,-185,-23,35,-25,60,-29,32,-112,-86,-50,33,-20,33,-92,-79,-34,1,-9,-1,-20,-7,-16,32,6,84,-41,-10,-6,-5,5,39,-35,-22,-12,-4,1,45,-6,12,6,-1,-276,-236,-40,-267,-195,-72,36,17,-205,-125,-50,44,0,7,-128,-98,-32,15,36,10,-77,-27,-18,29,-3,10,-148,-74,-45,-8,1,-1,-100,-69,-23,-5,-4,11,-48,-5,-22,-3,-380,-279,-101,-240,-153,-87,-15,-9,-199,-113,-97,36,-12,-28,-137,-83,-42,14,-3,19,-62,-30,-55,22,-15,5,-116,-82,-35,-1,-6,0,-81,-48,-19,0,-9,5,-35,-34,-16,-1,-654,-349,-305,-552,-341,-211,-92,-55,-188,-263,-86,18,-39,-14,-95,-163,-56,11,-53,-41,-93,-100,-30,7,-28,-26,-199,-188,-99,-15,-16,-13,-116,-132,-58,-7,-12,-13,-83,-56,-41,-8,19,-43,62,75,12,63,18,0,-24,-30,8,26,10,-6,-28,-25,-4,-1,8,6,4,-5,12,27,24,27,0,12,4,-1,15,3,-9,2,-3,-2,9,24,9,10,7,1,-577,-374,-203,-329,-191,-138,-70,-42,-181,-207,-75,-3,-59,-20,-123,-124,-38,-8,-11,-22,-58,-83,-37,5,-38,0,-110,-129,-45,-7,-28,2,-64,-73,-27,-2,-10,-2,-46,-56,-18,-5,-260,-190,-70,-102,-80,-22,-22,32,-116,-126,-69,29,-7,10,-78,-85,-45,10,-15,22,-38,-41,-24,19,8,34,-46,-64,-31,-8,-5,15,-26,-47,-16,-4,13,19,-20,-17,-15,-4
28,28131,San Lorenzo de El Escorial,11350,674,322,352,273,144,129,147,86,204,153,61,33,79,50,82,77,31,7,68,36,122,76,30,26,57,53,98,48,12,5,32,28,53,22,7,2,25,25,45,26,5,3,650,326,324,310,170,140,176,70,205,148,38,4,98,39,78,76,27,5,78,31,127,72,11,-1,61,66,89,73,14,4,39,39,41,38,9,2,22,27,48,35,5,2,674,322,352,324,144,180,142,88,223,128,75,17,60,31,116,73,26,12,82,57,107,55,49,5,76,70,98,56,19,2,32,29,51,24,4,1,44,41,47,32,15,1,758,382,376,323,164,159,170,85,248,157,82,22,79,38,129,91,36,11,91,47,119,66,46,11,61,72,91,52,31,16,30,38,47,34,9,7,31,34,44,18,22,9,362,151,211,222,104,118,82,58,80,80,25,39,45,17,30,34,14,11,37,41,50,46,11,28,32,51,65,38,25,9,11,29,30,19,11,4,21,22,35,19,14,5,463,199,264,216,99,117,113,61,131,99,39,15,66,24,41,44,18,3,47,37,90,55,21,12,36,43,54,46,23,11,19,21,22,25,8,3,17,22,32,21,15,8,591,290,301,276,129,147,140,70,220,68,50,38,87,20,125,31,22,1,53,50,95,37,28,37,71,71,83,42,6,0,43,28,35,21,0,0,28,43,48,21,6,0,519,234,285,309,150,159,82,94,145,121,39,26,34,42,89,45,14,4,48,52,56,76,25,22,54,90,71,58,30,4,22,48,39,25,12,3,32,42,32,33,18,1,316,113,203,182,70,112,60,69,94,34,8,64,47,24,28,4,2,13,13,45,66,30,6,51,46,48,59,23,5,0,25,21,18,6,1,-2,21,27,41,17,4,2,163,51,112,7,2,5,51,58,36,1,-7,18,13,25,12,-6,-10,12,38,33,24,7,3,6,3,27,15,-22,-7,-12,3,11,12,-20,-6,-1,0,16,3,-2,-1,-11,-26,0,-26,-68,-39,-29,6,15,-23,-6,-49,30,7,14,-7,0,-27,11,-1,1,-16,-6,-22,19,-3,7,-15,-24,-19,-16,-3,6,-11,-19,-8,-6,0,1,-4,-5,-11,-10,105,53,52,63,22,41,11,10,7,32,11,37,-20,13,2,27,15,18,31,-3,5,5,-4,19,2,23,26,15,2,-4,-2,9,5,10,1,-1,4,14,21,5,1,-3,-105,-60,-45,-34,-20,-14,-61,9,-46,-43,-1,44,-45,23,-18,-30,-5,20,-16,-14,-28,-13,4,24,-24,19,-5,-15,-11,2,-13,18,-11,-10,-7,3,-11,1,6,-5,-4,-1,-141,-58,-83,-48,-20,-28,-23,-16,-23,-65,-40,22,3,-11,2,-26,-35,11,-26,-5,-25,-39,-5,11,-2,3,-16,-23,-14,1,6,0,-4,-15,-9,0,-8,3,-12,-8,-5,1,17,-34,51,43,30,13,15,5,-26,1,-13,44,3,-17,-16,-3,-2,7,12,22,-10,4,-11,37,6,20,22,-4,0,1,4,6,17,3,-1,2,2,14,5,-7,1,-1,7,14,-7,-1,-20,19,10,-7,-19,37,-20,13,10,4,-17,24,-3,-1,0,-11,-2,13,-17,14,6,14,-4,4,-11,-10,1,3,-10,1,-9,-6,5,11,6,3,-2,-4,53,26,27,44,15,29,-26,7,-6,10,13,55,-9,2,-8,10,11,18,-17,5,2,0,2,37,4,14,1,7,13,3,-1,10,-3,1,7,0,5,4,4,6,6,3,73,17,56,111,57,54,27,2,-6,-10,5,54,17,3,2,-30,1,20,10,-1,-8,20,4,34,19,29,26,21,6,7,7,15,20,6,5,2,12,14,6,15,1,5
28,28132,San Martín de la Vega,10060,617,415,202,402,277,125,68,159,244,97,27,18,66,85,172,66,15,9,2,74,72,31,12,9,47,88,180,72,9,3,33,58,128,50,6,1,14,30,52,22,3,2,794,438,356,538,312,226,66,245,341,98,19,23,27,143,195,55,7,5,39,102,146,43,12,18,86,155,199,72,20,3,40,96,119,45,9,0,46,59,80,27,11,3,858,500,358,702,410,292,122,268,252,128,61,24,66,153,150,88,29,13,56,115,102,40,32,11,112,221,228,110,25,3,63,128,132,72,11,2,49,93,96,38,14,1,628,351,277,595,331,264,58,195,229,94,7,31,29,99,154,54,-5,12,29,96,75,40,12,19,85,178,204,87,28,13,40,92,135,49,7,8,45,86,69,38,21,5,919,532,387,697,390,307,138,263,321,118,42,24,80,154,189,71,19,10,58,109,132,47,23,14,93,211,237,117,28,8,45,118,140,69,15,2,48,93,97,48,13,6,700,372,328,569,309,260,70,175,307,62,57,15,31,105,181,25,22,2,39,70,126,37,35,13,108,176,158,84,32,3,46,104,93,48,15,0,62,72,65,36,17,3,840,449,391,592,329,263,145,237,357,58,20,-1,87,123,210,17,3,2,58,114,147,41,17,-3,114,195,185,80,9,4,71,113,109,30,3,1,43,82,76,50,6,3,1375,786,589,1000,562,438,241,292,521,237,47,17,139,141,312,164,13,8,102,151,209,73,34,9,180,270,310,168,52,12,100,137,193,106,19,3,80,133,117,62,33,9,404,171,233,227,99,128,31,77,164,57,47,24,-1,38,65,29,25,11,32,39,99,28,22,13,26,72,80,22,23,1,11,26,43,6,11,1,15,46,37,16,12,0,344,137,207,157,59,98,67,74,105,18,35,30,46,23,28,15,13,10,21,51,77,3,22,20,53,49,23,9,9,12,39,10,0,4,1,5,14,39,23,5,8,7,439,243,196,249,131,118,80,65,204,67,-3,7,62,21,100,40,3,4,18,44,104,27,-6,3,43,68,73,39,14,6,25,30,42,24,6,1,18,38,31,15,8,5,-93,-39,-54,-183,-114,-69,-31,18,-82,-1,6,-14,-20,12,-46,1,10,-2,-11,6,-36,-2,-4,-12,-39,11,-107,-37,2,-16,-23,7,-64,-28,-1,-6,-16,4,-43,-9,3,-10,-3,-9,6,-41,-44,3,-23,13,-19,19,-15,7,-4,6,-26,7,-7,7,-19,7,7,12,-8,0,-2,11,-29,-11,-16,3,-2,3,-21,-15,-10,0,0,8,-8,4,-6,3,-371,-214,-157,-247,-162,-85,-51,-43,-109,-145,-22,-11,-26,-31,-53,-89,-17,-5,-25,-12,-56,-56,-5,-6,-23,-27,-77,-99,-15,-6,-9,-21,-50,-69,-12,-1,-14,-6,-27,-30,-3,-5,-49,6,-55,-156,-85,-71,1,3,-35,-27,-11,23,12,0,-8,-3,-8,10,-11,3,-27,-24,-3,13,-22,-1,-58,-45,-26,-2,-4,-1,-33,-32,-14,-1,-18,0,-25,-13,-12,-1,-139,-95,-44,-188,-123,-65,-32,6,-74,-79,-21,43,-16,2,-48,-41,-15,12,-16,4,-26,-38,-6,31,-31,-3,-66,-76,-17,0,-22,-2,-44,-47,-12,0,-9,-1,-22,-29,-5,0,-247,-152,-95,-282,-160,-122,-55,-9,-56,-80,-64,4,-36,-9,-26,-55,-36,5,-19,0,-30,-25,-28,-1,-30,-11,-73,-81,-72,-18,-11,-5,-42,-62,-34,-7,-19,-6,-31,-19,-38,-11,-205,-126,-79,-260,-177,-83,7,17,-32,-174,-45,12,4,13,-1,-119,-30,5,3,4,-31,-55,-15,7,4,2,-55,-147,-43,-22,-8,0,-26,-102,-33,-9,12,2,-29,-45,-10,-13
28,28133,San Martín de Valdeiglesias,6034,85,41,44,37,12,25,0,23,14,12,8,24,-3,12,8,6,3,13,3,11,6,6,5,11,5,7,16,6,3,0,0,2,7,2,1,0,5,5,9,4,2,0,139,83,56,64,36,28,16,15,55,24,15,14,14,10,35,14,8,2,2,5,20,10,7,12,10,14,24,11,4,1,5,7,15,6,3,0,5,7,9,5,1,1,180,102,78,70,38,32,60,11,61,16,11,18,39,5,28,7,6,15,21,6,33,9,5,3,19,11,21,10,4,5,9,8,12,4,3,2,10,3,9,6,1,3,228,116,112,71,34,37,58,39,59,33,28,8,22,24,26,23,13,6,36,15,33,10,15,2,17,20,17,6,7,4,8,9,8,4,4,1,9,11,9,2,3,3,268,142,126,71,35,36,49,47,79,39,26,25,23,22,53,11,14,14,26,25,26,28,12,11,16,17,21,11,3,2,5,9,15,3,1,1,11,8,6,8,2,1,345,177,168,123,61,62,78,59,103,55,35,11,48,25,50,32,17,3,30,34,53,23,18,8,26,38,33,16,10,-1,13,18,19,7,4,-1,13,20,14,9,6,0,240,111,129,81,35,46,77,28,71,40,0,22,28,12,36,23,3,10,49,16,35,17,-3,12,23,19,25,9,2,3,7,9,14,2,1,2,16,10,11,7,1,1,262,127,135,110,58,52,40,31,74,46,22,44,10,23,32,29,12,19,30,8,42,17,10,25,17,34,27,18,9,1,6,24,9,12,6,-1,11,10,18,6,3,2,149,101,48,82,39,43,8,41,23,41,1,33,10,18,22,30,3,17,-2,23,1,11,-2,16,18,26,21,16,1,0,9,8,14,7,1,0,9,18,7,9,0,0,135,47,88,-30,-28,-2,-11,-1,-13,13,17,135,-13,-1,-6,7,6,57,2,0,-7,6,11,78,0,2,-8,-18,-1,-5,-5,-2,-8,-13,0,0,5,4,0,-5,-1,-5,63,29,34,-8,-4,-4,18,-13,1,-7,13,52,18,-14,-3,-2,16,17,0,1,4,-5,-3,35,5,-2,-13,0,1,1,7,-3,-8,-2,1,1,-2,1,-5,2,0,0,164,68,96,12,5,7,25,5,18,24,19,68,16,-8,13,9,11,23,9,13,5,15,8,45,5,4,-2,-3,7,1,5,4,-2,-4,3,-1,0,0,0,1,4,2,162,73,89,4,2,2,40,-2,18,32,26,49,21,-7,16,17,11,16,19,5,2,15,15,33,-3,1,3,1,3,-1,-3,0,3,-1,3,0,0,1,0,2,0,-1,52,12,40,-17,-16,-1,0,-12,-9,5,-7,77,-5,-10,-5,1,-1,34,5,-2,-4,4,-6,43,-2,-4,-5,-2,-5,1,-3,-4,-5,-1,-4,1,1,0,0,-1,-1,0,-39,3,-42,-27,-16,-11,-25,-22,1,-27,8,26,-11,-4,3,-3,10,10,-14,-18,-2,-24,-2,16,-6,-4,-7,-7,-3,-1,-5,-1,-4,-3,-3,0,-1,-3,-3,-4,0,-1,-47,-23,-24,-6,-14,8,-28,-13,-16,-21,13,16,-12,-5,-12,-7,2,10,-16,-8,-4,-14,11,6,5,-3,-6,1,0,-3,2,-6,-5,-1,-2,-2,3,3,-1,2,2,-1,31,7,24,28,11,17,-6,-6,-14,16,8,34,-2,-6,1,3,4,10,-4,0,-15,13,4,24,6,3,13,1,3,1,2,4,7,-4,1,1,4,-1,6,5,2,0,-1,-34,33,-49,-29,-20,8,3,-17,-15,-9,30,1,-1,-14,-15,-12,10,7,4,-3,0,3,20,0,14,-5,-37,-20,-2,-1,9,1,-24,-13,-1,1,5,-6,-13,-7,-1
28,28134,San Sebastián de los Reyes,58215,-579,-272,-307,33,18,15,-204,-102,-71,-140,-74,21,-103,-47,-19,-69,-41,6,-101,-55,-52,-71,-33,15,9,1,10,9,3,1,6,1,5,5,1,0,3,0,5,4,2,1,-642,-317,-325,24,11,13,-218,-30,-198,-169,-62,37,-98,-1,-89,-100,-39,8,-120,-29,-109,-69,-23,29,5,6,5,3,4,1,2,4,1,1,2,1,3,2,4,2,2,0,-443,-136,-307,-8,6,-14,-82,-105,-120,-80,-57,4,-26,-9,-52,-19,-31,4,-56,-96,-68,-61,-26,0,13,-9,-17,8,-5,1,8,-2,-6,8,-3,0,5,-7,-11,0,-2,1,-68,-49,-19,451,217,234,-35,28,43,-59,-73,37,-6,20,30,-57,-53,11,-29,8,13,-2,-20,26,110,107,134,63,25,10,58,58,66,27,4,4,52,49,68,36,21,6,471,104,367,752,324,428,96,79,244,164,-104,-21,26,35,51,71,-67,-20,70,44,193,93,-37,-1,109,168,270,156,39,6,52,67,113,70,19,1,57,101,157,86,20,5,857,325,532,968,426,542,77,312,330,124,-62,74,44,163,119,31,-55,21,33,149,211,93,-7,53,167,257,284,200,44,15,95,115,118,73,19,6,72,142,166,127,25,9,1992,874,1118,1268,558,710,369,362,860,364,-45,62,163,138,409,185,-43,8,206,224,451,179,-2,54,228,304,403,239,71,17,103,114,198,116,17,7,125,190,205,123,54,10,3547,1639,1908,1608,779,829,540,631,1471,577,86,192,298,270,688,281,25,46,242,361,783,296,61,146,285,421,488,317,71,14,147,176,231,170,44,5,138,245,257,147,27,9,2993,1363,1630,1242,567,675,530,586,1247,471,65,57,251,277,596,199,14,19,279,309,651,272,51,38,247,338,373,217,54,3,113,157,178,91,28,-3,134,181,195,126,26,6,1652,676,976,360,98,262,344,312,682,249,-34,74,176,143,265,100,-28,10,168,169,417,149,-6,64,91,142,121,14,-15,4,45,64,19,-12,-19,-1,46,78,102,26,4,5,1481,732,749,498,201,297,283,264,498,344,32,39,191,122,229,184,-11,7,92,142,269,160,43,32,69,173,123,92,23,8,39,58,46,48,1,5,30,115,77,44,22,3,1088,405,683,235,60,175,89,259,426,156,51,101,18,67,228,34,26,32,71,192,198,122,25,69,25,120,40,16,17,3,9,28,4,-2,14,1,16,92,36,18,3,2,815,363,452,199,74,125,149,117,384,98,-2,73,50,44,183,75,-17,28,99,73,201,23,15,45,53,90,14,5,23,9,25,43,-14,6,6,6,28,47,28,-1,17,3,757,457,300,38,17,21,156,115,257,215,9,-6,112,48,184,111,4,-11,44,67,73,104,5,5,15,55,-26,-11,-5,5,13,23,-6,-10,-6,0,2,32,-20,-1,1,5,751,358,393,254,126,128,101,162,240,130,17,64,83,75,119,51,8,6,18,87,121,79,9,58,42,81,29,23,39,29,31,47,10,11,19,2,11,34,19,12,20,27,963,432,531,349,150,199,281,179,172,171,47,85,172,82,59,72,10,20,109,97,113,99,37,65,137,71,101,-15,29,13,93,15,26,-4,13,2,44,56,75,-11,16,11,432,180,252,371,176,195,123,164,9,64,31,42,91,85,-1,7,-17,26,32,79,10,57,48,16,86,141,55,16,53,11,69,75,26,-11,5,8,17,66,29,27,48,3,718,283,435,644,246,398,94,229,135,113,5,116,63,92,75,35,-31,40,31,137,60,78,36,76,125,179,159,91,40,28,66,67,59,39,3,6,59,112,100,52,37,22
28,28137,"Santos de la Humosa, Los",895,21,15,6,24,16,8,-1,11,2,10,1,0,0,6,4,6,2,-1,-1,5,-2,4,-1,1,2,6,5,8,2,1,1,3,4,5,2,1,1,3,1,3,0,0,22,13,9,10,6,4,-1,4,3,10,5,1,-2,4,0,7,4,0,1,0,3,3,1,1,1,2,6,1,0,0,0,2,3,1,0,0,1,0,3,0,0,0,106,54,52,20,10,10,25,22,25,17,5,10,14,11,14,7,1,5,11,11,11,10,4,5,7,4,7,1,1,0,3,3,4,0,0,0,4,1,3,1,1,0,196,102,94,16,9,7,38,16,95,30,13,0,17,4,53,15,9,0,21,12,42,15,4,0,5,1,8,1,1,0,3,0,4,1,1,0,2,1,4,0,0,0,53,28,25,13,10,3,5,12,26,9,4,-1,5,5,10,7,2,0,0,7,16,2,2,-1,0,5,4,3,1,0,0,3,3,3,1,0,0,2,1,0,0,0,73,32,41,17,8,9,15,13,45,-2,5,-5,8,3,25,-4,2,-3,7,10,20,2,3,-2,3,4,8,2,0,0,1,2,3,2,0,0,2,2,5,0,0,0,214,114,100,20,10,10,16,49,94,34,10,9,10,20,52,22,4,5,6,29,42,12,6,4,2,8,4,5,1,0,2,3,3,2,0,0,0,5,1,3,1,0,287,154,133,36,24,12,57,46,131,40,12,-2,24,21,80,24,5,-1,33,25,51,16,7,-1,7,11,8,4,6,0,4,7,6,4,3,0,3,4,2,0,3,0,124,65,59,24,6,18,21,17,59,25,-3,3,15,8,26,17,-2,0,6,9,33,8,-1,3,7,5,6,3,0,1,2,-2,2,2,0,0,5,7,4,1,0,1,-3,-3,0,6,-1,7,-8,4,17,-9,-6,-1,-6,2,10,-7,-1,1,-2,2,7,-2,-5,-2,0,3,0,1,2,1,-1,0,1,0,0,0,1,3,-1,1,2,1,78,28,50,6,5,1,13,14,34,9,7,3,4,4,20,-3,4,2,9,10,14,12,3,1,-3,4,4,2,0,0,0,1,4,1,0,0,-3,3,0,1,0,0,14,-2,16,1,-3,4,17,-11,19,-9,-3,-2,6,-7,7,-1,-5,-3,11,-4,12,-8,2,1,2,-2,2,-1,0,1,0,-1,-1,-1,0,0,2,-1,3,0,0,1,16,7,9,11,4,7,-11,6,12,5,5,-1,-7,3,8,3,3,-2,-4,3,4,2,2,1,3,1,7,0,1,-1,2,0,3,-1,1,-1,1,1,4,1,0,0,30,0,30,4,-1,5,22,3,6,-3,-3,1,12,-1,-3,-6,-4,1,10,4,9,3,1,0,-1,3,1,-1,2,0,0,1,-1,-1,0,0,-1,2,2,0,2,0,-42,-15,-27,8,0,8,-16,-3,-5,-16,3,-1,-4,-2,1,-11,3,-2,-12,-1,-6,-5,0,1,4,1,5,-1,-1,0,0,0,1,-1,0,0,4,1,4,0,-1,0,51,28,23,-3,0,-3,10,-4,22,12,8,1,5,-1,9,5,7,0,5,-3,13,7,1,1,-3,1,1,-2,0,0,0,1,0,-1,0,0,-3,0,1,-1,0,0,30,16,14,23,11,12,-1,5,12,6,3,0,-7,3,1,14,1,-1,6,2,11,-8,2,1,4,6,6,9,-1,-1,2,3,2,5,-1,0,2,3,4,4,0,-1,33,5,28,30,17,13,1,8,17,0,6,2,-2,1,4,-1,5,-1,3,7,13,1,1,3,8,5,7,2,5,3,5,4,2,1,4,1,3,1,5,1,1,2
28,28141,Sevilla la Nueva,3243,363,206,157,69,43,26,54,65,138,57,21,18,30,37,79,33,12,8,24,28,59,24,9,10,15,10,26,13,3,2,8,5,16,11,2,1,7,5,10,2,1,1,298,146,152,56,37,19,37,54,134,32,23,20,17,34,56,25,9,7,20,20,78,7,14,13,10,16,12,15,1,2,5,14,6,12,0,0,5,2,6,3,1,2,508,276,232,136,69,67,77,76,188,105,28,25,47,38,100,55,18,11,30,38,88,50,10,14,23,30,41,23,16,3,9,15,21,12,10,2,14,15,20,11,6,1,471,222,249,78,38,40,77,72,205,53,30,23,32,27,103,30,16,9,45,45,102,23,14,14,18,25,17,14,1,3,10,10,10,6,0,2,8,15,7,8,1,1,387,177,210,163,88,75,37,66,212,43,13,10,26,30,97,22,2,0,11,36,115,21,11,10,23,36,63,25,11,4,15,15,38,13,4,1,8,21,25,12,7,3,446,214,232,134,66,68,54,81,189,54,40,24,19,46,97,17,23,8,35,35,92,37,17,16,21,39,31,28,11,3,6,25,18,13,4,0,15,14,13,15,7,3,517,260,257,230,121,109,76,79,213,73,39,33,41,35,120,40,9,10,35,44,93,33,30,23,53,50,67,40,15,4,31,25,35,18,8,3,22,25,32,22,7,1,328,164,164,126,70,56,2,74,117,38,16,85,5,44,67,20,6,24,-3,30,50,18,10,61,24,42,36,25,-1,-1,6,28,19,18,-1,0,18,14,17,7,0,-1,335,87,248,116,47,69,16,64,51,-5,23,195,10,23,11,0,4,43,6,41,40,-5,19,152,26,39,27,12,8,4,17,18,7,2,1,2,9,21,20,10,7,2,286,107,179,29,3,26,44,28,96,33,14,67,25,2,46,7,9,14,19,26,50,26,5,53,12,18,-6,3,-1,2,6,3,-6,0,-2,2,6,15,0,3,1,0,147,25,122,2,-7,9,7,-4,45,28,4,60,1,-6,-6,21,-4,16,6,2,51,7,8,44,6,5,-3,-8,1,1,2,0,-4,-4,-2,2,4,5,1,-4,3,-1,84,57,27,47,33,14,-34,13,56,4,2,42,-27,18,42,6,-5,22,-7,-5,14,-2,7,20,6,21,5,4,5,4,4,18,3,2,2,3,2,3,2,2,3,1,14,6,8,-29,-19,-10,-15,22,16,-37,13,13,-5,7,15,-22,7,2,-10,15,1,-15,6,11,-11,8,-18,-11,1,2,-4,1,-8,-7,-1,0,-7,7,-10,-4,2,2,-90,-49,-41,-132,-89,-43,-13,-42,-10,3,-31,4,6,-23,-9,9,-28,-1,-19,-19,-1,-6,-3,5,-30,-21,-34,-20,-20,-7,-14,-13,-23,-18,-16,-5,-16,-8,-11,-2,-4,-2,40,3,37,-33,-23,-10,13,-5,-8,-25,8,52,7,-1,-9,-14,0,16,6,-4,1,-11,8,36,-1,4,-8,-15,-9,-5,2,-1,-7,-10,-6,-2,-3,5,-1,-5,-3,-3,0,-15,15,-28,-14,-14,-4,4,-13,-51,16,50,-4,5,-3,-27,8,9,0,-1,-10,-24,8,41,1,4,-14,-12,-3,-4,1,2,-10,-6,-1,0,0,2,-4,-6,-2,-4,138,29,109,35,17,18,22,-2,35,-1,18,61,4,-5,12,1,-1,15,18,3,23,-2,19,46,6,1,8,3,8,7,3,0,8,4,0,1,3,1,0,-1,8,6,61,-8,69,-24,-26,2,-6,-8,41,-6,-16,51,-4,-2,21,-24,-11,9,-2,-6,20,18,-5,42,2,1,-2,-15,-12,1,-5,4,-2,-18,-7,1,7,-3,0,3,-5,0
28,28144,Soto del Real,4870,445,208,237,106,60,46,80,64,137,111,29,19,31,26,67,61,12,7,49,38,70,50,17,12,16,27,29,26,5,3,7,16,17,16,1,3,9,11,12,10,4,0,405,202,203,128,58,70,73,59,104,85,39,43,43,29,46,43,23,18,30,30,58,42,16,25,26,27,35,28,8,3,13,13,16,11,4,1,13,14,19,17,4,2,311,177,134,93,49,44,54,52,76,70,39,15,39,25,50,33,22,5,15,27,26,37,17,10,19,29,20,17,6,2,11,11,17,5,4,1,8,18,3,12,2,1,446,215,231,153,69,84,91,47,126,82,46,46,55,21,59,43,22,15,36,26,67,39,24,31,31,31,42,27,15,6,16,15,19,11,5,3,15,16,23,16,10,3,369,161,208,121,61,60,76,33,126,70,37,22,40,8,55,31,18,9,36,25,71,39,19,13,25,22,38,24,8,4,15,10,20,11,1,4,10,12,18,13,7,0,225,79,146,129,57,72,71,10,50,52,22,15,24,3,20,20,9,2,47,7,30,32,13,13,21,32,32,31,10,3,5,13,16,17,5,1,16,19,16,14,5,2,140,85,55,156,84,72,19,39,11,32,23,12,5,17,14,32,11,4,14,22,-3,0,12,8,22,38,50,26,14,3,9,17,30,15,9,1,13,21,20,11,5,2,169,72,97,171,76,95,43,61,3,43,18,6,34,36,-19,16,9,-1,9,25,22,27,9,7,39,50,50,21,5,6,23,26,20,2,1,4,16,24,30,19,4,2,85,46,39,78,35,43,49,-4,11,20,-5,14,26,5,9,7,-6,4,23,-9,2,13,1,10,16,18,23,14,5,2,6,10,10,7,1,1,10,8,13,7,4,1,114,54,60,45,11,34,28,23,22,17,-4,30,24,12,8,10,-7,11,4,11,14,7,3,19,8,16,18,12,-6,-3,10,3,3,4,-5,-4,-2,13,15,8,-1,1,60,-1,61,-35,-35,0,-1,-18,-25,18,10,80,0,-11,-25,4,7,24,-1,-7,0,14,3,56,-4,-1,-16,-10,-2,-2,-3,-5,-15,-11,-2,1,-1,4,-1,1,0,-3,0,4,-4,17,3,14,-2,-5,-25,-2,-2,31,0,4,-4,-9,0,9,-2,-9,-21,7,-2,22,5,9,-7,5,2,0,-2,5,-6,5,-1,1,7,4,-1,0,3,-1,64,28,36,-16,-9,-7,-1,1,22,-14,17,30,1,-7,12,-12,10,17,-2,8,10,-2,7,13,9,-5,-12,-5,-1,-2,9,-5,-7,-5,-1,0,0,0,-5,0,0,-2,-32,-44,12,-80,-43,-37,15,-21,-12,-17,-23,25,-4,-22,-2,-1,-18,1,19,1,-10,-16,-5,24,-15,-7,-15,-29,-14,-1,-9,-8,-4,-14,-8,-1,-6,1,-11,-15,-6,0,8,29,-21,-8,2,-10,5,0,-9,-17,-8,40,15,6,3,-3,-4,11,-10,-6,-12,-14,-4,29,2,-2,-5,-1,0,-2,4,2,-2,-2,2,-2,-2,-4,-3,1,-2,0,33,-5,38,-37,-24,-13,27,-24,-4,22,-18,26,10,-11,-5,4,-6,2,17,-13,1,18,-12,24,0,-3,-17,-9,-5,-5,1,-3,-8,-10,-2,-2,-1,0,-9,1,-3,-3,141,67,74,15,8,7,36,-11,17,25,23,42,18,-5,5,18,11,15,18,-6,12,7,12,27,1,-1,7,4,-1,0,-1,3,3,2,-3,1,2,-4,4,2,2,-1,135,64,71,4,2,2,29,-3,28,46,15,16,15,-2,16,11,14,9,14,-1,12,35,1,7,-3,3,2,-5,9,-4,3,5,-1,-5,4,-4,-6,-2,3,0,5,0
28,28145,Talamanca de Jarama,1408,75,34,41,29,17,12,13,13,20,20,7,2,3,3,13,11,4,0,10,10,7,9,3,2,5,6,12,5,1,0,1,2,11,2,1,0,4,4,1,3,0,0,83,50,33,48,30,18,18,15,45,8,-3,-1,11,11,27,6,-4,-1,7,4,18,2,1,0,9,16,15,6,1,0,5,11,11,3,0,0,4,5,4,3,1,0,97,39,58,37,18,19,17,14,28,22,7,5,9,8,11,6,1,0,8,6,17,16,6,5,11,10,12,4,0,0,6,7,4,1,0,0,5,3,8,3,0,0,125,75,50,42,23,19,15,17,34,33,6,14,9,4,26,23,2,7,6,13,8,10,4,7,6,11,12,13,0,0,2,3,9,9,0,0,4,8,3,4,0,0,160,93,67,59,34,25,28,34,76,10,9,-1,18,22,45,7,2,-2,10,12,31,3,7,1,10,15,25,8,1,0,6,10,12,6,0,0,4,5,13,2,1,0,66,44,22,33,16,17,2,6,31,10,9,6,-4,7,24,8,5,2,6,-1,7,2,4,4,7,10,9,5,2,0,4,8,1,2,1,0,3,2,8,3,1,0,208,98,110,72,39,33,39,48,67,35,3,9,13,19,37,21,2,4,26,29,30,14,1,5,16,21,21,12,1,0,4,12,14,8,0,0,12,9,7,4,1,0,164,90,74,52,30,22,44,18,76,13,6,5,23,6,52,3,3,0,21,12,24,10,3,5,16,12,17,0,7,-1,11,8,10,-2,3,-1,5,4,7,2,4,0,257,132,125,43,24,19,28,42,110,39,19,2,14,19,59,18,9,3,14,23,51,21,10,-1,10,10,15,3,3,1,5,5,8,2,2,1,5,5,7,1,1,0,205,98,107,3,-4,7,17,27,103,30,10,13,11,8,55,10,5,10,6,19,48,20,5,3,3,1,-1,-2,0,1,1,-2,-1,-2,-1,1,2,3,0,0,1,0,152,82,70,21,11,10,24,0,40,51,7,9,8,-5,26,35,2,5,16,5,14,16,5,4,4,1,5,3,4,0,2,0,4,2,0,0,2,1,1,1,4,0,51,24,27,13,-1,14,-6,3,28,3,8,16,-3,-1,21,-5,4,10,-3,4,7,8,4,6,7,1,-3,6,2,0,1,-2,-4,4,0,0,6,3,1,2,2,0,79,36,43,1,-1,2,13,7,12,20,15,14,-5,5,3,16,9,7,18,2,9,4,6,7,1,3,3,-4,-1,0,-2,2,2,-3,0,0,3,1,1,-1,-1,0,-8,-5,-3,-11,-11,0,-15,7,8,-20,6,6,-14,6,5,-11,4,4,-1,1,3,-9,2,2,-5,2,-1,-4,-3,-1,-4,0,0,-5,-2,0,-1,2,-1,1,-1,-1,74,40,34,14,8,6,-16,23,18,7,11,31,1,11,6,2,7,13,-17,12,12,5,4,18,0,6,3,3,-2,2,1,3,2,2,-1,0,-1,3,1,1,-1,2,44,6,38,20,9,11,9,5,9,9,11,4,5,0,-4,8,4,-5,4,5,13,1,7,9,6,6,5,4,2,-3,3,1,2,4,0,-1,3,5,3,0,2,-2,103,44,59,14,2,12,21,10,18,10,14,24,6,2,13,5,4,12,15,8,5,5,10,12,6,6,-2,-1,4,0,3,3,0,-4,0,0,3,3,-2,3,4,0,29,10,19,-60,-37,-23,7,8,14,-9,0,9,2,2,10,-6,1,1,5,6,4,-3,-1,8,2,3,-17,-37,-10,-1,-1,1,-8,-22,-6,-1,3,2,-9,-15,-4,0
28,28146,Tielmes,1923,102,62,40,98,61,37,5,32,37,19,7,3,1,20,24,12,6,0,4,12,13,7,1,3,9,29,37,19,4,0,4,20,25,10,2,0,5,9,12,9,2,0,109,75,34,108,72,36,9,27,33,18,6,14,8,23,18,16,4,5,1,4,15,2,2,9,6,39,36,23,3,0,3,26,23,18,2,0,3,13,13,5,1,0,137,79,58,166,94,72,51,39,18,18,6,3,32,12,13,13,5,2,19,27,5,5,1,1,48,41,50,21,6,-1,28,20,30,12,4,-1,20,21,20,9,2,0,75,27,48,73,37,36,18,17,23,7,2,7,11,4,7,1,0,3,7,13,16,6,2,4,19,16,23,10,3,1,12,7,9,6,1,1,7,9,14,4,2,0,96,48,48,74,39,35,8,15,54,12,5,1,-3,6,34,6,4,1,11,9,20,6,1,0,12,17,29,13,3,0,7,7,16,6,3,0,5,10,13,7,0,0,52,29,23,71,33,38,8,18,11,9,5,3,8,14,-2,5,2,2,0,4,13,4,3,1,10,20,20,16,5,0,7,10,7,8,1,0,3,10,13,8,4,0,123,75,48,94,43,51,16,58,32,15,0,0,12,34,22,8,-3,-1,4,24,10,7,3,1,23,31,22,14,4,0,10,14,11,8,0,0,13,17,11,6,4,0,72,38,34,74,43,31,25,28,3,13,5,-4,13,20,2,2,2,-3,12,8,1,11,3,-1,13,25,22,9,5,0,7,15,13,6,2,0,6,10,9,3,3,0,-25,-17,-8,15,6,9,2,-26,-4,-1,2,2,-5,-21,-2,6,4,0,7,-5,-2,-7,-2,2,3,-1,7,4,1,1,0,-4,6,3,0,1,3,3,1,1,1,0,53,29,24,8,4,4,12,-2,28,10,4,-1,7,-6,21,4,2,-1,5,4,7,6,2,0,0,2,4,2,0,0,0,1,3,0,0,0,0,1,1,2,0,0,22,14,8,8,2,6,-3,6,10,2,1,3,-1,-1,7,6,1,1,-2,7,3,-4,0,2,3,2,1,1,1,0,2,-1,0,0,1,0,1,3,1,1,0,0,7,-8,15,7,-1,8,-3,-10,7,9,3,0,-7,-6,-1,3,2,1,4,-4,8,6,1,-1,0,2,-1,2,3,1,0,0,-3,0,1,1,0,2,2,2,2,0,33,13,20,13,3,10,2,18,-12,7,13,2,2,11,-6,-2,4,3,0,7,-6,9,9,-1,3,0,3,2,4,1,1,0,1,1,0,0,2,0,2,1,4,1,-53,-41,-12,-100,-63,-37,3,-10,-20,-24,-11,7,4,-5,-21,-18,-6,5,-1,-5,1,-6,-5,2,-10,-15,-26,-29,-17,-3,-5,-9,-19,-18,-10,-2,-5,-6,-7,-11,-7,-1,-34,-4,-30,-30,-15,-15,-20,2,-14,-7,0,2,-3,-1,-4,-1,-1,3,-17,3,-10,-6,1,-1,-4,-1,-15,-6,-2,-2,-2,-1,-7,-4,0,-1,-2,0,-8,-2,-2,-1,34,8,26,-16,-16,0,8,-4,23,3,-10,14,-2,-2,10,4,-9,6,10,-2,13,-1,-1,8,7,-3,-5,-6,-9,0,2,-2,-7,-2,-7,0,5,-1,2,-4,-2,0,8,6,2,4,-1,5,6,7,-8,8,-10,3,7,0,3,1,-7,-2,-1,7,-11,7,-3,5,4,-2,0,6,-4,-1,1,-2,2,0,-2,-1,3,0,-2,6,-2,0,25,8,17,33,18,15,-4,-4,3,10,2,16,-3,-2,-4,9,3,5,-1,-2,7,1,-1,11,10,6,6,9,0,1,8,2,1,6,0,1,2,4,5,3,0,0
28,28148,Torrejón de Ardoz,92262,238,93,145,35,17,18,-29,87,234,-96,-19,60,-29,33,132,-55,-16,24,0,54,102,-41,-3,36,6,3,5,8,10,3,2,1,3,4,5,2,4,2,2,4,5,1,-445,-244,-201,39,19,20,-87,-39,-113,-135,-103,38,-62,-7,-64,-57,-61,5,-25,-32,-49,-78,-42,33,14,6,6,6,6,1,7,3,2,4,2,1,7,3,4,2,4,0,-197,-21,-176,-9,10,-19,-118,2,88,-101,-120,54,-38,33,93,-53,-74,22,-80,-31,-5,-48,-46,32,13,-12,-17,-4,8,3,10,-1,-4,-1,3,3,3,-11,-13,-3,5,0,-108,53,-161,52,29,23,-193,44,237,-96,-122,-2,-104,57,176,-22,-66,-7,-89,-13,61,-74,-56,5,9,9,14,6,8,6,6,6,6,3,5,3,3,3,8,3,3,3,1488,924,564,2239,1204,1035,-23,589,735,137,-10,70,-26,333,548,87,-27,25,3,256,187,50,17,45,313,671,742,345,117,41,157,326,469,186,45,16,156,345,273,159,72,25,1604,777,827,2228,1165,1063,66,693,668,68,-10,134,14,336,380,29,-31,57,52,357,288,39,21,77,340,705,676,358,102,30,179,345,395,189,36,12,161,360,281,169,66,18,2847,1604,1243,3216,1756,1460,170,1051,1123,435,-10,68,64,559,705,260,-4,16,106,492,418,175,-6,52,507,929,1015,555,152,41,249,505,571,341,64,16,258,424,444,214,88,25,1702,886,816,2591,1361,1230,97,846,584,125,5,47,49,404,364,73,-25,14,48,442,220,52,30,33,456,843,753,411,108,5,233,419,434,212,49,7,223,424,319,199,59,-2,493,264,229,1503,778,725,-36,515,126,-89,-51,16,18,242,122,-88,-28,0,-54,273,4,-1,-23,16,268,517,422,244,43,-11,133,229,261,130,17,0,135,288,161,114,26,-11,-653,-502,-151,-193,-231,38,-11,-53,-99,-371,-146,-2,-10,-57,-130,-220,-90,0,-1,4,31,-151,-56,-2,62,74,-121,-145,-68,-8,20,12,-123,-108,-31,-7,42,62,2,-37,-37,-1,3081,1374,1707,909,374,535,360,696,1409,376,108,28,211,291,670,129,13,1,149,405,739,247,95,27,133,348,244,99,61,-3,76,133,128,7,17,-1,57,215,116,92,44,-2,1796,751,1045,648,242,406,128,417,879,198,20,97,23,174,464,51,-18,32,105,243,415,147,38,65,77,287,119,83,51,19,33,132,53,-5,14,6,44,155,66,88,37,13,768,232,536,75,-31,106,60,227,369,18,0,57,11,106,119,-36,-18,19,49,121,250,54,18,38,3,110,-27,-20,-5,-1,-3,47,-47,-23,-8,-5,6,63,20,3,3,4,203,-14,217,-287,-197,-90,-58,137,75,-33,4,32,-53,51,37,-58,-39,16,-5,86,38,25,43,16,-89,49,-112,-111,-21,-13,-48,1,-59,-68,-17,-9,-41,48,-53,-43,-4,-4,490,193,297,409,203,206,68,196,139,-57,52,52,41,96,61,-57,19,16,27,100,78,0,33,36,82,132,76,37,32,21,51,66,45,13,5,8,31,66,31,24,27,13,1298,493,805,607,313,294,119,294,445,158,141,99,53,124,197,31,45,30,66,170,248,127,96,69,85,187,161,82,47,27,37,104,94,39,21,9,48,83,67,43,26,18,1332,557,775,946,467,479,124,326,455,183,98,105,43,114,230,108,27,18,81,212,225,75,71,87,135,234,282,146,95,33,67,114,155,81,42,4,68,120,127,65,53,29,1650,717,933,1259,637,622,153,361,449,333,160,147,82,175,230,103,55,43,71,186,219,230,105,104,200,305,344,225,120,46,116,167,180,109,38,14,84,138,164,116,82,32
28,28149,Torrejón de la Calzada,3873,186,88,98,22,11,11,27,35,54,28,19,20,22,17,24,11,7,5,5,18,30,17,12,15,2,7,5,7,0,1,2,4,3,2,0,0,0,3,2,5,0,1,301,156,145,35,15,20,58,55,104,51,26,8,25,28,55,32,13,4,33,27,49,19,13,4,11,7,9,7,1,0,7,1,4,3,0,0,4,6,5,4,1,0,169,70,99,52,28,24,31,20,59,43,15,2,15,4,32,14,7,2,16,16,27,29,8,0,15,10,11,12,2,1,10,4,7,5,1,0,5,6,4,7,1,1,95,54,41,48,25,23,37,24,25,-3,2,6,20,12,17,-3,4,2,17,12,8,0,-2,4,13,15,9,4,6,1,8,9,2,3,3,0,5,6,7,1,3,1,207,104,103,23,11,12,69,18,64,27,7,11,36,7,33,15,2,6,33,11,31,12,5,5,7,6,4,2,4,0,3,3,1,2,2,0,4,3,3,0,2,0,274,130,144,27,13,14,62,23,105,51,14,13,29,10,54,29,2,4,33,13,51,22,12,9,5,11,7,0,2,1,2,5,4,1,1,0,3,6,3,-1,1,1,259,137,122,54,23,31,53,60,41,66,25,10,34,35,14,33,18,3,19,25,27,33,7,7,17,9,14,7,5,1,8,1,8,3,2,0,9,8,6,4,3,1,266,121,145,64,30,34,45,69,74,68,0,5,22,31,33,34,1,0,23,38,41,34,-1,5,14,12,22,15,3,-2,6,5,10,8,3,-2,8,7,12,7,0,0,137,58,79,53,17,36,33,21,54,12,6,3,16,9,23,5,2,-1,17,12,31,7,4,4,14,14,14,7,2,0,9,8,1,2,-2,-1,5,6,13,5,4,1,157,84,73,20,8,12,21,-1,79,24,9,18,9,8,29,17,9,5,12,-9,50,7,0,13,4,3,5,2,3,3,2,2,1,0,1,2,2,1,4,2,2,1,358,179,179,-15,-9,-6,43,29,136,68,33,33,36,4,73,34,18,8,7,25,63,34,15,25,-5,-4,-1,-6,0,0,-4,-4,3,-2,-2,0,-1,0,-4,-4,2,0,314,163,151,21,13,8,47,20,146,56,13,13,19,17,74,31,6,4,28,3,72,25,7,9,6,1,8,3,-1,1,3,3,5,2,-1,1,3,-2,3,1,0,0,6,-5,11,-4,-4,0,-2,-13,14,-6,-9,19,0,-14,8,-1,-3,5,-2,1,6,-5,-6,14,1,1,-2,-2,-1,-1,-1,0,-2,0,-1,0,2,1,0,-2,0,-1,-23,-24,1,-25,-15,-10,-14,-11,-1,-22,10,13,-9,-13,1,-21,11,8,-5,2,-2,-1,-1,5,-3,-4,-12,-4,-2,0,1,-5,-7,-4,0,0,-4,1,-5,0,-2,0,124,46,78,-39,-25,-14,27,-26,91,4,-4,25,1,-14,47,3,-7,10,26,-12,44,1,3,15,-8,-8,-8,-12,-5,1,-9,-5,-3,-6,-3,0,1,-3,-5,-6,-2,1,192,73,119,49,22,27,49,26,64,28,-5,22,15,6,30,16,-2,5,34,20,34,12,-3,17,18,6,16,5,2,1,6,2,9,3,2,0,12,4,7,2,0,1,183,74,109,26,6,20,56,1,80,19,-9,35,26,-3,41,2,-3,12,30,4,39,17,-6,23,11,6,11,-2,0,0,5,4,4,-6,-2,1,6,2,7,4,2,-1,142,90,52,3,2,1,41,10,17,47,7,16,34,1,7,31,8,8,7,9,10,16,-1,8,-8,0,0,-1,10,1,-1,0,-4,0,6,0,-7,0,4,-1,4,1
28,28150,Torrejón de Velasco,1774,174,94,80,21,13,8,33,24,62,31,14,5,22,7,35,16,6,4,11,17,27,15,8,1,3,4,9,4,0,1,3,3,6,1,0,0,0,1,3,3,0,1,211,111,100,10,3,7,26,42,83,26,29,4,15,25,40,14,16,1,11,17,43,12,13,3,2,3,4,1,0,0,0,1,2,0,0,0,2,2,2,1,0,0,325,177,148,18,10,8,82,29,106,73,22,12,48,17,59,39,12,3,34,12,47,34,10,9,2,3,7,3,2,1,1,1,4,2,2,0,1,2,3,1,0,1,217,105,112,17,9,8,37,28,90,28,18,11,16,14,46,14,9,4,21,14,44,14,9,7,2,3,7,3,0,1,2,2,2,2,0,1,0,1,5,1,0,0,195,105,90,16,8,8,53,9,62,53,12,6,35,8,28,27,5,3,18,1,34,26,7,3,3,2,5,5,0,1,0,2,2,3,0,1,3,0,3,2,0,0,323,140,183,12,3,9,61,44,137,33,24,14,22,21,55,21,11,5,39,23,82,12,13,9,-1,3,6,2,3,-1,1,1,3,-1,0,-1,-2,2,3,3,3,0,240,106,134,25,11,14,42,36,101,20,20,15,24,12,48,10,3,7,18,24,53,10,17,8,4,11,7,2,1,0,1,6,3,1,0,0,3,5,4,1,1,0,74,31,43,27,16,11,14,3,14,15,11,13,6,1,7,7,4,6,8,2,7,8,7,7,3,7,7,9,2,-1,1,6,6,4,0,-1,2,1,1,5,2,0,63,34,29,21,6,15,-3,10,21,21,4,6,-6,3,15,13,4,4,3,7,6,8,0,2,1,8,6,3,2,0,-1,2,1,2,1,0,2,6,5,1,1,0,38,4,34,26,9,17,23,0,1,11,6,-1,7,-2,-10,4,6,1,16,2,11,7,0,-2,9,7,4,3,2,1,1,3,2,1,2,0,8,4,2,2,0,1,5,-12,17,14,9,5,10,9,-18,1,2,4,3,3,-11,-9,1,2,7,6,-7,10,1,2,4,3,1,3,1,1,2,1,1,2,1,1,2,2,0,1,0,0,-3,-3,0,4,2,2,-12,-1,18,-11,4,-3,-8,1,7,-3,1,-2,-4,-2,11,-8,3,-1,0,3,-1,-1,3,0,0,1,1,0,0,0,0,2,-2,-1,3,0,-10,7,-17,7,4,3,3,13,-13,-6,-4,0,5,9,1,-6,-1,-1,-2,4,-14,0,-3,1,3,2,-1,0,0,2,1,2,0,0,0,1,2,0,-1,0,0,1,6,-9,15,5,2,3,-2,8,1,2,-5,2,-5,0,-5,4,-4,0,3,8,6,-2,-1,2,1,1,-1,3,0,1,0,0,-1,2,0,1,1,1,0,1,0,0,21,16,5,6,0,6,5,5,2,17,-1,-4,-1,6,1,10,4,-3,6,-1,1,7,-5,-1,1,2,0,3,0,0,1,1,-1,0,-1,0,0,1,1,3,1,0,-13,-17,4,-11,-10,-1,9,-17,15,-22,-1,2,8,-14,-3,-11,4,0,1,-3,18,-11,-5,2,1,0,-9,-1,-2,-1,1,-1,-8,-1,-1,0,0,1,-1,0,-1,-1,-20,-17,-3,-12,-6,-6,10,2,-14,-5,-13,-3,-1,-1,-6,0,-7,-2,11,3,-8,-5,-6,-1,-2,3,-7,-1,-4,-1,-3,1,-1,0,-2,-1,1,2,-6,-1,-2,0,34,-2,36,17,6,11,8,-5,13,6,3,3,-5,-1,2,0,-2,1,13,-4,11,6,5,2,3,6,6,0,1,1,2,4,1,-1,0,0,1,2,5,1,1,1
28,28151,Torrelaguna,2729,152,87,65,103,61,42,10,34,59,17,9,22,6,19,37,13,3,10,4,15,22,4,6,12,6,32,42,22,1,0,1,17,26,17,0,0,5,15,16,5,1,0,254,131,123,172,91,81,37,50,73,41,14,34,19,31,34,22,6,16,18,19,39,19,8,18,34,45,51,33,6,2,17,25,24,20,2,2,17,20,27,13,4,0,276,181,95,187,116,71,42,58,98,55,11,12,27,43,63,31,8,6,15,15,35,24,3,6,28,52,68,32,4,2,17,34,43,19,3,0,11,18,25,13,1,2,357,206,151,177,102,75,57,68,129,58,16,27,29,40,78,32,14,12,28,28,51,26,2,15,27,50,54,38,5,2,14,30,30,23,4,0,13,20,24,15,1,2,193,92,101,110,53,57,28,29,57,33,19,25,19,3,29,20,11,10,9,26,28,13,8,15,14,36,39,20,1,0,6,15,21,11,0,0,8,21,18,9,1,0,208,102,106,133,76,57,27,36,78,15,19,28,14,20,35,9,12,10,13,16,43,6,7,18,14,47,41,21,4,2,7,26,24,10,3,2,7,21,17,11,1,0,255,127,128,181,96,85,38,46,67,54,23,24,17,21,35,29,14,10,21,25,32,25,9,14,33,53,52,28,12,1,16,25,33,14,7,0,17,28,19,14,5,1,202,126,76,179,111,68,23,85,71,11,6,4,6,38,56,14,4,4,17,47,15,-3,2,0,27,76,48,27,4,-5,14,38,35,19,4,0,13,38,13,8,0,-5,161,93,68,80,47,33,28,26,49,22,18,17,22,16,26,7,12,8,6,10,23,15,6,9,17,24,19,14,4,0,9,16,11,8,3,-1,8,8,8,6,1,1,72,37,35,42,20,22,4,12,6,4,35,9,-8,9,2,5,26,0,12,3,4,-1,9,9,11,16,2,9,4,0,6,7,-1,6,3,-1,5,9,3,3,1,1,-37,-47,10,-77,-56,-21,-10,8,0,-28,-15,11,-6,-8,-2,-24,-12,6,-4,16,2,-4,-3,5,-2,-5,-18,-32,-17,-2,-1,-7,-8,-29,-10,-1,-1,2,-10,-3,-7,-1,-59,-33,-26,-53,-47,-6,-16,5,-58,-5,-2,18,-7,2,-29,-6,-3,7,-9,3,-29,1,1,11,-9,0,-25,-15,-3,-1,-7,-5,-13,-14,-7,-1,-2,5,-12,-1,4,0,-25,-12,-13,-26,-15,-11,2,-11,-5,-10,-19,22,-3,1,-1,-1,-11,6,5,-12,-4,-9,-8,16,-9,1,-3,-9,-4,-2,-6,2,1,-8,-4,0,-3,-1,-4,-1,0,-2,-36,-11,-25,-45,-32,-13,-11,-5,-39,-12,8,23,-2,0,-24,-7,10,11,-9,-5,-15,-5,-2,12,-5,-7,-12,-16,-2,-3,-5,-3,-10,-10,-1,-3,0,-4,-2,-6,-1,0,-6,-18,12,-36,-27,-9,21,-14,6,-29,-15,25,12,-6,-6,-20,-7,9,9,-8,12,-9,-8,16,1,-2,-5,-22,-8,0,1,-1,-4,-19,-5,1,0,-1,-1,-3,-3,-1,-38,-44,6,-81,-47,-34,-8,-8,-5,-34,-1,19,-1,-15,-7,-20,-5,4,-7,7,2,-14,4,15,-16,0,-22,-32,-9,-3,-6,-1,-11,-22,-6,-1,-10,1,-11,-10,-3,-2,23,-6,29,-36,-29,-7,-4,4,-26,15,-3,38,0,5,-17,0,0,6,-4,-1,-9,15,-3,32,-2,-2,-12,-10,-6,-3,0,0,-10,-11,-5,-2,-2,-2,-2,1,-1,-1,61,34,27,6,0,6,-7,16,-3,9,9,36,-7,9,1,10,12,8,0,7,-4,-1,-3,28,3,3,-6,1,0,5,0,3,-3,-2,2,0,3,0,-3,3,-2,5
28,28152,Torrelodones,12342,1072,466,606,335,113,222,256,89,373,217,66,44,134,23,144,89,39,21,122,66,229,128,27,23,60,70,130,63,8,2,27,19,43,18,5,1,33,51,87,45,3,1,838,380,458,368,128,240,142,97,301,204,48,49,85,29,130,102,16,18,57,68,171,102,32,31,50,94,121,64,28,9,27,23,43,26,6,3,23,71,78,38,22,6,820,357,463,305,104,201,175,76,283,181,38,39,96,23,117,82,21,9,79,53,166,99,17,30,50,70,76,80,14,14,26,19,21,30,6,2,24,51,55,50,8,12,554,243,311,268,98,170,156,74,120,116,22,46,60,34,56,63,4,19,96,40,64,53,18,27,51,66,68,55,16,10,28,22,20,21,4,3,23,44,48,34,12,7,429,159,270,316,115,201,92,71,151,71,-24,44,40,17,41,51,-19,16,52,54,110,20,-5,28,38,91,94,67,13,11,19,30,33,24,7,2,19,61,61,43,6,9,251,113,138,174,60,114,91,12,65,39,7,23,47,6,26,17,2,7,44,6,39,22,5,16,13,49,57,36,15,4,12,12,22,10,4,0,1,37,35,26,11,4,368,140,228,276,70,206,96,22,134,103,-21,23,39,7,59,36,-12,6,57,15,75,67,-9,17,19,84,99,57,14,3,8,19,29,8,4,2,11,65,70,49,10,1,606,339,267,308,89,219,142,94,114,148,42,60,78,47,45,98,34,31,64,47,69,50,8,29,24,104,100,60,17,3,12,25,29,17,4,2,12,79,71,43,13,1,340,149,191,153,49,104,61,44,89,72,38,28,37,16,38,42,13,-5,24,28,51,30,25,33,4,53,54,32,10,1,11,6,22,7,4,-1,-7,47,32,25,6,2,168,51,117,35,6,29,60,-12,90,8,-1,22,37,-18,34,-7,-2,3,23,6,56,15,1,19,-3,26,15,0,-7,2,0,3,6,-1,-5,1,-3,23,9,1,-2,1,112,41,71,50,-3,53,102,-44,9,48,-41,39,51,-35,3,22,-12,12,51,-9,6,26,-29,27,15,14,7,14,0,-2,6,-2,-12,6,-2,-1,9,16,19,8,2,-1,208,121,87,15,-3,18,71,-3,-7,58,34,45,33,-2,-11,51,20,24,38,-1,4,7,14,21,-4,18,1,-17,7,6,5,4,-10,-10,2,5,-9,14,11,-7,5,1,31,-21,52,-155,-72,-83,18,-43,10,6,-22,57,-31,-13,-4,21,-9,6,49,-30,14,-15,-13,51,-14,-7,-51,-47,-21,-16,-11,-2,-27,-22,-7,-5,-3,-5,-24,-25,-14,-11,-70,-27,-43,-116,-48,-68,36,-43,-10,-20,-50,13,-5,0,12,-5,-39,9,41,-43,-22,-15,-11,4,-9,-8,-24,-49,-21,-8,-6,-2,-4,-21,-15,-2,-3,-6,-20,-28,-6,-6,147,81,66,-6,-8,2,72,-46,20,80,-25,44,49,-36,-3,57,-11,19,23,-10,23,23,-14,25,-8,17,-9,-13,4,2,1,5,-10,-5,-1,1,-9,12,1,-8,5,1,-5,-16,11,-11,-14,3,44,-32,-102,28,-39,83,31,-16,-51,5,-18,24,13,-16,-51,23,-21,59,-5,-2,-12,-4,7,2,0,-2,-14,0,2,-2,-5,0,2,-4,5,4,49,12,37,-14,-6,-8,67,-30,-49,65,-66,57,35,-5,-40,35,-26,9,32,-25,-9,30,-40,48,19,11,-12,-18,-16,1,19,2,-5,-12,-13,2,0,9,-7,-6,-3,-1,269,133,136,-2,3,-5,121,-44,-25,129,-23,87,71,-19,-15,63,-7,26,50,-25,-10,66,-16,61,0,0,-1,1,-14,9,8,3,1,-4,-12,6,-8,-3,-2,5,-2,3
28,28903,Tres Cantos,33121,1124,530,594,513,210,303,98,174,552,169,39,71,77,59,273,65,30,18,21,115,279,104,9,53,94,99,169,110,23,16,54,35,66,36,9,9,40,64,103,74,14,7,517,208,309,507,209,298,0,116,328,24,-16,71,11,55,144,-8,-18,25,-11,61,184,32,2,46,104,102,156,101,24,14,55,32,62,43,9,3,49,70,94,58,15,11,242,89,153,477,222,255,-43,108,208,-26,-36,32,-21,40,105,-17,-26,4,-22,68,103,-9,-10,28,100,106,142,87,21,15,50,50,70,38,6,6,50,56,72,49,15,9,95,-16,111,451,189,262,-68,39,179,-79,-28,54,-52,14,90,-62,-14,10,-16,25,89,-17,-14,44,79,81,164,80,32,12,39,31,73,30,13,2,40,50,91,50,19,10,9,-73,82,339,139,200,2,51,11,-68,-46,56,10,25,-10,-69,-38,15,-8,26,21,1,-8,41,56,93,100,65,16,6,27,43,42,16,8,3,29,50,58,49,8,3,118,-17,135,372,158,214,78,63,-27,-43,-13,46,33,22,-26,-43,-10,2,45,41,-1,0,-3,44,64,92,105,73,27,7,27,32,51,32,11,2,37,60,54,41,16,5,276,35,241,450,171,279,23,69,116,8,-48,84,-7,27,35,-15,-38,15,30,42,81,23,-10,69,86,89,147,75,34,11,31,32,50,31,15,6,55,57,97,44,19,5,277,87,190,389,173,216,-46,114,123,-25,-64,161,-14,53,64,-25,-47,43,-32,61,59,0,-17,118,33,139,144,51,14,3,21,61,70,13,4,1,12,78,74,38,10,2,178,68,110,288,171,117,-1,4,120,-23,-70,135,-2,-10,71,-5,-34,42,1,14,49,-18,-36,93,50,73,97,45,8,9,31,35,56,30,10,4,19,38,41,15,-2,5,-46,-57,11,109,27,82,-31,9,27,-83,-55,58,-29,15,13,-33,-43,3,-2,-6,14,-50,-12,55,17,48,33,3,0,4,5,24,5,-3,-6,0,12,24,28,6,6,4,-212,-161,-51,-147,-86,-61,-21,-21,11,-139,-94,35,-4,-29,-4,-77,-51,-1,-17,8,15,-62,-43,36,-23,-2,-20,-77,-20,-12,-14,-5,-11,-44,-11,-5,-9,3,-9,-33,-9,-7,100,3,97,-33,-38,5,45,5,-13,19,-40,67,29,-8,-19,2,-27,14,16,13,6,17,-13,53,-4,19,-8,-35,5,-16,-9,6,-7,-24,0,-7,5,13,-1,-11,5,-9,438,181,257,59,18,41,134,-7,100,105,-23,102,57,-7,35,58,-6,33,77,0,65,47,-17,69,37,11,-8,1,5,8,20,-3,-9,-4,7,5,17,14,1,5,-2,3,476,176,300,-66,-55,-11,126,1,211,86,-49,79,41,-14,100,50,-31,21,85,15,111,36,-18,58,-2,8,-34,-29,-15,0,-14,-2,-23,-15,-3,-1,12,10,-11,-14,-12,1,643,283,360,-105,-59,-46,207,-10,141,229,-20,69,94,-5,40,131,-4,12,113,-5,101,98,-16,57,-15,0,-50,-32,-12,0,-10,-1,-29,-21,-3,3,-5,1,-21,-11,-9,-3,1193,674,519,-26,0,-26,338,0,333,346,24,121,196,12,207,183,21,44,142,-12,126,163,3,77,26,-8,-27,-27,1,4,11,-3,6,-16,-1,1,15,-5,-33,-11,2,3,1115,495,620,169,60,109,282,48,334,319,-26,126,152,12,162,146,-31,36,130,36,172,173,5,90,46,3,48,40,14,13,33,-6,12,13,-2,7,13,9,36,27,16,6,489,233,256,133,54,79,134,-11,115,157,-35,113,67,14,48,84,-17,38,67,-25,67,73,-18,75,21,28,53,6,11,4,8,15,30,-1,-2,0,13,13,23,7,13,4
28,28160,Valdemorillo,5257,475,259,216,146,99,47,94,61,175,91,37,5,59,37,87,47,18,3,35,24,88,44,19,2,37,29,42,25,11,1,25,21,29,17,5,1,12,8,13,8,6,0,479,272,207,191,113,78,59,43,204,86,61,20,34,28,104,48,43,9,25,15,100,38,18,11,40,42,76,26,4,0,21,28,43,14,4,0,19,14,33,12,0,0,469,237,232,207,110,97,56,68,220,73,43,6,28,31,106,39,29,2,28,37,114,34,14,4,59,50,61,28,6,2,35,23,31,16,5,0,24,27,30,12,1,2,692,343,349,162,66,96,124,80,249,142,59,38,61,40,130,65,27,20,63,40,119,77,32,18,54,34,40,22,7,5,25,16,17,6,1,1,29,18,23,16,6,4,501,264,237,143,77,66,73,47,201,92,62,19,39,32,98,54,29,9,34,15,103,38,33,10,31,29,39,23,14,5,23,15,23,9,4,3,8,14,16,14,10,2,429,210,219,138,60,78,50,53,154,107,58,1,26,21,79,53,27,1,24,32,75,54,31,0,29,34,30,31,8,3,17,15,13,13,2,0,12,19,17,18,6,3,407,209,198,222,101,121,67,50,135,105,29,14,50,17,61,68,9,3,17,33,74,37,20,11,49,43,65,42,14,6,28,18,25,21,6,2,21,25,40,21,8,4,385,208,177,206,101,105,70,57,134,67,53,4,42,37,77,20,37,-4,28,20,57,47,16,8,41,38,54,49,19,4,22,23,27,16,12,0,19,15,27,33,7,4,51,24,27,-25,-18,-7,7,-3,53,-8,-6,6,-2,-4,31,-2,-2,3,9,1,22,-6,-4,3,4,5,-9,-12,-8,-7,-3,1,-11,-6,1,-1,7,4,2,-6,-9,-6,81,16,65,80,18,62,-1,11,61,23,-6,-12,-6,0,23,19,-10,-9,5,11,38,4,4,-3,16,22,27,8,4,-2,5,1,7,5,-1,-1,11,21,20,3,5,-1,251,126,125,74,28,46,46,28,84,64,11,19,23,13,44,35,2,8,23,15,40,29,9,11,6,21,26,15,4,2,-3,8,13,7,1,1,9,13,13,8,3,1,164,71,93,32,9,23,32,15,55,22,40,0,16,2,14,25,13,1,16,13,41,-3,27,-1,6,10,16,-2,3,-1,6,4,4,-2,-1,-2,0,6,12,0,4,1,158,80,78,27,17,10,24,5,64,39,21,8,2,6,32,34,8,-2,22,-1,32,5,13,10,0,10,11,2,3,1,-1,4,9,3,2,0,1,6,2,-1,1,1,81,31,50,17,6,11,38,2,41,2,-17,18,16,0,19,1,-9,7,22,2,22,1,-8,11,2,5,14,-4,0,0,2,2,6,-4,1,-1,0,3,8,0,-1,1,128,63,65,51,27,24,20,19,33,51,-8,13,4,6,20,28,1,3,16,13,13,23,-9,10,16,14,14,9,-3,2,6,5,11,6,-3,2,10,9,3,3,0,0,27,-1,28,11,-5,16,-17,24,-1,12,13,-2,-4,17,-1,-3,-3,-6,-13,7,0,15,16,4,6,15,-4,-11,5,0,-1,8,-5,-5,-1,-1,7,7,1,-6,6,1,152,51,101,-12,-36,24,44,-1,59,31,4,13,34,-6,18,-3,3,3,10,5,41,34,1,10,8,11,10,-37,-4,0,4,-5,-1,-29,-3,-1,4,16,11,-8,-1,1,-69,-82,13,-85,-70,-15,-5,-8,-39,4,-34,7,-4,-10,-36,-12,-21,-3,-1,2,-3,16,-13,10,10,0,-16,-52,-25,-3,5,-3,-13,-36,-18,-5,5,3,-3,-16,-7,2
28,28162,Valdeolmos-Alalpardo,1725,16,3,13,33,15,18,-10,0,6,12,-9,15,-4,0,0,2,-3,7,-6,0,6,10,-6,8,1,2,6,5,2,16,1,0,2,1,1,9,0,2,4,4,1,7,71,37,34,57,28,29,9,1,34,13,12,0,8,-2,18,8,8,-4,1,3,16,5,4,4,9,5,14,17,2,10,8,2,8,7,1,2,1,3,6,10,1,8,78,37,41,30,15,15,16,14,19,19,-2,11,3,7,10,13,-2,6,13,7,9,6,0,5,4,6,14,-1,0,7,3,3,8,-1,-1,3,1,3,6,0,1,4,111,58,53,63,34,29,25,24,57,9,4,-5,8,10,32,10,2,-4,17,14,25,-1,2,-1,5,11,14,6,9,17,2,7,4,3,6,11,3,4,10,3,3,6,127,68,59,67,33,34,14,16,50,25,5,13,8,6,26,19,0,7,6,10,24,6,5,6,3,11,16,11,6,20,2,3,9,5,1,13,1,8,7,6,5,7,103,45,58,40,19,21,21,19,51,22,-2,-8,6,12,20,14,-1,-6,15,7,31,8,-1,-2,5,10,6,4,2,13,2,4,2,2,0,9,3,6,4,2,2,4,141,75,66,61,28,33,31,2,54,31,4,16,8,10,24,22,2,9,23,-8,30,9,2,7,1,12,12,12,3,21,0,9,4,3,1,11,1,3,8,9,2,10,238,123,115,67,40,27,45,30,92,56,-2,11,19,14,49,36,-1,1,26,16,43,20,-1,10,8,13,17,10,1,16,4,8,13,6,0,7,4,5,4,4,1,9,218,112,106,72,45,27,50,25,113,18,10,2,35,12,53,10,1,2,15,13,60,8,9,0,21,18,15,7,2,9,16,10,10,3,0,6,5,8,5,4,2,3,125,55,70,37,25,12,40,19,42,35,-3,-7,21,16,15,16,-5,-6,19,3,27,19,2,-1,9,11,7,5,1,4,10,8,2,2,0,3,-1,3,5,3,1,1,154,81,73,38,20,18,47,19,37,35,7,7,28,11,19,18,3,2,19,8,18,17,4,5,8,9,9,2,2,7,6,2,6,1,1,4,2,7,3,1,1,3,189,95,94,22,11,11,54,16,50,44,9,9,29,10,13,27,11,2,25,6,37,17,-2,7,5,5,3,2,2,5,5,3,2,1,0,0,0,2,1,1,2,5,80,37,43,30,24,6,27,19,29,16,0,-11,12,14,10,8,1,-7,15,5,19,8,-1,-4,10,12,3,2,1,2,9,11,0,2,1,1,1,1,3,0,0,1,61,45,16,9,3,6,20,4,7,25,10,-6,14,5,12,10,7,-4,6,-1,-5,15,3,-2,2,4,2,-2,3,0,1,3,-2,-1,2,0,1,1,4,-1,1,0,66,19,47,-25,-29,4,20,-27,48,8,6,10,14,-29,18,12,0,4,6,2,30,-4,6,6,4,-38,0,4,3,2,4,-37,-1,2,2,1,0,-1,1,2,1,1,41,15,26,-29,-13,-16,23,-11,23,-1,-11,15,20,-11,5,-8,-3,9,3,0,18,7,-8,6,5,-6,-7,-10,-7,-4,5,-6,-5,-3,-4,0,0,0,-2,-7,-3,-4,-20,-9,-11,-37,-20,-17,14,9,-25,-9,-6,-5,13,7,-14,-5,-6,-4,1,2,-11,-4,0,-1,3,4,-22,-16,-6,-2,0,4,-11,-10,-2,-2,3,0,-11,-6,-4,0,66,48,18,-20,-16,-4,22,8,22,22,-6,-5,22,6,8,16,-3,-3,0,2,14,6,-3,-2,5,0,0,-19,-5,-1,4,1,-4,-13,-3,-1,1,-1,4,-6,-2,0
28,28167,Velilla de San Antonio,5935,631,297,334,67,32,35,133,108,233,88,40,24,65,41,122,41,19,7,68,67,111,47,21,17,17,10,26,9,2,3,8,2,16,5,0,1,9,8,10,4,2,2,539,285,254,101,58,43,61,126,203,78,39,24,24,65,111,49,20,11,37,61,92,29,19,13,19,19,36,21,3,1,11,7,24,12,1,1,8,12,12,9,2,0,485,248,237,105,57,48,39,96,233,55,31,25,26,44,118,37,12,11,13,52,115,18,19,14,21,29,31,14,6,4,7,17,18,11,2,2,14,12,13,3,4,2,352,172,180,130,70,60,17,123,153,46,5,10,0,53,84,30,3,4,17,70,69,16,2,6,23,25,42,30,7,1,12,14,22,16,4,1,11,11,20,14,3,0,275,146,129,163,78,85,35,82,121,20,9,7,27,31,72,10,3,2,8,51,49,10,6,5,29,42,52,26,10,3,11,19,31,10,4,2,18,23,21,16,6,1,84,61,23,126,69,57,-29,53,46,9,0,5,1,32,21,10,-4,2,-30,21,25,-1,4,3,23,26,42,31,3,1,18,13,25,13,1,-1,5,13,17,18,2,2,399,222,177,238,141,97,27,125,189,32,8,9,18,58,115,21,7,2,9,67,74,11,1,7,33,70,81,36,10,5,19,41,48,24,7,1,14,29,33,12,3,4,121,50,71,181,93,88,22,36,39,5,6,11,12,19,14,3,4,1,10,17,25,2,2,10,42,63,54,24,-2,-1,19,30,30,13,1,-1,23,33,24,11,-3,0,160,66,94,58,27,31,11,60,60,16,-1,19,2,29,35,-2,-5,8,9,31,25,18,4,11,17,23,10,5,0,3,6,14,7,0,-1,1,11,9,3,5,1,2,-1,-3,2,-36,-39,3,-20,7,56,-36,-7,3,1,0,14,-22,-1,7,-21,7,42,-14,-6,-4,-1,3,-21,-12,-5,0,-2,-2,-18,-16,-2,1,1,5,-3,4,-3,-1,4,-7,11,40,14,26,-10,8,-24,25,5,6,-1,5,-23,19,-5,1,-9,3,-1,6,10,5,8,13,13,6,1,-1,2,6,4,1,1,0,6,7,9,5,0,-1,171,58,113,42,5,37,30,28,73,29,-5,13,13,4,27,14,-5,3,17,24,46,15,0,10,13,5,10,12,1,1,7,-3,-4,4,0,1,6,8,14,8,1,0,129,44,85,24,1,23,32,20,61,17,-4,6,9,4,37,-3,-8,6,23,16,24,20,4,0,9,7,5,2,0,1,5,1,2,-4,-3,0,4,6,3,6,3,1,-25,-14,-11,-9,-4,-5,5,-14,29,-37,-18,2,14,-2,-7,-13,-10,0,-9,-12,36,-24,-8,2,6,9,-9,-7,-5,-3,8,6,-10,-3,-3,-2,-2,3,1,-4,-2,-1,-32,-1,-31,11,7,4,-7,-13,19,-27,-25,18,2,-5,17,-12,-12,9,-9,-8,2,-15,-13,9,5,8,-4,3,3,-3,2,7,0,-2,1,0,3,1,-4,5,2,-3,-48,-31,-17,19,7,12,-21,-8,10,-27,-7,7,-2,-2,-3,-17,-8,1,-19,-6,13,-10,1,6,4,10,1,-2,2,3,5,5,2,-3,-3,1,-1,5,-1,1,5,2,-364,-208,-156,-271,-152,-119,-40,-22,-89,-129,-81,-8,-22,-19,-52,-69,-39,-6,-18,-3,-37,-60,-42,-2,-41,-13,-60,-110,-39,-11,-21,-9,-32,-67,-19,-6,-20,-4,-28,-43,-20,-5,24,26,-2,3,18,-15,-3,16,29,-1,-8,-11,-6,14,18,7,-1,-7,3,2,11,-8,-7,-4,-4,2,-2,6,5,-4,2,7,2,9,2,-4,-6,-5,-4,-3,3,0
28,28168,"Vellón, El",1101,55,35,20,44,20,24,11,6,20,19,2,-4,6,5,16,10,-1,-1,5,1,4,9,3,-3,14,9,10,7,4,0,5,5,7,3,0,0,9,4,3,4,4,0,-5,-1,-4,33,19,14,-14,8,-3,-2,7,0,-8,5,-1,0,3,1,-6,3,-2,-2,4,-1,6,9,12,3,3,0,4,7,7,0,1,0,2,2,5,3,2,0,46,38,8,31,19,12,9,7,24,8,-4,2,4,4,21,10,-2,1,5,3,3,-2,-2,1,3,9,12,6,1,0,1,4,9,5,0,0,2,5,3,1,1,0,61,27,34,41,27,14,19,16,10,5,9,2,9,9,2,2,4,1,10,7,8,3,5,1,6,6,18,11,0,0,5,6,8,8,0,0,1,0,10,3,0,0,28,23,5,32,16,16,1,1,15,-1,12,1,-1,7,12,-1,8,0,2,-6,3,0,4,1,6,5,16,3,2,0,2,3,9,1,1,0,4,2,7,2,1,0,41,25,16,34,21,13,-9,6,20,15,8,0,-1,2,7,10,5,2,-8,4,13,5,3,-2,3,8,9,10,3,1,3,4,4,8,1,1,0,4,5,2,2,0,69,42,27,55,30,25,-2,12,46,6,7,0,-1,4,27,3,10,-2,-1,8,19,3,-3,2,12,10,20,11,1,1,7,7,11,4,1,0,5,3,9,7,0,1,114,66,48,67,31,36,13,25,49,16,7,0,10,10,24,11,6,2,3,15,25,5,1,-2,16,14,22,8,4,2,10,2,13,1,4,0,6,12,9,7,0,2,177,90,87,70,34,36,33,31,79,29,0,3,15,10,47,11,2,3,18,21,32,18,-2,0,17,17,23,11,2,0,9,7,11,5,2,0,8,10,12,6,0,0,33,18,15,26,10,16,-9,3,8,23,4,4,-4,3,1,12,1,3,-5,0,7,11,3,1,4,6,8,3,3,2,2,0,5,2,0,1,2,6,3,1,3,1,67,20,47,12,-2,14,17,9,32,0,7,1,11,3,9,-6,4,-2,6,6,23,6,3,3,6,4,-2,2,0,1,2,2,-4,-3,1,0,4,2,2,5,-1,1,2,12,-10,13,7,6,-15,12,3,5,4,-4,-2,3,6,6,1,-1,-13,9,-3,-1,3,-3,0,7,3,0,5,-1,1,1,2,1,2,0,-1,6,1,-1,3,-1,56,25,31,10,5,5,5,7,15,13,16,2,-4,3,5,12,10,2,9,4,10,1,6,0,0,4,3,1,0,0,0,2,1,1,0,0,0,2,2,0,0,0,-27,-10,-17,-8,-4,-4,-1,2,-6,-6,-10,-3,4,-3,-2,-4,-4,0,-5,5,-4,-2,-6,-3,-2,0,-2,-2,-2,0,-2,0,0,-2,0,0,0,0,-2,0,-2,0,-12,-3,-9,8,6,2,-12,10,-10,-9,7,2,-7,2,0,-2,2,1,-5,8,-10,-7,5,1,-1,1,3,1,3,0,-1,0,3,1,2,0,0,1,0,0,1,0,12,15,-3,-35,-27,-8,14,6,-10,-13,10,1,8,7,-3,-7,8,1,6,-1,-7,-6,2,0,0,-1,-8,-14,-6,-6,0,-1,-7,-11,-4,-4,0,0,-1,-3,-2,-2,-27,-3,-24,0,1,-1,-28,-6,3,2,-1,2,-14,-6,4,9,-2,5,-14,0,-1,-7,1,-3,-1,3,2,-3,0,-1,1,1,2,-3,0,0,-2,2,0,0,0,-1,89,34,55,25,9,16,13,6,36,31,8,-4,4,2,17,10,2,1,9,4,19,21,6,-5,6,5,5,2,4,3,5,2,1,-2,1,2,1,3,4,4,3,1
28,28169,Venturada,734,81,47,34,14,8,6,10,12,33,18,5,3,2,8,19,13,4,1,8,4,14,5,1,2,0,1,6,2,1,4,0,1,3,1,1,2,0,0,3,1,0,2,31,11,20,7,3,4,7,-2,11,9,7,-1,2,-5,5,5,5,-1,5,3,6,4,2,0,1,1,4,1,0,0,0,0,3,0,0,0,1,1,1,1,0,0,62,28,34,5,1,4,15,6,7,25,8,1,7,2,3,11,4,1,8,4,4,14,4,0,0,0,4,1,0,0,0,0,1,0,0,0,0,0,3,1,0,0,66,30,36,9,4,5,15,4,33,14,3,-1,3,3,15,9,3,-2,12,1,18,5,0,1,1,4,4,0,0,0,0,2,2,0,0,0,1,2,2,0,0,0,132,71,61,23,12,11,18,21,44,28,13,5,3,15,23,19,8,0,15,6,21,9,5,5,8,3,4,6,0,1,4,1,1,5,0,0,4,2,3,1,0,1,97,49,48,4,0,4,16,9,41,22,8,-1,8,3,21,12,3,1,8,6,20,10,5,-2,-2,2,3,0,1,0,0,0,1,-1,0,0,-2,2,2,1,1,0,126,55,71,15,4,11,35,11,21,48,7,5,16,7,9,24,1,0,19,4,12,24,6,5,5,5,4,2,-2,0,1,2,2,0,-1,0,4,3,2,2,-1,0,31,17,14,15,2,13,14,4,-5,17,4,-3,11,2,-1,7,2,-3,3,2,-4,10,2,0,1,9,2,3,0,1,1,1,0,0,0,0,0,8,2,3,0,1,63,29,34,19,10,9,8,7,7,18,10,9,4,4,5,5,4,5,4,3,2,13,6,4,5,1,1,5,4,3,1,1,1,3,2,2,4,0,0,2,2,1,50,31,19,8,4,4,14,-1,8,28,-4,7,14,-2,4,16,-2,2,0,1,4,12,-2,5,2,1,0,5,0,0,2,0,0,2,0,0,0,1,0,3,0,0,119,63,56,24,8,16,30,3,35,32,17,2,10,2,21,20,8,2,20,1,14,12,9,0,5,5,7,3,4,0,-1,1,4,2,2,0,6,4,3,1,2,0,29,22,7,4,1,3,13,10,8,-8,4,0,7,6,2,0,5,2,6,4,6,-8,-1,-2,0,3,3,-3,0,0,0,2,1,-2,0,0,0,1,2,-1,0,0,70,41,29,4,3,1,21,-2,7,15,15,15,15,-2,4,7,10,7,6,0,3,8,5,8,4,1,0,-2,-1,2,3,1,0,-2,0,1,1,0,0,0,-1,1,4,11,-7,-4,0,-4,-4,-7,-2,14,-3,2,-6,2,1,9,0,2,2,-9,-3,5,-3,0,2,-7,2,-2,-1,0,2,-2,0,-1,-1,0,0,-5,2,-1,0,0,32,33,-1,-4,-3,-1,-1,0,5,22,2,4,8,3,7,12,0,3,-9,-3,-2,10,2,1,-2,-1,2,-2,-1,0,1,0,0,-3,-1,0,-3,-1,2,1,0,0,9,6,3,-23,-8,-15,2,-8,-8,28,-2,-4,1,-2,-2,13,-3,-2,1,-6,-6,15,1,-2,-3,-4,-8,-2,-4,-2,1,-1,-4,-1,-2,-1,-4,-3,-4,-1,-2,-1,-27,-13,-14,-31,-16,-15,1,-6,-5,-8,-5,-3,2,-3,-9,3,-2,-3,-1,-3,4,-11,-3,0,-6,-2,-5,-7,-10,-2,-3,-1,-2,-5,-3,-2,-3,-1,-3,-2,-7,0,28,12,16,-14,-11,-3,3,-2,8,16,2,-2,0,-3,5,13,0,-5,3,1,3,3,2,3,-3,0,-3,-4,-2,-2,-2,-2,-1,-3,-2,-1,-1,2,-2,-1,0,-1
28,28171,Villa del Prado,3778,69,43,26,34,23,11,10,27,7,13,4,6,5,15,6,9,1,5,5,12,1,4,3,1,3,13,14,3,0,0,1,11,7,3,0,0,2,2,7,0,0,0,242,155,87,143,103,40,27,52,88,33,26,13,17,32,63,20,17,4,10,20,25,13,9,9,19,46,55,16,6,1,13,35,39,11,5,0,6,11,16,5,1,1,451,251,200,259,154,105,112,87,128,76,26,21,68,48,68,41,17,9,44,39,60,35,9,12,59,76,76,43,4,0,33,44,45,28,3,0,26,32,31,15,1,0,350,168,182,170,99,71,74,70,68,71,50,15,36,27,43,34,23,5,38,43,25,37,27,10,47,55,42,19,3,2,24,32,32,9,1,1,23,23,10,10,2,1,382,200,182,142,101,41,48,44,93,59,28,110,29,35,68,32,13,23,19,9,25,27,15,87,19,43,54,16,7,3,9,33,45,10,4,0,10,10,9,6,3,3,336,175,161,117,64,53,60,36,77,71,22,67,28,25,35,47,10,28,32,11,42,24,12,39,25,30,35,19,2,6,8,21,21,12,1,1,17,9,14,7,1,5,207,108,99,103,60,43,57,42,39,46,8,14,25,20,23,21,8,8,32,22,16,25,0,6,18,43,28,13,3,-2,6,24,18,10,2,0,12,19,10,3,1,-2,278,156,122,192,120,72,34,94,52,59,14,25,4,52,36,40,8,16,30,42,16,19,6,9,32,80,49,28,4,-2,12,46,38,22,1,0,20,34,11,6,3,-2,130,73,57,115,67,48,33,32,27,17,10,6,25,19,15,7,5,0,8,13,12,10,5,6,48,38,14,13,0,0,29,22,8,5,2,0,19,16,6,8,-2,0,109,51,58,63,28,35,27,27,37,-3,11,7,11,12,26,-1,3,0,16,15,11,-2,8,7,15,22,18,6,-1,2,9,8,10,2,-1,0,6,14,8,4,0,2,-9,-43,34,-29,-33,4,-8,7,-16,-27,13,14,-4,-3,-25,-24,5,7,-4,10,9,-3,8,7,-6,9,-14,-19,-1,0,-6,0,-10,-17,0,0,0,9,-4,-2,-1,0,26,27,-1,35,22,13,12,-2,3,1,-2,12,12,-3,11,-3,-1,10,0,1,-8,4,-1,2,12,12,8,1,2,0,12,5,5,-2,2,0,0,7,3,3,0,0,-42,-45,3,-22,-24,2,-10,-15,-18,-13,9,5,-10,-13,-17,-9,3,1,0,-2,-1,-4,6,4,-2,1,-14,-9,0,2,-3,0,-11,-11,1,0,1,1,-3,2,-1,2,-38,-46,8,-24,-23,-1,-27,2,-28,-5,3,22,-12,-5,-17,-14,0,4,-15,7,-11,9,3,18,-5,5,-17,-4,-1,-1,0,-1,-11,-9,-1,0,-5,6,-6,5,0,-1,-95,-61,-34,-63,-50,-13,-15,-19,-43,-28,-18,30,-9,-10,-27,-13,-11,10,-6,-9,-16,-15,-7,20,-3,-5,-29,-17,-10,1,-6,-4,-20,-15,-7,2,3,-1,-9,-2,-3,-1,-88,-73,-15,-105,-87,-18,1,-12,-45,-45,0,14,2,3,-46,-32,-8,9,-1,-15,1,-13,8,5,-11,-5,-41,-35,-13,-1,-10,1,-36,-28,-14,-1,-1,-6,-5,-7,1,0,56,28,28,18,7,11,26,-4,15,3,7,8,12,0,8,2,1,5,14,-4,7,1,6,3,3,9,2,-2,4,1,3,2,2,-3,1,1,0,7,0,1,3,0,59,-2,61,10,4,6,16,1,-13,11,8,35,2,-3,-14,2,2,7,14,4,1,9,6,28,0,14,-2,-7,2,3,1,6,-1,-3,0,1,-1,8,-1,-4,2,2
28,28172,Villalbilla,3838,302,147,155,26,7,19,71,42,89,65,25,7,36,15,41,32,17,4,35,27,48,33,8,3,4,6,5,5,4,1,1,1,1,2,1,1,3,5,4,3,3,0,447,208,239,50,23,27,123,65,132,97,26,0,56,22,61,51,14,2,67,43,71,46,12,-2,13,13,10,11,2,1,8,3,4,6,1,1,5,10,6,5,1,0,457,228,229,38,23,15,136,46,144,94,17,11,72,25,54,59,4,6,64,21,90,35,13,5,10,12,12,3,0,0,7,8,5,2,0,0,3,4,7,1,0,0,294,162,132,36,15,21,72,20,116,60,8,7,39,15,50,37,10,1,33,5,66,23,-2,6,6,4,11,10,4,1,3,2,4,4,1,1,3,2,7,6,3,0,317,166,151,71,37,34,63,45,102,74,5,23,32,17,58,39,5,12,31,28,44,35,0,11,9,16,24,13,4,3,3,9,13,7,2,2,6,7,11,6,2,1,156,61,95,46,22,24,10,10,62,39,18,7,-13,-3,43,14,9,5,23,13,19,25,9,2,1,7,21,9,2,6,0,3,12,3,1,3,1,4,9,6,1,3,249,145,104,68,34,34,74,12,109,45,-10,11,37,24,50,34,-6,1,37,-12,59,11,-4,10,11,17,25,12,2,1,5,8,14,6,1,0,6,9,11,6,1,1,384,193,191,59,26,33,94,55,113,92,11,13,60,29,46,43,6,3,34,26,67,49,5,10,6,23,8,12,12,-2,3,11,6,2,5,-1,3,12,2,10,7,-1,344,181,163,0,-6,6,39,27,202,38,3,30,33,11,98,26,8,2,6,16,104,12,-5,28,3,-3,4,0,-6,0,1,-3,-1,-3,-1,0,2,0,5,3,-5,0,744,366,378,8,-7,15,168,44,334,164,5,16,79,13,169,99,-8,7,89,31,165,65,13,9,8,-5,6,1,-7,3,2,-7,2,1,-7,0,6,2,4,0,0,3,548,280,268,-23,-2,-21,97,64,261,96,22,4,49,27,147,39,16,-1,48,37,114,57,6,5,-2,1,3,-13,-4,-8,2,6,4,-10,-1,-3,-4,-5,-1,-3,-3,-5,460,211,249,-48,-42,-6,49,56,279,47,22,-9,13,33,136,25,2,-5,36,23,143,22,20,-4,-25,2,-10,-10,-3,-2,-16,0,-9,-13,-3,-1,-9,2,-1,3,0,-1,496,256,240,28,13,15,53,59,227,82,31,36,36,25,122,39,11,19,17,34,105,43,20,17,9,6,-4,11,6,-1,9,1,-2,4,2,-1,0,5,-2,7,4,0,120,37,83,-34,-25,-9,5,4,132,-15,-26,7,-3,-5,67,-13,-13,-1,8,9,65,-2,-13,8,-2,-8,-7,-14,-4,-3,-3,-5,-4,-11,-3,-1,1,-3,-3,-3,-1,-2,292,139,153,-22,-19,-3,64,24,107,47,6,37,34,10,31,35,11,11,30,14,76,12,-5,26,6,1,-8,-18,-3,0,-1,-2,-8,-7,-2,1,7,3,0,-11,-1,-1,219,101,118,-4,4,-8,28,5,100,55,-9,28,15,0,40,33,1,5,13,5,60,22,-10,23,-6,7,-7,-5,5,0,-1,7,-6,0,3,0,-5,0,-1,-5,2,0,224,101,123,9,8,1,54,32,56,51,-2,26,27,15,26,18,2,9,27,17,30,33,-4,17,-1,9,12,-11,-3,1,0,5,12,-10,-1,1,-1,4,0,-1,-2,0,250,119,131,24,14,10,57,4,60,71,28,23,36,6,28,37,0,9,21,-2,32,34,28,14,-5,6,12,-1,8,1,1,5,9,-4,2,-1,-6,1,3,3,6,2
28,28173,Villamanrique de Tajo,606,26,18,8,38,26,12,-4,9,12,6,5,-2,-4,6,11,5,2,-2,0,3,1,1,3,0,0,10,17,6,4,1,0,6,13,5,2,0,0,4,4,1,2,1,22,15,7,34,25,9,-4,6,8,10,2,0,-3,2,7,8,1,0,-1,4,1,2,1,0,0,10,14,9,1,0,0,6,12,6,1,0,0,4,2,3,0,0,19,5,14,43,29,14,3,13,0,-6,7,2,-2,9,-1,-5,4,0,5,4,1,-1,3,2,4,17,15,4,3,0,2,11,11,3,2,0,2,6,4,1,1,0,19,13,6,31,16,15,4,6,-4,3,9,0,1,5,-4,2,7,1,3,1,0,1,2,-1,6,11,8,2,3,1,3,5,5,1,2,0,3,6,3,1,1,1,31,22,9,31,19,12,6,9,9,7,4,-5,6,7,4,4,3,-2,0,2,5,3,1,-3,3,12,12,5,0,-1,3,7,7,2,0,0,0,5,5,3,0,-1,21,11,10,20,10,10,8,0,13,3,1,-3,5,-2,6,4,1,-2,3,2,7,-1,0,-1,4,7,3,4,2,0,2,3,0,4,1,0,2,4,3,0,1,0,39,25,14,29,18,11,6,10,10,12,1,-3,3,4,10,6,1,-1,3,6,0,6,0,-2,4,12,6,6,2,-1,2,6,5,4,1,0,2,6,1,2,1,-1,12,1,11,23,14,9,-6,14,2,0,3,-2,-4,4,1,-4,1,2,-2,10,1,4,2,-4,1,10,7,2,3,0,1,3,7,1,2,0,0,7,0,1,1,0,16,17,-1,6,2,4,10,-4,3,4,1,-1,9,0,3,5,0,-2,1,-4,0,-1,1,1,2,3,2,0,-1,0,0,2,1,0,-1,0,2,1,1,0,0,0,2,6,-4,12,6,6,-3,1,0,-2,3,3,0,-1,3,-1,3,2,-3,2,-3,-1,0,1,3,3,3,1,1,1,2,0,3,0,1,0,1,3,0,1,0,1,7,4,3,3,1,2,-5,6,-3,1,5,4,-4,3,0,2,2,2,-1,3,-3,-1,3,2,0,1,1,1,0,0,0,0,0,1,0,0,0,1,1,0,0,0,-8,-6,-2,5,4,1,-1,-6,0,1,-1,1,-1,-5,2,-1,-2,1,0,-1,-2,2,1,0,0,0,2,0,2,1,0,0,2,0,1,1,0,0,0,0,1,0,10,3,7,7,4,3,4,3,7,-1,-3,1,0,5,2,-1,-1,-1,4,-2,5,0,-2,2,2,2,3,0,0,0,1,2,1,0,0,0,1,0,2,0,0,0,-13,-3,-10,1,0,1,-2,-5,-3,-8,2,3,0,-1,-1,-3,0,2,-2,-4,-2,-5,2,1,1,1,0,-1,0,0,0,1,0,-1,0,0,1,0,0,0,0,0,1,4,-3,5,3,2,-1,0,-2,1,0,2,-3,3,-2,3,1,1,2,-3,0,-2,-1,1,3,1,1,1,-1,0,2,1,0,1,-1,0,1,0,1,0,0,0,-5,-7,2,-3,-4,1,-2,-3,7,-10,3,-1,-1,1,4,-9,0,-2,-1,-4,3,-1,3,1,-1,0,1,-2,0,-1,-1,0,1,-2,-1,-1,0,0,0,0,1,0,-5,-2,-3,1,-2,3,-6,0,-5,-2,3,4,-3,-1,-2,-1,2,3,-3,1,-3,-1,1,1,0,0,1,-2,0,1,-1,0,0,-1,0,0,1,0,1,-1,0,1,19,5,14,6,6,0,3,6,3,3,0,3,1,5,-1,1,-1,0,2,1,4,2,1,3,0,1,2,3,0,0,1,1,2,2,0,0,-1,0,0,1,0,0
28,28174,Villamanta,1503,100,49,51,26,15,11,19,5,33,15,8,19,7,4,17,8,8,4,12,1,16,7,0,15,4,3,12,6,1,0,3,1,7,3,1,0,1,2,5,3,0,0,62,31,31,21,12,9,11,12,13,19,4,3,5,8,4,9,3,2,6,4,9,10,1,1,3,6,7,5,0,0,1,5,4,2,0,0,2,1,3,3,0,0,69,28,41,29,15,14,12,6,19,17,7,8,5,3,8,7,2,3,7,3,11,10,5,5,5,4,14,5,1,0,3,2,7,3,0,0,2,2,7,2,1,0,78,34,44,31,23,8,6,10,20,8,-1,33,5,5,10,6,2,5,1,5,10,2,-3,28,3,14,6,7,1,0,3,7,7,5,1,0,0,7,-1,2,0,0,96,55,41,59,35,24,24,20,27,18,8,-2,7,13,18,14,4,-2,17,7,9,4,4,0,7,19,19,13,1,0,4,12,11,8,0,0,3,7,8,5,1,0,97,37,60,39,22,17,7,29,36,7,8,7,3,11,13,8,3,-2,4,18,23,-1,5,9,8,8,13,7,3,0,3,5,7,7,0,0,5,3,6,0,3,0,112,57,55,23,15,8,3,8,23,2,0,74,1,11,20,4,2,18,2,-3,3,-2,-2,56,4,13,4,2,0,0,2,9,4,0,0,0,2,4,0,2,0,0,191,73,118,37,23,14,12,19,22,20,13,104,11,9,9,11,7,25,1,10,13,9,6,79,5,14,7,7,3,1,5,7,7,4,0,0,0,7,0,3,3,1,136,56,80,43,26,17,14,24,10,11,11,68,7,16,2,6,5,22,7,8,8,5,6,46,10,16,9,3,4,0,8,11,4,3,0,0,2,5,5,0,4,0,69,31,38,22,10,12,0,-1,8,5,4,54,1,-5,6,4,6,18,-1,4,2,1,-2,36,6,5,7,4,0,0,3,3,3,1,0,0,3,2,4,3,0,0,69,19,50,21,8,13,4,0,18,-3,-7,55,4,-1,8,-2,-4,14,0,1,10,-1,-3,41,3,6,8,3,0,1,0,4,3,1,0,0,3,2,5,2,0,1,44,16,28,12,0,12,-3,-11,2,10,2,44,0,-6,2,6,3,11,-3,-5,0,4,-1,33,3,3,2,3,-1,2,1,0,0,0,-1,0,2,3,2,3,0,2,44,4,40,4,4,0,-7,7,3,17,-1,23,-10,0,5,4,1,5,3,7,-2,13,-2,18,0,3,2,1,-1,-1,0,1,2,1,0,0,0,2,0,0,-1,-1,55,29,26,6,2,4,2,7,2,-2,4,43,4,2,-2,5,4,18,-2,5,4,-7,0,25,1,3,2,-1,0,1,1,1,0,-1,1,0,0,2,2,0,-1,1,59,27,32,7,5,2,-4,1,-2,-1,2,62,-5,2,4,-1,-4,30,1,-1,-6,0,6,32,-1,2,4,0,1,1,0,1,2,1,0,1,-1,1,2,-1,1,0,4,-6,10,-29,-16,-13,-1,5,-29,-21,-3,53,1,1,-18,-12,2,20,-2,4,-11,-9,-5,33,-1,9,-12,-10,-11,-5,-2,5,-7,-5,-6,-2,1,4,-5,-5,-5,-3,33,6,27,-1,-6,5,-3,-3,1,7,4,30,-3,0,0,2,0,7,0,-3,1,5,4,23,1,0,-1,-1,0,0,-1,0,-2,-2,-1,0,2,0,1,1,1,0,55,33,22,7,2,5,5,12,-1,11,-7,34,10,7,3,7,-7,12,-5,5,-4,4,0,22,1,3,3,-1,1,0,1,1,0,-1,1,0,0,2,3,0,0,0
28,28176,Villanueva de la Cañada,9966,687,302,385,411,176,235,156,100,188,179,31,25,70,34,74,86,17,15,86,66,114,93,14,10,70,84,140,102,9,4,37,28,57,45,5,2,33,56,83,57,4,2,560,260,300,350,152,198,140,82,173,124,20,15,73,38,70,64,11,2,67,44,103,60,9,13,61,82,127,67,9,3,33,37,52,28,0,1,28,45,75,39,9,2,550,222,328,396,166,230,144,98,173,87,6,27,78,30,78,30,-3,4,66,68,95,57,9,23,87,99,102,74,22,9,47,39,41,27,9,2,40,60,61,47,13,7,787,381,406,464,215,249,228,137,161,186,29,37,113,87,59,93,19,6,115,50,102,93,10,31,98,102,128,102,23,9,49,52,51,45,11,6,49,50,77,57,12,3,500,178,322,193,54,139,139,75,128,101,5,34,41,14,68,31,5,11,98,61,60,70,0,23,21,54,65,38,10,4,6,16,25,3,1,2,15,38,40,35,9,2,866,438,428,261,94,167,235,101,227,220,24,31,141,49,106,106,19,9,94,52,121,114,5,22,30,70,79,71,8,3,18,25,29,21,2,-1,12,45,50,50,6,4,936,413,523,493,193,300,227,173,241,215,33,31,112,68,101,100,18,3,115,105,140,115,15,28,62,144,155,105,22,4,27,57,61,38,8,1,35,87,94,67,14,3,379,197,182,319,148,171,116,117,46,45,-27,67,63,58,19,47,-15,12,53,59,27,-2,-12,55,72,111,72,49,9,2,35,49,24,34,2,1,37,62,48,15,7,1,285,129,156,124,77,47,110,63,42,35,-22,45,41,45,34,-2,-5,5,69,18,8,37,-17,40,23,61,47,-3,-6,-1,17,32,30,-9,4,0,6,29,17,6,-10,-1,422,195,227,195,86,109,172,37,23,126,19,41,92,21,-4,60,12,13,80,16,27,66,7,28,58,41,55,28,8,2,33,18,23,12,0,0,25,23,32,16,8,2,458,207,251,66,11,55,139,71,48,115,33,33,84,28,0,68,20,6,55,43,48,47,13,27,16,29,0,15,1,1,11,9,-12,3,0,-1,5,20,12,12,1,2,422,199,223,69,11,58,135,47,41,106,12,54,67,24,15,67,2,15,68,23,26,39,10,39,28,43,-5,1,1,-7,17,15,-9,-9,-5,-2,11,28,4,10,6,-5,308,140,168,58,30,28,59,147,-20,76,3,35,18,81,-29,44,6,14,41,66,9,32,-3,21,-14,111,-17,-24,0,-1,-7,59,-18,-6,3,-2,-7,52,1,-18,-3,1,130,70,60,-122,-59,-63,117,-9,-30,-1,-29,63,85,-16,-9,-6,-6,15,32,7,-21,5,-23,48,-7,9,-51,-39,-36,-1,4,-1,-30,-21,-10,-2,-11,10,-21,-18,-26,1,321,174,147,108,48,60,101,62,-7,99,-6,62,46,35,0,55,5,28,55,27,-7,44,-11,34,9,97,-12,7,-3,6,3,42,1,4,-2,-1,6,55,-13,3,-1,7,350,150,200,113,34,79,148,41,-11,93,-21,85,79,9,-10,48,-8,23,69,32,-1,45,-13,62,37,60,8,9,-11,4,14,18,11,-3,-11,2,23,42,-3,12,0,2,645,306,339,103,33,70,224,90,57,147,29,85,121,38,19,76,14,36,103,52,38,71,15,49,30,62,-3,-4,11,6,18,27,-6,-9,5,-2,12,35,3,5,6,8,633,286,347,145,28,117,218,75,30,209,19,54,100,42,9,103,0,17,118,33,21,106,19,37,31,55,21,28,4,-2,7,20,1,8,-12,0,24,35,20,20,16,-2
28,28177,Villanueva del Pardillo,4042,548,270,278,106,61,45,94,89,227,53,33,45,51,49,114,27,16,9,43,40,113,26,17,36,16,41,30,13,5,0,10,30,14,5,2,0,6,11,16,8,3,0,911,449,462,162,83,79,114,107,401,162,74,37,56,50,198,89,35,10,58,57,203,73,39,27,34,45,44,24,10,2,18,26,25,9,4,0,16,19,19,15,6,2,1224,596,628,190,111,79,187,125,557,195,61,63,81,55,296,97,26,21,106,70,261,98,35,42,37,54,60,30,5,3,19,29,45,15,2,0,18,25,15,15,3,3,1057,516,541,208,94,114,171,127,498,155,45,38,88,55,239,83,20,12,83,72,259,72,25,26,40,62,68,25,7,5,19,28,27,12,4,3,21,34,41,13,3,2,1556,735,821,262,115,147,233,150,711,271,86,51,108,69,343,144,38,13,125,81,368,127,48,38,33,72,94,45,10,7,13,29,45,24,3,1,20,43,49,21,7,6,1796,866,930,327,158,169,298,139,854,308,71,66,148,56,409,170,23,33,150,83,445,138,48,33,48,87,111,52,14,11,28,35,50,33,4,6,20,52,61,19,10,5,907,405,502,371,154,217,82,162,445,97,70,20,23,64,213,55,27,8,59,98,232,42,43,12,68,109,115,55,20,1,30,42,50,24,6,1,38,67,65,31,14,0,447,208,239,398,186,212,26,113,194,57,26,35,18,36,98,33,17,14,8,77,96,24,9,21,45,129,119,76,21,5,20,57,59,34,15,2,25,72,60,42,6,3,37,-8,45,69,19,50,-9,36,43,-56,-7,26,-8,22,18,-39,-11,11,-1,14,25,-17,4,15,20,48,-7,6,-3,1,9,25,-6,-6,-7,1,11,23,-1,12,4,0,212,96,116,39,-12,51,-7,47,124,-5,28,19,7,17,71,-15,3,9,-14,30,53,10,25,10,-6,28,15,-7,8,-5,-4,6,0,-16,0,-1,-2,22,15,9,8,-4,224,90,134,4,-9,13,25,28,86,42,16,21,28,7,26,1,4,16,-3,21,60,41,12,5,-1,14,-7,-11,8,1,-4,6,-9,-9,5,2,3,8,2,-2,3,-1,135,53,82,14,3,11,29,30,83,-28,8,5,12,13,40,-19,7,1,17,17,43,-9,1,4,6,21,7,-17,1,-8,5,6,3,-9,1,-3,1,15,4,-8,0,-5,-30,-65,35,-25,-28,3,-29,20,52,-90,1,13,-12,6,-9,-50,-1,2,-17,14,61,-40,2,11,3,3,10,-43,-1,5,5,0,-5,-27,-1,1,-2,3,15,-16,0,4,-50,-2,-48,-31,-21,-10,-30,35,-5,-6,-32,-11,-16,18,-1,15,-16,-3,-14,17,-4,-21,-16,-8,-11,14,-10,-14,-8,-4,-4,8,-11,-9,-4,-2,-7,6,1,-5,-4,-2,-43,9,-52,45,24,21,-84,24,21,-57,25,27,-31,7,31,-32,23,9,-53,17,-10,-25,2,18,1,19,5,9,7,1,-1,7,6,9,2,0,2,12,-1,0,5,1,91,25,66,39,-6,45,-4,22,62,8,-18,17,7,3,30,-1,-20,7,-11,19,32,9,2,10,3,26,10,0,-4,2,-3,9,2,-8,-6,-1,6,17,8,8,2,3,-21,-51,30,-12,-22,10,-17,4,17,-69,-19,55,-15,7,-9,-44,-19,23,-2,-3,26,-25,0,32,-1,17,-9,-29,-10,17,-6,12,-5,-22,-10,6,5,5,-4,-7,0,11,34,-4,38,127,48,79,-62,40,61,-53,4,33,-30,5,22,-29,8,15,-32,35,39,-24,-4,18,15,43,29,15,16,7,9,14,7,2,14,1,6,29,22,13,2,6
28,28179,Villar del Olmo,1290,71,39,32,9,3,6,10,12,19,23,-2,9,5,7,6,17,-1,5,5,5,13,6,-1,4,2,1,3,3,0,0,1,0,1,1,0,0,1,1,2,2,0,0,35,20,15,26,10,16,-6,20,16,-1,4,1,-2,10,8,2,2,0,-4,10,8,-3,2,1,4,13,3,4,1,0,0,6,1,3,0,0,4,7,2,1,1,0,65,45,20,35,19,16,1,20,35,8,-1,-1,-3,18,22,9,-2,0,4,2,13,-1,1,-1,1,17,14,3,0,0,1,7,8,3,0,0,0,10,6,0,0,0,70,37,33,64,35,29,3,20,33,7,5,-1,-2,5,28,3,4,-2,5,15,5,4,1,1,17,20,19,7,1,0,10,8,14,3,0,0,7,12,5,4,1,0,63,44,19,49,30,19,14,25,20,1,-4,5,8,20,11,4,-4,3,6,5,9,-3,0,2,8,23,13,6,-2,1,3,17,9,3,-2,0,5,6,4,3,0,1,57,31,26,45,25,20,15,-1,24,11,5,3,6,-2,16,8,1,3,9,1,8,3,4,0,10,13,13,6,2,1,6,9,6,3,0,1,4,4,7,3,2,0,58,22,36,43,12,31,16,-1,28,4,8,0,5,-3,16,1,3,-1,11,2,12,3,5,1,10,12,14,2,5,0,2,3,5,1,1,0,8,9,9,1,4,0,82,62,20,32,20,12,12,3,25,19,12,7,11,7,18,14,7,4,1,-4,7,5,5,3,3,7,12,7,3,0,2,4,8,5,1,0,1,3,4,2,2,0,35,16,19,30,17,13,13,1,4,13,-2,6,7,0,2,5,-2,2,6,1,2,8,0,4,3,10,10,2,2,2,2,6,7,0,0,1,1,4,3,2,2,1,36,5,31,20,9,11,9,0,22,-5,8,2,-2,-1,4,-3,3,4,11,1,18,-2,5,-2,7,6,6,0,1,0,4,3,2,0,0,0,3,3,4,0,1,0,4,18,-14,11,6,5,-6,4,-10,16,-1,-2,0,7,1,10,-1,-1,-6,-3,-11,6,0,-1,1,4,4,0,1,0,0,2,3,0,0,0,1,2,1,0,1,0,-8,-12,4,4,-1,5,-11,2,3,-13,9,2,-7,4,-7,-8,5,1,-4,-2,10,-5,4,1,-2,1,3,1,2,-1,-1,-1,1,0,1,-1,-1,2,2,1,1,0,-23,-19,-4,6,3,3,3,-13,-2,5,-6,-4,3,-8,-8,4,-3,-3,0,-5,6,1,-3,-1,3,0,0,2,0,1,1,0,0,1,0,1,2,0,0,1,0,0,-1,4,-5,5,3,2,0,-3,-8,6,-2,4,5,1,-7,4,-5,4,-5,-4,-1,2,3,0,-1,1,1,1,3,0,1,0,1,0,0,1,-2,1,0,1,3,-1,8,8,0,1,2,-1,3,-3,-6,9,-4,6,3,2,-4,5,-1,1,0,-5,-2,4,-3,5,-1,2,-2,0,2,0,0,2,-2,1,1,0,-1,0,0,-1,1,0,-54,-25,-29,-17,-4,-13,-21,-21,8,-19,1,-5,-11,-13,3,-4,0,-2,-10,-8,5,-15,1,-3,-3,-6,-5,-3,0,-2,-1,-1,-4,-1,0,1,-2,-5,-1,-2,0,-3,15,5,10,9,1,8,5,-2,-7,6,1,9,3,2,-8,7,-3,4,2,-4,1,-1,4,5,0,3,1,2,3,0,0,1,0,0,0,0,0,2,1,2,3,0,-15,-31,16,13,6,7,-6,3,-2,2,-6,-8,-11,0,-3,-3,-9,-7,5,3,1,5,3,-1,-2,9,5,-4,4,-1,2,2,2,-1,2,-1,-4,7,3,-3,2,0
28,28180,Villarejo de Salvanés,5581,98,38,60,48,24,24,17,23,23,19,11,2,11,12,3,5,3,3,6,11,20,14,8,-1,9,12,14,12,0,0,7,7,4,5,0,0,2,5,10,7,0,0,114,67,47,59,33,26,17,33,36,18,5,4,8,14,31,11,2,2,9,19,5,7,3,2,9,19,20,11,0,0,3,11,15,4,0,0,6,8,5,7,0,0,145,77,68,85,47,38,18,46,46,16,9,6,8,25,23,16,2,3,10,21,23,0,7,3,14,33,25,12,1,0,4,16,17,10,0,0,10,17,8,2,1,0,119,79,40,106,62,44,18,23,44,25,19,-8,8,23,31,16,9,-6,10,0,13,9,10,-2,10,33,40,15,7,0,8,20,26,6,2,0,2,13,14,9,5,0,187,99,88,134,75,59,32,57,69,16,6,5,20,29,36,6,3,3,12,28,33,10,3,2,28,40,46,17,2,1,18,24,23,10,0,0,10,16,23,7,2,1,196,112,84,131,72,59,32,38,57,48,10,6,10,28,37,24,6,5,22,10,20,24,4,1,22,34,44,25,3,3,11,21,23,14,1,2,11,13,21,11,2,1,260,143,117,162,81,81,38,75,70,49,9,15,18,36,40,29,7,10,20,39,30,20,2,5,26,50,45,29,8,3,6,20,31,15,6,2,20,30,14,14,2,1,299,178,121,194,108,86,51,78,106,53,11,-5,24,38,70,35,9,1,27,40,36,18,2,-6,19,68,68,33,4,1,6,33,43,21,3,1,13,35,25,12,1,0,191,88,103,59,29,30,32,50,68,27,9,2,7,25,38,14,3,0,25,25,30,13,6,2,10,15,21,5,6,2,3,10,13,2,1,0,7,5,8,3,5,2,-104,-71,-33,-87,-58,-29,4,-42,-17,-38,-7,-5,3,-30,-11,-22,-7,-6,1,-12,-6,-16,0,1,1,-29,-23,-28,-7,-1,3,-22,-14,-19,-5,-1,-2,-7,-9,-9,-2,0,-56,-39,-17,-102,-59,-43,-9,9,-43,-23,11,-7,-8,3,-16,-24,5,-1,-1,6,-27,1,6,-6,-22,-4,-45,-20,-7,-6,-11,-1,-25,-17,-4,-1,-11,-3,-20,-3,-3,-5,61,24,37,30,4,26,28,3,1,16,11,3,18,1,-10,6,8,3,10,2,11,10,3,0,13,8,-2,4,5,2,3,4,-7,1,3,0,10,4,5,3,2,2,-85,-47,-38,-74,-43,-31,-10,-26,-28,-1,-16,-5,-1,-12,-19,-4,-4,-6,-9,-14,-9,3,-12,1,-9,-12,-30,-11,-11,-1,0,-7,-23,-6,-6,-1,-9,-5,-7,-5,-5,0,-86,-51,-35,-94,-51,-43,5,-21,-38,-19,-10,-4,-1,-12,-21,-13,-5,-1,6,-9,-17,-6,-5,-3,-8,-16,-39,-26,-4,-1,-6,-9,-18,-18,0,0,-2,-7,-21,-8,-4,-1,-37,-20,-17,-36,-24,-12,-5,1,2,-29,-2,3,1,-6,10,-16,-3,-1,-6,7,-8,-13,1,4,0,4,-24,-15,-1,1,1,-1,-9,-15,0,0,-1,5,-15,0,-1,1,-27,-11,-16,-26,-14,-12,-12,-10,-3,-6,-1,3,-5,-8,-1,2,-1,-1,-7,-2,-2,-8,0,4,-6,-6,-4,-13,3,0,-1,-6,0,-8,1,0,-5,0,-4,-5,2,0,-39,-29,-10,-14,-3,-11,-12,3,-20,-12,0,6,-10,1,-14,-6,1,-1,-2,2,-6,-6,-1,7,-4,3,-1,-13,-1,2,-2,4,2,-7,0,0,-2,-1,-3,-6,-1,2,41,26,15,9,0,9,20,6,-3,21,-3,-4,13,4,2,7,-1,-1,7,2,-5,14,-2,-3,-1,8,2,2,-1,-1,-2,3,0,0,-1,0,1,5,2,2,0,-1
28,28181,Villaviciosa de Odón,18465,1191,522,669,171,68,103,262,180,225,368,64,88,130,61,89,178,33,30,132,119,136,190,31,58,25,42,60,36,7,0,14,14,26,10,3,0,11,28,34,26,4,0,693,313,380,192,79,113,128,85,146,187,75,67,58,41,56,94,45,16,70,44,90,93,30,51,39,29,64,45,12,2,19,11,24,16,6,2,20,18,40,29,6,0,853,398,455,382,164,218,160,190,142,202,46,101,80,86,70,100,27,26,80,104,72,102,19,75,50,129,117,63,16,4,20,53,50,29,8,1,30,76,67,34,8,3,1096,492,604,389,189,200,195,236,223,276,42,128,99,101,100,140,18,33,96,135,123,136,24,95,83,115,97,76,13,4,47,53,45,38,5,0,36,62,52,38,8,4,279,77,202,324,147,177,77,70,-9,62,-2,84,32,21,-21,33,-2,12,45,49,12,29,0,72,36,114,86,61,14,10,20,50,38,27,6,4,16,64,48,34,8,6,612,249,363,336,138,198,169,99,88,142,20,82,97,49,-5,71,20,11,72,50,93,71,0,71,39,131,78,62,13,7,17,49,32,29,9,0,22,82,46,33,4,7,307,57,250,328,126,202,100,76,10,60,-34,78,43,17,-12,5,-8,8,57,59,22,55,-26,70,54,97,107,42,17,8,26,34,43,15,3,5,28,63,64,27,14,3,310,126,184,235,102,133,128,45,-4,101,-21,59,48,18,6,48,-3,5,80,27,-10,53,-18,54,40,58,61,41,24,6,15,25,35,12,11,3,25,33,26,29,13,3,126,45,81,140,73,67,47,34,-11,10,-24,58,28,20,-9,8,-13,11,19,14,-2,2,-11,47,21,57,49,15,3,-6,14,25,26,10,1,-3,7,32,23,5,2,-3,129,61,68,48,19,29,44,33,-42,56,-7,44,22,19,-11,29,-8,12,22,14,-31,27,1,32,9,23,7,5,0,2,6,11,0,2,-1,0,3,12,7,3,1,2,-131,-111,-20,-162,-113,-49,15,22,-173,22,-46,37,-6,11,-90,-6,-23,3,21,11,-83,28,-23,34,-29,8,-74,-47,-15,-6,-20,1,-43,-31,-14,-6,-9,7,-31,-16,-1,0,-22,-19,-3,48,18,30,48,20,-132,3,-47,75,32,3,-52,-4,-21,14,16,17,-80,7,-26,61,5,57,-3,-12,-6,3,4,26,0,-12,-3,0,1,31,-3,0,-3,3,269,72,197,272,95,177,-6,299,-50,-7,-4,30,6,130,-52,-8,-4,-1,-12,169,2,1,0,31,-11,306,3,-13,-4,-11,-5,130,-10,-12,-4,-5,-6,176,13,-1,0,-6,-20,-12,-8,83,42,41,15,127,-145,-38,-55,64,23,79,-90,-13,-25,8,-8,48,-55,-25,-30,56,-12,160,-16,-30,-20,-4,-4,81,-12,-15,-8,-2,-8,79,-4,-15,-12,-2,133,10,123,-24,-14,-10,74,26,-68,41,-30,83,36,8,-53,2,-7,19,38,18,-15,39,-23,64,-1,12,-34,-9,-6,10,-1,4,-14,-7,-3,6,0,8,-20,-2,-3,4,243,72,171,109,30,79,89,118,-62,34,-26,78,43,49,-30,9,-15,10,46,69,-32,25,-11,68,17,124,-41,-3,-2,11,4,57,-22,-11,-4,3,13,67,-19,8,2,8,224,88,136,145,68,77,107,55,-66,75,-6,48,60,43,-45,40,-12,6,47,12,-21,35,6,42,37,75,-7,18,15,0,23,42,-7,9,1,0,14,33,0,9,14,0,137,23,114,137,59,78,81,63,-104,36,-7,68,41,26,-62,-2,0,18,40,37,-42,38,-7,50,24,89,-13,30,3,2,21,37,-13,12,3,-1,3,52,0,18,0,3
28,28183,Zarzalejo,1028,10,-2,12,25,14,11,6,3,-1,-3,1,1,1,-3,5,-10,2,1,5,6,-6,7,-1,0,10,5,6,2,0,0,5,3,4,0,0,0,5,2,2,2,0,0,56,30,26,54,36,18,8,17,18,7,3,2,6,9,8,6,-1,1,2,8,10,1,4,1,12,15,17,9,0,0,8,8,13,6,0,0,4,7,4,3,0,0,55,33,22,51,33,18,6,8,15,12,4,12,6,4,9,7,5,3,0,4,6,5,-1,9,11,11,15,11,1,2,8,8,9,7,1,0,3,3,6,4,0,2,78,42,36,49,30,19,19,15,16,23,3,0,14,9,4,13,1,0,5,6,12,10,2,0,10,14,15,6,3,0,7,10,8,4,0,0,3,4,7,2,3,0,78,51,27,35,23,12,23,14,29,11,1,-2,14,9,21,7,-1,1,9,5,8,4,2,-3,12,8,9,5,1,0,8,6,6,2,1,0,4,2,3,3,0,0,18,12,6,40,18,22,-10,4,8,3,8,4,-5,-1,7,3,3,3,-5,5,1,0,5,1,8,11,15,4,2,0,3,6,8,1,0,0,5,5,7,3,2,0,18,2,16,59,29,30,0,12,4,-2,-1,0,3,2,0,0,0,-4,-3,10,4,-2,-1,4,16,16,14,5,2,1,9,7,7,4,0,0,7,9,7,1,2,1,-1,10,-11,41,28,13,-13,-6,-10,6,10,6,-3,2,-2,5,5,1,-10,-8,-8,1,5,5,6,7,12,7,4,0,4,6,8,6,1,0,2,1,4,1,3,0,39,22,17,26,11,15,19,-6,8,17,3,-3,14,-6,-4,13,4,0,5,0,12,4,-1,-3,12,2,9,3,0,-1,8,-2,3,1,0,0,4,4,6,2,0,-1,13,5,8,-2,-5,3,5,-1,0,6,1,-4,4,1,1,1,0,-2,1,-2,-1,5,1,-2,1,2,-2,-4,-2,-1,1,0,-3,-3,0,0,0,2,1,-1,-2,-1,-7,-6,-1,11,6,5,-18,0,-3,-7,8,5,-5,-2,-3,-7,4,2,-13,2,0,0,4,3,0,4,-1,-2,0,0,2,2,0,-3,0,0,-2,2,-1,1,0,0,8,12,-4,6,1,5,9,2,0,-9,0,-2,6,1,3,-2,-1,-1,3,1,-3,-7,1,-1,-1,2,-1,-1,-1,-1,-1,0,-2,-1,-1,0,0,2,1,0,0,-1,32,7,25,2,-5,7,16,-4,9,3,-4,5,5,-5,-3,3,2,4,11,1,12,0,-6,1,-2,2,-3,-2,1,0,-1,-1,-3,-1,1,0,-1,3,0,-1,0,0,28,22,6,10,8,2,2,-5,11,12,3,0,2,0,3,14,0,-2,0,-5,8,-2,3,2,3,3,1,-3,-1,1,3,2,1,-2,-1,0,0,1,0,-1,0,1,-11,-13,2,8,3,5,2,-6,8,-14,-6,1,-1,-7,1,-7,-2,0,3,1,7,-7,-4,1,4,-1,7,-4,-4,0,2,1,4,-3,-4,0,2,-2,3,-1,0,0,29,16,13,-2,1,-3,-5,3,-2,2,10,15,4,2,2,-3,6,1,-9,1,-4,5,4,14,-2,2,-2,-3,1,-1,0,2,-1,-2,1,-1,-2,0,-1,-1,0,0,38,16,22,14,6,8,12,4,-1,6,3,7,5,3,1,-3,4,2,7,1,-2,9,-1,5,1,2,5,1,-2,0,1,1,3,-2,-1,0,0,1,2,3,-1,0,35,18,17,14,9,5,-7,7,11,4,3,12,0,3,9,-1,-3,5,-7,4,2,5,6,7,4,3,3,0,0,0,2,3,2,-1,0,0,2,0,1,1,0,0
29,29001,Alameda,4947,-1,3,-4,5,2,3,-3,-5,-5,5,2,3,3,-5,2,2,-1,0,-6,0,-7,3,3,3,0,0,2,1,2,0,0,0,1,0,1,0,0,0,1,1,1,0,-8,3,-11,8,3,5,0,1,-9,-1,7,-3,2,-2,-5,3,6,0,-2,3,-4,-4,1,-3,1,0,5,0,2,0,1,0,1,0,1,0,0,0,4,0,1,0,62,31,31,21,12,9,7,7,17,10,6,12,2,-1,21,7,1,0,5,8,-4,3,5,12,3,4,11,3,0,0,1,2,8,1,0,0,2,2,3,2,0,0,73,49,24,48,29,19,11,21,20,9,-4,13,9,18,16,5,-3,3,2,3,4,4,-1,10,9,14,16,4,2,2,5,10,11,2,0,1,4,4,5,2,2,1,41,21,20,35,19,16,9,0,6,10,7,7,3,8,-3,6,1,5,6,-8,9,4,6,2,7,3,8,9,6,2,3,3,4,5,2,2,4,0,4,4,4,0,37,19,18,56,28,28,-2,12,9,20,0,-1,0,8,-1,11,4,-3,-2,4,10,9,-4,2,4,21,15,11,4,1,1,10,9,4,3,1,3,11,6,7,1,0,24,-1,25,25,11,14,1,12,7,1,1,-1,-1,1,5,-2,1,-6,2,11,2,3,0,5,5,6,6,2,6,0,3,2,4,-1,3,0,2,4,2,3,3,0,21,4,17,36,21,15,14,-2,4,-4,7,1,11,2,-9,-1,2,-1,3,-4,13,-3,5,2,6,9,13,1,7,0,4,7,6,0,4,0,2,2,7,1,3,0,33,19,14,31,14,17,11,17,0,2,1,4,3,14,5,-2,1,1,8,3,-5,4,0,3,10,7,8,5,1,0,6,3,3,1,1,0,4,4,5,4,0,0,30,5,25,17,4,13,8,0,-5,10,10,4,3,-6,-3,4,3,2,5,6,-2,6,7,2,2,2,1,-1,8,3,-1,-1,0,-1,3,2,3,3,1,0,5,1,-9,-6,-3,16,4,12,6,-4,-1,-12,-2,-1,3,-4,3,-8,-3,1,3,0,-4,-4,1,-2,7,2,3,1,0,1,2,0,2,0,0,0,5,2,1,1,0,1,3,12,-9,31,18,13,-5,3,-1,4,-2,1,-2,3,6,5,-1,0,-3,0,-7,-1,-1,1,11,10,5,8,-1,-2,6,5,4,3,1,-1,5,5,1,5,-2,-1,-23,-13,-10,0,5,-5,-5,6,-18,4,-3,-6,-1,1,-10,4,-4,-3,-4,5,-8,0,1,-3,4,5,-6,-2,-1,0,6,4,-2,-2,-1,0,-2,1,-4,0,0,0,-49,-33,-16,-14,-7,-7,2,-7,-10,-26,-7,-7,-3,-3,-7,-20,-3,0,5,-4,-3,-6,-4,-7,-2,1,-2,-6,-6,-2,-2,0,-3,0,-2,-1,0,1,1,-6,-4,-1,2,13,-11,24,13,11,1,9,-5,0,-3,-7,6,4,-2,5,0,-3,-5,5,-3,-5,-3,-4,4,6,5,5,0,0,2,2,4,4,-1,0,2,4,1,1,1,0,-10,4,-14,0,-2,2,-9,-5,4,5,1,-3,-5,-2,13,2,-1,-1,-4,-3,-9,3,2,-2,-7,-2,3,1,4,2,-4,-1,1,1,1,1,-3,-1,2,0,3,1,-8,-11,3,-20,-16,-4,0,-8,-7,-3,9,-1,5,-6,-9,-5,5,-2,-5,-2,2,2,4,1,-4,-4,-9,-3,-1,-1,-1,-3,-9,-3,-1,-1,-3,-1,0,0,0,0,-9,-3,-6,15,8,7,-4,-4,-15,0,5,9,-6,-4,-5,0,6,6,2,0,-10,0,-1,3,5,2,2,5,1,0,1,1,2,2,2,0,4,1,0,3,-1,0
29,29002,Alcaucín,1499,31,17,14,20,11,9,7,-1,10,4,12,-1,6,0,4,-1,8,0,1,-1,6,5,4,-1,3,2,6,3,5,1,3,0,3,1,3,1,0,2,3,2,2,0,33,28,5,33,19,14,0,0,2,4,16,8,3,1,1,4,13,6,-3,-1,1,0,3,2,7,4,8,2,5,4,6,2,4,1,4,2,1,2,4,1,1,2,46,26,20,40,21,19,6,3,11,7,21,0,10,2,-1,5,13,-1,-4,1,12,2,8,1,7,5,6,8,14,0,4,2,2,4,9,0,3,3,4,4,5,0,57,28,29,47,25,22,17,3,13,14,10,0,6,4,6,8,4,0,11,-1,7,6,6,0,12,2,9,10,12,2,7,2,4,5,5,2,5,0,5,5,7,0,50,35,15,66,40,26,15,3,5,15,17,-6,16,4,1,6,10,-2,-1,-1,4,9,7,-4,18,3,14,13,17,1,13,2,9,5,11,0,5,1,5,8,6,1,123,59,64,131,63,68,21,9,9,25,41,20,13,3,3,11,22,9,8,6,6,14,19,11,24,8,11,27,41,20,11,4,6,11,21,10,13,4,5,16,20,10,210,109,101,193,94,99,28,20,18,33,84,27,16,11,13,17,39,13,12,9,5,16,45,14,30,11,25,27,78,22,15,4,12,13,37,13,15,7,13,14,41,9,179,82,97,157,77,80,35,4,22,26,71,20,15,1,11,8,34,12,20,3,11,18,37,8,20,10,22,19,68,18,8,3,14,8,33,11,12,7,8,11,35,7,126,64,62,91,46,45,15,10,11,19,51,18,9,3,3,10,29,9,6,7,8,9,22,9,11,2,9,16,43,10,6,0,3,7,24,6,5,2,6,9,19,4,102,46,56,86,40,46,4,5,18,5,48,20,1,1,15,3,19,7,3,4,3,2,29,13,8,2,9,6,51,10,5,0,5,3,22,5,3,2,4,3,29,5,107,59,48,71,35,36,14,4,5,13,42,26,6,3,6,7,17,19,8,1,-1,6,25,7,2,0,4,12,29,24,0,1,4,6,11,13,2,-1,0,6,18,11,70,36,34,65,32,33,5,11,11,25,17,2,3,10,0,16,8,-1,2,1,11,9,9,3,9,3,11,15,17,10,5,3,4,7,8,5,4,0,7,8,9,5,20,26,-6,43,28,15,0,-3,1,-7,20,8,-1,3,3,3,12,5,1,-6,-2,-10,8,3,5,3,6,0,17,10,4,3,4,-1,10,7,1,0,2,1,7,3,-6,-4,-2,27,15,12,-5,-6,-14,4,10,4,-2,-9,-7,1,7,7,-3,3,-7,3,3,-3,1,0,0,5,16,5,1,-1,-1,2,10,4,0,1,1,3,6,1,27,9,18,31,11,20,9,-9,3,3,9,11,3,-8,-4,-1,10,8,6,-1,7,4,-1,3,9,1,6,2,10,3,3,1,0,-1,6,2,6,0,6,3,4,1,19,23,-4,18,14,4,0,0,7,-10,22,-1,-2,-1,10,-2,14,3,2,1,-3,-8,8,-4,-4,-2,1,-3,17,8,-2,-1,2,-1,11,5,-2,-1,-1,-2,6,3,42,29,13,74,37,37,3,1,-3,1,29,12,2,3,-2,0,17,10,1,-2,-1,1,12,2,9,2,6,11,26,20,4,2,2,5,12,12,5,0,4,6,14,8,56,30,26,66,33,33,8,-2,1,14,34,4,5,-3,0,7,20,3,3,1,1,7,14,1,10,3,2,5,31,15,7,0,1,2,16,7,3,3,1,3,15,8
29,29005,Algarrobo,4861,-2,14,-16,16,10,6,4,0,-11,9,4,-6,8,1,-6,4,9,-2,-4,-1,-5,5,-5,-4,4,0,4,4,4,0,2,0,2,3,3,0,2,0,2,1,1,0,33,16,17,19,10,9,5,-11,24,6,9,0,5,-5,6,5,3,2,0,-6,18,1,6,-2,8,2,5,0,3,1,7,0,2,0,1,0,1,2,3,0,2,1,41,25,16,40,17,23,12,-2,17,2,11,0,7,-3,13,1,6,-1,5,1,4,1,5,1,8,6,8,8,8,2,5,1,2,4,4,1,3,5,6,4,4,1,139,84,55,52,27,25,19,26,29,23,34,8,16,10,19,12,20,6,3,16,10,11,14,2,7,5,14,7,10,9,5,2,7,2,6,5,2,3,7,5,4,4,167,83,84,118,59,59,14,20,60,31,30,11,6,8,30,18,12,7,8,12,30,13,18,4,14,16,38,21,18,11,4,4,22,13,9,7,10,12,16,8,9,4,335,168,167,249,119,130,11,37,55,31,70,133,7,18,28,8,39,68,4,19,27,23,31,65,6,21,27,20,56,119,3,11,12,7,25,61,3,10,15,13,31,58,233,121,112,198,93,105,11,13,45,23,54,85,11,13,19,13,19,45,0,0,26,10,35,40,13,17,30,20,47,70,6,10,15,10,15,36,7,7,15,10,32,34,229,121,108,212,111,101,17,23,37,29,55,69,4,14,17,21,32,30,13,9,20,8,23,39,16,31,29,19,52,63,6,17,16,14,26,31,10,14,13,5,26,32,75,43,32,109,52,57,-5,13,8,5,30,29,6,2,5,1,14,16,-11,11,3,4,16,13,12,13,13,12,25,34,9,7,10,2,7,17,3,6,3,10,18,17,125,58,67,76,34,42,19,4,26,26,28,25,6,-3,8,22,14,13,13,7,18,4,14,12,9,7,17,2,27,14,3,3,7,0,12,9,6,4,10,2,15,5,126,73,53,55,25,30,4,18,48,25,24,5,3,8,37,11,9,3,1,10,11,14,15,2,6,5,15,2,17,9,3,4,5,-1,6,7,3,1,10,3,11,2,49,41,8,61,33,28,3,19,-10,6,21,11,3,12,-1,11,12,4,0,7,-9,-5,9,7,10,9,8,9,15,10,8,4,5,4,9,3,2,5,3,5,6,7,18,-2,20,19,3,16,-10,16,-3,10,9,-1,-11,8,-3,5,7,-6,1,8,0,5,2,5,4,3,3,-1,4,5,1,-1,-1,-1,3,1,3,4,4,0,1,4,-31,-30,-1,-1,-11,10,4,-14,-26,-10,4,12,-4,-6,-19,-3,-5,7,8,-8,-7,-7,9,5,2,3,-1,-5,3,-3,-2,0,-3,-1,-1,-4,4,3,2,-4,4,1,38,17,21,32,17,15,1,11,-14,18,13,6,-1,7,-3,5,6,1,2,4,-11,13,7,5,6,2,6,6,7,4,5,-1,4,2,5,2,1,3,2,4,2,2,36,20,16,9,9,0,16,8,-23,5,8,20,5,6,-8,-2,7,12,11,2,-15,7,1,8,1,0,-8,-3,10,8,2,1,-5,-1,6,5,-1,-1,-3,-2,4,3,48,19,29,21,12,9,7,8,-7,7,20,13,5,0,-8,12,3,6,2,8,1,-5,17,7,-2,5,1,-4,10,11,-1,4,0,0,2,7,-1,1,1,-4,8,4,84,42,42,68,44,24,4,22,0,21,30,11,-2,14,1,13,12,7,6,8,-1,8,18,4,12,15,13,5,19,4,6,9,8,5,11,5,6,6,5,0,8,-1
29,29007,Alhaurín de la Torre,20192,859,440,419,184,96,88,190,83,246,196,84,50,91,45,114,117,43,26,99,38,132,79,41,24,38,18,45,37,31,11,16,7,21,20,22,7,22,11,24,17,9,4,829,401,428,234,113,121,188,80,219,214,76,47,101,32,96,111,30,28,87,48,123,103,46,19,72,18,46,62,24,11,32,12,22,28,12,7,40,6,24,34,12,4,1258,654,604,354,193,161,272,137,363,259,135,73,155,69,173,139,76,33,117,68,190,120,59,40,84,28,82,73,71,14,50,12,42,36,40,11,34,16,40,37,31,3,1271,616,655,366,178,188,313,99,385,236,127,92,148,46,165,142,63,46,165,53,220,94,64,46,93,24,73,80,67,27,44,5,34,46,34,15,49,19,39,34,33,12,1408,719,689,430,216,214,259,175,411,302,171,67,133,85,203,161,93,37,126,90,208,141,78,30,87,48,89,98,82,22,38,21,48,51,45,10,49,27,41,47,37,12,1558,776,782,454,217,237,314,206,458,291,191,80,146,96,243,147,98,33,168,110,215,144,93,47,88,68,94,106,83,13,38,33,45,49,42,8,50,35,49,57,41,5,1483,782,701,307,151,156,314,159,521,269,116,91,183,76,264,168,47,34,131,83,257,101,69,57,45,61,81,54,49,16,24,29,42,27,24,5,21,32,39,27,25,11,1338,589,749,244,94,150,317,151,388,232,114,98,155,49,199,80,51,34,162,102,189,152,63,64,63,37,52,32,40,18,29,9,19,11,15,9,34,28,33,21,25,9,1247,605,642,179,86,93,337,98,388,207,88,96,160,34,191,111,46,44,177,64,197,96,42,52,38,35,28,43,20,14,20,14,10,22,13,7,18,21,18,21,7,7,483,221,262,4,-5,9,102,22,182,44,50,66,58,12,71,20,20,30,44,10,111,24,30,36,12,-6,-10,-12,7,10,8,-4,-12,-2,-4,8,4,-2,2,-10,11,2,585,247,338,36,12,24,169,-5,197,115,53,43,93,-10,73,44,26,5,76,5,124,71,27,38,-1,0,1,18,18,0,-2,-2,2,9,7,-3,1,2,-1,9,11,3,442,223,219,14,-6,20,79,39,171,88,23,42,27,11,112,51,5,15,52,28,59,37,18,27,-3,4,8,-9,4,8,-5,3,3,-7,-3,4,2,1,5,-2,7,4,442,206,236,-16,-32,16,148,-22,138,102,46,12,64,-26,65,64,14,18,84,4,73,38,32,-6,24,-4,-17,-16,-2,-1,9,-12,-22,-10,0,2,15,8,5,-6,-2,-3,373,161,212,-110,-75,-35,100,-9,97,80,30,54,60,-25,30,37,29,18,40,16,67,43,1,36,6,-26,-25,-38,-21,-11,-1,-24,-12,-18,-12,-8,7,-2,-13,-20,-9,-3,-82,-85,3,-119,-56,-63,57,-63,33,-51,-68,5,16,-39,6,-37,-25,-7,41,-24,27,-14,-43,12,3,-18,-11,-30,-35,-32,1,-14,-7,-11,-8,-19,2,-4,-4,-19,-27,-13,116,88,28,-171,-71,-100,118,-41,32,76,-26,-53,74,-15,21,47,-12,-30,44,-26,11,29,-14,-23,-19,-38,-3,-41,-24,-50,-4,-18,-6,-15,-9,-21,-15,-20,3,-26,-15,-29,200,90,110,25,12,13,111,-17,28,53,16,-1,67,-8,-1,27,-4,-3,44,-9,29,26,20,2,18,-1,12,-9,24,-23,16,-1,9,-10,10,-13,2,0,3,1,14,-10,416,207,209,62,35,27,206,-33,94,105,12,12,125,-15,32,38,4,15,81,-18,62,67,8,-3,52,1,0,9,8,-13,34,5,-2,-5,-1,1,18,-4,2,14,9,-14
29,29008,Alhaurín el Grande,16870,103,52,51,5,4,1,33,2,36,14,3,10,16,-2,23,7,1,4,17,4,13,7,2,6,1,1,0,0,3,0,1,1,0,0,2,0,0,0,0,0,1,0,122,71,51,103,52,51,37,-8,32,25,40,-5,20,-3,15,14,27,-2,17,-5,17,11,13,-3,24,6,24,17,31,0,11,2,14,9,16,0,13,4,10,8,15,0,10,-5,15,-8,-5,-3,0,7,1,9,-2,-4,-3,2,-3,-5,7,-2,3,5,4,14,-9,-2,0,-2,-5,-2,1,0,0,-1,-2,-2,0,0,0,-1,-3,0,1,0,275,152,123,202,100,102,48,32,63,73,49,9,28,24,33,38,25,3,20,8,30,35,24,6,49,17,41,47,42,4,26,7,21,22,22,1,23,10,20,25,20,3,627,338,289,633,333,300,143,59,140,138,135,6,74,36,69,68,81,10,69,23,71,70,54,-4,134,62,125,136,147,24,72,31,64,65,83,18,62,31,61,71,64,6,861,440,421,780,390,390,177,157,190,187,135,7,80,75,107,100,68,3,97,82,83,87,67,4,143,132,162,183,133,20,58,63,85,100,72,7,85,69,77,83,61,13,818,422,396,639,308,331,191,100,227,149,110,36,83,54,116,84,52,30,108,46,111,65,58,6,151,71,154,123,105,33,59,37,72,68,50,22,92,34,82,55,55,11,851,466,385,633,338,295,191,130,213,186,109,15,96,68,129,100,56,8,95,62,84,86,53,7,130,97,138,128,106,28,67,53,77,70,55,12,63,44,61,58,51,16,394,192,202,340,172,168,98,50,88,81,43,29,53,12,31,50,29,11,45,38,57,31,14,18,98,40,51,66,60,20,57,14,21,33,33,10,41,26,30,33,27,10,194,78,116,250,121,129,34,25,56,38,36,7,19,11,14,15,15,3,15,14,42,23,21,4,39,43,57,57,37,13,25,16,23,30,19,5,14,27,34,27,18,8,71,14,57,67,18,49,-2,7,-14,22,43,13,-13,4,-11,6,19,10,11,3,-3,16,24,3,9,6,-13,14,34,16,0,1,-8,3,12,10,9,5,-5,11,22,6,209,68,141,144,76,68,37,16,51,23,62,22,15,-3,19,10,24,7,22,19,32,13,38,15,7,23,17,20,56,21,4,7,10,17,27,11,3,16,7,3,29,10,-35,-14,-21,30,22,8,-32,9,-41,-5,30,8,-8,-12,-20,1,15,8,-24,21,-21,-6,15,0,-2,1,-11,1,27,12,1,-4,0,2,14,7,-3,5,-11,-1,13,5,-318,-184,-134,-424,-245,-179,3,-83,-27,-55,-62,-95,0,-40,-35,-24,-37,-49,3,-43,8,-31,-25,-46,-44,-84,-49,-84,-69,-97,-26,-45,-37,-47,-42,-50,-18,-39,-12,-37,-27,-47,2,-12,14,-21,-28,7,39,-56,-25,13,44,-12,22,-26,-26,4,19,-3,17,-30,1,9,25,-9,25,-31,-50,5,30,1,13,-13,-40,3,8,3,12,-18,-10,2,22,-2,-104,-48,-56,-159,-76,-83,3,-61,-18,-19,13,-29,17,-35,0,-22,8,-19,-14,-26,-18,3,5,-10,-8,-51,-7,-67,6,-36,3,-29,-3,-35,6,-20,-11,-22,-4,-32,0,-16,330,170,160,277,140,137,52,20,31,81,83,54,29,4,24,35,50,25,23,16,7,46,33,29,54,17,38,58,66,38,28,4,20,32,37,17,26,13,18,26,29,21,-616,-290,-326,-728,-362,-366,-34,-145,-31,-126,-163,-122,-8,-61,-12,-65,-83,-62,-26,-84,-19,-61,-80,-60,-50,-129,-64,-184,-177,-127,-20,-59,-33,-98,-88,-65,-30,-70,-31,-86,-89,-62
29,29011,Almogía,4119,15,9,6,18,9,9,4,-3,-5,7,13,-1,3,-4,-3,5,9,-1,1,1,-2,2,4,0,2,1,3,3,9,0,1,0,2,1,5,0,1,1,1,2,4,0,-6,8,-14,23,13,10,0,2,-12,5,7,-8,-4,3,1,2,6,0,4,-1,-13,3,1,-8,3,1,6,3,9,1,1,0,4,0,7,1,2,1,2,3,2,0,26,15,11,27,15,12,4,-3,-1,28,4,-5,0,1,-1,13,7,-4,4,-4,0,15,-3,-1,6,2,3,8,7,1,3,1,2,3,5,1,3,1,1,5,2,0,-22,-18,-4,27,12,15,0,5,-18,5,0,-13,-3,1,-10,0,1,-6,3,4,-8,5,-1,-7,11,5,2,5,4,0,6,1,1,1,3,0,5,4,1,4,1,0,-58,-25,-33,30,16,14,-10,-7,-10,-11,-10,-13,-4,-4,-7,-2,-2,-7,-6,-3,-3,-9,-8,-6,4,4,6,5,11,0,1,3,4,2,6,0,3,1,2,3,5,0,-22,-3,-19,37,25,12,-2,5,-13,6,-6,-9,1,5,1,1,-5,-6,-3,0,-14,5,-1,-3,5,4,7,10,9,2,5,2,6,5,6,1,0,2,1,5,3,1,32,5,27,38,18,20,4,3,1,6,17,-1,-5,3,-2,4,7,-1,9,0,3,2,10,0,1,7,5,7,13,4,0,2,4,4,6,2,1,5,1,3,7,2,3,5,-2,28,14,14,-6,7,-10,14,6,-7,2,4,-7,7,5,-5,-8,3,-3,7,1,-2,2,6,5,5,7,3,2,3,2,2,4,1,0,3,3,3,3,2,25,20,5,39,17,22,9,7,5,2,7,-7,3,8,3,2,4,-2,6,-1,2,0,3,-5,7,5,6,10,9,1,2,4,1,5,4,1,5,1,5,5,5,0,-34,-15,-19,9,5,4,-15,10,-10,-3,6,-19,-11,10,-3,-5,5,-10,-4,0,-7,2,1,-9,2,2,-3,3,6,-1,2,1,-3,1,4,0,0,1,0,2,2,-1,-23,-12,-11,14,9,5,1,2,-17,3,-7,-4,-1,-6,-3,4,-4,-1,2,8,-14,-1,-3,-3,0,0,1,3,7,3,0,0,0,3,3,3,0,0,1,0,4,0,-27,-7,-20,7,1,6,9,8,-26,1,4,-19,10,5,-15,-1,4,-8,-1,3,-11,2,0,-11,0,-1,-2,0,8,2,0,-1,-2,-1,3,2,0,0,0,1,5,0,4,-2,6,14,8,6,8,-10,4,8,2,-6,3,-8,0,4,0,0,5,-2,4,4,2,-6,4,-2,0,6,4,2,2,-1,0,4,1,2,2,-1,0,2,3,0,-21,-12,-9,-4,-4,0,-2,-6,9,-14,0,-9,-2,-7,9,-12,3,-3,0,1,0,-2,-3,-6,-2,0,-3,-3,4,0,0,0,-2,-3,1,0,-2,0,-1,0,3,0,-58,-33,-25,-9,-7,-2,-2,-14,-6,-15,-13,-8,-4,-5,-1,-10,-11,-1,2,-9,-5,-5,-2,-7,-1,-3,-1,-3,0,-1,-1,-2,-1,-2,-2,1,0,-1,0,-1,2,-2,-35,-15,-20,8,4,4,0,-8,-9,-10,2,-10,-3,-1,-9,-2,2,-2,3,-7,0,-8,0,-8,1,-1,1,-2,10,-1,1,0,0,-1,3,1,0,-1,1,-1,7,-2,-205,-98,-107,-169,-84,-85,-10,-16,-13,-21,-57,-87,-10,-7,-8,-7,-24,-43,0,-9,-5,-14,-33,-44,0,-11,-5,-14,-56,-84,-3,-6,-2,-6,-24,-43,3,-5,-3,-8,-32,-41,12,14,-2,13,8,5,9,0,-13,14,1,-1,4,2,-9,9,7,0,5,-2,-4,5,-6,-1,2,1,-3,5,4,4,1,0,-2,3,4,2,1,1,-1,2,0,2
29,29012,Álora,12565,-34,-13,-21,44,24,20,-12,-2,-35,5,8,3,-11,2,-20,0,13,2,-1,-4,-15,5,-5,1,7,2,9,6,19,1,3,2,5,1,12,1,4,0,4,5,7,0,-26,-7,-19,38,22,16,-5,-6,-25,17,1,-3,1,-5,-9,7,3,-1,-6,-1,-16,10,-2,-2,2,3,8,12,6,6,1,3,5,6,3,4,1,0,3,6,3,2,194,91,103,166,85,81,45,17,16,35,80,0,17,6,4,22,42,0,28,11,12,13,38,0,26,6,29,44,57,4,11,3,14,25,29,3,15,3,15,19,28,1,110,64,46,139,74,65,11,11,24,33,38,-10,-1,8,14,23,23,-4,12,3,10,10,15,-6,17,12,30,34,37,8,9,8,14,19,20,4,8,4,16,15,17,4,158,87,71,196,99,97,39,18,8,48,52,-5,18,19,-2,25,25,2,21,-1,10,23,27,-7,24,19,40,43,61,8,8,12,21,23,27,7,16,7,19,20,34,1,171,82,89,240,124,116,28,36,23,48,54,-13,3,16,18,27,30,-7,25,20,5,21,24,-6,38,39,52,57,48,5,16,19,28,32,25,3,22,20,24,25,23,2,129,88,41,156,92,64,55,3,-4,38,39,-1,34,-2,12,17,25,0,21,5,-16,21,14,-1,32,22,17,45,38,1,23,11,12,25,22,-2,9,11,5,20,16,3,144,88,56,141,74,67,27,21,22,41,32,-2,20,10,12,26,17,1,7,11,10,15,15,-3,31,22,24,31,24,7,20,10,12,17,12,2,11,12,12,14,12,5,-25,0,-25,89,46,43,-17,7,-29,0,17,-1,4,13,-18,1,10,-8,-21,-6,-11,-1,7,7,12,13,22,17,24,1,5,10,9,10,13,-1,7,3,13,7,11,2,101,29,72,58,22,36,44,-5,4,13,27,16,18,-8,-6,7,11,8,26,3,10,6,16,8,11,9,-1,19,14,6,5,7,-6,6,7,3,6,2,5,13,7,3,74,42,32,14,6,8,36,12,-18,22,20,-1,25,-5,-3,7,16,1,11,17,-15,15,4,-2,2,10,0,-5,9,-4,-1,4,1,-4,8,-2,3,6,-1,-1,1,-2,-76,-30,-46,21,10,11,-26,-32,-30,-1,23,-10,-11,-28,-8,5,12,0,-15,-4,-22,-6,11,-10,-5,1,9,3,9,3,1,-5,4,1,6,3,-6,6,5,2,3,0,-18,-21,3,-34,-15,-19,19,6,-28,-14,-4,-2,5,9,-31,-4,-1,1,14,-3,3,-10,-3,-3,4,-6,-10,-10,-7,-5,3,0,-11,-5,-2,0,1,-6,1,-5,-5,-5,-158,-85,-73,-92,-51,-41,-10,-26,-29,-46,-28,-19,-8,-13,-23,-20,-15,-11,-2,-13,-6,-26,-13,-8,0,-14,-17,-35,-18,-8,1,-9,-7,-19,-12,-5,-1,-5,-10,-16,-6,-3,3,13,-10,4,7,-3,-10,-1,2,6,16,-9,2,-1,6,3,12,-7,-12,0,-4,3,4,-2,-5,3,7,-3,-2,4,1,5,4,-7,3,1,-6,-2,3,4,-5,3,-54,-9,-45,-35,-23,-12,6,-27,5,7,-12,-30,5,-12,15,10,-13,-11,1,-15,-10,-3,1,-19,2,-7,12,-6,-12,-24,-2,-6,9,-2,-9,-13,4,-1,3,-4,-3,-11,34,27,7,36,25,11,13,11,-10,10,27,-14,7,10,1,2,20,-11,6,1,-11,8,7,-3,3,8,8,9,19,-12,3,4,5,6,14,-7,0,4,3,3,5,-5,72,32,40,61,29,32,5,13,-15,37,31,1,3,3,-6,13,10,6,2,10,-9,24,21,-5,-5,6,12,13,25,10,-2,3,6,7,6,8,-3,3,6,6,19,2
29,29013,Alozaina,2127,24,11,13,21,13,8,3,3,7,9,2,-1,-1,0,6,4,4,-2,4,3,1,5,-2,1,3,2,7,7,0,1,0,1,6,5,0,1,3,1,1,2,0,0,70,44,26,68,35,33,19,7,19,14,5,5,12,8,16,7,0,1,7,-1,3,7,5,4,14,12,21,16,4,1,7,7,12,8,1,0,7,5,9,8,3,1,26,12,14,32,17,15,6,12,1,7,-1,0,1,2,5,1,2,1,5,10,-4,6,-3,-1,4,7,7,7,5,1,1,4,6,1,5,0,3,3,1,6,0,1,-10,-6,-4,8,4,4,2,-3,-15,2,6,-2,6,0,-14,0,3,-1,-4,-3,-1,2,3,-1,2,0,1,1,2,2,1,0,0,1,1,1,1,0,1,0,1,1,27,20,7,21,12,9,-3,7,2,8,13,2,-2,5,4,4,8,1,-1,2,-2,4,5,1,0,0,5,4,12,0,0,0,4,1,7,0,0,0,1,3,5,0,-36,-8,-28,29,14,15,-17,3,-11,-3,2,-9,-5,4,-4,0,2,-3,-12,-1,-7,-3,0,-6,4,8,2,7,8,0,2,4,0,3,5,0,2,4,2,4,3,0,11,3,8,31,16,15,0,-2,3,-2,11,2,-4,-2,4,1,4,1,4,0,-1,-3,7,1,3,3,5,10,8,2,1,1,4,6,2,2,2,2,1,4,6,0,23,13,10,39,19,20,8,5,-5,9,11,-2,9,-1,-2,1,9,0,-1,6,-3,8,2,-2,12,5,2,8,10,2,8,1,1,1,7,1,4,4,1,7,3,1,16,8,8,28,16,12,-2,5,7,2,6,-2,0,4,4,-3,4,-1,-2,1,3,5,2,-1,1,5,11,6,4,1,-1,4,8,1,3,1,2,1,3,5,1,0,18,9,9,24,9,15,3,2,-3,9,6,0,1,3,-4,3,3,2,2,-1,1,6,3,-2,2,2,5,5,7,3,0,2,0,0,4,3,2,0,5,5,3,0,35,23,12,6,2,4,3,5,8,6,11,2,0,3,5,6,6,3,3,2,3,0,5,-1,0,2,0,1,5,-2,0,0,0,0,3,-1,0,2,0,1,2,-1,-21,-11,-10,-2,-3,1,-1,-2,-11,1,-2,-6,-2,0,-8,2,-3,0,1,-2,-3,-1,1,-6,-2,0,-4,2,1,1,-1,0,-2,0,-1,1,-1,0,-2,2,2,0,-7,-3,-4,4,3,1,-1,-5,-5,7,5,-8,-1,-1,-3,4,-1,-1,0,-4,-2,3,6,-7,1,1,0,-1,3,0,1,1,0,0,1,0,0,0,0,-1,2,0,-23,-15,-8,-11,-9,-2,5,-4,-1,-10,-4,-9,1,-3,0,-6,-2,-6,4,-1,-1,-4,-2,-3,-1,-1,1,-3,-5,-2,-2,-1,1,-3,-2,-2,1,0,0,0,-3,0,-21,-9,-12,-4,-1,-3,1,-2,-9,-4,-3,-3,0,0,-5,-5,1,0,1,-2,-4,1,-4,-3,-1,-2,0,1,-1,-1,-1,0,0,0,0,0,0,-2,0,1,-1,-1,-38,-26,-12,-16,-14,-2,-4,-1,-12,-16,-1,-3,-2,0,-8,-12,-1,-4,-2,-1,-4,-4,0,1,1,0,-6,-7,-2,-2,1,-1,-4,-6,-3,-1,0,1,-2,-1,1,-1,0,1,-1,19,8,11,-3,-4,-5,1,6,5,0,-1,-3,-2,2,5,-3,-3,-2,3,4,0,2,1,3,3,6,4,0,1,1,1,4,1,2,0,2,2,2,3,15,13,2,18,13,5,6,-3,-4,13,-3,3,4,-2,1,8,-2,2,2,-1,-5,5,-1,1,2,0,7,3,4,2,1,0,7,1,3,1,1,0,0,2,1,1
29,29015,Antequera,40433,39,-14,53,53,24,29,17,-15,10,21,3,7,-8,-16,2,2,5,3,25,1,8,19,-2,4,13,5,21,8,4,2,7,2,8,4,3,0,6,3,13,4,1,2,138,89,49,115,56,59,53,-3,63,32,-1,-10,31,6,39,16,-3,0,22,-9,24,16,2,-10,13,29,37,22,13,0,7,12,18,12,6,0,6,17,19,10,7,0,296,159,137,204,124,80,92,41,65,65,30,2,45,25,41,35,9,1,47,16,24,30,21,1,46,40,48,43,15,11,26,27,31,27,7,5,20,13,17,16,8,6,429,264,165,256,154,102,136,24,136,109,35,-14,85,17,73,63,23,4,51,7,63,46,12,-18,43,43,69,58,29,11,26,32,37,36,17,6,17,11,32,22,12,5,516,275,241,387,203,184,119,70,160,137,58,-18,66,35,101,69,26,-17,53,35,59,68,32,-1,60,70,112,93,43,8,27,39,60,54,21,2,33,31,52,39,22,6,530,301,229,477,278,199,79,137,146,125,52,-10,32,72,99,72,25,3,47,65,47,53,27,-13,57,125,136,105,40,11,28,73,90,62,18,5,29,52,46,43,22,6,466,247,219,421,205,216,125,72,108,105,56,-5,61,37,65,51,37,-2,64,35,43,54,19,-3,78,98,123,71,40,8,38,48,60,33,20,5,40,50,63,38,20,3,375,204,171,491,260,231,42,110,80,101,38,11,11,44,51,66,30,4,31,66,29,35,8,7,49,130,155,103,47,6,27,58,84,60,24,7,22,72,71,43,23,-1,114,65,49,202,99,103,70,19,47,-12,8,-16,40,19,14,-5,6,-3,30,0,33,-7,2,-13,46,64,53,24,13,1,23,32,19,13,9,2,23,32,34,11,4,-1,-181,-127,-54,-143,-101,-42,17,-24,-121,-23,-11,-14,14,-7,-79,-27,-16,-6,3,-17,-42,4,5,-8,0,2,-77,-53,-10,-5,-2,5,-50,-43,-11,0,2,-3,-27,-10,1,-5,-93,-93,0,17,-4,21,37,-51,-42,-14,-10,-6,0,-48,-24,-12,-9,3,37,-3,-18,-2,-1,-9,3,8,-6,-10,13,8,5,4,-12,-12,7,3,-2,4,6,2,6,5,-112,-69,-43,-45,-48,3,19,-11,-82,9,-40,-1,2,-3,-37,-2,-31,5,17,-8,-45,11,-9,-6,5,5,-36,-12,-8,1,0,-13,-23,-9,-4,1,5,18,-13,-3,-4,0,-43,3,-46,3,-5,8,7,-3,-37,-5,-16,16,2,-2,-1,-4,0,9,5,-1,-36,-1,-16,7,0,9,-9,-2,2,2,-5,9,-4,-8,1,2,5,0,-5,6,1,0,-192,-72,-120,-5,-2,-3,22,-48,-77,-23,-28,-34,24,-21,-41,-2,-19,-12,-2,-27,-36,-21,-9,-22,27,4,-21,-11,-1,-3,17,0,-18,-2,2,-2,10,4,-3,-9,-3,-1,-277,-147,-130,-54,-33,-21,-25,-58,-86,-52,-29,-25,-22,-32,-40,-32,-11,-9,-3,-26,-46,-20,-18,-16,-1,-3,-24,-24,-6,5,2,-6,-12,-16,-3,3,-3,3,-12,-8,-3,2,31,21,10,78,38,40,37,-39,43,-28,-3,18,19,-11,31,-34,1,14,18,-28,12,6,-4,4,15,16,17,8,14,7,8,9,9,0,7,4,7,7,8,8,7,3,30,-45,75,115,42,73,60,-28,-11,17,-39,28,24,-13,-30,-3,-34,8,36,-15,19,20,-5,20,26,34,30,16,1,6,14,21,8,1,-6,4,12,13,22,15,7,2,57,26,31,171,71,100,22,8,-18,20,-1,22,20,12,-4,-12,1,7,2,-4,-14,32,-2,15,36,54,48,25,3,2,18,33,21,2,-4,0,18,21,27,23,7,2
29,29017,Archidona,8203,49,26,23,5,4,1,11,3,-2,11,2,25,6,1,1,4,3,11,5,2,-3,7,-1,14,0,1,2,2,0,0,0,0,2,2,0,0,0,1,0,0,0,0,-35,-25,-10,5,1,4,-7,-4,-23,1,-2,2,-9,1,-17,0,-1,2,2,-5,-6,1,-1,0,1,1,0,1,2,0,0,0,0,0,1,0,1,1,0,1,1,0,129,74,55,18,10,8,6,7,20,32,11,54,3,7,15,18,8,24,3,0,5,14,3,30,3,0,3,5,5,2,2,0,3,1,2,2,1,0,0,4,3,0,131,62,69,28,14,14,17,27,22,20,11,34,7,16,2,11,9,16,10,11,20,9,2,18,8,6,5,7,2,0,5,3,2,2,2,0,3,3,3,5,0,0,156,71,85,70,33,37,38,18,11,38,18,32,20,13,-1,18,10,11,18,5,12,20,8,21,15,9,7,20,16,3,9,5,2,8,8,1,6,4,5,12,8,2,117,60,57,63,32,31,12,28,12,13,18,34,7,19,8,4,12,11,5,9,4,9,6,23,8,10,17,16,9,2,3,6,9,7,7,0,5,4,8,9,2,2,108,43,65,78,33,45,3,17,37,25,2,18,0,4,13,13,0,10,3,13,24,12,2,8,11,17,24,19,7,0,3,6,12,10,2,0,8,11,12,9,5,0,152,88,64,115,62,53,24,49,26,26,18,10,14,31,20,16,8,2,10,18,6,10,10,8,16,40,26,19,8,4,9,24,14,8,5,2,7,16,12,11,3,2,18,8,10,56,27,29,-4,15,1,-14,6,13,-7,13,-1,-6,5,5,3,2,2,-8,1,8,6,22,19,7,2,0,1,14,9,1,2,0,5,8,10,6,0,0,22,9,13,37,16,21,7,16,-1,-1,5,-3,2,5,3,-6,3,2,5,11,-4,5,2,-5,10,10,11,3,2,0,6,4,6,-1,2,-1,4,6,5,4,0,1,51,41,10,54,33,21,20,19,-6,8,5,4,17,8,2,11,3,-2,3,11,-8,-3,2,6,18,16,9,7,1,1,13,5,9,5,-1,0,5,11,0,2,2,1,-25,-1,-24,21,9,12,-10,-5,-17,-5,2,11,-5,3,-7,-3,6,5,-5,-8,-10,-2,-4,6,7,4,2,8,-1,1,3,0,-3,8,1,0,4,4,5,0,-2,1,-79,-40,-39,-48,-26,-22,4,-17,-25,-24,-12,-3,1,-11,-15,-11,-3,-1,3,-6,-10,-13,-9,-2,1,-4,-12,-16,-13,-4,-1,-1,-7,-8,-6,-3,2,-3,-5,-8,-7,-1,-117,-81,-36,-55,-39,-16,-25,-13,-41,-27,-17,4,-15,-7,-27,-16,-13,-2,-10,-6,-14,-11,-4,6,-7,-7,-19,-14,-8,-1,-3,-3,-17,-8,-7,-1,-4,-4,-2,-6,-1,0,-79,-20,-59,-23,-13,-10,-26,-7,-30,-18,-4,5,-8,-2,-12,-6,1,5,-18,-5,-18,-12,-5,0,3,-4,-8,-4,-10,0,2,-3,-5,-3,-4,0,1,-1,-3,-1,-6,0,58,70,-12,47,33,14,4,8,15,22,7,1,0,9,24,23,6,7,4,-1,-9,-1,1,-6,10,10,12,7,6,3,2,6,12,7,4,2,8,4,0,0,2,1,-80,-59,-21,-10,-14,4,2,-30,-26,-13,-4,-10,-2,-27,-14,-9,-4,-2,4,-3,-12,-4,0,-8,5,0,-8,-1,-1,-5,4,-3,-8,-3,-2,-2,1,3,0,2,1,-3,-55,-9,-46,19,11,8,-8,0,-37,-8,-1,4,-7,6,-3,-7,1,5,-1,-6,-34,-1,-2,-1,5,5,7,-2,3,0,3,1,7,-3,2,0,2,4,0,1,1,0
29,29018,Ardales,2958,3,3,0,2,1,1,-3,1,-2,2,7,-2,-1,2,-1,2,3,-2,-2,-1,-1,0,4,0,0,0,2,0,0,0,0,0,1,0,0,0,0,0,1,0,0,0,-6,-3,-3,2,1,1,1,-8,-5,-2,9,0,3,-7,-2,0,4,-1,-2,-1,-3,-2,5,1,0,0,1,0,1,0,0,0,0,0,1,0,0,0,1,0,0,0,47,23,24,19,10,9,32,6,1,10,0,-1,16,2,-1,7,0,0,16,4,2,3,0,-1,12,1,2,4,0,0,6,0,1,3,0,0,6,1,1,1,0,0,-2,7,-9,3,1,2,-3,-1,-5,6,2,-1,-1,1,2,3,2,1,-2,-2,-7,3,0,-2,0,0,1,2,0,0,0,0,0,1,0,0,0,0,1,1,0,0,-12,3,-15,14,9,5,-8,-7,3,-1,5,-2,-6,-1,8,4,0,-1,-2,-6,-5,-5,5,-1,0,1,3,3,6,1,0,1,3,2,2,1,0,0,0,1,4,0,10,8,2,22,12,10,-5,7,8,0,0,2,-4,7,3,0,0,2,-1,0,5,0,0,0,5,3,4,5,4,1,2,2,3,3,1,1,3,1,1,2,3,0,45,17,28,19,8,11,6,4,10,10,16,-1,4,1,3,3,7,-1,2,3,7,7,9,0,3,6,3,3,2,2,2,3,1,1,1,0,1,3,2,2,1,2,35,25,10,16,8,8,7,16,1,8,7,-3,7,7,-1,5,6,1,0,9,2,3,1,-4,2,5,4,1,1,3,1,5,0,0,0,2,1,0,4,1,1,1,5,7,-2,18,10,8,8,0,0,0,3,-6,4,3,-2,-1,4,-1,4,-3,2,1,-1,-5,0,6,3,6,3,0,0,4,2,2,2,0,0,2,1,4,1,0,16,2,14,4,2,2,8,4,1,5,0,-2,1,0,1,3,-1,-2,7,4,0,2,1,0,1,2,0,0,0,1,0,1,0,0,1,0,1,1,0,0,-1,1,-18,-9,-9,-7,-2,-5,-6,-6,-5,8,-6,-1,-3,-5,-2,4,-3,1,-3,-1,-3,4,-3,-2,-3,-2,-3,2,-1,0,0,0,-2,1,-1,0,-3,-2,-1,1,0,0,-14,-10,-4,-2,-1,-1,-3,7,-13,2,-1,-6,-3,2,-5,-1,-2,-1,0,5,-8,3,1,-5,1,1,-2,-1,0,-1,0,0,0,-1,0,0,1,1,-2,0,0,-1,-15,1,-16,-10,-5,-5,-5,3,0,-10,3,-7,0,3,0,-5,5,-3,-5,0,0,-5,-2,-4,-3,-2,-2,-1,-1,-1,-2,0,-1,-1,0,-1,-1,-2,-1,0,-1,0,-26,-12,-14,-3,-2,-1,0,-4,-15,-7,5,-4,2,-3,-9,-5,6,-2,-2,-1,-6,-2,-1,-2,0,-1,-2,-1,1,0,0,-1,-1,-1,1,0,0,0,-1,0,0,0,-21,-8,-13,0,-1,1,0,-1,0,1,-11,-11,-1,3,-1,0,-3,-6,1,-4,1,1,-8,-5,0,1,0,-1,0,0,0,0,0,-1,0,0,0,1,0,0,0,0,-8,-3,-5,7,0,7,-5,6,-6,-4,4,-2,-6,2,-1,0,2,0,1,4,-5,-4,2,-2,0,2,3,-1,2,1,-1,1,1,-1,0,0,1,1,2,0,2,1,-30,-5,-25,2,3,-1,-8,1,-7,-6,-3,-5,-1,3,-1,-2,0,-2,-7,-2,-6,-4,-3,-3,0,2,0,1,-1,0,0,2,0,1,0,0,0,0,0,0,-1,0,28,14,14,11,6,5,11,-1,5,6,6,0,8,-1,-2,5,4,-1,3,0,7,1,2,1,5,0,1,1,2,2,4,0,-1,0,2,1,1,0,2,1,0,1
29,29020,Arriate,3436,33,16,17,6,3,3,-7,6,12,-4,1,25,-3,5,7,-4,0,10,-4,1,5,0,1,15,1,2,2,1,0,0,1,0,2,0,0,0,0,2,0,1,0,0,47,18,29,6,2,4,10,3,6,9,7,11,5,0,2,4,6,0,5,3,4,5,1,11,1,2,1,1,0,0,0,0,1,0,0,0,1,2,0,1,0,0,68,26,42,11,6,5,6,5,12,11,14,18,6,4,2,4,7,3,0,1,10,7,7,15,0,0,2,2,7,0,0,0,1,1,4,0,0,0,1,1,3,0,58,30,28,9,5,4,15,6,18,8,4,5,9,3,9,7,2,-1,6,3,9,1,2,6,1,2,2,2,0,2,0,1,1,2,0,1,1,1,1,0,0,1,118,69,49,33,17,16,27,1,25,28,10,25,16,4,14,16,5,13,11,-3,11,12,5,12,9,1,7,9,4,2,6,1,4,3,2,1,3,0,3,6,2,1,68,35,33,27,13,14,2,15,11,6,16,18,2,7,5,1,10,10,0,8,6,5,6,8,3,4,11,4,5,0,2,1,5,2,3,0,1,3,6,2,2,0,102,46,56,33,13,20,14,18,25,17,5,22,8,6,11,8,3,8,6,12,14,9,2,14,3,10,5,6,4,5,1,3,3,3,1,2,2,7,2,3,3,3,78,40,38,23,9,14,11,11,33,-4,7,19,3,6,21,-4,5,10,8,5,12,0,2,9,8,2,9,-1,3,1,5,0,4,-2,1,1,3,2,5,1,2,0,74,35,39,13,7,6,20,8,27,6,6,9,11,4,12,3,2,5,9,4,15,3,4,4,8,0,1,4,0,0,4,0,1,2,0,0,4,0,0,2,0,0,-2,1,-3,6,2,4,-2,6,1,-21,8,5,-1,0,2,-11,8,1,-1,6,-1,-10,0,4,0,2,1,1,1,1,0,0,0,1,1,0,0,2,1,0,0,1,14,7,7,6,4,2,4,5,-8,5,-3,12,9,6,-10,0,-2,7,-5,-1,2,5,-1,5,-1,6,-2,2,1,0,0,5,-1,0,0,0,-1,1,-1,2,1,0,10,4,6,2,1,1,-7,-4,-5,1,10,13,-4,1,-5,0,8,5,-3,-5,0,1,2,8,1,1,0,1,0,-1,0,1,0,1,0,-1,1,0,0,0,0,0,-12,-10,-2,1,1,0,0,-1,-17,-4,1,12,-2,0,-7,-4,3,1,2,-1,-10,0,-2,11,0,1,-1,1,0,0,0,1,0,0,0,0,0,0,-1,1,0,0,69,32,37,6,0,6,12,11,10,8,16,12,6,5,7,6,7,1,6,6,3,2,9,11,5,1,0,2,0,-2,0,1,0,1,0,-2,5,0,0,1,0,0,13,5,8,4,2,2,-6,0,0,-5,9,16,-2,3,2,-3,4,2,-4,-3,-2,-2,5,14,1,0,0,0,3,0,1,0,0,0,1,0,0,0,0,0,2,0,8,5,3,0,1,-1,-14,-9,-6,12,-2,25,-6,-2,-5,12,-4,10,-8,-7,-1,0,2,15,-1,-3,-3,1,2,4,1,-1,-2,0,0,3,-2,-2,-1,1,2,1,-13,-12,-1,5,2,3,-3,-7,-14,1,4,11,-2,-4,-8,0,1,5,-1,-3,-6,1,3,6,4,1,0,0,3,-3,1,1,-1,0,1,0,3,0,1,0,2,-3,74,38,36,14,3,11,3,12,17,7,11,20,0,6,7,3,6,14,3,6,10,4,5,6,4,3,3,4,0,0,1,1,1,2,0,-2,3,2,2,2,0,2
29,29025,Benalmádena,30059,1451,708,743,852,435,417,266,175,367,281,238,115,129,72,171,135,138,58,137,103,196,146,100,57,183,96,195,159,160,53,83,47,92,87,97,27,100,49,103,72,63,26,1735,828,907,1112,558,554,397,177,447,353,245,93,192,79,223,157,123,44,205,98,224,196,122,49,285,134,231,222,174,56,142,55,114,117,94,31,143,79,117,105,80,25,2088,1034,1054,1446,729,717,473,252,640,366,255,71,252,101,316,177,129,36,221,151,324,189,126,35,340,176,347,282,227,54,182,76,173,149,110,28,158,100,174,133,117,26,2476,1197,1279,1486,739,747,467,318,753,496,303,108,245,150,334,234,148,63,222,168,419,262,155,45,329,171,340,316,240,79,169,79,162,157,112,51,160,92,178,159,128,28,2840,1465,1375,1742,893,849,497,359,790,515,421,230,254,179,394,299,209,117,243,180,396,216,212,113,320,205,369,331,322,185,164,100,176,188,162,99,156,105,193,143,160,86,2649,1286,1363,1781,891,890,480,325,752,545,370,139,235,124,350,288,193,75,245,201,402,257,177,64,291,270,434,364,295,114,150,118,206,194,148,69,141,152,228,170,147,45,3467,1706,1761,1820,923,897,557,425,1082,649,447,266,273,208,526,348,229,110,284,217,556,301,218,156,345,249,427,365,315,108,176,122,198,196,168,60,169,127,229,169,147,48,2873,1413,1460,2039,1014,1025,418,400,853,561,395,206,212,149,471,280,192,102,206,251,382,281,203,104,357,296,459,397,348,150,179,126,237,210,165,82,178,170,222,187,183,68,2473,1226,1247,1726,858,868,289,342,771,435,375,251,162,145,394,217,176,123,127,197,377,218,199,128,236,254,450,308,306,159,119,98,225,163,157,88,117,156,225,145,149,71,2705,1311,1394,1437,695,742,234,299,747,553,504,347,76,121,384,309,237,175,158,178,363,244,267,172,151,164,304,245,335,223,80,66,144,127,147,123,71,98,160,118,188,100,2358,1214,1144,1208,585,623,251,243,749,368,457,247,138,117,399,183,237,126,113,126,350,185,220,121,117,137,243,208,313,167,61,61,118,99,146,94,56,76,125,109,167,73,1905,907,998,626,281,345,293,186,663,345,240,150,134,67,313,184,135,75,159,119,350,161,105,75,123,74,115,85,143,72,58,22,41,40,69,47,65,52,74,45,74,25,2260,1174,1086,832,416,416,250,161,433,379,626,385,141,66,207,175,312,252,109,95,226,204,314,133,97,51,29,41,348,256,54,16,0,9,170,161,43,35,29,32,178,95,2231,1084,1147,1311,643,668,237,183,371,386,614,419,114,66,175,223,285,209,123,117,196,163,329,210,169,105,189,229,341,269,97,37,91,122,156,137,72,68,98,107,185,132,1800,991,809,1214,632,582,193,117,411,441,339,271,105,75,203,254,199,141,88,42,208,187,140,130,172,69,212,283,291,169,89,46,88,157,159,81,83,23,124,126,132,88,1240,584,656,862,416,446,217,132,252,142,355,115,119,44,99,61,191,61,98,88,153,81,164,54,162,83,96,128,270,95,87,29,32,51,146,61,75,54,64,77,124,34,-6727,-3387,-3340,-7044,-3534,-3510,-513,-677,-677,-1333,-1310,-2274,-244,-349,-314,-679,-658,-1170,-269,-328,-363,-654,-652,-1104,-496,-699,-801,-1436,-1347,-2291,-238,-366,-382,-720,-665,-1175,-258,-333,-419,-716,-682,-1116,-1338,-814,-524,-1626,-864,-762,10,12,176,-181,-390,-999,-3,-24,52,-159,-173,-514,13,36,124,-22,-217,-485,0,-2,-29,-233,-408,-973,1,0,-27,-157,-195,-496,-1,-2,-2,-76,-213,-477
29,29026,Benamargosa,1552,15,8,7,10,6,4,1,1,7,3,2,0,1,0,3,1,2,0,0,1,4,2,0,0,2,0,1,5,1,0,2,0,0,2,1,0,0,0,1,3,0,0,-3,-4,1,8,3,5,-1,5,-5,-1,0,0,-1,2,-4,-1,0,0,0,3,-1,0,0,0,1,2,4,1,0,0,0,2,0,1,0,0,1,0,4,0,0,0,15,8,7,31,18,13,-3,0,-12,13,18,0,-3,0,-7,7,10,1,0,0,-5,6,8,-1,1,0,1,11,17,1,1,0,1,6,9,1,0,0,0,5,8,0,33,17,16,54,29,25,-6,7,5,8,16,2,-6,2,2,6,10,2,0,5,3,2,6,0,6,2,11,16,17,2,3,0,5,9,10,2,3,2,6,7,7,0,59,28,31,53,26,27,13,11,5,12,18,0,4,6,2,6,8,2,9,5,3,6,10,-2,3,9,14,8,18,1,1,4,9,3,8,1,2,5,5,5,10,0,37,22,15,56,31,25,6,5,0,17,13,-1,5,5,2,3,7,2,1,0,-2,14,6,-3,9,6,10,15,13,3,5,3,8,6,7,2,4,3,2,9,6,1,28,18,10,42,19,23,1,-1,2,7,15,4,3,-2,3,8,6,0,-2,1,-1,-1,9,4,6,3,9,10,12,2,3,-1,6,6,4,1,3,4,3,4,8,1,25,9,16,52,24,28,0,1,3,3,24,-4,1,-3,1,3,11,-2,-1,4,2,0,13,-2,7,10,6,7,20,2,3,4,3,3,9,2,4,6,3,4,11,0,-17,-5,-12,11,5,6,-7,5,-3,-6,-2,-3,-3,4,-1,-4,1,-1,-4,1,-2,-2,-3,-2,1,5,2,0,1,2,0,3,0,0,1,1,1,2,2,0,0,1,-6,-5,-1,17,9,8,-1,-5,1,1,3,-5,-3,-4,0,3,-1,-1,2,-1,1,-2,4,-4,3,0,2,2,8,1,2,0,1,2,2,1,1,0,1,0,6,0,7,4,3,13,6,7,0,6,-3,2,4,-3,0,3,-2,3,1,-1,0,3,-1,-1,3,-2,0,4,0,3,6,0,0,3,0,0,3,0,0,1,0,3,3,0,23,22,1,13,8,5,0,12,12,-2,4,-2,3,10,11,-3,1,1,-3,2,1,1,3,-3,3,1,2,4,3,0,2,1,1,2,2,0,1,0,1,2,1,0,1,-1,2,12,7,5,5,3,-10,2,1,0,4,-1,-7,1,2,0,1,4,-3,1,-1,0,2,3,0,1,5,1,2,2,0,1,2,0,0,1,0,0,3,1,-20,-12,-8,7,3,4,3,1,-7,-8,-4,-3,2,4,-9,-3,-4,0,1,-3,2,-5,0,-3,4,1,-1,4,1,-2,3,0,-2,3,0,-1,1,1,1,1,1,-1,-9,-7,-2,7,3,4,2,-1,1,-9,0,-3,1,-3,-1,-5,2,-2,1,2,2,-4,-2,-1,0,1,1,1,5,-1,0,0,0,0,3,0,0,1,1,1,2,-1,-11,-4,-7,0,0,0,-3,-3,-3,-4,3,2,-1,0,-2,-4,1,2,-2,-3,-1,0,2,0,0,2,-1,-3,1,1,0,1,0,-3,1,1,0,1,-1,0,0,0,-18,-6,-12,2,1,1,0,-2,-4,-3,2,-11,0,0,0,-2,1,-5,0,-2,-4,-1,1,-6,0,-1,0,0,3,0,0,-1,0,0,2,0,0,0,0,0,1,0,-22,-13,-9,1,1,0,-1,-1,-2,-7,-3,-8,-1,1,-4,-5,0,-4,0,-2,2,-2,-3,-4,0,-1,3,0,0,-1,0,0,1,0,0,0,0,-1,2,0,0,-1
29,29027,Benamocarra,2790,4,10,-6,4,3,1,1,1,-2,3,3,-2,1,2,-1,4,4,0,0,-1,-1,-1,-1,-2,1,1,0,1,1,0,0,1,0,1,1,0,1,0,0,0,0,0,2,6,-4,2,1,1,1,-6,0,2,2,2,2,-2,4,0,0,2,-1,-4,-4,2,2,0,1,0,0,0,1,0,0,0,0,0,1,0,1,0,0,0,0,0,19,17,2,11,4,7,3,6,3,-1,6,1,2,5,4,2,2,1,1,1,-1,-3,4,0,3,0,1,2,4,1,1,0,0,1,1,1,2,0,1,1,3,0,22,2,20,14,7,7,5,-1,-1,10,9,0,-1,-4,-2,3,6,0,6,3,1,7,3,0,1,0,3,3,7,0,1,0,1,1,4,0,0,0,2,2,3,0,6,1,5,28,14,14,-9,-1,-6,9,15,-2,-6,1,-7,7,7,-1,-3,-2,1,2,8,-1,0,1,2,8,14,3,0,1,0,2,9,2,0,0,2,6,5,1,52,35,17,25,12,13,16,2,11,10,8,2,8,6,10,5,2,1,8,-4,1,5,6,1,4,1,8,7,5,0,1,0,5,4,2,0,3,1,3,3,3,0,46,18,28,16,9,7,-9,11,11,13,17,2,-6,3,4,5,9,3,-3,8,7,8,8,-1,1,2,2,3,8,0,1,2,0,2,4,0,0,0,2,1,4,0,68,28,40,12,5,7,13,10,19,11,9,5,5,4,4,6,7,2,8,6,15,5,2,3,2,2,1,0,7,0,1,1,1,0,2,0,1,1,0,0,5,0,-4,7,-11,6,2,4,-12,-3,8,-4,6,2,-3,0,10,-3,3,1,-9,-3,-2,-1,3,1,0,2,-1,1,1,3,0,0,-1,0,1,2,0,2,0,1,0,1,-28,-11,-17,10,5,5,-3,-11,-12,1,-4,0,-6,-2,-4,4,-2,-1,3,-9,-8,-3,-2,1,2,2,3,1,2,0,0,2,1,1,1,0,2,0,2,0,1,0,69,37,32,-3,-4,1,10,14,23,15,3,2,8,5,14,5,4,0,2,9,9,10,-1,2,-1,4,-2,-1,-1,-2,1,2,-4,-1,-1,-1,-2,2,2,0,0,-1,-30,-22,-8,2,1,1,5,-1,-20,-12,-6,2,1,-1,-13,-8,-2,0,4,0,-7,-4,-4,2,0,1,0,0,1,0,0,0,0,0,1,0,0,1,0,0,0,0,-18,-12,-6,14,5,9,1,-4,-16,-6,8,-1,1,-4,-10,-5,5,1,0,0,-6,-1,3,-2,6,1,4,1,1,0,4,0,2,0,-1,0,2,1,2,1,2,0,-25,-10,-15,-4,-3,-1,-5,2,-16,1,-3,-2,-1,2,-4,-3,-2,-2,-4,0,-12,4,-1,0,-4,0,0,0,0,0,-2,0,0,-1,0,0,-2,0,0,1,0,0,4,-2,6,0,-1,1,4,3,-3,3,-3,-2,2,2,-1,1,-4,-2,2,1,-2,2,1,0,1,0,0,0,-1,0,0,0,0,0,-1,0,1,0,0,0,0,0,-19,-16,-3,-4,-4,0,8,-11,-11,-9,5,-1,0,-7,-5,-3,1,-2,8,-4,-6,-6,4,1,0,1,-2,-3,0,0,0,0,-2,-2,0,0,0,1,0,-1,0,0,-12,5,-17,11,4,7,-2,-5,5,0,-3,-8,1,0,7,2,-2,-3,-3,-5,-2,-2,-1,-5,5,1,4,2,1,-2,2,0,2,1,0,-1,3,1,2,1,1,-1,-32,-12,-20,8,4,4,-18,-10,8,-11,-5,3,-5,-3,-3,0,-3,2,-13,-7,11,-11,-2,1,2,0,2,2,1,1,2,0,1,0,0,1,0,0,1,2,1,0
29,29032,Campillos,7633,16,12,4,7,4,3,6,-8,4,6,5,4,3,-8,6,5,4,2,3,0,-2,1,1,2,1,0,4,0,2,0,1,0,2,0,1,0,0,0,2,0,1,0,21,25,-4,4,1,3,5,7,-2,4,5,2,6,4,5,5,2,3,-1,3,-7,-1,3,-1,0,1,0,0,1,2,0,0,0,0,0,1,0,1,0,0,1,1,44,15,29,28,10,18,7,-8,12,9,14,10,4,-8,5,1,8,5,3,0,7,8,6,5,1,7,12,2,4,2,0,2,5,0,2,1,1,5,7,2,2,1,96,28,68,17,4,13,38,17,6,22,7,6,9,5,2,10,2,1,29,12,4,12,5,5,5,2,4,-1,4,3,2,1,0,-1,2,0,3,1,4,0,2,3,107,59,48,44,24,20,20,15,15,24,31,-4,16,5,11,15,13,-4,4,10,4,9,18,0,3,9,10,13,8,1,1,7,4,8,3,1,2,2,6,5,5,0,100,66,34,69,40,29,13,5,14,21,34,9,14,3,9,14,18,9,-1,2,5,7,16,0,14,8,8,11,22,6,10,4,6,4,11,5,4,4,2,7,11,1,140,59,81,66,30,36,36,29,11,30,28,7,19,17,0,10,11,2,17,12,11,20,17,5,15,18,11,11,8,3,9,10,5,3,3,0,6,8,6,8,5,3,185,115,70,61,38,23,66,9,46,32,29,2,40,7,32,17,15,3,26,2,14,15,14,-1,17,13,16,4,10,0,11,6,10,4,6,0,6,7,6,0,4,0,89,52,37,38,17,21,38,-9,23,20,-2,15,15,0,16,11,-3,7,23,-9,7,9,1,8,13,6,11,6,-1,3,8,2,3,4,-2,2,5,4,8,2,1,1,-9,-14,5,-1,-6,5,7,-3,-6,-12,7,0,3,-1,-6,-13,3,1,4,-2,0,1,4,-1,1,-1,2,-5,4,-2,2,-2,-3,-5,3,-1,-1,1,5,0,1,-1,39,27,12,23,7,16,5,6,20,-3,5,0,6,5,11,-3,2,1,-1,1,9,0,3,-1,5,7,6,2,0,2,2,4,4,-2,-2,1,3,3,2,4,2,1,-29,6,-35,6,5,1,7,-10,-11,-5,-6,-8,8,2,-3,3,0,-7,-1,-12,-8,-8,-6,-1,1,0,2,0,3,0,0,-2,1,3,3,0,1,2,1,-3,0,0,18,4,14,-5,-10,5,3,3,-18,21,5,6,-3,0,-4,6,-1,7,6,3,-14,15,6,-1,6,-1,-12,3,0,-1,1,-1,-9,0,0,-1,5,0,-3,3,0,0,-105,-58,-47,-79,-46,-33,-11,-13,-23,-28,-13,-18,-2,-8,-21,-10,-8,-12,-9,-5,-2,-18,-5,-6,-9,-9,-14,-17,-14,-16,-6,-5,-9,-8,-10,-8,-3,-4,-5,-9,-4,-8,-57,-36,-21,-9,-6,-3,-2,-18,-17,-9,1,-15,0,-11,-16,-6,5,-9,-2,-7,-1,-3,-4,-6,-1,-3,-2,-1,3,-5,-1,-2,-3,-1,3,-2,0,-1,1,0,0,-3,-3,9,-12,21,14,7,-3,-15,9,13,3,-9,-6,-8,8,13,5,-2,3,-7,1,0,-2,-7,2,2,4,6,5,1,-1,2,0,7,4,1,3,0,4,-1,1,0,43,83,-40,7,18,-11,-2,-6,-6,51,9,-3,1,-2,12,56,13,3,-3,-4,-18,-5,-4,-6,5,-3,-10,23,-6,-4,3,-1,-6,23,0,-3,2,-2,-4,0,-6,-1,-7,-7,0,-71,-73,2,6,-22,-2,-7,15,6,4,-8,-3,-7,10,2,2,-14,1,0,5,4,-1,3,-18,-50,-7,2,-1,1,-15,-50,-9,1,0,2,-3,0,2,1
29,29033,Canillas de Aceituno,2257,-15,-6,-9,6,2,4,-3,-4,-1,-7,2,-1,-1,0,-2,-3,3,-3,-2,-4,1,-4,-1,2,1,1,2,1,1,0,0,1,0,0,1,0,1,0,2,1,0,0,-12,-7,-5,5,3,2,-2,-1,-4,-4,1,-4,0,-2,-2,-3,2,-3,-2,1,-2,-1,-1,-1,1,0,1,0,1,0,1,0,0,0,1,0,0,0,1,0,0,0,13,11,2,13,8,5,-1,2,-2,6,8,-1,-1,1,1,4,4,1,0,1,-3,2,4,-2,1,0,2,6,2,2,0,0,2,4,1,1,1,0,0,2,1,1,56,19,37,39,16,23,13,-1,3,10,25,6,6,-3,1,-1,14,2,7,2,2,11,11,4,8,0,3,8,16,4,3,0,1,3,8,1,5,0,2,5,8,3,50,22,28,36,17,19,-2,7,8,12,19,5,-3,1,3,8,8,4,1,6,5,4,11,1,2,2,7,8,13,3,0,1,2,4,7,2,2,1,5,4,6,1,99,58,41,84,46,38,17,10,12,19,46,-4,8,6,3,13,28,0,9,4,9,6,18,-4,11,8,10,17,31,7,5,6,3,9,20,3,6,2,7,8,11,4,31,19,12,55,28,27,4,1,7,3,21,-3,2,0,9,2,9,-3,2,1,-2,1,12,0,8,6,7,9,21,4,5,3,5,4,9,2,3,3,2,5,12,2,-4,-5,1,48,26,22,-5,-12,-2,3,22,-10,-5,-7,-3,2,13,-5,0,-5,1,1,9,-5,4,2,6,13,20,3,1,1,3,7,12,2,3,1,3,6,8,1,15,10,5,37,15,22,-3,8,-4,6,18,-8,-1,1,-2,1,11,1,-2,7,-2,5,7,-9,3,5,4,7,17,1,2,0,1,3,8,1,1,5,3,4,9,0,-23,-3,-20,18,8,10,-10,-8,-11,1,11,-7,-4,1,-6,2,5,-2,-6,-9,-5,-1,6,-5,-2,1,-1,0,15,5,-1,0,0,0,7,2,-1,1,-1,0,8,3,14,3,11,15,8,7,3,3,-5,11,6,-4,1,2,-5,5,2,-2,2,1,0,6,4,-2,-3,0,-1,4,10,5,0,0,-1,2,4,3,-3,0,0,2,6,2,-1,1,-2,6,2,4,3,3,-7,4,6,-10,2,1,-1,0,2,-3,1,2,-6,4,4,-7,1,-1,0,0,3,3,1,-1,0,-1,1,2,0,0,0,1,2,1,-39,-15,-24,9,7,2,-13,-2,-3,-13,1,-9,-6,-2,-1,-8,2,-1,-7,0,-2,-5,-1,-8,1,0,0,3,2,3,0,0,0,2,3,2,1,0,0,1,-1,1,-32,-24,-8,6,2,4,-3,5,-6,-14,-4,-10,-5,-3,-5,-7,1,-5,2,8,-1,-7,-5,-5,0,0,0,0,6,0,-1,-1,0,0,5,-1,1,1,0,0,1,1,15,10,5,21,8,13,0,-6,-4,11,12,3,1,-1,-3,6,5,1,-1,-5,-1,5,7,2,1,1,2,3,11,3,0,0,0,2,5,1,1,1,2,1,6,2,-1,10,-11,6,6,0,2,-3,-2,4,2,-4,5,-1,0,5,2,-1,-3,-2,-2,-1,0,-3,-1,-1,0,-1,9,0,1,-2,-1,1,6,1,-2,1,1,-2,3,-1,18,13,5,31,14,17,-1,0,-10,9,16,3,0,0,-5,4,13,0,-1,0,-5,5,3,3,1,1,3,9,14,1,1,0,0,4,7,1,0,1,3,5,7,0,2,-1,3,19,8,11,-3,-1,-10,5,14,-2,-3,-1,-6,4,8,-3,0,0,-4,1,6,1,1,0,3,6,10,-1,0,0,-1,3,7,-1,1,0,4,3,3,0
29,29034,Canillas de Albaida,680,25,13,12,8,4,4,0,1,7,5,11,1,0,-1,4,3,5,2,0,2,3,2,6,-1,0,0,0,2,5,1,0,0,0,1,2,1,0,0,0,1,3,0,26,13,13,27,13,14,5,2,-1,3,11,6,4,1,1,-1,4,4,1,1,-2,4,7,2,7,1,2,3,9,5,5,0,1,0,4,3,2,1,1,3,5,2,13,0,13,18,6,12,0,2,1,7,5,-2,-1,0,-2,2,2,-1,1,2,3,5,3,-1,2,2,1,9,4,0,1,1,0,3,1,0,1,1,1,6,3,0,21,10,11,27,12,15,2,1,3,4,4,7,1,-2,3,1,3,4,1,3,0,3,1,3,2,3,3,4,11,4,1,0,2,1,5,3,1,3,1,3,6,1,-3,-1,-2,14,7,7,-7,2,2,-4,6,-2,-7,2,2,-2,4,0,0,0,0,-2,2,-2,1,1,1,0,11,0,1,1,0,0,5,0,0,0,1,0,6,0,35,19,16,39,18,21,5,0,7,3,18,1,1,0,7,-1,12,0,4,0,0,4,6,1,5,0,6,4,20,4,1,0,3,1,11,2,4,0,3,3,9,2,33,13,20,59,30,29,-1,-2,-7,12,23,7,0,-3,-5,4,12,4,-1,1,-2,8,11,3,1,2,2,18,28,8,1,0,1,8,15,5,0,2,1,10,13,3,47,28,19,39,24,15,2,1,4,13,20,7,2,1,2,8,10,5,0,0,2,5,10,2,0,1,1,11,19,7,0,1,1,6,11,5,0,0,0,5,8,2,19,10,9,31,14,17,-2,0,-5,7,15,2,-2,0,-2,2,8,3,0,0,-3,5,7,-1,2,2,0,2,19,5,1,0,0,0,9,3,1,2,0,2,10,2,23,5,18,31,15,16,7,3,-6,3,17,-2,2,1,-5,-2,9,0,5,2,-1,5,8,-2,4,3,3,4,15,2,1,2,1,1,9,1,3,1,2,3,6,1,29,16,13,24,8,16,6,3,5,3,12,-2,3,5,3,2,2,0,3,-2,2,1,10,-2,4,0,2,3,14,1,2,0,0,1,4,1,2,0,2,2,10,0,15,13,2,23,13,10,1,2,3,0,9,-1,0,1,3,2,6,0,1,1,0,-2,3,-1,2,1,0,3,14,2,1,0,0,2,8,1,1,1,0,1,6,1,7,4,3,19,10,9,-4,-3,-3,4,13,0,-1,-1,-2,1,7,0,-3,-2,-1,3,6,0,2,0,0,5,10,2,1,0,0,2,5,2,1,0,0,3,5,0,14,6,8,12,6,6,2,2,-1,12,0,-1,1,2,-2,6,0,-1,1,0,1,6,0,0,0,0,2,6,2,2,0,0,1,4,0,1,0,0,1,2,2,1,12,-2,14,19,11,8,-4,-2,6,-6,15,0,-6,-1,1,-3,7,-1,2,-1,5,-3,8,1,1,1,6,1,9,1,1,1,3,1,5,0,0,0,3,0,4,1,6,2,4,13,5,8,-1,1,-6,3,8,1,0,0,-4,2,4,0,-1,1,-2,1,4,1,4,0,0,3,6,0,2,-1,0,1,3,0,2,1,0,2,3,0,4,4,0,16,7,9,-3,0,-4,1,6,4,-1,2,-2,0,2,3,-2,-2,-2,1,4,1,0,0,0,2,8,6,0,0,0,0,4,3,0,0,0,2,4,3,14,5,9,16,8,8,-1,1,-2,4,13,-1,0,1,-2,2,6,-2,-1,0,0,2,7,1,0,0,-1,5,10,2,0,0,-1,2,6,1,0,0,0,3,4,1
29,29038,Cártama,13004,109,56,53,43,28,15,39,-12,13,26,40,1,18,-8,6,12,27,-1,21,-4,7,14,13,2,13,5,7,6,12,0,9,3,4,3,9,0,4,2,3,3,3,0,300,143,157,68,36,32,89,24,60,72,55,0,44,1,29,37,31,1,45,23,31,35,24,-1,20,4,12,14,17,1,9,3,5,9,9,1,11,1,7,5,8,0,504,260,244,163,92,71,130,52,154,97,53,16,73,21,82,41,32,9,57,31,72,56,21,7,48,20,40,27,22,6,28,11,20,18,12,3,20,9,20,9,10,3,711,379,332,246,124,122,150,79,211,137,113,17,76,36,126,73,63,3,74,43,85,64,50,14,48,26,39,63,58,10,20,18,21,32,27,5,28,8,18,31,31,5,1026,546,480,290,142,148,175,127,360,179,148,32,82,65,209,93,78,16,93,62,151,86,70,16,38,26,65,59,89,12,13,11,42,28,42,6,25,15,23,31,47,6,924,488,436,307,175,132,141,125,351,146,130,24,79,64,188,84,63,10,62,61,163,62,67,14,34,57,69,67,72,7,21,34,44,35,37,4,13,23,25,32,35,3,1053,543,510,261,137,124,207,138,377,189,95,33,101,70,189,111,49,15,106,68,188,78,46,18,63,46,53,53,33,11,33,22,30,27,18,5,30,24,23,26,15,6,1235,641,594,230,110,120,243,155,501,198,104,18,137,69,267,113,48,5,106,86,234,85,56,13,36,56,67,39,23,5,17,25,39,18,8,2,19,31,28,21,15,3,813,440,373,185,94,91,95,103,407,101,72,15,60,44,227,50,38,7,35,59,180,51,34,8,34,46,47,32,18,4,22,26,24,10,8,4,12,20,23,22,10,0,621,326,295,86,45,41,87,82,353,65,32,-7,46,32,188,33,24,-3,41,50,165,32,8,-4,20,15,31,1,16,3,12,8,12,0,12,1,8,7,19,1,4,2,562,251,311,111,52,59,119,49,200,97,51,35,55,7,89,58,28,11,64,42,111,39,23,24,30,22,16,18,18,5,17,8,7,7,10,1,13,14,9,11,8,4,515,289,226,25,2,23,77,74,218,58,32,32,45,49,109,34,23,23,32,25,109,24,9,9,2,13,2,-7,3,7,6,6,-10,-8,0,5,-4,7,12,1,3,2,419,207,212,18,6,12,31,45,214,54,40,21,19,11,108,34,24,7,12,34,106,20,16,14,11,-2,6,0,-1,3,7,-5,1,1,2,0,4,3,5,-1,-3,3,253,95,158,-143,-89,-54,66,27,153,13,-17,1,12,15,78,8,-13,-3,54,12,75,5,-4,4,-17,-8,-49,-54,-18,-3,-8,-2,-29,-35,-14,-4,-9,-6,-20,-19,-4,1,-418,-214,-204,-626,-333,-293,-34,-28,-34,-87,-121,-126,-13,-12,0,-60,-62,-68,-21,-16,-34,-27,-59,-58,-66,-76,-103,-116,-142,-125,-32,-41,-57,-62,-76,-66,-34,-35,-46,-54,-66,-59,73,12,61,-90,-67,-23,-22,27,78,-44,13,11,-5,5,34,-30,1,-1,-17,22,44,-14,12,12,-15,-15,-21,-30,-11,0,-9,-15,-15,-24,-7,2,-6,0,-6,-6,-4,-2,381,148,233,19,2,17,97,47,134,72,12,5,44,23,42,27,7,-3,53,24,92,45,5,8,3,5,2,-12,11,6,4,1,-4,-11,7,3,-1,4,6,-1,4,3,349,199,150,36,16,20,93,16,139,54,48,-1,46,7,82,38,24,3,47,9,57,16,24,-4,12,0,13,7,5,-6,3,-1,6,4,2,-1,9,1,7,3,3,-5
29,29039,Casabermeja,2958,16,4,12,9,5,4,1,3,0,6,-2,8,-2,-1,1,4,-2,4,3,4,-1,2,0,4,0,2,2,3,2,0,0,0,1,2,2,0,0,2,1,1,0,0,-7,-10,3,15,7,8,-5,9,-11,-4,6,-2,-4,-1,-4,-3,3,-1,-1,10,-7,-1,3,-1,2,7,2,1,3,0,1,2,2,1,1,0,1,5,0,0,2,0,68,34,34,27,11,16,4,8,17,18,26,-5,-4,4,15,7,15,-3,8,4,2,11,11,-2,4,6,4,5,7,1,1,2,1,2,4,1,3,4,3,3,3,0,127,62,65,45,26,19,19,15,21,27,36,10,7,6,11,14,20,5,12,9,10,13,16,5,10,7,8,10,9,1,6,4,6,6,4,0,4,3,2,4,5,1,123,71,52,43,26,17,38,4,35,35,7,3,19,2,22,21,5,1,19,2,13,14,2,2,12,2,12,13,4,0,7,1,8,6,3,1,5,1,4,7,1,-1,132,73,59,51,30,21,17,17,39,25,25,9,9,11,23,12,11,7,8,6,16,13,14,2,10,6,19,9,6,1,6,2,13,4,4,1,4,4,6,5,2,0,84,37,47,36,19,17,25,15,16,22,4,3,10,10,2,14,3,-1,15,5,14,8,1,4,9,9,7,8,2,1,4,5,2,7,1,0,5,4,5,1,1,1,53,48,5,30,20,10,0,22,4,20,11,-3,-1,20,16,9,6,-1,1,2,-12,11,5,-2,2,14,1,9,3,1,1,10,3,3,2,1,1,4,-2,6,1,0,30,26,4,33,20,13,0,17,10,11,6,-13,2,15,5,7,4,-7,-2,2,5,4,2,-6,3,8,11,6,3,1,2,6,7,1,2,1,1,2,4,5,1,0,34,15,19,17,7,10,1,10,3,6,5,6,3,2,-4,3,2,6,-2,8,7,3,3,0,0,6,2,3,3,2,0,1,3,0,1,1,0,5,-1,3,2,1,125,84,41,27,23,4,-2,24,39,25,19,20,-1,20,31,13,14,7,-1,4,8,12,5,13,-3,15,5,4,2,4,-1,12,5,3,2,2,-2,3,0,1,0,2,29,42,-13,47,38,9,-8,12,3,16,15,-10,-2,7,11,22,14,-10,-6,5,-8,-6,1,0,6,5,14,17,6,-1,3,5,14,13,4,-1,3,0,0,4,2,0,-27,-24,-3,-12,-15,3,8,-11,1,-18,-5,0,2,-7,-6,-11,-3,1,6,-4,7,-7,-2,-1,-2,-6,-4,1,0,-1,-2,-5,-6,-2,1,-1,0,-1,2,3,-1,0,-72,-36,-36,7,-1,8,-11,-7,-9,-28,-9,-6,-5,-2,-8,-14,-5,-1,-6,-5,-1,-14,-4,-5,4,3,-2,-2,4,0,2,2,-2,-4,1,0,2,1,0,2,3,0,-40,-16,-24,17,11,6,-3,-1,-14,-9,-7,-5,0,-2,-1,-8,-7,2,-3,1,-13,-1,0,-7,3,2,5,2,3,2,2,0,4,3,1,1,1,2,1,-1,2,1,-63,-41,-22,-86,-52,-34,1,4,-22,-20,-9,-17,3,5,-16,-13,-7,-12,-2,-1,-6,-7,-2,-5,-9,-2,-18,-27,-20,-10,-8,2,-10,-17,-13,-6,-1,-4,-8,-10,-7,-4,36,17,19,-1,-4,3,8,15,18,3,1,-3,1,15,9,0,-1,-3,7,0,9,3,2,0,-2,3,-3,-2,3,0,-2,2,-3,-1,0,0,0,1,0,-1,3,0,93,36,57,24,9,15,24,9,15,24,18,0,13,10,-2,13,6,-5,11,-1,17,11,12,5,5,2,5,3,6,2,3,1,2,0,2,0,2,1,3,3,4,2
29,29040,Casarabonela,2559,-14,-2,-12,8,7,1,0,-4,-9,-1,3,-3,0,-1,-2,0,2,-1,0,-3,-7,-1,1,-2,3,0,0,0,4,1,3,0,0,0,3,1,0,0,0,0,1,0,0,-3,3,6,4,2,2,3,-10,5,4,-5,-1,0,-4,0,3,-2,3,3,-6,5,1,-3,0,0,1,2,3,0,0,0,1,1,2,0,0,0,0,1,1,0,26,10,16,36,17,19,2,1,-2,13,10,3,2,-2,0,5,6,0,0,3,-2,8,4,3,10,-1,5,12,9,1,5,-1,2,6,5,0,5,0,3,6,4,1,24,10,14,43,22,21,-5,3,-1,7,13,7,-2,2,-2,1,7,4,-3,1,1,6,6,3,6,1,3,18,11,4,4,0,1,9,6,2,2,1,2,9,5,2,110,59,51,88,50,38,14,16,25,16,40,-2,3,7,18,11,19,1,11,9,7,5,21,-3,13,8,13,18,31,5,6,5,10,11,15,3,7,3,3,7,16,2,57,36,21,58,30,28,-1,15,12,11,23,-3,1,11,10,5,11,-1,-2,4,2,6,12,-2,1,11,20,12,14,0,0,6,10,6,8,0,1,5,10,6,6,0,118,83,35,102,68,34,21,13,22,32,22,7,14,12,14,25,11,6,7,1,8,7,11,1,11,19,28,22,18,3,5,14,17,19,9,3,6,5,11,3,9,0,23,21,2,53,30,23,-5,10,-10,12,17,0,-3,7,0,6,9,3,-2,3,-10,6,8,-3,4,12,7,9,18,3,2,5,8,3,10,2,2,7,-1,6,8,1,33,15,18,22,12,10,6,0,-1,8,21,-3,-1,-3,6,4,9,-1,7,3,-7,4,12,-2,5,-1,6,4,7,0,1,-2,5,4,4,0,4,1,1,0,3,0,-33,-34,1,-34,-28,-6,4,-1,-12,-13,1,-13,0,0,-10,-15,-1,-8,4,-1,-2,2,2,-5,0,-5,-12,-16,-1,0,0,-3,-10,-15,0,0,0,-2,-2,-1,-1,0,3,7,-4,2,1,1,0,6,2,-6,3,-1,2,1,-1,0,5,1,-2,5,3,-6,-2,-2,0,1,-4,1,3,1,0,0,-2,1,2,0,0,1,-2,0,1,1,23,16,7,7,-2,9,8,-1,0,9,7,1,3,2,3,3,5,1,5,-3,-3,6,2,0,1,1,2,-2,4,1,-1,1,-1,-3,2,0,2,0,3,1,2,1,-36,-17,-19,-10,-9,-1,-6,0,0,-20,-1,-8,-3,-1,3,-14,3,-3,-3,1,-3,-6,-4,-5,-3,-2,-1,-5,4,-3,-2,-3,0,-5,2,-1,-1,1,-1,0,2,-2,-19,-20,1,-9,-7,-2,-8,-10,-6,-7,-3,19,-4,-7,-3,-8,-1,4,-4,-3,-3,1,-2,15,-1,0,-3,-4,-2,1,0,-1,-2,-2,-2,0,-1,1,-1,-2,0,1,28,13,15,-13,-6,-7,8,0,-6,11,5,9,7,-1,-3,4,2,4,1,1,-3,7,3,5,-1,-2,-5,0,-3,-2,0,-2,-2,1,-2,-1,-1,0,-3,-1,-1,-1,-15,-9,-6,-43,-31,-12,3,1,1,-7,-11,-2,4,-2,-3,-1,-5,-2,-1,3,4,-6,-6,0,-2,-2,-5,-12,-11,-11,0,-2,-5,-11,-6,-7,-2,0,0,-1,-5,-4,-24,-18,-6,-14,-9,-5,2,-8,-7,-5,0,-7,-1,-3,-3,-5,-1,-5,3,-5,-4,0,1,-2,-1,-1,-6,-1,-6,1,0,0,-4,-2,-3,0,-1,-1,-2,1,-3,1,-10,-2,-8,8,3,5,-6,-1,-6,-4,-1,6,-1,0,-2,-2,-3,4,-5,-1,-4,-2,2,2,0,0,3,-2,7,0,0,0,2,-1,2,0,0,0,1,-1,5,0
29,29041,Casares,3224,18,18,0,48,29,19,5,-1,9,3,0,2,4,5,4,6,-1,1,1,-6,5,-3,1,1,7,5,14,12,5,4,6,3,7,8,3,2,1,2,7,4,2,2,22,11,11,31,18,13,-4,11,3,10,8,-5,3,2,0,2,8,-3,-7,9,3,8,0,-2,2,2,9,7,9,2,2,0,4,4,7,1,0,2,5,3,2,1,183,86,97,118,61,57,32,23,40,48,30,8,9,15,23,21,12,4,23,8,17,27,18,4,18,12,26,30,29,1,7,8,15,15,14,0,11,4,11,15,15,1,195,103,92,165,88,77,46,18,65,33,26,7,26,6,31,20,16,5,20,12,34,13,10,2,40,13,38,35,30,7,22,4,17,22,18,4,18,9,21,13,12,3,185,103,82,140,75,65,30,28,33,59,37,0,12,13,19,35,21,2,18,15,14,24,16,-2,25,19,25,40,23,8,14,6,14,23,12,6,11,13,11,17,11,2,211,99,112,177,95,82,42,19,54,46,38,11,21,7,25,20,19,7,21,12,29,26,19,4,28,16,42,47,35,7,17,6,23,24,18,5,11,10,19,23,17,2,282,145,137,213,112,101,34,42,90,51,48,10,24,21,37,33,21,8,10,21,53,18,27,2,36,24,46,45,45,13,18,12,24,27,21,8,18,12,22,18,24,5,244,152,92,232,125,107,45,45,83,29,44,-9,31,34,57,13,15,-3,14,11,26,16,29,-6,56,37,56,38,38,4,35,21,33,16,16,2,21,16,23,22,22,2,195,75,120,145,80,65,36,11,67,40,35,2,21,-2,23,17,17,-3,15,13,44,23,18,5,36,16,38,28,23,2,22,8,20,16,12,1,14,8,18,12,11,1,171,106,65,137,67,70,13,4,35,29,66,21,9,5,25,21,31,13,4,-1,10,8,35,8,26,9,27,1,50,21,13,6,14,-3,21,14,13,3,13,4,29,7,129,30,99,-15,-29,14,42,31,48,13,4,-15,11,6,21,-6,4,-7,31,25,27,19,0,-8,13,-2,0,-4,-7,-17,2,-6,-8,-4,-4,-10,11,4,8,0,-3,-7,269,137,132,125,56,69,49,10,83,51,51,28,29,-4,47,26,23,19,20,14,36,25,28,9,10,14,24,27,36,13,2,5,12,10,16,11,8,9,12,17,20,2,278,164,114,152,92,60,39,36,80,58,40,11,27,17,43,41,20,7,12,19,37,17,20,4,21,16,41,29,28,12,12,9,25,20,11,11,9,7,16,9,17,1,252,131,121,125,63,62,35,28,62,58,47,20,21,10,32,28,30,9,14,18,30,30,17,11,15,9,27,19,38,15,9,5,10,11,18,8,6,4,17,8,20,7,294,150,144,152,82,70,46,19,56,66,58,41,16,10,24,39,30,25,30,9,32,27,28,16,29,15,13,28,38,24,14,5,4,19,24,14,15,10,9,9,14,10,74,36,38,60,34,26,6,2,42,-19,34,0,3,1,16,-8,9,7,3,1,26,-11,25,-7,10,1,16,-6,23,12,8,-3,6,1,11,8,2,4,10,-7,12,4,152,63,89,116,53,63,35,-7,24,39,35,24,24,-13,15,12,17,9,11,6,9,27,18,15,15,8,22,18,34,17,9,1,10,7,16,9,6,7,12,11,18,8,489,268,221,215,117,98,90,58,116,96,83,39,56,22,58,63,40,25,34,36,58,33,43,14,30,18,28,48,61,28,14,7,14,28,35,18,16,11,14,20,26,10
29,29042,Coín,17627,71,50,21,3,2,1,0,10,28,7,28,1,6,4,23,2,17,-1,-6,6,5,5,11,2,1,0,1,1,0,0,1,0,0,1,0,0,0,0,1,0,0,0,48,64,-16,7,5,2,2,6,6,12,24,-3,3,11,21,9,18,2,-1,-5,-15,3,6,-5,0,0,4,2,1,0,0,0,3,1,1,0,0,0,1,1,0,0,52,64,-12,14,7,7,19,-5,-17,34,20,0,12,0,12,24,10,5,7,-5,-29,10,10,-5,3,2,4,1,3,1,0,2,3,0,1,1,3,0,1,1,2,0,445,275,170,389,215,174,103,56,98,123,63,-6,64,39,64,65,42,-3,39,17,34,58,21,-3,90,44,91,100,48,8,52,25,51,50,29,5,38,19,40,50,19,3,861,514,347,701,415,286,160,116,256,156,150,9,87,74,151,95,89,7,73,42,105,61,61,2,133,89,206,133,121,11,80,50,120,82,71,8,53,39,86,51,50,3,808,484,324,537,300,237,150,164,252,166,49,11,77,96,164,102,33,6,73,68,88,64,16,5,113,114,148,100,50,5,56,65,88,55,28,4,57,49,60,45,22,1,477,269,208,326,154,172,125,70,165,56,59,-4,70,42,98,30,31,-7,55,28,67,26,28,3,93,61,78,47,50,-5,45,30,36,21,22,-1,48,31,42,26,28,-4,451,238,213,350,152,198,89,77,118,84,44,27,64,26,60,46,22,14,25,51,58,38,22,13,83,74,81,68,25,14,50,19,29,30,12,10,33,55,52,38,13,4,213,96,117,323,164,159,85,36,-11,50,57,-1,52,11,-19,27,26,-2,33,25,8,23,31,1,92,49,54,65,47,13,50,22,29,31,23,7,42,27,25,34,24,6,130,63,67,179,76,103,23,15,3,47,35,2,8,-6,2,22,28,10,15,21,1,25,7,-8,37,26,36,41,32,3,16,2,15,22,16,4,21,24,21,19,16,-1,188,100,88,134,69,65,51,5,61,23,37,11,38,3,19,14,15,10,13,2,42,9,22,1,18,14,31,23,37,10,12,3,12,16,19,8,6,11,19,7,18,2,197,90,107,178,85,93,52,11,34,31,35,24,21,4,16,21,17,9,31,7,18,10,18,15,44,13,40,32,33,16,25,6,17,14,16,7,19,7,23,18,17,9,0,28,-28,51,27,24,20,-2,-6,-11,1,-2,12,-2,-4,17,5,0,8,0,-2,-28,-4,-2,18,13,-3,3,17,3,13,4,-4,1,9,4,5,9,1,2,8,-1,-9,-40,31,16,-11,27,-7,-12,-25,-1,48,-16,-5,4,-23,-25,22,-12,-2,-16,-2,24,26,-4,-3,2,-5,-11,28,4,-1,1,-13,-14,13,1,-2,1,8,3,15,3,111,63,48,90,60,30,19,0,0,29,35,25,18,10,-9,10,23,12,1,-10,9,19,12,13,13,6,19,16,13,20,16,8,11,3,11,10,-3,-2,8,13,2,10,61,8,53,66,29,37,31,-4,35,-25,16,1,2,-10,18,-10,3,2,29,6,17,-15,13,-1,18,7,14,-5,24,5,8,2,5,0,12,1,10,5,9,-5,12,4,24,-17,41,69,31,38,0,-36,17,-4,25,9,0,-29,-5,-15,16,6,0,-7,22,11,9,3,5,1,20,11,16,11,5,-1,9,5,6,4,0,2,11,6,10,7,227,130,97,53,34,19,52,-26,64,50,68,7,23,-22,43,16,51,12,29,-4,21,34,17,-5,0,0,28,-6,27,1,-2,1,22,-15,19,7,2,-1,6,9,8,-6
29,29044,Comares,1407,-12,-4,-8,35,22,13,-11,-2,-5,6,3,-3,-10,2,-2,6,2,-2,-1,-4,-3,0,1,-1,3,5,8,11,7,1,1,5,4,7,4,1,2,0,4,4,3,0,11,17,-6,28,18,10,-1,-1,-7,12,10,-2,0,1,0,7,10,-1,-1,-2,-7,5,0,-1,3,2,1,14,8,0,1,2,1,8,6,0,2,0,0,6,2,0,20,20,0,38,22,16,4,8,-2,7,6,-4,6,4,4,4,2,-1,-2,4,-6,3,4,-3,7,5,10,10,4,1,3,3,6,6,2,1,4,2,4,4,2,0,54,25,29,60,29,31,4,3,12,11,23,1,1,2,5,8,9,0,3,1,7,3,14,1,9,7,11,14,16,3,3,4,4,9,8,1,6,3,7,5,8,2,70,45,25,74,46,28,0,13,16,20,20,1,0,7,16,13,5,4,0,6,0,7,15,-3,4,11,20,21,16,2,2,7,15,14,7,1,2,4,5,7,9,1,47,24,23,62,30,32,4,6,3,13,24,-3,0,7,2,4,10,1,4,-1,1,9,14,-4,3,8,14,11,21,5,0,7,7,3,9,4,3,1,7,8,12,1,65,31,34,63,32,31,8,8,-1,16,33,2,3,7,-1,6,17,0,5,1,0,10,16,2,7,7,9,16,21,3,3,4,6,8,11,0,4,3,3,8,10,3,12,8,4,52,27,25,0,-9,-11,10,27,-4,0,-6,-4,4,14,0,0,-3,-7,6,13,-4,1,2,4,10,32,3,0,1,4,3,17,2,1,1,0,7,15,1,27,12,15,69,30,39,2,-1,2,10,21,-7,-1,-1,-3,7,12,-2,3,0,5,3,9,-5,11,5,9,17,23,4,2,1,4,10,11,2,9,4,5,7,12,2,22,15,7,34,14,20,-2,4,-1,5,18,-2,0,6,-7,4,12,0,-2,-2,6,1,6,-2,0,4,2,6,19,3,0,3,-3,3,10,1,0,1,5,3,9,2,38,22,16,39,25,14,6,2,2,10,15,5,3,-2,-1,10,7,6,3,4,3,0,8,-1,5,1,7,9,11,6,4,1,4,5,6,5,1,0,3,4,5,1,16,6,10,21,10,11,7,2,-7,3,11,0,4,4,-6,-2,3,3,3,-2,-1,5,8,-3,1,0,-1,3,16,2,0,0,-1,2,6,3,1,0,0,1,10,-1,-44,-26,-18,18,7,11,-8,-7,-13,-12,-3,1,-4,-5,-6,-6,-2,-1,-4,-2,-7,-6,-1,2,2,1,1,5,6,3,2,0,0,2,2,1,0,1,1,3,4,2,6,10,-4,3,2,1,-2,2,-5,0,5,4,-3,0,1,2,3,5,1,2,-6,-2,2,-1,-1,-1,-2,3,3,1,0,-2,0,0,2,2,-1,1,-2,3,1,-1,-45,-15,-30,-23,-8,-15,1,-11,-14,-5,-5,-10,1,-5,-7,1,1,-7,0,-6,-7,-6,-6,-3,2,-3,-11,-2,-5,-5,2,-1,-6,1,-2,-3,0,-2,-5,-3,-3,-2,-133,-66,-67,-128,-62,-66,-19,-21,-12,-32,-20,-30,-8,-12,-5,-18,-14,-10,-11,-9,-7,-14,-6,-20,-15,-17,-11,-31,-23,-31,-6,-8,-4,-16,-16,-12,-9,-9,-7,-15,-7,-19,16,12,4,19,11,8,2,5,3,-4,17,-6,3,3,1,-3,10,-1,-1,2,2,-1,7,-5,1,4,6,1,8,-1,0,2,3,0,6,0,1,2,3,1,2,-1,14,13,1,19,13,6,2,-2,-2,2,19,-5,4,2,0,-1,11,-3,-2,-4,-2,3,8,-2,1,-3,1,2,17,1,1,0,2,-2,11,1,0,-3,-1,4,6,0
29,29045,Cómpeta,2703,38,24,14,67,35,32,-8,6,6,13,19,3,-2,3,4,6,10,3,-6,3,2,7,9,0,3,6,8,20,26,4,2,3,3,9,14,4,1,3,5,11,12,0,46,26,20,68,40,28,-1,2,11,15,18,2,-2,2,9,8,12,-2,1,0,2,7,6,4,7,4,18,18,16,5,5,3,10,8,12,2,2,1,8,10,4,3,159,87,72,144,86,58,27,15,30,40,41,5,12,12,18,18,24,3,15,3,12,22,17,2,25,12,23,33,35,14,12,12,16,17,20,8,13,0,7,16,15,6,165,110,55,149,95,54,15,32,35,29,54,1,13,29,25,13,31,-1,2,3,10,16,23,2,15,21,25,27,55,6,13,20,17,14,29,2,2,1,8,13,26,4,54,34,20,125,65,60,-2,5,0,12,42,-3,-4,5,3,9,22,-2,2,0,-3,3,20,-1,15,5,19,25,52,7,7,4,10,14,24,5,8,1,9,11,28,2,150,79,71,173,90,83,26,15,8,29,72,0,9,14,3,12,38,2,17,1,5,17,34,-2,30,8,17,37,71,9,13,5,11,15,39,6,17,3,6,22,32,3,136,61,75,175,89,86,29,-10,8,33,68,8,18,-6,0,10,33,7,11,-4,8,23,35,1,26,6,18,39,76,9,14,2,11,18,38,6,12,4,7,21,38,3,82,34,48,114,53,61,7,-3,-9,24,52,10,10,2,-17,8,27,5,-3,-5,8,16,25,5,14,5,0,28,52,15,11,4,-8,10,28,8,3,1,8,18,24,7,74,35,39,102,54,48,7,2,-5,12,55,5,11,-1,-14,6,23,10,-4,3,9,6,32,-5,11,2,11,19,51,8,11,2,0,11,24,6,0,0,11,8,27,2,14,4,10,46,18,28,-4,-6,-7,-9,40,-2,-3,-2,-4,-9,22,0,-1,-4,-3,0,18,-2,4,0,1,6,38,-4,1,-1,-1,-1,21,-1,3,1,2,7,17,-3,-28,-24,-4,24,4,20,-15,-15,-17,-7,24,2,-7,-11,-16,-5,12,2,-8,-4,-1,-2,12,0,0,-1,-4,8,21,-1,-1,-1,-6,2,9,1,1,0,2,6,12,-2,25,3,22,50,25,25,-1,-2,-4,-5,31,8,0,0,-11,-4,14,5,-1,-2,7,-1,17,3,0,2,1,5,34,9,1,2,-3,0,18,7,-1,0,4,5,16,2,55,30,25,76,42,34,-6,4,-3,13,51,-2,-4,-5,5,3,32,0,-2,9,-8,10,19,-2,5,-4,3,12,55,5,3,-4,2,3,33,5,2,0,1,9,22,0,18,14,4,43,23,20,6,-21,5,12,10,4,-1,-12,6,7,8,4,7,-9,-1,5,2,0,4,2,5,10,18,4,2,-1,4,3,11,4,2,3,1,7,7,0,56,17,39,90,36,54,6,-3,-5,2,56,-1,3,-6,-5,1,29,-5,3,3,0,1,27,4,4,0,6,11,57,11,-1,-2,1,6,29,3,5,2,5,5,28,8,-116,-50,-66,-92,-40,-52,-13,-3,-16,-5,8,-86,0,-1,-4,-1,7,-50,-13,-2,-12,-4,1,-36,-6,-2,-15,-1,8,-76,2,-1,-5,3,6,-45,-8,-1,-10,-4,2,-31,52,8,44,80,29,51,-1,-9,-5,11,87,-31,-3,-7,-8,3,36,-13,2,-2,3,8,51,-18,5,-11,2,14,91,-21,1,-3,-4,6,36,-7,4,-8,6,8,55,-14,56,23,33,55,26,29,5,-7,6,30,39,-18,0,-9,4,15,25,-13,5,2,2,15,14,-5,1,-5,6,21,46,-14,1,-6,4,8,28,-9,0,1,2,13,18,-5
29,29048,Cuevas del Becerro,1933,10,7,3,5,3,2,1,-1,4,-4,7,3,0,0,3,-3,4,3,1,-1,1,-1,3,0,1,0,3,0,1,0,0,0,2,0,1,0,1,0,1,0,0,0,39,18,21,11,7,4,5,2,5,6,15,5,2,2,2,2,7,2,3,0,3,4,8,3,2,2,2,3,1,0,1,1,1,2,1,0,1,1,1,1,0,0,5,7,-2,1,4,-3,2,2,-5,2,3,2,4,2,-4,3,2,0,-2,0,-1,-1,1,2,3,1,-2,-1,0,0,3,1,-1,1,0,0,0,0,-1,-2,0,0,-12,-3,-9,0,0,0,0,-1,-8,3,-2,-4,0,-1,-4,2,0,-1,0,0,-4,1,-2,-3,0,-1,0,2,-2,1,0,-1,0,1,-1,1,0,0,0,1,-1,0,-16,-6,-10,4,1,3,-1,-4,-9,-3,1,0,0,-2,-4,0,1,-1,-1,-2,-5,-3,0,1,1,0,-1,0,1,3,0,0,-1,0,1,1,1,0,0,0,0,2,18,10,8,15,10,5,8,6,7,1,0,-3,4,1,3,1,2,-2,4,5,4,0,-2,-1,4,2,2,4,2,1,3,1,1,2,2,1,1,1,1,2,0,0,20,15,5,10,6,4,-2,0,8,8,5,0,-3,4,5,6,1,1,1,-4,3,2,4,-1,1,1,2,4,3,-1,0,1,1,3,1,0,1,0,1,1,2,-1,-20,-4,-16,7,0,7,-5,-1,-13,-4,4,0,-1,3,-5,-4,1,2,-4,-4,-8,0,3,-2,0,-1,2,2,4,0,-2,0,0,0,2,0,2,-1,2,2,2,0,-1,-10,9,4,-3,7,-4,4,3,6,-3,-8,-1,-2,-1,1,-5,-3,-3,6,4,5,2,-5,1,2,2,1,-1,-1,0,0,0,-1,-1,-1,1,2,2,2,0,0,-20,-9,-11,1,0,1,-2,-5,-5,-10,1,3,0,-5,1,-8,2,2,-2,0,-6,-2,-1,1,0,0,-1,0,2,0,0,0,0,-1,1,0,0,0,-1,1,1,0,37,23,14,10,6,4,7,6,7,10,8,-1,4,4,3,6,4,2,3,2,4,4,4,-3,3,1,-2,3,5,0,1,1,-1,2,3,0,2,0,-1,1,2,0,-23,-8,-15,-1,-3,2,-7,2,-10,-2,0,-7,-4,3,-4,-1,2,-4,-3,-1,-6,-1,-2,-3,0,0,-1,1,1,-2,0,-1,-2,0,1,-1,0,1,1,1,0,-1,-24,-14,-10,-5,-3,-2,-2,-3,-9,-5,-2,-3,-1,-3,-5,-4,-1,0,-1,0,-4,-1,-1,-3,-2,1,-2,-2,0,0,-1,0,-1,-1,0,0,-1,1,-1,-1,0,0,-11,-4,-7,-1,1,-2,0,-4,-6,0,-1,-1,0,-3,-2,0,1,-1,0,-1,-4,0,-2,0,0,0,-1,-1,0,1,0,0,0,0,0,1,0,0,-1,-1,0,0,-13,-2,-11,-4,-2,-2,0,-4,-5,0,1,-4,2,-3,-1,2,0,-2,-2,-1,-4,-2,1,-2,0,-2,-3,0,2,0,0,-1,-2,0,1,0,0,-1,-1,0,1,0,-19,-15,-4,-5,-4,-1,0,0,-5,-4,2,-11,-1,-3,-4,-3,1,-4,1,3,-1,-1,1,-7,-1,0,-4,0,1,-1,-1,-1,-2,0,0,0,0,1,-2,0,1,-1,-4,-3,-1,0,-1,1,1,4,-7,1,4,-7,0,-1,-3,0,4,-3,1,5,-4,1,0,-4,0,1,-1,0,0,0,0,0,-1,0,0,0,0,1,0,0,0,0,1,7,-6,-2,1,-3,-1,5,-1,-1,-2,1,2,5,-1,0,-1,2,-3,0,0,-1,-1,-1,0,0,0,-1,-1,0,1,1,0,0,-1,0,-1,-1,0,-1,0,0
29,29050,Cútar,609,10,6,4,3,2,1,3,-1,5,2,1,0,2,0,3,1,0,0,1,-1,2,1,1,0,0,1,0,1,1,0,0,1,0,0,1,0,0,0,0,1,0,0,16,10,6,10,8,2,5,2,-2,7,5,-1,4,2,0,4,1,-1,1,0,-2,3,4,0,6,0,0,4,0,0,5,0,0,3,0,0,1,0,0,1,0,0,20,10,10,10,6,4,4,7,1,0,8,0,4,2,-1,-1,6,0,0,5,2,1,2,0,2,0,1,3,4,0,2,0,1,0,3,0,0,0,0,3,1,0,13,4,9,7,4,3,3,0,0,1,8,1,3,-2,-1,-2,5,1,0,2,1,3,3,0,2,0,1,1,2,1,2,0,0,0,1,1,0,0,1,1,1,0,8,2,6,21,9,12,3,-2,-5,3,9,0,-2,1,-1,0,3,1,5,-3,-4,3,6,-1,4,1,2,2,12,0,0,1,1,1,6,0,4,0,1,1,6,0,9,9,0,21,11,10,-2,-6,-5,3,15,4,1,-2,-3,3,8,2,-3,-4,-2,0,7,2,0,1,1,4,15,0,0,1,0,3,7,0,0,0,1,1,8,0,20,13,7,25,13,12,-2,-3,1,12,13,-2,-2,0,0,8,6,0,0,-3,1,4,7,-2,1,1,0,11,12,-1,0,1,0,6,5,0,1,0,0,5,7,-1,4,4,0,14,4,10,5,-2,-3,4,2,-1,1,-3,0,4,3,0,4,1,-3,0,-1,-1,2,2,3,4,2,1,0,0,1,1,2,0,2,2,2,3,0,1,27,12,15,15,5,10,6,0,-2,13,11,-1,2,0,-1,6,7,-2,4,0,-1,7,4,1,3,-1,1,2,10,0,1,-1,-1,1,5,0,2,0,2,1,5,0,0,2,-2,4,3,1,-4,-1,1,-1,5,1,-3,0,2,0,4,-1,-1,-1,-1,-1,1,2,1,0,0,0,3,0,1,0,0,0,2,0,0,0,0,0,1,0,14,6,8,7,3,4,-2,0,-2,3,8,7,-1,-1,-2,3,3,4,-1,1,0,0,5,3,0,0,1,2,3,1,0,0,1,0,1,1,0,0,0,2,2,0,0,1,-1,9,5,4,1,1,-3,1,4,-4,-1,0,-1,1,4,-2,2,1,-2,0,0,-2,0,0,0,0,9,0,0,0,0,0,5,0,0,0,0,0,4,0,-5,0,-5,5,5,0,-1,3,-3,-4,5,-7,2,2,-1,-2,2,-4,-3,1,-2,-2,3,-3,-2,1,0,0,5,1,0,1,0,0,3,1,-2,0,0,0,2,0,5,1,4,6,3,3,1,-2,5,-3,4,1,-1,2,1,-3,2,0,2,-4,4,0,2,1,1,1,0,2,2,0,1,1,0,0,1,0,0,0,0,2,1,0,-12,-5,-7,3,3,0,-3,3,-3,-1,-2,-5,-1,1,-2,2,-2,-2,-2,2,-1,-3,0,-3,1,0,0,1,1,0,1,0,0,1,0,1,0,0,0,0,1,-1,4,3,1,13,6,7,0,0,-1,2,8,-3,1,0,0,0,3,0,-1,0,-1,2,5,-3,0,0,1,3,8,1,0,0,0,1,4,1,0,0,1,2,4,0,6,9,-3,5,4,1,0,-1,-1,3,4,1,0,2,-1,2,3,3,0,-3,0,1,1,-2,0,1,0,0,1,3,0,1,0,0,1,2,0,0,0,0,0,1,1,-1,2,6,4,2,1,-3,0,3,0,0,0,0,-2,1,0,0,1,-3,2,2,0,0,0,0,0,1,5,0,0,0,0,1,3,0,0,0,0,0,2,0
29,29051,Estepona,40552,1157,575,582,686,339,347,171,196,343,212,147,83,82,83,177,121,73,38,89,113,166,91,74,45,116,79,181,151,107,48,57,31,87,81,52,28,59,48,94,70,55,20,1983,1016,967,1132,563,569,385,256,583,401,216,126,189,127,300,228,107,58,196,129,283,173,109,68,216,122,286,256,166,75,103,62,135,138,80,42,113,60,151,118,86,33,2492,1268,1224,1512,779,733,417,382,785,411,342,140,226,181,381,220,175,71,191,201,404,191,167,69,272,196,440,255,252,86,151,83,220,140,124,53,121,113,220,115,128,33,2675,1387,1288,1632,869,763,389,440,834,516,357,121,168,248,442,275,179,69,221,192,392,241,178,52,264,216,383,379,293,90,130,115,221,198,144,58,134,101,162,181,149,32,3677,2085,1592,2151,1177,974,504,580,1200,755,415,197,276,312,700,458,248,83,228,268,500,297,167,114,325,331,585,454,349,97,181,173,320,254,194,50,144,158,265,200,155,47,3499,1962,1537,2130,1149,981,552,595,1057,791,329,157,309,303,628,467,159,83,243,292,429,324,170,74,308,341,581,519,286,87,161,178,335,281,135,51,147,163,246,238,151,36,2211,1123,1088,1559,728,831,380,441,647,396,212,114,189,218,357,215,76,63,191,223,290,181,136,51,313,323,383,269,193,65,162,150,160,137,78,36,151,173,223,132,115,29,1806,812,994,1024,463,561,449,242,499,220,204,173,210,116,193,108,100,80,239,126,306,112,104,93,265,197,197,109,151,93,155,97,51,42,61,52,110,100,146,67,90,41,2301,1100,1201,1395,661,734,261,164,458,370,603,417,145,35,182,158,315,242,116,129,276,212,288,175,192,157,225,149,405,250,103,51,94,49,189,163,89,106,131,100,216,87,228,16,212,277,49,228,17,-24,-13,-86,109,201,-9,-34,-37,-77,55,103,26,10,24,-9,54,98,100,27,7,-5,90,48,32,-3,-39,-28,46,34,68,30,46,23,44,14,-705,-484,-221,-535,-387,-148,-150,-103,-272,-262,16,50,-80,-59,-222,-161,-10,40,-70,-44,-50,-101,26,10,-64,-27,-226,-236,-11,15,-35,-23,-169,-156,-15,7,-29,-4,-57,-80,4,8,876,440,436,461,228,233,96,77,132,126,218,213,69,13,101,33,116,97,27,64,31,93,102,116,85,48,37,86,136,53,48,13,16,42,68,34,37,35,21,44,68,19,525,212,313,201,64,137,76,32,128,29,128,113,37,6,55,-39,69,71,39,26,73,68,59,42,3,46,43,7,57,28,9,-5,14,-13,25,25,-6,51,29,20,32,3,291,131,160,-25,-28,3,60,-31,118,5,111,16,70,-27,31,-7,49,8,-10,-4,87,12,62,8,9,-9,-2,-72,40,-6,27,-18,-9,-47,16,-3,-18,9,7,-25,24,-3,1221,566,655,672,293,379,207,80,326,214,221,155,92,42,150,70,118,87,115,38,176,144,103,68,111,68,95,114,164,105,52,38,29,30,77,62,59,30,66,84,87,43,-557,-328,-229,-935,-501,-434,142,-67,60,-241,-134,-341,104,-55,2,-139,-66,-182,38,-12,58,-102,-68,-159,82,-92,-45,-296,-168,-431,60,-60,-36,-162,-90,-223,22,-32,-9,-134,-78,-208,-144,-114,-30,-399,-248,-151,179,4,87,-145,-76,-220,116,-9,66,-123,-48,-132,63,13,21,-22,-28,-88,146,16,9,-157,-113,-315,83,-1,9,-105,-73,-171,63,17,0,-52,-40,-144,-698,-478,-220,-756,-465,-291,-196,-171,105,-122,-40,-298,-123,-88,-1,-85,-22,-169,-73,-83,106,-37,-18,-129,-123,-125,35,-146,-88,-320,-62,-71,4,-100,-60,-181,-61,-54,31,-46,-28,-139
29,29053,Frigiliana,2157,19,7,12,50,23,27,0,5,-2,-1,11,6,-3,4,-3,-2,5,6,3,1,1,1,6,0,7,7,8,9,11,8,1,4,4,5,5,4,6,3,4,4,6,4,44,19,25,36,16,20,10,1,15,12,6,-2,6,3,6,6,0,-3,4,-2,9,6,6,1,9,4,5,10,6,1,4,2,1,6,1,1,5,2,4,4,5,0,63,36,27,67,38,29,14,5,7,21,12,3,7,5,5,11,8,0,7,0,2,10,4,3,9,10,5,22,15,6,6,6,2,13,9,2,3,4,3,9,6,4,186,100,86,153,81,72,49,14,36,50,25,7,26,10,19,22,16,3,23,4,17,28,9,4,37,13,28,36,24,10,18,8,12,18,15,6,19,5,16,18,9,4,122,65,57,117,56,61,17,3,25,24,49,6,7,2,10,14,32,0,10,1,15,10,17,6,13,4,12,25,54,9,4,1,7,10,31,3,9,3,5,15,23,6,156,77,79,148,68,80,22,14,13,45,54,8,13,9,0,26,26,4,9,5,13,19,28,4,20,9,22,35,52,10,9,4,9,15,25,6,11,5,13,20,27,4,161,81,80,161,73,88,31,7,27,58,36,4,6,2,20,30,19,4,25,5,7,28,17,0,33,9,20,51,43,5,8,4,9,26,22,4,25,5,11,25,21,1,135,59,76,153,75,78,24,18,8,36,41,3,7,5,3,16,21,5,17,13,5,20,20,-2,36,16,15,36,38,9,16,6,8,17,19,7,20,10,7,19,19,2,98,43,55,116,55,61,20,7,23,12,27,7,8,0,11,3,14,6,12,7,12,9,13,1,21,10,16,25,33,10,9,3,8,11,17,6,12,7,8,14,16,4,99,49,50,95,52,43,18,-12,15,35,31,11,7,-9,2,22,16,10,11,-3,13,13,15,1,11,1,9,24,32,18,5,-2,6,16,14,13,6,3,3,8,18,5,103,52,51,89,48,41,18,17,15,18,28,5,16,12,3,8,15,-1,2,5,12,10,13,6,16,4,12,20,29,6,11,3,6,11,16,1,5,1,6,9,13,5,93,51,42,69,39,30,14,-1,19,24,27,11,7,0,10,9,15,11,7,-1,9,15,12,0,7,0,6,21,25,10,3,1,4,11,12,8,4,-1,2,10,13,2,37,23,14,34,17,17,3,-6,-7,20,19,9,0,-3,0,9,7,10,3,-3,-7,11,12,-1,2,0,-2,20,6,7,0,-2,0,10,3,5,2,2,-2,10,3,2,79,38,41,64,40,24,15,-2,15,27,20,0,8,-8,7,16,9,4,7,6,8,11,11,-4,15,2,5,23,15,3,11,0,3,13,7,5,4,2,2,10,8,-2,31,26,5,71,39,32,-3,-7,18,-3,30,-5,0,0,13,-4,15,3,-3,-7,5,1,15,-8,6,-1,11,17,35,2,0,3,6,8,19,3,6,-4,5,9,16,-1,81,31,50,80,39,41,21,7,10,16,23,2,6,2,6,7,7,3,15,5,4,9,16,-1,15,-1,14,15,27,9,5,1,10,5,11,7,10,-2,4,10,16,2,127,67,60,139,71,68,17,-2,6,28,49,27,8,0,3,11,30,15,9,-2,3,17,19,12,13,4,11,31,46,34,5,-1,6,14,25,22,8,5,5,17,21,12,129,69,60,143,74,69,17,2,8,37,41,25,9,-4,3,19,30,14,8,6,5,18,11,11,16,9,15,32,42,28,8,5,6,12,27,15,8,4,9,20,15,13
29,29054,Fuengirola,46392,1707,931,776,1706,894,812,268,173,307,383,354,225,174,97,170,191,195,105,94,76,137,192,159,120,302,198,391,345,334,129,160,108,191,180,182,68,142,90,200,165,152,61,2386,1226,1160,2166,1150,1016,374,274,616,432,432,235,180,135,326,243,208,119,194,139,290,189,224,116,403,296,525,426,349,148,207,155,271,238,176,92,196,141,254,188,173,56,2576,1304,1272,2508,1297,1211,410,438,547,466,493,228,201,227,294,235,232,120,209,211,253,231,261,108,496,376,548,482,394,203,272,176,299,249,184,111,224,200,249,233,210,92,2888,1426,1462,2316,1174,1142,421,479,729,531,438,292,217,216,376,276,214,130,204,263,353,255,224,162,426,380,588,452,330,131,225,176,298,237,166,68,201,204,290,215,164,63,3434,1793,1641,2932,1525,1407,319,593,825,683,651,361,137,303,459,359,330,187,182,290,366,324,321,174,380,486,767,647,456,187,199,236,413,341,226,104,181,250,354,306,230,83,2759,1603,1156,2840,1548,1292,241,586,648,605,481,178,146,344,402,331,257,110,95,242,246,274,224,68,374,584,746,586,356,173,195,305,436,312,188,99,179,279,310,274,168,74,2347,1261,1086,2629,1339,1290,300,496,648,441,348,118,182,266,331,229,175,74,118,230,317,212,173,44,413,518,724,509,312,139,217,249,379,267,150,71,196,269,345,242,162,68,3268,1621,1647,3008,1473,1535,497,660,720,495,597,275,267,317,372,235,266,145,230,343,348,260,331,130,496,607,707,492,459,226,261,269,359,237,221,118,235,338,348,255,238,108,1690,872,818,1992,996,996,232,296,284,292,373,231,90,136,168,176,186,118,142,160,116,116,187,113,317,368,474,340,299,188,165,156,246,181,143,104,152,212,228,159,156,84,909,397,512,1251,577,674,114,48,97,142,330,199,71,21,15,54,131,122,43,27,82,88,199,77,163,189,269,211,282,135,86,71,130,99,120,72,77,118,139,112,162,63,847,407,440,853,426,427,118,-6,37,173,332,183,55,-26,7,122,144,103,63,20,30,51,188,80,121,117,104,89,259,148,62,45,52,52,118,92,59,72,52,37,141,56,1473,652,821,1181,568,613,187,229,231,289,352,181,69,108,94,133,183,62,118,121,137,156,169,119,183,162,183,212,273,154,89,79,69,122,142,61,94,83,114,90,131,93,1721,751,970,1346,632,714,287,177,247,387,362,255,128,88,58,177,175,123,159,89,189,210,187,132,213,161,241,252,301,166,109,69,114,105,148,84,104,92,127,147,153,82,1437,696,741,1276,661,615,195,110,247,294,348,245,85,32,115,155,175,141,110,78,132,139,173,104,176,243,181,232,279,153,87,127,97,112,143,86,89,116,84,120,136,67,1638,825,813,1339,701,638,161,242,225,309,420,284,90,132,94,156,201,151,71,110,131,153,219,133,187,176,244,230,312,183,97,93,124,122,154,105,90,83,120,108,158,78,1174,634,540,1330,682,648,81,175,151,241,328,175,84,68,81,117,166,100,-3,107,70,124,162,75,168,186,241,291,286,141,91,89,118,153,149,74,77,97,123,138,137,67,553,185,368,746,289,457,178,-75,61,115,190,69,95,-94,-9,26,104,50,83,19,70,89,86,19,169,-82,149,202,211,77,88,-114,69,80,114,39,81,32,80,122,97,38,968,403,565,1098,488,610,267,171,99,104,257,49,137,84,-5,29,136,16,130,87,104,75,121,33,261,176,157,194,219,60,134,86,40,70,104,41,127,90,117,124,115,19
29,29056,Gaucín,1688,21,11,10,37,21,16,6,2,-5,9,8,0,5,-3,3,2,3,0,1,5,-8,7,5,0,9,4,6,5,11,1,5,1,6,1,6,1,4,3,0,4,5,0,4,1,3,19,10,9,-2,-7,1,5,10,-3,-4,-1,-1,1,6,0,2,-6,2,4,4,-3,2,0,3,5,9,0,1,0,2,1,6,0,1,0,1,4,3,0,54,29,25,42,24,18,12,-16,17,17,19,6,1,-6,9,10,10,5,11,-10,8,7,9,1,7,2,12,6,11,4,3,1,7,4,6,3,4,1,5,2,5,1,44,23,21,44,22,22,5,2,14,8,12,2,1,3,6,0,11,2,4,-1,8,8,1,0,7,3,7,9,13,5,4,0,2,3,9,4,3,3,5,6,4,1,17,10,7,56,24,32,0,2,-7,4,22,-5,-2,3,3,-1,9,-2,2,-1,-10,5,13,-3,8,6,10,9,18,3,3,3,7,1,8,2,5,3,3,8,10,1,63,25,38,73,39,34,8,13,6,22,11,4,4,7,0,7,7,1,4,6,6,15,4,3,5,12,18,20,14,4,2,8,10,9,8,2,3,4,8,11,6,2,49,31,18,68,34,34,0,7,7,15,16,3,5,4,0,7,10,5,-5,3,7,8,6,-2,7,11,12,17,16,4,4,2,5,8,11,4,3,9,7,9,5,0,26,16,10,28,14,14,-14,9,-1,15,20,0,-8,1,2,10,10,2,-6,8,-3,5,10,-2,2,7,3,8,8,0,0,3,2,5,3,1,2,4,1,3,5,-1,-47,-30,-17,25,12,13,-3,0,-14,-11,-4,-13,-4,0,-7,-9,-2,-6,1,0,-7,-2,-2,-7,6,2,6,5,5,0,4,2,2,1,3,0,2,0,4,4,2,0,-80,-41,-39,-44,-24,-20,-6,-5,-25,-14,-14,-16,-8,-1,-11,-8,-4,-9,2,-4,-14,-6,-10,-7,1,-3,-10,-10,-14,-8,0,0,-6,-6,-7,-5,1,-3,-4,-4,-7,-3,-64,-42,-22,-53,-35,-18,-8,-7,4,-18,-22,-16,-5,-6,-2,-9,-11,-9,-3,-1,6,-9,-11,-7,-9,-6,-1,-9,-18,-12,-6,-3,-2,-6,-8,-10,-3,-3,1,-3,-10,-2,-37,-21,-16,-3,-5,2,-9,-2,-11,-3,4,-15,-3,2,-7,-2,-2,-9,-6,-4,-4,-1,6,-6,-2,-1,-1,-1,6,-3,0,-1,-1,-2,2,-3,-2,0,0,1,4,0,-4,3,-7,17,7,10,-6,-2,-3,2,12,-7,-2,-1,-3,1,8,0,-4,-1,0,1,4,-7,-2,0,1,7,10,1,-2,-1,0,4,5,1,0,1,1,3,5,0,25,16,9,8,10,-2,5,3,6,8,9,-4,2,2,4,3,7,0,3,1,2,5,2,-4,2,0,-1,3,3,1,2,0,-1,3,4,2,0,0,0,0,-1,-1,11,9,2,26,18,8,0,-1,-5,5,9,2,1,0,-5,7,4,2,-1,-1,0,-2,5,0,3,2,1,9,6,5,3,2,0,7,3,3,0,0,1,2,3,2,-31,-24,-7,-13,-10,-3,-6,8,-7,-7,-11,-9,-5,0,-3,-2,-7,-7,-1,8,-4,-5,-4,-2,1,0,-1,-3,-7,-3,-1,0,-1,-1,-5,-2,2,0,0,-2,-2,-1,0,6,-6,20,12,8,3,2,-3,8,0,-10,5,3,-1,2,1,-4,-2,-1,-2,6,-1,-6,2,1,1,10,4,2,2,0,0,5,3,2,0,1,1,5,1,0,-20,-9,-11,-9,-2,-7,1,0,-5,-4,-4,-8,1,0,-2,-2,-4,-2,0,0,-3,-2,0,-6,1,-2,1,0,-2,-7,2,-1,2,0,-2,-3,-1,-1,-1,0,0,-4
29,29058,Guaro,1901,10,11,-1,17,9,8,0,2,2,-1,9,-2,2,3,1,1,4,0,-2,-1,1,-2,5,-2,2,2,4,4,5,0,1,1,2,4,1,0,1,1,2,0,4,0,26,12,14,31,19,12,3,5,2,5,11,0,1,-1,2,3,6,1,2,6,0,2,5,-1,9,4,5,9,4,0,5,1,4,6,3,0,4,3,1,3,1,0,59,26,33,50,27,23,11,10,18,11,12,-2,5,4,4,5,7,1,6,6,14,6,5,-3,11,4,14,11,5,5,5,3,6,7,3,3,6,1,8,4,2,2,29,9,20,35,18,17,-7,1,2,14,13,6,-9,0,7,5,4,2,2,1,-5,9,9,4,7,2,7,10,7,1,2,1,4,7,4,0,5,1,3,3,3,1,56,35,21,58,33,25,3,17,15,15,8,-3,7,8,8,7,8,-3,-4,9,7,8,0,0,7,7,17,15,11,0,4,5,11,6,7,0,3,2,6,9,4,0,157,65,92,59,29,30,15,7,11,16,8,101,12,1,7,5,7,33,3,6,4,11,1,68,14,11,13,12,7,2,6,3,7,6,5,2,8,8,6,6,2,0,68,29,39,39,20,19,-8,12,3,-2,13,51,-9,1,5,4,9,20,1,11,-2,-6,4,31,12,5,12,7,3,0,6,1,7,6,0,0,6,4,5,1,3,0,6,-1,7,38,16,22,10,1,0,4,2,-10,7,0,-3,1,3,-6,3,1,3,3,-1,-4,9,7,10,7,3,1,4,3,5,3,1,0,5,4,5,4,2,1,64,32,32,26,11,15,5,6,10,13,-1,30,3,8,3,10,-3,11,2,-2,7,3,2,19,6,4,3,7,3,2,1,3,0,4,1,1,5,1,3,3,2,1,29,12,17,21,8,13,6,3,-10,3,16,12,4,0,-2,-7,5,12,2,3,-8,10,11,0,4,1,2,5,7,2,2,0,0,2,3,1,2,1,2,3,4,1,60,34,26,13,9,4,6,16,5,15,2,18,2,6,7,4,6,10,4,10,-2,11,-4,8,0,1,2,7,2,1,0,1,3,3,2,0,0,0,-1,4,0,1,10,5,5,16,6,10,6,4,2,-10,5,4,6,6,-1,-9,5,1,0,-2,3,-1,0,3,4,1,2,1,5,3,0,0,0,1,3,2,4,1,2,0,2,1,24,17,7,18,7,11,-3,2,-9,16,5,10,-2,0,-7,12,8,4,-1,2,-2,4,-3,6,2,1,3,5,2,3,0,0,0,3,0,2,2,1,3,2,2,1,-4,4,-8,3,1,2,-4,-4,-9,-4,1,15,0,-7,-5,2,4,9,-4,3,-4,-6,-3,6,0,0,2,0,1,0,0,0,0,0,1,0,0,0,2,0,0,0,32,22,10,18,11,7,0,-3,0,12,3,21,4,-1,0,5,1,15,-4,-2,0,7,2,6,1,2,3,6,5,1,1,1,1,3,4,1,0,1,2,3,1,0,-15,-9,-6,-12,-12,0,3,-8,-2,-17,-3,14,3,-4,-4,-10,0,7,0,-4,2,-7,-3,7,1,-1,-4,-7,-3,1,1,-1,-3,-8,-2,0,0,0,-1,1,-1,1,64,29,35,17,11,6,5,11,2,19,5,22,2,3,4,9,5,7,3,8,-2,10,0,15,1,2,2,6,5,1,0,2,1,3,3,2,1,0,1,3,2,-1,131,56,75,31,18,13,28,7,24,26,27,16,14,-4,12,12,13,8,14,11,12,14,14,8,4,2,8,8,5,4,2,-1,6,5,2,4,2,3,2,3,3,0
29,29067,Málaga,530553,-142,-18,-124,2429,1325,1104,148,-50,-94,-8,-30,-83,96,-29,-37,-9,-24,2,52,-21,-57,1,-6,-85,354,561,817,400,197,89,183,295,487,206,106,44,171,266,330,194,91,45,2661,1318,1343,3186,1723,1463,780,523,793,384,51,122,368,275,382,214,8,68,412,248,411,170,43,54,625,715,1019,541,203,65,323,413,557,297,98,26,302,302,462,244,105,39,438,242,196,4647,2474,2173,207,359,-74,364,-153,-214,84,118,89,150,-92,-81,123,241,-163,214,-61,-133,769,1038,1466,978,298,66,389,530,885,482,146,25,380,508,581,496,152,41,792,501,291,4690,2536,2154,412,296,51,277,-100,-116,213,153,134,130,-80,-35,199,143,-83,147,-20,-81,821,976,1450,927,358,124,414,516,870,490,169,60,407,460,580,437,189,64,4228,2170,2058,6589,3472,3117,785,1189,1031,1135,169,-67,443,533,687,498,38,-26,342,656,344,637,131,-41,816,1596,2160,1342,484,147,424,821,1293,641,210,58,392,775,867,701,274,89,1035,659,376,5372,3050,2322,643,308,45,488,-238,-171,366,207,104,200,-143,-60,277,101,-59,288,-95,-111,881,1228,1845,1033,297,54,473,678,1177,557,125,23,408,550,668,476,172,31,-100,-275,175,5455,2758,2697,453,620,-518,-4,-326,-299,276,238,-336,-86,-227,-119,177,382,-182,82,-99,-180,1060,1399,1632,944,294,68,556,656,916,450,124,27,504,743,716,494,170,41,2782,1141,1641,7391,3674,3717,836,1101,374,592,-63,2,431,424,120,260,-114,41,405,677,254,332,51,-39,1325,1827,2259,1348,498,93,672,845,1194,693,199,47,653,982,1065,655,299,46,1410,303,1107,5433,2667,2766,453,782,-3,265,-103,-61,289,312,-219,50,-126,-27,164,470,216,215,23,-34,918,1368,1728,921,339,89,528,645,869,429,129,37,390,723,859,492,210,52,-3490,-2487,-1003,-94,-549,455,29,-25,-1592,-1089,-568,-222,33,-191,-1127,-754,-335,-101,-4,166,-465,-335,-233,-121,470,512,-249,-545,-252,-75,264,132,-384,-414,-141,-33,206,380,135,-131,-111,-42,237,-267,504,3653,1707,1946,94,512,-243,44,-75,-65,15,108,-173,-49,-119,-26,79,404,-70,93,44,-39,454,958,1154,634,330,77,228,395,630,288,115,31,226,563,524,346,215,46,-1261,-1095,-166,329,-77,406,304,116,-1039,-459,-218,-47,143,-74,-775,-289,-146,-14,161,190,-264,-170,-72,-33,533,359,-325,-304,-18,13,292,98,-255,-232,-20,0,241,261,-70,-72,2,13,-490,-420,-70,1020,477,543,186,90,-481,-140,-151,-8,94,-1,-307,-74,-113,-28,92,91,-174,-66,-38,20,312,323,139,102,57,42,171,120,77,42,31,10,141,203,62,60,26,32,-226,-228,2,458,202,256,38,228,-298,-179,-28,-28,16,53,-179,-127,-46,28,22,175,-119,-52,18,-56,240,213,-4,-68,29,5,134,67,2,-61,27,9,106,146,-6,-7,2,-4,672,276,396,-854,-404,-450,638,424,77,-236,-125,-161,337,139,-40,-94,-9,-101,301,285,117,-142,-116,-60,342,179,-320,-612,-265,-222,201,52,-130,-336,-107,-107,141,127,-190,-276,-158,-115,1217,377,840,-134,-77,-57,-234,201,388,325,260,220,-208,16,92,98,199,159,-26,185,296,227,61,61,-394,68,-8,17,64,65,-225,-5,17,7,57,41,-169,73,-25,10,7,24,1667,682,985,2193,1081,1112,318,441,365,74,264,172,162,219,133,-85,154,86,156,222,232,159,110,86,302,512,566,385,279,100,153,275,277,169,134,41,149,237,289,216,145,59,1096,174,922,1003,305,698,295,661,363,-285,-121,127,137,284,113,-313,-147,54,158,377,250,28,26,73,274,602,400,-229,-135,11,133,302,189,-233,-121,-5,141,300,211,4,-14,16
29,29068,Manilva,5509,156,76,80,115,58,57,10,7,54,34,38,12,3,3,24,20,20,6,7,4,30,14,18,6,8,11,26,23,32,13,4,5,13,11,16,8,4,6,13,12,16,5,22,25,-3,72,37,35,2,3,-9,0,20,6,8,6,-3,2,8,4,-6,-3,-6,-2,12,2,19,4,9,14,19,6,13,3,4,4,9,4,6,1,5,10,10,2,488,257,231,335,185,150,57,42,125,114,121,24,22,27,65,64,59,16,35,15,60,50,62,8,35,22,71,70,108,28,17,14,44,38,55,16,18,8,27,32,53,12,798,424,374,451,236,215,129,102,199,178,145,44,61,64,104,85,86,25,68,38,95,93,59,19,70,43,87,104,108,36,28,27,46,53,59,22,42,16,41,51,49,14,1152,705,447,903,552,351,109,198,388,257,136,47,58,114,264,166,75,22,51,84,124,91,61,25,92,142,267,209,145,40,44,91,185,126,83,22,48,51,82,83,62,18,1471,856,615,940,533,407,223,298,496,264,142,32,108,159,293,188,82,17,115,139,203,76,60,15,154,196,269,175,110,30,82,103,157,111,61,15,72,93,112,64,49,15,1208,585,623,837,407,430,239,199,315,212,169,57,126,103,150,91,75,27,113,96,165,121,94,30,171,157,186,127,144,44,94,84,77,59,63,25,77,73,109,68,81,19,851,436,415,580,259,321,157,169,238,121,140,15,110,62,117,53,76,11,47,107,121,68,64,4,114,124,128,90,105,13,57,49,52,35,56,6,57,75,76,55,49,7,450,218,232,329,154,175,117,55,119,31,104,10,66,8,65,8,57,7,51,47,54,23,47,3,83,50,66,23,74,20,46,12,33,9,35,12,37,38,33,14,39,8,283,73,210,248,84,164,39,42,4,87,70,37,-3,7,-13,32,28,19,42,35,17,55,42,18,64,21,23,55,57,22,29,-2,4,15,24,11,35,23,19,40,33,11,-427,-233,-194,-562,-297,-265,-123,7,21,-111,-79,-151,-70,-9,17,-57,-33,-86,-53,16,4,-54,-46,-65,-137,-11,-40,-114,-113,-157,-73,-12,-21,-62,-49,-86,-64,1,-19,-52,-64,-71,565,279,286,436,224,212,91,63,137,123,106,30,42,36,48,76,52,17,49,27,89,47,54,13,73,54,105,86,81,24,33,28,46,54,42,14,40,26,59,32,39,10,411,242,169,279,145,134,51,49,133,107,54,-1,27,22,81,51,38,12,24,27,52,56,16,-13,39,30,80,62,54,3,21,6,53,25,24,8,18,24,27,37,30,-5,104,43,61,-18,-15,-3,21,22,60,-13,44,-48,-2,2,29,5,20,-20,23,20,31,-18,24,-28,37,16,42,-48,-11,-65,14,4,11,-19,-3,-27,23,12,31,-29,-8,-38,572,305,267,442,233,209,67,64,85,118,138,87,46,33,37,47,78,55,21,31,48,71,60,32,65,39,55,103,90,81,38,17,18,52,51,53,27,22,37,51,39,28,585,253,332,320,141,179,151,49,159,98,73,39,70,26,59,59,16,10,81,23,100,39,57,29,62,31,84,35,58,35,33,14,39,13,17,16,29,17,45,22,41,19,-11,10,-21,-230,-128,-102,-56,4,-13,3,55,-22,-30,-1,-1,20,19,-4,-26,5,-12,-17,36,-18,-76,-33,-28,-75,5,-32,-42,-22,-4,-43,-10,-11,-34,-11,-24,-32,15,-21,737,368,369,525,252,273,77,84,189,140,144,87,26,57,104,48,83,46,51,27,85,92,61,41,77,56,90,113,103,76,38,32,48,37,52,41,39,24,42,76,51,35
29,29069,Marbella,101144,4485,2247,2238,2619,1303,1316,743,802,1403,836,449,197,359,391,733,422,213,97,384,411,670,414,236,100,419,435,788,545,306,104,217,196,403,266,157,52,202,239,385,279,149,52,3962,1962,2000,2926,1473,1453,678,682,1276,759,395,143,352,325,596,384,214,75,326,357,680,375,181,68,554,491,858,618,291,89,287,229,414,316,164,52,267,262,444,302,127,37,5876,2961,2915,3899,1937,1962,1060,1034,1939,1043,468,248,540,487,965,579,227,115,520,547,974,464,241,133,804,614,1142,781,380,135,417,275,558,405,189,64,387,339,584,376,191,71,4974,2497,2477,3830,1917,1913,864,807,1576,1039,446,185,437,376,816,519,227,89,427,431,760,520,219,96,677,670,1132,808,360,140,372,305,583,383,176,75,305,365,549,425,184,65,4983,2426,2557,4211,2059,2152,581,902,1540,1260,451,210,313,430,748,603,212,95,268,472,792,657,239,115,579,741,1286,1062,410,103,294,355,646,498,196,53,285,386,640,564,214,50,3611,1774,1837,4114,2073,2041,451,596,1241,739,407,157,258,286,641,337,169,74,193,310,600,402,238,83,567,774,1327,893,421,116,311,381,694,413,202,62,256,393,633,480,219,54,3198,1395,1803,3827,1830,1997,503,513,977,676,376,156,223,188,426,301,198,63,280,325,551,375,178,93,615,752,1150,769,388,133,300,320,564,373,199,67,315,432,586,396,189,66,-2028,-1257,-771,-876,-535,-341,-154,67,-803,-708,-304,-100,-54,-18,-525,-431,-173,-52,-100,85,-278,-277,-131,-48,21,275,-365,-546,-169,-104,64,99,-245,-322,-103,-33,-43,176,-120,-224,-66,-71,3141,1414,1727,4176,1976,2200,472,574,973,551,325,235,223,218,473,246,146,104,249,356,500,305,179,131,656,756,1322,822,406,181,345,314,643,378,190,91,311,442,679,444,216,90,1235,405,830,1403,571,832,378,138,293,129,130,152,139,15,86,46,59,60,239,123,207,83,71,92,305,236,341,185,159,135,132,75,120,81,71,72,173,161,221,104,88,63,2397,1132,1265,2569,1219,1350,399,283,599,505,340,246,209,101,298,253,159,108,190,182,301,252,181,138,448,383,615,528,349,213,243,131,271,280,177,103,205,252,344,248,172,110,2752,1306,1446,2282,1090,1192,387,356,735,586,395,286,182,180,327,300,186,128,205,176,408,286,209,158,323,355,527,514,355,188,178,138,244,248,176,98,145,217,283,266,179,90,2580,1227,1353,2101,1042,1059,424,301,710,481,389,280,229,134,313,215,195,139,195,167,397,266,194,141,325,324,502,365,348,216,187,145,229,161,177,128,138,179,273,204,171,88,1857,789,1068,1554,728,826,331,311,424,372,244,129,169,138,106,187,115,59,162,173,318,185,129,70,312,241,353,291,232,97,166,107,128,151,121,43,146,134,225,140,111,54,3058,1430,1628,2468,1140,1328,606,410,726,625,383,295,306,171,303,297,176,169,300,239,423,328,207,126,440,331,512,505,369,282,211,144,198,233,181,156,229,187,314,272,188,126,-408,-231,-177,-576,-308,-268,149,29,137,-219,-239,-285,81,2,64,-145,-118,-135,68,27,73,-74,-121,-150,56,60,16,-308,-203,-230,15,14,16,-165,-98,-107,41,46,0,-143,-105,-123,2347,1082,1265,2747,1272,1475,382,316,688,524,259,180,172,128,274,337,91,81,210,188,414,187,168,99,500,381,675,569,360,232,260,157,285,283,155,117,240,224,390,286,205,115,2799,1261,1538,3673,1771,1902,556,287,712,679,388,141,295,95,318,309,161,66,261,192,394,370,227,75,636,421,944,826,534,266,332,179,431,399,265,140,304,242,513,427,269,126
29,29070,Mijas,39302,2579,1349,1230,1524,794,730,470,335,668,470,471,149,266,142,335,264,246,86,204,193,333,206,225,63,249,129,306,304,383,145,141,51,145,168,198,86,108,78,161,136,185,59,2194,1097,1097,1492,753,739,430,293,604,416,323,115,226,138,287,205,163,73,204,155,317,211,160,42,303,135,317,304,313,110,162,55,147,151,161,71,141,80,170,153,152,39,2829,1423,1406,1804,892,912,532,315,769,511,474,197,283,121,394,261,234,111,249,194,375,250,240,86,340,158,315,333,456,184,163,69,148,168,236,98,177,89,167,165,220,86,3259,1654,1605,1867,937,930,751,457,961,639,308,99,393,232,463,324,168,56,358,225,498,315,140,43,445,184,403,398,323,99,228,90,185,199,169,62,217,94,218,199,154,37,3699,1920,1779,2098,1084,1014,665,414,1236,747,456,140,358,187,663,404,215,83,307,227,573,343,241,57,384,219,468,456,411,147,207,105,244,223,202,97,177,114,224,233,209,50,3592,1796,1796,1942,989,953,577,473,1252,623,458,177,279,202,632,350,245,72,298,271,620,273,213,105,339,213,440,385,401,154,174,101,222,211,203,75,165,112,218,174,198,79,4577,2287,2290,2499,1231,1268,811,600,1511,789,581,235,402,255,790,416,256,148,409,345,721,373,325,87,505,275,548,472,486,204,269,128,262,229,218,122,236,147,286,243,268,82,4445,2257,2188,2433,1237,1196,738,621,1499,835,516,202,389,237,785,467,262,108,349,384,714,368,254,94,436,365,542,484,435,159,241,152,286,247,219,86,195,213,256,237,216,73,2960,1461,1499,1467,753,714,475,499,1002,555,283,107,288,207,485,270,140,58,187,292,517,285,143,49,277,204,372,294,223,81,158,86,196,144,114,46,119,118,176,150,109,35,2398,1217,1181,1257,614,643,327,353,732,460,344,149,174,178,387,230,166,61,153,175,345,230,178,88,238,167,281,212,223,123,119,75,152,95,106,62,119,92,129,117,117,61,2594,1360,1234,1726,865,861,373,357,778,457,422,175,218,153,428,236,221,91,155,204,350,221,201,84,266,220,379,323,370,149,147,83,179,169,194,86,119,137,200,154,176,63,1335,648,687,435,162,273,116,101,274,185,422,187,39,30,98,131,212,113,77,71,176,54,210,74,27,17,-70,-13,289,167,-16,-17,-77,8,150,106,43,34,7,-21,139,61,3128,1533,1595,1973,959,1014,330,269,526,519,829,605,164,112,238,258,408,328,166,157,288,261,421,277,125,144,156,301,703,528,46,54,56,155,343,297,79,90,100,146,360,231,-7523,-3711,-3812,-8120,-4004,-4116,-463,-666,-543,-1350,-1216,-3304,-255,-331,-272,-642,-586,-1641,-208,-335,-271,-708,-630,-1663,-578,-752,-672,-1472,-1325,-3332,-286,-384,-331,-685,-657,-1668,-292,-368,-341,-787,-668,-1664,2062,987,1075,1383,700,683,325,180,438,384,484,213,178,67,192,152,254,118,147,113,246,232,230,95,160,118,224,242,405,216,92,45,95,116,221,123,68,73,129,126,184,93,1730,775,955,1157,585,572,185,141,419,266,501,219,66,57,173,112,248,126,119,84,246,154,253,93,132,84,180,178,376,192,53,30,90,84,201,120,79,54,90,94,175,72,2275,1122,1153,1447,719,728,365,133,532,515,499,195,168,58,269,219,280,111,197,75,263,296,219,84,251,85,296,278,368,149,131,32,131,115,205,97,120,53,165,163,163,52,-4214,-2188,-2026,-5097,-2564,-2533,-261,-282,-23,-793,-888,-2023,-166,-129,-9,-371,-485,-1057,-95,-153,-14,-422,-403,-966,-405,-319,-369,-1035,-963,-2039,-218,-144,-162,-500,-493,-1064,-187,-175,-207,-535,-470,-975
29,29072,Mollina,3345,33,18,15,17,10,7,2,-5,9,-1,13,11,-1,0,4,-2,10,4,3,-5,5,1,3,7,1,1,1,2,10,2,1,1,0,1,6,1,0,0,1,1,4,1,57,28,29,49,24,25,2,3,3,7,37,4,0,4,0,2,16,6,2,-1,3,5,21,-2,3,1,7,4,29,5,2,1,1,1,15,4,1,0,6,3,14,1,149,85,64,111,59,52,13,11,3,21,79,20,6,5,4,11,43,16,7,6,-1,10,36,4,5,3,2,15,70,16,2,1,1,8,35,12,3,2,1,7,35,4,200,105,95,195,101,94,15,0,9,22,125,28,4,1,3,10,67,19,11,-1,6,12,58,9,4,1,8,19,127,35,1,1,3,8,65,22,3,0,5,11,62,13,256,127,129,192,100,92,35,6,21,71,102,21,12,3,8,34,59,12,23,3,13,37,43,9,15,7,12,44,94,20,8,5,5,20,51,11,7,2,7,24,43,9,208,107,101,143,70,73,24,15,28,31,88,16,16,4,19,17,39,8,8,11,9,14,49,8,9,6,9,15,90,14,2,3,7,7,43,8,7,3,2,8,47,6,285,155,130,182,89,93,23,28,76,35,101,18,14,13,44,20,47,17,9,15,32,15,54,1,14,5,13,31,95,22,7,1,3,16,45,17,7,4,10,15,50,5,320,183,137,202,113,89,47,48,69,77,71,4,24,30,39,45,35,5,23,18,30,32,36,-1,19,25,21,43,76,18,8,16,11,27,40,11,11,9,10,16,36,7,128,78,50,96,54,42,11,20,25,22,41,7,8,8,15,16,24,5,3,12,10,6,17,2,10,13,9,13,38,12,4,7,7,8,20,7,6,6,2,5,18,5,113,69,44,78,46,32,17,4,18,13,39,18,11,6,7,8,17,17,6,-2,11,5,22,1,2,9,9,9,37,11,2,7,5,6,17,9,0,2,4,3,20,2,-35,-20,-15,-15,-8,-7,-9,-3,-23,-13,34,-24,-3,-3,-13,-7,21,-15,-6,0,-10,-6,13,-9,-1,-7,-12,-12,26,-9,0,-5,-7,-10,18,-4,-1,-2,-5,-2,8,-5,-25,-9,-16,-4,3,-7,-7,8,-7,-9,3,-17,0,4,-7,-5,9,-11,-7,4,0,-4,-6,-6,-6,3,-8,-4,16,-5,0,2,-7,-1,12,-3,-6,1,-1,-3,4,-2,-76,-35,-41,-26,-7,-19,-11,-14,-22,-16,-8,-5,-10,-3,-10,-8,-6,2,-1,-11,-12,-8,-2,-7,0,-7,-8,-7,-1,-3,0,-2,-5,-3,0,3,0,-5,-3,-4,-1,-6,-26,-12,-14,-22,-12,-10,5,4,-7,-8,5,-30,2,2,-6,-5,10,-17,3,2,-1,-3,-5,-13,1,5,-9,-5,7,-24,0,2,-6,-2,7,-14,1,3,-3,-3,0,-10,-40,-22,-18,17,8,9,-13,-15,-14,1,22,-20,-9,-9,-5,0,12,-9,-4,-6,-9,1,10,-11,0,1,-2,4,22,-9,0,0,-2,3,10,-4,0,1,0,1,12,-5,76,29,47,84,41,43,5,10,5,-1,46,12,-2,4,1,-5,24,6,7,6,4,4,22,6,-4,5,3,4,59,17,-4,4,0,0,31,10,0,1,3,4,28,7,10,13,-3,16,13,3,-4,-8,-7,20,67,-62,-2,-3,-1,13,35,-29,-2,-5,-6,7,32,-33,1,-1,-2,5,72,-60,1,0,-1,3,35,-25,0,-1,-1,2,37,-35,32,29,3,56,30,26,12,-11,-9,-3,51,-9,8,-7,2,0,27,-2,4,-4,-11,-3,24,-7,5,0,-2,-6,59,-1,5,0,-3,-3,30,0,0,0,1,-3,29,-1
29,29075,Nerja,15725,420,227,193,285,155,130,70,42,124,88,72,21,49,31,58,47,35,7,21,11,66,41,37,14,47,33,72,51,62,19,30,22,33,22,34,13,17,11,39,29,28,6,513,269,244,561,275,286,39,32,71,72,183,116,19,14,42,31,87,75,20,18,29,41,96,41,56,39,77,79,194,114,26,17,38,32,90,71,30,22,39,47,104,43,753,368,385,600,306,294,114,113,211,117,123,70,53,49,123,53,56,32,61,64,88,64,67,38,77,99,127,105,126,57,35,45,77,57,59,30,42,54,50,48,67,27,690,366,324,763,395,368,79,74,115,143,172,103,52,36,64,70,84,56,27,38,51,73,88,47,100,86,121,152,195,103,59,44,62,73,97,56,41,42,59,79,98,47,835,435,400,934,464,470,98,97,110,127,258,145,52,47,87,51,118,78,46,50,23,76,140,67,122,101,153,151,260,140,61,53,79,71,120,77,61,48,74,80,140,63,804,361,443,864,428,436,87,90,179,152,203,91,30,21,101,65,88,55,57,69,78,87,115,36,118,91,167,175,211,100,60,36,84,90,97,60,58,55,83,85,114,40,689,361,328,783,397,386,90,60,90,138,196,110,46,21,68,72,89,61,44,39,22,66,107,49,104,86,116,138,212,118,55,31,63,77,100,66,49,55,53,61,112,52,708,352,356,618,300,318,133,103,150,111,147,64,67,41,66,68,76,34,66,62,84,43,71,30,96,92,117,80,158,73,46,45,48,38,75,47,50,47,69,42,83,26,214,94,120,330,163,167,-13,25,14,42,102,47,-5,19,4,10,44,26,-8,6,10,32,58,21,25,50,48,66,99,42,15,29,21,24,43,31,10,21,27,42,56,11,144,45,99,232,96,136,32,23,-28,-6,102,25,17,11,-15,-33,56,13,15,12,-13,27,46,12,31,28,20,20,92,37,22,7,5,-5,51,16,9,21,15,25,41,21,201,159,42,177,91,86,-15,-27,7,70,101,65,8,0,31,49,41,31,-23,-27,-24,21,60,34,-18,5,13,22,98,56,-6,2,8,8,50,29,-12,3,5,14,48,27,341,195,146,374,184,190,15,10,54,24,152,82,4,8,37,7,81,56,11,2,17,17,71,26,13,23,20,48,166,101,1,9,2,25,85,61,12,14,18,23,81,40,302,182,120,303,153,150,38,20,2,74,109,62,17,9,10,42,64,41,21,11,-8,32,45,21,29,15,40,57,104,58,12,8,20,24,53,36,17,7,20,33,51,22,-48,-20,-28,-98,-62,-36,68,0,-84,-21,24,-34,51,1,-54,-21,19,-17,17,-1,-30,0,5,-17,19,-15,-45,-34,2,-26,8,-10,-26,-32,10,-13,11,-5,-19,-2,-8,-13,352,188,164,277,151,126,13,-1,14,54,160,111,-2,3,7,40,75,65,15,-4,7,14,85,46,17,2,3,17,133,104,12,-3,-3,12,66,66,5,5,6,5,67,38,-1211,-540,-671,-1163,-541,-622,4,-99,-122,-203,-143,-651,14,-45,-46,-87,-62,-315,-10,-54,-76,-116,-81,-336,6,-88,-99,-200,-118,-667,8,-43,-43,-87,-54,-325,-2,-45,-56,-113,-64,-342,-419,-204,-215,-340,-162,-178,-20,3,-86,-104,10,-219,-13,-5,-34,-56,-8,-85,-7,8,-52,-48,18,-134,-1,0,-45,-106,18,-206,4,0,-17,-65,-5,-79,-5,0,-28,-41,23,-127,210,96,114,320,140,180,-14,-16,27,43,97,69,-5,-2,7,6,51,36,-9,-14,20,37,46,33,-17,11,48,58,142,74,-4,5,19,15,66,38,-13,6,29,43,76,36
29,29076,Ojén,1994,63,38,25,30,18,12,6,7,23,16,7,3,3,-1,19,10,5,2,3,8,4,6,2,1,4,1,11,8,6,0,2,0,8,4,4,0,2,1,3,4,2,0,18,7,11,25,15,10,2,9,7,4,-4,0,3,5,-1,3,-3,0,-1,4,8,1,-1,0,8,3,8,6,0,0,7,0,4,4,0,0,1,3,4,2,0,0,158,70,88,127,64,63,43,21,45,30,15,6,22,9,21,10,6,3,21,12,24,20,9,3,26,26,37,22,11,3,13,13,20,10,4,3,13,13,17,12,7,0,113,57,56,61,28,33,18,10,34,40,5,6,12,6,9,23,4,3,6,4,25,17,1,3,9,9,21,15,4,3,4,3,11,6,3,1,5,6,10,9,1,2,139,59,80,90,40,50,33,20,47,30,8,-2,9,12,32,5,2,-2,24,8,15,25,6,0,18,14,20,27,10,1,7,8,11,10,4,0,11,6,9,17,6,1,140,82,58,94,48,46,10,28,37,38,19,1,9,14,17,26,11,2,1,14,20,12,8,-1,12,22,24,20,11,2,8,12,9,10,6,1,4,10,15,10,5,1,82,43,39,77,38,39,14,19,30,11,7,4,7,8,18,5,4,2,7,11,12,6,3,2,23,10,18,19,7,0,12,3,8,11,4,0,11,7,10,8,3,0,154,86,68,103,48,55,17,25,49,41,20,4,9,11,29,22,8,8,8,14,20,19,12,-4,27,7,27,23,16,3,11,5,11,11,7,3,16,2,16,12,9,0,90,65,25,88,48,40,2,21,13,24,32,1,9,10,16,11,15,2,-7,11,-3,13,17,-1,12,15,21,17,19,3,7,5,18,7,8,3,5,10,3,10,11,0,118,63,55,96,46,50,2,5,41,25,35,5,-1,6,29,9,14,3,3,-1,12,16,21,2,10,6,12,26,36,7,5,2,6,12,18,4,5,4,6,14,18,3,55,31,24,27,14,13,3,21,32,0,-9,2,-3,9,17,5,-3,0,6,12,15,-5,-6,2,2,11,3,8,-2,3,0,4,1,5,1,1,2,7,2,3,-3,2,159,82,77,66,30,36,28,14,24,31,48,8,17,1,13,15,26,6,11,13,11,16,22,2,9,5,5,7,33,6,7,-2,2,3,16,4,2,7,3,4,17,2,-111,-53,-58,-147,-70,-77,-9,-11,-4,-37,-41,-10,-2,-2,-6,-21,-21,-1,-7,-9,2,-16,-20,-9,-16,-16,-25,-41,-41,-9,-9,-5,-12,-20,-22,-3,-7,-11,-13,-21,-19,-6,26,17,9,-16,-9,-7,-4,10,18,20,-16,-5,0,0,16,12,-9,-2,-4,10,2,8,-7,-3,-5,0,-6,6,-11,0,-4,-3,-2,7,-8,1,-1,3,-4,-1,-3,-1,47,23,24,-14,-7,-7,3,9,30,9,-6,-3,-4,6,12,2,0,3,7,3,18,7,-6,-6,-1,0,1,0,-10,-6,-3,1,2,-4,-4,-1,2,-1,-1,4,-6,-5,27,2,25,-10,-5,-5,2,12,18,-11,5,-1,1,2,10,-11,7,-6,1,10,8,0,-2,5,6,0,-1,-11,-4,1,3,-1,-2,-4,1,-1,3,1,1,-7,-5,2,129,66,63,53,30,23,29,9,31,29,26,-1,10,8,11,9,23,0,19,1,20,20,3,-1,19,6,7,11,14,-5,15,5,0,0,13,-3,4,1,7,11,1,-2,48,22,26,46,21,25,5,12,1,24,4,-3,7,0,-7,15,5,-1,-2,12,8,9,-1,-2,12,9,6,14,4,0,6,2,4,5,3,0,6,7,2,9,1,0
29,29080,Pizarra,6586,1,1,0,9,3,6,-6,1,3,5,8,-9,-3,1,5,-4,7,-5,-3,0,-2,9,1,-4,0,0,0,4,5,0,0,0,0,1,2,0,0,0,0,3,3,0,10,16,-6,22,13,9,6,-17,15,1,4,0,3,-1,10,2,3,-1,3,-16,5,-1,1,1,5,2,6,6,3,0,3,1,4,2,3,0,2,1,2,4,0,0,184,98,86,72,37,35,47,13,38,48,28,10,22,3,25,28,16,6,25,10,13,20,12,4,14,9,6,19,20,4,8,4,5,7,10,3,6,5,1,12,10,1,156,68,88,76,37,39,11,23,41,35,38,10,7,9,16,14,19,6,4,14,25,21,19,4,9,6,12,15,27,6,3,5,4,5,15,4,6,1,8,10,12,2,276,152,124,123,77,46,46,47,87,49,33,11,25,25,49,27,18,5,21,22,38,22,15,6,21,20,41,25,11,5,13,15,23,18,5,3,8,5,18,7,6,2,237,142,95,165,98,67,34,58,62,57,24,0,21,36,35,37,12,0,13,22,27,20,12,0,14,35,46,47,17,4,8,23,31,25,9,2,6,12,15,22,8,2,331,174,157,83,50,33,73,36,103,69,39,6,38,18,54,40,21,2,35,18,49,29,18,4,12,14,20,15,20,2,8,9,13,9,9,2,4,5,7,6,11,0,487,263,224,159,99,60,93,75,153,115,33,8,45,28,90,67,22,6,48,47,63,48,11,2,30,38,38,42,8,2,13,24,24,30,5,2,17,14,14,12,3,0,127,57,70,46,25,21,28,25,37,32,8,-7,8,13,22,13,4,-4,20,12,15,19,4,-3,10,13,10,12,0,0,5,9,4,7,0,0,5,4,6,5,0,0,181,110,71,78,41,37,27,15,64,30,29,14,22,12,36,19,18,1,5,3,28,11,11,13,12,17,15,14,10,9,6,9,8,10,6,2,6,8,7,4,4,7,102,50,52,67,43,24,3,37,27,20,22,-7,2,20,14,8,9,-3,1,17,13,12,13,-4,2,23,19,16,6,1,2,16,14,8,3,0,0,7,5,8,3,1,97,49,48,34,19,15,10,34,32,22,4,-2,1,18,16,14,7,-4,9,16,16,8,-3,2,1,12,6,12,0,4,0,8,4,7,0,1,1,4,2,5,0,3,50,23,27,8,2,6,17,1,8,11,9,3,14,4,-5,5,2,3,3,-3,13,6,7,0,7,1,-2,-5,6,1,5,2,-2,-7,3,1,2,-1,0,2,3,0,-60,-56,-4,-29,-16,-13,6,-14,-27,-6,-18,-3,0,-10,-27,-10,-8,-1,6,-4,0,4,-10,-2,-2,1,-9,-12,-2,-5,0,4,-9,-8,-2,-1,-2,-3,0,-4,0,-4,-13,-3,-10,0,-3,3,-14,-14,1,-10,18,5,-11,-7,6,-5,12,3,-3,-7,-5,-5,6,2,0,0,-1,-4,3,2,-1,0,2,-7,2,1,1,0,-3,3,1,1,-1,8,-9,7,7,0,9,2,-11,-1,-2,1,-2,0,-5,11,-1,2,11,2,-6,-12,-1,-1,0,3,0,2,1,-1,-1,3,-3,5,1,0,1,0,3,-3,0,-1,6,4,2,-23,-12,-11,14,-21,11,6,-10,6,11,-11,1,5,-7,5,3,-10,10,1,-3,1,3,-6,4,-9,-14,-3,3,-7,3,-4,-6,-2,0,1,1,-5,-8,-1,98,50,48,20,9,11,16,17,24,8,20,9,14,10,8,1,11,6,2,7,16,7,9,3,1,3,6,-4,10,3,-1,3,3,-3,4,2,2,0,3,-1,6,1
29,29082,Rincón de la Victoria,21721,1083,526,557,251,112,139,147,170,360,184,141,57,71,72,184,90,71,24,76,98,176,94,70,33,53,33,72,46,29,14,22,14,34,19,14,7,31,19,38,27,15,7,-73,-26,-47,100,48,52,-35,-4,-13,-14,-3,-2,-21,-1,0,-2,3,-7,-14,-3,-13,-12,-6,5,31,10,28,12,15,3,13,2,19,6,7,1,18,8,9,6,8,2,1675,860,815,485,279,206,322,203,550,286,229,69,164,113,288,135,119,32,158,90,262,151,110,37,116,73,121,85,70,13,73,44,70,46,34,6,43,29,51,39,36,7,1831,907,924,450,231,219,300,247,676,352,168,58,161,105,349,175,90,15,139,142,327,177,78,43,119,71,104,93,52,8,64,34,56,43,30,1,55,37,48,50,22,7,1393,638,755,496,221,275,166,174,523,235,170,106,84,63,235,119,85,43,82,111,288,116,85,63,96,80,136,104,58,16,52,30,52,44,28,12,44,50,84,60,30,4,1655,790,865,517,233,284,199,177,613,325,227,90,83,77,290,173,109,43,116,100,323,152,118,47,95,76,131,105,77,31,38,36,59,45,38,17,57,40,72,60,39,14,1623,836,787,398,192,206,182,236,644,226,176,131,84,119,333,127,100,60,98,117,311,99,76,71,87,98,92,58,33,19,39,44,44,31,19,12,48,54,48,27,14,7,1069,485,584,285,129,156,132,155,383,187,137,49,40,61,213,87,56,16,92,94,170,100,81,33,41,74,90,49,31,-5,23,32,44,19,11,-3,18,42,46,30,20,-2,1183,547,636,120,45,75,200,94,429,211,121,90,109,23,205,91,57,42,91,71,224,120,64,48,28,26,32,10,16,3,24,4,17,-4,4,-3,4,22,15,14,12,6,961,462,499,106,45,61,159,75,371,223,70,31,80,23,191,102,34,19,79,52,180,121,36,12,29,13,12,28,13,7,12,1,1,16,5,8,17,12,11,12,8,-1,269,137,132,-404,-198,-206,71,-8,157,8,5,-14,42,-11,80,-1,9,-14,29,3,77,9,-4,0,-55,-37,-102,-109,-65,-43,-20,-26,-49,-55,-31,-21,-35,-11,-53,-54,-34,-22,695,318,377,-27,-30,3,143,71,273,118,54,15,80,33,141,31,23,-1,63,38,132,87,31,16,-7,10,-19,-17,0,4,-8,7,-7,-16,-7,1,1,3,-12,-1,7,3,723,329,394,-81,-40,-41,140,38,283,146,57,8,70,10,120,67,23,8,70,28,163,79,34,0,-11,1,-29,-38,9,-15,-12,1,-15,-19,9,-6,1,0,-14,-19,0,-9,707,336,371,-89,-51,-38,202,27,153,196,52,46,97,12,77,97,27,10,105,15,76,99,25,36,-13,8,-33,-45,-7,-3,-6,9,-21,-22,-9,-6,-7,-1,-12,-23,2,3,308,103,205,21,0,21,79,-5,90,58,29,33,38,11,18,18,-10,22,41,-16,72,40,39,11,11,1,31,-20,1,-5,1,5,9,-12,-4,0,10,-4,22,-8,5,-5,646,319,327,125,55,70,167,23,178,151,78,17,115,4,73,71,32,9,52,19,105,80,46,8,76,6,16,16,5,1,44,-6,-1,10,4,2,32,12,17,6,1,-1,883,372,511,92,40,52,251,5,199,251,80,70,127,-13,71,116,37,17,124,18,128,135,43,53,46,10,31,3,6,-8,32,0,10,-5,6,-6,14,10,21,8,0,-2,803,434,369,207,96,111,169,37,175,256,60,51,108,25,90,150,21,22,61,12,85,106,39,29,48,33,62,48,11,1,27,9,25,27,6,0,21,24,37,21,5,1
29,29083,Riogordo,2692,-18,-2,-16,13,8,5,-1,-11,-3,-2,3,-3,1,-6,2,-1,4,-1,-2,-5,-5,-1,-1,-2,4,0,5,0,4,0,2,0,3,0,3,0,2,0,2,0,1,0,-5,-1,-4,6,3,3,-3,1,-5,-3,3,2,-2,4,-1,-6,2,2,-1,-3,-4,3,1,0,0,1,0,3,2,0,0,0,0,2,1,0,0,1,0,1,1,0,84,45,39,26,16,10,12,15,9,24,13,13,6,8,7,10,6,8,6,7,2,14,7,5,2,4,8,9,3,0,1,3,7,4,1,0,1,1,1,5,2,0,80,35,45,72,33,39,27,6,14,19,23,-9,11,0,5,12,13,-5,16,6,9,7,10,-4,27,8,9,14,13,1,13,4,2,8,6,0,14,4,7,6,7,1,72,38,34,81,47,34,15,3,27,19,14,-5,8,4,16,4,10,-3,7,-1,11,15,4,-2,18,8,19,18,18,0,10,6,13,7,11,0,8,2,6,11,7,0,93,63,30,63,41,22,14,14,20,24,15,5,12,6,16,18,9,3,2,8,4,6,6,2,8,8,15,13,17,2,5,7,10,9,9,1,3,1,5,4,8,1,32,21,11,54,30,24,7,2,-18,18,17,5,2,3,-7,7,10,5,5,-1,-11,11,7,0,13,7,9,13,10,2,6,4,5,8,6,1,7,3,4,5,4,1,63,31,32,65,32,33,4,6,3,17,35,-7,-2,1,-2,11,23,-3,6,5,5,6,12,-4,5,3,10,18,24,5,0,-1,5,10,15,3,5,4,5,8,9,2,29,8,21,49,16,33,11,-2,-9,9,13,7,3,1,-4,-1,5,4,8,-3,-5,10,8,3,12,2,6,8,19,2,3,1,2,0,9,1,9,1,4,8,10,1,-15,-10,-5,18,10,8,-9,5,2,-9,-5,-1,-1,2,-4,-4,-2,-1,-8,3,6,-5,-3,0,-1,5,6,-1,5,4,-1,3,3,-1,3,3,0,2,3,0,2,1,97,54,43,11,5,6,9,21,14,22,11,18,9,11,5,14,5,9,0,10,9,8,6,9,1,2,2,2,2,2,1,1,0,2,1,0,0,1,2,0,1,2,-10,8,-18,20,10,10,-4,-5,-1,11,-3,-8,-2,-2,5,10,0,-2,-2,-3,-6,1,-3,-6,1,1,9,7,1,0,1,0,5,4,0,0,0,1,4,3,1,0,-20,-24,4,-11,-15,4,-1,-5,-15,0,3,-2,-4,-5,-12,-3,2,-2,3,0,-3,3,1,0,-2,-1,-12,-4,5,2,-1,-1,-10,-4,0,1,-1,0,-2,0,5,1,-111,-45,-66,-68,-36,-32,-18,-17,-22,-37,-7,-10,-11,-7,-10,-10,0,-6,-7,-10,-12,-27,-7,-4,-12,-13,-19,-21,-1,-2,-5,-8,-13,-9,0,-1,-7,-5,-6,-12,-1,-1,49,26,23,10,7,3,10,-11,-1,22,13,17,6,-6,-2,10,6,12,4,-5,1,12,7,5,1,-1,5,1,2,2,1,-1,2,2,1,2,0,0,3,-1,1,0,-59,-28,-31,9,3,6,-2,-5,-10,-22,-4,-15,-3,-5,0,-16,-1,-3,1,0,-10,-6,-3,-12,1,1,3,0,3,1,0,1,2,-2,1,1,1,0,1,2,2,0,-62,-23,-39,14,8,6,-28,0,-7,-16,2,-13,-16,-3,4,-5,1,-4,-12,3,-11,-11,1,-9,1,-4,1,1,14,1,1,-3,1,2,6,1,0,-1,0,-1,8,0,7,14,-7,16,9,7,8,2,9,-5,-1,-7,4,2,8,0,3,-3,4,0,1,-5,-4,-4,4,3,3,2,4,0,1,1,3,0,4,0,3,2,0,2,0,0
29,29084,Ronda,33806,133,44,89,77,35,42,41,-23,48,27,13,21,12,-17,19,15,5,8,29,-6,29,12,8,13,10,12,24,17,10,4,7,2,10,9,6,1,3,10,14,8,4,3,-4,-1,-3,101,44,57,1,-32,-4,21,13,-5,-5,-23,1,17,10,-1,6,-9,-5,4,3,-4,25,14,22,22,11,4,10,4,11,9,6,3,15,10,11,13,5,1,81,87,-6,120,72,48,32,4,16,5,24,-10,23,15,22,2,18,-2,9,-11,-6,3,6,-8,17,17,45,14,24,1,8,12,27,8,15,1,9,5,18,6,9,0,-85,-34,-51,154,91,63,-8,-25,-48,0,14,-18,2,-7,-32,-4,12,-5,-10,-18,-16,4,2,-13,33,26,44,23,22,4,24,15,22,14,12,2,9,11,22,9,10,2,310,199,111,241,125,116,44,55,77,66,55,13,33,37,46,42,32,11,11,18,31,24,23,2,37,40,71,48,31,13,17,22,42,25,15,4,20,18,29,23,16,9,281,148,133,222,108,114,23,108,34,59,38,10,20,51,45,9,11,10,3,57,-11,50,27,0,37,49,51,47,23,11,18,23,26,22,12,5,19,26,25,25,11,6,339,189,150,150,61,89,83,124,28,34,55,11,45,94,-2,12,30,9,38,30,30,22,25,2,17,46,36,25,15,8,10,18,9,10,6,5,7,28,27,15,9,3,338,149,189,202,91,111,106,79,44,52,42,7,51,48,16,11,22,2,55,31,28,41,20,5,46,64,39,19,28,2,24,33,20,2,8,2,22,31,19,17,20,0,166,99,67,144,59,85,63,-29,61,57,28,-14,40,-8,25,22,16,1,23,-21,36,35,12,-15,10,57,38,30,10,-1,3,25,21,8,2,0,7,32,17,22,8,-1,96,10,86,120,55,65,62,-20,25,40,-4,-20,22,-11,-14,22,-6,-13,40,-9,39,18,2,-7,24,30,31,20,11,3,6,18,8,12,8,2,18,12,23,8,3,1,-89,-55,-34,121,68,53,10,-51,-75,47,-11,-8,2,-33,-40,21,-3,-2,8,-18,-35,26,-8,-6,22,21,23,33,18,2,14,8,14,19,11,1,8,13,9,14,7,1,-55,-26,-29,61,22,39,-11,25,-30,-19,18,-35,1,-1,-16,-15,12,-7,-12,26,-14,-4,6,-28,4,26,12,6,11,2,5,8,2,2,3,2,-1,18,10,4,8,0,7,32,-25,71,35,36,24,14,-34,7,18,-16,16,21,1,-9,11,-4,8,-7,-35,16,7,-12,15,16,9,10,16,5,7,6,5,5,9,3,8,10,4,5,7,2,-90,-29,-61,12,5,7,-23,-37,-48,6,-1,6,-19,-19,-11,-2,6,12,-4,-18,-37,8,-7,-6,7,2,-4,6,0,0,2,1,0,0,0,2,5,1,-4,6,0,-2,-170,-66,-104,54,21,33,-31,-37,-81,-11,-9,-12,-16,-8,-46,9,-7,-7,-15,-29,-35,-20,-2,-5,16,6,3,13,11,5,9,-2,-2,8,5,3,7,8,5,5,6,2,-186,-111,-75,-40,-27,-13,-12,-36,-111,-38,-6,24,-3,-16,-73,-16,-10,16,-9,-20,-38,-22,4,8,6,-7,-36,-9,-4,10,2,2,-30,-4,-3,6,4,-9,-6,-5,-1,4,-59,-62,3,9,-1,10,12,-23,-70,-10,18,16,4,-18,-51,-8,1,10,8,-5,-19,-2,17,6,-3,-2,-4,6,6,5,-2,-2,-3,3,2,1,-1,0,-1,3,4,4,-212,-93,-119,10,-3,13,-46,-10,-81,-59,3,-19,-38,-1,-32,-31,4,1,-8,-9,-49,-28,-1,-20,10,7,-5,-3,-5,4,0,-1,-3,-1,-2,3,10,8,-2,-2,-3,1
29,29086,Sayalonga,1143,29,13,16,27,15,12,4,2,1,9,12,1,2,2,-2,4,6,1,2,0,3,5,6,0,0,2,1,9,13,2,0,1,0,5,7,2,0,1,1,4,6,0,40,17,23,42,20,22,7,-1,3,11,22,-2,3,-1,0,6,10,-1,4,0,3,5,12,-1,7,0,5,11,19,0,3,0,2,6,9,0,4,0,3,5,10,0,25,9,16,31,16,15,6,-5,-8,17,16,-1,4,-4,-5,8,7,-1,2,-1,-3,9,9,0,4,0,0,11,13,3,3,0,-1,8,5,1,1,0,1,3,8,2,31,18,13,40,20,20,2,4,5,0,20,0,0,5,4,-2,11,0,2,-1,1,2,9,0,2,5,6,4,21,2,1,2,4,0,12,1,1,3,2,4,9,1,69,48,21,64,44,20,2,16,13,7,31,-1,0,14,11,3,18,2,2,2,2,4,13,-3,3,14,12,6,27,2,1,11,11,2,17,2,2,3,1,4,10,0,66,40,26,81,51,30,-6,9,4,14,39,5,-3,5,10,3,21,4,-3,4,-6,11,18,1,1,14,13,13,34,6,1,12,13,3,18,4,0,2,0,10,16,2,52,22,30,49,22,27,10,3,-1,18,24,-1,1,0,0,5,15,1,9,3,-1,13,9,-2,5,6,3,11,20,4,0,1,1,3,14,3,5,5,2,8,6,1,34,11,23,41,15,26,-5,0,-19,15,33,11,-2,-1,-18,5,19,8,-3,1,-1,10,14,3,0,0,-7,10,27,11,0,0,-10,3,16,6,0,0,3,7,11,5,53,24,29,30,15,15,14,9,2,8,18,3,4,3,0,3,14,0,10,6,2,5,4,3,5,2,1,3,18,1,3,1,-2,1,11,1,2,1,3,2,7,0,-12,0,-12,19,8,11,-7,3,-10,-2,5,-1,1,0,-1,-1,0,0,-8,3,-9,-1,5,-1,0,2,2,2,11,1,0,0,1,0,5,1,0,2,1,2,6,0,17,6,11,26,14,12,-2,-2,-4,0,18,4,-5,0,-1,-4,13,2,3,-2,-3,4,5,2,2,1,3,3,13,4,0,0,2,-1,10,3,2,1,1,4,3,1,6,7,-1,23,11,12,-2,0,-7,0,15,1,-1,2,-5,-1,10,3,-1,-2,-2,1,5,-2,2,1,2,1,14,3,1,1,-1,0,7,3,1,0,3,1,7,0,14,15,-1,24,17,7,-1,-2,5,-4,5,10,3,-1,1,0,4,8,-4,-1,4,-4,1,2,0,1,-2,1,11,12,2,1,-2,2,7,7,-2,0,0,-1,4,5,41,23,18,33,16,17,-1,5,3,12,18,4,0,3,2,6,8,4,-1,2,1,6,10,0,0,3,0,6,15,9,0,1,0,2,7,6,0,2,0,4,8,3,40,22,18,48,25,23,3,-3,14,10,19,-4,2,-1,6,5,12,-2,1,-2,8,5,7,-2,4,1,3,10,19,10,3,0,1,4,11,6,1,1,2,6,8,4,120,68,52,113,60,53,12,7,-2,23,46,34,8,6,0,9,23,22,4,1,-2,14,23,12,9,1,2,22,43,36,5,0,2,10,21,22,4,1,0,12,22,14,15,6,9,31,15,16,-3,5,-4,0,10,7,-1,1,-3,1,5,3,-2,4,-1,-1,5,4,1,1,0,5,15,9,0,1,-1,3,8,4,1,0,1,2,7,5,14,6,8,22,11,11,11,4,1,17,28,-46,5,1,-1,9,17,-25,6,3,2,8,11,-21,8,3,2,15,33,-39,3,2,-1,9,21,-23,5,1,3,6,12,-16
29,29901,Torremolinos,39068,2547,1293,1254,1267,652,615,375,397,820,403,343,190,210,164,419,212,189,92,165,233,401,191,154,98,193,201,364,251,187,64,99,87,191,128,109,35,94,114,173,123,78,29,2415,1238,1177,1617,813,804,368,430,675,424,340,165,218,189,347,228,184,71,150,241,328,196,156,94,333,275,395,316,220,69,172,121,198,156,123,39,161,154,197,160,97,30,3755,1990,1765,2256,1172,1084,459,628,1026,669,577,374,255,306,556,384,307,165,204,322,470,285,270,209,361,375,561,427,337,182,185,178,296,228,181,96,176,197,265,199,156,86,2970,1658,1312,1900,1004,896,383,552,875,493,416,219,203,307,523,288,203,116,180,245,352,205,213,103,334,357,454,355,278,107,169,180,256,189,137,64,165,177,198,166,141,43,2724,1578,1146,1853,1006,847,293,351,740,534,483,300,188,187,464,297,280,145,105,164,276,237,203,155,303,259,459,375,300,143,166,136,252,198,166,78,137,123,207,177,134,65,3121,1861,1260,1784,986,798,296,573,954,581,444,265,199,319,594,345,252,148,97,254,360,236,192,117,249,329,429,313,299,146,148,186,227,170,153,92,101,143,202,143,146,54,2713,1518,1195,1571,812,759,361,518,779,496,349,205,210,264,479,300,170,96,151,254,300,196,179,109,295,294,372,280,212,110,153,139,205,160,100,51,142,155,167,120,112,59,2690,1467,1223,1534,778,756,322,461,814,486,380,196,183,227,448,255,242,96,139,234,366,231,138,100,284,335,319,293,185,105,156,145,178,133,103,58,128,190,141,160,82,47,2072,1188,884,1000,511,489,196,330,775,362,232,155,119,169,448,241,125,72,77,161,327,121,107,83,153,218,229,171,119,99,101,100,121,83,47,51,52,118,108,88,72,48,1336,820,516,562,286,276,136,173,402,236,261,113,110,68,252,153,166,68,26,105,150,83,95,45,68,103,86,82,137,77,35,48,26,47,83,42,33,55,60,35,54,35,1483,926,557,723,390,333,116,239,500,224,276,117,101,112,350,152,142,60,15,127,150,72,134,57,93,117,135,132,162,73,42,50,86,75,86,42,51,67,49,57,76,31,166,244,-78,52,18,34,-29,-24,39,-55,122,91,21,-18,108,-25,88,57,-50,-6,-69,-30,34,34,-26,50,-16,-67,54,33,-20,18,-10,-35,32,20,-6,32,-6,-32,22,13,378,305,73,260,147,113,-37,88,111,59,78,82,25,37,101,60,46,41,-62,51,10,-1,32,41,61,70,13,4,65,39,42,36,-3,2,38,26,19,34,16,2,27,13,279,256,23,262,136,126,-30,41,26,-7,209,52,-2,30,68,10,120,33,-28,11,-42,-17,89,19,29,39,22,13,105,42,11,16,10,-1,67,25,18,23,12,14,38,17,-1397,-611,-786,-1596,-795,-801,90,-148,-125,-304,-205,-713,62,-88,-10,-153,-91,-345,28,-60,-115,-151,-114,-368,87,-136,-154,-340,-315,-749,46,-89,-81,-166,-151,-361,41,-47,-73,-174,-164,-388,234,192,42,-169,-87,-82,69,95,90,45,40,-122,32,53,92,60,16,-69,37,42,-2,-15,24,-53,37,42,10,-89,-20,-170,11,25,26,-59,-15,-86,26,17,-16,-30,-5,-84,577,414,163,136,60,76,179,110,282,33,86,-121,104,71,183,63,38,-47,75,39,99,-30,48,-74,128,71,66,-38,-4,-102,58,41,39,-15,-17,-54,70,30,27,-23,13,-48,-572,-297,-275,-490,-276,-214,-56,97,68,-219,-68,-397,-18,41,53,-128,-44,-206,-38,56,15,-91,-24,-191,-42,55,-14,-108,-80,-312,-14,17,-4,-66,-47,-165,-28,38,-10,-42,-33,-147
29,29091,Torrox,11919,153,77,76,158,87,71,14,16,30,45,41,10,1,9,22,19,24,1,13,7,8,26,17,9,17,27,32,31,41,10,8,16,18,15,25,5,9,11,14,16,16,5,182,92,90,185,98,87,29,31,23,44,38,16,12,15,18,18,21,6,17,16,5,26,17,10,21,29,42,36,37,18,8,17,26,16,20,9,13,12,16,20,17,9,394,212,182,329,175,154,45,63,65,64,133,22,16,30,38,34,78,12,29,33,27,30,55,10,46,45,49,55,100,33,21,25,28,27,58,15,25,20,21,28,42,18,509,267,242,440,234,206,65,72,102,82,148,37,30,38,60,41,68,28,35,34,42,41,80,9,64,50,83,72,130,39,30,28,49,38,60,28,34,22,34,34,70,11,862,454,408,649,346,303,103,92,222,180,191,69,52,39,122,96,98,46,51,53,100,84,93,23,79,76,137,139,167,49,38,41,79,73,82,32,41,35,58,66,85,17,1030,567,463,707,384,323,148,185,250,200,181,63,85,103,155,93,98,33,63,82,95,107,83,30,81,118,131,148,161,64,41,70,77,70,88,36,40,48,54,78,73,28,916,514,402,676,372,304,136,102,208,161,217,88,89,62,115,87,105,52,47,40,93,74,112,36,100,78,114,112,191,75,65,42,63,61,93,44,35,36,51,51,98,31,857,463,394,641,338,303,105,99,182,196,192,68,57,54,94,98,101,46,48,45,88,98,91,22,95,87,100,129,161,62,51,45,52,63,84,38,44,42,48,66,77,24,641,336,305,521,272,249,67,84,103,135,144,106,45,49,40,76,69,57,22,35,63,59,75,49,52,57,96,85,137,92,29,27,53,45,69,48,23,30,43,40,68,44,480,258,222,395,196,199,31,55,91,62,147,93,17,26,60,33,72,52,14,29,31,29,75,41,33,34,52,66,135,72,19,18,22,31,66,40,14,16,30,35,69,32,452,271,181,326,167,159,8,65,132,40,126,79,-8,43,85,33,70,48,16,22,47,7,56,31,13,28,44,31,115,93,4,14,23,15,52,58,9,14,21,16,63,35,374,201,173,306,153,153,31,27,47,38,144,87,12,9,30,32,68,49,19,18,17,6,76,38,23,21,27,25,136,73,9,8,9,20,65,41,14,13,18,5,71,32,207,109,98,122,65,57,37,18,-8,44,56,50,9,17,-22,24,37,40,28,1,14,20,19,10,6,4,-14,10,71,44,2,7,-14,4,35,31,4,-3,0,6,36,13,-179,-129,-50,-29,-25,-4,-31,-23,-61,-56,16,-21,-25,-7,-54,-42,4,-2,-6,-16,-7,-14,12,-19,12,-5,-12,-2,13,-35,8,-2,-17,-6,5,-13,4,-3,5,4,8,-22,23,6,17,38,10,28,-7,-27,-15,3,56,14,23,-26,-29,2,24,12,-30,-1,14,1,32,2,-21,-16,-9,-5,61,26,-2,-8,-13,-8,25,15,-19,-8,4,3,36,11,19,10,9,-56,-49,-7,-20,13,-12,-30,83,-21,-3,4,-1,-27,39,-4,-17,9,-11,-3,44,-17,-11,8,-38,-54,47,-12,-3,3,-27,-39,23,-8,-8,5,-11,-15,24,-4,404,197,207,320,168,152,7,27,20,58,171,122,2,6,-3,32,87,73,5,21,23,26,84,49,16,22,30,52,111,87,7,9,13,28,55,56,9,13,17,24,56,31,710,398,312,493,251,242,50,61,101,107,236,150,28,34,71,51,130,81,22,27,30,56,106,69,37,37,62,76,155,124,10,16,37,36,81,70,27,21,25,40,74,54
29,29094,Vélez-Málaga,54796,699,318,381,278,159,119,147,87,180,137,86,54,67,31,97,55,39,27,80,56,83,82,47,27,51,39,64,54,44,21,37,24,33,28,25,11,14,15,31,26,19,10,723,348,375,394,195,199,146,102,241,108,97,24,65,38,117,62,54,11,81,64,124,46,43,13,88,79,98,78,35,14,43,37,46,39,20,9,45,42,52,39,15,5,1707,863,844,911,472,439,322,147,365,308,293,246,158,84,159,176,149,122,164,63,206,132,144,124,169,94,167,132,173,164,82,53,87,67,97,79,87,41,80,65,76,85,1767,936,831,992,541,451,289,243,471,311,267,170,149,151,240,167,133,92,140,92,231,144,134,78,134,189,219,163,170,107,72,116,116,88,81,63,62,73,103,75,89,44,2497,1369,1128,1495,850,645,410,407,690,460,361,140,224,230,381,252,186,80,186,177,309,208,175,60,207,299,389,295,216,77,101,182,232,170,113,44,106,117,157,125,103,33,2287,1226,1061,1528,827,701,329,413,661,407,341,117,167,220,370,246,157,56,162,193,291,161,184,61,247,319,392,268,236,60,125,172,229,152,118,28,122,147,163,116,118,32,2081,1045,1036,1294,650,644,415,359,546,374,240,117,201,154,276,209,134,55,214,205,270,165,106,62,261,258,306,216,163,81,127,130,162,99,85,42,134,128,144,117,78,39,2157,1137,1020,1379,731,648,379,410,571,378,251,150,196,200,328,215,129,63,183,210,243,163,122,87,196,367,356,231,152,71,108,180,202,131,75,34,88,187,154,100,77,37,1240,600,640,690,369,321,221,135,206,259,228,172,131,60,117,119,88,82,90,75,89,140,140,90,107,148,155,99,110,60,69,76,87,51,40,37,38,72,68,48,70,23,1097,472,625,369,155,214,145,71,187,201,199,275,72,-1,75,110,107,97,73,72,112,91,92,178,50,72,42,37,88,74,28,29,7,16,39,32,22,43,35,21,49,42,1202,645,557,520,262,258,188,62,346,220,221,162,105,35,181,103,119,95,83,27,165,117,102,67,87,88,101,81,90,66,50,45,50,37,39,35,37,43,51,44,51,31,1287,621,666,302,116,186,192,85,311,254,253,166,102,25,153,128,131,68,90,60,158,126,122,98,54,49,40,43,69,42,23,19,10,13,26,24,31,30,30,30,43,18,667,314,353,-23,-37,14,122,-14,-4,219,191,142,81,-23,-4,92,91,75,41,9,0,127,100,67,2,9,-84,-29,36,40,-2,-8,-52,-20,16,26,4,17,-32,-9,20,14,549,246,303,-132,-83,-49,63,-4,48,94,202,135,31,-39,9,62,109,72,32,35,39,32,93,63,-26,-23,-63,-47,18,7,-13,-13,-53,-30,11,14,-13,-10,-10,-17,7,-7,418,175,243,241,112,129,71,10,45,49,109,133,24,25,-11,14,55,63,47,-15,56,35,54,70,56,26,55,19,52,31,30,11,25,-3,29,19,26,15,30,22,23,12,102,19,83,-519,-279,-240,38,-71,-16,-85,81,137,9,-28,-29,-65,62,56,29,-43,13,-20,19,81,-47,-54,-182,-194,-39,-7,-19,-20,-113,-125,-7,2,-28,-34,-69,-69,-32,-9,1194,509,685,455,200,255,213,76,225,222,201,252,109,26,89,98,82,109,104,50,136,124,119,143,97,67,85,56,81,60,51,26,24,27,39,30,46,41,61,29,42,30,1101,516,585,589,297,292,205,79,221,218,219,151,105,24,88,99,116,81,100,55,133,119,103,70,116,80,128,86,115,53,61,34,61,49,56,30,55,46,67,37,59,23
29,29095,Villanueva de Algaidas,4159,2,-1,3,6,3,3,1,-6,6,3,0,-2,0,-6,2,1,1,1,1,0,4,2,-1,-3,1,1,2,1,1,0,0,1,1,0,1,0,1,0,1,1,0,0,14,15,-1,5,1,4,6,-5,14,3,0,-5,2,2,11,1,0,-2,4,-7,3,2,0,-3,1,0,1,3,0,0,0,0,0,1,0,0,1,0,1,2,0,0,20,17,3,21,11,10,0,2,0,12,3,-1,2,3,2,6,2,1,-2,-1,-2,6,1,-2,0,3,7,6,4,1,0,3,2,3,2,1,0,0,5,3,2,0,131,79,52,68,40,28,19,6,31,30,17,28,13,4,23,16,13,10,6,2,8,14,4,18,3,13,20,23,10,-1,2,8,15,9,7,-1,1,5,5,14,3,0,136,76,60,130,71,59,-7,18,36,26,25,36,-5,15,17,19,11,17,-2,3,19,7,14,19,4,27,42,31,21,4,2,16,23,18,8,3,2,11,19,13,13,1,74,45,29,53,30,23,11,28,10,12,13,0,8,16,9,5,8,-3,3,12,1,7,5,3,3,12,14,18,6,0,3,7,8,9,3,0,0,5,6,9,3,0,43,22,21,66,34,32,7,11,9,0,12,3,3,14,-1,2,4,-1,4,-3,10,-2,8,4,8,16,11,14,14,2,5,6,9,7,6,0,3,10,2,7,8,2,93,60,33,96,51,45,25,15,12,16,15,8,15,11,8,10,10,7,10,4,4,6,5,1,15,21,25,18,10,6,11,8,13,8,7,4,4,13,12,10,3,2,27,20,7,50,31,19,9,12,-7,12,6,-4,4,11,-4,5,4,0,5,1,-3,7,2,-4,15,11,9,8,5,2,9,8,6,5,3,0,6,3,3,3,2,2,6,17,-11,16,8,8,6,-10,7,-9,1,9,7,2,3,-3,2,5,-1,-12,4,-6,-1,4,4,5,4,2,1,0,3,3,2,0,0,0,1,2,2,2,1,0,-13,-7,-6,24,13,11,3,-4,-1,-11,-6,7,2,-1,0,-11,0,3,1,-3,-1,0,-6,4,4,7,11,-3,3,2,3,5,5,-2,2,0,1,2,6,-1,1,2,3,-2,5,29,12,17,11,1,-8,-3,6,-1,2,3,-1,-3,0,0,9,-2,-7,0,6,-1,9,6,8,1,4,1,1,5,5,1,0,0,8,1,3,0,4,1,6,-3,9,12,8,4,-1,-2,0,8,6,-5,-3,-1,0,4,2,-4,2,-1,0,4,4,-1,1,1,3,4,2,0,1,0,1,5,1,0,0,1,2,-1,1,0,-109,-55,-54,-59,-36,-23,-14,-10,-42,-34,-8,-1,-8,-5,-23,-21,0,1,-6,-5,-19,-13,-8,-2,-1,-2,-26,-20,-9,-1,-3,-1,-15,-14,-3,0,2,-1,-11,-6,-6,-1,8,8,0,20,16,4,5,1,-1,-1,9,-6,3,-1,0,2,4,-1,2,2,-1,-3,5,-5,7,2,2,4,3,1,5,2,2,4,1,1,2,0,0,0,2,0,-39,-3,-36,-47,-20,-27,-7,5,-3,2,-26,-11,-8,1,12,10,-13,-6,1,4,-15,-8,-13,-5,-11,0,0,-5,-22,-9,-9,-2,2,3,-11,-3,-2,2,-2,-8,-11,-6,-23,-11,-12,19,9,10,-9,-6,-18,5,-2,7,-6,-4,-10,2,3,3,-3,-2,-8,3,-5,4,3,2,5,3,4,1,1,0,3,1,2,1,2,2,2,2,2,0,-22,-6,-16,-3,0,-3,0,-10,-5,-11,4,-3,4,-6,-7,-8,8,1,-4,-4,2,-3,-4,-4,3,1,-3,-4,1,-1,3,1,-1,-4,2,-1,0,0,-2,0,-1,0
29,29096,Villanueva del Rosario,3339,28,15,13,11,7,4,1,10,0,7,10,2,1,3,3,2,5,1,0,7,-3,5,5,1,2,0,3,2,2,2,2,0,1,1,2,1,0,0,2,1,0,1,21,14,7,2,1,1,3,3,-3,2,10,5,2,5,-3,2,4,3,1,-2,0,0,6,2,0,0,0,0,2,0,0,0,0,0,1,0,0,0,0,0,1,0,-5,-2,-3,8,1,7,-2,-6,-3,2,4,0,-4,2,0,1,1,-1,2,-8,-3,1,3,1,3,1,2,1,1,0,1,0,0,0,0,0,2,1,2,1,1,0,2,6,-4,14,6,8,-3,-7,-10,6,14,2,-3,-1,-3,3,8,2,0,-6,-7,3,6,0,1,0,0,5,6,2,0,-1,0,2,4,1,1,1,0,3,2,1,25,15,10,24,13,11,10,-9,5,2,14,3,3,0,-1,3,5,5,7,-9,6,-1,9,-2,7,1,2,5,8,1,5,0,0,3,4,1,2,1,2,2,4,0,69,41,28,39,20,19,9,1,2,18,34,7,4,0,8,9,15,5,5,1,-6,9,19,2,1,2,3,13,19,1,0,1,2,8,8,1,1,1,1,5,11,0,62,37,25,6,3,3,25,4,19,9,5,2,15,0,11,4,4,3,10,4,8,5,1,-1,0,1,2,1,2,0,0,1,1,0,1,0,0,0,1,1,1,0,55,37,18,33,21,12,-1,2,16,20,8,11,3,7,9,9,3,6,-4,-5,7,11,5,5,3,4,10,11,3,2,2,3,7,7,1,1,1,1,3,4,2,1,27,9,18,13,6,7,5,-1,-1,10,7,7,4,-1,-4,4,4,2,1,0,3,6,3,5,3,2,3,5,1,-1,2,2,0,2,1,-1,1,0,3,3,0,0,-19,-17,-2,-1,-1,0,0,0,-10,-7,-5,2,-3,1,-10,-3,-1,-2,3,-1,0,-4,-4,4,1,0,3,-3,-2,0,0,0,-1,0,0,0,1,0,4,-3,-2,0,8,10,-2,4,1,3,2,0,-8,2,7,6,4,3,-6,0,7,1,-2,-3,-2,2,0,5,-1,0,0,1,2,2,0,0,0,-1,1,1,-1,0,0,2,1,1,-13,-17,4,6,2,4,-1,3,6,-10,0,-11,-4,0,0,-6,-3,-4,3,3,6,-4,3,-7,1,3,3,1,0,-2,1,0,2,1,-1,-1,0,3,1,0,1,-1,-47,-10,-37,-27,-12,-15,-11,2,-11,-14,-8,-7,-4,6,-2,-7,0,-6,-7,-4,-9,-7,-8,-1,-2,-1,-4,-8,-9,-4,-2,0,-1,-4,-3,-3,0,-1,-3,-4,-6,-1,-39,-20,-19,-25,-14,-11,-6,-5,-12,-8,-7,-1,-7,2,-9,0,-6,1,1,-7,-3,-8,-1,-2,-2,-3,-8,-6,-5,0,-1,0,-7,-1,-4,0,-1,-3,-1,-5,-1,0,-13,-3,-10,3,0,3,-7,-1,-8,-7,4,2,-4,0,-5,-3,3,2,-3,-1,-3,-4,1,0,0,-1,0,0,4,0,0,-1,-1,0,2,0,0,0,1,0,2,0,-19,-11,-8,5,2,3,0,-7,-11,1,2,-3,-2,-4,-3,1,1,-3,2,-3,-8,0,1,0,1,0,0,3,0,1,0,0,0,2,0,0,1,0,0,1,0,1,-53,-20,-33,-2,-1,-1,-13,-16,-16,-5,-6,3,-10,-6,-4,0,-3,3,-3,-10,-12,-5,-3,0,0,0,-2,5,-2,-3,0,0,0,1,-1,-1,0,0,-2,4,-1,-2,-12,-5,-7,2,0,2,-5,1,-5,1,-5,0,2,-2,-5,0,-3,3,-7,3,0,1,-2,-3,2,0,0,5,-1,-4,1,0,0,1,0,-2,1,0,0,4,-1,-2
29,29099,Viñuela,1185,38,17,21,23,12,11,6,8,4,4,11,2,1,1,1,6,5,2,5,7,3,-2,6,0,3,0,2,6,11,1,1,0,0,5,5,1,2,0,2,1,6,0,36,22,14,36,20,16,5,1,-3,9,17,7,5,1,-2,5,8,5,0,0,-1,4,9,2,5,1,1,5,17,7,4,0,1,2,8,5,1,1,0,3,9,2,76,44,32,67,36,31,12,-1,9,8,40,8,9,3,3,1,24,4,3,-4,6,7,16,4,12,3,8,9,26,9,9,2,2,3,16,4,3,1,6,6,10,5,97,49,48,97,52,45,13,2,9,18,46,10,7,0,2,13,20,7,6,2,7,5,26,3,11,2,5,15,52,12,8,0,2,10,24,8,3,2,3,5,28,4,132,52,80,134,64,70,7,1,7,29,77,11,-5,-4,6,12,34,9,12,5,1,17,43,2,8,4,6,26,70,20,2,2,5,11,30,14,6,2,1,15,40,6,116,60,56,126,64,62,2,-1,15,20,63,14,2,-2,7,7,37,8,0,1,8,13,26,6,6,4,17,19,67,12,2,2,7,8,37,7,4,2,10,11,30,5,147,81,66,135,69,66,7,5,2,28,75,30,1,3,4,14,39,20,6,2,-2,14,36,10,8,4,9,22,67,25,2,1,4,12,34,16,6,3,5,10,33,9,110,55,55,100,47,53,6,9,6,23,44,22,6,3,5,7,22,12,0,6,1,16,22,10,11,6,6,24,40,13,6,3,3,10,19,6,5,3,3,14,21,7,15,2,13,32,15,17,3,7,-2,4,11,-8,0,3,-5,1,5,-2,3,4,3,3,6,-6,2,2,5,6,12,5,1,1,2,4,5,2,1,1,3,2,7,3,5,9,-4,21,13,8,-3,-2,1,-4,11,1,-2,0,2,-2,5,5,-1,-2,-1,-2,6,-4,0,0,2,1,12,6,-1,0,3,0,5,6,1,0,-1,1,7,0,1,15,-14,23,17,6,-5,-6,4,9,7,-9,3,0,3,5,7,-4,-8,-6,1,4,0,-5,0,-1,1,6,17,0,1,0,1,3,11,1,-1,-1,0,3,6,-1,74,45,29,30,14,16,19,9,14,11,15,7,14,7,10,5,6,5,5,2,4,6,9,2,3,4,2,4,12,5,1,1,1,2,5,4,2,3,1,2,7,1,38,25,13,44,21,23,-3,4,-5,16,13,13,0,-1,2,8,9,6,-3,5,-7,8,4,7,2,5,1,6,16,14,1,4,1,1,8,6,1,1,0,5,8,8,-25,-16,-9,3,2,1,-2,-3,-7,-2,2,-13,-1,0,-5,-2,0,-8,-1,-3,-2,0,2,-5,3,-2,1,5,4,-8,2,0,-1,2,2,-3,1,-2,2,3,2,-5,122,63,59,98,48,50,9,8,10,20,63,10,4,0,5,10,36,7,5,8,5,10,27,3,10,-2,2,14,58,15,4,-2,-2,4,34,9,6,0,4,10,24,6,34,15,19,61,28,33,2,-6,-7,17,29,-2,1,-3,-4,11,11,-1,1,-3,-3,6,18,-1,5,0,3,11,38,4,2,0,1,6,16,3,3,0,2,5,22,1,-6,-2,-4,-19,-11,-8,2,5,1,-1,6,-21,0,5,3,0,-2,-9,2,0,-2,-1,8,-12,3,-1,-2,-1,3,-21,0,-1,0,1,-3,-8,3,0,-2,-2,6,-13,-4,2,-6,16,10,6,-12,-9,-8,12,10,3,-5,-4,-4,4,9,2,-7,-5,-4,8,1,1,2,-5,2,9,8,0,1,-1,2,3,5,0,1,-4,0,6,3,0
30,30001,Abanilla,6153,-29,-8,-21,73,46,27,-16,-7,-6,0,5,-5,-10,0,0,0,3,-2,-6,-7,-6,0,2,-3,3,16,29,18,4,2,2,9,20,11,2,1,1,7,9,7,2,1,43,27,16,61,29,32,12,10,-1,18,7,-5,8,6,-1,9,5,-1,4,4,0,9,2,-4,7,18,12,13,7,3,4,7,5,7,4,2,3,11,7,6,3,1,32,29,3,47,26,21,-2,-4,-4,9,33,-1,-3,4,5,9,15,0,1,-8,-9,0,18,-1,11,13,11,12,5,-5,4,7,8,7,2,-2,7,6,3,5,3,-3,-49,-40,-9,54,20,34,-30,-1,-35,6,15,-1,-18,-1,-27,3,7,-2,-12,0,-8,3,8,1,4,12,12,15,8,3,1,2,3,8,3,3,3,10,9,7,5,0,121,77,44,117,61,56,28,-1,14,23,42,19,13,6,15,12,24,10,15,-7,-1,11,18,9,20,17,24,21,28,7,11,9,12,10,16,3,9,8,12,11,12,4,36,27,9,110,63,47,-1,8,3,18,10,-1,-1,5,8,11,3,0,0,3,-5,7,7,-1,17,21,31,18,19,4,6,13,21,10,10,3,11,8,10,8,9,1,275,136,139,158,80,78,21,47,16,44,69,81,11,31,6,22,31,35,10,16,10,22,38,46,24,24,34,21,34,19,12,12,20,6,16,12,12,12,14,15,18,7,92,42,50,111,51,60,5,8,4,3,67,7,2,5,1,-4,37,5,3,3,3,7,30,2,7,16,13,20,46,9,4,8,5,12,18,4,3,8,8,8,28,5,-31,-45,14,37,11,26,2,-2,-43,-12,15,11,0,-3,-22,-19,1,-1,2,1,-21,7,14,12,9,1,6,8,12,0,3,-2,3,3,5,-1,6,3,3,5,7,1,-25,11,-36,22,9,13,-21,-4,-19,-9,28,2,-7,3,-1,-4,14,5,-14,-7,-18,-5,14,-3,0,0,3,0,19,0,-1,-2,-2,2,10,2,1,2,5,-2,9,-2,72,33,39,10,3,7,-1,0,-6,40,33,11,-4,0,-5,20,16,8,3,0,-1,20,17,3,0,3,-9,3,8,5,-1,1,-4,1,3,3,1,2,-5,2,5,2,-36,-22,-14,25,13,12,-16,5,-37,-13,23,3,-6,-6,-18,-2,8,4,-10,11,-19,-11,15,-1,-1,2,0,2,16,5,-1,-1,3,0,9,2,0,3,-3,2,7,3,33,23,10,7,-2,9,0,-4,0,10,36,-7,-2,4,-1,4,23,-4,2,-8,1,6,13,-3,-5,0,-3,1,16,-2,-2,0,-3,-4,7,0,-3,0,0,5,9,-2,7,8,-1,28,14,14,-6,1,-17,-2,15,17,-7,-5,-3,5,6,12,1,6,-14,-7,9,5,-4,4,0,0,18,10,-2,1,0,-2,9,8,-2,3,0,2,9,2,-35,-8,-27,4,2,2,-7,-8,-7,-13,11,-8,-2,0,-3,-12,12,-3,-5,-8,-4,-1,-1,-5,0,-1,-4,2,9,-2,0,-1,-3,2,4,0,0,0,-1,0,5,-2,-10,8,-18,41,25,16,-8,-7,-13,6,13,-1,-1,-2,-3,5,11,-3,-7,-5,-10,1,2,2,4,1,7,4,20,5,1,0,5,2,15,2,3,1,2,2,5,3,-18,-15,-3,5,4,1,11,-5,-13,-5,15,-17,11,-6,-8,-10,7,-6,0,1,-5,5,8,-11,4,1,0,0,10,-10,2,0,1,-2,5,-2,2,1,-1,2,5,-8,-17,-12,-5,5,3,2,-3,5,-30,6,4,2,-4,2,-13,0,0,4,1,3,-17,6,4,-2,3,3,-1,-2,3,-1,3,2,-2,-3,1,2,0,1,1,1,2,-3
30,30002,Abarán,12177,174,117,57,265,163,102,3,69,67,35,0,1,4,43,47,22,-1,2,-1,26,20,13,1,-1,21,79,108,51,4,0,12,46,67,33,3,0,9,33,41,18,1,0,202,135,67,245,139,106,24,80,54,39,6,-5,12,60,34,22,2,2,12,20,20,17,4,-7,23,99,80,37,3,0,9,60,49,19,0,0,14,39,31,18,3,0,132,80,52,138,74,64,41,35,21,11,4,13,27,25,11,5,4,3,14,10,10,6,0,10,44,40,36,13,2,2,20,25,16,9,2,1,24,15,20,4,0,1,58,18,40,179,85,94,47,22,-11,-4,4,1,15,13,-6,-2,-1,-1,32,9,-5,-2,5,2,62,48,41,16,8,2,28,21,26,7,3,0,34,27,15,9,5,2,49,61,-12,122,75,47,3,14,21,14,2,-7,12,16,28,11,0,-3,-9,-2,-7,3,2,-4,23,35,41,17,4,1,9,24,33,8,1,0,14,11,8,9,3,1,127,105,22,170,117,53,11,52,59,5,7,-3,12,39,49,9,3,-3,-1,13,10,-4,4,0,30,50,62,20,5,3,17,38,46,13,1,2,13,12,16,7,4,1,82,54,28,106,50,56,16,46,12,8,4,-9,13,17,12,8,5,-3,3,29,0,0,-1,-6,21,49,32,2,2,0,10,22,18,-2,1,1,11,27,14,4,1,-1,81,30,51,156,64,92,17,44,12,1,2,5,7,22,14,-13,-5,4,10,22,-2,14,7,1,37,43,55,11,5,3,14,17,28,1,0,3,23,26,27,10,5,0,50,50,0,87,52,35,15,39,22,-10,-10,-9,20,29,5,1,-6,0,-5,10,17,-11,-4,-9,10,45,23,6,1,0,10,24,13,3,2,-1,0,21,10,3,-1,1,114,86,28,97,54,43,27,40,25,19,7,-1,10,32,17,21,2,6,17,8,8,-2,5,-7,19,34,31,13,0,1,8,21,19,6,0,0,11,13,12,7,0,1,-82,-57,-25,-39,-44,5,-10,-14,-33,-16,1,-1,-5,-8,-22,-13,-2,0,-5,-6,-11,-3,3,-1,3,-8,-8,-21,-1,-3,3,-12,-11,-18,-4,-1,0,4,3,-3,3,-2,-17,-14,-3,50,31,19,-16,4,-31,19,7,3,-11,-3,-20,19,0,1,-5,7,-11,0,7,2,13,7,14,13,2,2,8,1,11,10,0,1,5,6,3,3,2,1,-62,-43,-19,-61,-53,-8,4,8,-36,-35,9,-11,14,2,-24,-29,2,-7,-10,6,-12,-6,7,-4,-4,3,-39,-20,1,-2,1,0,-33,-21,0,0,-5,3,-6,1,1,-2,-77,-65,-12,-77,-65,-12,-7,-1,-19,-44,-2,-5,-5,-5,-21,-30,-1,-2,-2,4,2,-14,-1,-3,-5,0,-35,-30,-5,-3,1,-5,-30,-28,-2,-1,-6,5,-5,-2,-3,-2,18,25,-7,61,35,26,4,6,-19,32,2,-5,4,7,-8,19,5,-2,0,-1,-11,13,-3,-3,10,18,10,20,2,0,4,8,7,15,1,0,6,10,3,5,1,0,-155,-80,-75,-91,-46,-45,-18,-2,-60,-54,-11,-5,-11,2,-27,-30,-6,-4,-7,-4,-33,-24,-5,-1,-8,0,-27,-42,-12,-3,-4,4,-15,-25,-6,-1,-4,-4,-12,-17,-6,-2,-61,-55,-6,61,28,33,-10,12,-24,-36,5,-8,-5,-3,-18,-28,-1,-1,-5,15,-6,-8,6,-7,10,13,19,12,5,2,4,2,11,8,3,0,6,11,8,4,2,2,-20,-8,-12,93,44,49,1,5,-30,1,-2,-4,10,0,-19,3,-3,-3,-9,5,-11,-2,1,-1,29,16,22,16,5,0,14,8,8,10,2,-2,15,8,14,6,3,2
30,30003,Águilas,26773,564,302,262,500,278,222,47,120,190,75,73,50,20,71,106,46,31,21,27,49,84,29,42,29,48,121,183,69,52,22,20,69,104,45,24,12,28,52,79,24,28,10,502,250,252,463,227,236,87,87,154,75,50,54,44,50,82,32,23,24,43,37,72,43,27,30,98,100,143,78,34,7,55,50,70,33,17,2,43,50,73,45,17,5,678,351,327,525,273,252,129,136,157,108,89,52,67,57,86,55,56,29,62,79,71,53,33,23,104,120,142,79,67,9,60,57,74,36,39,5,44,63,68,43,28,4,665,306,359,557,260,297,134,147,134,79,117,52,58,75,64,30,50,29,76,72,70,49,67,23,131,116,115,84,80,24,65,55,56,34,34,13,66,61,59,50,46,11,768,415,353,626,348,278,123,127,205,163,105,33,60,62,134,97,46,12,63,65,71,66,59,21,108,121,182,114,74,23,53,62,114,67,35,15,55,59,68,47,39,8,969,567,402,636,362,274,186,160,207,213,147,47,92,95,139,125,80,31,94,65,68,88,67,16,103,141,150,123,92,24,48,79,99,71,49,14,55,62,51,52,43,10,940,498,442,810,429,381,159,193,249,146,132,51,76,88,135,89,76,32,83,105,114,57,56,19,148,183,211,136,94,32,72,98,107,77,49,21,76,85,104,59,45,11,682,362,320,580,288,292,105,151,140,129,105,41,73,80,66,57,57,21,32,71,74,72,48,20,109,138,107,112,82,23,57,68,51,51,41,13,52,70,56,61,41,10,316,214,102,260,155,105,41,75,43,73,59,14,21,37,46,56,26,19,20,38,-3,17,33,-5,44,63,52,45,46,5,29,32,28,31,24,9,15,31,24,14,22,-4,287,127,160,194,81,113,34,55,37,30,57,65,5,40,10,14,27,31,29,15,27,16,30,34,26,54,30,26,37,19,14,27,6,10,15,9,12,27,24,16,22,10,-44,-41,-3,-45,-29,-16,-21,-37,-12,-31,23,28,0,-21,-32,-10,8,11,-21,-16,20,-21,15,17,-9,-22,-36,-7,16,9,-4,-15,-24,-3,5,9,-5,-7,-12,-4,11,0,-165,-107,-58,-276,-167,-109,-54,-12,-33,-49,-9,-21,-15,-31,-19,-41,5,-9,-39,19,-14,-8,-14,-12,-45,-13,-38,-72,-46,-66,-21,-21,-30,-45,-17,-35,-24,8,-8,-27,-29,-31,-3,-28,25,-114,-78,-36,8,-3,-14,-30,19,16,-5,2,-14,-31,13,4,13,-5,0,1,6,12,-20,-7,-44,-21,-11,-11,-8,-7,-32,-19,-3,-9,-12,0,-12,-2,-8,-2,-238,-144,-94,-231,-159,-72,-45,-38,-65,-74,-12,-1,-20,-30,-32,-35,-17,-5,-25,-8,-33,-39,5,4,0,-15,-70,-84,-32,-32,0,-14,-51,-47,-25,-23,0,-1,-19,-37,-7,-9,29,-12,41,-167,-104,-63,46,72,-11,-76,-13,4,15,44,-2,-66,-2,-5,31,28,-9,-10,-11,9,4,48,-39,-99,-53,-31,0,29,-8,-74,-34,-19,4,19,-31,-25,-19,-12,-14,-35,21,-15,-29,14,-9,3,-40,-6,27,12,-6,-4,-28,-17,8,12,-3,7,-12,11,19,0,-11,22,9,-20,-5,-10,-4,2,0,-17,-8,-2,-7,20,9,-3,3,-8,50,13,37,-100,-62,-38,12,6,44,-30,33,-28,11,2,32,-38,5,-7,1,4,12,8,28,-21,-13,11,-6,-46,-2,-49,-11,6,7,-33,-11,-21,-2,5,-13,-13,9,-28,202,106,96,25,6,19,29,26,16,50,21,50,-3,25,18,27,3,30,32,1,-2,23,18,20,1,27,13,-30,-1,11,-2,21,11,-28,-3,6,3,6,2,-2,2,5
30,30005,Alcantarilla,32982,560,313,247,325,170,155,95,189,182,79,2,9,49,104,107,54,-5,6,46,85,75,25,7,3,36,100,122,54,7,4,14,50,72,30,3,1,22,50,50,24,4,3,518,301,217,456,257,199,78,174,185,65,8,2,35,98,130,32,-2,2,43,76,55,33,10,0,87,133,143,78,13,0,49,70,88,42,6,0,38,63,55,36,7,0,607,316,291,430,217,213,152,192,182,52,8,23,72,88,104,40,3,10,80,104,78,12,5,13,112,118,133,45,15,3,52,53,78,25,7,-1,60,65,55,20,8,4,499,252,247,398,201,197,42,147,168,88,32,11,27,58,84,58,4,10,15,89,84,30,28,1,72,132,108,48,24,8,34,64,58,30,8,4,38,68,50,18,16,4,666,396,270,396,208,188,81,147,302,82,40,14,33,99,209,31,16,7,48,48,93,51,24,7,61,117,146,52,19,3,27,66,91,19,7,0,34,51,55,33,12,3,893,512,381,493,279,214,125,250,303,143,43,25,55,129,203,84,23,10,70,121,100,59,20,15,96,152,159,57,17,4,47,85,100,33,7,1,49,67,59,24,10,3,795,416,379,505,253,252,169,214,292,105,21,-8,103,80,176,59,6,-12,66,134,116,46,15,4,97,135,166,71,28,3,47,63,92,39,10,0,50,72,74,32,18,3,652,339,313,544,268,276,115,146,245,87,14,41,54,93,117,54,1,16,61,53,128,33,13,25,113,151,149,96,18,8,50,78,75,48,6,4,63,73,74,48,12,4,390,204,186,395,205,190,61,135,126,33,26,13,32,67,92,1,9,2,29,68,34,32,17,11,79,128,102,55,17,4,44,62,60,25,6,2,35,66,42,30,11,2,36,1,35,197,94,103,-27,56,58,-63,-5,12,-19,19,25,-38,6,3,-8,37,33,-25,-11,9,26,59,70,32,5,4,16,25,34,14,2,2,10,34,36,18,3,2,4,-59,63,113,34,79,6,32,-10,-6,-5,-23,-2,-7,-15,-29,-6,-6,8,39,5,23,1,-17,0,46,39,21,4,0,-7,15,16,9,-1,0,7,31,23,12,5,0,-41,-19,-22,130,53,77,-36,51,-24,-53,8,10,-15,53,-36,-19,6,-1,-21,-2,12,-34,2,11,35,41,27,14,3,4,20,17,2,10,0,2,15,24,25,4,3,2,-242,-149,-93,24,6,18,-55,-14,-54,-43,-45,-29,-27,-13,-35,-40,-16,-13,-28,-1,-19,-3,-29,-16,0,17,15,-4,1,-7,2,8,5,-6,-1,-3,-2,9,10,2,2,-4,-116,-64,-52,19,3,16,14,-33,-50,-20,-3,-18,10,-11,-24,-12,-14,-8,4,-22,-26,-8,11,-10,1,10,2,9,0,-3,-3,4,3,3,-2,-2,4,6,-1,6,2,-1,-124,-71,-53,47,12,35,-56,19,-9,-74,-12,4,-40,10,-16,-30,-1,5,-16,9,7,-44,-11,-1,-3,26,18,-1,7,-1,-5,12,5,-1,3,-2,2,14,13,0,4,1,-138,-72,-66,111,43,68,-8,20,-58,-40,-22,-23,20,12,-22,-46,-16,-15,-28,8,-36,6,-6,-8,41,19,20,21,3,5,21,9,6,6,0,1,20,10,14,15,3,4,118,69,49,143,79,64,17,41,45,33,-15,-11,9,12,36,26,-12,-4,8,29,9,7,-3,-7,15,34,47,32,9,3,12,14,30,17,2,1,3,20,17,15,7,2,243,100,143,185,106,79,50,54,25,59,21,16,27,19,10,8,13,8,23,35,15,51,8,8,19,30,67,41,17,6,13,19,41,22,7,2,6,11,26,19,10,4
30,30902,"Alcázares, Los",6877,201,92,109,7,4,3,36,-7,35,32,56,55,20,-1,0,14,33,25,16,-6,35,18,23,30,2,2,1,2,0,0,1,2,0,1,0,0,1,0,1,1,0,0,162,85,77,25,18,7,20,38,36,18,43,8,21,26,8,-2,24,6,-1,12,28,20,19,2,6,6,3,2,3,2,6,4,2,2,1,1,0,2,1,0,2,1,426,200,226,9,5,4,158,54,58,85,49,19,85,20,12,41,32,11,73,34,46,44,17,8,1,-1,0,1,4,2,0,0,0,1,2,1,1,-1,0,0,2,1,164,40,124,4,2,2,8,35,26,-5,61,32,-2,11,-6,-5,23,17,10,24,32,0,38,15,0,0,1,1,2,0,0,0,1,0,1,0,0,0,0,1,1,0,752,450,302,573,329,244,93,77,236,136,180,32,71,47,136,90,87,19,22,30,100,46,93,13,68,94,126,100,144,39,40,55,78,60,72,23,28,39,48,40,72,16,1402,918,484,1022,626,396,185,280,412,230,231,61,111,191,306,135,135,38,74,89,106,95,96,23,145,197,281,182,163,48,75,124,194,112,91,27,70,73,87,70,72,21,851,489,362,689,377,312,103,148,273,146,154,30,37,83,162,88,97,24,66,65,111,58,57,6,113,110,162,120,145,36,47,55,94,70,86,23,66,55,68,50,59,13,608,291,317,657,356,301,53,145,197,52,127,21,41,56,94,37,53,7,12,89,103,15,74,14,123,139,160,99,105,25,65,76,91,52,54,16,58,63,69,47,51,9,347,172,175,439,244,195,24,84,92,56,78,2,12,45,47,23,38,9,12,39,45,33,40,-7,86,99,110,58,68,15,44,58,62,34,33,11,42,41,48,24,35,4,224,109,115,256,131,125,45,89,21,33,36,-2,32,45,15,13,10,-2,13,44,6,20,26,0,48,65,52,42,32,12,29,36,30,17,14,6,19,29,22,25,18,6,-105,-82,-23,-146,-109,-37,3,-4,-59,-79,19,19,5,-10,-34,-64,16,5,-2,6,-25,-15,3,14,-1,3,-72,-79,4,-3,4,2,-52,-62,-4,0,-5,1,-20,-17,8,-3,-188,-143,-45,2,-34,36,-93,11,-85,-66,27,12,-55,-13,-57,-39,15,4,-38,24,-28,-27,12,8,-7,11,-39,-8,24,17,-6,-4,-35,-7,6,9,-1,15,-4,-1,18,8,116,45,71,-39,-40,1,16,2,14,12,38,24,17,-2,-22,3,23,17,-1,4,36,9,15,7,-6,1,-37,-14,11,0,-4,-1,-38,-13,11,2,-2,2,1,-1,0,-2,171,86,85,41,1,40,11,40,38,7,55,9,23,6,5,13,34,2,-12,34,33,-6,21,7,1,13,17,-15,16,5,1,-4,5,-14,6,5,0,17,12,-1,10,0,259,113,146,182,92,90,18,24,77,18,61,64,8,5,44,0,33,25,10,19,33,18,28,39,26,22,35,26,50,23,16,8,17,16,25,11,10,14,18,10,25,12,16,4,12,56,15,41,-14,37,10,-45,14,11,-4,17,5,-18,-5,3,-10,20,5,-27,19,8,8,22,24,-33,13,16,6,3,12,-21,5,5,2,19,12,-12,8,11,-155,-117,-38,-165,-114,-51,-26,29,-52,-59,2,-45,-21,14,-38,-40,-7,-23,-5,15,-14,-19,9,-22,-24,23,-47,-69,-3,-48,-17,17,-32,-55,-5,-23,-7,6,-15,-14,2,-25,127,118,9,60,64,-4,11,75,54,45,27,-79,20,48,63,37,10,-57,-9,27,-9,8,17,-22,27,65,52,-5,-8,-70,11,53,53,-2,-2,-48,16,12,-1,-3,-6,-22
30,30007,Alguazas,7021,67,56,11,90,55,35,-4,32,24,22,-5,-4,12,22,16,6,1,-1,-16,10,8,16,-6,-3,11,25,28,21,4,0,9,14,17,12,3,0,2,11,11,9,1,0,99,58,41,100,59,41,17,30,30,11,5,5,9,19,19,8,2,2,8,11,11,3,3,3,24,26,33,10,6,1,12,17,21,5,3,1,12,9,12,5,3,0,109,56,53,74,43,31,23,34,31,8,8,-1,22,15,12,3,3,0,1,19,19,5,5,-1,17,28,18,9,2,0,13,15,11,4,0,0,4,13,7,5,2,0,147,66,81,49,26,23,21,18,79,10,10,-3,-2,2,46,12,4,-4,23,16,33,-2,6,1,8,14,19,5,2,1,4,6,12,3,0,1,4,8,7,2,2,0,174,146,28,104,74,30,10,65,72,17,6,5,17,44,58,13,12,1,-7,21,14,4,-6,4,11,38,31,12,9,3,7,28,24,4,9,2,4,10,7,8,0,1,388,263,125,170,103,67,100,80,141,61,0,-1,56,53,99,44,2,0,44,27,42,17,-2,-1,28,52,63,17,6,1,15,32,38,11,4,1,13,20,25,6,2,0,388,243,145,142,85,57,73,82,143,68,16,-1,42,48,92,46,11,0,31,34,51,22,5,-1,22,41,50,24,2,2,10,21,35,16,1,1,12,20,15,8,1,1,423,225,198,177,93,84,103,93,142,71,7,-4,38,58,78,41,5,-5,65,35,64,30,2,1,33,52,60,29,3,0,10,27,38,17,0,0,23,25,22,12,3,0,102,87,15,150,87,63,2,19,54,8,11,3,20,5,38,11,10,1,-18,14,16,-3,1,2,40,46,42,17,2,1,24,29,28,5,2,-1,16,17,14,12,0,2,23,4,19,37,14,23,-23,35,-10,11,13,3,-6,9,-5,1,4,2,-17,26,-5,10,9,1,-3,11,18,5,7,1,2,0,11,0,2,0,-5,11,7,5,5,1,-29,-6,-23,35,24,11,-15,-12,22,2,-6,-13,-10,-6,16,4,-7,0,-5,-6,6,-2,1,-13,-4,11,17,5,3,2,-3,7,12,6,1,1,-1,4,5,-1,2,1,83,75,8,55,39,16,48,8,11,19,-4,-3,31,15,15,17,1,-6,17,-7,-4,2,-5,3,11,19,11,10,2,2,9,13,8,7,1,1,2,6,3,3,1,1,30,23,7,30,20,10,26,5,16,-1,-7,-9,26,1,-1,3,-4,-2,0,4,17,-4,-3,-7,9,20,0,-2,0,1,6,14,0,-2,0,1,3,6,0,0,0,0,-183,-135,-48,-203,-142,-61,-8,-19,-84,-57,-19,-3,1,-15,-62,-44,-15,-1,-9,-4,-22,-13,-4,-2,-16,-11,-90,-66,-15,-8,-7,-6,-65,-52,-10,-3,-9,-5,-25,-14,-5,-5,-71,-34,-37,-2,-1,-1,-42,-14,3,-25,4,4,-14,-23,6,-7,6,-1,-28,9,-3,-18,-2,5,6,6,-3,-12,-1,1,12,2,-5,-7,-2,-1,-6,4,2,-5,1,2,-40,-13,-27,-53,-24,-29,14,-16,12,-24,-23,-1,15,-13,14,-14,-15,3,-1,-3,-2,-10,-8,-4,0,9,-9,-35,-13,-5,5,3,-2,-19,-8,-3,-5,6,-7,-16,-5,-2,-67,-51,-16,46,26,20,-5,-15,-23,-32,11,6,3,-13,-19,-18,-1,1,-8,-2,-4,-14,12,5,16,12,15,-4,4,2,16,6,4,-5,2,2,0,6,11,1,2,0,-25,-24,-1,58,43,15,12,4,6,-33,-14,1,-1,7,7,-28,-12,0,13,-3,-1,-5,-2,1,14,32,21,-6,1,-5,11,28,20,-13,-2,-2,3,4,1,7,3,-3
30,30008,Alhama de Murcia,15640,356,215,141,341,215,126,63,89,143,54,7,-2,31,51,93,32,2,4,32,38,50,22,5,-6,61,85,136,36,16,5,35,49,95,25,7,2,26,36,41,11,9,3,384,272,112,359,241,118,55,114,137,43,12,17,43,80,101,33,8,3,12,34,36,10,4,14,62,113,120,41,14,5,37,74,88,29,9,2,25,39,32,12,5,3,520,301,219,448,270,178,105,128,144,99,29,12,50,75,96,59,11,7,55,53,48,40,18,5,87,119,130,82,21,6,41,69,93,54,7,4,46,50,37,28,14,2,558,354,204,402,232,170,98,145,149,100,46,15,67,78,106,64,30,4,31,67,43,36,16,11,77,119,115,66,18,3,41,64,76,40,8,1,36,55,39,26,10,2,572,357,215,484,280,204,90,137,191,107,38,5,39,73,136,79,27,1,51,64,55,28,11,4,92,139,141,78,26,5,44,76,92,50,16,1,48,63,49,28,10,4,768,498,270,553,348,205,153,148,258,139,38,21,99,103,175,94,15,7,54,45,83,45,23,14,118,134,185,74,30,5,71,84,133,41,13,2,47,50,52,33,17,3,433,260,173,368,220,148,48,130,136,64,49,4,21,74,93,41,32,-3,27,56,43,23,17,7,75,97,111,54,27,3,39,54,75,31,19,1,36,43,36,23,8,2,369,189,180,408,206,202,49,161,94,33,28,1,43,83,39,12,9,2,6,78,55,21,19,-1,66,161,105,46,20,4,35,82,55,25,6,2,31,79,50,21,14,2,292,108,184,220,75,145,41,119,76,29,23,-1,7,62,36,-7,14,-6,34,57,40,36,9,5,49,90,51,16,8,0,20,48,13,-10,1,0,29,42,38,26,7,0,23,-46,69,-6,-44,38,19,23,-42,-21,28,13,0,-3,-42,-28,19,6,19,26,0,7,9,7,0,5,-20,-5,8,3,-5,-12,-29,-9,7,2,5,17,9,4,1,1,-341,-261,-80,-306,-244,-62,-41,-66,-170,-66,-9,1,-10,-37,-149,-69,-6,4,-31,-29,-21,3,-3,-3,-18,-48,-158,-72,-13,-2,0,-35,-137,-67,-10,1,-18,-13,-21,-5,-3,-3,41,-26,67,-57,-65,8,36,17,-22,-8,20,-4,14,-4,-44,5,7,-3,22,21,22,-13,13,-1,-3,4,-60,-8,7,1,-1,-7,-53,-5,-1,1,-2,11,-7,-3,8,0,216,90,126,117,49,68,30,41,65,44,32,1,4,19,19,23,19,4,26,22,46,21,13,-3,18,19,41,19,16,4,4,8,17,8,8,3,14,11,24,11,8,1,295,157,138,128,74,54,56,54,58,64,55,5,25,24,47,36,24,0,31,30,11,28,31,5,20,14,40,38,18,-1,13,5,29,22,7,-1,7,9,11,16,11,0,95,68,27,91,49,42,4,12,6,44,13,15,20,6,-6,31,6,10,-16,6,12,13,7,5,13,18,20,28,11,1,7,5,13,18,4,2,6,13,7,10,7,-1,207,113,94,118,68,50,38,42,54,30,27,15,14,24,30,25,14,5,24,18,24,5,13,10,16,26,29,30,15,2,9,11,18,17,11,2,7,15,11,13,4,0,97,56,41,72,35,37,13,20,29,7,21,4,4,10,11,14,13,2,9,10,18,-7,8,2,9,32,14,-4,13,6,3,16,6,1,5,2,6,16,8,-5,8,4,223,85,138,159,77,82,20,43,71,45,35,7,6,10,24,22,15,6,14,33,47,23,20,1,15,29,30,33,40,9,10,16,7,14,25,4,5,13,23,19,15,5
30,30009,Archena,14398,453,296,157,495,317,178,19,177,160,66,24,10,0,121,115,47,13,3,19,56,45,19,11,7,33,175,189,80,16,2,15,110,124,56,11,1,18,65,65,24,5,1,304,183,121,391,230,161,56,111,86,43,-10,7,23,83,45,27,-6,5,33,28,41,16,-4,2,69,134,126,53,3,2,29,94,70,33,1,1,40,40,56,20,2,1,359,221,138,308,183,125,84,128,67,56,10,2,45,77,45,37,2,5,39,51,22,19,8,-3,51,124,76,45,7,0,27,75,47,26,3,0,24,49,29,19,4,0,144,124,20,282,164,118,46,38,41,-2,20,4,21,34,45,13,11,1,25,4,-4,-15,9,3,59,84,82,43,10,1,29,47,52,30,5,0,30,37,30,13,5,1,363,220,143,296,192,104,23,104,118,82,1,24,26,53,71,55,6,2,-3,51,47,27,-5,22,40,86,104,60,6,-1,26,56,66,40,4,-2,14,30,38,20,2,1,422,223,199,346,208,138,60,119,98,65,21,53,25,55,53,49,16,24,35,64,45,16,5,29,49,123,101,60,9,2,23,70,61,44,8,2,26,53,40,16,1,0,947,579,368,802,501,301,117,287,341,113,3,71,73,155,231,83,3,26,44,132,110,30,0,45,97,274,273,131,15,5,52,159,187,87,10,2,45,115,86,44,5,3,583,342,241,562,357,205,39,259,151,79,11,34,23,153,101,53,3,6,16,106,50,26,8,28,69,268,144,71,10,-2,41,151,112,45,8,-1,28,117,32,26,2,-1,409,315,94,543,360,183,26,161,121,88,-1,11,12,119,121,58,2,1,14,42,0,30,-3,10,63,194,188,89,7,1,37,125,137,56,5,0,26,69,51,33,2,1,210,229,-19,288,198,90,-1,132,123,-31,3,-22,0,102,134,-5,3,-6,-1,30,-11,-26,0,-16,31,110,100,37,7,2,16,78,77,21,5,1,15,32,23,16,2,1,-253,-100,-153,15,3,12,-68,-6,-80,-82,-18,3,-29,9,-23,-46,-17,6,-39,-15,-57,-36,-1,-3,-6,38,18,-23,-13,0,-4,25,18,-23,-14,0,-2,13,0,0,1,0,-331,-254,-77,-414,-324,-90,5,-9,-193,-114,-19,-3,4,-20,-139,-78,-20,-1,1,11,-54,-36,1,-2,-9,-35,-188,-148,-30,-4,-6,-34,-144,-110,-30,0,-3,-1,-44,-38,0,-4,-310,-236,-74,-422,-314,-108,-67,4,-151,-72,-26,-5,-41,17,-114,-71,-23,-3,-26,-13,-37,-1,-3,-2,-48,-25,-182,-124,-49,1,-27,-13,-139,-100,-36,0,-21,-12,-43,-24,-13,1,145,123,22,75,68,7,5,52,53,12,9,16,4,37,46,21,4,10,1,15,7,-9,5,6,-1,19,46,8,1,1,4,12,37,15,-3,1,-5,7,9,-7,4,0,-100,-75,-25,-39,-38,-1,-7,-17,-59,-46,9,18,-6,1,-49,-22,-5,5,-1,-18,-10,-24,14,13,-5,13,-37,-14,4,-1,-7,6,-24,-12,0,-2,2,7,-13,-2,4,1,80,68,12,-10,-6,-4,16,51,-10,26,-10,0,3,25,14,23,-3,4,13,26,-24,3,-7,-4,4,23,-24,-10,-4,-2,2,14,-14,-8,-3,1,2,9,-10,-2,-1,-3,141,119,22,190,149,41,-1,69,23,20,5,25,-4,63,26,18,6,8,3,6,-3,2,-1,17,10,66,74,28,5,3,5,47,64,22,6,2,5,19,10,6,-1,1,274,161,113,204,114,90,60,113,35,35,14,19,32,80,16,10,8,11,28,33,19,25,6,8,27,90,55,18,9,3,9,66,27,5,3,2,18,24,28,13,6,1
30,30010,Beniel,7974,171,124,47,145,90,55,34,15,76,33,1,9,26,13,61,20,-2,4,8,2,15,13,3,5,12,31,58,38,5,1,3,16,43,24,3,1,9,15,15,14,2,0,373,221,152,327,205,122,44,109,122,74,16,6,20,66,78,45,8,3,24,43,44,29,8,3,43,89,110,70,12,1,17,57,75,46,8,0,26,32,35,24,4,1,213,148,65,236,143,93,29,62,77,27,9,4,24,33,63,23,2,2,5,29,14,4,7,2,33,64,85,42,7,-1,21,31,60,26,3,-1,12,33,25,16,4,0,281,144,137,259,159,100,52,82,69,56,11,6,7,42,56,32,4,2,45,40,13,24,7,4,60,62,82,43,7,2,32,38,62,21,4,0,28,24,20,22,3,2,282,213,69,226,157,69,19,94,102,51,10,3,13,75,88,30,6,1,6,19,14,21,4,2,22,76,76,40,5,5,12,58,55,25,4,1,10,18,21,15,1,4,350,250,100,280,196,84,15,144,146,32,9,1,4,103,110,33,1,-1,11,41,36,-1,8,2,35,106,91,32,8,4,22,76,69,23,4,1,13,30,22,9,4,3,355,227,128,226,141,85,74,103,128,51,7,-4,40,62,89,36,4,-3,34,41,39,15,3,-1,52,66,68,35,5,0,28,40,47,24,3,-1,24,26,21,11,2,1,189,57,132,113,28,85,65,81,45,-11,1,3,16,47,6,-24,6,5,49,34,39,13,-5,-2,33,63,17,-6,6,0,10,33,-1,-18,4,0,23,30,18,12,2,0,-22,-103,81,-103,-132,29,57,28,-27,-60,-27,-1,28,-7,-48,-57,-20,0,29,35,21,-3,-7,-1,23,32,-50,-80,-28,-3,8,2,-57,-67,-16,-1,15,30,7,-13,-12,-2,-143,-105,-38,-117,-115,-2,-17,4,-71,-52,-4,8,-3,-3,-51,-37,-8,3,-14,7,-20,-15,4,5,1,-2,-49,-61,-1,-1,-7,-11,-47,-43,-4,-1,8,9,-2,-18,3,0,-73,-33,-40,-66,-33,-33,-1,4,-22,-20,-8,-20,5,2,-16,-18,1,-7,-6,2,-6,-2,-9,-13,-4,2,-42,-9,-12,-1,5,0,-24,-8,-7,0,-9,2,-18,-1,-5,-1,110,66,44,59,25,34,30,23,30,18,7,5,21,1,30,11,3,3,9,22,0,7,4,2,13,9,27,8,3,-1,3,4,15,1,2,1,10,5,12,7,1,-2,-94,-60,-34,-63,-66,3,-33,-17,-7,-23,-14,3,-8,-17,-13,-14,-7,0,-25,0,6,-9,-7,3,-9,2,-26,-22,-11,3,-9,-5,-28,-17,-7,0,0,7,2,-5,-4,3,-83,-57,-26,-57,-38,-19,-9,-2,-31,-34,-12,9,-7,-3,-20,-19,-7,3,-2,1,-11,-15,-5,6,-6,0,-20,-29,-1,-1,-1,-4,-16,-14,-2,-1,-5,4,-4,-15,1,0,-111,-104,-7,-90,-81,-9,-27,3,-33,-46,-11,0,-29,6,-35,-39,-9,1,2,-3,2,-7,-2,-1,-16,5,-39,-28,-11,0,-11,2,-37,-23,-11,-1,-5,3,-2,-5,0,1,38,40,-2,36,19,17,22,24,-2,12,-21,-3,13,18,3,17,-10,-3,9,6,-5,-5,-11,0,19,11,9,8,-13,-1,12,9,2,6,-9,0,7,2,7,2,-4,-1,32,24,8,5,0,5,5,35,9,-12,-10,2,11,15,3,-5,-3,3,-6,20,6,-7,-7,-1,14,25,-3,-25,-6,0,7,16,-2,-18,-3,0,7,9,-1,-7,-3,0,-25,14,-39,48,49,-1,-24,14,22,-18,-12,-5,-16,15,28,-1,-10,-1,-8,-1,-6,-17,-2,-4,4,17,33,2,-9,0,7,11,30,6,-5,-1,-3,6,3,-4,-4,1
30,30011,Blanca,5706,31,18,13,47,24,23,21,7,1,4,-1,0,10,3,5,0,-1,1,11,4,-4,4,0,-1,10,16,12,9,0,0,3,10,8,3,0,0,7,6,4,6,0,0,16,7,9,47,26,21,6,6,8,3,1,-5,4,2,4,1,0,-2,2,4,4,2,1,-3,9,15,15,7,1,0,4,7,9,5,1,0,5,8,6,2,0,0,31,19,12,41,23,18,1,15,17,-4,0,1,0,3,15,-2,2,0,1,12,2,-2,-2,1,6,19,12,4,0,0,4,8,9,2,0,0,2,11,3,2,0,0,87,37,50,57,27,30,28,11,27,13,5,-1,16,3,9,6,1,1,12,8,18,7,4,-2,14,13,18,7,3,0,7,4,10,4,1,0,7,9,8,3,2,0,82,63,19,52,33,19,26,7,18,22,10,-2,18,4,22,12,4,2,8,3,-4,10,6,-4,12,7,12,11,8,2,9,3,11,6,3,1,3,4,1,5,5,1,17,15,2,60,38,22,-1,0,5,5,6,2,-2,-2,11,4,4,0,1,2,-6,1,2,2,16,18,14,9,2,1,9,11,13,3,2,0,7,7,1,6,0,1,65,47,18,59,32,27,6,10,26,11,9,-1,1,13,18,7,4,0,5,-3,8,4,5,-1,6,9,18,13,10,2,4,6,10,8,3,0,2,3,8,5,7,2,73,54,19,45,25,20,7,12,35,8,6,5,2,7,25,13,4,4,5,5,10,-5,2,1,6,12,17,5,3,0,4,6,9,4,2,0,2,6,8,1,1,0,121,52,69,71,31,40,29,42,17,16,15,-3,11,20,9,3,8,-2,18,22,8,13,7,-1,25,19,11,4,8,0,11,7,6,1,4,0,14,12,5,3,4,0,78,56,22,42,24,18,1,31,13,22,8,2,-2,24,14,13,5,1,3,7,-1,9,3,1,10,16,5,7,4,0,5,9,6,2,2,0,5,7,-1,5,2,0,44,29,15,31,17,14,11,16,10,0,2,3,5,8,12,1,2,0,6,8,-2,-1,0,3,2,7,15,1,3,1,1,1,11,1,1,1,1,6,4,0,2,0,-13,-14,1,-1,-3,2,-3,-2,-5,-10,1,4,-2,-2,-3,-10,0,3,-1,0,-2,0,1,1,0,0,-3,-2,2,1,-1,0,-1,-3,1,1,1,0,-2,1,1,0,-28,-22,-6,25,11,14,-1,-5,-25,3,-3,2,-2,-2,-17,1,-4,1,1,-3,-8,2,1,1,2,5,2,9,4,0,1,3,-3,6,2,0,1,2,5,3,2,0,16,3,13,12,8,4,9,4,-7,2,4,2,3,1,-6,0,2,3,6,3,-1,2,2,-1,2,1,2,1,5,1,2,0,2,0,3,1,0,1,0,1,2,0,24,21,3,-5,-5,0,10,3,12,4,1,-7,7,5,9,2,2,-5,3,-2,3,2,-1,-2,-1,3,-2,-3,-1,-1,0,0,-2,-2,0,-1,-1,3,0,-1,-1,0,3,-7,10,16,12,4,-6,3,20,-2,0,-11,-3,0,3,3,-3,-6,-3,3,17,-5,3,-5,4,8,11,-1,-1,-5,4,3,7,-1,-1,0,0,5,4,0,0,-5,-4,3,-7,-1,2,-3,4,-2,-5,-1,1,-3,0,2,-7,5,5,-3,4,-4,2,-6,-4,0,-2,8,2,-7,-1,-2,-1,2,2,-1,1,-1,-1,6,0,-6,-2,-1,46,34,12,25,19,6,-7,1,21,5,16,10,-2,1,15,8,6,6,-5,0,6,-3,10,4,-5,12,9,8,3,-2,-1,8,8,5,0,-1,-4,4,1,3,3,-1
30,30012,Bullas,10677,209,136,73,228,142,86,24,65,70,42,6,2,12,40,47,32,1,4,12,25,23,10,5,-2,24,54,90,52,4,4,12,31,62,33,2,2,12,23,28,19,2,2,112,52,60,151,72,79,41,17,36,13,3,0,28,4,12,10,1,-1,13,13,24,3,2,1,39,37,47,19,7,1,22,15,19,14,2,0,17,22,28,5,5,1,67,47,20,92,52,40,18,28,11,2,11,-4,14,13,12,2,7,-3,4,15,-1,0,4,-1,31,27,16,15,2,0,20,8,15,9,1,-2,11,19,1,6,1,2,131,78,53,104,59,45,21,46,22,23,19,1,17,21,18,13,11,-1,4,25,4,10,8,2,19,45,19,11,8,1,13,25,7,9,4,1,6,20,12,2,4,0,156,86,70,123,69,54,11,46,34,33,18,14,-1,29,20,18,11,9,12,17,14,15,7,5,12,36,34,23,11,7,6,23,18,12,5,5,6,13,16,11,6,2,189,114,75,109,58,51,34,42,57,24,23,1,17,16,43,20,11,2,17,26,14,4,12,-1,21,32,30,15,8,0,10,13,20,10,4,0,11,19,10,5,4,0,261,146,115,185,101,84,59,51,74,55,18,-1,28,34,43,31,6,1,31,17,31,24,12,-2,47,42,62,23,11,0,25,23,39,10,5,-1,22,19,23,13,6,1,287,154,133,253,136,117,60,89,76,29,16,9,25,37,50,20,9,8,35,52,26,9,7,1,53,78,75,33,9,1,27,40,46,15,6,0,26,38,29,18,3,1,67,36,31,105,39,66,20,39,-20,21,10,-5,11,18,-16,17,2,2,9,21,-4,4,8,-7,37,34,10,15,8,0,17,12,3,6,1,0,20,22,7,9,7,0,-105,-65,-40,-37,-25,-12,-34,-8,-54,-12,2,-4,-25,-1,-39,-10,5,2,-9,-7,-15,-2,-3,-6,-12,4,-23,-9,-1,1,-4,5,-19,-9,0,1,-8,-1,-4,0,-1,0,-75,-45,-30,16,3,13,-18,2,-24,-26,3,-13,-8,1,-11,-20,-3,-4,-10,1,-13,-6,6,-9,14,9,0,-7,1,-4,7,4,2,-8,0,-3,7,5,-2,1,1,-1,-29,-10,-19,0,-3,3,-2,-1,-13,-8,0,-6,-8,1,0,-6,4,-1,6,-2,-13,-2,-4,-5,4,1,-7,1,1,0,2,-1,-5,1,0,0,2,2,-2,0,1,0,35,11,24,19,4,15,21,12,-10,3,15,-5,7,7,-4,5,3,-7,14,5,-6,-2,12,2,16,7,-4,-2,0,2,6,2,-3,-1,-1,1,10,5,-1,-1,1,1,-201,-118,-83,-154,-79,-75,-49,-9,-65,-55,-31,4,-25,-1,-40,-42,-16,3,-24,-8,-25,-13,-15,1,-31,-18,-46,-44,-13,-2,-16,-9,-25,-26,-5,1,-15,-9,-21,-18,-8,-3,-293,-153,-140,-207,-114,-93,-64,-47,-94,-60,-23,-4,-34,-25,-47,-34,-14,0,-30,-22,-47,-26,-9,-4,-48,-23,-68,-45,-25,0,-25,-10,-38,-27,-17,1,-23,-13,-30,-18,-8,-1,-19,1,-20,-4,3,-7,2,-2,-26,-7,8,5,4,-2,-10,1,4,4,-2,0,-16,-8,4,1,6,-3,-9,0,1,-2,6,0,-6,2,1,-1,0,-3,-3,-2,0,-1,-139,-78,-61,-132,-75,-57,-24,-21,-54,-24,-11,-7,-13,-15,-30,-15,-7,-1,-11,-6,-24,-9,-4,-6,-35,-22,-31,-35,-7,-2,-19,-8,-20,-22,-5,-1,-16,-14,-11,-13,-2,-1,53,22,31,63,32,31,23,-1,0,25,9,-6,5,1,-8,14,9,-2,18,-2,8,11,0,-4,19,5,11,18,3,5,8,2,6,8,2,5,11,3,5,10,1,0
30,30013,Calasparra,8934,142,65,77,133,64,69,23,30,36,35,11,2,5,18,12,20,3,2,18,12,24,15,8,0,18,38,48,28,1,0,5,21,22,15,1,0,13,17,26,13,0,0,137,95,42,165,108,57,25,27,73,22,-2,-9,10,15,56,18,0,-4,15,12,17,4,-2,-5,34,43,59,27,1,0,14,27,45,20,1,0,20,16,14,7,0,0,141,77,64,140,73,67,32,55,18,12,15,8,6,31,20,7,10,5,26,24,-2,5,5,3,36,49,29,19,6,0,14,27,16,12,3,0,22,22,13,7,3,0,195,97,98,159,82,77,46,57,38,27,16,7,27,28,21,8,9,2,19,29,17,19,7,5,40,50,48,15,5,1,19,29,26,5,2,1,21,21,22,10,3,0,164,93,71,136,91,45,23,54,21,32,27,9,8,25,21,15,17,7,15,29,0,17,10,2,9,44,36,27,15,5,6,30,26,18,8,3,3,14,10,9,7,2,149,119,30,146,96,50,2,39,36,29,38,6,2,37,35,22,20,5,0,2,1,7,18,1,13,37,46,26,21,3,3,29,33,16,13,2,10,8,13,10,8,1,398,224,174,308,181,127,57,45,88,88,110,5,35,26,49,47,58,8,22,19,39,41,52,-3,34,57,61,52,89,15,20,35,38,33,46,9,14,22,23,19,43,6,288,171,117,320,175,145,20,57,46,45,85,29,16,31,37,30,39,14,4,26,9,15,46,15,52,48,59,56,75,26,31,28,32,31,39,11,21,20,27,25,36,15,206,74,132,147,70,77,51,22,29,35,44,19,5,11,8,11,19,15,46,11,21,24,25,4,21,19,36,20,41,10,6,9,23,7,17,8,15,10,13,13,24,2,112,51,61,48,19,29,20,19,24,15,43,-7,13,-1,21,6,19,-5,7,20,3,9,24,-2,1,6,5,3,34,-1,0,0,3,-1,19,-2,1,6,2,4,15,1,-185,-99,-86,-85,-52,-33,-36,-17,-70,-47,-16,-5,-6,-15,-41,-31,-9,-1,-30,-2,-29,-16,-7,-4,-7,-6,-19,-33,-11,-9,2,-5,-11,-24,-10,-4,-9,-1,-8,-9,-1,-5,-42,-21,-21,-22,-14,-8,-9,-5,-33,-4,2,10,-5,1,-21,-1,3,4,-4,-6,-12,-3,-1,6,-8,0,-15,-3,7,-2,-3,2,-13,-2,4,-1,-5,-2,-2,-1,3,-1,-78,-39,-39,-22,-16,-6,-22,11,-48,-3,-6,-11,-4,3,-28,-5,-4,-4,-18,8,-20,2,-2,-7,-8,7,-18,10,-5,-6,-2,2,-10,4,-6,-4,-6,5,-8,6,1,-2,-32,2,-34,19,8,11,6,19,-41,-7,11,-20,7,9,-16,-2,8,-5,-1,10,-25,-5,3,-15,7,9,-15,2,10,5,5,3,-10,0,6,3,2,6,-5,2,4,2,-58,-35,-23,-30,-23,-7,10,-16,-16,-9,-17,-11,2,-8,-11,-8,-7,-3,8,-8,-5,-1,-10,-8,5,-2,-8,-13,-6,-6,2,-2,-4,-13,-4,-2,3,0,-4,0,-2,-4,-142,-44,-98,-85,-41,-44,-39,-10,-37,-36,-16,-4,-18,-2,-8,-11,-6,1,-21,-8,-29,-25,-10,-5,-11,2,-15,-20,-26,-15,-7,3,-7,-14,-10,-6,-4,-1,-8,-6,-16,-9,11,-20,31,-7,-15,8,27,7,-10,6,-9,-11,11,-4,-3,-3,-9,-9,16,11,-7,9,0,-2,5,4,2,-6,-7,-10,0,-1,0,-9,-2,-5,5,5,2,3,-5,-5,-39,-7,-32,-32,-26,-6,17,-12,-7,-27,-1,-8,20,1,-3,-20,0,-4,-3,-13,-4,-7,-1,-4,2,10,9,-27,-14,-13,1,6,2,-18,-10,-7,1,4,7,-9,-4,-6
30,30014,Campos del Río,2005,1,7,-6,27,20,7,-6,3,9,-4,2,-3,-3,5,7,-2,1,-1,-3,-2,2,-2,1,-2,4,9,7,4,3,0,3,8,5,3,1,0,1,1,2,1,2,0,16,7,9,27,12,15,13,-4,2,5,-1,0,4,1,-1,3,-1,0,9,-5,3,2,0,0,10,7,5,3,1,0,5,3,2,1,0,0,5,4,3,2,1,0,2,-4,6,27,9,18,-2,-1,6,-4,1,3,-6,1,1,0,1,0,4,-2,5,-4,0,3,8,4,7,4,2,2,2,1,2,2,1,1,6,3,5,2,1,1,-7,0,-7,33,17,16,-9,13,-22,1,4,7,-4,7,-10,2,3,2,-5,6,-12,-1,1,5,8,7,7,3,5,3,4,4,3,2,3,1,4,3,4,1,2,2,-1,-1,0,16,11,5,0,-4,2,0,3,-2,1,-6,4,-2,2,-2,-1,2,-2,2,1,0,0,3,9,2,2,0,0,1,8,1,1,0,0,2,1,1,1,0,55,26,29,27,12,15,7,10,13,7,16,1,6,7,1,2,9,0,1,3,12,5,7,1,3,5,4,4,10,1,2,3,1,1,4,1,1,2,3,3,6,0,57,19,38,38,16,22,9,8,1,20,17,3,3,1,-1,9,7,1,6,7,2,11,10,2,8,7,4,9,9,1,2,4,1,5,4,0,6,3,3,4,5,1,30,21,9,33,17,16,16,-1,4,8,6,-2,9,3,3,2,3,1,7,-4,1,6,3,-3,11,2,8,3,9,0,5,3,3,1,5,0,6,-1,5,2,4,0,-5,3,-8,10,2,8,-1,-6,-4,-5,13,-3,-2,2,1,-5,7,-1,1,-8,-5,0,6,-2,1,2,1,2,0,3,-1,1,0,0,0,2,2,1,1,2,0,1,-18,-9,-9,6,2,4,-12,6,-6,-1,-6,1,-9,0,-2,3,-3,2,-3,6,-4,-4,-3,-1,0,1,1,1,2,1,0,0,1,0,0,1,0,1,0,1,2,0,57,26,31,12,5,7,0,12,6,14,18,5,0,3,4,9,8,1,0,9,2,5,10,4,0,2,2,1,6,1,0,1,1,0,3,0,0,1,1,1,3,1,-21,-4,-17,0,2,-2,-10,0,-5,0,-4,-1,-6,5,-1,1,-2,-2,-4,-5,-4,-1,-2,1,0,2,-2,-1,1,0,0,2,0,-1,1,0,0,0,-2,0,0,0,-35,-20,-15,5,2,3,-4,-7,-8,-15,3,-2,-3,-2,-5,-9,1,0,-1,-5,-3,-6,2,-2,0,1,1,1,2,0,0,1,0,0,1,0,0,0,1,1,1,0,-56,-23,-33,5,3,2,-11,-3,-21,-15,0,-4,-9,1,-10,-1,-1,-1,-2,-4,-11,-14,1,-3,2,0,-1,1,2,1,1,0,0,0,1,1,1,0,-1,1,1,0,-10,-4,-6,5,3,2,-5,2,-10,4,-1,-1,-3,5,-6,-1,1,-1,-2,-3,-4,5,-2,0,0,0,0,0,3,1,0,0,0,0,2,0,0,0,0,0,1,1,-46,-22,-24,4,2,2,-13,-8,-11,-12,1,-3,-9,-3,0,-8,0,-1,-4,-5,-11,-4,1,-2,0,1,0,0,3,0,0,1,0,0,1,0,0,0,0,0,2,0,-1,-6,5,6,2,4,3,-9,6,0,-8,6,2,-6,2,-1,-3,0,1,-3,4,1,-5,6,2,2,2,1,-1,0,1,1,1,-1,0,0,1,1,1,2,-1,0,29,20,9,4,3,1,4,-2,2,-3,0,29,1,4,1,0,4,10,3,-6,1,-3,-4,19,0,0,1,1,2,0,0,0,0,2,1,0,0,0,1,-1,1,0
30,30015,Caravaca de la Cruz,22269,483,291,192,405,248,157,47,144,184,66,17,25,35,84,98,47,13,13,12,60,86,19,4,12,32,133,157,73,7,2,20,80,95,48,4,1,12,53,62,25,3,1,421,235,186,418,243,175,54,160,127,41,11,28,21,92,78,23,5,15,33,68,49,18,6,13,51,167,142,49,5,3,24,95,91,29,1,3,27,72,51,20,4,0,384,217,167,404,218,186,110,109,89,43,28,3,56,53,52,28,13,13,54,56,37,15,15,-10,95,119,121,56,10,2,43,65,71,34,5,0,52,54,50,22,5,2,413,228,185,345,196,149,100,112,96,61,33,11,60,65,52,26,18,8,40,47,44,35,15,3,74,102,107,40,17,5,40,61,64,21,8,2,34,41,43,19,9,3,324,201,123,373,215,158,25,70,77,69,39,41,6,41,55,54,16,30,19,29,22,15,23,11,47,109,107,73,31,5,25,63,63,46,14,4,22,46,44,27,17,1,435,235,200,403,217,186,115,104,88,67,46,10,61,49,51,33,35,1,54,55,37,34,11,9,80,114,111,60,29,1,44,51,66,34,16,1,36,63,45,26,13,0,642,356,286,663,363,300,102,174,186,125,52,-1,50,88,108,71,32,4,52,86,78,54,20,-5,105,210,215,93,31,4,51,109,125,52,19,3,54,101,90,41,12,1,474,301,173,642,386,256,78,126,99,123,29,15,52,82,71,66,16,11,26,44,28,57,13,4,120,159,203,119,32,4,72,99,124,70,17,2,48,60,79,49,15,2,105,34,71,156,65,91,29,37,-28,12,26,30,6,32,-31,0,15,15,23,5,3,12,11,15,48,47,34,21,5,-1,20,31,10,0,3,0,28,16,24,21,2,-1,33,-8,41,63,23,40,17,-6,-3,-8,9,24,-4,-4,2,-4,-2,6,21,-2,-5,-4,11,18,0,23,12,14,12,0,-6,15,9,3,2,0,6,8,3,11,10,0,-7,-6,-1,-28,-33,5,20,23,-63,-17,24,9,20,15,-49,-10,19,0,0,8,-14,-7,5,9,5,23,-41,-15,-1,1,2,7,-25,-19,2,0,3,16,-16,4,-3,1,-14,-7,-7,-20,-15,-5,19,-14,-44,16,-2,11,18,-11,-39,15,1,8,1,-3,-5,1,-3,3,19,2,-31,-21,10,0,16,-4,-20,-12,4,1,3,6,-11,-9,6,-1,-125,-99,-26,-148,-115,-33,-4,-8,-54,-60,-19,14,-5,-8,-32,-46,-14,4,1,0,-22,-14,-5,10,-20,2,-55,-62,-16,-1,-16,-2,-40,-47,-13,0,-4,4,-15,-15,-3,-1,77,32,45,34,11,23,35,10,16,-9,20,2,11,-2,6,-6,19,1,24,12,10,-3,1,1,11,12,8,-4,4,1,-1,6,3,0,1,1,12,6,5,-4,3,0,56,23,33,80,45,35,14,20,-49,3,33,40,7,10,-26,-7,15,23,7,10,-23,10,18,17,21,18,16,12,7,4,14,11,5,9,1,3,7,7,11,3,6,1,-110,-55,-55,-63,-33,-30,-14,-20,-50,-41,-3,21,-4,-10,-18,-21,-10,10,-10,-10,-32,-20,7,11,-3,11,-36,-29,-4,-3,6,7,-20,-17,-7,-2,-9,4,-16,-12,3,-1,86,39,47,87,41,46,0,10,7,12,33,21,-6,-2,5,13,18,9,6,12,2,-1,15,12,17,25,14,8,16,4,7,9,13,2,8,1,10,16,1,6,8,3,186,99,87,160,84,76,53,30,33,30,31,1,25,15,16,23,12,4,28,15,17,7,19,-3,35,43,40,33,5,2,17,20,27,14,4,1,18,23,13,19,1,1
30,30016,Cartagena,177709,912,618,294,1175,688,487,157,242,245,248,33,-47,59,202,163,161,18,-9,98,40,82,87,15,-38,168,342,384,206,48,14,90,204,237,118,21,10,78,138,147,88,27,4,2172,1301,871,2632,1604,1028,427,564,711,336,68,34,215,373,461,185,31,17,212,191,250,151,37,17,454,722,876,401,109,32,236,470,567,229,59,20,218,252,309,172,50,12,3125,1935,1190,3611,2142,1469,759,750,858,587,99,22,436,448,574,384,46,14,323,302,284,203,53,8,799,905,1105,529,164,64,436,526,703,339,84,27,363,379,402,190,80,37,3674,2165,1509,3801,2260,1541,739,921,1103,608,227,29,354,570,678,388,117,37,385,351,425,220,110,-8,734,977,1146,535,286,86,373,600,751,320,144,51,361,377,395,215,142,35,4461,3107,1354,4352,2938,1414,514,1191,1584,723,383,43,294,864,1180,521,204,42,220,327,404,202,179,1,533,1203,1462,661,355,100,284,857,1117,432,178,53,249,346,345,229,177,47,4118,2679,1439,4184,2709,1475,567,907,1153,823,471,150,325,630,804,557,243,98,242,277,349,266,228,52,609,1001,1308,654,441,137,328,656,960,431,236,77,281,345,348,223,205,60,2707,1541,1166,3784,2234,1550,431,677,736,441,357,73,263,362,433,251,185,48,168,315,303,190,172,25,539,893,1190,608,419,115,296,514,785,351,214,64,243,379,405,257,205,51,1852,833,1019,3082,1700,1382,411,714,244,240,256,-14,194,443,11,42,122,18,217,271,233,198,134,-32,518,889,847,426,320,69,269,514,507,199,156,47,249,375,340,227,164,22,338,-129,467,1024,293,731,414,353,-358,-126,5,42,245,244,-440,-192,-19,29,169,109,82,66,24,13,358,506,56,-57,85,55,206,304,-139,-142,19,35,152,202,195,85,66,20,1020,624,396,1617,799,818,326,319,107,223,61,-23,201,239,5,145,18,15,125,80,102,78,43,-38,372,425,378,251,129,49,220,195,176,116,57,29,152,230,202,135,72,20,50,-133,183,238,-55,293,123,6,-151,-32,94,-10,44,-5,-173,-41,22,11,79,11,22,9,72,-21,53,160,-85,-88,105,75,18,71,-129,-97,26,43,35,89,44,9,79,32,-995,-686,-309,-548,-552,4,-85,-164,-569,-236,6,19,2,-151,-388,-178,-3,19,-87,-13,-181,-58,9,0,-27,-63,-373,-189,54,30,1,-93,-351,-155,9,26,-28,30,-22,-34,45,4,-412,-392,-20,-35,-168,133,-1,-9,-307,-112,2,15,6,-67,-246,-100,-1,17,-7,58,-61,-12,3,-2,-1,81,-92,-121,36,43,2,-18,-102,-116,20,31,-3,99,10,-5,16,12,-293,-213,-80,102,-52,154,5,-30,-218,-151,36,55,51,-26,-181,-108,15,31,-46,-4,-37,-43,21,24,75,52,-84,-31,42,25,35,-2,-96,-25,20,8,40,54,12,-6,22,17,-1110,-762,-348,-669,-465,-204,5,-143,-417,-287,-132,-150,4,-81,-353,-197,-58,-72,1,-62,-64,-90,-74,-78,5,-28,-221,-188,-104,-139,-12,-14,-192,-132,-38,-78,17,-14,-29,-56,-66,-61,-2427,-1478,-949,-1890,-1137,-753,-176,-189,-570,-595,-433,-470,-83,-121,-349,-397,-261,-275,-93,-68,-221,-198,-172,-195,-127,-72,-331,-514,-411,-448,-68,-60,-212,-302,-246,-255,-59,-12,-119,-212,-165,-193,-1277,-755,-522,-806,-485,-321,51,-60,-235,-433,-261,-345,35,-8,-152,-307,-150,-186,16,-52,-83,-126,-111,-159,84,51,-74,-276,-242,-365,44,15,-36,-184,-134,-202,40,36,-38,-92,-108,-163,-411,-305,-106,67,-46,113,30,139,7,-355,-153,-106,26,102,2,-266,-122,-72,4,37,5,-89,-31,-34,110,224,157,-231,-100,-118,82,125,97,-202,-96,-64,28,99,60,-29,-4,-54
30,30017,Cehegín,14077,69,32,37,67,38,29,14,21,16,18,6,-6,10,6,6,5,8,-3,4,15,10,13,-2,-3,3,27,21,13,3,0,1,14,14,6,3,0,2,13,7,7,0,0,112,64,48,154,80,74,27,42,4,28,14,-2,12,29,-2,21,5,-1,15,13,6,7,9,-1,31,45,45,31,1,1,14,28,20,18,0,0,17,17,25,13,1,1,215,99,116,228,117,111,60,44,33,57,21,-6,19,16,17,31,12,1,41,28,16,26,9,-7,52,56,62,48,5,1,22,24,41,24,2,1,30,32,21,24,3,0,153,73,80,188,87,101,37,23,23,40,17,12,12,2,23,21,11,4,25,21,0,19,6,8,45,45,48,38,5,6,17,19,27,19,3,2,28,26,21,19,2,4,340,216,124,264,150,114,67,40,77,72,64,19,42,32,53,40,39,11,25,8,24,32,25,8,53,36,71,52,43,9,31,20,40,30,26,3,22,16,31,22,17,6,272,140,132,271,151,120,70,34,32,67,58,7,38,15,20,30,26,8,32,19,12,37,32,-1,64,35,47,72,43,9,37,18,28,41,22,5,27,17,19,31,21,4,306,181,125,267,157,110,71,51,41,51,68,24,34,27,40,33,36,14,37,24,1,18,32,10,71,44,59,45,40,6,39,25,37,30,21,5,32,19,22,15,19,1,375,242,133,409,239,170,73,80,72,107,49,-7,40,49,49,80,26,-2,33,31,23,27,23,-5,64,95,104,105,30,9,27,50,66,76,14,5,37,45,38,29,16,4,37,33,4,105,56,49,26,-11,-11,24,17,-6,17,-4,-3,13,11,0,9,-7,-8,11,6,-6,28,13,22,23,13,4,20,4,13,10,7,2,8,9,9,13,6,2,91,46,45,79,42,37,29,17,27,-3,14,3,12,4,20,1,3,3,17,13,7,-4,11,0,35,12,19,9,4,-3,16,9,6,8,2,-1,19,3,13,1,2,-2,22,29,-7,89,36,53,11,14,-43,19,15,1,12,8,-13,14,9,-2,-1,6,-30,5,6,3,15,22,16,11,22,1,5,7,13,2,9,0,10,15,3,9,13,1,-15,3,-18,87,58,29,-4,-4,-25,12,5,0,0,0,-10,13,1,0,-4,-4,-15,-1,4,0,15,11,18,35,5,0,13,3,11,27,2,1,2,8,7,8,3,-1,46,34,12,37,24,13,-8,6,15,10,14,0,-4,10,6,10,9,0,-4,-4,9,0,5,0,0,10,10,12,4,-1,-2,8,5,12,2,-1,2,2,5,0,2,0,-49,-28,-21,13,-6,19,-3,12,-40,4,-4,-16,5,4,-22,-4,-2,-9,-8,8,-18,8,-2,-7,10,4,-1,-2,2,0,6,-4,-1,-6,-1,0,4,8,0,4,3,0,-5,-2,-3,50,27,23,13,-10,-19,-7,15,-1,6,-3,-14,-6,7,4,7,-7,-5,-1,8,-5,7,9,9,7,13,2,4,4,7,2,6,1,3,5,2,5,7,1,-502,-318,-184,-434,-289,-145,-49,-63,-123,-139,-87,-43,-24,-31,-74,-107,-65,-19,-25,-32,-49,-32,-22,-24,-47,-39,-96,-141,-89,-23,-21,-20,-65,-110,-62,-11,-26,-19,-31,-31,-27,-12,86,65,21,131,72,59,40,27,-24,25,20,1,23,22,-9,10,13,6,17,5,-15,15,7,-5,28,23,24,19,24,8,15,16,9,10,13,5,13,7,15,9,11,3,-27,-11,-16,128,70,58,-2,-2,-16,-24,11,0,-4,-2,-1,-12,4,1,2,0,-15,-12,7,-1,25,21,33,7,26,9,13,13,21,3,11,4,12,8,12,4,15,5
30,30018,Ceutí,7153,252,139,113,152,84,68,36,57,94,39,14,4,15,30,52,27,12,0,21,27,42,12,2,4,23,39,62,24,3,0,8,21,35,17,3,0,15,18,27,7,0,0,129,69,60,106,56,50,22,60,11,22,7,6,12,23,18,8,6,2,10,37,-7,14,1,4,15,46,28,14,1,0,7,26,14,7,1,0,8,20,14,7,0,0,205,120,85,129,77,52,54,51,55,20,14,11,42,23,33,10,8,2,12,28,22,10,6,9,41,27,37,17,7,-1,29,12,25,8,3,-1,12,15,12,9,4,0,170,93,77,119,70,49,30,44,63,15,13,2,22,17,37,5,7,3,8,27,26,10,6,-1,27,36,41,9,4,0,15,21,27,3,1,0,12,15,14,6,3,0,268,162,106,99,70,29,28,88,103,35,14,-1,16,54,63,21,9,-1,12,34,40,14,5,0,9,40,34,12,2,2,5,31,25,7,1,1,4,9,9,5,1,1,186,102,84,85,42,43,45,31,76,29,7,-3,16,12,55,16,2,0,29,19,21,13,5,-3,17,21,34,6,5,0,7,8,24,3,-1,0,10,13,10,3,6,0,360,189,171,70,38,32,46,70,97,30,22,86,25,41,62,12,16,24,21,29,35,18,6,62,11,25,22,8,3,1,4,15,14,3,2,0,7,10,8,5,1,1,533,289,244,97,65,32,98,117,194,47,17,50,58,54,114,34,8,15,40,63,80,13,9,35,18,28,37,12,2,-1,9,18,27,7,3,0,9,10,10,5,-1,-1,306,154,152,59,25,34,64,54,112,33,16,23,36,26,52,18,13,7,28,28,60,15,3,16,31,19,4,6,-2,0,16,7,-4,3,1,0,15,12,8,3,-3,0,243,113,130,51,25,26,27,53,76,25,8,50,16,23,42,9,0,20,11,30,34,16,8,30,8,13,14,8,3,4,6,8,9,0,0,1,2,5,5,8,3,3,228,97,131,-8,-23,15,34,38,92,16,22,23,7,21,33,16,11,8,27,17,59,0,11,15,7,-1,-20,1,1,3,3,-3,-20,-4,-1,2,4,2,0,5,2,1,79,21,58,-43,-30,-13,8,17,41,-7,4,18,-5,4,27,-5,-2,3,13,13,14,-2,6,15,-4,3,-21,-18,-4,1,-5,-2,-8,-11,-5,1,1,5,-13,-7,1,0,13,17,-4,-51,-32,-19,-31,12,1,-19,19,30,-6,4,7,-10,12,11,-25,8,-6,-9,7,19,-9,-7,-25,-9,-1,1,-1,-7,-16,-6,-1,0,-8,0,-9,-3,0,1,62,50,12,-16,-15,-1,-1,24,21,-9,7,18,3,9,25,-2,4,7,-4,15,-4,-7,3,11,-3,0,-3,-9,-1,0,-5,-1,-3,-5,-1,0,2,1,0,-4,0,0,106,57,49,16,6,10,-2,10,38,16,27,15,-9,6,22,8,22,6,7,4,16,8,5,9,7,1,1,-2,5,2,3,0,-3,1,2,1,4,1,4,-3,3,1,87,20,67,34,17,17,14,34,28,-13,6,23,-2,11,9,-9,5,11,16,23,19,-4,1,12,9,9,7,6,2,0,3,4,4,4,1,1,6,5,3,2,1,-1,162,68,94,68,36,32,21,29,54,21,14,20,9,3,24,13,10,10,12,26,30,8,4,10,12,7,19,22,9,-1,6,3,7,15,6,-1,6,4,12,7,3,0,96,68,28,63,42,21,9,40,17,21,-1,13,17,26,4,23,1,-1,-8,14,13,-2,-2,14,12,25,13,12,-1,0,8,17,8,8,0,0,4,8,5,4,-1,0
30,30019,Cieza,31725,6,9,-3,13,8,5,4,-4,1,0,2,-1,4,-7,-2,7,3,3,0,3,3,-7,-1,-4,3,0,1,3,3,3,2,0,1,2,2,1,1,0,0,1,1,2,-131,-79,-52,5,3,2,-12,-29,-69,-28,7,0,-10,-18,-39,-15,2,-1,-2,-11,-30,-13,5,1,1,0,0,1,1,1,1,0,0,0,0,1,0,0,0,1,1,0,-214,-133,-81,-4,-2,-2,-35,-48,-73,-37,1,-18,-20,-31,-43,-27,0,-8,-15,-17,-30,-10,1,-10,0,-1,0,-2,-3,2,0,-1,0,-2,-1,2,0,0,0,0,-2,0,-184,-100,-84,-67,-41,-26,-44,-31,-91,-31,9,2,-23,-21,-39,-26,4,5,-21,-10,-52,-5,5,-3,-12,-12,-25,-15,-2,0,-5,-7,-17,-12,0,1,-7,-5,-8,-3,-2,-1,177,144,33,299,218,81,-4,83,46,28,17,11,-19,71,52,25,13,1,15,12,-6,3,4,10,31,105,113,39,4,7,16,76,90,30,3,3,15,29,23,9,1,4,216,177,39,323,212,111,20,93,68,46,-10,0,2,81,63,36,-7,3,18,12,5,10,-3,-3,39,113,124,36,6,2,19,80,85,23,2,1,20,33,39,13,4,1,252,136,116,338,172,166,44,114,61,24,20,-6,27,72,20,16,4,-1,17,42,41,8,16,-5,66,106,97,44,21,2,35,62,43,21,9,2,31,44,54,23,12,0,6,-43,49,231,78,153,73,30,-66,-16,-6,-5,31,-4,-48,-24,4,-3,42,34,-18,8,-10,-2,83,75,43,23,6,0,38,25,11,-3,5,1,45,50,32,26,1,-1,18,54,-36,174,100,74,-22,55,-12,12,0,-15,-7,41,30,-1,2,-12,-15,14,-42,13,-2,-3,28,78,42,18,6,0,24,43,20,7,4,0,4,35,22,11,2,0,77,50,27,46,16,30,45,43,-42,16,7,3,28,27,-17,7,3,0,17,16,-25,9,4,3,26,42,-20,-4,3,-3,14,27,-21,-5,1,-1,12,15,1,1,2,-2,-63,-56,-7,6,-33,39,17,-4,-51,-3,-9,-1,6,-19,-27,-1,-8,1,11,15,-24,-2,-1,-2,19,8,-11,3,-10,-1,10,-12,-14,-6,-10,0,9,20,3,9,0,-1,-101,-51,-50,-30,-35,5,-14,-4,-12,-57,-16,-6,-5,-18,-5,-21,-11,3,-9,14,-7,-36,-5,-9,-6,20,-19,-23,-8,2,-3,1,-14,-16,-6,0,-3,19,-5,-7,-2,2,-188,-83,-105,-114,-80,-34,-40,-43,-70,-27,-19,3,-22,-22,-16,-15,-16,2,-18,-21,-54,-12,-3,1,-18,-4,-22,-45,-23,-3,-9,-8,-14,-36,-13,-1,-9,4,-8,-9,-10,-2,-234,-117,-117,-109,-82,-27,-51,-34,-69,-48,-23,-7,-12,-13,-52,-24,-12,-2,-39,-21,-17,-24,-11,-5,-26,0,-32,-38,-13,-2,-9,-2,-33,-30,-9,0,-17,2,1,-8,-4,-2,-60,-7,-53,-65,-22,-43,21,-38,-43,2,-11,9,3,-13,-14,15,1,2,18,-25,-29,-13,-12,7,11,-5,-33,-25,-13,0,8,-1,-13,-12,-4,0,3,-4,-20,-13,-9,0,-28,1,-29,-18,-23,5,-3,28,-27,0,-16,-11,2,17,-13,2,-9,-2,-5,11,-14,-2,-7,-9,1,26,-18,-13,-10,-4,2,14,-10,-21,-6,-2,-1,12,-8,8,-4,-2,-160,-98,-62,44,7,37,-11,-12,-50,-86,8,-3,-11,-7,-23,-54,-2,0,0,-5,-27,-32,10,-3,16,28,28,-35,5,1,6,15,12,-28,-1,2,10,13,16,-7,6,-1,-139,-101,-38,49,1,48,7,12,-51,-69,-24,-10,-4,11,-21,-62,-19,-4,11,1,-30,-7,-5,-6,13,54,24,-41,0,-1,5,31,14,-41,-7,-1,8,23,10,0,7,0
30,30020,Fortuna,6652,8,-4,12,50,23,27,4,0,-4,7,7,-6,1,-1,-6,0,5,-2,3,1,2,7,2,-4,9,10,17,9,4,0,4,3,9,3,3,0,5,7,8,6,1,0,156,93,63,165,90,75,21,43,36,32,18,6,16,23,20,21,11,4,5,20,16,11,7,2,26,46,43,27,16,5,17,25,25,11,8,4,9,21,18,16,8,1,200,100,100,166,87,79,27,32,64,27,40,12,11,12,40,13,21,7,16,20,24,14,19,5,18,40,43,23,32,9,8,21,25,13,14,6,10,19,18,10,18,3,238,129,109,189,105,84,42,54,36,33,56,17,26,22,16,23,27,15,16,32,20,10,29,2,30,41,39,24,36,17,17,22,25,12,16,13,13,19,14,12,20,4,314,201,113,291,186,105,22,86,92,45,57,11,11,54,75,19,37,5,11,32,17,26,20,6,26,81,89,39,48,7,13,55,67,22,25,3,13,26,22,17,23,4,403,224,179,338,186,152,79,71,72,43,112,23,39,49,30,28,61,15,40,22,42,15,51,8,63,61,60,48,84,21,27,38,37,28,44,11,36,23,23,20,40,10,347,198,149,315,168,147,39,59,40,93,93,21,26,33,29,44,51,13,13,26,11,49,42,8,32,57,49,72,87,16,16,32,28,37,45,9,16,25,21,35,42,7,450,245,205,309,169,140,48,80,115,92,86,29,19,50,64,52,45,14,29,30,51,40,41,15,39,54,77,55,64,20,20,36,42,32,32,8,19,18,35,23,32,12,342,219,123,228,135,93,26,62,132,61,35,21,17,31,96,45,15,14,9,31,36,16,20,7,30,48,69,31,34,15,19,27,45,20,14,10,11,21,24,11,20,5,248,183,65,196,124,72,32,42,69,44,60,3,19,33,65,32,33,2,13,9,4,12,27,1,31,37,51,25,43,8,15,22,40,17,25,4,16,15,11,8,18,4,131,94,37,116,70,46,2,31,36,10,42,10,-2,11,40,18,20,6,4,20,-4,-8,22,4,6,18,30,17,35,7,3,10,22,11,16,5,3,8,8,6,19,2,66,6,60,53,25,28,14,8,-8,6,27,10,14,3,-27,-5,10,6,0,5,19,11,17,4,3,15,6,3,17,7,2,9,0,-1,10,4,1,6,6,4,7,3,90,56,34,58,28,30,1,19,25,7,22,16,8,10,14,3,12,7,-7,9,11,4,10,9,10,9,9,4,18,7,8,3,3,1,8,4,2,6,6,3,10,3,-28,-46,18,-71,-77,6,11,2,-46,-9,5,4,1,-6,-41,-8,0,3,10,8,-5,-1,5,1,2,-7,-49,-33,3,12,-1,-8,-47,-26,-1,5,3,1,-2,-7,4,7,100,76,24,79,48,31,-9,38,0,30,26,14,-6,29,16,17,10,11,-3,9,-16,13,16,3,8,12,6,17,24,12,4,8,4,10,12,10,4,4,2,7,12,2,42,11,31,-13,-15,2,34,21,-14,-25,12,14,14,12,-16,-18,9,13,20,9,2,-7,3,1,11,6,-33,-24,14,11,6,6,-29,-15,8,9,5,0,-4,-9,6,2,134,69,65,136,67,69,10,16,40,23,45,0,14,5,19,19,22,-8,-4,11,21,4,23,8,21,23,28,19,34,8,12,8,16,13,17,0,9,15,12,6,17,8,78,36,42,112,64,48,-2,5,32,5,32,8,-5,14,7,2,14,6,3,-9,25,3,18,2,8,12,34,13,33,12,5,10,18,8,18,5,3,2,16,5,15,7
30,30021,Fuente Álamo de Murcia,9606,1101,796,305,1177,842,335,69,414,414,169,34,0,39,299,308,128,21,-1,30,115,106,41,13,1,78,422,456,177,30,9,40,302,338,133,20,6,38,120,118,44,10,3,338,183,155,426,272,154,79,90,98,42,29,-2,39,65,47,20,12,1,40,25,51,22,17,-3,65,137,143,56,15,8,34,94,98,37,6,3,31,43,45,19,9,5,-236,-173,-63,-11,-6,-5,-7,-58,-116,-43,-5,-6,2,-55,-83,-34,-1,-1,-9,-3,-33,-9,-4,-5,0,0,-6,-5,-2,2,0,0,-2,-4,-1,1,0,0,-4,-1,-1,1,-70,-76,6,-7,-4,-3,4,-35,-43,-32,26,12,10,-36,-50,-22,17,6,-6,1,7,-10,9,6,2,-4,-3,-2,0,0,4,-1,-5,-2,1,-1,-2,-3,2,0,-1,1,572,387,185,712,471,241,36,202,151,122,48,3,14,134,116,85,32,2,22,68,35,37,16,1,82,219,225,113,56,10,40,146,165,80,32,6,42,73,60,33,24,4,560,312,248,544,335,209,101,142,159,93,49,14,42,88,92,54,26,8,59,54,67,39,23,6,105,135,141,93,50,10,53,86,98,59,28,6,52,49,43,34,22,4,413,192,221,513,274,239,79,136,65,66,50,15,31,80,13,32,29,9,48,56,52,34,21,6,109,149,134,79,31,9,57,86,74,35,14,6,52,63,60,44,17,3,662,358,304,629,349,280,83,211,159,130,75,4,35,98,96,79,43,8,48,113,63,51,32,-4,95,192,183,103,46,10,44,97,110,69,24,5,51,95,73,34,22,5,535,244,291,496,253,243,145,156,129,83,17,3,76,67,69,29,2,0,69,89,60,54,15,3,119,133,146,71,26,1,60,71,84,29,10,0,59,62,62,42,16,1,379,226,153,211,96,115,82,96,100,47,46,0,52,41,71,38,19,-1,30,55,29,9,27,1,50,73,49,13,17,5,23,31,30,4,6,1,27,42,19,9,11,4,-195,-180,-15,-328,-266,-62,2,17,-123,-82,-20,2,-4,-7,-87,-64,-25,1,6,24,-36,-18,5,1,-30,26,-169,-125,-26,-7,-16,-6,-117,-101,-26,-3,-14,32,-52,-24,0,-4,75,25,50,-31,-24,-7,4,35,29,11,-8,-1,5,12,23,-6,-6,-5,-1,23,6,17,-2,4,-19,20,-18,-14,-2,0,-5,7,-9,-11,-8,0,-14,13,-9,-3,6,0,-424,-268,-156,-365,-265,-100,-81,-28,-229,-79,-14,5,-39,-30,-153,-42,-3,2,-42,2,-76,-37,-11,3,-52,-28,-186,-79,-21,2,-33,-27,-135,-59,-10,-1,-19,-1,-51,-20,-11,3,-394,-261,-133,-344,-244,-100,-32,-15,-45,-161,-105,-36,-13,-21,-41,-109,-62,-14,-19,6,-4,-52,-43,-22,-25,3,-59,-138,-94,-31,2,-6,-55,-112,-56,-17,-27,9,-4,-26,-38,-14,-126,-57,-69,-55,-36,-19,11,12,-36,-63,-31,-23,-6,18,-13,-38,-15,-8,17,-6,-23,-25,-16,-15,26,12,-28,-25,-21,-21,-1,9,-12,-14,-12,-8,27,3,-16,-11,-9,-13,-144,-101,-43,-20,-26,6,-35,0,-36,-73,16,-13,-25,-2,-37,-51,10,3,-10,2,1,-22,6,-16,12,11,-24,-39,19,-1,2,6,-21,-27,10,3,10,5,-3,-12,9,-4,126,81,45,180,105,75,5,41,-19,-2,52,51,16,20,-8,0,26,26,-11,21,-11,-2,26,25,23,49,25,25,39,18,20,27,16,12,20,9,3,22,9,13,19,9,75,45,30,151,87,64,-7,42,31,-37,20,18,-4,32,12,-10,0,12,-3,10,19,-27,20,6,16,43,54,-12,26,22,7,33,25,-2,9,15,9,10,29,-10,17,7
30,30022,Jumilla,20573,1348,930,418,1457,977,480,90,525,497,205,30,-15,40,362,343,158,25,-8,50,163,154,47,5,-7,113,528,540,228,29,2,56,354,366,168,23,0,57,174,174,60,6,2,673,407,266,797,476,321,126,209,211,96,7,13,63,134,127,64,5,9,63,75,84,32,2,4,127,266,263,108,18,4,61,165,158,72,12,2,66,101,105,36,6,2,393,228,165,598,349,249,76,184,74,53,-4,3,41,111,61,16,-3,1,35,73,13,37,-1,2,115,207,173,79,13,5,61,118,119,42,4,2,54,89,54,37,9,3,560,328,232,622,369,253,111,194,162,56,19,9,59,129,93,23,14,1,52,65,69,33,5,8,122,223,180,62,21,5,66,134,112,36,11,1,56,89,68,26,10,4,368,301,67,410,273,137,35,140,111,52,29,-2,35,101,99,44,20,0,0,39,12,8,9,-2,50,133,133,66,23,5,28,89,98,41,15,2,22,44,35,25,8,3,541,359,182,484,315,169,85,132,173,135,15,3,36,95,128,85,13,2,49,37,45,50,2,1,82,118,159,101,15,7,40,80,115,64,11,4,42,38,44,37,4,3,642,423,219,666,430,236,64,233,213,94,37,3,37,168,127,67,23,1,27,65,86,27,14,2,77,228,231,98,28,1,37,155,153,66,18,0,40,73,78,32,10,1,518,310,208,604,362,242,57,230,137,67,31,-7,26,144,90,43,10,-3,31,86,47,24,21,-4,72,243,191,67,21,3,40,150,119,39,10,1,32,93,72,28,11,2,592,415,177,403,247,156,125,140,176,68,54,27,67,91,147,57,36,19,58,49,29,11,18,8,102,122,96,57,21,1,51,76,71,37,10,1,51,46,25,20,11,0,324,250,74,219,113,106,29,89,142,36,35,-7,11,59,130,27,22,0,18,30,12,9,13,-7,46,75,61,20,16,0,26,39,37,0,11,0,20,36,24,20,5,0,-191,-114,-77,-107,-83,-24,-1,-26,-108,-37,-6,-9,1,-22,-65,-15,-6,-6,-2,-4,-43,-22,0,-3,-3,-4,-55,-39,-5,-1,-1,-9,-40,-26,-8,0,-2,5,-15,-13,3,-1,-292,-214,-78,-163,-132,-31,-42,-23,-178,-50,-8,5,-34,-23,-126,-29,-8,6,-8,0,-52,-21,0,-1,-22,-12,-88,-43,0,1,-16,-11,-71,-33,-3,2,-6,-1,-17,-10,3,-1,-191,-143,-48,-252,-188,-64,7,3,-72,-106,-36,11,9,-1,-47,-85,-23,0,-2,4,-25,-21,-13,11,-21,-20,-120,-85,-7,-1,-4,-18,-89,-69,-8,-2,-17,-2,-31,-16,1,1,-152,-97,-55,-203,-137,-66,-10,-25,-82,-12,-11,-11,-3,-31,-49,-3,-10,-2,-7,6,-33,-9,-1,-9,-16,-15,-112,-48,-11,-3,-7,-21,-71,-31,-8,-1,-9,6,-41,-17,-3,-2,-13,-21,8,-55,-38,-17,11,1,18,-39,10,-15,6,3,0,-27,7,-9,5,-2,18,-12,3,-6,-3,3,-14,-42,-2,1,-3,-1,-7,-30,0,2,0,4,-7,-12,-2,-1,32,71,-39,8,8,0,1,29,28,26,3,-57,5,34,24,25,2,-19,-4,-5,4,1,1,-38,4,28,-9,-13,0,-3,2,25,-5,-13,-2,0,2,3,-4,0,2,-3,-262,-88,-174,-279,-123,-156,-25,37,-42,-91,-79,-70,-4,40,-1,-51,-44,-34,-21,-3,-41,-40,-35,-36,-24,36,-36,-125,-75,-57,-4,34,-4,-78,-43,-29,-20,2,-32,-47,-32,-28,6,-18,24,106,43,63,27,48,-2,-57,-4,-10,7,31,-4,-36,-9,-7,20,17,2,-21,5,-3,26,56,41,-35,13,3,15,35,23,-31,2,-1,11,21,18,-4,11,4
30,30023,Librilla,3873,10,10,0,16,8,8,0,-1,7,3,-2,2,-5,2,7,4,-1,2,5,-3,0,-1,-1,0,1,4,5,1,2,3,0,2,3,1,1,1,1,2,2,0,1,2,38,26,12,28,17,11,4,8,11,15,3,-3,1,8,5,11,2,-1,3,0,6,4,1,-2,5,12,6,5,0,0,2,9,3,3,0,0,3,3,3,2,0,0,50,41,9,38,21,17,4,20,18,2,5,1,2,20,11,5,1,3,2,0,7,-3,4,-2,8,11,12,6,1,0,2,8,7,3,1,0,6,3,5,3,0,0,42,22,20,28,21,7,9,10,13,9,2,2,5,9,-2,9,1,1,4,1,15,0,1,1,5,7,7,7,0,2,3,5,5,7,0,1,2,2,2,0,0,1,40,25,15,34,18,16,6,13,8,4,12,-2,1,9,8,-1,9,-2,5,4,0,5,3,0,7,9,3,5,9,0,3,5,2,2,5,0,4,4,1,3,4,0,64,34,30,39,20,19,16,7,27,5,6,1,4,4,17,0,4,2,12,3,10,5,2,-1,7,9,18,3,2,0,4,3,11,1,1,0,3,6,7,2,1,0,138,67,71,46,19,27,27,29,28,35,15,3,15,14,12,21,4,0,12,15,16,14,11,3,6,17,14,6,2,1,3,8,7,1,0,0,3,9,7,5,2,1,70,35,35,46,14,32,21,17,26,3,2,0,12,5,9,8,0,1,9,12,17,-5,2,-1,11,13,15,6,1,0,3,4,6,1,0,0,8,9,9,5,1,0,99,48,51,26,9,17,22,15,32,16,10,1,11,6,19,3,7,0,11,9,13,13,3,1,6,7,7,3,3,0,2,2,4,0,1,0,4,5,3,3,2,0,70,43,27,19,13,6,9,8,34,12,9,4,-1,4,26,7,7,1,10,4,8,5,2,3,4,1,4,7,3,0,4,0,3,4,2,0,0,1,1,3,1,0,72,36,36,10,6,4,2,14,36,10,17,-5,-1,11,16,6,9,-2,3,3,20,4,8,-3,0,3,2,3,2,0,1,1,1,3,0,0,-1,2,1,0,2,0,59,32,27,10,3,7,8,16,25,6,3,4,4,9,9,11,3,-1,4,7,16,-5,0,5,1,6,2,-2,2,1,1,2,0,-1,1,0,0,4,2,-1,1,1,24,19,5,6,2,4,-1,4,13,6,4,-1,1,2,7,7,1,0,-2,2,6,-1,3,-1,0,1,2,-1,3,1,-1,0,2,0,0,1,1,1,0,-1,3,0,60,38,22,12,1,11,13,11,20,2,9,3,4,5,14,3,5,4,9,6,6,-1,4,-1,6,4,1,2,0,-1,2,1,-1,0,0,-1,4,3,2,2,0,0,99,56,43,15,12,3,24,20,29,15,0,12,11,16,15,8,0,4,13,4,14,7,0,8,2,7,2,1,2,0,1,6,3,0,1,0,1,1,-1,1,1,0,76,34,42,19,6,13,23,7,9,17,13,2,17,0,0,8,5,1,6,7,9,9,8,1,0,6,7,0,4,1,1,1,4,-2,2,0,-1,5,3,2,2,1,39,24,15,18,9,9,-16,7,21,12,10,1,-6,5,12,8,3,-3,-10,2,9,4,7,4,0,4,11,3,1,0,1,1,5,2,0,0,-1,3,6,1,1,0,69,36,33,25,13,12,12,17,24,0,9,5,10,5,11,2,4,2,2,12,13,-2,5,3,4,6,7,5,3,0,4,4,3,1,1,0,0,2,4,4,2,0
30,30024,Lorca,70689,4763,3263,1500,4870,3355,1515,249,1747,1918,739,90,11,142,1196,1297,544,70,6,107,551,621,195,20,5,244,1776,1955,780,87,16,132,1212,1365,567,63,7,112,564,590,213,24,9,1695,1028,667,2475,1610,865,444,583,433,203,24,1,228,405,265,123,12,-10,216,178,168,80,12,11,439,848,818,308,47,7,225,590,552,209,26,2,214,258,266,99,21,5,2043,1193,850,2575,1536,1039,510,746,507,182,89,6,277,474,305,88,41,7,233,272,202,94,48,-1,558,853,740,296,97,17,295,541,464,174,46,10,263,312,276,122,51,7,1876,1095,781,2238,1365,873,500,717,396,186,61,17,245,476,243,97,35,5,255,241,153,89,26,12,499,775,586,257,94,15,252,509,387,155,48,10,247,266,199,102,46,5,2079,1528,551,2147,1521,626,151,787,716,334,76,10,83,603,580,199,50,14,68,184,136,135,26,-4,208,790,757,297,64,23,115,592,575,181,37,16,93,198,182,116,27,7,1868,1315,553,1751,1139,612,206,667,615,292,61,28,140,482,444,199,43,12,66,185,171,93,18,16,271,574,576,230,77,14,145,406,388,148,40,8,126,168,188,82,37,6,1569,966,603,1921,1139,782,306,593,355,192,93,20,167,401,215,110,48,14,139,192,140,82,45,6,334,639,574,251,90,21,176,408,347,138,46,17,158,231,227,113,44,4,696,173,523,1660,864,796,241,470,-154,106,17,17,98,268,-261,52,-3,12,143,202,107,54,20,5,311,645,379,232,52,19,173,361,154,127,26,9,138,284,225,105,26,10,513,211,302,967,468,499,238,199,44,-27,44,12,106,82,20,-52,32,25,132,117,24,25,12,-13,280,348,239,53,39,0,131,171,123,11,24,3,149,177,116,42,15,-3,461,280,181,319,115,204,100,173,115,8,23,27,73,98,81,-16,16,9,27,75,34,24,7,18,70,171,73,-37,20,20,59,63,23,-55,10,13,11,108,50,18,10,7,-485,-347,-138,-380,-335,-45,-76,12,-260,-116,-16,-28,-32,-39,-159,-91,-12,-17,-44,51,-101,-25,-4,-11,-78,59,-247,-114,-5,3,-31,5,-187,-115,-8,-1,-47,54,-60,1,3,4,-108,-48,-60,271,105,166,-55,52,-113,-33,40,7,-41,15,-51,1,13,13,-14,37,-62,-34,27,-6,49,127,20,2,46,21,23,60,-14,-1,21,13,26,67,34,3,25,8,-635,-454,-181,-485,-417,-68,-98,47,-338,-173,-34,-35,-49,6,-243,-124,-38,-3,-49,41,-95,-49,4,-32,-102,36,-281,-121,-26,5,-59,-5,-218,-118,-26,7,-43,41,-63,-3,0,-2,-1000,-791,-209,-1105,-892,-213,-54,-73,-424,-350,-108,-7,-34,-79,-348,-255,-76,-6,-20,6,-76,-95,-32,-1,-124,-61,-426,-416,-81,0,-79,-74,-346,-326,-66,-3,-45,13,-80,-90,-15,3,-613,-417,-196,-609,-450,-159,23,20,-233,-204,-170,-67,4,2,-157,-146,-96,-30,19,18,-76,-58,-74,-37,-8,23,-183,-239,-170,-40,-13,-4,-138,-166,-105,-25,5,27,-45,-73,-65,-15,56,-11,67,237,107,130,36,145,35,-133,-19,-5,8,54,17,-84,-9,6,28,91,18,-49,-10,-11,68,164,103,-110,10,-1,32,71,56,-59,4,0,36,93,47,-51,6,-1,649,354,295,563,268,295,187,217,181,69,-23,-9,91,110,97,57,6,-13,96,107,84,12,-29,4,153,248,166,22,-38,-4,68,127,104,6,-27,-15,85,121,62,16,-11,11,524,301,223,692,377,315,109,266,175,-50,8,11,71,145,153,-71,1,2,38,121,22,21,7,9,152,277,285,-22,-11,4,89,167,186,-48,-18,1,63,110,99,26,7,3
30,30025,Lorquí,5527,119,72,47,145,95,50,10,36,39,25,6,1,-1,19,27,18,4,3,11,17,12,7,2,-2,10,55,50,22,7,0,2,31,40,17,4,0,8,24,10,5,3,0,147,91,56,143,85,58,25,45,38,26,8,5,15,36,17,14,4,5,10,9,21,12,4,0,27,53,31,27,2,1,16,35,17,14,1,0,11,18,14,13,1,1,66,50,16,105,65,40,16,29,18,15,-1,-13,11,23,11,10,-1,-6,5,6,7,5,0,-7,25,29,32,17,1,1,15,17,19,13,0,1,10,12,13,4,1,0,190,118,72,140,99,41,61,28,80,29,2,-6,37,20,49,20,0,-6,24,8,31,9,2,0,25,32,50,28,6,-1,14,19,39,24,3,0,11,13,11,4,3,-1,148,104,44,77,52,25,17,35,58,31,11,-6,10,20,40,25,6,-1,7,15,18,6,5,-5,7,22,31,12,5,0,4,14,22,11,2,-1,3,8,9,1,3,1,205,149,56,102,71,31,19,60,89,27,7,0,15,44,67,20,4,1,4,16,22,7,3,-1,18,31,40,9,2,1,13,21,30,3,2,1,5,10,10,6,0,0,247,134,113,114,63,51,37,79,82,34,14,-6,14,43,44,23,7,-3,23,36,38,11,7,-3,11,43,46,13,2,-2,5,27,25,3,1,0,6,16,21,10,1,-2,142,86,56,73,32,41,39,44,36,16,6,-7,27,23,23,17,-1,-4,12,21,13,-1,7,-3,14,32,12,6,6,-1,8,18,-3,7,0,0,6,14,15,-1,6,-1,41,29,12,70,39,31,-8,46,-9,5,6,-1,6,35,-22,7,3,1,-14,11,13,-2,3,-2,18,30,1,10,7,0,14,16,-4,10,3,0,4,14,5,0,4,0,9,-13,22,8,-8,16,-8,23,-3,8,-9,-8,-22,6,14,-2,-6,-2,14,17,-17,10,-3,-6,7,4,-1,-1,1,-2,-3,2,-3,-6,2,0,10,2,2,5,-1,-2,-26,-25,-1,18,1,17,-4,-10,-18,0,3,0,6,-5,-12,-11,-2,-2,-10,-5,-6,11,5,2,2,5,8,1,2,0,1,1,1,-1,-1,0,1,4,7,2,3,0,-101,-58,-43,-31,-23,-8,-40,19,-63,-18,2,4,-21,16,-39,-18,2,2,-19,3,-24,0,0,2,-6,4,-17,-5,-9,1,-4,4,-13,-4,-7,0,-2,0,-4,-1,-2,1,-45,-39,-6,-19,-17,-2,-17,-13,-10,7,-7,-9,-16,-3,-14,2,-7,-4,-1,-10,4,5,0,-5,-8,-1,-10,2,-2,0,-7,-3,-11,4,0,0,-1,2,1,-2,-2,0,4,2,2,-23,-19,-4,3,-5,16,-1,-8,-3,4,-7,10,-1,-6,0,-1,2,6,0,-2,-3,2,-1,-7,-9,-6,-2,0,-4,-5,-3,-6,-1,2,3,-2,-6,0,-1,86,25,61,29,15,14,19,22,21,8,5,10,6,10,-2,7,1,4,13,12,23,1,4,6,2,12,8,3,2,2,2,6,5,-1,2,1,0,6,3,4,0,1,-77,-26,-51,-65,-49,-16,-15,1,-31,-17,-19,0,-7,7,-1,-16,-12,-1,-8,-6,-30,-1,-7,1,-2,-1,-19,-23,-22,0,-4,1,-8,-22,-17,0,2,-2,-11,-1,-5,0,108,60,48,45,29,16,34,36,21,14,2,0,17,15,20,7,-1,2,17,21,1,7,3,-2,4,16,19,5,-2,3,3,8,13,4,-1,2,1,8,6,1,-1,1,-57,-49,-8,-33,-25,-8,5,-13,1,-30,-18,-2,10,-7,-5,-31,-14,0,-5,-6,6,1,-4,-2,8,-5,-1,-22,-12,-1,8,3,-7,-16,-12,-1,0,-8,6,-6,0,0
30,30026,Mazarrón,17478,1025,659,366,805,528,277,81,323,312,111,150,54,68,210,214,56,83,31,13,113,98,55,67,23,71,256,253,102,87,34,43,176,169,69,50,20,28,80,84,33,37,14,1514,896,618,1703,1061,642,188,399,323,207,309,76,96,254,212,120,163,48,92,145,111,87,146,28,211,450,434,222,297,76,108,299,299,143,160,46,103,151,135,79,137,30,1757,964,793,1660,919,741,267,336,352,253,415,140,131,205,202,148,201,82,136,131,150,105,214,58,273,343,295,230,390,122,142,212,166,128,192,76,131,131,129,102,198,46,1790,952,838,1903,1071,832,239,352,190,224,640,149,129,189,97,113,333,89,110,163,93,111,307,60,269,335,266,246,634,148,151,209,171,126,321,90,118,126,95,120,313,58,2129,1179,950,2091,1185,906,183,255,346,285,872,187,115,177,206,125,450,111,68,78,140,160,422,76,193,277,298,290,869,155,112,193,189,133,451,102,81,84,109,157,418,53,2064,1101,963,2239,1256,983,239,249,135,391,900,145,121,179,54,196,457,88,118,70,81,195,443,57,229,292,272,392,899,149,124,202,170,207,455,94,105,90,102,185,444,55,1859,985,874,1917,1067,850,154,277,293,372,652,115,64,165,164,188,338,70,90,112,129,184,314,45,175,278,289,369,670,132,97,174,174,195,349,77,78,104,115,174,321,55,1704,861,843,1758,919,839,214,302,345,308,423,101,126,166,157,143,201,63,88,136,188,165,222,38,211,327,357,333,418,107,110,191,183,161,207,66,101,136,174,172,211,41,884,493,391,1228,693,535,90,120,146,127,293,101,58,86,66,69,154,53,32,34,80,58,139,48,183,190,252,198,303,96,108,113,147,103,160,59,75,77,105,95,143,37,-228,-266,38,150,-27,177,-66,-36,-201,-92,144,25,-35,-66,-159,-90,69,19,-31,30,-42,-2,75,6,1,33,-94,10,163,35,2,-11,-107,-20,84,24,-1,44,13,30,79,11,-314,-259,-55,-21,-58,37,-118,-55,-247,-107,124,90,-65,-45,-174,-86,62,43,-53,-10,-73,-21,62,47,-43,-26,-108,-43,143,56,-24,-20,-81,-35,69,31,-19,-6,-27,-8,74,25,-81,-90,9,185,65,120,-107,16,-108,-43,139,27,-69,3,-90,-30,73,27,-38,13,-18,-13,66,0,-16,17,-31,36,146,31,2,0,-39,2,80,20,-18,17,8,34,66,11,340,183,157,423,225,198,17,73,27,-5,171,51,4,31,31,4,82,25,13,42,-4,-9,89,26,42,60,70,59,159,30,23,27,48,29,78,17,19,33,22,30,81,13,237,123,114,275,151,124,19,53,23,6,102,27,21,22,8,-4,53,17,-2,31,15,10,49,10,9,41,51,50,103,19,7,20,37,20,52,13,2,21,14,30,51,6,336,181,155,370,189,181,22,61,8,49,154,47,18,32,0,28,82,24,4,29,8,21,72,23,37,60,44,69,123,35,21,28,17,35,66,20,16,32,27,34,57,15,269,153,116,438,247,191,-9,77,38,35,111,13,-6,27,33,15,57,27,-3,50,5,20,54,-14,37,88,79,83,126,23,22,42,54,45,57,25,15,46,25,38,69,-2,206,94,112,236,100,136,18,64,5,5,112,-1,3,57,7,-21,60,-15,15,7,-2,26,52,14,27,63,8,26,99,10,11,45,-7,-6,59,-3,16,18,15,32,40,13,-3209,-1705,-1504,-3143,-1663,-1480,19,-126,-154,-461,-775,-1706,16,-58,-92,-273,-383,-913,3,-68,-62,-188,-392,-793,10,-90,-126,-446,-766,-1725,13,-39,-72,-258,-379,-928,-3,-51,-54,-188,-387,-797
30,30027,Molina de Segura,43097,832,403,429,45,16,29,163,109,280,136,61,77,62,52,151,78,35,22,101,57,129,58,26,55,14,4,9,7,6,5,3,2,1,5,3,2,11,2,8,2,3,3,1487,807,680,857,492,365,312,297,494,286,54,33,175,146,271,161,30,15,137,151,223,125,24,18,179,213,295,136,25,7,90,120,182,83,11,5,89,93,113,53,14,2,1359,691,668,695,348,347,325,227,433,239,74,41,175,121,197,127,44,17,150,106,236,112,30,24,180,152,221,97,31,7,91,65,119,53,15,4,89,87,102,44,16,3,1744,905,839,854,470,384,387,258,554,351,112,59,187,132,315,188,54,16,200,126,239,163,58,43,189,198,264,128,52,17,93,103,157,86,22,7,96,95,107,42,30,10,1681,969,712,719,427,292,296,313,614,341,65,25,150,184,367,201,40,5,146,129,247,140,25,20,92,193,256,139,27,4,45,106,169,88,15,0,47,87,87,51,12,4,2268,1197,1071,964,518,446,534,383,757,424,105,34,258,204,410,237,54,11,276,179,347,187,51,23,212,230,291,168,46,11,107,120,165,98,21,4,105,110,126,70,25,7,2225,1197,1028,1051,546,505,428,380,828,414,104,42,211,188,476,239,51,15,217,192,352,175,53,27,191,301,329,174,37,11,90,141,187,96,20,6,101,160,142,78,17,5,2318,1171,1147,1228,649,579,445,452,817,418,90,64,200,225,428,243,48,9,245,227,389,175,42,55,245,368,352,180,63,12,137,187,183,101,30,7,108,181,169,79,33,5,1363,570,793,462,198,264,343,247,404,259,56,38,187,73,171,101,11,17,156,174,233,158,45,21,140,149,57,72,29,8,82,65,7,17,15,7,58,84,50,55,14,1,881,421,460,154,32,122,165,148,295,205,48,29,78,59,146,105,19,7,87,89,149,100,29,22,42,74,-9,27,12,2,21,14,-23,11,3,3,21,60,14,16,9,-1,531,226,305,30,-14,44,102,43,206,95,4,62,52,21,91,47,-6,11,50,22,115,48,10,51,8,38,-10,-26,5,1,7,17,-14,-19,-4,-4,1,21,4,-7,9,5,503,251,252,13,-36,49,126,22,199,114,-4,27,60,1,105,64,-6,11,66,21,94,50,2,16,19,25,-11,-22,-9,2,0,7,-11,-27,-12,0,19,18,0,5,3,2,476,225,251,167,63,104,120,37,178,48,22,46,90,16,82,6,17,-6,30,21,96,42,5,52,31,49,32,27,9,15,17,19,11,8,1,5,14,30,21,19,8,10,410,172,238,-9,-16,7,92,38,159,66,-7,34,18,26,56,55,-3,16,74,12,103,11,-4,18,-2,35,-37,-24,3,5,-2,11,-35,-7,5,6,0,24,-2,-17,-2,-1,520,227,293,117,35,82,90,27,139,165,44,21,27,-10,85,68,30,1,63,37,54,97,14,20,6,29,28,21,28,-2,1,9,20,-11,17,-4,5,20,8,32,11,2,573,276,297,279,138,141,97,92,153,143,8,47,32,33,69,113,-12,18,65,59,84,30,20,29,66,71,55,46,24,11,33,35,29,23,11,4,33,36,26,23,13,7,708,327,381,423,220,203,196,66,164,211,60,-8,93,44,77,89,20,-3,103,22,87,122,40,-5,101,77,90,89,48,5,51,36,50,57,20,2,50,41,40,32,28,3,430,228,202,387,185,202,63,54,134,111,12,39,50,33,66,58,10,14,13,21,68,53,2,25,57,81,112,79,28,12,37,43,55,33,10,4,20,38,57,46,18,8
30,30028,Moratalla,8574,-37,-16,-21,16,12,4,-5,-7,-16,0,-2,-6,-2,-3,-4,-1,-2,-2,-3,-4,-12,1,0,-4,3,2,5,3,0,3,2,1,5,2,0,2,1,1,0,1,0,1,102,88,14,93,72,21,17,18,43,25,1,-3,7,26,38,16,3,-2,10,-8,5,9,-2,-1,10,26,44,9,4,0,4,21,37,7,3,0,6,5,7,2,1,0,-16,-5,-11,43,30,13,-3,4,-21,7,-4,-3,-6,9,-13,5,1,-4,3,-5,-8,2,-5,1,7,12,15,9,0,0,3,9,10,8,0,0,4,3,5,1,0,0,30,13,17,62,38,24,27,5,-20,25,1,-12,15,-2,-17,19,4,-6,12,7,-3,6,-3,-6,20,15,12,10,5,0,12,9,8,6,3,0,8,6,4,4,2,0,-39,-16,-23,35,18,17,-14,-18,-22,0,17,-3,-4,-11,-3,-7,9,-1,-10,-7,-19,7,8,-2,2,4,11,10,7,0,1,3,6,4,3,0,1,1,5,6,4,0,5,-1,6,45,22,23,2,8,-17,2,9,2,-1,8,-14,-1,2,4,3,0,-3,3,7,-2,7,11,10,5,7,3,3,5,5,3,3,2,4,6,5,2,4,1,21,8,13,30,15,15,14,-3,-8,12,8,-1,7,-4,-5,3,3,4,7,1,-3,9,5,-5,6,5,6,5,7,1,3,1,4,2,4,1,3,4,2,3,3,0,40,30,10,55,34,21,17,6,9,8,12,-12,12,5,5,9,9,-10,5,1,4,-1,3,-2,5,18,15,4,9,3,4,9,11,2,6,1,1,9,4,2,3,2,34,45,-11,49,35,14,0,25,10,-3,15,-17,3,23,12,-1,8,-4,-3,2,-2,-2,7,-13,4,19,15,8,1,0,1,15,10,6,0,1,3,4,5,2,1,-1,24,25,-1,33,14,19,3,17,-5,9,0,0,0,11,8,3,0,3,3,6,-13,6,0,-3,5,14,6,4,2,1,2,4,3,3,0,1,3,10,3,1,2,0,-37,-19,-18,17,5,12,-10,-5,12,-18,-3,-12,-8,0,6,-11,-3,-2,-2,-5,6,-7,0,-10,2,4,7,1,3,0,0,3,2,-1,1,0,2,1,5,2,2,0,-49,-30,-19,28,12,16,-11,2,-23,-11,0,-10,-7,-1,-11,-6,-1,-5,-4,3,-12,-5,1,-5,6,9,4,2,3,1,2,3,3,1,2,0,4,6,1,1,1,1,-39,-19,-20,5,2,3,3,-3,-26,-1,9,-18,-2,-2,-13,0,5,-6,5,-1,-13,-1,4,-12,1,2,-3,-1,5,1,0,0,-1,-1,3,1,1,2,-2,0,2,0,14,9,5,7,4,3,9,5,-12,11,-2,-2,11,-2,-9,3,1,4,-2,7,-3,8,-3,-6,-1,6,1,-2,1,2,0,3,0,-1,1,1,-1,3,1,-1,0,1,-15,6,-21,13,6,7,-11,-2,-15,3,11,-1,-3,1,-5,3,10,-1,-8,-3,-10,0,1,0,1,-1,1,6,2,4,0,0,0,3,1,2,1,-1,1,3,1,2,-1,1,-2,22,11,11,11,-5,-11,11,5,-11,7,-1,-5,2,3,-3,4,-4,-6,9,2,-8,4,6,3,5,2,2,1,3,1,2,1,3,3,3,2,3,1,-1,-66,-20,-46,12,5,7,-1,-14,-28,-7,0,-14,4,0,-9,-6,-3,-4,-5,-14,-19,-1,3,-10,-2,3,8,0,2,1,-1,1,5,-1,1,0,-1,2,3,1,1,1,-44,-40,-4,9,2,7,-4,-4,-23,-15,7,-4,-3,-4,-18,-10,0,-4,-1,0,-5,-5,7,0,1,2,0,-1,7,0,0,1,-1,-1,3,0,1,1,1,0,4,0
30,30029,Mula,13632,700,490,210,841,567,274,46,227,268,149,7,-3,30,157,183,110,11,-3,16,70,85,39,-4,0,58,255,340,163,20,1,34,168,224,123,17,0,24,87,116,40,3,1,308,193,115,452,294,158,55,138,70,38,2,-1,29,81,53,22,3,1,26,57,17,16,-1,-2,73,153,139,77,7,1,42,95,97,54,5,0,31,58,42,23,2,1,347,183,164,408,222,186,118,80,80,45,16,5,65,30,51,25,11,1,53,50,29,20,5,4,112,108,115,55,15,1,54,60,67,32,9,0,58,48,48,23,6,1,203,130,73,354,212,142,55,87,20,23,0,19,26,57,30,11,-3,9,29,30,-10,12,3,10,84,117,94,43,13,1,47,69,61,26,6,1,37,48,33,17,7,0,309,207,102,298,196,102,30,90,84,49,59,0,20,64,64,34,32,-5,10,26,20,15,27,5,27,86,101,40,40,2,12,56,80,27,18,2,15,30,21,13,22,0,335,228,107,299,194,105,38,47,143,64,32,12,31,34,91,51,15,7,7,13,52,13,17,5,40,74,90,50,29,13,25,53,56,36,15,8,15,21,34,14,14,5,447,304,143,435,255,180,27,148,159,80,19,4,18,91,108,64,12,6,9,57,51,16,7,-2,47,135,167,62,18,2,21,79,97,43,11,1,26,56,70,19,7,1,356,219,137,386,233,153,66,114,134,29,9,5,25,80,77,16,12,8,41,34,57,13,-3,-3,68,143,118,38,12,3,34,92,73,22,8,2,34,51,45,16,4,1,187,99,88,228,123,105,54,61,60,-5,22,2,23,31,52,-11,10,-1,31,30,8,6,12,3,55,74,61,25,9,2,19,45,44,8,5,1,36,29,17,17,4,1,69,38,31,73,50,23,5,34,-1,26,7,-3,6,13,6,14,-3,0,-1,21,-7,12,10,-3,2,22,27,18,1,3,4,12,18,14,-1,3,-2,10,9,4,2,0,-51,-7,-44,47,38,9,-7,-14,-34,14,6,-7,-5,1,-9,10,3,-4,-2,-15,-25,4,3,-3,-6,16,23,10,1,3,-1,11,21,7,0,1,-5,5,2,3,1,2,-29,7,-36,8,22,-14,-2,8,-17,2,-4,-15,11,9,-15,6,-1,-4,-13,-1,-2,-4,-3,-11,-19,20,7,1,-1,0,-2,11,9,3,1,0,-17,9,-2,-2,-2,0,57,59,-2,22,24,-2,-1,20,13,13,4,6,4,21,18,18,-4,1,-5,-1,-5,-5,8,5,-1,17,-2,5,2,1,4,14,2,4,0,0,-5,3,-4,1,2,1,-458,-324,-134,-479,-356,-123,3,-31,-196,-189,-38,-7,8,-25,-133,-146,-28,-3,-5,-6,-63,-43,-10,-4,-32,-19,-209,-179,-39,-2,-16,-18,-141,-152,-30,0,-16,-1,-68,-27,-9,-2,23,-12,35,42,30,12,7,1,-3,7,16,-4,-3,-4,-6,-3,9,-1,10,5,3,10,7,-3,12,6,5,15,2,1,11,4,3,10,1,0,1,2,2,5,1,1,-107,-58,-49,-9,-9,0,-30,8,-49,-20,1,-16,-19,-2,-27,-5,-3,-2,-11,10,-22,-15,4,-14,-22,8,12,-10,5,-1,-16,2,11,-4,0,-1,-6,6,1,-6,5,0,47,52,-5,107,62,45,6,31,4,-8,15,2,12,24,14,-7,9,0,-6,7,-10,-1,6,2,27,40,24,11,1,4,14,27,14,6,0,1,13,13,10,5,1,3,83,70,13,109,72,37,22,52,17,-14,11,-6,16,47,27,-24,1,1,6,5,-10,10,10,-7,10,55,23,7,12,0,4,41,27,-5,4,0,6,14,-4,12,8,0
30,30030,Murcia,353504,-127,-293,166,167,76,91,41,-258,70,46,19,-14,-4,-160,-74,-7,-20,-5,45,-98,144,53,39,-9,32,19,31,30,45,8,14,5,15,14,22,5,18,14,16,16,23,3,351,47,304,102,58,44,131,-25,145,51,41,24,89,-61,-29,15,29,21,42,36,174,36,12,3,30,11,15,23,19,3,18,7,8,13,9,3,12,4,7,10,10,0,4110,2075,2035,3508,1963,1545,938,875,1345,686,128,125,473,466,685,328,59,49,465,409,660,358,69,76,730,942,1025,597,149,42,402,507,631,321,66,20,328,435,394,276,83,22,6243,3342,2901,6534,3514,3020,1310,1764,1900,937,264,49,708,944,1115,431,116,20,602,820,785,506,148,29,1310,1816,1999,1022,289,53,684,981,1191,513,106,14,626,835,808,509,183,39,8036,5026,3010,7541,4747,2794,888,2425,3047,1193,397,56,451,1616,2042,668,167,42,437,809,1005,525,230,14,864,2279,2765,1162,359,71,440,1499,1935,658,157,29,424,780,830,504,202,42,8672,5488,3184,8149,5212,2937,1033,2496,3261,1374,404,53,516,1545,2253,899,234,21,517,951,1008,475,170,32,1080,2361,2898,1282,402,74,578,1519,2035,810,194,44,502,842,863,472,208,30,5771,2940,2831,7173,3746,3427,859,1915,1846,891,344,-86,419,960,984,434,145,1,440,955,862,457,199,-87,1086,2119,2368,1123,364,62,522,1103,1350,580,141,26,564,1016,1018,543,223,36,5022,2179,2843,6544,3380,3164,833,1955,1214,782,252,-72,433,946,400,222,108,35,400,1009,814,560,144,-107,1001,2199,1910,992,310,63,507,1150,1006,491,150,39,494,1049,904,501,160,24,5571,2923,2648,5657,3238,2419,1108,1551,1580,880,319,54,585,877,800,441,153,33,523,674,780,439,166,21,922,1574,1895,866,296,52,503,915,1158,477,136,19,419,659,737,389,160,33,4178,1992,2186,3599,1893,1706,610,942,1314,670,317,180,242,488,676,301,159,52,368,454,638,369,158,128,533,977,1187,551,237,64,275,496,686,284,102,28,258,481,501,267,135,36,1586,511,1075,2466,1231,1235,295,384,450,164,189,78,185,90,84,52,76,35,110,294,366,112,113,43,296,608,863,406,208,53,189,274,441,203,82,25,107,334,422,203,126,28,-495,-562,67,-135,-226,91,69,125,-415,-275,-73,40,3,-2,-282,-248,-90,31,66,127,-133,-27,17,9,98,289,-114,-292,-138,-30,64,117,-57,-248,-113,-19,34,172,-57,-44,-25,-11,-5908,-3938,-1970,-6419,-4268,-2151,-617,-375,-2426,-1832,-609,-92,-268,-279,-1654,-1397,-329,-27,-349,-96,-772,-435,-280,-65,-739,-373,-2551,-1952,-677,-164,-362,-270,-1770,-1419,-385,-80,-377,-103,-781,-533,-292,-84,-365,-665,300,-1191,-991,-200,62,325,-343,-346,-7,-52,39,33,-366,-332,-3,-33,23,292,23,-14,-4,-19,-133,160,-519,-584,-125,-7,-86,-7,-395,-420,-87,-4,-47,167,-124,-164,-38,-3,-1472,-1011,-461,-1523,-995,-528,-6,63,-482,-734,-284,-73,-8,-31,-307,-447,-189,-45,2,94,-175,-287,-95,-28,-28,-4,-584,-641,-248,-65,-15,-35,-361,-442,-137,-30,-13,31,-223,-199,-111,-35,221,-47,268,-510,-385,-125,154,331,-143,-200,-16,40,56,120,-105,-145,-24,11,98,211,-38,-55,8,29,56,256,-274,-412,-146,-32,37,78,-122,-266,-119,-18,19,178,-152,-146,-27,-14,1477,628,849,652,220,432,287,544,588,-76,79,14,155,239,290,-115,37,15,132,305,298,39,42,-1,168,503,218,-272,-20,9,113,250,116,-236,-47,3,55,253,102,-36,27,6,2913,1481,1432,1777,843,934,459,996,904,168,287,24,250,552,484,42,100,18,209,444,420,126,187,6,312,925,521,-113,78,-7,171,515,303,-170,-1,-3,141,410,218,57,79,-4
30,30032,Pliego,3401,7,7,0,21,13,8,0,4,-2,1,1,2,-1,5,-1,1,0,2,1,-1,-1,0,1,0,2,10,6,2,1,0,1,6,5,1,0,0,1,4,1,1,1,0,-8,-7,-1,9,5,4,-2,-3,-8,1,3,2,-2,-2,-6,1,1,2,0,-1,-2,0,2,0,0,3,4,2,0,0,0,2,2,1,0,0,0,1,2,1,0,0,39,36,3,35,22,13,12,1,13,9,2,1,11,7,9,8,0,1,1,-6,4,1,2,0,11,7,12,4,1,0,6,4,9,3,0,0,5,3,3,1,1,0,55,26,29,39,19,20,7,18,19,2,9,-1,4,11,5,2,5,-1,3,7,14,0,4,0,7,10,15,2,2,2,3,6,7,2,0,1,4,4,8,0,2,1,112,75,37,85,55,30,22,29,25,18,16,-1,18,18,11,13,11,1,4,11,14,5,5,-2,14,24,24,14,8,0,8,17,16,8,5,0,6,7,8,6,3,0,120,62,58,74,39,35,20,20,29,21,18,8,8,7,21,13,9,3,12,13,8,8,9,5,15,15,17,14,11,1,6,9,9,8,6,1,9,6,8,6,5,0,186,95,91,133,76,57,37,19,47,43,36,4,18,8,26,26,15,3,19,11,21,17,21,1,26,20,35,27,23,1,13,10,23,17,12,1,13,10,12,10,11,0,104,49,55,70,37,33,25,5,32,21,16,2,11,4,17,10,6,1,14,1,15,11,10,1,15,7,17,16,14,1,9,4,8,8,8,0,6,3,9,8,6,1,41,24,17,43,24,19,21,14,-8,18,3,-6,11,10,-5,8,0,-1,10,4,-3,10,3,-5,13,10,8,8,4,0,7,4,5,4,4,0,6,6,3,4,0,0,18,10,8,25,11,14,5,5,-9,14,1,0,-2,4,-4,7,0,3,7,1,-5,7,1,-3,3,6,3,9,2,2,1,4,2,2,1,1,2,2,1,7,1,1,-29,-19,-10,5,4,1,-11,-6,-2,-10,6,-4,-7,-5,0,-8,6,-3,-4,-1,-2,-2,0,-1,0,-1,4,1,1,0,1,-1,3,0,1,0,-1,0,1,1,0,0,3,5,-2,19,13,6,-1,-5,7,-9,3,8,0,0,6,-7,2,5,-1,-5,1,-2,1,3,6,1,5,3,1,2,5,2,3,2,0,1,1,-1,2,1,1,1,28,8,20,19,12,7,5,9,8,13,-4,-5,8,-2,-2,9,-1,-4,-3,11,10,4,-3,-1,4,5,2,7,0,0,4,3,1,4,0,0,0,2,1,3,0,0,11,8,3,12,7,5,1,6,-5,-2,1,2,2,3,-4,2,0,2,-1,3,-1,-4,1,0,3,5,2,-1,2,1,2,3,0,0,1,1,1,2,2,-1,1,0,55,34,21,21,14,7,17,14,19,8,5,-10,14,7,8,6,1,-3,3,7,11,2,4,-7,4,3,3,3,5,1,5,3,1,1,3,1,-1,0,2,2,2,0,-9,-9,0,13,6,7,-1,-1,-1,-9,3,-1,1,-1,-1,-6,-2,0,-2,0,0,-3,5,-1,3,0,2,4,3,1,2,0,1,1,1,1,1,0,1,3,2,0,-11,-3,-8,22,14,8,-11,7,-4,-9,5,2,-5,4,1,-8,4,1,-6,3,-5,-1,1,1,3,5,2,6,3,3,2,3,2,3,2,2,1,2,0,3,1,1,-20,-9,-11,28,14,14,-9,-3,-8,-5,-1,5,-6,-1,1,-1,-3,1,-3,-2,-9,-4,2,4,6,5,3,5,6,2,4,4,2,2,2,0,2,1,1,3,4,2
30,30033,Puerto Lumbreras,10658,184,123,61,194,126,68,-16,92,63,22,11,11,-9,58,50,7,6,10,-7,34,13,15,5,1,8,72,74,28,6,5,4,47,53,16,3,3,4,25,21,12,3,2,340,242,98,243,185,58,39,111,134,23,13,14,23,83,95,27,3,8,16,28,39,-4,10,6,26,89,98,25,3,0,15,68,81,19,1,0,11,21,17,6,2,0,314,177,137,247,158,89,78,84,81,51,18,-2,42,52,46,24,10,0,36,32,35,27,8,-2,54,71,73,36,9,2,30,51,49,22,5,0,24,20,24,14,4,2,281,131,150,277,142,135,68,41,80,32,34,22,30,12,44,13,13,15,38,29,36,19,21,7,73,58,82,36,20,7,27,31,51,19,9,5,46,27,31,17,11,2,408,212,196,276,159,117,90,96,102,70,37,6,42,56,50,39,18,2,48,40,52,31,19,4,60,69,61,48,33,4,30,44,39,30,15,1,30,25,22,18,18,3,383,196,187,233,133,100,62,86,108,57,47,20,31,35,54,34,27,15,31,51,54,23,20,5,33,68,58,36,26,11,18,39,31,25,13,7,15,29,27,11,13,4,432,220,212,217,95,122,107,90,126,49,43,7,53,35,67,32,19,9,54,55,59,17,24,-2,45,66,48,28,19,7,12,25,25,16,9,6,33,41,23,12,10,1,488,264,224,229,123,106,78,129,135,90,36,14,40,57,88,51,14,10,38,72,47,39,22,4,44,71,46,41,17,6,26,35,27,22,5,5,18,36,19,19,12,1,228,125,103,158,71,87,33,46,65,51,32,0,11,16,52,31,16,-3,22,30,13,20,16,3,42,37,36,20,17,4,22,17,15,9,6,0,20,20,21,11,11,4,148,82,66,57,27,30,9,33,56,21,8,15,8,10,31,12,8,11,1,23,25,9,0,4,14,18,15,4,3,0,10,1,10,1,3,1,4,17,5,3,0,-1,133,73,60,49,22,27,8,36,76,0,14,1,1,16,54,3,8,-6,7,20,22,-3,6,7,8,14,14,8,6,0,5,4,9,4,3,-2,3,10,5,4,3,2,273,161,112,-21,-24,3,85,52,88,37,6,2,50,37,53,20,-4,3,35,15,35,17,10,-1,10,17,-20,-26,-7,1,5,7,-14,-18,-6,0,5,10,-6,-8,-1,1,162,92,70,74,36,38,40,24,80,1,3,7,31,4,47,2,3,4,9,20,33,-1,0,3,19,17,21,7,7,1,11,6,13,1,3,1,8,11,8,6,4,0,46,18,28,-6,-10,4,4,18,25,-8,7,-2,3,2,20,-8,3,-2,1,16,5,0,4,0,7,10,-11,-15,4,-1,5,-2,-9,-9,4,0,2,12,-2,-6,0,-1,91,67,24,83,40,43,-2,31,47,-4,5,4,3,17,33,3,3,-1,-5,14,14,-7,2,5,22,33,14,4,3,3,13,11,7,2,2,1,9,22,7,2,1,2,217,119,98,135,76,59,56,48,44,32,30,1,31,27,30,16,16,1,25,21,14,16,14,0,17,39,41,16,12,8,9,22,23,12,6,3,8,17,18,4,6,5,144,80,64,123,67,56,19,42,38,41,4,4,7,20,25,28,-3,5,12,22,13,13,7,-1,20,34,30,24,10,5,7,19,20,12,6,3,13,15,10,12,4,2,-205,-105,-100,-186,-103,-83,-11,14,-27,-124,-59,-1,0,21,-4,-81,-44,3,-11,-7,-23,-43,-15,-4,-8,13,-19,-119,-55,-1,0,18,-3,-82,-36,0,-8,-5,-16,-37,-19,-1
30,30035,San Javier,18267,1320,872,448,1091,757,334,202,323,424,223,96,41,128,231,295,136,53,23,74,92,129,87,43,18,134,321,392,171,46,14,82,226,283,128,25,7,52,95,109,43,21,7,1199,617,582,870,502,368,203,266,361,190,111,56,87,152,195,90,64,24,116,114,166,100,47,32,133,237,296,133,48,17,67,146,175,73,26,12,66,91,121,60,22,5,1443,827,616,1130,669,461,301,278,352,247,202,55,180,157,210,144,105,25,121,121,142,103,97,30,290,253,295,167,91,26,167,154,186,95,50,12,123,99,109,72,41,14,1143,611,532,940,515,425,243,211,314,92,184,96,150,110,188,27,87,49,93,101,126,65,97,47,180,220,256,100,137,43,96,117,153,50,72,25,84,103,103,50,65,18,1328,713,615,989,560,429,194,314,367,230,147,65,78,179,236,100,74,35,116,135,131,130,73,30,131,272,264,138,124,49,63,164,149,81,64,29,68,108,115,57,60,20,1434,761,673,1028,571,457,280,223,453,213,209,43,118,134,249,120,98,26,162,89,204,93,111,17,180,212,234,168,180,48,104,111,137,100,86,30,76,101,97,68,94,18,1427,743,684,992,500,492,269,263,337,295,188,58,153,112,168,175,98,33,116,151,169,120,90,25,196,222,239,148,145,31,105,99,122,84,71,15,91,123,117,64,74,16,613,189,424,358,83,275,166,171,94,48,127,12,65,81,-47,10,73,7,101,90,141,38,54,5,107,172,-12,-15,92,8,57,76,-78,-29,43,11,50,96,66,14,49,-3,506,249,257,410,191,219,101,94,124,52,102,30,55,53,70,-3,65,11,46,41,54,55,37,19,100,81,82,50,76,14,55,33,36,20,36,11,45,48,46,30,40,3,203,57,146,190,30,160,7,-8,88,18,65,27,0,-42,36,5,41,13,7,34,52,13,24,14,69,24,5,22,52,3,27,-3,-19,-9,31,-3,42,27,24,31,21,6,223,141,82,27,11,16,30,17,22,54,43,59,13,-13,29,57,18,33,17,30,-7,-3,25,26,-6,11,-25,-13,41,16,-1,-10,-12,-1,24,9,-5,21,-13,-12,17,7,72,29,43,61,4,57,3,-1,-18,11,30,44,12,0,-5,-8,7,21,-9,-1,-13,19,23,23,-1,20,-15,1,27,22,6,11,-26,-10,8,12,-7,9,11,11,19,10,-7,-27,20,-37,-37,0,7,8,30,-50,18,-21,-11,-6,16,-29,3,-3,18,14,14,-21,15,-18,-13,-6,-24,-15,22,-9,-7,-9,-17,-12,8,-5,-6,3,-7,-3,14,-4,27,-39,66,-86,-91,5,-1,-30,33,-2,12,11,-17,-2,-13,-20,7,4,16,-28,46,18,5,7,-15,-3,-55,-15,-7,7,-20,2,-46,-20,-10,3,5,-5,-9,5,3,4,-122,-99,-23,-56,-44,-12,-53,-29,2,-50,9,-8,-17,-22,-22,-38,-9,8,-36,-7,24,-12,18,-16,25,4,0,-27,-24,-42,10,4,-8,-18,-20,-17,15,0,8,-9,-4,-25,-533,-338,-195,-589,-326,-263,-6,-80,-7,-73,-163,-202,-23,-53,-12,-34,-96,-109,17,-27,5,-39,-67,-93,-22,-41,-46,-109,-171,-206,-13,-24,-21,-69,-97,-103,-9,-17,-25,-40,-74,-103,-229,-148,-81,-349,-209,-140,61,1,-53,-104,-87,-62,37,15,-26,-87,-49,-49,24,-14,-27,-17,-38,-13,-14,4,-74,-116,-73,-83,-4,4,-43,-68,-45,-56,-10,0,-31,-48,-28,-27,-87,-65,-22,-120,-94,-26,9,30,32,-84,-12,-78,9,24,14,-71,-10,-41,0,6,18,-13,-2,-37,19,14,20,-65,-24,-96,17,10,9,-59,-27,-51,2,4,11,-6,3,-45
30,30036,San Pedro del Pinatar,15008,562,381,181,491,313,178,49,153,169,100,65,23,37,88,121,78,34,18,12,65,48,22,31,5,57,147,172,82,25,6,31,94,115,56,12,4,26,53,57,26,13,2,703,424,279,642,365,277,100,172,237,128,46,17,62,92,145,88,24,9,38,80,92,40,22,8,89,166,203,134,34,10,49,92,113,84,18,6,40,74,90,50,16,4,774,415,359,568,289,279,104,159,260,102,86,52,58,81,142,67,40,23,46,78,118,35,46,29,106,133,161,88,59,16,57,64,80,50,28,8,49,69,81,38,31,8,410,168,242,309,138,171,101,56,58,58,100,37,32,21,18,25,47,27,69,35,40,33,53,10,113,46,47,45,39,17,45,25,17,21,19,10,68,21,30,24,20,7,682,324,358,417,205,212,94,154,140,104,127,59,47,62,87,41,62,26,47,92,53,63,65,33,85,78,90,64,73,24,46,38,45,27,34,14,39,40,45,37,39,10,1383,827,556,854,485,369,203,283,438,235,155,68,128,158,288,146,79,30,75,125,150,89,76,38,156,199,223,132,116,24,91,110,130,79,61,12,65,89,93,53,55,12,1162,640,522,698,357,341,194,234,388,139,146,57,109,135,220,83,64,27,85,99,168,56,82,30,138,153,159,113,107,25,74,78,84,54,52,13,64,75,75,59,55,12,1022,565,457,879,470,409,158,260,303,159,112,19,89,145,179,90,47,10,69,115,124,69,65,9,144,243,249,128,95,11,74,126,145,73,40,8,70,117,104,55,55,3,136,36,100,237,106,131,-16,84,-1,34,26,11,-3,33,-7,10,1,7,-13,51,6,24,25,4,62,76,37,35,23,0,27,34,27,6,7,4,35,42,10,29,16,-4,96,63,33,199,110,89,-17,50,69,-47,17,29,-18,9,60,-23,22,15,1,41,9,-24,-5,14,29,60,53,23,21,7,8,29,39,11,17,3,21,31,14,12,4,4,15,-45,60,-15,-24,9,-3,33,-43,-4,-2,37,14,9,-34,-25,-14,7,-17,24,-9,21,12,30,7,20,-21,-16,1,-7,12,8,-20,-19,1,-6,-5,12,-1,3,0,-1,82,61,21,145,62,83,-18,13,48,-6,5,46,-2,14,36,3,7,7,-16,-1,12,-9,-2,39,23,41,43,12,16,6,8,12,28,2,8,1,15,29,15,10,8,5,-304,-181,-123,-203,-136,-67,-57,-40,-156,-87,8,36,-20,-15,-98,-55,1,7,-37,-25,-58,-32,7,29,-25,-12,-93,-56,-12,-3,-4,-7,-72,-39,-10,-2,-21,-5,-21,-17,-2,-1,161,66,95,23,15,8,29,30,19,15,27,41,13,14,6,-2,14,19,16,16,13,17,13,22,-4,20,17,-4,-2,-5,-3,13,12,-4,1,-5,-1,7,5,0,-3,0,143,62,81,64,27,37,18,32,47,-28,48,31,17,7,25,-14,22,8,1,25,22,-14,26,23,9,20,34,-9,11,-2,9,10,15,-11,6,-3,0,10,19,2,5,1,72,28,44,-39,-11,-28,5,11,27,-13,14,29,6,-13,15,-1,3,17,-1,24,12,-12,11,12,9,11,9,-11,-20,-41,4,0,10,-2,-7,-19,5,11,-1,-9,-13,-22,387,213,174,129,70,59,55,74,96,68,54,45,28,42,50,38,33,25,27,32,46,30,21,20,18,34,27,28,7,12,8,12,21,18,4,6,10,22,6,10,3,6,386,205,181,185,112,73,98,53,100,70,42,21,71,29,46,39,23,5,27,24,54,31,19,16,30,41,49,33,20,10,13,20,34,24,15,6,17,21,15,9,5,4
30,30901,Santomera,10594,512,281,231,301,169,132,41,152,220,65,12,13,20,80,127,41,2,7,21,72,93,24,10,6,43,73,132,42,9,1,21,40,79,26,3,0,22,33,53,16,6,1,420,235,185,300,162,138,67,116,138,58,27,5,34,65,85,28,12,5,33,51,53,30,15,0,62,74,100,47,10,2,32,41,56,26,5,0,30,33,44,21,5,2,221,112,109,169,88,81,32,91,59,30,10,-2,23,39,27,18,4,-1,9,52,32,12,6,-1,35,57,48,23,4,0,20,27,28,11,1,0,15,30,20,12,3,0,289,141,148,170,91,79,43,77,102,27,18,9,15,34,61,16,6,5,28,43,41,11,12,4,40,50,40,32,4,2,20,33,19,15,2,1,20,17,21,17,2,1,433,232,201,221,155,66,62,105,178,44,26,6,27,60,97,30,12,4,35,45,81,14,14,2,29,66,73,36,11,6,17,43,60,27,5,3,12,23,13,9,6,3,365,198,167,220,127,93,19,106,150,68,3,11,9,52,84,39,-2,9,10,54,66,29,5,2,25,74,74,39,3,3,12,43,42,24,3,1,13,31,32,15,0,2,354,176,178,218,106,112,47,124,129,28,11,0,26,68,67,5,3,1,21,56,62,23,8,-1,42,79,67,28,1,1,20,45,32,7,1,1,22,34,35,21,0,0,430,198,232,282,139,143,70,151,148,20,13,17,44,67,69,7,2,5,26,84,79,13,11,12,64,96,78,34,8,0,40,45,35,17,0,2,24,51,43,17,8,-2,197,106,91,136,66,70,-10,96,81,-2,8,14,-14,36,54,6,8,9,4,60,27,-8,0,5,30,48,31,13,6,4,14,18,22,5,1,2,16,30,9,8,5,2,111,54,57,89,29,60,10,38,79,-12,-10,3,1,22,49,-7,-4,-6,9,16,30,-5,-6,9,24,26,27,8,-4,3,12,9,9,0,-3,1,12,17,18,8,-1,2,46,51,-5,2,1,1,5,28,43,-23,-15,1,11,22,26,-6,-12,3,-6,6,17,-17,-3,-2,0,11,2,-5,-2,-5,2,7,-1,-7,1,-2,-2,4,3,2,-3,-3,-67,-51,-16,-33,-24,-9,-6,6,-27,-45,-8,12,-2,0,-13,-28,-11,4,-4,6,-14,-17,3,8,4,12,-29,-20,-5,5,3,5,-16,-15,-3,2,1,7,-13,-5,-2,3,23,38,-15,8,8,0,-1,-1,6,-11,12,12,12,-4,8,-3,10,10,-13,3,-2,-8,2,2,2,7,-5,-3,4,1,7,0,-5,0,2,2,-5,7,0,-3,2,-1,-46,-17,-29,-22,-3,-19,-29,-4,-17,-9,8,9,-15,-5,3,2,-2,3,-14,1,-20,-11,10,6,-8,-1,-11,-3,4,0,-3,-2,-2,6,1,-1,-5,1,-9,-9,3,1,131,79,52,65,34,31,48,23,44,13,10,-7,20,8,12,25,14,-2,28,15,32,-12,-4,-5,8,6,20,25,2,3,2,2,9,17,1,2,6,4,11,8,1,1,-158,-113,-45,-76,-52,-24,-28,15,-53,-46,-24,-20,-15,9,-42,-44,-14,-6,-13,6,-11,-2,-10,-14,-8,-2,-22,-27,-11,-7,-6,0,-10,-25,-7,-5,-2,-2,-12,-2,-4,-2,99,53,46,60,26,34,17,8,56,3,10,4,-4,-3,29,23,3,1,21,11,27,-20,7,3,5,11,23,13,3,4,-4,8,14,7,-1,1,9,3,9,6,4,3,-73,-95,22,-16,-19,3,-10,21,-20,-50,-15,-4,-25,6,-13,-47,-10,-8,15,15,-7,-3,-5,4,4,26,-7,-23,-14,-3,7,11,-4,-19,-10,-5,-3,15,-3,-4,-4,2
30,30037,Torre-Pacheco,21937,1132,716,416,1360,955,405,89,432,427,157,14,4,53,265,281,105,0,6,36,167,146,52,14,-2,105,437,573,211,23,5,62,298,415,161,11,3,43,139,158,50,12,2,1201,723,478,1340,873,467,188,345,423,163,50,23,107,213,266,94,24,11,81,132,157,69,26,12,197,381,518,192,39,5,110,251,354,130,19,3,87,130,164,62,20,2,799,392,407,1051,636,415,206,281,187,67,17,25,120,152,77,23,-2,13,86,129,110,44,19,12,232,305,332,140,23,6,123,190,220,84,9,3,109,115,112,56,14,3,-73,-192,119,530,289,241,101,-11,-117,-37,5,-3,59,-33,-144,-64,-2,-1,42,22,27,27,7,-2,144,157,134,74,15,4,79,93,71,36,9,1,65,64,63,38,6,3,46,-138,184,369,213,156,99,24,-133,8,28,20,37,-26,-160,-19,16,12,62,50,27,27,12,8,83,85,79,69,37,7,39,45,47,50,26,2,44,40,32,19,11,5,641,355,286,749,460,289,99,230,232,29,52,1,46,124,156,6,14,5,53,106,76,23,38,-4,144,194,214,99,71,12,76,112,155,66,32,9,68,82,59,33,39,3,582,292,290,577,315,262,137,165,124,42,81,30,79,106,41,9,44,14,58,59,83,33,37,16,109,162,137,81,71,13,60,95,70,42,40,6,49,67,67,39,31,7,210,-133,343,231,23,208,245,31,-74,-119,73,36,155,-16,-160,-161,27,15,90,47,86,42,46,21,131,116,-29,-68,61,15,82,56,-66,-85,23,9,49,60,37,17,38,6,723,338,385,616,306,310,153,168,135,150,62,36,95,90,31,72,24,16,58,78,104,78,38,20,160,145,103,100,74,19,93,75,47,38,32,13,67,70,56,62,42,6,625,292,333,306,107,199,148,165,149,63,82,21,54,74,58,39,43,21,94,91,91,24,39,0,104,63,31,25,67,9,49,21,-6,0,32,8,55,42,37,25,35,1,623,353,270,405,251,154,99,116,164,103,109,15,38,46,119,61,68,11,61,70,45,42,41,4,52,67,94,87,89,9,35,39,64,46,55,5,17,28,30,41,34,4,423,201,222,334,183,151,103,61,147,24,65,16,63,23,65,5,27,5,40,38,82,19,38,11,67,52,77,46,72,14,35,31,45,25,34,7,32,21,32,21,38,7,-129,-93,-36,-145,-151,6,-23,4,-51,-98,20,22,-13,-9,-22,-71,2,21,-10,13,-29,-27,18,1,-13,-3,-98,-93,42,14,-8,-15,-72,-81,13,10,-5,12,-26,-12,29,4,130,40,90,-40,-47,7,50,9,13,-34,47,33,4,0,13,-40,36,17,46,9,0,6,11,16,-8,19,-70,-37,28,18,-9,12,-50,-37,20,8,1,7,-20,0,8,10,257,167,90,350,209,141,60,52,37,32,67,5,35,21,25,31,47,6,25,31,12,1,20,-1,47,57,83,73,66,13,23,26,61,43,42,9,24,31,22,30,24,4,20,-21,41,111,55,56,7,1,6,-29,32,-3,-15,26,-27,-28,14,8,22,-25,33,-1,18,-11,17,19,10,-3,44,15,5,21,7,-19,23,13,12,-2,3,16,21,2,275,179,96,183,111,72,112,94,100,-18,-9,-10,72,79,63,-18,-18,-7,40,15,37,0,9,-3,60,91,87,-24,-26,-15,35,61,64,-19,-27,-8,25,30,23,-5,1,-7,-156,-155,-1,42,2,40,8,3,-31,-45,-41,-57,26,-8,-47,-49,-51,-29,-18,11,16,4,10,-28,34,34,40,-17,-6,-51,22,30,19,-29,-18,-27,12,4,21,12,12,-24
30,30038,"Torres de Cotillas, Las",15617,350,254,96,205,149,56,60,86,127,45,16,9,35,63,101,32,17,2,25,23,26,13,-1,7,9,68,92,27,5,4,3,49,73,18,4,2,6,19,19,9,1,2,203,126,77,190,122,68,11,57,78,41,10,3,9,25,53,29,10,-1,2,32,25,12,0,4,23,59,62,28,8,8,12,36,44,21,5,4,11,23,18,7,3,4,379,214,165,205,112,93,91,81,119,66,6,9,50,30,86,43,0,2,41,51,33,23,6,7,53,52,59,22,17,2,23,28,39,15,6,1,30,24,20,7,11,1,386,233,153,154,81,73,96,93,121,49,7,2,58,55,72,30,0,4,38,38,49,19,7,-2,43,39,45,23,4,0,20,22,26,12,1,0,23,17,19,11,3,0,441,248,193,139,104,35,77,57,197,75,21,3,32,32,116,56,9,-1,45,25,81,19,12,4,11,43,59,22,3,1,9,30,46,16,3,0,2,13,13,6,0,1,519,277,242,138,73,65,84,103,185,108,27,0,46,51,109,53,15,1,38,52,76,55,12,-1,25,41,38,23,7,4,9,21,24,13,5,1,16,20,14,10,2,3,802,476,326,222,137,85,119,161,324,140,30,11,61,99,203,85,15,9,58,62,121,55,15,2,30,73,76,31,9,2,15,46,53,19,2,1,15,27,23,12,7,1,627,395,232,284,210,74,100,141,256,89,20,9,57,95,180,47,11,4,43,46,76,42,9,5,51,80,122,23,2,4,31,66,98,11,-1,4,20,14,24,12,3,0,475,279,196,303,194,109,109,103,193,60,7,0,54,70,109,36,4,3,55,33,84,24,3,-3,56,75,115,46,5,1,26,53,78,30,4,0,30,22,37,16,1,1,89,37,52,10,5,5,28,26,30,6,-13,9,25,2,14,-4,-4,4,3,24,16,10,-9,5,7,14,-10,-2,-4,3,10,7,-9,-3,-2,1,-3,7,-1,1,-2,2,-34,-36,2,20,-4,24,45,7,-83,-7,-4,1,33,-6,-69,-1,6,0,12,13,-14,-6,-10,1,16,9,-20,7,4,2,7,2,-22,3,3,1,9,7,2,4,1,1,-1,-86,85,-48,-58,10,8,-17,17,-21,-2,10,-1,-13,-19,-48,-7,4,9,-4,36,27,5,6,-2,-1,-19,-28,0,0,-5,-3,-24,-25,-1,0,3,2,5,-3,1,0,-138,-91,-47,-46,-29,-17,-25,-8,-60,-24,-10,-8,-16,-9,-40,-8,-5,-7,-9,1,-20,-16,-5,-1,-6,-3,-10,-22,-5,-1,-1,-4,-8,-15,-1,-1,-5,1,-2,-7,-4,0,-200,-109,-91,-141,-89,-52,-16,-49,-83,-45,-6,-8,0,-24,-68,-25,3,-4,-16,-25,-15,-20,-9,-4,-19,-13,-52,-49,-7,-2,-7,-6,-36,-36,-4,0,-12,-7,-16,-13,-3,-2,-54,-52,-2,52,39,13,2,-15,-28,-22,0,-2,-4,-18,-29,-9,1,-1,6,3,1,-13,-1,-1,6,5,15,15,6,2,4,3,11,13,6,1,2,2,4,2,0,1,-57,-31,-26,-10,-16,6,28,-13,-49,-6,-18,2,21,-11,-16,-11,-13,0,7,-2,-33,5,-5,2,5,-1,-9,-8,2,2,5,0,-12,-8,0,0,0,-1,3,0,2,2,92,65,27,34,23,11,11,-3,47,23,16,-8,-2,4,25,22,14,-3,13,-7,22,1,2,-5,-3,15,11,8,2,3,-1,8,6,7,2,2,-2,7,5,1,0,1,-43,-7,-36,85,50,35,-8,-12,12,-8,-18,-2,-1,1,11,5,-15,-3,-7,-13,1,-13,-3,1,18,17,33,17,0,0,10,11,21,11,-3,0,8,6,12,6,3,0
30,30039,Totana,21973,1326,854,472,1385,888,497,105,497,499,184,13,16,51,294,348,137,9,8,54,203,151,47,4,8,98,504,551,190,20,10,48,308,367,139,14,5,50,196,184,51,6,5,1394,844,550,1346,852,494,168,512,470,180,34,30,76,302,312,121,17,16,92,210,158,59,17,14,150,494,480,191,22,7,69,315,321,129,13,4,81,179,159,62,9,3,817,482,335,890,540,350,215,270,226,72,37,-7,120,172,126,45,21,-4,95,98,100,27,16,-3,220,273,265,94,26,5,126,169,162,62,16,2,94,104,103,32,10,3,580,261,319,730,403,327,194,152,110,84,23,9,95,56,48,38,16,5,99,96,62,46,7,4,200,210,187,99,23,0,102,108,113,63,12,0,98,102,74,36,11,0,994,572,422,861,541,320,65,397,341,133,47,7,31,214,212,86,22,5,34,183,129,47,25,2,62,319,306,127,31,11,35,194,209,84,13,5,27,125,97,43,18,6,673,400,273,410,244,166,77,263,194,85,34,0,29,166,136,41,15,3,48,97,58,44,19,-3,51,180,108,47,12,8,24,103,86,20,3,6,27,77,22,27,9,2,781,443,338,657,372,285,124,278,228,105,19,20,71,161,135,54,12,10,53,117,93,51,7,10,105,284,172,74,18,1,59,168,101,36,9,-1,46,116,71,38,9,2,426,189,237,442,241,201,53,248,62,-2,54,2,22,131,24,-22,29,4,31,117,38,20,25,-2,55,261,106,-9,28,-3,23,157,62,-14,10,1,32,104,44,5,18,-4,593,319,274,510,298,212,129,192,139,71,44,12,72,90,77,57,20,2,57,102,62,14,24,10,115,155,151,58,23,6,58,84,107,34,10,4,57,71,44,24,13,2,420,259,161,220,139,81,98,78,151,50,31,14,38,60,99,34,18,6,60,18,52,16,13,8,51,67,48,26,20,7,27,41,37,20,12,2,24,26,11,6,8,5,176,133,43,88,55,33,30,41,25,58,4,21,12,27,39,44,4,11,18,14,-14,14,0,10,14,24,20,23,7,2,11,16,18,10,4,-1,3,8,2,13,3,3,389,220,169,45,13,32,69,97,149,53,15,1,38,45,89,33,7,5,31,52,60,20,8,-4,11,41,-19,-4,9,5,1,20,-11,-4,2,3,10,21,-8,0,7,2,181,73,108,-65,-68,3,83,24,32,9,10,17,50,7,13,-3,-4,4,33,17,19,12,14,13,-3,23,-56,-38,-1,10,4,10,-49,-35,-4,4,-7,13,-7,-3,3,6,195,123,72,72,35,37,17,66,71,31,8,-1,16,48,45,14,4,-2,1,18,26,17,4,1,3,31,17,8,10,2,1,19,11,1,2,2,2,12,6,7,8,0,135,49,86,-40,-31,-9,64,61,9,11,-11,-3,50,24,-25,-1,-5,-2,14,37,34,12,-6,-1,8,28,-26,-44,-13,5,10,13,-20,-27,-11,1,-2,15,-6,-17,-2,4,146,96,50,172,105,67,6,58,50,0,18,7,7,35,30,6,12,2,-1,23,20,-6,6,5,25,59,50,31,4,3,10,30,36,26,1,2,15,29,14,5,3,1,315,152,163,183,91,92,107,72,78,46,19,-7,52,32,29,22,14,0,55,40,49,24,5,-7,49,81,50,-9,12,-1,25,39,29,-11,8,0,24,42,21,2,4,-1,344,184,160,368,211,157,60,128,106,39,12,-1,19,74,74,14,0,1,41,54,32,25,12,-2,67,119,133,23,18,6,33,72,88,12,3,2,34,47,45,11,15,4
30,30041,"Unión, La",14386,96,75,21,102,75,27,19,21,53,11,1,-5,14,19,41,8,0,-1,5,2,12,3,1,-4,15,21,45,15,4,1,7,18,37,10,2,0,8,3,8,5,2,1,70,52,18,146,91,55,16,31,-11,27,13,-8,10,28,-10,22,7,-7,6,3,-1,5,6,-1,23,36,47,30,5,3,13,25,30,19,2,1,10,11,17,11,3,2,74,39,35,146,79,67,18,41,13,9,0,-8,5,17,20,2,-1,-4,13,24,-7,7,1,-4,39,42,40,20,4,1,19,20,27,12,1,0,20,22,13,8,3,1,94,47,47,136,68,68,42,49,-12,8,0,-1,25,25,-15,3,1,2,17,24,3,5,-1,-3,45,50,18,12,7,1,22,31,5,5,4,0,23,19,13,7,3,1,193,116,77,124,67,57,42,70,36,25,6,-2,21,43,21,23,3,-3,21,27,15,2,3,1,33,33,21,15,9,2,20,22,9,5,5,1,13,11,12,10,4,1,298,142,156,177,95,82,90,60,81,54,25,-24,36,12,50,28,17,-11,54,48,31,26,8,-13,42,44,39,27,10,1,22,17,25,14,7,1,20,27,14,13,3,0,296,136,160,106,49,57,47,57,140,37,10,1,16,21,80,13,1,2,31,36,60,24,9,-1,18,32,32,13,10,3,8,15,19,5,2,1,10,17,13,8,8,2,437,223,214,117,55,62,93,109,117,83,33,2,43,46,63,53,13,6,50,63,54,30,20,-4,27,42,13,15,14,4,16,21,5,3,6,3,11,21,8,12,8,1,458,217,241,122,58,64,84,91,206,78,10,-13,37,35,108,31,5,-2,47,56,98,47,5,-11,38,25,38,17,3,0,18,9,24,4,2,1,20,16,14,13,1,-1,384,198,186,113,54,59,38,105,165,45,32,-2,21,42,94,23,21,-2,17,63,71,22,11,0,17,30,24,23,15,2,11,15,11,10,6,1,6,15,13,13,9,1,217,120,97,34,9,25,6,36,103,50,22,-2,14,14,54,26,11,0,-8,22,49,24,11,-2,3,7,12,0,4,5,-1,2,7,-4,3,1,4,5,5,4,1,4,41,0,41,24,1,23,-9,14,53,-9,-3,-16,-14,6,19,-8,1,-9,5,8,34,-1,-4,-7,5,6,12,-5,7,-1,3,1,-2,-6,6,-1,2,5,14,1,1,0,77,48,29,-18,-10,-8,-13,45,54,1,6,-10,4,19,18,13,1,-3,-17,26,36,-12,5,-7,-8,5,-10,-8,3,0,0,2,-8,-6,2,0,-8,3,-2,-2,1,0,70,39,31,8,2,6,-8,27,24,7,11,-5,-6,10,27,-2,3,-2,-2,17,-3,9,8,-3,1,8,1,-4,3,-1,1,2,1,-2,1,-1,0,6,0,-2,2,0,-23,18,-41,10,9,1,-38,5,30,0,-8,3,-19,-3,49,-2,-5,1,-19,8,-19,2,-3,2,-5,5,4,-1,5,1,-3,3,7,2,0,0,-2,2,-3,-3,5,1,-39,-5,-34,24,9,15,1,-17,2,-18,1,-1,9,-5,12,-19,2,2,-8,-12,-10,1,-1,-3,13,3,10,1,-4,-1,8,-4,10,-2,-4,0,5,7,0,3,0,-1,51,32,19,74,29,45,-42,41,25,-5,20,1,-24,11,23,2,13,-2,-18,30,2,-7,7,3,14,20,26,7,4,4,8,7,14,-2,4,-1,6,13,12,9,0,5,0,-27,27,79,46,33,-7,18,-21,9,-2,4,-8,4,-12,-6,0,3,1,14,-9,15,-2,1,6,21,22,19,3,5,5,10,17,10,2,1,1,11,5,9,1,4
30,30042,Villanueva del Río Segura,1555,-7,0,-7,12,3,9,1,-1,-12,0,3,5,6,2,-9,-2,2,2,-5,-3,-3,2,1,3,3,2,3,3,1,0,0,1,1,0,1,0,3,1,2,3,0,0,21,10,11,6,4,2,10,8,1,0,-2,6,4,4,1,1,-2,2,6,4,0,-1,0,4,1,3,0,2,0,0,1,1,0,2,0,0,0,2,0,0,0,0,25,5,20,10,4,6,11,3,8,-3,2,4,4,0,4,-5,0,2,7,3,4,2,2,2,3,1,4,2,0,0,2,0,1,1,0,0,1,1,3,1,0,0,164,67,97,12,4,8,28,29,34,44,14,11,11,7,13,25,7,3,17,22,21,19,7,8,6,3,2,1,0,0,1,1,1,1,0,0,5,2,1,0,0,0,67,38,29,13,9,4,-3,5,7,-2,0,62,-1,4,13,2,0,20,-2,1,-6,-4,0,42,2,3,4,3,0,0,1,1,3,3,0,0,1,2,1,0,0,0,74,27,47,17,9,8,11,14,10,18,2,17,3,10,3,11,0,-1,8,4,7,7,2,18,1,2,7,3,4,0,1,1,4,1,2,0,0,1,3,2,2,0,186,105,81,17,6,11,48,19,50,31,17,16,32,9,27,16,10,8,16,10,23,15,7,8,6,1,3,2,4,1,2,0,1,0,2,1,4,1,2,2,2,0,136,70,66,8,5,3,44,25,29,29,-2,13,24,10,21,13,-1,3,20,15,8,16,-1,10,0,4,1,3,0,0,0,2,0,3,0,0,0,2,1,0,0,0,107,48,59,11,5,6,3,11,45,19,5,21,-3,8,18,14,3,6,6,3,27,5,2,15,2,4,1,4,0,0,1,2,1,1,0,0,1,2,0,3,0,0,91,41,50,4,1,3,29,5,7,23,4,21,20,3,1,10,3,4,9,2,6,13,1,17,0,1,1,0,1,0,0,0,1,0,0,0,0,1,0,0,1,0,44,24,20,9,6,3,8,25,-5,15,5,-2,4,14,1,5,3,0,4,11,-6,10,2,-2,1,1,4,1,1,0,1,1,3,0,1,0,0,0,1,1,0,0,71,30,41,18,9,9,-3,22,25,12,1,12,-4,11,13,5,-1,5,1,11,12,7,2,7,2,7,4,5,0,0,0,5,1,4,-1,0,2,2,3,1,1,0,41,14,27,8,5,3,8,-2,26,-6,3,10,-4,-7,14,4,-1,4,12,5,12,-10,4,6,-1,4,4,-1,0,0,0,1,2,0,0,0,-1,3,2,-1,0,0,-4,13,-17,-2,0,-2,-3,5,-12,0,9,-3,5,3,-2,-3,10,1,-8,2,-10,3,-1,-4,0,-1,0,-1,0,0,0,-1,1,0,0,0,0,0,-1,-1,0,0,79,35,44,-1,0,-1,7,18,31,8,-4,16,-2,13,17,8,-5,2,9,5,14,0,1,14,-3,0,0,-3,3,1,-2,1,1,-2,1,0,-1,-1,-1,-1,2,1,42,11,31,5,6,-1,11,7,10,-5,2,17,11,4,-2,-9,0,8,0,3,12,4,2,9,-2,4,3,-1,1,0,-2,2,5,0,1,0,0,2,-2,-1,0,0,103,45,58,13,5,8,1,5,18,23,10,40,-3,4,16,6,4,15,4,1,2,17,6,25,0,3,6,1,2,1,0,1,3,0,0,1,0,2,3,1,2,0,123,69,54,26,20,6,7,15,48,23,9,16,7,14,23,16,7,1,0,1,25,7,2,15,1,12,8,3,0,1,1,6,7,3,0,2,0,6,1,0,0,-1
30,30043,Yecla,28772,1441,896,545,1350,829,521,85,579,575,189,16,-10,37,353,364,135,7,-1,48,226,211,54,9,-9,89,519,523,190,19,2,41,310,341,122,12,1,48,209,182,68,7,1,598,292,306,649,341,308,148,203,177,42,24,5,67,109,88,20,9,3,81,94,89,22,15,2,168,216,181,65,15,2,85,121,92,33,8,2,83,95,89,32,7,0,549,293,256,572,300,272,159,187,138,43,6,4,82,90,89,23,-3,4,77,97,49,20,9,0,155,161,152,69,14,6,76,86,83,41,4,2,79,75,69,28,10,4,587,306,281,583,314,269,141,197,141,58,33,9,85,105,70,20,14,3,56,92,71,38,19,6,156,170,157,63,29,5,89,94,84,32,10,3,67,76,73,31,19,2,343,162,181,245,112,133,92,104,89,40,20,-7,41,54,39,19,10,-4,51,50,50,21,10,-3,30,77,85,32,18,1,15,36,38,14,6,1,15,41,47,18,12,0,150,84,66,305,153,152,28,61,53,-2,18,-4,21,40,22,-3,13,-4,7,21,31,1,5,0,75,84,86,36,20,2,44,40,41,18,10,0,31,44,45,18,10,2,448,230,218,463,235,228,82,141,117,71,25,8,48,63,55,44,7,7,34,78,62,27,18,1,82,116,144,82,31,5,41,54,72,49,15,2,41,62,72,33,16,3,492,252,240,439,224,215,114,177,120,44,15,17,41,96,86,10,7,11,73,81,34,34,8,6,102,153,99,54,21,4,41,77,60,27,12,4,61,76,39,27,9,0,-77,-44,-33,139,50,89,13,-11,-49,-31,-5,10,5,-4,-26,-16,-1,5,8,-7,-23,-15,-4,5,42,49,37,12,0,-3,18,17,15,5,-4,-1,24,32,22,7,4,-2,-304,-167,-137,-102,-82,-20,-77,-41,-109,-85,6,4,-41,-20,-54,-49,1,-2,-36,-21,-55,-36,5,6,-10,-7,-50,-29,-7,-1,-11,-10,-31,-21,-6,-3,1,3,-19,-8,-1,2,-310,-178,-132,-215,-130,-85,-50,-34,-134,-80,-23,8,-23,-17,-69,-62,-12,2,-27,-17,-65,-18,-11,6,-25,-13,-92,-66,-9,-10,-12,-9,-56,-43,-5,-5,-13,-4,-36,-23,-4,-5,-305,-153,-152,-171,-102,-69,-80,-46,-91,-85,-10,9,-38,-14,-42,-53,-10,5,-42,-32,-49,-32,0,4,-55,-17,-45,-36,-16,-3,-24,-11,-23,-30,-14,0,-31,-6,-22,-6,-2,-3,-319,-205,-114,-178,-129,-49,-92,-39,-83,-86,-19,2,-59,-39,-50,-48,-13,6,-33,0,-33,-38,-6,-4,-36,-5,-45,-78,-15,-2,-22,-6,-35,-52,-14,-2,-14,1,-10,-26,-1,0,-254,-122,-132,-175,-102,-73,-2,-34,-70,-116,-38,7,-1,-7,-35,-66,-16,3,-1,-27,-35,-50,-22,4,-18,-20,-49,-67,-22,-2,-7,-11,-28,-43,-12,-2,-11,-9,-21,-24,-10,0,-111,-71,-40,-70,-46,-24,-14,-5,-42,-49,-26,20,0,-10,-29,-28,-10,5,-14,5,-13,-21,-16,15,1,-4,-29,-37,-7,3,2,-7,-21,-20,-2,1,-1,3,-8,-17,-5,2,-128,-44,-84,-39,-16,-23,-24,-28,-45,-32,0,2,-8,-15,-5,-11,-7,2,-16,-13,-40,-21,7,0,-14,-1,-3,-25,9,-5,-5,1,1,-11,0,-2,-9,-2,-4,-14,9,-3,75,80,-5,107,59,48,35,15,17,2,-4,0,22,24,17,4,3,5,13,-9,0,-2,-7,-5,36,34,21,1,8,4,20,17,23,-8,2,4,16,17,-2,9,6,0,68,13,55,80,27,53,38,1,6,-24,19,22,10,3,8,-15,-7,11,28,-2,-2,-9,26,11,35,20,17,-15,16,5,21,11,10,-20,-1,4,14,9,7,5,17,1
31,31006,Ablitas,2311,9,16,-7,28,19,9,-7,12,-2,5,3,-2,3,9,-1,4,1,-1,-10,3,-1,1,2,-1,3,12,6,6,1,0,3,7,5,4,0,0,0,5,1,2,1,0,29,11,18,36,18,18,9,5,9,-2,3,2,3,5,1,-2,2,0,6,0,8,0,1,2,11,9,13,1,1,0,5,5,7,0,0,0,6,4,6,1,1,0,64,39,25,31,13,18,21,13,24,6,1,-3,15,5,17,3,1,-3,6,8,7,3,0,0,14,11,5,1,0,-1,9,3,3,-1,0,-1,5,8,2,2,0,0,39,18,21,28,17,11,17,8,8,4,4,-2,5,9,-1,4,3,-2,12,-1,9,0,1,0,5,11,8,3,0,0,1,8,5,2,0,0,4,3,3,1,0,0,-15,-10,-5,4,4,0,-1,-4,-14,5,-2,3,-5,-3,-7,5,-1,2,4,-1,-7,0,-1,1,1,0,1,1,1,0,1,0,1,1,1,0,0,0,0,0,0,0,10,10,0,12,5,7,4,3,-4,4,0,3,0,4,-2,3,2,3,4,-1,-2,1,-2,0,4,2,1,3,1,1,1,1,0,1,1,1,3,1,1,2,0,0,24,6,18,21,11,10,6,6,0,5,4,1,4,0,-4,1,2,2,2,6,4,4,2,-1,9,4,6,0,2,0,5,3,2,0,1,0,4,1,4,0,1,0,46,25,21,34,12,22,32,5,-3,12,2,-3,14,4,-2,9,2,-2,18,1,-1,3,0,-1,18,6,2,4,4,-1,4,4,0,3,2,-1,14,2,2,1,2,0,20,21,-1,15,6,9,-10,10,17,3,5,-2,-3,3,14,7,2,-2,-7,7,3,-4,3,0,3,3,4,1,4,0,1,2,2,0,1,0,2,1,2,1,3,0,44,14,30,13,7,6,13,2,17,4,6,1,6,0,7,4,-3,-1,7,2,10,0,9,2,5,2,1,1,3,1,5,0,0,1,1,0,0,2,1,0,2,1,14,14,0,5,5,0,-1,6,16,1,-8,-5,2,1,10,4,-2,-4,-3,5,6,-3,-6,-1,-1,2,5,0,1,-2,0,1,4,0,1,-1,-1,1,1,0,0,-1,5,8,-3,13,4,9,-2,-7,13,-12,5,3,1,-3,6,-1,2,1,-3,-4,7,-11,3,2,4,0,8,-2,0,0,1,-1,3,0,0,0,3,1,5,-2,0,0,-40,-29,-11,4,0,4,-11,-7,-12,-6,-3,-2,-6,-2,-9,-8,-2,-2,-5,-5,-3,2,-1,0,-1,1,2,1,0,0,0,0,1,-1,0,0,-1,1,1,2,0,0,-36,-14,-22,-3,-1,-2,-13,0,-17,-2,-5,0,-7,2,-7,-2,-1,0,-6,-2,-10,0,-4,0,-2,0,-5,3,0,1,0,2,-2,0,-1,0,-2,-2,-3,3,1,1,-15,-6,-9,-6,-2,-4,-3,-10,-2,-1,3,-1,2,-5,-2,-2,1,1,-5,-5,0,1,2,-2,-2,-2,-3,1,1,-1,0,-2,-1,1,1,-1,-2,0,-2,0,0,0,-11,-13,2,-16,-13,-3,3,3,1,-10,-4,-3,1,1,-4,-6,-4,-1,2,2,5,-4,0,-2,-3,-2,-4,-5,-3,1,-2,0,-4,-4,-3,0,-1,-2,0,-1,0,1,26,12,14,21,10,11,11,7,-1,14,2,-6,2,2,0,10,3,-5,9,5,-1,4,-1,-1,7,10,0,3,2,-1,5,2,-1,2,2,0,2,8,1,1,0,-1,-11,2,-13,-11,-6,-5,1,-5,1,-10,2,-1,4,1,-1,-2,1,0,-3,-6,2,-8,1,-1,-6,3,-4,-3,-1,0,-6,1,-1,0,0,0,0,2,-3,-3,-1,0
31,31023,Aranguren,3485,192,95,97,43,20,23,53,26,55,35,10,13,35,12,19,17,5,6,18,14,36,18,5,7,9,8,15,9,1,1,4,4,6,5,0,1,5,4,9,4,1,0,241,111,130,13,7,6,50,47,77,46,7,11,22,19,36,25,8,0,28,28,41,21,-1,11,5,4,3,1,0,0,2,3,1,1,0,0,3,1,2,0,0,0,302,164,138,13,8,5,76,47,89,61,17,10,39,26,46,39,9,5,37,21,43,22,8,5,3,3,-1,6,1,0,3,1,0,3,1,0,0,2,-1,3,0,0,542,257,285,13,6,7,160,55,124,162,24,10,78,23,47,87,14,5,82,32,77,75,10,5,0,7,6,0,-1,1,0,3,2,0,0,1,0,4,4,0,-1,0,453,228,225,27,8,19,127,47,143,104,23,4,65,23,68,54,13,-2,62,24,75,50,10,6,8,5,4,11,-1,1,4,0,2,4,-1,0,4,5,2,7,0,1,261,126,135,26,12,14,88,43,71,40,6,4,35,24,35,28,-1,-1,53,19,36,12,7,5,8,11,4,2,1,0,3,5,1,3,0,0,5,6,3,-1,1,0,310,168,142,30,14,16,89,32,60,87,10,14,65,18,29,35,6,7,24,14,31,52,4,7,6,4,11,9,0,0,3,2,6,2,1,0,3,2,5,7,-1,0,260,132,128,43,28,15,49,35,52,75,27,17,36,19,19,43,5,5,13,16,33,32,22,12,6,12,14,6,2,1,8,6,7,6,1,0,-2,6,7,0,1,1,238,120,118,31,10,21,72,28,63,63,11,0,38,8,35,33,4,0,34,20,28,30,7,0,14,6,6,9,-5,0,8,1,1,2,-3,0,6,5,5,7,-2,0,104,78,26,-17,-9,-8,36,2,28,25,-2,11,23,7,26,17,-2,6,13,-5,2,8,0,5,4,-2,-6,-12,-2,-1,2,-2,-1,-8,-1,-1,2,0,-5,-4,-1,0,188,96,92,21,7,14,53,4,86,32,-2,6,33,6,49,10,-5,-1,20,-2,37,22,3,7,5,8,11,-3,1,-1,1,4,4,-1,0,-1,4,4,7,-2,1,0,429,182,247,12,7,5,78,28,245,49,7,6,40,2,105,20,5,-1,38,26,140,29,2,7,5,5,-6,5,0,0,4,3,-3,-1,1,0,1,2,-3,6,-1,0,385,187,198,-5,-2,-3,64,14,212,65,6,10,31,3,104,33,3,5,33,11,108,32,3,5,1,-3,-2,0,0,-2,3,-2,-4,2,-1,-1,-2,-1,2,-2,1,-1,297,130,167,-18,-9,-9,80,2,110,74,9,15,31,0,49,34,6,6,49,2,61,40,3,9,-7,-3,2,-8,-3,1,-3,-3,1,-3,-2,1,-4,0,1,-5,-1,0,305,147,158,-24,-17,-7,74,30,119,51,9,17,38,6,72,26,1,4,36,24,47,25,8,13,-2,4,-9,-17,-3,3,-1,2,-10,-8,-2,1,-1,2,1,-9,-1,2,289,162,127,28,18,10,87,5,89,64,15,26,62,9,42,30,7,12,25,-4,47,34,8,14,5,9,8,0,0,3,5,6,5,0,0,2,0,3,3,0,0,1,274,142,132,59,26,33,74,8,91,75,18,0,34,0,47,47,10,2,40,8,44,28,8,-2,20,8,17,7,4,1,7,2,9,4,4,-1,13,6,8,3,0,2,120,55,65,68,27,41,22,0,54,33,-2,0,12,4,24,7,0,1,10,-4,30,26,-2,-1,17,12,19,3,8,7,6,10,8,-5,2,5,11,2,11,8,6,2
31,31032,Arguedas,2264,4,-1,5,3,2,1,6,3,-7,2,3,-1,3,-1,-2,-1,1,0,3,4,-5,3,2,-1,2,0,0,0,1,0,2,0,0,0,0,0,0,0,0,0,1,0,10,4,6,3,1,2,0,6,2,-2,4,0,-2,3,2,-2,2,1,2,3,0,0,2,-1,0,1,0,0,2,0,0,0,0,0,1,0,0,1,0,0,1,0,18,6,12,0,-1,1,5,3,6,-5,6,2,1,3,1,-3,3,0,4,0,5,-2,3,2,0,0,0,0,0,0,0,0,0,0,-1,0,0,0,0,0,1,0,-11,0,-11,1,1,0,-2,1,-7,1,0,-2,1,0,-1,0,0,1,-3,1,-6,1,0,-3,3,0,-1,0,-1,0,1,0,0,0,0,0,2,0,-1,0,-1,0,-5,-4,-1,11,3,8,0,1,-3,2,1,-5,0,4,-5,1,0,-3,0,-3,2,1,1,-2,3,3,3,-1,1,1,2,1,1,-1,0,0,1,2,2,0,1,1,11,15,-4,31,19,12,-5,12,3,-7,5,4,-3,8,7,0,1,3,-2,4,-4,-7,4,1,4,11,11,2,2,0,4,4,8,2,0,0,0,7,3,0,2,0,10,3,7,26,12,14,1,11,-1,0,2,-3,-3,11,-2,-2,2,-3,4,0,1,2,0,0,7,6,9,3,1,0,2,4,4,1,1,0,5,2,5,2,0,0,23,26,-3,24,17,7,4,2,9,3,6,-3,3,0,15,5,3,0,1,2,-6,-2,3,-3,3,6,6,5,3,0,1,4,5,4,3,0,2,2,1,1,0,0,46,28,18,30,12,18,5,12,21,9,0,-2,5,9,8,6,0,-1,0,3,13,3,0,-1,7,8,8,3,2,2,5,2,1,2,1,1,2,6,7,1,1,1,-31,-14,-17,7,0,7,-5,1,-14,-10,-1,-1,-2,2,-8,-5,-1,0,-3,-1,-6,-5,0,-1,5,4,0,-3,1,0,4,2,-4,-2,0,0,1,2,4,-1,1,0,23,14,9,12,4,8,4,9,7,5,1,-4,-2,7,5,1,2,-1,6,2,2,4,-1,-3,9,1,2,1,-1,-1,4,-1,1,0,-1,0,5,2,1,1,0,-1,-28,-12,-16,5,2,3,-9,-1,-8,-9,-1,0,-3,1,-8,-3,0,1,-6,-2,0,-6,-1,-1,2,6,-1,-3,1,0,1,5,-2,-3,1,0,1,1,1,0,0,0,-22,-13,-9,-16,-7,-9,0,-4,0,-7,-2,-7,-1,-3,-1,0,-1,-5,1,-1,1,-7,-1,-2,-5,2,-2,-7,-3,-1,-2,2,-2,-3,-2,0,-3,0,0,-4,-1,-1,-11,-2,-9,-7,-1,-6,-3,5,-8,-1,-4,0,1,3,-6,0,-3,2,-4,2,-2,-1,-1,-2,0,-1,-5,1,-1,-1,2,-2,-3,1,0,1,-2,1,-2,0,-1,-2,-14,-4,-10,0,4,-4,1,-3,-9,5,1,-8,1,-2,-5,5,0,-3,0,-1,-4,0,1,-5,0,0,-1,1,1,0,0,0,0,3,1,0,0,0,-1,-2,0,0,10,12,-2,12,7,5,7,5,3,-2,0,-2,3,4,1,4,-2,2,4,1,2,-6,2,-4,6,0,4,1,1,0,5,-1,2,2,-1,0,1,1,2,-1,2,0,27,9,18,-3,-3,0,15,1,9,-1,1,1,8,-2,6,-3,0,0,7,3,3,2,1,1,0,-1,1,-3,-1,0,-1,0,0,-1,0,-1,1,-1,1,-2,-1,1,19,7,12,7,3,4,1,1,15,-2,4,-2,0,-2,9,-3,3,-2,1,3,6,1,1,0,2,-2,10,-3,0,0,1,-2,6,-2,0,0,1,0,4,-1,0,0
31,31041,Ayegui/Aiegi,933,32,26,6,43,28,15,-4,7,16,5,6,1,-2,-1,14,8,6,1,-2,8,2,-3,0,0,4,8,21,9,0,0,2,3,15,8,0,0,2,5,6,1,0,0,94,58,36,28,17,11,32,10,28,14,7,3,18,4,21,7,5,3,14,6,7,7,2,0,9,4,9,3,2,1,6,2,6,1,1,1,3,2,3,2,1,0,69,36,33,24,9,15,8,10,19,16,13,1,7,6,4,10,6,2,1,4,15,6,7,-1,9,10,2,3,0,0,3,5,0,1,0,0,6,5,2,2,0,0,76,41,35,7,6,1,20,1,22,24,3,3,16,-3,12,12,1,1,4,4,10,12,2,2,6,0,2,1,-2,0,5,0,1,0,0,0,1,0,1,1,-2,0,119,67,52,10,4,6,20,13,47,27,7,2,14,7,22,19,4,-1,6,6,25,8,3,3,1,1,5,2,0,0,0,1,2,2,-1,0,1,0,3,0,1,0,81,40,41,11,8,3,23,10,28,18,1,2,13,6,15,7,0,1,10,4,13,11,1,1,4,2,3,1,1,0,2,2,2,1,1,0,2,0,1,0,0,0,96,59,37,17,11,6,25,7,27,20,16,1,10,3,17,14,13,1,15,4,10,6,3,0,3,2,7,2,3,0,3,1,3,1,3,0,0,1,4,1,0,0,90,44,46,26,14,12,25,8,28,21,1,6,15,4,14,10,0,1,10,4,14,11,1,5,11,5,5,5,0,0,6,4,1,3,0,0,5,1,4,2,0,0,-1,-3,2,10,6,4,-10,-1,1,-4,9,5,-8,-1,-1,-3,7,3,-2,0,2,-1,2,2,0,4,1,3,1,1,0,2,1,2,0,1,0,2,0,1,1,0,60,24,36,17,5,12,8,13,28,12,-4,3,10,3,11,1,-2,1,-2,10,17,11,-2,2,6,6,3,3,0,-1,4,1,1,0,0,-1,2,5,2,3,0,0,31,24,7,10,7,3,5,-1,19,7,1,0,9,0,11,4,1,-1,-4,-1,8,3,0,1,1,0,3,3,2,1,0,0,3,3,0,1,1,0,0,0,2,0,28,28,0,-9,-1,-8,9,-3,23,-2,6,-5,3,0,18,3,4,0,6,-3,5,-5,2,-5,-1,0,0,-4,1,-5,-1,-1,0,0,1,0,0,1,0,-4,0,-5,83,54,29,13,5,8,19,16,18,21,4,5,19,9,11,8,4,4,0,7,7,13,0,1,1,3,2,5,1,1,0,1,1,2,1,0,1,2,1,3,0,1,38,10,28,-2,-2,0,14,-6,21,1,13,-4,3,-2,10,-4,9,-5,11,-4,11,5,4,1,-2,0,1,-2,2,-1,-2,1,0,0,0,-1,0,-1,1,-2,2,0,35,23,12,2,3,-1,6,0,16,7,4,2,6,2,5,8,0,2,0,-2,11,-1,4,0,0,1,2,-3,1,1,0,1,2,-1,0,1,0,0,0,-2,1,0,13,0,13,2,0,2,8,-12,13,1,-3,1,3,-7,8,-6,0,0,5,-5,5,7,-3,1,3,-1,-1,-1,1,1,2,0,-1,-1,1,-1,1,-1,0,0,0,2,40,30,10,15,7,8,15,1,22,-3,2,0,10,2,11,2,2,1,5,-1,11,-5,0,-1,4,2,3,5,0,1,2,1,3,1,0,0,2,1,0,4,0,1,17,8,9,11,4,7,10,3,3,9,-4,-6,4,-3,1,12,-4,-3,6,6,2,-3,0,-3,2,1,6,0,1,1,2,-1,3,-1,1,0,0,2,3,1,0,1
31,31050,Baztan,7741,5,2,3,2,1,1,0,-14,1,4,11,5,0,-6,-3,5,6,2,0,-8,4,-1,5,3,0,0,1,1,0,0,0,0,0,1,0,0,0,0,1,0,0,0,24,12,12,4,1,3,3,2,-3,7,5,9,-1,6,4,0,1,1,4,-4,-7,7,4,8,0,0,0,0,1,3,0,0,0,0,1,0,0,0,0,0,0,3,-15,-2,-13,-2,1,-3,3,-20,-21,14,4,6,6,-12,-5,4,2,2,-3,-8,-16,10,2,4,0,-2,-1,-1,0,2,0,-1,0,-1,1,2,0,-1,-1,0,-1,0,-20,0,-20,8,3,5,-6,-8,4,-12,6,-3,-3,7,6,-6,3,-6,-3,-15,-2,-6,3,3,0,3,2,1,0,1,0,2,2,0,0,-1,0,1,0,1,0,2,64,34,30,53,27,26,1,24,4,17,6,8,4,13,-3,10,2,4,-3,11,7,7,4,4,5,12,14,10,7,2,2,4,6,7,4,1,3,8,8,3,3,1,17,6,11,27,10,17,8,-5,-11,12,-1,12,3,-1,-9,12,0,1,5,-4,-2,0,-1,11,10,8,6,2,-2,1,3,4,1,1,-1,1,7,4,5,1,-1,0,103,57,46,64,37,27,4,12,27,21,19,18,3,8,10,9,12,14,1,4,17,12,7,4,6,18,19,11,7,2,5,13,9,5,3,1,1,5,10,6,4,1,71,13,58,81,38,43,9,25,29,0,7,1,-2,1,13,3,-3,1,11,24,16,-3,10,0,19,25,22,12,3,0,10,6,13,7,2,0,9,19,9,5,1,0,97,48,49,73,32,41,22,11,37,16,6,3,12,6,13,10,3,2,10,5,24,6,3,1,21,22,20,5,5,-1,10,10,7,3,2,-1,11,12,13,2,3,0,-29,-17,-12,25,12,13,-14,4,-25,-1,-3,7,-6,6,-12,-4,-5,3,-8,-2,-13,3,2,4,2,11,5,-1,4,4,2,5,4,-3,2,2,0,6,1,2,2,2,5,-14,19,12,-3,15,-11,3,1,-3,-5,16,-3,-2,-1,-5,-6,2,-8,5,2,2,1,14,-4,5,3,6,2,0,-2,2,-3,1,-1,0,-2,3,6,5,3,0,-26,-15,-11,5,-1,6,12,1,-19,-1,1,-22,11,-2,-18,-4,-1,-3,1,3,-1,3,2,-19,3,4,-11,11,0,-2,4,0,-8,3,0,0,-1,4,-3,8,0,-2,-17,-23,6,-9,-7,-2,0,-4,-11,-7,0,6,-3,-7,-6,-9,2,2,3,3,-5,2,-2,4,3,-2,-6,-4,-1,2,-1,0,-5,-2,1,1,4,-2,-1,-2,-2,1,-53,-28,-25,-3,-3,0,-11,-5,-20,-11,-10,3,-7,-4,-9,-5,-5,2,-4,-1,-11,-6,-5,1,0,1,-1,-2,-4,4,-1,2,-4,-1,-1,2,1,-1,3,-1,-3,2,-71,-31,-40,-28,-19,-9,-2,-10,-15,-38,0,-4,1,-3,-9,-27,5,2,-3,-7,-6,-11,-5,-6,6,-4,-7,-19,0,-4,5,-4,-6,-13,1,-2,1,0,-1,-6,-1,-2,-34,-5,-29,-24,-7,-17,-15,3,0,-15,-5,-3,-6,2,4,-2,-7,2,-9,1,-4,-13,2,-5,-5,0,-5,-10,-5,-1,-1,-1,1,-5,-3,0,-4,1,-6,-5,-2,-1,43,18,25,28,11,17,-10,7,22,9,8,4,-7,2,5,10,7,1,-3,5,17,-1,1,3,4,8,9,7,-2,2,1,2,3,7,-1,-1,3,6,6,0,-1,3,75,38,37,37,16,21,15,10,7,20,13,4,9,3,3,13,6,1,6,7,4,7,7,3,4,11,8,4,3,5,4,5,2,0,2,1,0,6,6,4,1,4
31,31250,Bera,3511,20,10,10,8,2,6,3,-2,3,4,5,8,-1,-1,-1,6,2,4,4,-1,4,-2,3,4,2,3,2,1,0,0,0,1,0,1,0,0,2,2,2,0,0,0,7,4,3,4,1,3,6,-3,9,-4,-1,2,3,0,4,-3,1,0,3,-3,5,-1,-2,2,0,2,0,2,0,0,0,0,0,1,0,0,0,2,0,1,0,0,-13,-10,-3,3,2,1,1,-9,9,0,-10,-3,-1,-6,2,5,-7,-2,2,-3,7,-5,-3,-1,2,-1,-1,3,0,0,0,0,0,2,0,0,2,-1,-1,1,0,0,-12,-16,4,0,1,-1,2,8,-10,-3,-7,-3,-1,1,-9,-1,-4,-3,3,7,-1,-2,-3,0,2,-1,0,-1,0,0,1,-1,1,0,0,0,1,0,-1,-1,0,0,-17,-12,-5,35,19,16,-14,-5,9,-11,2,6,-8,0,1,-7,3,1,-6,-5,8,-4,-1,5,7,10,7,7,3,1,6,4,2,5,2,0,1,6,5,2,1,1,21,5,16,20,8,12,0,-4,14,1,-4,14,-2,-2,4,3,-4,5,2,-2,10,-2,0,9,4,1,5,8,2,-1,1,0,2,4,1,-1,3,1,3,4,1,0,-32,-10,-22,9,3,6,-3,4,-17,-6,-5,-6,1,-3,-2,-2,-2,-3,-4,7,-15,-4,-3,-3,1,4,0,2,1,1,1,0,1,1,0,0,0,4,-1,1,1,1,-15,-11,-4,23,12,11,9,0,-2,0,-7,-15,3,1,-2,-2,-3,-8,6,-1,0,2,-4,-7,8,2,12,4,1,-4,3,-1,9,3,0,-2,5,3,3,1,1,-2,1,-2,3,12,3,9,6,5,-11,-7,-2,8,3,4,-8,-4,0,1,3,1,-3,-3,-2,7,3,3,-1,2,3,2,0,3,-2,0,3,-1,3,0,1,2,0,3,34,13,21,20,8,12,-3,10,13,8,7,1,-1,4,5,2,0,3,-2,6,8,6,7,-2,0,5,10,3,2,0,-1,3,5,0,1,0,1,2,5,3,1,0,42,16,26,12,2,10,8,11,18,1,1,6,2,4,2,5,2,4,6,7,16,-4,-1,2,0,8,2,2,1,0,-1,4,-1,0,0,0,1,4,3,2,1,0,6,16,-10,15,11,4,3,1,0,2,-5,3,3,1,3,8,-2,1,0,0,-3,-6,-3,2,3,4,1,3,1,2,0,4,1,2,2,1,3,0,0,1,-1,1,0,0,0,15,4,11,-9,13,-4,1,0,-3,-1,4,-4,4,-1,-2,-8,9,0,-3,1,-1,7,13,-4,0,0,-2,3,5,-3,-1,0,0,4,8,-1,1,0,-2,-56,-31,-25,-26,-17,-9,-15,-7,-8,-16,-6,-3,-9,-5,-4,-7,-4,-2,-6,-2,-4,-9,-2,-1,-9,0,-10,-6,-1,0,-6,-1,-5,-4,-1,0,-3,1,-5,-2,0,0,-12,-25,13,-26,-25,-1,0,4,-12,-5,-6,3,-4,-1,-4,-8,-8,-1,4,5,-8,3,2,4,-7,2,-10,-3,-7,-2,-6,-1,-6,-2,-9,-1,-1,3,-4,-1,2,-1,19,-1,20,23,10,13,4,2,8,6,-4,3,3,-1,3,-2,-4,1,1,3,5,8,0,2,8,3,10,3,-1,0,2,2,7,0,-1,0,6,1,3,3,0,0,14,-5,19,34,15,19,22,-9,3,3,-2,-5,5,-5,-1,2,-2,-4,17,-4,4,1,0,-1,9,6,12,-1,4,2,2,0,12,0,0,1,7,6,0,-1,4,1,30,12,18,46,25,21,6,10,15,2,-6,4,1,6,10,1,-7,1,5,4,5,1,1,3,1,13,20,11,0,1,0,5,13,7,0,0,1,8,7,4,0,1
31,31060,Burlada/Burlata,16647,91,42,49,4,2,2,75,-10,-22,30,3,19,43,4,-23,13,0,9,32,-14,1,17,3,10,1,0,0,0,1,2,0,0,0,0,1,1,1,0,0,0,0,1,-114,-104,-10,5,1,4,-36,-12,-45,-15,-8,2,-29,-11,-51,-10,-2,-1,-7,-1,6,-5,-6,3,2,1,0,0,1,1,0,1,0,0,0,0,2,0,0,0,1,1,-123,-73,-50,-11,-3,-8,-44,3,-29,-35,-7,-8,-22,11,-28,-25,-5,-6,-22,-8,-1,-10,-2,-2,-2,-2,-3,0,-2,-2,-1,0,0,0,-2,0,-1,-2,-3,0,0,-2,-177,-87,-90,-11,-7,-4,-42,-8,-37,-69,-22,1,-30,5,-9,-35,-16,-4,-12,-13,-28,-34,-6,5,-2,-5,-4,0,0,0,-1,-4,-2,0,0,0,-1,-1,-2,0,0,0,218,85,133,220,117,103,25,89,52,53,-3,-2,24,35,0,25,-2,0,1,54,52,28,-1,-2,38,61,64,38,12,4,25,33,31,19,6,1,13,28,33,19,6,3,35,7,28,207,105,102,24,29,28,-2,-29,-2,-2,8,13,2,-15,2,26,21,15,-4,-14,-4,56,53,53,26,14,5,29,28,23,15,9,1,27,25,30,11,5,4,44,-2,46,225,121,104,36,69,-26,-12,-15,0,5,37,-25,1,-10,-2,31,32,-1,-13,-5,2,51,50,65,38,16,3,25,27,37,23,8,1,26,23,28,15,8,2,104,111,-7,359,227,132,30,109,-3,-13,3,-16,25,66,24,3,4,-10,5,43,-27,-16,-1,-6,79,112,111,37,17,-1,45,66,81,24,10,0,34,46,30,13,7,-1,67,33,34,204,108,96,16,63,-42,16,15,4,1,37,-5,0,3,-2,15,26,-37,16,12,6,42,70,44,34,10,-1,19,41,30,10,5,-1,23,29,14,24,5,0,-222,-132,-90,14,-14,28,0,16,-139,-62,-29,-5,0,6,-85,-22,-11,-15,0,10,-54,-40,-18,10,23,15,-2,-17,-7,-2,12,6,-12,-11,-6,-4,11,9,10,-6,-1,2,-205,-180,-25,16,-37,53,17,-17,-87,-91,-15,-5,10,-22,-85,-67,-11,-2,7,5,-2,-24,-4,-3,26,17,-8,-15,-6,1,7,4,-21,-19,-10,1,19,13,13,4,4,0,-54,-49,-5,46,11,35,-13,11,8,-27,-23,-10,-3,8,-2,-17,-26,-8,-10,3,10,-10,3,-2,11,30,8,-2,-4,-1,2,14,4,-7,-5,1,9,16,4,5,1,-2,80,35,45,-19,-22,3,8,25,19,3,11,11,0,28,8,-6,-2,4,8,-3,11,9,13,7,6,18,-22,-26,-4,5,1,9,-11,-18,-7,1,5,9,-11,-8,3,4,10,-25,35,-115,-68,-47,37,1,18,-52,-24,24,20,-9,4,-40,-4,3,17,10,14,-12,-20,21,-5,3,-49,-44,-21,-1,-3,-2,-26,-27,-9,-3,-2,5,-23,-17,-12,2,146,55,91,-97,-74,-23,46,18,47,29,-1,8,10,14,33,8,-8,2,36,4,14,21,7,6,-7,-9,-46,-27,-7,-1,-7,-9,-28,-24,-6,0,0,0,-18,-3,-1,-1,39,21,18,5,-7,12,12,-22,-4,37,11,14,7,0,-19,26,0,8,5,-22,15,11,11,6,3,5,-8,-1,-1,6,3,5,-14,1,-5,3,0,0,6,-2,4,3,278,86,192,126,58,68,59,32,67,78,25,12,21,24,16,9,14,4,38,8,51,69,11,8,34,31,25,8,12,11,18,23,9,-6,9,3,16,8,16,14,3,8,317,164,153,155,78,77,44,32,105,79,31,15,27,22,47,39,18,6,17,10,58,40,13,9,14,46,49,15,19,8,7,27,31,2,7,2,7,19,18,13,12,6
31,31062,Cabanillas,1461,25,19,6,65,43,22,2,13,5,5,0,0,3,11,0,5,0,-1,-1,2,5,0,0,1,9,21,23,9,2,0,3,17,15,6,1,0,6,4,8,3,1,0,28,17,11,43,26,17,0,8,12,6,1,-2,1,4,10,2,0,0,-1,4,2,4,1,-2,4,12,13,9,2,0,3,9,10,4,0,0,1,3,3,5,2,0,0,5,-5,-3,-1,-2,3,2,-13,5,5,-1,0,5,-6,2,3,1,3,-3,-7,3,2,-2,0,-2,0,0,-1,0,0,0,0,0,-1,0,0,-2,0,0,0,0,-41,-17,-24,3,1,2,-7,-9,-25,3,0,-2,-4,-3,-13,4,1,-1,-3,-6,-12,-1,-1,-1,0,1,0,2,0,0,0,1,0,0,0,0,0,0,0,2,0,0,-24,-18,-6,41,24,17,8,-4,-14,-6,-6,0,5,-4,-11,-2,-6,0,3,0,-3,-4,0,0,6,12,14,5,2,1,3,8,8,4,1,0,3,4,6,1,1,1,-66,-56,-10,-45,-40,-5,-1,-3,-31,-25,-1,-5,0,-4,-28,-19,-1,-4,-1,1,-3,-6,0,-1,3,-3,-23,-18,-4,0,1,-3,-22,-14,-2,0,2,0,-1,-4,-2,0,0,-1,1,24,14,10,5,3,2,-8,1,-2,-1,2,4,-6,1,-1,6,1,-2,-2,0,-1,5,6,11,1,1,0,1,4,7,1,1,0,4,2,4,0,0,0,-12,-1,-11,20,10,10,-7,1,-5,1,3,-3,-5,-2,1,4,2,-1,-2,3,-6,-3,1,-2,0,2,12,4,2,0,0,0,7,3,0,0,0,2,5,1,2,0,1,0,1,9,4,5,1,3,2,4,-3,-3,1,0,-1,5,-3,0,0,3,3,-1,0,-3,0,2,5,3,-1,0,0,0,2,3,-1,0,0,2,3,0,0,0,7,6,1,8,3,5,-2,2,-2,11,-1,0,0,3,-1,6,-1,-1,-2,-1,-1,5,0,1,0,2,3,3,0,0,0,1,1,1,0,0,0,1,2,2,0,0,9,3,6,3,1,2,5,-1,2,8,-1,-3,1,0,2,3,-1,-2,4,-1,0,5,0,-1,1,0,0,3,-1,0,1,0,0,1,-1,0,0,0,0,2,0,0,-2,1,-3,1,-1,2,-1,0,8,-8,2,-4,2,1,1,-5,3,-1,-3,-1,7,-3,-1,-3,1,0,2,-2,0,0,2,-1,1,-3,0,0,-1,1,1,1,0,0,-11,0,-11,5,4,1,-1,-3,-4,1,-1,-4,-2,0,1,1,0,-1,1,-3,-5,0,-1,-3,0,3,-2,3,0,0,0,1,-1,3,0,0,0,2,-1,0,0,0,-21,-9,-12,-5,-5,0,-3,-5,-3,-8,1,-3,-1,-2,2,-8,3,-3,-2,-3,-5,0,-2,0,-1,-1,4,-6,-1,0,-1,-1,4,-6,-1,0,0,0,0,0,0,0,-4,1,-5,-5,-4,-1,0,7,-3,-6,-3,0,2,2,2,-4,-2,0,-2,5,-5,-2,-1,0,0,2,-2,-5,-1,1,1,0,0,-5,-1,1,-1,2,-2,0,0,0,-17,-5,-12,-6,-2,-4,-1,1,-5,-6,-4,-3,2,0,0,-3,-3,-1,-3,1,-5,-3,-1,-2,-1,0,0,-2,-3,0,1,0,0,-2,-1,0,-2,0,0,0,-2,0,-44,-23,-21,-33,-15,-18,-5,3,-10,-16,-12,-3,-3,3,-3,-11,-7,-1,-2,0,-7,-5,-5,-2,-3,-1,-2,-14,-9,-4,-1,0,2,-9,-5,-2,-2,-1,-4,-5,-4,-2,6,5,1,20,14,6,3,-2,7,-3,0,1,4,-3,5,-2,1,0,-1,1,2,-1,-1,1,5,2,8,2,2,0,4,1,5,2,1,0,1,1,3,0,1,0
31,31068,Cascante,3616,127,86,41,99,60,39,24,29,44,13,13,5,15,13,35,14,7,4,9,16,9,-1,6,1,17,25,40,12,3,0,11,13,25,9,0,0,6,12,15,3,3,0,63,46,17,81,46,35,13,24,13,8,0,6,13,13,10,5,1,4,0,11,3,3,-1,2,17,25,24,12,1,2,11,11,15,7,1,1,6,14,9,5,0,1,73,30,43,84,42,42,24,27,-7,7,8,11,6,16,-2,2,2,5,18,11,-5,5,6,6,35,22,16,6,3,0,15,14,8,4,0,0,20,8,8,2,3,0,49,25,24,28,14,14,13,4,5,3,-1,26,11,5,5,-1,1,4,2,-1,0,4,-2,22,13,6,6,2,1,0,7,3,4,0,0,0,6,3,2,2,1,0,44,19,25,28,16,12,9,13,7,-1,1,15,6,8,1,-3,1,6,3,5,6,2,0,9,8,6,11,3,0,0,6,4,6,0,0,0,2,2,5,3,0,0,52,17,35,33,15,18,5,4,23,2,0,13,0,0,9,4,-1,3,5,4,14,-2,1,10,8,9,11,3,2,0,1,3,8,2,1,0,7,6,3,1,1,0,36,26,10,33,17,16,2,12,0,10,7,6,4,10,0,11,-1,2,-2,2,0,-1,8,4,3,9,14,5,1,1,1,4,8,4,0,0,2,5,6,1,1,1,61,37,24,53,34,19,6,14,10,25,4,3,0,10,9,15,5,-2,6,4,1,10,-1,5,9,18,13,12,3,-2,7,9,9,7,3,-1,2,9,4,5,0,-1,28,16,12,28,7,21,6,12,11,2,-10,8,4,0,10,1,-3,4,2,12,1,1,-7,4,9,14,9,-2,-3,1,4,7,1,-5,0,0,5,7,8,3,-3,1,-10,-5,-5,21,9,12,-2,-11,-9,-11,-4,26,1,-4,-3,-6,2,5,-3,-7,-6,-5,-6,21,10,10,-2,0,1,1,6,4,-2,-1,1,0,4,6,0,1,0,1,29,15,14,16,5,11,3,-1,4,-1,-8,28,-1,-8,2,9,-4,13,4,7,2,-10,-4,15,6,3,10,-2,1,-2,3,1,3,-1,0,-1,3,2,7,-1,1,-1,11,-14,25,-19,-15,-4,10,5,-14,4,-6,10,6,-2,-17,-1,-5,3,4,7,3,5,-1,7,-2,3,-8,-9,-4,0,0,-2,-4,-7,-3,0,-2,5,-4,-2,-1,0,-10,-12,2,-42,-23,-19,12,-5,-24,-5,7,3,3,1,-19,-2,3,1,9,-6,-5,-3,4,2,-10,-3,-18,-8,-3,0,-6,1,-12,-3,-3,0,-4,-4,-6,-5,0,0,-19,-12,-7,-21,-18,-3,-9,-1,-3,-10,-3,6,-5,1,2,-8,-5,3,-4,-2,-5,-2,2,3,-4,-3,-9,-5,-1,0,-3,-4,-6,-4,-1,0,-1,1,-3,-1,0,0,-91,-65,-26,-32,-24,-8,-18,-21,-30,-28,-8,14,-11,-7,-14,-26,-3,1,-7,-14,-16,-2,-5,13,-4,-1,-8,-14,-6,-1,-5,-1,-5,-10,-2,-1,1,0,-3,-4,-4,0,-16,-14,-2,-52,-31,-21,-3,5,-9,-15,-4,10,-2,5,-8,-15,-1,7,-1,0,-1,0,-3,3,-11,-2,-10,-17,-11,-1,-4,-1,-6,-12,-8,0,-7,-1,-4,-5,-3,-1,54,39,15,24,10,14,18,9,14,11,-7,3,7,3,11,15,2,1,11,6,3,-4,-9,2,7,7,3,2,1,2,3,3,1,1,1,0,4,4,2,1,0,2,78,38,40,20,16,4,19,3,24,9,10,5,8,1,13,11,0,0,11,2,11,-2,10,5,1,4,11,3,1,0,1,0,9,6,0,0,0,4,2,-3,1,0
31,31077,Corella,6686,52,36,16,4,2,2,1,12,18,5,2,13,-1,10,16,2,-1,9,2,2,2,3,3,4,0,0,1,0,1,2,0,0,0,0,1,1,0,0,1,0,0,1,56,34,22,3,2,1,12,20,10,-8,12,10,6,4,14,-3,9,5,6,16,-4,-5,3,5,1,0,1,0,1,0,1,0,0,0,1,0,0,0,1,0,0,0,42,26,16,-3,-4,1,1,26,6,-2,1,5,-5,20,19,-5,-3,1,6,6,-13,3,4,4,0,-1,0,-1,0,-1,0,-1,-1,0,-1,-1,0,0,1,-1,1,0,-2,8,-10,-2,-1,-1,-22,29,-27,6,9,4,-14,16,-6,7,6,3,-8,13,-21,-1,3,1,0,0,-1,0,-1,0,0,0,-1,0,0,0,0,0,0,0,-1,0,71,49,22,142,80,62,10,20,15,6,15,3,10,20,16,-2,7,-3,0,0,-1,8,8,6,27,47,34,29,4,0,14,28,18,17,3,0,13,19,16,12,1,0,94,70,24,146,79,67,24,48,44,-16,-12,5,16,31,26,-1,-6,3,8,17,18,-15,-6,2,28,51,43,23,-1,1,19,26,19,13,0,1,9,25,24,10,-1,0,77,66,11,155,86,69,-13,45,31,8,6,1,-2,25,28,10,2,3,-11,20,3,-2,4,-2,24,40,50,30,7,2,11,18,32,21,3,1,13,22,18,9,4,1,204,178,26,315,215,100,21,68,45,52,18,3,11,42,59,54,13,0,10,26,-14,-2,5,3,54,83,88,69,18,1,27,50,69,53,14,1,27,33,19,16,4,0,121,78,43,175,95,80,25,24,31,26,11,-8,18,12,22,15,4,0,7,12,9,11,7,-8,34,44,48,34,9,-1,20,17,27,25,2,0,14,27,21,9,7,-1,27,2,25,71,25,46,16,29,-10,-9,8,-10,3,14,-11,-7,5,-4,13,15,1,-2,3,-6,21,21,13,7,3,-1,9,11,4,-2,2,-1,12,10,9,9,1,0,24,12,12,28,2,26,-3,12,-2,0,15,0,0,3,-7,-1,12,3,-3,9,5,1,3,-3,4,5,-5,11,9,2,1,0,-8,-2,8,2,3,5,3,13,1,0,-70,-45,-25,-70,-66,-4,-4,3,-49,-12,-9,0,2,2,-36,-7,-7,2,-6,1,-13,-5,-2,-2,2,3,-34,-26,-16,0,5,-3,-34,-23,-12,1,-3,6,0,-3,-4,-1,-128,-100,-28,-79,-66,-13,-12,-11,-48,-31,-19,-5,-21,-3,-43,-22,-9,-1,9,-8,-5,-9,-10,-4,-18,2,-29,-19,-13,-1,-17,1,-23,-18,-9,0,-1,1,-6,-1,-4,-1,-114,-78,-36,-124,-98,-26,0,-7,-31,-42,-32,-2,2,2,-26,-34,-22,0,-2,-9,-5,-8,-10,-2,-14,-11,-31,-44,-19,-6,-6,-6,-29,-37,-18,-3,-8,-5,-2,-7,-1,-3,1,-23,24,-6,-6,0,7,15,-18,7,-2,-8,3,5,-22,-2,-1,-6,4,10,4,9,-1,-2,3,4,-8,-5,-1,1,3,0,-5,-4,0,0,0,4,-3,-1,-1,1,6,-17,23,-48,-47,-1,12,17,12,-27,-3,-5,0,6,12,-26,-6,-6,12,11,0,-1,3,1,-9,5,-18,-17,-10,-2,-9,1,-12,-17,-9,-2,0,4,-6,0,-1,0,-35,-37,2,-52,-41,-11,-2,25,-18,-22,-14,-8,3,9,-11,-26,-7,-7,-5,16,-7,4,-7,-1,3,13,-24,-23,-24,1,3,1,-15,-18,-13,-1,0,12,-9,-5,-11,2,83,28,55,54,23,31,46,19,13,8,-6,3,19,6,1,8,-5,1,27,13,12,0,-1,2,16,18,10,1,1,6,7,5,2,3,1,4,9,13,8,-2,0,2
31,31097,Estella/Lizarra,12607,180,93,87,186,98,88,16,35,86,32,2,4,5,17,41,20,1,6,11,18,45,12,1,-2,21,46,75,34,6,3,10,22,46,16,3,1,11,24,29,18,3,2,254,129,125,306,163,143,51,91,67,24,19,1,25,43,36,16,10,1,26,48,31,8,9,0,77,95,93,32,6,2,42,47,54,18,2,0,35,48,39,14,4,2,312,156,156,259,126,133,125,82,51,51,-6,6,50,52,28,26,-8,7,75,30,23,25,2,-1,78,74,61,36,4,3,28,39,38,20,0,-1,50,35,23,16,4,4,22,33,-11,129,64,65,-24,16,5,-4,7,16,-11,14,10,6,6,4,-13,2,-5,-10,1,12,27,35,38,17,7,2,14,18,20,8,1,1,13,17,18,9,6,1,117,41,76,95,48,47,48,26,12,-4,10,22,33,4,12,-17,-1,7,15,22,0,13,11,15,17,29,33,9,5,2,9,13,20,5,0,1,8,16,13,4,5,1,165,103,62,119,63,56,42,32,29,55,8,-6,24,22,19,27,3,3,18,10,10,28,5,-9,27,33,40,14,1,3,18,16,21,6,0,1,9,17,19,8,1,2,166,105,61,175,105,70,23,61,55,19,-4,4,30,36,30,3,3,1,-7,25,25,16,-7,3,29,59,64,20,0,1,19,34,37,13,1,0,10,25,27,7,-1,1,93,30,63,156,89,67,44,26,18,3,-8,1,18,14,7,-6,-12,5,26,12,11,9,4,-4,34,46,44,30,0,0,21,24,25,19,-1,0,13,22,19,11,1,0,194,96,98,145,78,67,61,58,28,39,-5,16,36,31,3,23,-3,10,25,27,25,16,-2,6,57,44,21,16,4,3,29,34,7,4,3,1,28,10,14,12,1,2,-38,-27,-11,13,-6,19,0,3,-34,2,-3,-9,-8,-2,-17,2,-6,0,8,5,-17,0,3,-9,11,4,-1,-1,-1,1,6,-5,-4,-2,-2,1,5,9,3,1,1,0,25,10,15,24,-3,27,18,-2,-2,15,-13,8,8,1,0,5,-13,8,10,-3,-2,10,0,0,11,11,-3,2,-1,2,1,4,-9,0,-4,3,10,7,6,2,3,-1,-112,-72,-40,0,-3,3,-15,-2,-68,-16,-11,1,-3,-9,-48,-17,-2,8,-12,7,-20,1,-9,-7,-1,12,-24,4,6,3,4,3,-13,-2,3,2,-5,9,-11,6,3,1,-150,-104,-46,-48,-45,-3,-33,4,-66,-26,-25,-5,-24,1,-40,-13,-25,-2,-9,3,-26,-13,0,-3,-6,5,-26,-21,-5,3,-8,-1,-18,-13,-7,1,2,6,-8,-8,2,2,-136,-73,-63,-109,-62,-47,-17,-34,-48,-23,-13,-9,-7,-15,-30,-18,2,-9,-10,-19,-18,-5,-15,0,-23,-26,-41,-18,-1,-2,-16,-10,-23,-15,1,-1,-7,-16,-18,-3,-2,-1,15,-31,46,-98,-73,-25,19,8,-17,-12,4,7,-4,3,-21,-20,2,3,23,5,4,8,2,4,-20,7,-30,-42,-10,-4,-15,-1,-19,-33,-3,-4,-5,8,-11,-9,-7,0,-18,-9,-9,-16,-19,3,1,12,-39,2,8,4,1,0,-12,-2,0,5,0,12,-27,4,8,-1,1,16,-16,-11,-6,-3,0,2,-8,-6,-8,-1,1,14,-8,-5,2,-2,97,64,33,71,41,30,7,38,34,1,9,4,-1,16,35,11,-1,1,8,22,-1,-10,10,3,0,33,27,2,2,1,4,12,17,3,0,2,-4,21,10,-1,2,-1,40,3,37,116,41,75,9,35,18,-28,-3,6,12,23,1,-35,-2,3,-3,12,17,7,-1,3,22,40,31,6,9,5,13,17,9,-7,5,2,9,23,22,13,4,3
31,31084,Etxarri-Aranatz,2337,28,26,2,20,10,10,0,6,9,8,2,3,2,6,8,6,2,2,-2,0,1,2,0,1,3,3,10,4,0,0,3,3,3,1,0,0,0,0,7,3,0,0,41,27,14,33,21,12,-2,9,24,3,7,0,-2,9,19,-2,4,-1,0,0,5,5,3,1,3,10,12,8,0,0,0,7,11,3,0,0,3,3,1,5,0,0,3,-4,7,8,1,7,0,-6,2,4,0,2,-3,-1,-1,4,-2,-1,3,-5,3,0,2,3,5,-1,3,1,1,-1,0,0,2,0,0,-1,5,-1,1,1,1,0,-12,-8,-4,16,6,10,-1,-6,-5,2,-2,-2,2,-5,-7,1,1,-1,-3,-1,2,1,-3,-1,4,2,7,2,1,-1,2,0,3,0,1,-1,2,2,4,2,0,0,32,17,15,8,2,6,15,8,11,3,-5,-2,4,4,2,6,-3,1,11,4,9,-3,-2,-3,3,1,3,0,0,0,0,0,1,0,0,0,3,1,2,0,0,0,0,-1,1,11,4,7,3,-3,-5,4,2,0,1,-3,6,-3,-1,0,2,0,-11,7,3,0,4,2,2,2,1,0,2,0,1,1,0,0,2,2,1,1,1,0,14,7,7,10,4,6,4,4,9,-1,1,-1,3,0,1,4,1,-1,1,4,8,-5,0,0,1,1,4,4,0,0,0,0,0,4,0,0,1,1,4,0,0,0,-1,12,-13,20,13,7,-3,-2,-1,0,2,2,2,1,10,-2,0,0,-5,-3,-11,2,2,2,3,2,8,5,1,1,3,2,4,3,0,1,0,0,4,2,1,0,-14,-7,-7,10,8,2,-3,-3,4,-3,-3,-5,-6,-1,2,3,-4,-1,3,-2,2,-6,1,-4,2,1,2,2,2,0,0,2,1,2,1,1,2,-1,1,0,1,-1,-3,0,-3,8,3,5,7,2,-5,-2,0,-2,5,0,2,-1,-1,-2,2,2,-7,-1,1,0,2,1,2,1,2,0,1,1,0,0,1,0,1,0,2,1,1,0,2,11,-9,7,3,4,-3,-1,9,-4,-2,3,0,1,8,1,1,0,-3,-2,1,-5,-3,3,1,2,1,1,0,2,1,1,1,0,0,0,0,1,0,1,0,2,-6,-8,2,3,0,3,-6,-1,-3,1,2,2,0,-3,-2,-4,2,0,-6,2,-1,5,0,2,2,2,-1,0,1,-1,2,0,-2,0,0,0,0,2,1,0,1,-1,9,3,6,4,2,2,1,2,6,2,0,0,1,2,4,-2,-2,0,0,0,2,4,2,0,2,2,1,0,-1,0,1,1,1,0,-1,0,1,1,0,0,0,0,-22,-11,-11,-3,0,-3,-7,2,-2,-9,-4,-2,-4,1,3,-8,0,-3,-3,1,-5,-1,-4,1,-2,0,0,-1,0,0,-1,0,0,0,1,0,-1,0,0,-1,-1,0,-19,-8,-11,-2,-1,-1,1,-1,-12,-5,-2,-2,2,0,-2,-6,-3,0,-1,-1,-10,1,1,-2,0,-1,-1,-1,1,0,0,0,0,-1,0,0,0,-1,-1,0,1,0,-20,-8,-12,-2,-1,-1,-11,5,3,-8,-6,-3,-9,3,5,-4,-3,0,-2,2,-2,-4,-3,-3,-2,2,1,0,-2,-1,-1,0,0,0,0,0,-1,2,1,0,-2,-1,-4,-1,-3,8,2,6,2,-1,-12,5,2,1,4,0,-6,4,-1,0,-2,-1,-6,1,3,1,-1,0,3,1,4,0,0,0,0,0,2,0,-1,0,3,1,2,0,34,18,16,9,6,3,15,-2,18,-1,3,-1,7,0,9,0,0,1,8,-2,9,-1,3,-2,3,4,4,-1,1,-2,2,3,1,0,0,0,1,1,3,-1,1,-2
31,31108,Fustiñana,2290,102,70,32,81,58,23,16,25,32,23,5,1,4,16,26,22,1,1,12,9,6,1,4,0,6,25,23,22,4,1,2,15,20,20,1,0,4,10,3,2,3,1,33,14,19,49,30,19,9,15,8,-2,0,3,4,9,2,-2,0,1,5,6,6,0,0,2,9,19,14,7,0,0,4,12,10,4,0,0,5,7,4,3,0,0,-37,-16,-21,1,3,-2,-8,-16,-5,-10,1,2,-4,-8,-1,-5,1,1,-4,-8,-4,-5,0,1,2,0,-2,0,1,0,2,0,-1,1,1,0,0,0,-1,-1,0,0,-5,-5,0,1,1,0,2,2,-7,-2,-1,2,-2,4,-2,-3,1,-1,4,-2,-5,1,-2,3,0,0,1,0,0,0,0,0,1,0,0,0,0,0,0,0,0,0,29,18,11,18,4,14,2,5,5,12,0,5,5,4,3,7,-2,1,-3,1,2,5,2,4,5,2,5,4,3,-1,3,0,1,1,-1,0,2,2,4,3,4,-1,34,27,7,17,11,6,12,8,-10,4,5,14,10,9,-4,-3,6,9,2,-1,-6,7,-1,5,7,9,0,0,-2,3,6,3,1,0,0,1,1,6,-1,0,-2,2,62,32,30,28,19,9,9,18,27,9,-1,2,3,8,13,7,-2,3,6,10,14,2,1,-1,4,13,3,5,1,2,3,9,1,5,0,1,1,4,2,0,1,1,46,27,19,23,7,16,6,18,7,2,6,5,3,13,6,1,1,2,3,5,1,1,5,3,4,9,3,3,4,0,1,3,2,0,1,0,3,6,1,3,3,0,27,22,5,18,11,7,1,10,3,6,3,3,1,6,4,3,5,2,0,4,-1,3,-2,1,3,8,5,1,3,-2,2,3,2,0,5,-1,1,5,3,1,-2,-1,-18,-10,-8,-4,-2,-2,-3,0,-19,-4,5,5,-4,-3,-2,0,1,0,1,3,-17,-4,4,5,-1,3,-4,-3,1,0,-1,0,1,-2,0,0,0,3,-5,-1,1,0,3,-7,10,-24,-23,-1,-1,4,-9,-1,-2,10,-2,1,-9,-1,-2,4,1,3,0,0,0,6,-4,-1,-11,-9,0,1,-4,0,-9,-9,-1,0,0,-1,-2,0,1,1,1,6,-5,-8,-5,-3,6,0,-2,-1,3,-4,3,2,-1,3,2,-4,3,-2,-1,-4,1,0,0,1,-4,-1,-3,-1,0,0,-4,0,-1,0,0,1,0,-1,-2,-1,2,2,0,-4,-5,1,2,0,-14,3,2,7,3,2,-9,-1,3,4,-1,-2,-5,4,-1,3,3,-2,-2,-2,-2,0,2,-1,-2,-2,-2,0,1,-1,0,0,0,0,-24,-19,-5,-3,-3,0,4,-5,-11,-8,-7,4,3,-5,-7,-6,-5,1,1,0,-4,-2,-2,3,3,0,-3,-3,0,0,2,-1,-2,-2,0,0,1,1,-1,-1,0,0,-17,-16,-1,-5,-1,-4,-12,1,-1,-6,-2,2,-11,4,1,-8,-5,2,-1,-3,-2,2,3,0,-4,5,-1,-3,-2,0,-2,5,1,-4,-1,0,-2,0,-2,1,-1,0,-18,-2,-16,-21,-11,-10,0,0,-2,-11,-11,5,3,3,2,-8,-6,3,-3,-3,-4,-3,-5,2,-1,2,-2,-7,-10,-3,0,1,-1,-5,-5,-1,-1,1,-1,-2,-5,-2,0,4,-4,1,5,-4,1,-2,-2,-1,-2,6,1,-1,-1,1,-1,5,0,-1,-1,-2,-1,1,1,3,-1,0,-2,0,1,2,1,1,0,0,0,1,-2,-1,-2,0,32,20,12,16,3,13,6,10,4,-4,8,8,3,6,1,-4,10,4,3,4,3,0,-2,4,1,6,3,2,3,1,-2,3,-1,-1,3,1,3,3,4,3,0,0
31,31149,Leitza,3003,-2,1,-3,12,6,6,2,0,-5,4,-1,0,3,2,-2,0,-1,0,-1,-2,-3,4,0,0,1,2,6,2,1,0,0,2,3,1,0,0,1,0,3,1,1,0,6,3,3,8,5,3,3,0,7,-3,1,-2,0,-1,7,-2,0,-1,3,1,0,-1,1,-1,1,3,3,1,0,0,0,1,3,1,0,0,1,2,0,0,0,0,11,7,4,25,15,10,1,8,-3,2,2,0,1,6,-4,1,3,-1,0,2,1,1,-1,1,5,9,8,1,1,0,3,6,4,1,0,0,2,3,4,0,1,0,21,33,-12,18,15,3,7,3,11,3,-2,-3,3,13,9,8,-1,-1,4,-10,2,-5,-1,-2,3,6,6,3,0,0,2,6,4,3,0,0,1,0,2,0,0,0,25,26,-1,19,16,3,6,7,12,1,1,-1,1,5,19,2,2,-1,5,2,-7,-1,-1,0,2,3,10,2,2,0,0,2,10,2,2,0,2,1,0,0,0,0,-38,-16,-22,10,4,6,2,0,-18,-12,-6,-3,0,3,-7,-8,-2,-2,2,-3,-11,-4,-4,-1,3,3,4,0,0,0,0,1,3,0,0,0,3,2,1,0,0,0,-23,-15,-8,12,8,4,-1,-6,-19,7,-2,-3,-1,-6,-8,3,-1,-4,0,0,-11,4,-1,1,2,0,2,6,1,1,1,0,2,4,1,0,1,0,0,2,0,1,-2,10,-12,15,12,3,3,9,-4,2,-8,-4,2,13,-4,2,-1,-1,1,-4,0,0,-7,-3,2,2,5,5,0,0,1,1,6,4,0,0,1,1,-1,1,0,0,33,12,21,9,3,6,13,6,13,1,1,0,4,2,7,2,-1,-1,9,4,6,-1,2,1,4,3,1,2,-1,0,2,2,-2,2,-1,0,2,1,3,0,0,0,9,3,6,17,10,7,-1,8,-4,7,-1,0,-1,6,0,0,-1,0,0,2,-4,7,0,0,5,2,3,5,2,0,3,2,2,2,1,0,2,0,1,3,1,0,3,12,-9,12,4,8,-1,5,-8,2,5,1,0,4,-1,5,3,1,-1,1,-7,-3,2,0,4,3,3,-1,2,1,1,1,2,-2,1,1,3,2,1,1,1,0,-28,-11,-17,7,6,1,-5,0,-14,-4,-5,-1,-2,-1,-5,2,-5,-2,-3,1,-9,-6,0,1,-2,3,1,4,-1,1,-2,2,1,5,-1,0,0,1,0,-1,0,1,-2,-3,1,4,1,3,-5,1,7,-6,-1,1,-1,-3,2,-4,2,0,-4,4,5,-2,-3,1,-4,3,1,1,1,1,-3,0,1,1,1,0,-1,3,0,0,0,1,-10,-11,1,4,2,2,4,2,-8,-3,-4,-2,0,0,-7,0,-3,-1,4,2,-1,-3,-1,-1,3,5,-1,-4,1,0,2,4,-2,-3,1,0,1,1,1,-1,0,0,-11,-2,-9,8,6,2,-1,-4,5,-4,-7,-1,0,-2,3,0,-2,-1,-1,-2,2,-4,-5,0,0,7,-2,2,1,0,0,6,-2,1,1,0,0,1,0,1,0,0,-12,-13,1,6,1,5,4,-9,-1,-5,-1,1,1,-6,-4,-4,1,0,3,-3,3,-1,-2,1,4,0,0,1,1,0,0,1,0,-1,1,0,4,-1,0,2,0,0,9,-3,12,8,1,7,14,9,-12,0,-4,-1,3,7,-10,-1,-3,-1,11,2,-2,1,-1,0,5,3,-2,0,1,0,1,1,-1,0,0,0,4,2,-1,0,1,0,22,10,12,34,21,13,9,-3,6,-4,16,-4,9,1,0,-8,10,-2,0,-4,6,4,6,-2,10,5,12,-1,7,0,9,4,6,-2,4,0,1,1,6,1,3,0
31,31157,Lodosa,4589,70,46,24,68,52,16,1,38,5,8,6,10,2,25,5,4,4,5,-1,13,0,4,2,5,7,19,28,11,0,1,6,14,21,9,0,1,1,5,7,2,0,0,67,41,26,44,32,12,8,15,25,6,7,6,9,10,18,5,1,-2,-1,5,7,1,6,8,6,12,16,8,2,0,4,10,13,4,1,0,2,2,3,4,1,0,59,50,9,74,43,31,13,23,21,-9,6,4,8,14,19,0,5,4,5,9,2,-9,1,0,16,22,30,5,1,0,9,12,17,4,1,0,7,10,13,1,0,0,16,14,2,55,33,22,8,6,3,5,3,-5,4,2,8,5,-1,-2,4,4,-5,0,4,-3,11,19,18,5,1,0,4,12,14,2,1,0,7,7,4,3,0,0,18,13,5,51,30,21,-1,10,-13,8,11,4,2,6,-3,4,3,2,-3,4,-10,4,8,2,8,14,18,6,4,0,3,11,12,4,0,0,5,3,6,2,4,0,24,6,18,25,8,17,11,8,8,-5,3,-2,0,7,4,-9,5,0,11,1,4,4,-2,-2,6,13,7,-2,1,0,4,4,3,-3,0,0,2,9,4,1,1,0,59,27,32,81,41,40,15,14,-1,15,7,7,12,4,-4,7,1,4,3,10,3,8,6,3,24,22,18,12,4,0,14,9,11,4,2,0,10,13,7,8,2,0,122,67,55,95,44,51,36,26,36,21,-5,7,25,7,20,12,-3,4,11,19,16,9,-2,3,25,28,32,10,0,0,12,10,16,5,1,0,13,18,16,5,-1,0,42,19,23,38,25,13,24,5,12,7,2,-8,10,6,9,2,-2,-4,14,-1,3,5,4,-4,8,12,14,5,-3,1,6,8,11,1,-2,1,2,4,3,4,-1,0,41,23,18,34,17,17,3,20,-6,19,1,3,9,3,3,9,-2,0,-6,17,-9,10,3,3,7,15,2,7,2,0,5,6,1,5,-1,0,2,9,1,2,3,0,20,6,14,13,1,12,21,8,-1,1,-4,-8,5,17,-8,-5,-6,0,16,-9,7,6,2,-8,7,7,-3,0,1,0,5,6,-4,-5,-1,0,2,1,1,5,2,0,-53,-36,-17,-37,-31,-6,-1,-12,-25,-12,-2,-1,4,-12,-14,-17,0,2,-5,0,-11,5,-2,-3,-7,-4,-14,-6,-7,-1,-6,-4,-12,-7,-4,0,-1,0,-2,1,-3,-1,-78,-40,-38,-29,-19,-10,-35,7,-30,-15,6,-10,-18,1,-14,-8,4,-5,-17,6,-16,-7,2,-5,-8,-1,-9,-12,1,0,-5,-1,-3,-10,0,0,-3,0,-6,-2,1,0,-71,-43,-28,-29,-22,-7,-15,1,-26,-19,-15,4,-12,6,-18,-13,-6,2,-3,-5,-8,-6,-9,2,-6,5,-12,-9,-9,1,-6,2,-11,-4,-3,0,0,3,-1,-5,-6,1,5,14,-9,-1,-5,4,-2,1,1,-8,11,2,0,4,6,-10,9,4,-2,-3,-5,2,2,-2,6,2,2,-8,-2,-2,2,1,0,-7,-1,-1,4,1,2,-1,-1,-1,-6,0,-6,16,9,7,-2,2,-17,13,2,-3,-4,6,-9,6,1,1,2,-4,-8,7,1,-4,8,-2,-2,7,4,1,3,-1,-3,6,3,1,5,-1,1,1,1,0,20,10,10,4,9,-5,17,6,2,-4,3,-5,8,2,-3,0,4,-2,9,4,5,-4,-1,-3,-3,4,-3,4,1,1,-2,2,1,5,2,1,-1,2,-4,-1,-1,0,35,17,18,13,8,5,6,13,-4,4,4,9,2,10,-5,5,1,3,4,3,1,-1,3,6,-1,12,-1,0,1,1,0,7,2,-3,1,0,-1,5,-3,3,0,1
31,31201,Pamplona/Iruña,180483,-756,-455,-301,122,55,67,-200,-83,-318,-176,-64,71,-121,-14,-189,-118,-28,16,-79,-69,-129,-58,-36,55,13,15,23,20,27,23,4,4,13,11,13,9,9,11,10,9,14,14,-1077,-605,-472,69,37,32,-192,-193,-416,-167,-143,51,-90,-99,-224,-117,-89,23,-102,-94,-192,-50,-54,28,13,12,12,3,14,13,9,7,6,1,7,6,4,5,6,2,7,7,-1853,-973,-880,-98,-18,-80,-347,-195,-666,-379,-195,-36,-185,-103,-327,-211,-96,-23,-162,-92,-339,-168,-99,-13,26,-49,-57,-9,-12,2,16,-14,-19,-3,0,2,10,-35,-38,-6,-12,0,-1325,-746,-579,442,218,224,-308,12,-569,-264,-178,-22,-183,3,-290,-181,-107,3,-125,9,-279,-83,-71,-25,66,144,107,63,36,19,24,70,62,31,19,10,42,74,45,32,17,9,1033,450,583,2433,1206,1227,42,615,245,207,-110,26,-14,260,139,126,-81,19,56,355,106,81,-29,7,429,780,728,357,95,27,214,352,409,182,31,12,215,428,319,175,64,15,2562,1314,1248,2808,1398,1410,279,802,869,342,114,118,119,393,514,163,52,50,160,409,355,179,62,68,528,841,823,415,124,55,273,397,449,201,42,24,255,444,374,214,82,31,1487,616,871,3625,1741,1884,-30,1023,295,180,5,-6,-84,522,112,30,7,13,54,501,183,150,-2,-19,597,1104,1076,603,168,55,276,527,538,286,83,22,321,577,538,317,85,33,1930,1172,758,3939,2122,1817,328,1250,128,202,-2,19,204,627,197,117,17,8,124,623,-69,85,-19,11,818,1224,1010,631,177,32,424,626,598,344,91,17,394,598,412,287,86,15,1006,441,565,2072,1059,1013,128,857,-5,19,-90,87,94,353,20,-30,-59,62,34,504,-25,49,-31,25,507,728,514,252,36,-1,269,356,268,118,24,1,238,372,246,134,12,-2,-964,-675,-289,1293,614,679,-181,418,-827,-243,-88,-42,-86,152,-508,-183,-56,-6,-95,266,-319,-60,-32,-36,317,434,308,156,37,13,183,182,144,77,13,2,134,252,164,79,24,11,-274,-268,-6,807,321,486,-134,561,-582,-117,-60,35,-67,232,-295,-112,-59,15,-67,329,-287,-5,-1,20,187,447,95,-1,46,13,106,204,11,-31,20,3,81,243,84,30,26,10,525,97,428,1218,471,747,197,506,-159,-99,5,44,104,184,-103,-123,-6,30,93,322,-56,24,11,14,198,499,317,92,51,32,82,177,158,8,18,13,116,322,159,84,33,19,-1153,-813,-340,-741,-504,-237,-26,278,-835,-449,-173,33,-43,111,-505,-306,-103,17,17,167,-330,-143,-70,16,15,117,-465,-346,-93,12,1,69,-290,-251,-51,10,14,48,-175,-95,-42,2,186,-41,227,-584,-421,-163,211,234,-345,-8,77,18,117,101,-239,-100,40,30,94,133,-106,92,37,-12,41,166,-446,-274,-76,-16,10,79,-280,-189,-41,-10,31,87,-166,-85,-35,-6,782,255,527,265,62,203,292,409,-158,11,130,38,118,166,-143,6,39,33,174,243,-15,5,91,5,133,290,-131,-88,26,6,70,116,-92,-58,5,5,63,174,-39,-30,21,1,1199,539,660,595,231,364,178,501,113,150,115,69,133,207,58,48,38,22,45,294,55,102,77,47,152,366,-13,-13,41,32,90,153,-16,-39,18,11,62,213,3,26,23,21,2274,877,1397,1183,431,752,517,649,404,379,99,143,247,257,157,101,15,46,270,392,247,278,84,97,227,498,262,64,54,42,119,198,117,-15,-14,6,108,300,145,79,68,36,2617,1074,1543,1809,812,997,569,915,475,320,198,100,300,383,195,99,52,28,269,532,280,221,146,72,333,712,373,200,98,53,173,328,170,77,21,23,160,384,203,123,77,30
31,31202,Peralta/Azkoien,4694,-23,-18,-5,20,12,8,5,-10,-20,-4,0,3,6,-6,-9,-11,-1,0,-1,-4,-11,7,1,3,0,6,7,4,3,0,0,3,4,3,2,0,0,3,3,1,1,0,-43,-37,-6,8,5,3,-3,-13,-25,-9,6,0,-1,-19,-11,-9,0,1,-2,6,-14,0,6,-1,0,4,2,2,0,0,0,2,1,2,0,0,0,2,1,0,0,0,13,-13,26,75,39,36,24,-8,2,-8,3,2,17,-19,-1,-13,1,3,7,11,3,5,2,-1,23,24,19,7,1,0,13,7,15,2,0,1,10,17,4,5,1,-1,-63,-52,-11,28,11,17,-15,-7,-27,-6,2,-6,-10,-4,-19,-13,0,-4,-5,-3,-8,7,2,-2,14,9,4,-2,4,-1,5,4,2,-2,2,0,9,5,2,0,2,-1,24,9,15,53,27,26,5,-1,11,0,3,7,-3,9,0,3,-1,4,8,-10,11,-3,4,3,23,10,9,10,0,1,11,9,2,5,0,0,12,1,7,5,0,1,65,33,32,94,51,43,13,22,20,7,2,0,5,14,9,5,1,-3,8,8,11,2,1,3,28,27,19,13,3,3,14,15,11,9,1,1,14,12,8,4,2,2,33,34,-1,75,50,25,-21,26,14,3,1,8,-10,14,16,7,0,5,-11,12,-2,-4,1,3,12,30,22,7,1,2,9,19,13,6,1,1,3,11,9,1,0,1,112,59,53,102,54,48,25,29,47,13,-4,5,11,16,32,4,-2,1,14,13,15,9,-2,4,18,29,36,18,1,0,7,14,26,7,0,0,11,15,10,11,1,0,143,75,68,86,44,42,33,43,43,17,8,-6,19,15,30,8,3,-5,14,28,13,9,5,-1,23,30,24,8,2,-2,11,15,15,4,-1,-1,12,15,9,4,3,-1,-19,-12,-7,15,-2,17,7,-1,-21,-9,-1,4,6,-2,-8,-12,2,1,1,1,-13,3,-3,3,19,9,-14,4,-1,-2,6,5,-11,-1,-1,0,13,4,-3,5,0,-2,-13,-9,-4,11,2,9,-6,-2,6,-17,0,3,2,-3,3,-12,-1,2,-8,1,3,-5,1,1,-1,7,4,-2,1,1,0,1,0,1,0,0,-1,6,4,-3,1,1,-81,-55,-26,-38,-28,-10,-15,-21,-15,-27,-4,2,-9,-12,-13,-21,-1,2,-6,-9,-2,-6,-3,0,-3,3,-18,-17,-3,0,-1,0,-15,-10,-2,0,-2,3,-3,-7,-1,0,-95,-63,-32,-74,-51,-23,-27,-11,-40,-13,-13,8,-18,-7,-19,-8,-13,1,-9,-4,-21,-5,0,7,-22,-12,-25,-12,-2,0,-13,-9,-13,-13,-3,0,-9,-3,-12,1,1,0,-83,-61,-22,-60,-40,-20,-13,-7,-36,-13,-7,-5,-13,-4,-23,-18,-1,-1,0,-3,-13,5,-6,-4,-7,-10,-21,-15,-6,-1,-5,-6,-14,-14,-1,0,-2,-4,-7,-1,-5,-1,-35,-13,-22,-4,4,-8,-10,3,5,-26,-7,0,-7,0,7,-9,-3,0,-3,3,-2,-17,-4,0,1,8,1,-11,-3,0,2,5,1,-4,0,0,-1,3,0,-7,-3,0,3,-8,11,-29,-22,-7,4,4,1,-8,-6,6,4,0,-4,-5,-4,1,0,4,5,-3,-2,5,-5,0,-11,-11,-5,3,-5,1,-8,-5,-6,1,0,-1,-3,-6,1,2,11,19,-8,12,13,-1,1,21,3,-12,-2,2,1,16,10,-8,-3,4,0,5,-7,-4,1,-2,7,9,6,-9,-2,0,8,4,7,-4,-4,1,-1,5,-1,-5,2,-1,7,3,4,39,21,18,13,10,-9,7,-11,-2,7,4,-5,6,-8,-1,6,6,-4,1,-3,-1,12,16,3,6,-2,2,6,7,4,5,-2,1,6,9,-1,1,0,1
31,31236,Ultzama,1630,-11,-1,-10,8,7,1,-6,4,-2,-7,-1,0,-1,2,2,-3,-2,0,-5,2,-4,-4,1,0,0,5,2,1,0,0,0,4,2,1,0,0,0,1,0,0,0,0,11,4,7,6,4,2,2,3,2,-1,1,4,0,1,2,2,-1,0,2,2,0,-3,2,4,1,3,1,1,0,0,1,1,1,1,0,0,0,2,0,0,0,0,13,4,9,21,9,12,0,8,0,2,6,-3,1,3,-2,1,4,-3,-1,5,2,1,2,0,5,5,8,1,2,0,3,2,3,0,1,0,2,3,5,1,1,0,-9,-4,-5,12,6,6,1,-1,-2,-11,-5,9,-1,1,3,-4,-5,2,2,-2,-5,-7,0,7,4,1,2,3,1,1,1,1,2,2,0,0,3,0,0,1,1,1,8,1,7,10,2,8,-3,5,5,-1,-1,4,-3,0,6,-1,-1,0,0,5,-1,0,0,4,0,3,5,2,0,0,0,1,1,0,0,0,0,2,4,2,0,0,9,0,9,3,1,2,3,-5,15,1,-3,-3,1,-4,8,-2,-1,-2,2,-1,7,3,-2,-1,0,0,1,2,0,0,0,0,1,0,0,0,0,0,0,2,0,0,4,10,-6,10,4,6,-7,4,3,3,0,0,-2,3,5,4,1,-2,-5,1,-2,-1,-1,2,0,5,3,2,0,0,0,3,1,0,0,0,0,2,2,2,0,0,45,36,9,10,4,6,5,7,8,17,6,2,2,3,5,17,6,3,3,4,3,0,0,-1,0,3,4,3,0,0,0,0,2,2,0,0,0,3,2,1,0,0,2,7,-5,7,6,1,-6,0,3,1,2,2,-3,3,0,6,2,0,-3,-3,3,-5,0,2,1,2,1,2,1,0,0,2,1,2,1,0,1,0,0,0,0,0,35,16,19,8,3,5,5,11,5,7,1,5,0,7,-1,6,1,2,5,4,6,1,0,3,5,2,3,-2,0,0,3,2,0,-2,0,0,2,0,3,0,0,0,20,12,8,5,2,3,9,0,2,4,2,4,3,1,1,3,1,4,6,-1,1,1,1,0,1,3,0,1,0,0,0,2,0,0,0,0,1,1,0,1,0,0,6,-2,8,4,1,3,3,-1,-4,6,0,1,0,0,-2,-3,0,2,3,-1,-2,9,0,-1,1,2,-1,1,-1,2,0,0,0,0,0,1,1,2,-1,1,-1,1,-10,-1,-9,1,-2,3,-1,1,-15,1,3,0,2,1,-7,1,2,0,-3,0,-8,0,1,0,3,1,0,-3,0,0,0,1,-1,-2,0,0,3,0,1,-1,0,0,-14,-4,-10,-12,-9,-3,-1,2,-1,-5,-2,-7,-1,1,0,-3,-1,0,0,1,-1,-2,-1,-7,-1,-1,-4,-4,-2,0,0,0,-3,-4,-2,0,-1,-1,-1,0,0,0,6,6,0,2,-1,3,7,-5,2,3,0,-2,3,-3,1,4,-1,1,4,-2,1,-1,1,-3,2,-1,0,2,-1,0,0,-1,0,1,-1,0,2,0,0,1,0,0,6,1,5,4,2,2,5,-1,2,2,-1,-2,3,-1,1,-3,-1,1,2,0,1,5,0,-3,1,0,0,3,0,0,0,0,0,2,0,0,1,0,0,1,0,0,-3,-4,1,0,1,-1,3,0,3,-5,-4,-1,2,0,2,-4,-3,-2,1,0,1,-1,-1,1,0,-1,2,-1,0,0,0,-1,3,-1,0,0,0,0,-1,0,0,0,8,6,2,9,6,3,-1,1,5,1,4,0,-3,1,4,0,4,0,2,0,1,1,0,0,1,3,1,3,1,0,0,1,2,2,1,0,1,2,-1,1,0,0
31,31258,Villava/Atarrabia,9142,115,36,79,109,41,68,2,22,60,19,-10,22,-11,16,28,0,-7,9,13,6,32,19,-3,13,10,24,39,26,5,4,2,9,17,10,1,1,8,15,22,16,4,3,207,126,81,128,65,63,30,26,107,23,8,10,19,14,66,12,6,8,11,12,41,11,2,2,41,26,39,17,4,0,22,9,21,10,2,0,19,17,18,7,2,0,209,96,113,123,64,59,59,30,77,23,4,12,32,13,31,12,0,8,27,17,46,11,4,4,36,31,29,18,5,2,22,15,13,9,2,1,14,16,16,9,3,1,29,18,11,13,5,8,8,1,4,-7,5,19,6,-3,-5,6,2,12,2,4,9,-13,3,7,4,2,3,2,1,1,2,-1,2,2,0,0,2,3,1,0,1,1,27,2,25,59,21,38,18,-19,39,-26,1,20,12,-5,16,-15,-4,4,6,-14,23,-11,5,16,13,16,13,4,6,6,7,8,2,0,1,3,6,8,11,4,5,3,12,2,10,71,34,37,-1,18,-24,-11,17,6,3,10,-5,-21,9,5,-4,8,-19,10,8,1,10,13,20,18,6,2,4,6,15,5,3,0,6,7,5,13,3,2,-64,-37,-27,71,26,45,-33,2,-31,-13,3,14,-17,3,-28,-3,3,5,-16,-1,-3,-10,0,9,14,18,20,9,3,4,8,7,7,1,1,0,6,11,13,8,2,4,203,124,79,183,98,85,35,65,49,40,11,2,14,39,35,27,2,4,21,26,14,13,9,-2,33,56,50,27,15,2,17,36,23,16,4,2,16,20,27,11,11,0,175,106,69,104,45,59,47,30,53,30,-5,15,26,17,24,23,0,10,21,13,29,7,-5,5,30,26,32,9,5,1,14,10,15,3,2,0,16,16,17,6,3,1,-112,-55,-57,-1,0,-1,-12,6,-69,-35,-4,2,-8,-4,-32,-12,2,-1,-4,10,-37,-23,-6,3,18,4,-6,-14,-1,-3,15,1,-9,-7,1,-2,3,3,3,-7,-2,-1,-97,-57,-40,-7,-6,-1,4,-6,-65,-23,-2,-7,3,-8,-34,-9,-3,-7,1,2,-31,-14,1,0,7,5,-13,-1,-2,-3,3,1,-7,1,-2,-2,4,4,-6,-2,0,-1,-34,-32,-2,-17,-11,-6,-5,-3,-60,6,13,15,-16,0,-26,2,5,4,11,-3,-34,4,8,11,-10,7,-11,0,-4,0,-6,3,-1,-2,-3,-2,-4,4,-10,2,-1,2,-128,-57,-71,5,1,4,14,-33,-59,-38,-29,19,13,-9,-40,-23,-10,13,1,-24,-19,-15,-19,6,15,12,-11,-9,-5,3,7,8,-7,-6,-5,4,8,4,-4,-3,0,-1,-85,-78,-7,-32,-21,-11,14,-22,-56,-32,0,9,1,-20,-32,-23,-7,6,13,-2,-24,-9,7,3,-1,-2,-11,-18,-5,3,-2,-2,-4,-14,-1,1,1,0,-7,-4,-4,2,87,37,50,-10,-5,-5,54,-1,13,28,-9,0,29,-3,0,15,-7,2,25,2,13,13,-2,-2,9,5,-11,-9,-5,0,5,0,-3,-7,-1,0,4,5,-8,-2,-4,0,71,38,33,0,7,-7,49,-2,-15,20,-3,21,20,8,-10,15,-7,12,29,-10,-5,5,4,9,-1,5,-2,-8,5,2,0,9,1,-5,1,2,-1,-4,-3,-3,4,0,-79,-37,-42,32,12,20,-43,-11,-11,-23,-4,17,-24,-1,-6,-10,-2,12,-19,-10,-5,-13,-2,5,8,1,9,0,4,7,4,-2,2,0,4,3,4,3,7,0,0,4,-33,-7,-26,58,25,33,6,-31,-25,5,0,14,0,-9,-8,-1,3,9,6,-22,-17,6,-3,5,12,9,19,12,5,1,2,3,12,7,0,1,10,6,7,5,5,0
32,32001,Allariz,5151,88,37,51,27,11,16,13,16,11,21,22,4,7,5,4,10,10,1,6,11,7,11,12,3,6,4,2,4,9,2,4,1,0,2,3,1,2,3,2,2,6,1,50,24,26,7,3,4,8,1,7,20,11,3,3,-4,3,10,8,4,5,5,4,10,3,-1,2,1,1,1,2,0,0,1,1,0,1,0,2,0,0,1,1,0,86,40,46,-3,-2,-1,9,16,17,26,12,5,7,5,8,12,7,1,2,11,9,14,5,4,-2,0,-1,2,-2,0,-1,0,-1,1,-1,0,-1,0,0,1,-1,0,101,49,52,-3,-4,1,14,7,31,26,18,1,4,6,15,13,10,1,10,1,16,13,8,0,-1,-2,0,-2,2,0,-1,-1,0,-2,1,-1,0,-1,0,0,1,1,70,32,38,14,7,7,13,3,31,10,15,-2,4,-3,17,4,8,2,9,6,14,6,7,-4,5,1,6,0,2,0,2,0,4,0,1,0,3,1,2,0,1,0,63,46,17,-2,0,-2,-5,20,20,17,15,-5,0,10,7,19,7,2,-5,10,13,-2,8,-7,0,1,-2,1,0,-2,0,1,-1,0,0,0,0,0,-1,1,0,-2,107,41,66,13,8,5,4,13,33,27,12,10,-2,-5,15,18,2,8,6,18,18,9,10,2,2,3,2,6,1,-2,0,1,2,4,0,0,2,2,0,2,1,-2,173,105,68,32,22,10,25,21,55,27,34,5,14,13,36,13,18,8,11,8,19,14,16,-3,5,9,4,8,3,1,4,6,5,3,3,0,1,3,-1,5,0,1,157,110,47,103,66,37,34,13,77,24,19,-8,15,9,48,25,16,-1,19,4,29,-1,3,-7,22,8,39,18,11,3,13,3,28,14,6,1,9,5,11,4,5,2,93,56,37,24,17,7,12,10,26,30,12,3,7,2,19,22,3,4,5,8,7,8,9,-1,6,2,7,10,1,-2,6,1,3,7,0,0,0,1,4,3,1,-2,109,57,52,-12,-3,-9,22,19,35,34,8,-13,13,13,9,18,8,-7,9,6,26,16,0,-6,-1,0,-9,0,-2,-1,0,3,-9,2,0,0,-1,-3,0,-2,-2,-1,99,62,37,10,0,10,9,4,25,43,20,-9,2,-2,10,32,13,0,7,6,15,11,7,-9,-4,0,0,0,8,6,-4,-3,-1,-1,5,4,0,3,1,1,3,2,28,12,16,-4,-1,-3,-1,-3,35,-1,-5,0,0,4,9,-3,-1,1,-1,-7,26,2,-4,-1,-2,0,0,-4,1,1,0,1,3,-5,0,0,-2,-1,-3,1,1,1,68,26,42,-5,-2,-3,9,21,27,26,-3,-13,3,0,17,9,0,-5,6,21,10,17,-3,-8,-3,-1,2,-2,-1,0,-2,0,1,-4,0,3,-1,-1,1,2,-1,-3,36,3,33,14,5,9,1,1,4,13,18,-2,-2,-5,-3,5,10,-2,3,6,7,8,8,0,2,1,3,5,4,-1,0,1,0,1,2,1,2,0,3,4,2,-2,-8,0,-8,9,2,7,-23,1,16,-8,2,0,-11,1,5,4,1,-1,-12,0,11,-12,1,1,-2,2,-2,1,7,2,-1,1,-3,0,3,2,-1,1,1,1,4,0,67,46,21,15,10,5,-4,5,25,14,25,-2,-2,1,17,11,14,3,-2,4,8,3,11,-5,0,7,7,4,-3,0,0,6,3,3,-3,1,0,1,4,1,0,-1,119,59,60,37,17,20,18,1,41,26,9,21,7,0,22,7,6,15,11,1,19,19,3,6,8,3,9,7,6,3,4,2,4,2,4,1,4,1,5,5,2,2
32,32004,Avión,2959,53,33,20,78,43,35,5,4,3,17,27,-4,4,0,2,7,18,2,1,4,1,10,9,-6,12,7,7,18,27,6,9,2,3,8,17,4,3,5,4,10,10,2,-5,6,-11,27,16,11,2,5,-4,-2,4,-10,6,3,-1,-2,2,-2,-4,2,-3,0,2,-8,7,3,2,5,6,4,6,0,2,2,3,3,1,3,0,3,3,1,-47,-19,-28,-7,-5,-2,-3,-2,-14,-7,-17,-5,-3,-5,-3,1,-6,-3,0,3,-11,-8,-11,-2,6,5,-8,0,-12,1,1,-3,-5,4,-3,1,5,8,-3,-4,-9,0,4,2,2,9,8,1,4,1,3,5,-3,-7,1,3,3,3,-5,-3,3,-2,0,2,2,-4,2,5,7,0,-2,-4,1,5,7,2,-5,-2,1,0,0,-2,3,-2,-35,-11,-24,14,9,5,-7,3,-20,-2,3,-11,-5,3,-10,-2,3,1,-2,0,-10,0,0,-12,-5,3,4,3,9,0,-3,2,2,0,6,2,-2,1,2,3,3,-2,-20,-3,-17,13,10,3,-11,-1,-6,-2,9,-9,-4,-3,-1,2,6,-3,-7,2,-5,-4,3,-6,-3,3,2,1,10,0,2,1,2,1,5,-1,-5,2,0,0,5,1,-35,-10,-25,16,7,9,-2,-6,-13,-7,2,-9,2,1,-7,-1,-2,-3,-4,-7,-6,-6,4,-6,3,0,6,2,4,1,1,1,3,1,1,0,2,-1,3,1,3,1,-45,-8,-37,-21,-6,-15,-8,-5,-11,2,-4,-18,-1,1,-2,3,1,-9,-7,-6,-9,-1,-5,-9,-4,-9,-4,0,-2,-2,-2,-2,1,0,0,-3,-2,-7,-5,0,-2,1,-47,-21,-26,-20,-10,-10,-2,-3,-6,-17,-6,-12,-4,-2,-2,-6,-3,-4,2,-1,-4,-11,-3,-8,1,-3,-5,-9,-3,-1,-2,-1,-2,-3,-2,0,3,-2,-3,-6,-1,-1,-57,-29,-28,-5,-7,2,-8,-10,1,-16,-4,-22,-4,-8,0,-6,0,-12,-4,-2,1,-10,-4,-10,-2,-1,-1,-3,2,-1,0,-3,-1,-2,1,-2,-2,2,0,-1,1,1,-34,-23,-11,2,-5,7,-6,9,-14,-4,-8,-11,-2,6,-10,-5,-8,-4,-4,3,-4,1,0,-7,3,2,-5,2,1,-1,2,1,-4,-2,-1,-1,1,1,-1,4,2,0,-35,-13,-22,-9,-6,-3,-1,-6,-1,-4,-6,-15,-2,-7,1,0,2,-5,1,1,-2,-4,-8,-10,-1,-4,1,-3,0,-2,-3,-5,2,-1,3,-2,2,1,-1,-2,-3,0,-20,-1,-19,4,6,-2,-8,1,-5,-1,0,-6,-1,-1,2,2,-1,-1,-7,2,-7,-3,1,-5,-4,0,5,0,0,3,2,-1,2,3,-2,2,-6,1,3,-3,2,1,-81,-43,-38,-28,-18,-10,-15,-2,-21,-23,-11,-7,-13,-3,-8,-10,-6,-1,-2,1,-13,-13,-5,-6,-6,0,-7,-12,-2,-1,-6,-2,-2,-6,-3,1,0,2,-5,-6,1,-2,-36,-11,-25,3,6,-3,-4,0,-13,-7,-4,-9,-2,-2,-6,-3,1,0,-2,2,-7,-4,-5,-9,5,2,-3,-1,0,0,2,0,-1,-1,3,3,3,2,-2,0,-3,-3,-50,-18,-32,-25,-3,-22,-2,4,-8,-19,-4,-21,1,0,-6,-7,0,-6,-3,4,-2,-12,-4,-15,-2,5,-3,-15,-5,-5,1,3,-2,-5,-1,1,-3,2,-1,-10,-4,-6,-51,-32,-19,-36,-26,-10,9,-3,-21,-8,-15,-13,2,-5,-5,-10,-5,-9,7,2,-16,2,-10,-4,10,-2,-15,-9,-10,-10,3,-5,-4,-8,-2,-10,7,3,-11,-1,-8,0,-45,-14,-31,-12,-5,-7,4,-2,-28,-15,-6,-1,5,2,-14,-6,-4,3,-1,-4,-14,-9,-2,-4,7,-1,-16,-10,-7,12,5,1,-10,-4,-4,7,2,-2,-6,-6,-3,5
32,32005,Baltar,1304,-16,-11,-5,7,4,3,-4,1,-11,-2,-1,1,-3,0,-8,-2,1,1,-1,1,-3,0,-2,0,1,1,0,1,2,2,1,0,0,0,2,1,0,1,0,1,0,1,9,0,9,4,1,3,4,2,1,3,1,-3,0,0,0,2,-1,-1,4,2,1,1,2,-2,1,0,1,1,0,0,0,0,0,1,0,0,1,0,1,0,0,0,-3,5,-8,1,1,0,-4,0,-9,1,4,5,-2,0,-3,1,5,4,-2,0,-6,0,-1,1,0,0,-1,-1,1,2,0,0,0,-1,1,1,0,0,-1,0,0,1,17,10,7,3,3,0,5,5,0,7,5,-5,3,2,1,3,2,-1,2,3,-1,4,3,-4,0,0,1,2,-1,1,0,0,0,2,0,1,0,0,1,0,-1,0,17,9,8,22,13,9,4,6,1,3,7,-4,3,2,-1,1,6,-2,1,4,2,2,1,-2,5,3,6,2,6,0,2,2,3,1,5,0,3,1,3,1,1,0,-7,4,-11,5,3,2,0,1,-2,-1,3,-8,1,4,1,0,1,-3,-1,-3,-3,-1,2,-5,0,1,3,0,1,0,0,1,2,0,0,0,0,0,1,0,1,0,0,2,-2,10,6,4,-3,-1,-3,6,7,-6,-2,-1,2,4,4,-5,-1,0,-5,2,3,-1,0,0,2,1,5,2,0,0,1,0,4,1,0,0,1,1,1,1,64,34,30,20,9,11,0,7,16,14,23,4,0,4,8,8,12,2,0,3,8,6,11,2,2,5,5,4,4,0,0,3,2,1,3,0,2,2,3,3,1,0,-2,-4,2,17,8,9,5,3,7,2,-1,-17,2,0,1,1,-1,-7,3,3,6,1,0,-10,3,3,5,2,1,2,1,1,3,1,1,1,2,2,2,1,0,1,-8,3,-11,7,6,1,-3,-1,2,4,1,-11,-1,2,1,3,2,-4,-2,-3,1,1,-1,-7,0,0,0,6,2,-1,0,0,0,5,1,0,0,0,0,1,1,-1,3,9,-6,8,6,2,0,2,-5,2,5,0,1,2,0,6,0,1,-1,0,-5,-4,5,-1,0,3,2,-1,1,3,0,2,2,0,0,2,0,1,0,-1,1,1,-7,-8,1,9,4,5,-1,8,-12,4,2,-8,1,8,-10,-2,2,-7,-2,0,-2,6,0,-1,1,4,-1,2,2,1,1,2,-1,0,2,0,0,2,0,2,0,1,-18,-2,-16,7,6,1,-2,-3,-5,-1,5,-11,3,-2,-3,-2,4,-2,-5,-1,-2,1,1,-9,0,3,-1,2,3,0,0,2,0,1,3,0,0,1,-1,1,0,0,2,5,-3,10,6,4,6,-1,-2,-1,1,-1,2,1,-1,1,0,2,4,-2,-1,-2,1,-3,0,0,2,1,4,3,0,0,2,0,2,2,0,0,0,1,2,1,-3,2,-5,2,2,0,0,3,0,1,2,-6,-1,-1,2,5,1,-1,1,4,-2,-4,1,-5,1,0,0,1,1,-1,1,-1,0,1,2,-1,0,1,0,0,-1,0,6,1,5,7,4,3,4,0,-7,4,8,-4,1,1,-8,1,5,0,3,-1,1,3,3,-4,2,0,1,1,3,-1,0,0,0,1,2,0,2,0,1,0,1,-1,-1,9,-10,0,2,-2,-1,4,5,0,-1,-8,0,4,5,1,-1,0,-1,0,0,-1,0,-8,-1,2,-1,3,0,-3,-1,2,0,2,0,-1,0,0,-1,1,0,-2,19,17,2,11,7,4,1,2,10,5,4,-4,2,2,6,1,4,1,-1,0,4,4,0,-5,0,2,3,1,3,2,0,1,2,0,2,2,0,1,1,1,1,0
32,32006,Bande,2660,-2,0,-2,41,20,21,-9,-9,-3,12,10,-4,-6,-2,-2,11,4,-5,-3,-7,-1,1,6,1,2,2,6,17,11,3,1,2,3,9,5,0,1,0,3,8,6,3,-35,-27,-8,17,9,8,-5,-7,-17,-11,4,3,-2,-8,-13,-8,3,1,-3,1,-4,-3,1,2,3,1,4,2,4,3,3,0,3,0,2,1,0,1,1,2,2,2,-18,-12,-6,16,6,10,0,-4,-7,-3,-3,1,0,-2,-9,-1,-1,2,0,-2,2,-2,-2,-1,5,4,1,2,0,4,1,0,0,1,0,4,4,4,1,1,0,0,7,7,0,24,15,9,-4,3,-1,-6,14,1,-2,2,0,-3,9,1,-2,1,-1,-3,5,0,2,1,5,1,9,6,1,0,3,2,7,2,1,1,2,-1,2,4,-30,-14,-16,21,10,11,-1,-6,-7,-8,-9,1,0,-3,-5,-5,-3,2,-1,-3,-2,-3,-6,-1,0,-1,4,7,3,8,1,0,1,4,0,4,-1,-1,3,3,3,4,-24,-7,-17,34,16,18,-3,-4,-13,0,6,-12,-2,-1,-10,3,7,-5,-1,-3,-3,-3,-1,-7,2,4,6,9,5,7,1,2,0,7,4,2,1,2,6,2,1,5,131,61,70,14,8,6,-1,19,41,35,26,10,-2,10,21,17,8,7,1,9,20,18,18,3,-1,5,5,1,4,0,-1,1,4,3,0,1,0,4,1,-2,4,-1,-58,-22,-36,13,7,6,-1,3,-24,-11,-9,-16,-1,8,-13,-7,-2,-7,0,-5,-11,-4,-7,-9,4,0,1,3,4,1,1,-1,0,4,2,1,3,1,1,-1,2,0,-30,3,-33,13,9,4,-2,-8,-17,0,-1,-1,1,-2,-5,6,-2,5,-3,-6,-12,-6,1,-6,0,1,-1,2,7,4,-1,1,0,2,4,3,1,0,-1,0,3,1,10,13,-3,16,8,8,6,0,4,-7,7,1,6,2,5,-7,6,1,0,-2,-1,0,1,0,2,3,1,1,4,5,2,1,0,0,2,3,0,2,1,1,2,2,-18,-7,-11,2,-2,4,5,6,-5,-4,-3,-17,3,4,-8,-4,2,-4,2,2,3,0,-5,-13,4,2,-2,1,1,-4,2,0,-3,-1,2,-2,2,2,1,2,-1,-2,-19,-7,-12,15,10,5,-3,3,-9,-7,6,-8,-5,5,-3,-3,3,-4,2,-2,-6,-4,3,-4,0,0,3,2,9,1,1,1,0,3,5,0,-1,-1,3,-1,4,1,-46,-12,-34,-4,1,-5,-5,-1,-15,-10,1,-17,1,-2,-8,-3,3,-4,-6,1,-7,-7,-2,-13,0,1,-2,-1,0,-2,0,1,0,-1,1,0,0,0,-2,0,-1,-2,-27,-9,-18,-8,-6,-2,-6,-6,3,-9,-6,-2,-6,-1,1,-2,-1,1,0,-5,2,-7,-5,-3,-1,-1,-2,-1,-2,-1,-1,0,-2,0,-2,-1,0,-1,0,-1,0,0,-53,-20,-33,3,6,-3,-5,-2,-15,-12,-1,-17,-2,-1,-6,-1,0,-9,-3,-1,-9,-11,-1,-8,0,1,0,3,-1,0,0,1,1,2,1,1,0,0,-1,1,-2,-1,-32,-13,-19,-6,-7,1,-3,-3,-10,-5,-4,-6,-4,0,1,-2,-4,-4,1,-3,-11,-3,0,-2,-1,-1,-1,-1,-4,2,-1,0,-1,-2,-3,0,0,-1,0,1,-1,2,-15,-10,-5,2,2,0,0,-1,2,-6,0,-8,2,0,0,-5,-2,-3,-2,-1,2,-1,2,-5,2,-2,2,-1,0,1,1,-1,1,1,-2,2,1,-1,1,-2,2,-1,9,12,-3,11,7,4,-6,6,-6,1,10,4,-4,6,0,0,10,0,-2,0,-6,1,0,4,0,3,-1,2,4,3,-1,2,0,0,4,2,1,1,-1,2,0,1
32,32008,Barbadás,5929,398,217,181,56,32,24,69,63,129,65,33,37,47,34,68,40,17,13,22,29,61,25,16,24,11,5,15,7,10,8,7,2,9,5,5,4,4,3,6,2,5,4,138,55,83,21,11,10,10,24,53,25,17,6,1,1,23,20,9,1,9,23,30,5,8,5,9,2,3,6,1,0,5,0,1,4,1,0,4,2,2,2,0,0,174,86,88,18,10,8,34,11,55,40,7,22,16,4,31,20,0,16,18,7,24,20,7,6,8,3,6,2,-1,0,6,0,3,1,-1,1,2,3,3,1,0,-1,312,136,176,21,10,11,34,49,116,59,33,12,11,23,51,31,19,-6,23,26,65,28,14,18,8,0,2,3,5,3,3,0,2,1,3,1,5,0,0,2,2,2,319,170,149,45,19,26,36,41,136,48,32,21,25,12,75,34,13,8,11,29,61,14,19,13,8,7,14,7,7,1,3,1,9,4,2,0,5,6,5,3,5,1,422,237,185,52,38,14,76,63,139,66,34,39,50,37,78,40,17,15,26,26,61,26,17,24,8,13,21,8,1,0,3,11,15,10,-1,0,5,2,6,-2,2,0,207,104,103,25,16,9,-2,21,78,46,43,16,-2,9,43,30,16,6,0,12,35,16,27,10,5,8,3,9,1,-1,4,4,3,5,0,0,1,4,0,4,1,-1,152,53,99,36,18,18,22,26,82,2,1,7,22,7,32,-5,-3,-5,0,19,50,7,4,12,5,11,2,11,4,2,3,9,-6,9,1,1,2,2,8,2,3,1,232,112,120,19,4,15,48,14,78,27,7,48,24,15,31,14,1,24,24,-1,47,13,6,24,7,7,7,-3,0,0,1,5,2,-4,-3,2,6,2,5,1,3,-2,237,114,123,16,6,10,19,34,73,30,16,57,5,21,27,23,7,24,14,13,46,7,9,33,13,6,6,-7,-1,-2,10,1,2,-8,2,-1,3,5,4,1,-3,-1,222,107,115,-39,-26,-13,57,16,83,30,-13,38,33,-5,42,20,-7,18,24,21,41,10,-6,20,-4,-1,-7,-16,-8,-4,1,-1,-8,-10,-6,-2,-5,0,1,-6,-2,-2,318,155,163,40,22,18,39,48,96,55,24,52,23,31,48,24,11,18,16,17,48,31,13,34,6,7,11,8,3,4,5,5,5,3,-1,5,1,2,6,5,4,-1,177,90,87,-16,-18,2,12,2,78,17,7,57,10,-4,37,9,11,25,2,6,41,8,-4,32,4,-3,-8,-6,-3,0,1,-3,-5,-5,-4,-2,3,0,-3,-1,1,2,163,126,37,7,7,0,-7,37,55,31,24,24,7,16,33,27,25,20,-14,21,22,4,-1,4,-2,9,-1,-1,2,0,0,6,0,-1,2,0,-2,3,-1,0,0,0,100,81,19,-15,-7,-8,18,-8,5,22,7,48,16,3,9,22,-2,30,2,-11,-4,0,9,18,4,-5,-6,-2,-2,-4,4,-3,-1,0,-5,-2,0,-2,-5,-2,3,-2,184,90,94,17,2,15,0,24,61,14,21,61,11,3,34,5,12,25,-11,21,27,9,9,36,6,-1,1,-6,10,7,3,-2,-2,-8,7,4,3,1,3,2,3,3,162,81,81,64,31,33,5,20,46,31,17,42,2,10,29,21,3,15,3,10,17,10,14,27,21,14,7,10,7,4,8,12,1,7,1,1,13,2,6,3,6,3,132,53,79,52,30,22,17,19,54,25,-6,24,2,5,34,13,-5,5,15,14,20,12,-1,19,10,8,18,14,5,-4,4,5,11,7,3,-1,6,3,7,7,2,-3
32,32009,"Barco de Valdeorras, O",12596,151,77,74,117,58,59,6,54,40,26,17,8,-4,18,32,17,13,1,10,36,8,9,4,7,26,34,23,15,11,7,18,12,12,7,6,2,8,22,11,8,5,5,207,87,120,126,57,69,49,44,60,32,23,-6,22,14,21,16,8,2,27,30,39,16,15,-8,27,30,39,16,7,6,16,16,14,5,3,2,11,14,25,11,4,4,98,48,50,106,52,54,46,49,17,1,0,-10,28,19,12,-5,-1,-2,18,30,5,6,1,-8,21,27,38,10,3,7,13,12,21,1,1,4,8,15,17,9,2,3,61,35,26,113,50,63,5,30,42,-14,-7,0,-6,32,22,-11,-9,3,11,-2,20,-3,2,-3,28,32,26,11,8,6,12,18,9,5,2,3,16,14,17,6,6,3,184,84,100,122,54,68,31,26,64,10,21,26,8,10,26,13,11,13,23,16,38,-3,10,13,31,35,26,11,8,10,15,12,10,8,4,5,16,23,16,3,4,5,109,63,46,124,63,61,8,56,23,5,13,1,9,23,11,18,-1,3,-1,33,12,-13,14,-2,30,42,25,14,6,6,17,17,12,10,2,4,13,25,13,4,4,2,162,84,78,124,62,62,23,38,19,19,38,21,6,26,9,7,23,12,17,12,10,12,15,9,29,26,27,17,16,5,15,13,13,11,7,2,14,13,14,6,9,3,71,37,34,145,72,73,30,16,-20,-2,28,20,16,5,-11,0,12,14,14,11,-9,-2,16,6,35,37,23,25,19,6,20,17,8,15,9,3,15,20,15,10,10,3,149,73,76,152,77,75,40,6,43,37,-5,28,18,1,25,17,5,7,22,5,18,20,-10,21,43,27,41,31,3,6,22,13,21,14,5,2,21,14,20,17,-2,4,-24,-30,6,6,-2,8,12,-15,0,-23,0,6,7,-11,-7,-17,-2,2,5,-4,7,-6,2,4,14,1,0,-7,1,-2,8,0,3,-11,0,-1,6,1,-3,4,1,-1,26,1,25,-11,-13,2,-10,8,-10,15,6,16,-1,1,-16,6,-3,13,-9,7,6,9,9,3,-12,4,-4,-2,5,-4,-5,3,-9,-3,-1,0,-7,1,5,1,6,-4,-38,-8,-30,-24,-17,-7,-11,-26,-21,-18,1,35,-4,-15,-2,-11,-5,25,-7,-11,-19,-7,6,10,-4,-3,-13,-10,5,1,-6,1,-8,-7,2,1,2,-4,-5,-3,3,0,-5,12,-17,8,2,6,-2,5,-3,-3,-1,-6,-1,16,-10,0,6,-1,-1,-11,7,-3,-7,-5,6,6,-8,7,-4,0,0,3,-5,5,-2,0,6,3,-3,2,-2,0,-39,0,-39,-63,-28,-35,16,-21,-18,-11,10,-9,10,-14,7,-3,-1,3,6,-7,-25,-8,11,-12,-13,-1,-23,-18,-3,-4,-4,-4,-11,-4,-3,-1,-9,3,-12,-14,0,-3,-80,-48,-32,-20,-9,-11,3,-34,-11,-28,-8,-4,4,-16,-5,-21,1,-11,-1,-18,-6,-7,-9,7,-1,-5,-8,-10,2,1,0,-5,1,-10,3,1,-1,0,-9,0,-1,0,36,28,8,-9,-17,8,26,-7,4,3,7,2,16,-5,-9,7,5,13,10,-2,13,-4,2,-11,8,5,-14,-3,-2,-4,-1,2,-13,-3,-1,-1,9,3,-1,0,-1,-3,-120,-33,-87,-38,-18,-20,-22,-2,-10,-42,-25,-16,-1,0,5,-28,-10,5,-21,-2,-15,-14,-15,-21,0,-5,-8,-17,-10,1,1,2,-4,-16,-2,1,-1,-7,-4,-1,-8,0,-53,-23,-30,55,26,29,-1,-1,-41,9,-19,1,-11,-5,-8,16,-11,-1,10,4,-33,-7,-8,2,14,13,9,11,5,3,3,5,9,6,2,1,11,8,0,5,3,2
32,32013,Boborás,3485,12,3,9,57,23,34,-6,-2,12,5,10,-9,-8,-4,4,3,4,2,2,2,8,2,6,-11,8,4,12,13,13,6,4,0,3,5,6,4,4,4,9,8,7,2,28,16,12,56,31,25,21,1,-5,6,0,2,11,-3,0,3,-1,4,10,4,-5,3,1,-2,21,6,5,9,6,7,10,3,4,4,3,5,11,3,1,5,3,2,-14,-11,-3,24,12,12,-3,-1,-8,-2,-3,1,-1,0,-8,-3,0,0,-2,-1,0,1,-3,1,4,4,5,0,5,4,4,3,2,-1,2,1,0,1,3,1,3,3,0,-2,2,57,22,35,7,-6,-1,-4,12,-9,1,-2,-2,-3,7,-4,6,-4,1,-1,5,-5,8,3,17,11,14,3,2,1,7,3,8,0,6,2,10,8,6,3,-37,-3,-34,23,19,4,-2,-5,-11,-3,4,-19,3,0,-6,1,4,-5,-5,-5,-5,-4,0,-14,5,3,2,1,8,4,5,2,2,1,6,3,0,1,0,0,2,1,-20,0,-20,35,24,11,3,-1,-21,-3,10,-8,2,6,-8,-2,7,-5,1,-7,-13,-1,3,-3,8,5,4,5,10,2,6,5,4,1,7,1,2,0,0,4,3,1,-5,-4,-1,24,11,13,5,-8,-14,9,5,-2,-3,-6,-3,5,3,0,8,-2,-11,4,2,-2,13,-1,-2,5,6,3,6,0,-3,2,3,3,7,-1,1,3,3,0,60,30,30,41,22,19,6,4,19,14,21,-9,5,3,8,8,6,-5,1,1,11,6,15,-4,-3,8,15,5,14,1,-2,5,12,3,3,0,-1,3,3,2,11,1,-18,-20,2,1,-11,12,-4,1,-9,-4,2,-4,-5,-1,-7,-4,-4,1,1,2,-2,0,6,-5,-1,4,-1,-3,-1,3,-2,0,-4,-1,-5,1,1,4,3,-2,4,2,-15,-6,-9,26,12,14,-17,0,-8,10,17,-16,-9,-2,-4,2,11,-2,-8,2,-4,8,6,-14,-4,2,2,13,15,-2,-1,0,0,4,9,0,-3,2,2,9,6,-2,22,13,9,39,21,18,2,8,-4,12,18,-13,2,5,-3,10,9,-10,0,3,-1,2,9,-3,4,8,2,7,16,2,3,4,0,3,8,3,1,4,2,4,8,-1,-25,2,-27,11,11,0,-6,2,-4,-5,2,-13,-2,1,2,0,3,-1,-4,1,-6,-5,-1,-12,1,2,-1,-2,6,4,4,2,2,-3,0,5,-3,0,-3,1,6,-1,-55,-21,-34,-3,-4,1,-2,1,-26,-8,-5,-15,-5,2,-12,-1,0,-5,3,-1,-14,-7,-5,-10,4,0,-1,-5,0,-1,0,2,-3,-2,1,-2,4,-2,2,-3,-1,1,-66,-33,-33,-14,-6,-8,-23,3,-22,-18,3,-8,-9,1,-9,-9,0,-8,-14,2,-13,-9,3,0,-6,3,-3,-5,-2,-2,-2,1,-1,-1,0,-4,-4,2,-2,-4,-2,2,-21,-7,-14,5,0,5,-4,2,1,5,-3,-21,-4,-1,0,2,2,-6,0,3,1,3,-5,-15,0,4,0,-1,3,-1,-1,0,1,-1,1,0,1,4,-1,0,2,-1,-30,-14,-16,-7,-3,-4,11,3,-10,3,-19,-17,3,-2,-4,-2,-7,-2,8,5,-6,5,-12,-15,4,5,-9,2,-16,7,1,0,-7,0,-4,7,3,5,-2,2,-12,0,-43,-17,-26,-12,-4,-8,8,-7,-15,-9,-4,-15,8,-6,-8,0,-1,-9,0,-1,-7,-9,-3,-6,-1,-2,-8,1,0,-2,0,-1,-3,4,-1,-3,-1,-1,-5,-3,1,1,-21,-2,-19,-8,1,-9,13,-9,-9,-2,-6,-8,6,-3,-2,-2,3,-4,7,-6,-7,0,-9,-4,-1,1,-3,-6,-1,2,-1,1,-1,-5,4,3,0,0,-2,-1,-5,-1
32,32014,"Bola, A",1599,20,8,12,10,4,6,3,5,3,6,6,-3,0,0,3,0,5,0,3,5,0,6,1,-3,1,0,2,3,1,3,0,0,1,2,0,1,1,0,1,1,1,2,-5,-1,-4,4,3,1,-3,-2,-3,2,3,-2,0,0,-2,0,2,-1,-3,-2,-1,2,1,-1,1,0,1,0,1,1,1,0,1,0,0,1,0,0,0,0,1,0,8,12,-4,1,0,1,1,2,2,1,6,-3,-1,1,5,4,3,0,2,1,-3,-3,3,-3,0,-1,1,0,0,1,0,-1,1,0,-1,1,0,0,0,0,1,0,26,18,8,8,5,3,-2,5,16,13,-7,1,2,4,10,6,-6,2,-4,1,6,7,-1,-1,1,0,2,2,1,2,1,0,1,2,0,1,0,0,1,0,1,1,-13,-6,-7,7,4,3,0,4,-13,-2,2,-4,0,3,-7,-1,2,-3,0,1,-6,-1,0,-1,0,3,0,1,1,2,0,2,0,1,0,1,0,1,0,0,1,1,0,5,-5,0,2,-2,-1,2,13,0,-2,-12,-1,2,9,-1,1,-5,0,0,4,1,-3,-7,1,1,1,0,-1,-2,0,0,1,0,1,0,1,1,0,0,-2,-2,3,7,-4,9,5,4,-5,0,0,-1,8,2,-3,0,0,3,3,4,-2,0,0,-4,5,-2,1,1,3,0,2,2,1,1,2,0,0,1,0,0,1,0,2,1,28,8,20,3,0,3,4,5,6,10,4,0,3,1,-1,4,4,-2,1,4,7,6,0,2,3,1,-1,1,-1,0,1,1,-1,0,-1,0,2,0,0,1,0,0,6,-9,15,3,1,2,5,-3,0,10,-1,-5,1,-4,0,2,-2,-6,4,1,0,8,1,1,0,1,2,1,-1,0,0,1,0,1,-1,0,0,0,2,0,0,0,5,2,3,0,-3,3,5,-5,2,7,-2,-2,3,-4,3,3,-1,-2,2,-1,-1,4,-1,0,1,0,1,2,-3,-1,1,0,0,0,-3,-1,0,0,1,2,0,0,-15,-4,-11,-2,-1,-1,-2,-1,0,-4,4,-12,-2,0,4,-4,3,-4,0,-1,-4,0,1,-8,-1,-1,2,0,-1,-1,-1,-1,2,0,0,-1,0,0,0,0,-1,0,-19,-6,-13,0,2,-2,1,2,1,-2,0,-20,2,0,1,0,0,-8,-1,2,0,-2,0,-12,0,0,1,-1,2,-2,0,-1,1,1,2,-1,0,1,0,-2,0,-1,-4,3,-7,4,4,0,0,5,-6,-5,-4,6,0,3,-1,-1,-1,3,0,2,-5,-4,-3,3,2,2,1,-2,-1,2,1,1,1,-1,0,2,1,1,0,-1,-1,0,19,15,4,0,1,-1,-4,7,7,0,2,7,-1,6,2,0,3,5,-3,1,5,0,-1,2,0,3,0,0,-2,-1,0,2,0,0,-1,0,0,1,0,0,-1,-1,-5,-9,4,6,6,0,1,5,-6,5,0,-9,-2,2,-3,-2,-1,-3,3,3,-3,7,1,-6,1,3,0,2,2,-2,0,1,1,2,2,0,1,2,-1,0,0,-2,-44,-26,-18,3,1,2,-4,-4,-22,-8,1,-7,-4,0,-16,-4,0,-2,0,-4,-6,-4,1,-5,-2,1,1,2,0,0,-1,1,0,1,0,0,-1,0,1,1,0,0,2,2,0,11,6,5,6,3,-4,-3,6,-5,4,1,-2,-3,5,-3,2,2,-2,0,1,-2,3,3,-1,2,2,2,2,2,-1,0,1,2,1,1,0,2,1,0,-25,-12,-13,7,4,3,-8,-1,-4,-3,5,-15,-2,-2,-2,0,1,-7,-6,1,-2,-3,4,-8,-1,-2,5,3,5,-3,0,-1,3,2,2,-2,-1,-1,2,1,3,-1
32,32019,"Carballiño, O",12363,145,51,94,149,70,79,17,3,27,7,58,32,9,-3,8,-5,26,18,8,6,19,12,32,14,25,23,24,17,43,13,10,8,9,9,23,8,15,15,15,8,20,5,196,78,118,96,50,46,53,29,44,33,22,17,20,11,22,16,7,4,33,18,22,17,15,13,19,16,11,23,20,7,9,10,8,8,11,4,10,6,3,15,9,3,257,145,112,201,90,111,62,49,43,21,43,34,31,26,28,13,22,21,31,23,15,8,21,13,45,30,30,31,35,27,19,14,7,15,18,15,26,16,23,16,17,12,227,103,124,174,81,93,56,37,26,21,49,31,25,5,3,22,21,20,31,32,23,-1,28,11,31,35,40,22,26,17,13,10,16,13,15,12,18,25,24,9,11,5,322,138,184,206,83,123,29,65,78,54,41,53,16,30,34,17,17,26,13,35,44,37,24,27,24,50,52,34,22,23,10,17,22,10,10,13,14,33,30,24,12,10,305,139,166,177,82,95,61,65,50,51,30,46,26,30,30,17,16,20,35,35,20,34,14,26,26,58,33,30,23,5,12,30,12,15,11,1,14,28,21,15,12,4,273,122,151,181,100,81,57,35,73,37,40,26,26,9,40,14,22,7,31,26,33,23,18,19,33,36,38,28,35,10,19,19,21,12,23,5,14,17,17,16,12,5,163,77,86,174,99,75,24,46,9,16,51,21,14,21,9,15,22,3,10,25,0,1,29,18,29,44,31,24,37,8,21,26,17,14,17,4,8,18,14,10,20,4,183,85,98,139,54,85,30,29,57,18,22,28,14,9,37,-2,9,16,16,20,20,20,13,12,29,34,38,20,15,1,10,15,15,7,5,0,19,19,23,13,10,1,105,43,62,46,10,36,-2,29,20,-2,30,24,-9,11,11,-2,19,10,7,18,9,0,11,14,-1,25,5,2,8,6,-4,5,3,-1,4,3,3,20,2,3,4,3,76,55,21,43,20,23,3,-1,1,10,38,20,-10,2,13,5,21,20,13,-3,-12,5,17,0,4,19,-2,12,5,3,0,8,4,5,2,0,4,11,-6,7,3,3,216,118,98,100,43,57,18,39,52,21,47,37,12,16,47,6,29,6,6,23,5,15,18,31,11,30,21,13,20,5,7,7,8,8,13,0,4,23,13,5,7,5,175,85,90,38,28,10,8,11,25,39,41,41,4,6,6,28,18,16,4,5,19,11,23,25,11,5,3,3,10,4,8,5,-2,5,6,5,3,0,5,-2,4,-1,-138,-99,-39,-98,-59,-39,-32,-42,-33,-42,8,4,-13,-26,-33,-29,4,4,-19,-16,0,-13,4,0,-5,-7,-52,-24,-5,-6,-6,-1,-37,-13,-1,-1,1,-6,-15,-11,-4,-5,-34,-26,-8,17,4,13,2,-26,-35,-5,3,20,5,-7,-20,-10,-8,10,-3,-19,-15,5,11,10,8,5,-11,-3,8,9,6,1,-3,-2,0,2,2,4,-8,-1,8,7,6,14,-8,35,8,27,-27,-3,-5,-30,40,25,-9,4,-2,-13,19,9,-18,-7,-3,-17,21,16,13,4,-4,0,17,3,4,1,-2,-4,7,0,9,3,-2,4,10,3,63,26,37,92,49,43,-5,10,17,6,13,20,-2,6,10,1,6,5,-3,4,7,5,7,15,22,11,28,5,15,11,14,4,13,6,8,5,8,7,15,-1,7,6,162,94,68,176,88,88,36,27,6,44,38,15,18,11,6,25,16,19,18,16,0,19,22,-4,39,24,35,31,24,22,16,11,17,14,11,17,23,13,18,17,13,5
32,32020,Cartelle,3981,21,22,-1,41,25,16,-10,11,-13,14,18,2,-3,7,1,6,11,1,-7,4,-14,8,7,1,4,2,6,11,14,4,4,1,4,8,7,1,0,1,2,3,7,3,9,3,6,23,14,9,-1,12,-12,3,7,0,0,3,-8,1,5,2,-1,9,-4,2,2,-2,5,2,2,9,3,2,3,1,1,5,2,2,2,1,1,4,1,0,6,-2,8,30,12,18,4,-5,-3,-2,7,1,2,-8,2,-1,2,-2,2,3,-5,-1,5,3,6,-2,6,3,6,9,4,-2,2,2,0,4,2,0,4,1,6,5,8,-5,13,32,19,13,-4,7,0,7,3,-5,-5,0,-2,9,-5,-2,1,7,2,-2,8,-3,5,2,8,5,10,2,5,0,3,5,3,3,0,2,5,0,7,-1,24,13,11,23,12,11,0,2,-5,2,15,9,2,6,-7,-1,9,3,-2,-4,2,3,6,6,3,0,2,4,9,5,2,-2,1,1,8,2,1,2,1,3,1,3,20,18,2,30,22,8,-3,8,-15,2,20,8,-1,1,-6,0,15,9,-2,7,-9,2,5,-1,6,2,1,2,13,6,5,2,0,2,10,3,1,0,1,0,3,3,47,37,10,36,20,16,-3,10,-6,26,19,2,2,10,-4,12,15,2,-5,0,-2,14,4,0,1,5,8,8,10,4,1,4,4,4,5,2,0,1,4,4,5,2,7,13,-6,28,16,12,0,5,-5,-13,22,-2,2,2,-1,-8,16,3,-2,3,-4,-5,6,-5,5,1,5,2,12,2,4,0,2,0,9,1,1,1,3,2,3,1,15,11,4,15,10,5,-3,-1,14,0,13,-6,-2,0,6,0,9,-1,-1,-1,8,0,4,-5,1,-1,4,5,4,3,1,-1,2,3,4,1,0,0,2,2,0,2,9,17,-8,17,13,4,1,12,-16,12,10,-7,0,10,-4,11,4,-2,1,2,-12,1,6,-5,3,1,2,0,9,2,3,1,2,2,5,0,0,0,0,-2,4,2,-5,2,-7,4,2,2,-10,5,3,-18,17,-2,-4,2,4,-14,12,2,-6,3,-1,-4,5,-4,-3,0,2,0,-1,6,-2,0,0,0,-1,5,-1,0,2,0,0,1,-29,-6,-23,-2,-4,2,-6,2,-1,2,1,-27,-3,3,0,1,5,-12,-3,-1,-1,1,-4,-15,-1,-1,0,0,0,0,-1,-1,0,-1,1,-2,0,0,0,1,-1,2,-38,-10,-28,-5,-3,-2,-4,2,-7,-14,2,-17,-2,2,1,-3,-2,-6,-2,0,-8,-11,4,-11,0,-1,-2,-3,-1,1,0,-1,-1,-2,0,0,0,0,-1,-1,-1,1,-43,-21,-22,-5,-1,-4,-2,3,-14,-19,-3,-10,-1,-1,-4,-9,-4,-4,-1,4,-10,-10,1,-6,-2,1,-2,-3,0,1,-2,0,0,0,-2,3,0,1,-2,-3,2,-2,-29,-4,-25,-3,1,-4,-7,-3,-16,5,2,-10,-2,-1,-6,8,1,-4,-5,-2,-10,-3,1,-6,1,-1,0,1,3,-7,1,-1,2,1,1,-3,0,0,-2,0,2,-4,-42,-28,-14,-10,-9,-1,-3,5,-20,-3,1,-23,-1,3,-16,1,2,-18,-2,2,-4,-4,-1,-5,0,1,-5,-3,-1,-2,0,1,-5,-4,1,-2,0,0,0,1,-2,0,-15,-3,-12,14,5,9,5,-1,-6,2,-2,-12,3,-1,-1,-1,-1,-2,2,0,-5,3,-1,-10,0,1,0,1,2,10,0,0,-1,1,0,5,0,1,1,0,2,5,7,4,3,11,2,9,5,3,1,-3,8,-6,0,4,-1,-1,5,-1,5,-1,2,-2,3,-5,3,1,2,1,6,-3,1,-1,0,0,2,0,2,2,2,1,4,-3
32,32021,Castrelo do Val,1312,0,3,-3,10,5,5,6,0,-1,-2,1,-4,3,0,2,0,0,-2,3,0,-3,-2,1,-2,0,2,0,0,6,2,0,1,0,0,2,2,0,1,0,0,4,0,8,-2,10,5,1,4,1,1,-2,6,6,-4,1,2,-6,2,1,-2,0,-1,4,4,5,-2,0,0,0,0,5,0,0,0,0,0,1,0,0,0,0,0,4,0,-11,1,-12,2,3,-1,-1,-3,-6,4,-3,-1,-1,-1,0,1,-1,3,0,-2,-6,3,-2,-4,0,-1,1,0,0,2,0,0,1,0,0,2,0,-1,0,0,0,0,-12,-5,-7,1,1,0,-5,-1,-4,2,2,-7,-1,-1,-4,3,2,-4,-4,0,0,-1,0,-3,0,0,0,1,0,0,0,0,0,1,0,0,0,0,0,0,0,0,14,9,5,15,6,9,4,3,3,3,5,-3,2,1,4,1,3,-1,2,2,-1,2,2,-2,3,1,2,4,4,1,1,0,1,1,3,0,2,1,1,3,1,1,-5,3,-8,4,2,2,-2,-1,1,1,0,-3,0,-2,0,5,3,-2,-2,1,1,-4,-3,-1,0,1,1,-1,1,2,0,0,0,0,1,1,0,1,1,-1,0,1,27,13,14,7,4,3,8,5,4,3,8,-1,5,6,0,0,5,-2,3,-1,4,3,3,1,0,1,0,0,3,3,0,1,0,0,2,1,0,0,0,0,1,2,16,12,4,9,6,3,7,0,-3,8,4,2,8,2,-3,2,2,2,-1,-2,0,6,2,0,-2,-1,2,0,4,6,0,-1,0,1,2,4,-2,0,2,-1,2,2,15,10,5,4,3,1,5,2,-4,11,6,-6,2,1,-3,6,3,-1,3,1,-1,5,3,-5,2,0,0,1,1,-1,1,0,0,1,0,0,1,0,0,0,1,-1,-23,-12,-11,3,2,1,4,-5,2,-9,-1,-14,3,-5,-2,-4,0,-4,1,0,4,-5,-1,-10,0,0,0,0,2,1,0,0,0,0,1,1,0,0,0,0,1,0,-7,-2,-5,4,3,1,-2,-2,-1,-5,10,-8,0,0,-3,-4,5,-1,-2,-2,2,-1,5,-7,1,1,0,0,2,0,1,1,0,0,1,0,0,0,0,0,1,0,17,11,6,10,7,3,8,4,3,5,3,-7,6,3,3,1,3,-5,2,1,0,4,0,-2,1,4,1,1,2,1,1,3,0,0,2,1,0,1,1,1,0,0,-18,-2,-16,4,2,2,-5,-2,1,-1,0,-12,-2,0,6,1,-1,-6,-3,-2,-5,-2,1,-6,0,0,1,1,1,1,0,0,1,0,0,1,0,0,0,1,1,0,-16,-3,-13,0,1,-1,2,-3,-8,-3,3,-7,3,-1,-4,-1,3,-3,-1,-2,-4,-2,0,-4,0,0,0,0,-1,1,0,0,0,0,0,1,0,0,0,0,-1,0,-23,-17,-6,3,1,2,-17,1,-1,0,3,-10,-13,-2,0,1,2,-5,-4,3,-1,-1,1,-5,0,0,0,1,3,-1,0,0,0,0,2,-1,0,0,0,1,1,0,1,-1,2,-4,-3,-1,4,2,-5,2,0,-2,0,3,-7,2,2,-1,4,-1,2,0,-2,-1,0,0,0,-2,0,-2,0,0,0,-1,0,-2,0,0,0,-1,0,0,-19,-11,-8,0,1,-1,1,-2,-1,-7,0,-10,2,-2,-1,-6,1,-5,-1,0,0,-1,-1,-5,-1,0,0,0,0,1,-1,0,0,1,0,1,0,0,0,-1,0,0,-16,-15,-1,-2,-2,0,-5,-4,5,-2,0,-11,-2,-3,-2,0,-1,-8,-3,-1,7,-2,1,-3,0,0,-1,0,0,-1,0,0,-1,0,0,-1,0,0,0,0,0,0
32,32024,Celanova,5959,52,30,22,56,28,28,-8,0,1,5,32,21,-6,-3,6,5,15,12,-2,3,-5,0,17,9,3,4,3,8,26,12,2,1,2,5,12,6,1,3,1,3,14,6,42,11,31,31,20,11,-1,-1,-5,14,20,15,-7,-5,-6,10,11,9,6,4,1,4,9,6,3,2,5,7,8,6,3,1,3,3,6,4,0,1,2,4,2,2,49,37,12,52,30,22,5,1,-2,18,25,4,7,2,-4,10,14,8,-2,-1,2,8,11,-4,8,6,6,8,20,4,6,2,2,5,11,4,2,4,4,3,9,0,66,35,31,55,29,26,27,-8,9,11,14,13,12,-2,3,7,7,7,15,-6,6,4,7,6,12,5,13,9,9,6,7,2,8,5,5,1,5,3,5,4,4,5,90,48,42,105,52,53,2,23,1,15,36,15,2,16,-2,10,19,7,0,7,3,5,17,8,9,15,20,17,31,13,2,9,8,6,18,9,7,6,12,11,13,4,79,37,42,81,33,48,16,-21,12,26,15,36,8,-16,9,16,7,16,8,-5,3,10,8,20,15,5,20,18,11,13,7,0,9,8,5,5,8,5,11,10,6,8,59,29,30,80,42,38,19,11,-14,-5,37,9,4,6,-16,4,23,7,15,5,2,-9,14,2,13,11,10,11,24,10,3,6,6,6,14,6,10,5,4,5,10,4,58,36,22,60,28,32,7,13,-16,21,32,0,1,11,1,9,11,4,6,2,-17,12,21,-4,6,12,14,5,18,5,2,6,9,2,6,3,4,6,5,3,12,2,5,11,-6,49,27,22,-4,-8,0,-12,15,12,1,-5,3,-4,7,9,-5,-3,-3,-8,8,3,5,7,10,8,11,7,3,4,5,5,5,5,2,3,5,3,6,2,0,-17,17,33,7,26,-4,4,-27,5,13,11,0,1,-17,-3,1,4,-4,3,-10,8,12,7,3,3,5,0,17,3,1,0,0,-1,5,0,2,3,5,1,12,3,33,-12,45,53,17,36,1,-6,-2,16,15,9,-7,-5,-9,3,9,-2,8,-1,7,13,6,11,3,10,7,14,11,8,-1,1,4,6,3,4,4,9,3,8,8,4,-31,7,-38,-13,-4,-9,2,-2,1,0,-12,-19,2,1,3,10,-4,-6,0,-3,-2,-10,-8,-13,-2,5,0,-6,-9,-1,-1,1,3,-1,-4,-2,-1,4,-3,-5,-5,1,-29,-17,-12,-19,-10,-9,-9,-11,-11,0,8,-9,-5,-6,1,-3,-1,-5,-4,-5,-12,3,9,-4,-4,-1,-7,0,0,-8,-1,-1,-3,-3,-2,-1,-3,0,-4,3,2,-7,37,26,11,18,11,7,18,3,-1,24,1,-8,8,2,-6,20,4,-2,10,1,5,4,-3,-6,1,8,-1,7,-1,4,1,4,-2,4,3,1,0,4,1,3,-4,3,-5,3,-8,11,5,6,0,1,-10,3,4,-4,-2,-2,4,5,1,-3,2,3,-14,-2,3,-1,4,0,-4,4,5,2,1,0,-3,2,3,2,3,0,-1,2,2,0,-41,-2,-39,-32,-1,-31,-3,-10,-1,-21,6,-11,3,-1,7,-7,3,-6,-6,-9,-8,-14,3,-5,0,-1,-7,-18,3,-9,2,3,5,-9,1,-3,-2,-4,-12,-9,2,-6,5,3,2,59,24,35,-2,2,4,-6,16,-8,-3,-2,3,1,4,1,1,4,1,-7,12,-9,10,7,10,10,15,7,4,5,4,3,5,3,6,2,6,7,10,4,104,43,61,124,54,70,18,18,11,6,25,27,11,13,3,1,9,6,7,5,8,5,16,21,21,26,18,23,24,12,10,14,9,10,9,2,11,12,9,13,15,10
32,32026,Coles,3063,74,34,40,18,8,10,4,19,20,14,14,2,2,8,10,3,10,0,2,11,10,11,4,2,2,6,6,0,4,0,2,1,2,0,3,0,0,5,4,0,1,0,21,11,10,18,7,11,-1,14,-11,4,9,6,1,6,-7,0,6,5,-2,8,-4,4,3,1,1,3,3,3,4,4,0,1,1,1,2,2,1,2,2,2,2,2,28,20,8,17,9,8,5,3,10,11,3,-2,1,1,8,5,3,3,4,2,2,6,0,-5,3,4,3,4,1,2,0,2,3,4,-1,1,3,2,0,0,2,1,83,35,48,19,12,7,16,19,3,36,12,-2,4,6,-2,21,6,1,12,13,5,15,6,-3,2,4,8,1,1,3,1,3,5,1,0,2,1,1,3,0,1,1,37,15,22,11,7,4,6,13,6,-1,16,-3,0,8,-1,-1,11,-2,6,5,7,0,5,-1,1,1,2,4,2,1,1,1,1,1,2,1,0,0,1,3,0,0,39,21,18,13,7,6,8,12,14,7,5,-5,6,8,5,3,3,-2,2,4,9,4,2,-3,3,4,1,1,2,2,3,2,-1,1,2,0,0,2,2,0,0,2,6,7,-1,18,9,9,2,4,-5,7,2,-3,3,3,-5,10,0,-3,-1,1,0,-3,2,0,7,3,3,1,4,0,5,1,2,0,1,0,2,2,1,1,3,0,2,-3,5,10,2,8,8,-5,0,-1,4,-3,6,-5,-3,-1,3,-1,2,0,3,0,1,-2,4,2,4,1,0,0,1,0,2,1,-1,0,3,2,2,0,1,0,-15,6,-21,1,0,1,5,0,-15,3,-5,-3,-1,0,0,7,1,-1,6,0,-15,-4,-6,-2,1,-1,0,1,0,0,0,-1,-1,1,1,0,1,0,1,0,-1,0,14,10,4,5,2,3,5,4,-10,12,7,-5,1,4,-2,4,5,-3,4,0,-8,8,2,-2,3,1,-2,3,-1,1,2,1,0,0,-1,0,1,0,-2,3,0,1,17,13,4,-6,-1,-5,-7,8,-10,13,12,-3,-2,3,1,7,2,0,-5,5,-11,6,10,-3,-2,1,-2,2,-1,-4,0,0,-1,2,-1,-1,-2,1,-1,0,0,-3,49,16,33,2,3,-1,15,7,4,10,4,5,1,2,5,3,5,0,14,5,-1,7,-1,5,0,0,0,4,-1,-1,0,0,0,3,1,-1,0,0,0,1,-2,0,-11,-2,-9,4,2,2,-8,-4,9,-8,0,1,2,-3,6,-5,-1,0,-10,-1,3,-3,1,1,1,0,2,-1,2,0,1,0,2,-2,1,0,0,0,0,1,1,0,30,21,9,-5,-1,-4,4,3,-3,11,4,12,8,7,0,7,-1,1,-4,-4,-3,4,5,11,-2,0,0,-1,-1,-1,-1,0,1,0,0,-1,-1,0,-1,-1,-1,0,51,28,23,-8,-6,-2,11,-4,3,26,18,-2,11,-2,2,17,6,-6,0,-2,1,9,12,4,0,-2,-2,-4,0,0,0,-1,0,-4,-1,0,0,-1,-2,0,1,0,-3,4,-7,6,0,6,-5,3,-6,-7,5,5,-6,4,-3,-5,5,7,1,-1,-3,-2,0,-2,2,2,0,-2,3,1,0,1,0,-3,1,1,2,1,0,1,2,0,5,0,5,8,1,7,-4,0,-10,-13,9,21,-3,2,-6,-10,6,11,-1,-2,-4,-3,3,10,1,3,0,0,1,3,0,0,0,-1,1,1,1,3,0,1,0,2,14,8,6,2,0,2,-7,-7,1,-13,15,24,-2,-2,-3,-7,12,9,-5,-5,4,-6,3,15,0,0,0,0,1,1,0,0,-1,0,1,0,0,0,1,0,0,1
32,32027,Cortegada,1444,35,19,16,24,14,10,17,8,3,0,8,-1,11,3,0,-3,6,2,6,5,3,3,2,-3,9,2,7,2,3,1,5,1,3,1,3,1,4,1,4,1,0,0,2,7,-5,9,8,1,-5,-2,5,4,1,-2,-3,-2,5,3,1,1,-2,0,0,1,0,-3,0,1,1,3,2,1,0,1,0,3,2,1,0,0,1,0,0,0,-23,-13,-10,-3,-1,-2,-7,-5,-7,-6,3,0,-3,-3,-6,-2,0,1,-4,-2,-1,-4,3,-1,-2,0,-2,2,0,-1,-2,0,-1,3,-1,0,0,0,-1,-1,1,-1,-12,-11,-1,0,-1,1,-6,3,-13,-4,3,5,-5,2,-8,-4,2,2,-1,1,-5,0,1,3,1,-1,-3,-2,2,3,0,0,-3,-1,2,1,1,-1,0,-1,0,2,-10,1,-11,11,6,5,1,-1,0,-3,4,-11,0,0,2,0,2,-3,1,-1,-2,-3,2,-8,2,2,3,2,2,0,0,1,2,1,2,0,2,1,1,1,0,0,-1,6,-7,11,9,2,-1,1,-4,0,7,-4,-1,2,-1,1,5,0,0,-1,-3,-1,2,-4,0,1,2,3,5,0,0,0,2,3,4,0,0,1,0,0,1,0,-29,-15,-14,1,-1,2,-11,3,-8,-5,3,-12,-5,-3,-2,-3,1,-4,-6,6,-6,-2,2,-8,0,1,-1,1,1,-1,-1,0,-1,1,0,0,1,1,0,0,1,-1,43,47,-4,11,8,3,2,0,12,13,14,5,0,6,11,12,11,8,2,-6,1,1,3,-3,0,1,3,3,4,0,0,1,3,3,1,0,0,0,0,0,3,0,-4,1,-5,5,2,3,-4,-2,0,-3,12,-7,0,-2,-3,0,8,-1,-4,0,3,-3,4,-6,1,0,1,0,2,1,0,0,1,0,1,0,1,0,0,0,1,1,-20,-11,-9,0,-2,2,-2,2,-2,-2,-5,-11,-1,-1,2,-2,-5,-4,-1,3,-4,0,0,-7,0,0,0,-1,1,0,0,0,-1,-1,0,0,0,0,1,0,1,0,12,12,0,2,3,-1,3,2,-4,7,7,-3,3,1,0,7,1,0,0,1,-4,0,6,-3,2,2,-4,1,0,1,1,2,-1,1,-1,1,1,0,-3,0,1,0,-30,-12,-18,-3,0,-3,-4,-6,-9,-11,-2,2,-1,-3,-7,-5,1,2,-3,-3,-2,-6,-3,0,-3,1,2,-1,-3,0,-1,0,1,0,-1,0,-2,1,1,-1,-2,0,-33,-13,-20,0,2,-2,2,-3,-12,-13,3,-10,1,1,-8,-8,3,-2,1,-4,-4,-5,0,-8,0,1,-1,-3,2,1,0,1,0,-2,1,2,0,0,-1,-1,1,-1,-14,-5,-9,-6,-5,-1,-1,3,2,-2,-7,-9,-1,3,2,1,-5,-5,0,0,0,-3,-2,-4,1,1,-2,-2,-4,0,0,1,-1,-1,-3,-1,1,0,-1,-1,-1,1,6,-5,11,-1,-2,1,0,13,-4,-6,7,-5,-2,2,-2,-5,2,-1,2,11,-2,-1,5,-4,0,1,0,-2,-1,0,0,0,0,-2,-1,0,0,1,0,0,0,0,-19,-9,-10,-7,-3,-4,-3,5,-5,-7,1,-8,-1,2,-1,-5,1,-3,-2,3,-4,-2,0,-5,-2,0,-1,-1,-1,-2,0,0,-1,-1,0,-1,-2,0,0,0,-1,-1,-12,-4,-8,4,2,2,-3,0,-6,0,5,-9,0,2,-5,-1,3,-3,-3,-2,-1,1,2,-6,0,1,-1,0,4,-1,0,1,-1,1,2,-1,0,0,0,-1,2,0,-3,-12,9,12,6,6,-3,1,-9,3,8,-4,-5,-1,-4,-2,3,-4,2,2,-5,5,5,0,-1,1,3,4,5,0,-1,0,2,4,2,-1,0,1,1,0,3,1
32,32028,Cualedro,2469,7,7,0,7,5,2,-1,-2,-4,10,8,-3,-1,1,-3,3,6,0,0,-3,-1,7,2,-3,0,0,1,2,3,1,0,0,1,1,2,1,0,0,0,1,1,0,-23,-16,-7,7,1,6,-10,-2,-13,3,12,-12,-5,-2,-7,-2,5,-5,-5,0,-6,5,7,-7,1,0,1,0,5,0,0,0,0,0,1,0,1,0,1,0,4,0,-26,-7,-19,5,4,1,2,-5,-4,-4,0,-16,3,1,-4,-4,3,-6,-1,-6,0,0,-3,-10,1,-2,3,2,1,0,0,-1,2,1,3,-1,1,-1,1,1,-2,1,-5,-2,-3,8,3,5,3,-9,0,7,5,-11,1,-5,2,5,1,-6,2,-4,-2,2,4,-5,0,1,1,2,4,0,0,1,0,1,1,0,0,0,1,1,3,0,-28,-22,-6,10,5,5,-1,-1,-10,-3,-2,-10,-3,-2,-5,-7,3,-8,2,1,-5,4,-5,-2,2,2,-1,2,5,1,1,1,-1,0,4,0,1,1,0,2,1,1,-30,-19,-11,23,11,12,-6,0,-16,-3,5,-10,-3,-6,-4,0,3,-9,-3,6,-12,-3,2,-1,1,3,3,1,13,2,0,1,2,1,6,1,1,2,1,0,7,1,4,0,4,10,5,5,3,-3,-8,11,7,-6,-2,1,-8,5,5,-1,5,-4,0,6,2,-5,2,3,0,4,0,1,0,1,0,3,0,1,2,2,0,1,0,0,-31,-15,-16,5,0,5,-5,0,-16,-3,-3,-5,-2,0,-11,-1,-2,0,-3,0,-5,-2,-1,-5,0,2,0,1,2,0,0,1,0,0,-1,0,0,1,0,1,3,0,-16,13,-29,-4,-1,-3,-6,-4,6,-7,11,-15,-1,0,12,-1,5,-2,-5,-4,-6,-6,6,-13,-1,0,3,-2,-2,-2,0,0,2,-1,-2,0,-1,0,1,-1,0,-2,8,17,-9,-3,-1,-2,-7,12,8,-5,7,-5,-1,7,10,-2,5,-2,-6,5,-2,-3,2,-3,-1,-1,1,0,0,-2,0,-1,1,0,0,-1,-1,0,0,0,0,-1,-6,-4,-2,-1,0,-1,7,-7,-6,11,3,-13,0,-3,-3,5,3,-5,7,-4,-3,6,0,-8,2,-1,-1,1,-2,0,1,0,0,1,-2,0,1,-1,-1,0,0,0,-42,-15,-27,-4,1,-5,-7,2,-6,-13,2,-20,-2,1,-2,-4,-1,-7,-5,1,-4,-9,3,-13,-1,0,0,-2,1,-2,0,0,0,1,0,0,-1,0,0,-3,1,-2,-15,-16,1,5,3,2,-4,-5,1,-8,2,-1,-4,-3,-1,-3,1,-6,0,-2,2,-5,1,5,2,2,1,0,0,0,0,2,0,0,1,0,2,0,1,0,-1,0,-18,1,-19,2,4,-2,4,4,-6,-5,7,-21,3,5,2,-2,6,-12,1,-1,-8,-3,1,-9,-2,0,-2,0,4,2,0,0,-1,1,3,1,-2,0,-1,-1,1,1,66,48,18,21,16,5,0,15,21,17,16,-3,0,10,14,9,13,2,0,5,7,8,3,-5,0,3,8,6,3,1,0,3,6,4,1,2,0,0,2,2,2,-1,-18,-8,-10,6,3,3,0,-1,-6,-6,3,-8,1,1,-3,-3,2,-6,-1,-2,-3,-3,1,-2,0,0,1,1,0,4,0,0,1,1,0,1,0,0,0,0,0,3,-44,-16,-28,-11,-6,-5,-2,-5,-10,-6,-5,-15,0,-1,-5,-3,0,-6,-2,-4,-5,-3,-5,-9,0,-4,-3,-8,3,1,0,-2,-1,-6,2,1,0,-2,-2,-2,1,0,11,1,10,4,1,3,0,2,1,1,11,-7,-1,0,0,-2,5,-1,1,2,1,3,6,-6,1,0,1,1,2,-1,0,0,0,1,0,0,1,0,1,0,2,-1
32,32030,Entrimo,1478,16,10,6,18,10,8,-2,7,-4,1,11,3,-1,5,-3,2,5,2,-1,2,-1,-1,6,1,2,4,2,1,5,4,1,3,1,1,2,2,1,1,1,0,3,2,-10,-1,-9,13,4,9,-6,-1,-3,-4,2,2,-2,3,-2,-3,1,2,-4,-4,-1,-1,1,0,2,1,1,1,4,4,0,0,0,0,2,2,2,1,1,1,2,2,13,6,7,21,10,11,-2,4,-7,6,12,0,-1,0,-4,2,7,2,-1,4,-3,4,5,-2,2,3,0,5,11,0,1,0,0,2,6,1,1,3,0,3,5,-1,43,21,22,25,14,11,4,4,7,10,11,7,2,5,7,2,5,0,2,-1,0,8,6,7,3,1,6,5,8,2,1,0,5,2,4,2,2,1,1,3,4,0,34,20,14,32,21,11,3,2,6,8,7,8,2,-1,7,5,5,2,1,3,-1,3,2,6,3,2,6,7,6,8,2,1,5,5,4,4,1,1,1,2,2,4,-6,3,-9,9,6,3,1,-2,-6,3,0,-2,3,-1,-4,4,2,-1,-2,-1,-2,-1,-2,-1,1,2,0,5,1,0,1,2,-1,3,1,0,0,0,1,2,0,0,53,21,32,4,3,1,-1,9,10,17,11,6,-2,1,4,9,3,5,1,8,6,8,8,1,0,-1,-1,1,4,1,0,-1,-1,1,4,0,0,0,0,0,0,1,39,23,16,28,16,12,5,7,7,10,15,-7,3,4,2,6,7,-1,2,3,5,4,8,-6,1,7,8,5,4,1,1,4,4,2,2,1,0,3,4,3,2,0,-19,-5,-14,14,6,8,-6,3,-11,4,-1,-8,-6,1,-2,8,0,-6,0,2,-9,-4,-1,-2,5,1,2,2,3,1,1,0,1,2,1,1,4,1,1,0,2,0,25,23,2,18,11,7,6,4,7,-1,4,5,4,4,6,0,6,3,2,0,1,-1,-2,2,4,4,1,2,7,0,2,3,1,0,5,0,2,1,0,2,2,0,21,5,16,23,13,10,5,-2,13,-7,9,3,4,-4,4,1,2,-2,1,2,9,-8,7,5,3,4,11,0,4,1,2,1,7,2,2,-1,1,3,4,-2,2,2,25,19,6,23,16,7,1,0,4,17,6,-3,-1,1,2,12,6,-2,2,-1,2,5,0,-1,1,0,4,6,8,4,1,0,3,6,5,1,0,0,1,0,3,3,-19,-9,-10,-3,-2,-1,-3,0,-1,-4,-5,-6,-4,0,1,-3,-3,0,1,0,-2,-1,-2,-6,0,1,0,0,-3,-1,0,0,0,-1,-1,0,0,1,0,1,-2,-1,0,6,-6,12,8,4,-1,-2,-2,1,4,0,0,0,2,-1,2,3,-1,-2,-4,2,2,-3,0,1,1,4,3,3,0,1,1,2,2,2,0,0,0,2,1,1,20,9,11,10,4,6,3,-7,12,5,5,2,0,-4,5,2,2,4,3,-3,7,3,3,-2,2,0,1,0,4,3,0,0,0,0,2,2,2,0,1,0,2,1,-21,-11,-10,5,1,4,1,-3,-5,-6,-3,-3,1,2,-4,-9,-3,3,0,-5,-1,3,0,-6,2,2,0,1,-2,2,2,1,0,-2,-2,2,0,1,0,3,0,0,-4,-5,1,11,7,4,-4,1,-3,0,3,-1,-2,-2,-3,2,0,0,-2,3,0,-2,3,-1,0,3,-1,4,3,2,0,0,0,3,3,1,0,3,-1,1,0,1,-67,-47,-20,-61,-43,-18,-3,3,-21,-19,-14,-11,-4,0,-11,-12,-12,-7,1,3,-10,-7,-2,-4,0,1,-16,-19,-16,-11,1,-1,-10,-14,-12,-7,-1,2,-6,-5,-4,-4
32,32033,Gomesende,1211,-20,-5,-15,10,7,3,-7,-3,-11,-3,9,-4,-2,-1,-5,0,5,-2,-5,-2,-6,-3,4,-2,0,1,1,0,8,0,0,1,1,0,5,0,0,0,0,0,3,0,-7,-4,-3,7,3,4,-2,-1,-5,-1,3,-1,-1,-2,-3,-2,2,2,-1,1,-2,1,1,-3,0,3,2,1,1,0,0,1,2,0,0,0,0,2,0,1,1,0,-7,1,-8,13,8,5,-1,0,-4,-1,6,-5,-1,0,0,-1,5,-1,0,0,-4,0,1,-4,2,1,1,2,6,1,0,1,0,1,5,1,2,0,1,1,1,0,34,30,4,15,10,5,1,2,13,3,16,-1,1,4,12,3,10,0,0,-2,1,0,6,-1,2,1,5,0,4,3,2,0,3,0,2,3,0,1,2,0,2,0,-5,-3,-2,0,1,-1,-5,-4,-2,-2,5,3,-1,-2,-2,-3,4,1,-4,-2,0,1,1,2,-1,0,-1,-1,2,1,0,0,-1,-1,2,1,-1,0,0,0,0,0,-1,0,-1,9,7,2,4,3,-4,-4,2,-3,4,2,-1,-4,0,-2,0,1,-3,0,2,-1,1,5,2,1,-2,1,1,2,2,0,0,1,0,3,0,1,-2,0,-3,-3,0,3,-1,4,-3,-3,-8,7,5,0,-1,-1,-5,2,2,0,-2,-2,-3,5,3,0,0,-1,2,0,2,0,0,0,0,-1,0,0,0,-1,2,1,2,0,7,0,7,1,-1,2,-7,1,1,5,5,1,-4,2,-1,2,-2,2,-3,-1,2,3,7,-1,0,1,-3,0,1,2,0,1,-2,-1,0,1,0,0,-1,1,1,1,-14,-10,-4,-1,-2,1,-2,4,-5,0,-1,-9,-1,0,-1,-1,-2,-4,-1,4,-4,1,1,-5,0,0,-1,1,1,-2,0,-1,0,0,0,-1,0,1,-1,1,1,-1,-26,-7,-19,2,1,1,-1,-3,-5,-3,-1,-14,4,-2,-3,1,-2,-6,-5,-1,-2,-4,1,-8,-1,-2,0,0,5,0,0,-1,1,1,1,-1,-1,-1,-1,-1,4,1,-5,6,-11,4,5,-1,-4,2,7,-2,0,-8,0,1,4,-1,4,-2,-4,1,3,-1,-4,-6,0,2,2,1,-1,0,0,3,1,2,0,-1,0,-1,1,-1,-1,1,-3,3,-6,-4,0,-4,-3,2,-2,0,-3,3,-3,2,3,0,-2,3,0,0,-5,0,-1,0,0,0,-1,-1,-3,1,0,0,1,0,-2,1,0,0,-2,-1,-1,0,-4,4,-8,8,5,3,5,1,-1,-1,0,-8,5,0,0,-1,3,-3,0,1,-1,0,-3,-5,1,1,2,0,1,2,1,0,2,-1,2,1,0,1,0,1,-1,1,-30,-12,-18,-10,-6,-4,-1,0,-11,-2,-3,-13,-1,0,-6,2,-1,-6,0,0,-5,-4,-2,-7,0,0,-2,-1,-5,-2,0,0,-2,0,-3,-1,0,0,0,-1,-2,-1,6,3,3,3,0,3,0,-1,4,-1,7,-3,0,-2,1,1,5,-2,0,1,3,-2,2,-1,0,0,1,-1,2,1,0,0,0,-1,1,0,0,0,1,0,1,1,-20,-8,-12,-6,-4,-2,-2,0,-2,0,-2,-15,0,0,-2,0,-1,-6,-2,0,0,0,-1,-9,0,0,-1,-1,0,-4,0,0,-1,-1,-1,-1,0,0,0,0,1,-3,-17,0,-17,6,4,2,-1,-4,3,-7,-2,-7,0,-2,2,-3,1,2,-1,-2,1,-4,-3,-9,3,-1,4,-1,1,-1,2,-1,1,0,1,1,1,0,3,-1,0,-2,-16,-11,-5,5,-1,6,1,3,-7,-3,1,-12,-1,3,-4,-4,-2,-3,2,0,-3,1,3,-9,2,1,1,0,1,-1,0,1,0,-1,0,-1,2,0,1,1,1,0
32,32035,"Irixo, O",2216,1,-3,4,13,5,8,-3,2,-4,-6,13,-1,-2,-1,-2,-1,4,-1,-1,3,-2,-5,9,0,2,0,3,2,5,1,1,0,2,1,1,0,1,0,1,1,4,1,7,14,-7,23,18,5,-1,-2,14,4,1,-9,0,1,9,4,2,-2,-1,-3,5,0,-1,-7,0,5,11,4,2,1,0,4,10,2,1,1,0,1,1,2,1,0,9,18,-9,17,11,6,3,-3,-9,7,15,-4,4,-1,-3,5,11,2,-1,-2,-6,2,4,-6,0,3,3,3,5,3,0,2,3,3,2,1,0,1,0,0,3,2,6,4,2,14,10,4,-5,1,5,-2,12,-5,-3,3,2,-3,6,-1,-2,-2,3,1,6,-4,0,3,0,2,5,4,0,3,0,2,3,2,0,0,0,0,2,2,4,6,-2,13,8,5,4,6,-8,1,11,-8,2,4,-4,1,7,-3,2,2,-4,0,4,-5,1,1,0,4,6,1,0,0,0,4,3,1,1,1,0,0,3,0,10,8,2,14,9,5,-2,-3,-5,4,11,4,-1,-1,-5,3,6,6,-1,-2,0,1,5,-2,2,0,4,0,3,4,2,0,1,0,1,5,0,0,3,0,2,-1,-25,-13,-12,11,6,5,-4,-2,-18,3,16,-19,0,-2,-10,-1,7,-6,-4,0,-8,4,9,-13,0,2,-1,3,6,1,0,1,-1,-1,5,2,0,1,0,4,1,-1,2,15,-13,23,17,6,7,2,0,2,1,-11,7,3,-3,6,4,-3,0,-1,3,-4,-3,-8,5,3,1,5,5,4,4,3,0,4,4,2,1,0,1,1,1,2,-6,1,-7,7,7,0,-6,4,-4,0,4,-4,-5,3,0,0,4,-1,-1,1,-4,0,0,-3,-1,0,0,0,2,6,0,0,0,1,2,4,-1,0,0,-1,0,2,-15,-7,-8,9,4,5,-5,-5,-9,1,5,-2,-1,-4,-1,-3,0,2,-4,-1,-8,4,5,-4,0,1,-3,2,3,6,0,0,-1,0,1,4,0,1,-2,2,2,2,4,10,-6,13,9,4,4,1,-12,3,13,-3,5,0,-6,2,8,3,-1,1,-6,1,5,-6,2,1,1,2,6,1,2,1,0,1,5,0,0,0,1,1,1,1,-14,-2,-12,3,1,2,-4,1,1,-6,5,-11,0,2,3,-6,3,-4,-4,-1,-2,0,2,-7,0,0,-1,-1,6,-1,0,0,-1,-1,4,-1,0,0,0,0,2,0,21,9,12,2,-1,3,14,-2,8,4,8,-11,7,-2,3,-1,4,-2,7,0,5,5,4,-9,1,-3,0,0,3,1,1,-3,0,0,0,1,0,0,0,0,3,0,-7,-9,2,1,-1,2,-3,-1,-2,8,-5,-5,-4,-1,0,4,-1,-8,1,0,-2,4,-4,3,-1,0,-2,2,-1,3,-1,0,-1,1,-1,1,0,0,-1,1,0,2,-35,-11,-24,-32,-19,-13,0,2,-15,-11,-6,-6,1,2,-9,-7,0,1,-1,0,-6,-4,-6,-7,-1,0,-10,-13,-5,-3,-1,0,-7,-10,0,-1,0,0,-3,-3,-5,-2,-5,-4,-1,6,3,3,1,0,-2,-4,2,-2,1,-1,-1,-3,0,0,0,1,-1,-1,2,-2,0,0,3,-1,1,3,0,0,2,0,0,1,0,0,1,-1,1,2,-2,0,-2,17,9,8,1,-3,-4,-1,4,2,-1,-1,-3,1,4,1,2,-2,-1,-2,0,1,1,1,0,4,5,6,0,1,0,2,3,3,1,0,0,2,2,3,-2,-3,1,3,3,0,-3,2,-1,-5,-5,10,-1,2,-5,-5,2,4,-2,0,4,0,-7,6,0,0,-1,-1,-1,6,0,0,-1,0,1,3,0,0,0,-1,-2,3
32,32042,Lobios,2718,-22,3,-25,11,8,3,-13,-1,-7,1,5,-7,-3,2,-2,-1,6,1,-10,-3,-5,2,-1,-8,0,0,3,4,3,1,0,0,1,3,3,1,0,0,2,1,0,0,2,3,-1,4,3,1,-6,0,-5,11,7,-5,-2,1,-5,3,6,0,-4,-1,0,8,1,-5,0,0,1,1,2,0,0,0,1,0,2,0,0,0,0,1,0,0,-55,-25,-30,-10,-4,-6,-24,-4,-18,-8,1,0,-9,-3,-10,-4,0,1,-15,-1,-8,-4,1,-1,-1,-4,-1,-3,-1,0,0,-2,0,-3,1,0,-1,-2,-1,0,-2,0,-27,-13,-14,0,0,0,-6,-7,-9,-1,3,-11,-7,-3,-4,-1,0,-1,1,-4,-5,0,3,-10,-1,0,-1,2,0,0,-1,0,0,1,0,0,0,0,-1,1,0,0,-86,-52,-34,-51,-28,-23,-12,-10,-19,-19,-14,-12,-6,-2,-17,-12,-7,-8,-6,-8,-2,-7,-7,-4,0,-4,-14,-12,-14,-7,0,-2,-11,-7,-5,-3,0,-2,-3,-5,-9,-4,-34,-11,-23,20,16,4,-5,2,-13,-7,2,-15,-4,3,-6,-3,3,-6,-1,-1,-7,-4,-1,-9,3,4,5,6,4,-2,2,4,3,5,4,-2,1,0,2,1,0,0,-30,0,-30,23,17,6,-10,-7,-11,1,2,-5,-5,-1,-2,4,4,0,-5,-6,-9,-3,-2,-5,0,4,2,11,3,3,0,4,2,9,1,1,0,0,0,2,2,2,-39,-26,-13,-25,-13,-12,-2,1,-15,-7,4,-18,0,1,-9,-11,5,-10,-2,0,-6,4,-1,-8,-3,1,-5,-8,-3,-7,-1,2,-2,-7,-2,-3,-2,-1,-3,-1,-1,-4,28,22,6,40,24,16,5,13,14,10,4,-17,0,7,6,8,6,-5,5,6,8,2,-2,-12,2,10,8,9,11,0,0,5,4,8,7,0,2,5,4,1,4,0,0,7,-7,31,17,14,-3,0,-14,8,10,0,1,1,-6,4,7,-1,-4,-1,-8,4,3,1,4,2,4,4,9,7,4,1,2,0,5,4,0,1,2,4,4,3,7,12,-5,29,20,9,-3,3,-7,11,11,-7,-1,1,-2,10,3,1,-2,2,-5,1,8,-8,5,1,5,13,4,1,3,0,5,9,2,1,2,1,0,4,2,0,-31,0,-31,15,15,0,2,3,-3,-8,-4,-20,3,5,0,-4,3,-6,-1,-2,-3,-4,-7,-14,5,0,3,5,3,-1,4,0,4,3,3,1,1,0,-1,2,0,-2,-16,-1,-15,8,5,3,3,-4,-13,3,8,-13,1,-2,-6,4,5,-3,2,-2,-7,-1,3,-10,0,0,4,2,4,-2,0,0,2,2,2,-1,0,0,2,0,2,-1,-34,-20,-14,7,4,3,-3,-4,-7,-5,0,-14,-2,0,-4,-4,-4,-5,-1,-4,-3,-1,4,-9,0,0,2,1,3,1,-1,0,1,1,3,0,1,0,1,0,0,1,23,19,4,31,18,13,-2,8,6,8,9,-7,-2,5,4,2,9,0,0,3,2,6,0,-7,0,4,10,11,8,-2,0,2,6,5,6,-1,0,2,4,6,2,-1,-34,-11,-23,1,6,-5,-7,-1,-4,-8,-4,-10,-1,2,0,-5,1,-8,-6,-3,-4,-3,-5,-2,-1,2,-1,-2,2,0,0,2,1,-2,3,1,-1,0,-2,0,-1,-1,8,10,-2,10,9,1,6,0,3,5,6,-14,-2,4,2,4,5,-5,8,-4,1,1,1,-9,1,3,-1,6,1,0,0,3,1,5,0,0,1,0,-2,1,1,0,1,-1,2,10,6,4,-1,1,0,1,9,-11,-2,-1,1,-1,4,-2,1,2,-1,2,5,-9,0,2,2,2,3,0,0,2,2,0,2,0,0,0,0,2,1,0
32,32045,Maside,3345,6,18,-12,19,12,7,5,-7,-14,7,5,7,5,-2,-6,5,5,8,0,-5,-8,2,0,-1,1,4,3,1,4,6,1,3,1,1,3,3,0,1,2,0,1,3,-12,-6,-6,26,8,18,-7,-2,-7,-4,6,2,-6,-2,-9,0,6,4,-1,0,2,-4,0,-2,2,9,9,1,3,2,0,1,3,1,2,1,2,8,6,0,1,1,-2,-5,3,25,11,14,2,3,-9,-3,10,-5,3,-1,-2,-6,5,-4,-1,4,-7,3,5,-1,1,5,5,5,5,4,1,1,2,1,4,2,0,4,3,4,1,2,-19,-9,-10,19,7,12,-8,-14,-9,-2,16,-1,-7,-7,-3,0,10,-1,-1,-7,-6,-2,6,0,3,0,7,1,4,4,1,-1,3,0,3,1,2,1,4,1,1,3,-25,-9,-16,15,5,10,-2,5,-21,3,0,-10,-1,-2,-6,2,1,-3,-1,7,-15,1,-1,-7,1,5,2,4,3,-1,0,1,1,2,2,-1,1,4,1,2,1,0,30,8,22,65,17,48,-3,27,-1,2,13,-11,-1,5,-1,2,7,-6,-2,22,0,0,6,-5,0,37,16,2,11,-1,0,4,4,2,7,0,0,33,12,0,4,-1,29,25,4,26,13,13,-2,1,8,13,6,2,1,4,8,5,5,1,-3,-3,0,8,1,1,2,11,6,6,1,-1,1,4,4,3,2,-2,1,7,2,3,-1,1,68,51,17,4,9,-5,18,2,11,28,11,-3,9,8,17,14,5,-4,9,-6,-6,14,6,1,2,-5,-6,7,5,1,1,2,-1,4,2,1,1,-7,-5,3,3,0,39,6,33,31,6,25,11,12,4,10,4,-4,4,2,-9,2,4,3,7,10,13,8,0,-7,4,9,9,2,6,1,1,1,-1,1,4,0,3,8,10,1,2,1,8,18,-10,27,19,8,3,-2,-9,12,5,0,7,0,-5,10,2,5,-4,-2,-4,2,3,-5,2,2,2,6,9,6,2,1,1,5,6,4,0,1,1,1,3,2,41,29,12,18,9,9,2,14,-2,9,7,11,2,8,9,1,3,4,0,6,-11,8,4,7,1,5,7,4,1,0,1,2,2,2,1,1,0,3,5,2,0,-1,-33,-17,-16,6,-3,9,-7,-10,-13,0,2,-5,-3,-5,-7,-2,2,-2,-4,-5,-6,2,0,-3,0,-2,4,4,0,0,1,-2,-1,1,-1,-1,-1,0,5,3,1,1,-6,1,-7,0,0,0,9,0,-9,-9,3,0,9,1,-2,-7,0,0,0,-1,-7,-2,3,0,1,-1,0,-1,1,0,1,-1,1,-1,-1,1,0,0,-1,0,2,-1,-1,7,-8,-34,-18,-16,20,7,-10,-8,0,-10,5,5,0,-4,5,-5,15,2,-10,-4,-5,-5,-2,-2,-13,-13,-4,0,-2,0,-3,-10,-3,0,0,-2,-10,-3,-1,0,21,12,9,-4,-5,1,0,7,2,12,8,-9,1,4,-1,5,6,-4,-1,3,3,7,2,-5,0,-1,-1,-3,1,0,0,0,-2,-3,1,-1,0,-1,1,0,0,1,-23,-4,-19,-3,-2,-1,16,-3,-13,-4,-8,-10,1,-2,-1,3,-6,1,15,-1,-12,-7,-2,-11,-1,-1,0,0,-4,3,-1,-1,0,2,-4,2,0,0,0,-2,0,1,-7,4,-11,-9,-5,-4,2,0,8,-16,2,-5,4,-2,2,-7,3,1,-2,2,6,-9,-1,-6,-3,0,-2,-5,1,0,-2,0,-1,-2,0,0,-1,0,-1,-3,1,0,2,1,1,-2,0,-2,10,0,-2,-2,-6,1,-2,-1,6,1,-1,-3,12,1,-8,-3,-5,4,-2,0,0,0,-1,1,-2,0,1,0,1,0,0,0,-1,0,-2,1
32,32046,Melón,1618,-10,1,-11,15,10,5,-8,-11,2,3,4,0,-4,-5,5,1,2,2,-4,-6,-3,2,2,-2,0,2,3,3,6,1,0,2,2,1,4,1,0,0,1,2,2,0,-15,-6,-9,7,5,2,4,-6,-3,-2,-1,-6,2,-4,2,-5,1,-2,2,-2,-5,3,-2,-4,1,0,0,4,1,1,1,0,0,2,1,1,0,0,0,2,0,0,36,22,14,15,8,7,2,5,8,8,14,0,1,6,4,2,9,1,1,-1,4,6,5,-1,2,0,2,5,6,0,1,0,2,2,3,0,1,0,0,3,3,0,24,9,15,8,5,3,2,13,1,-2,11,-1,-1,4,0,-1,7,0,3,9,1,-1,4,-1,1,1,1,2,3,0,0,1,1,0,3,0,1,0,0,2,0,0,33,2,31,9,2,7,-7,0,2,1,10,27,-3,-2,-1,1,4,3,-4,2,3,0,6,24,2,-2,2,0,4,3,2,-1,1,0,0,0,0,-1,1,0,4,3,10,10,0,6,5,1,1,3,-5,7,4,0,-1,5,-3,4,5,0,2,-2,-2,3,-1,0,0,0,3,1,2,0,0,0,2,1,2,0,0,0,1,0,0,0,20,7,13,13,4,9,7,2,-5,6,5,4,3,4,-8,6,2,0,4,-2,3,0,3,4,4,1,1,3,4,0,2,0,-1,2,2,-1,2,1,2,1,2,1,-16,-5,-11,18,11,7,-8,-4,-8,-3,8,-2,-2,-4,-3,-2,6,0,-6,0,-5,-1,2,-2,3,1,6,3,2,3,2,0,3,2,2,2,1,1,3,1,0,1,3,15,-12,2,2,0,-4,-1,4,0,6,-2,1,0,3,2,7,2,-5,-1,1,-2,-1,-4,0,0,0,1,4,-3,-1,0,0,0,4,-1,1,0,0,1,0,-2,-7,12,-19,4,4,0,-5,-1,0,-5,8,-5,0,0,8,-3,6,0,-5,-1,-8,-2,2,-5,0,-2,3,1,4,-2,0,0,2,2,2,-2,0,-2,1,-1,2,0,44,32,12,9,6,3,-1,7,11,2,9,17,-1,5,9,4,8,8,0,2,2,-2,1,9,1,0,2,0,5,1,0,0,0,0,5,1,1,0,2,0,0,0,34,15,19,2,-2,4,3,13,-2,9,12,-1,2,6,0,1,3,3,1,7,-2,8,9,-4,0,0,-2,2,2,0,0,-1,-2,0,0,1,0,1,0,2,2,-1,-37,-13,-24,-1,0,-1,-5,-5,-20,-1,-1,-4,-1,-2,-12,-1,6,-2,-4,-3,-8,0,-7,-2,1,0,-2,1,-1,0,1,0,-2,0,1,0,0,0,0,1,-2,0,-40,-24,-16,-3,-2,-1,-6,-4,-15,-9,1,-7,-4,-2,-9,-7,1,-3,-2,-2,-6,-2,0,-4,-2,0,-1,-3,3,0,-1,0,-1,-2,2,0,-1,0,0,-1,1,0,-22,-9,-13,-4,-3,-1,-1,4,-3,-10,-9,1,-2,2,-1,-3,-3,1,1,2,-2,-7,-6,0,0,0,0,0,-4,0,0,0,0,0,-3,0,0,0,0,0,-1,0,6,8,-2,1,0,1,3,-1,-4,3,2,4,2,-1,0,2,1,4,1,0,-4,1,1,0,0,0,0,0,1,0,0,0,0,0,1,-1,0,0,0,0,0,1,-5,-2,-3,-2,-2,0,3,-3,-4,-6,-3,9,-2,-3,-1,-2,-1,7,5,0,-3,-4,-2,2,1,0,-2,-1,-2,2,0,0,0,-1,-2,1,1,0,-2,0,0,1,-2,7,-9,7,5,2,0,1,-6,-1,2,4,-2,2,0,3,3,2,2,-1,-6,-4,-1,2,3,0,1,0,3,0,1,0,0,2,2,0,2,0,1,-2,1,0
32,32047,"Merca, A",2444,27,15,12,16,8,8,-3,12,1,4,6,7,2,6,-2,1,3,5,-5,6,3,3,3,2,3,1,3,1,6,2,2,0,2,1,2,1,1,1,1,0,4,1,30,10,20,14,8,6,4,5,6,12,5,-3,2,4,2,3,0,-1,2,1,4,9,5,-2,4,1,3,5,1,0,3,0,3,1,1,0,1,1,0,4,0,0,2,-2,4,6,1,5,-1,-1,-14,0,16,2,-1,-3,-7,0,6,3,0,2,-7,0,10,-1,0,0,0,2,3,1,0,0,-1,2,0,0,0,0,1,0,3,1,0,-1,1,20,13,7,-4,7,-19,5,12,-1,-2,6,-15,5,4,1,-2,1,-4,0,8,-2,3,1,2,3,4,7,1,1,1,3,2,5,2,0,1,0,2,2,6,7,-1,9,5,4,0,7,-9,11,-1,-2,0,7,-5,5,0,0,0,0,-4,6,-1,-2,0,0,1,4,5,-1,0,0,0,2,4,-1,0,0,1,2,1,0,10,7,3,4,3,1,-3,-4,4,6,5,2,-1,-2,3,5,2,-1,-2,-2,1,1,3,3,0,0,2,0,2,0,0,0,1,1,1,0,0,0,1,-1,1,0,-16,-5,-11,6,5,1,-2,0,-1,-3,-5,-7,-1,1,5,-7,-4,0,-1,-1,-6,4,-1,-7,1,0,1,2,1,0,1,0,2,1,0,0,0,0,-1,1,1,0,30,14,16,20,11,9,7,2,1,6,9,4,3,-1,2,2,4,4,4,3,-1,4,5,0,1,0,4,2,6,6,1,0,2,1,4,3,0,0,2,1,2,3,13,6,7,6,3,3,3,2,6,1,10,-11,3,1,2,0,4,-4,0,1,4,1,6,-7,0,0,4,0,1,1,0,0,3,0,-1,1,0,0,1,0,2,0,27,18,9,12,9,3,5,5,-3,0,16,2,5,0,-7,5,11,3,0,5,4,-5,5,-1,-1,2,1,0,7,3,0,0,1,0,5,3,-1,2,0,0,2,0,-7,-1,-6,6,4,2,-6,4,-6,6,2,-5,-1,2,-8,6,1,0,-5,2,2,0,1,-5,0,1,2,4,2,-3,0,1,2,3,0,-2,0,0,0,1,2,-1,26,28,-2,6,5,1,-3,9,-1,2,5,12,1,5,6,4,3,8,-4,4,-7,-2,2,4,0,2,1,2,0,1,0,1,0,2,1,1,0,1,1,0,-1,0,-16,-6,-10,4,4,0,-5,-4,-4,-4,-1,2,-6,4,-2,-2,2,-2,1,-8,-2,-2,-3,4,1,2,-2,0,3,0,0,2,-1,0,3,0,1,0,-1,0,0,0,14,2,12,0,0,0,-2,-5,-1,1,13,8,-3,-3,-1,-3,9,3,1,-2,0,4,4,5,-1,-2,0,1,3,-1,0,-2,0,1,2,-1,-1,0,0,0,1,0,-17,-15,-2,4,1,3,-1,1,-15,-1,5,-7,-3,-2,-11,-1,4,-3,2,3,-4,0,1,-4,0,0,0,-2,1,4,0,0,-1,-2,1,2,0,0,1,0,0,2,-17,-1,-16,-5,-3,-2,-2,2,-10,-8,1,-1,0,1,-4,1,1,0,-2,1,-6,-9,0,-1,-1,-1,-1,-2,2,-2,-1,-1,-1,0,1,-1,0,0,0,-2,1,-1,2,-4,6,9,4,5,-2,2,-4,-6,9,3,-1,-1,-4,-3,4,1,-1,3,0,-3,5,2,1,1,-3,2,4,4,0,1,-2,2,1,2,1,0,-1,0,3,2,30,15,15,21,11,10,5,4,0,13,8,0,2,3,1,5,4,0,3,1,-1,8,4,0,5,3,0,6,5,2,3,2,0,3,3,0,2,1,0,3,2,2
32,32050,Monterrei,3461,-8,-2,-6,4,2,2,0,-6,-11,3,12,-6,0,-1,-8,0,6,0,0,-5,-3,3,6,-6,0,1,0,1,2,0,0,1,0,0,1,0,0,0,0,1,1,0,4,0,4,9,5,4,3,-3,-4,3,13,-7,4,-5,-5,2,6,-2,-1,2,1,1,7,-5,0,1,0,2,5,1,0,0,0,2,2,1,0,1,0,0,3,0,-21,-5,-16,16,7,9,-15,-4,-11,1,6,3,-5,-2,-1,-2,4,2,-10,-2,-10,3,2,1,-1,2,5,3,2,5,0,-1,4,2,0,2,-1,3,1,1,2,3,-16,-10,-6,12,4,8,4,-8,-5,11,0,-17,1,-5,-3,6,2,-12,3,-3,-2,5,-2,-5,3,-1,0,4,3,3,2,-2,-1,2,1,2,1,1,1,2,2,1,-30,-10,-20,15,6,9,-10,-3,-14,-5,7,-5,-5,-1,-5,-4,5,1,-5,-2,-9,-1,2,-6,0,1,2,2,9,1,-1,1,1,0,5,0,1,0,1,2,4,1,19,20,-1,5,6,-1,8,2,0,11,2,-3,7,1,1,8,2,2,1,1,-1,3,0,-5,1,0,-2,2,2,2,1,0,0,2,2,1,0,0,-2,0,0,1,37,26,11,31,20,11,7,-3,7,-1,26,0,4,1,5,1,18,-3,3,-4,2,-2,8,3,6,2,8,3,10,2,2,1,6,0,10,1,4,1,2,3,0,1,17,16,1,16,9,7,0,6,0,8,2,3,-1,4,2,6,3,4,1,2,-2,2,-1,-1,0,1,6,2,6,1,-1,1,4,0,4,1,1,0,2,2,2,0,21,9,12,8,3,5,11,-1,-10,9,12,0,5,-2,-3,6,4,1,6,1,-7,3,8,-1,0,2,1,1,3,0,0,0,2,1,1,-1,0,2,-1,0,2,1,2,12,-10,6,8,-2,-7,6,-10,4,14,-5,-2,5,-7,3,12,0,-5,1,-3,1,2,-5,0,1,2,3,1,-1,0,2,2,3,1,0,0,-1,0,0,0,-1,13,6,7,8,3,5,-2,-2,-16,3,13,16,0,0,-5,-3,10,4,-2,-2,-11,6,3,12,2,-1,-1,2,3,3,2,-1,-2,0,2,2,0,0,1,2,1,1,-12,6,-18,6,2,4,-6,-1,-14,1,17,-8,-5,3,-7,2,8,5,-1,-4,-7,-1,9,-13,3,0,-1,1,3,0,1,0,-1,0,2,0,2,0,0,1,1,0,18,17,1,10,7,3,3,5,1,10,7,-7,3,2,0,4,6,2,0,3,1,6,1,-9,0,0,0,1,6,3,0,0,0,1,4,2,0,0,0,0,2,1,5,5,0,1,0,1,-3,0,2,-2,9,-2,-5,-1,6,1,4,-1,2,1,-4,-3,5,-1,0,0,-1,-1,2,1,0,0,-1,-1,1,1,0,0,0,0,1,0,7,14,-7,7,3,4,5,-4,-3,5,7,-3,5,4,-3,7,-1,2,0,-8,0,-2,8,-5,2,-2,2,0,5,0,2,-1,0,0,1,1,0,-1,2,0,4,-1,1,5,-4,4,2,2,-1,0,-16,10,12,-3,1,0,-9,5,8,1,-2,0,-7,5,4,-4,1,1,2,0,-1,1,0,0,2,0,0,0,1,1,0,0,-1,1,-12,-13,1,10,2,8,-2,1,0,-4,6,-12,-3,0,2,-7,1,-6,1,1,-2,3,5,-6,3,1,5,0,3,-2,1,1,2,0,-1,-1,2,0,3,0,4,-1,5,16,-11,5,4,1,4,6,-11,5,12,-11,4,8,-8,3,9,0,0,-2,-3,2,3,-11,-1,5,0,-1,2,0,0,5,0,-2,1,0,-1,0,0,1,1,0
32,32051,Muíños,2083,-8,-8,0,12,6,6,-8,-8,-10,-2,16,5,-6,-6,-4,-2,7,4,-2,-2,-6,0,9,1,0,0,3,1,6,2,0,0,0,0,4,2,0,0,3,1,2,0,15,10,5,2,1,1,-4,8,-1,5,6,1,-4,8,3,0,2,1,0,0,-4,5,4,0,0,2,0,0,0,0,0,1,0,0,0,0,0,1,0,0,0,0,33,16,17,-3,-2,-1,5,12,2,9,4,-1,5,4,-1,1,5,1,0,8,3,8,-1,-2,0,-2,-1,-1,-1,2,0,-2,0,-1,0,1,0,0,-1,0,-1,1,14,9,5,-3,-2,-1,-4,7,-5,5,4,7,-3,1,1,4,2,4,-1,6,-6,1,2,3,-1,-1,-2,0,0,1,-1,-1,-1,0,1,0,0,0,-1,0,-1,1,28,7,21,1,1,0,8,-2,7,3,11,1,3,-2,2,-1,4,1,5,0,5,4,7,0,0,1,0,0,1,-1,0,1,0,0,0,0,0,0,0,0,1,-1,19,21,-2,7,5,2,-2,9,13,6,-3,-3,3,10,7,2,0,0,-5,-1,6,4,-3,-3,2,1,1,3,-1,1,1,1,1,1,0,1,1,0,0,2,-1,0,-55,-27,-28,11,9,2,-12,-4,-26,-8,5,-8,-9,-4,-9,-5,5,-4,-3,0,-17,-3,0,-4,0,1,1,0,4,5,0,1,1,1,3,3,0,0,0,-1,1,2,-12,-6,-6,5,0,5,-3,-3,-10,4,4,-4,-2,-2,-5,1,3,-1,-1,-1,-5,3,1,-3,0,1,0,3,2,-1,0,0,0,0,1,-1,0,1,0,3,1,0,-39,-10,-29,3,4,-1,-12,-1,-15,1,0,-11,-6,-1,-8,3,5,-3,-6,0,-7,-2,-5,-8,0,0,2,2,-1,0,0,0,1,2,1,0,0,0,1,0,-2,0,25,12,13,1,1,0,2,16,12,-1,2,-7,1,10,4,-2,1,-2,1,6,8,1,1,-5,0,1,2,0,0,-2,0,1,1,0,0,-1,0,0,1,0,0,-1,-15,-2,-13,2,2,0,-5,-3,2,2,3,-13,-5,0,1,6,0,-3,0,-3,1,-4,3,-10,0,1,0,0,0,1,0,1,1,0,-1,1,0,0,-1,0,1,0,16,7,9,1,1,0,4,4,0,4,9,-3,3,1,1,1,4,0,1,3,-1,3,5,-3,-1,1,0,-1,-1,3,-1,2,0,-1,-1,2,0,-1,0,0,0,1,-1,4,-5,1,2,-1,4,10,7,-3,-8,-9,-1,7,4,-1,-3,-2,5,3,3,-2,-5,-7,-3,1,2,-1,0,2,-2,1,2,-2,1,2,-1,0,0,1,-1,0,-85,-36,-49,3,5,-2,-28,2,-16,-21,-4,-19,-11,0,-4,-8,-7,-7,-17,2,-12,-13,3,-12,3,0,-1,2,0,-1,3,1,0,1,0,0,0,-1,-1,1,0,-1,29,13,16,5,4,1,2,8,-7,-2,-1,29,2,1,-5,1,2,13,0,7,-2,-3,-3,16,1,2,0,0,2,0,1,1,0,0,2,0,0,1,0,0,0,0,-17,-5,-12,2,1,1,-3,1,-8,0,-1,-6,-1,3,-6,-5,2,2,-2,-2,-2,5,-3,-8,0,0,-1,-1,1,3,0,1,-1,-1,0,2,0,-1,0,0,1,1,-19,-6,-13,7,4,3,-6,1,-2,-6,-1,-5,0,1,-1,-3,1,-3,-6,0,-1,-3,-2,-2,0,0,0,1,3,3,0,0,0,1,1,2,0,0,0,0,2,1,-3,0,-3,1,1,0,-2,2,-5,-5,5,3,-2,6,-3,0,-2,2,0,-4,-2,-5,7,1,2,1,-3,0,0,1,1,2,-3,0,0,1,1,-1,0,0,0,0
32,32054,Ourense,109120,-764,-493,-271,265,133,132,92,-369,-311,-132,-68,30,32,-209,-189,-72,-68,17,60,-160,-122,-60,0,13,46,27,45,39,69,37,25,15,21,21,31,20,21,12,24,18,38,17,-583,-259,-324,168,100,68,113,-331,-149,-132,-105,37,65,-133,-86,-34,-71,7,48,-198,-63,-98,-34,30,38,12,31,32,35,20,22,7,21,20,18,12,16,5,10,12,17,8,-809,-445,-364,278,154,124,51,-336,-369,-194,-66,114,18,-179,-183,-91,-59,51,33,-157,-186,-103,-7,63,64,18,42,38,64,51,31,8,25,25,36,29,33,10,17,13,28,22,-1349,-619,-730,222,120,102,3,-407,-515,-275,-195,69,18,-176,-243,-157,-99,51,-15,-231,-272,-118,-96,18,51,20,27,38,42,43,26,12,17,17,25,23,25,8,10,21,17,20,-61,-17,-44,791,391,400,133,-103,-151,-71,32,101,88,-34,-87,-48,16,56,45,-69,-64,-23,16,45,117,213,212,101,97,46,55,106,108,48,51,20,62,107,104,53,46,26,-6,-104,98,772,384,388,142,-117,-12,13,-48,21,51,-93,-34,4,-54,23,91,-24,22,9,6,-2,137,170,195,140,83,41,67,65,100,77,42,28,70,105,95,63,41,13,-160,-207,47,670,304,366,181,-47,-68,-188,-99,66,56,-44,-75,-99,-65,19,125,-3,7,-89,-34,47,121,179,150,94,83,34,53,78,67,48,37,15,68,101,83,46,46,19,136,23,113,795,413,382,120,-11,-7,3,-15,60,57,23,-19,-27,-20,18,63,-34,12,30,5,42,146,164,211,124,100,40,77,97,115,57,47,18,69,67,96,67,53,22,868,308,560,677,344,333,274,80,151,159,28,171,110,24,57,46,-9,72,164,56,94,113,37,99,133,162,174,106,76,18,68,72,98,55,34,14,65,90,76,51,42,4,1200,432,768,569,274,295,393,127,168,229,52,219,174,16,74,89,9,70,219,111,94,140,43,149,125,117,137,97,59,24,48,48,80,53,22,17,77,69,57,44,37,7,-300,-229,-71,79,9,70,92,-53,-133,-132,-110,46,34,-65,-121,-58,-42,26,58,12,-12,-74,-68,20,49,60,-11,-27,19,-13,31,21,-27,-18,-1,2,18,39,16,-9,20,-15,134,-50,184,98,1,97,61,-82,-69,-5,58,184,29,-46,-66,-20,1,52,32,-36,-3,15,57,132,39,55,-18,-7,23,1,16,30,-20,-38,8,4,23,25,2,31,15,-3,316,17,299,5,-67,72,169,-29,-62,79,7,153,70,-56,-47,12,-6,57,99,27,-15,67,13,96,63,25,-57,-23,-18,9,17,-8,-38,-27,-14,-1,46,33,-19,4,-4,10,-105,-158,53,-161,-110,-51,53,-32,-155,-13,-33,77,-5,-25,-104,-19,-39,29,58,-7,-51,6,6,48,-4,-1,-90,-37,-20,-13,-12,-5,-56,-23,-6,-10,8,4,-34,-14,-14,-3,-220,-219,-1,50,-1,51,65,-51,-179,-72,-2,17,45,-50,-102,-90,-9,-9,20,-1,-77,18,7,26,29,39,-68,-13,38,14,24,8,-40,-24,16,10,5,31,-28,11,22,4,62,-99,161,35,-23,58,45,-28,-81,9,23,106,14,-4,-123,-30,-19,67,31,-24,42,39,42,39,58,29,-27,-25,-16,9,27,12,-40,-12,-22,9,31,17,13,-13,6,0,287,90,197,314,126,188,133,39,-59,71,12,96,94,-5,-9,-8,-26,41,39,44,-50,79,38,55,76,117,11,19,59,25,45,55,8,-17,19,9,31,62,3,36,40,16,432,143,289,534,224,310,130,79,-13,5,90,133,80,10,-41,-17,24,83,50,69,28,22,66,50,145,109,72,65,82,50,73,46,17,20,37,23,72,63,55,45,45,27
32,32055,Paderne de Allariz,1712,2,0,2,5,3,2,-3,4,-10,7,9,-5,-2,5,-7,2,5,-4,-1,-1,-3,5,4,-1,0,0,0,1,3,1,0,0,0,1,1,1,0,0,0,0,2,0,14,10,4,9,1,8,-3,1,-2,8,8,2,-1,2,-1,3,5,2,-2,-1,-1,5,3,0,2,1,0,2,3,1,0,0,0,0,1,0,2,1,0,2,2,1,3,2,1,8,4,4,4,1,-1,6,0,-7,2,3,-2,4,0,-5,2,-2,1,2,0,-2,2,0,1,4,1,0,1,0,0,3,0,0,1,0,1,1,1,0,15,9,6,15,10,5,-3,1,3,-1,9,6,-1,-1,2,2,5,2,-2,2,1,-3,4,4,1,1,3,0,7,3,0,0,3,0,6,1,1,1,0,0,1,2,9,13,-4,9,7,2,0,4,-2,4,4,-2,1,1,1,3,6,0,-1,3,-3,1,-2,-2,2,0,5,1,1,0,1,0,3,0,3,0,1,0,2,1,-2,0,-2,3,-5,11,5,6,2,1,-6,5,0,-2,1,2,-1,4,-1,-1,1,-1,-5,1,1,-1,2,2,0,5,1,1,2,1,0,1,1,0,0,1,0,4,0,1,32,16,16,20,7,13,6,9,2,1,12,3,2,5,0,-2,6,6,4,4,2,3,6,-3,5,3,3,2,6,1,1,1,1,1,2,1,4,2,2,1,4,0,25,12,13,5,0,5,6,2,9,10,-1,-4,2,-3,2,4,1,3,4,5,7,6,-2,-7,0,1,2,1,0,0,-1,-1,0,1,0,0,1,2,2,0,0,0,-11,-2,-9,-2,-2,0,2,2,-11,-2,5,-3,0,3,-5,1,3,-1,2,-1,-6,-3,2,-2,-2,1,1,-2,0,0,-2,1,0,-1,0,0,0,0,1,-1,0,0,25,11,14,3,1,2,4,0,3,11,8,0,0,0,-1,4,7,0,4,0,4,7,1,0,0,0,1,0,0,2,0,0,0,0,0,1,0,0,1,0,0,1,12,6,6,2,2,0,11,-2,-1,5,1,-4,8,0,-5,2,0,0,3,-2,4,3,1,-4,2,-2,2,1,-1,0,2,-1,0,1,0,0,0,-1,2,0,-1,0,-10,-5,-5,-3,-3,0,-4,11,2,-13,6,-14,-1,4,1,-8,4,-6,-3,7,1,-5,2,-8,-1,1,2,-2,-1,-2,0,0,1,-2,-1,-1,-1,1,1,0,0,-1,-4,-1,-3,9,2,7,-1,-2,-3,6,9,-12,-3,-1,2,5,4,-7,2,-1,-5,1,5,-5,5,0,1,0,5,-2,2,0,0,0,2,-2,3,0,1,0,3,0,-5,-8,3,4,1,3,-6,1,-3,2,2,-1,-2,-1,-1,-2,1,-3,-4,2,-2,4,1,2,0,0,1,2,1,0,0,0,0,1,1,-1,0,0,1,1,0,1,-3,0,-3,1,1,0,1,2,-2,2,3,-7,3,3,-2,0,-2,-2,-2,-1,0,2,5,-5,0,0,1,0,0,0,0,0,1,0,-1,1,0,0,0,0,1,-1,-28,-10,-18,-2,0,-2,-7,8,-4,-6,2,-19,-3,2,3,-3,-1,-7,-4,6,-7,-3,3,-12,-3,0,-1,1,0,1,-1,0,-1,1,0,1,-2,0,0,0,0,0,3,1,2,-2,-1,-1,3,1,-4,11,5,-12,5,-1,-3,3,4,-5,-2,2,-1,8,1,-7,1,0,-1,-1,0,-1,1,0,0,-1,0,-1,0,0,-1,0,0,0,-7,-1,-6,1,1,0,-5,0,0,2,5,-9,-4,0,0,1,4,-2,-1,0,0,1,1,-7,0,0,0,1,3,-3,0,0,0,0,2,-1,0,0,0,1,1,-2
32,32056,Padrenda,2707,-48,-25,-23,52,24,28,-6,-10,-23,0,-1,-5,-6,-5,-14,4,-1,-2,0,-5,-9,-4,0,-3,7,3,12,14,12,4,2,1,6,7,6,2,5,2,6,7,6,2,-52,-24,-28,26,16,10,-2,-15,-26,-8,1,-1,-5,-7,-10,-5,2,1,3,-8,-16,-3,-1,-2,5,2,2,8,7,2,2,1,1,6,4,2,3,1,1,2,3,0,-16,-14,-2,9,0,9,-6,-4,4,-2,-4,-4,-4,-6,2,-4,-1,-1,-2,2,2,2,-3,-3,3,-2,5,3,0,0,1,-2,1,0,0,0,2,0,4,3,0,0,-23,1,-24,30,19,11,-2,-6,-11,3,4,-11,-4,0,-3,6,4,-2,2,-6,-8,-3,0,-9,5,3,7,3,9,2,2,3,4,3,6,1,3,0,3,0,3,1,3,15,-12,30,19,11,-2,2,-8,4,12,-4,0,0,0,7,7,0,-2,2,-8,-3,5,-4,2,5,6,7,7,2,0,1,7,5,5,0,2,4,-1,2,2,2,-56,-13,-43,23,18,5,-20,-4,-28,-9,9,-4,-6,-2,-13,-1,7,2,-14,-2,-15,-8,2,-6,1,3,3,4,7,5,0,3,3,4,3,5,1,0,0,0,4,0,42,39,3,62,44,18,-8,8,2,21,22,-1,-2,6,5,10,19,3,-6,2,-3,11,3,-4,5,13,11,10,16,7,3,7,8,7,15,4,2,6,3,3,1,3,28,12,16,45,28,17,9,-2,-6,9,11,4,3,-3,-11,8,9,4,6,1,5,1,2,0,6,8,5,15,8,1,3,5,2,10,5,1,3,3,3,5,3,0,0,4,-4,13,7,6,6,11,-11,2,3,-9,4,9,-9,3,0,-2,2,2,-2,-1,3,-7,1,3,3,1,1,4,1,2,2,1,0,1,0,1,1,0,1,3,-44,-32,-12,1,-4,5,-9,-1,-4,-6,-4,-20,-3,-3,2,-12,-2,-13,-6,2,-6,6,-2,-7,0,-1,-3,3,2,0,0,-1,-1,-1,1,-2,0,0,-2,4,1,2,83,61,22,16,15,1,5,8,9,24,31,8,5,10,16,10,16,3,0,-2,-7,14,15,5,5,-1,5,3,3,1,4,1,5,2,2,1,1,-2,0,1,1,0,-65,-34,-31,16,9,7,-2,-7,-16,-15,-4,-21,0,-4,-12,-9,-3,-6,-2,-3,-4,-6,-1,-15,-1,1,4,1,4,7,0,1,3,1,1,3,-1,0,1,0,3,4,-57,-37,-20,-7,-5,-2,-5,-10,-7,-12,-7,-18,-4,-4,-7,-12,-3,-7,-1,-6,0,0,-4,-11,0,-3,-1,-5,1,1,-1,-1,0,-4,0,1,1,-2,-1,-1,1,0,-49,-22,-27,-11,-7,-4,-9,0,-11,-16,1,-14,0,-1,-4,-10,-3,-4,-9,1,-7,-6,4,-10,-1,-1,-3,-5,1,-2,0,-1,-3,-3,0,0,-1,0,0,-2,1,-2,-29,-11,-18,-3,-2,-1,4,-5,-12,-7,4,-12,2,-2,-10,-5,8,-4,2,-3,-2,-2,-4,-8,1,-2,-2,0,2,-2,1,0,-1,0,1,-3,0,-2,-1,0,1,1,-9,-5,-4,5,-1,6,1,2,1,-3,-4,-6,2,0,-1,-2,-1,-3,-1,2,2,-1,-3,-3,0,-1,0,-1,4,3,0,-1,-1,-1,1,1,0,0,1,0,3,2,-42,-31,-11,-33,-26,-7,5,-9,-19,-6,-5,-7,1,-4,-16,-4,-7,-1,4,-5,-3,-2,2,-6,0,-5,-10,-8,-4,-6,0,-2,-9,-6,-6,-3,0,-3,-1,-2,2,-3,-43,-9,-34,-11,-9,-2,-2,-1,-10,-9,-1,-20,-1,2,-5,-1,2,-6,-1,-3,-5,-8,-3,-14,0,1,-3,-7,2,-4,-1,0,-3,-4,1,-2,1,1,0,-3,1,-2
32,32058,"Pereiro de Aguiar, O",4847,314,181,133,37,23,14,40,66,105,66,26,5,26,34,55,42,15,6,14,32,50,24,11,-1,7,3,7,11,3,4,6,2,2,7,1,3,1,1,5,4,2,1,202,103,99,11,6,5,6,30,34,25,28,78,5,19,26,20,18,13,1,11,8,5,10,65,2,1,1,3,3,1,0,1,1,0,3,1,2,0,0,3,0,0,68,30,38,3,2,1,-13,31,7,30,11,0,-9,14,3,16,6,-2,-4,17,4,14,5,2,0,-1,2,0,2,0,0,-1,2,0,1,0,0,0,0,0,1,0,85,50,35,2,3,-1,-4,26,23,11,31,-2,-1,12,11,6,17,5,-3,14,12,5,14,-7,2,-1,0,0,2,-1,0,-1,1,1,2,0,2,0,-1,-1,0,-1,139,61,78,21,9,12,17,16,25,28,21,31,9,6,13,15,8,8,8,10,12,13,13,23,6,0,3,4,8,0,2,0,1,3,4,-1,4,0,2,1,4,1,189,84,105,5,1,4,21,34,45,33,22,28,11,17,17,14,15,5,10,17,28,19,7,23,1,2,1,3,0,-2,0,0,1,2,0,-2,1,2,0,1,0,0,333,172,161,25,9,16,83,12,105,91,19,14,45,7,47,55,8,3,38,5,58,36,11,11,6,2,3,9,5,0,3,1,0,5,0,0,3,1,3,4,5,0,166,99,67,28,15,13,38,25,36,37,3,30,23,14,14,33,8,8,15,11,22,4,-5,22,1,7,4,8,7,1,0,2,3,6,4,0,1,5,1,2,3,1,130,68,62,26,7,19,28,15,35,39,15,-6,15,8,20,18,12,-4,13,7,15,21,3,-2,6,3,1,11,5,0,4,0,-1,2,2,0,2,3,2,9,3,0,-4,-7,3,-1,0,-1,2,-2,-6,11,2,-14,-12,1,2,4,1,-6,14,-3,-8,7,1,-8,-1,0,6,-3,-2,-1,-3,0,4,-1,0,0,2,0,2,-2,-2,-1,74,32,42,9,8,1,-9,19,-1,-1,15,49,-6,13,-5,-7,15,22,-3,6,4,6,0,27,-1,4,2,1,2,1,0,4,1,1,1,1,-1,0,1,0,1,0,185,98,87,12,3,9,25,-1,35,55,9,63,13,1,12,38,12,26,12,-2,23,17,-3,37,2,2,3,-1,4,2,2,0,1,-2,1,1,0,2,2,1,3,1,82,30,52,12,6,6,36,18,23,7,-9,2,17,4,8,7,-1,-13,19,14,15,0,-8,15,6,1,3,1,0,1,5,-1,1,1,0,0,1,2,2,0,0,1,79,25,54,11,2,9,-13,-3,-6,4,10,84,-6,3,-15,4,8,28,-7,-6,9,0,2,56,5,-1,6,4,-2,-1,3,0,0,3,-3,-1,2,-1,6,1,1,0,22,22,0,12,8,4,-1,-4,10,1,1,12,7,0,12,-1,1,2,-8,-4,-2,2,0,10,2,1,-1,2,5,3,1,0,1,1,3,2,1,1,-2,1,2,1,-2,15,-17,-22,-10,-12,-7,-10,4,-20,-3,33,0,1,3,-5,6,9,-7,-11,1,-15,-9,24,-3,-1,-5,-7,-3,-4,-3,0,-3,-3,-1,-1,0,-1,-2,-4,-2,-3,35,22,13,-4,2,-6,1,-4,-11,6,-5,44,3,1,-5,8,-2,17,-2,-5,-6,-2,-3,27,-5,0,-1,-2,5,-1,-3,2,-1,1,2,1,-2,-2,0,-3,3,-2,135,25,110,45,16,29,20,-2,19,26,11,60,3,-8,2,7,1,22,17,6,17,19,10,38,5,6,8,10,8,7,2,1,1,6,1,4,3,5,7,4,7,3
32,32066,Quintela de Leirado,981,-2,2,-4,11,7,4,-7,4,-3,0,5,-1,-3,4,-1,-2,5,-1,-4,0,-2,2,0,0,1,1,1,4,4,0,1,1,0,2,3,0,0,0,1,2,1,0,-14,-8,-6,3,2,1,2,-7,-5,-1,0,0,1,-4,-2,-1,0,0,1,-3,-3,0,0,0,0,0,2,0,0,1,0,0,2,0,0,0,0,0,0,0,0,1,-19,-10,-9,4,0,4,-5,-4,-6,-7,1,2,-3,-2,-4,-3,0,2,-2,-2,-2,-4,1,0,0,-1,1,-1,4,1,0,-1,0,-1,2,0,0,0,1,0,2,1,-5,-4,-1,9,6,3,-3,2,0,-5,1,0,-2,2,-4,-1,1,0,-1,0,4,-4,0,0,0,2,3,0,3,1,0,2,0,0,3,1,0,0,3,0,0,0,0,-1,1,6,2,4,-3,1,-3,4,3,-2,-2,0,-2,2,0,1,-1,1,-1,2,3,-3,0,0,0,1,5,0,0,0,0,0,2,0,0,0,0,1,3,0,-3,-1,-2,14,7,7,4,4,-7,-1,2,-5,4,2,-4,-2,0,-1,0,2,-3,1,2,-4,3,5,0,4,1,1,2,2,0,2,0,1,1,3,0,2,1,0,20,11,9,26,14,12,0,3,4,5,7,0,-2,3,1,3,3,3,2,0,3,2,4,-3,5,4,3,6,6,1,2,3,2,3,3,1,3,1,1,3,3,0,-23,-15,-8,1,0,1,0,-6,-5,-3,-1,-8,-1,-4,-1,-1,-3,-5,1,-2,-4,-2,2,-3,0,-2,-1,2,2,0,0,-1,0,1,0,0,0,-1,-1,1,2,0,8,5,3,3,-2,5,4,2,3,-1,3,-3,2,2,3,-1,3,-4,2,0,0,0,0,1,1,0,2,-3,1,2,0,0,0,-3,0,1,1,0,2,0,1,1,9,3,6,4,3,1,0,2,-1,-1,10,0,0,1,-1,-2,5,1,0,1,0,1,5,-1,0,0,0,1,4,-1,0,0,0,1,3,-1,0,0,0,0,1,0,-8,-2,-6,-2,-1,-1,0,0,-2,0,2,-6,0,-1,1,-1,0,0,0,1,-3,1,2,-6,0,0,0,-2,0,0,0,0,0,0,-1,0,0,0,0,-2,1,0,9,-1,10,3,1,2,-1,1,4,3,0,2,0,1,0,1,0,-2,-1,0,4,2,0,4,0,0,0,3,-1,0,0,0,0,2,-1,0,0,0,0,1,0,0,-17,-10,-7,1,1,0,-3,-3,-6,0,-2,-3,0,-4,-2,0,-1,-3,-3,1,-4,0,-1,0,0,0,-2,0,2,1,1,-1,0,0,1,0,-1,1,-2,0,1,1,-14,-7,-7,-2,0,-2,-4,1,-4,-2,-1,-3,0,0,-3,-2,-2,1,-4,1,-1,0,1,-4,-3,0,-1,-1,1,2,0,0,-1,-1,0,2,-3,0,0,0,1,0,-9,5,-14,4,4,0,0,-1,-4,-3,4,-5,1,0,-1,1,5,-1,-1,-1,-3,-4,-1,-4,1,1,0,1,0,1,0,1,0,2,1,0,1,0,0,-1,-1,1,5,5,0,0,0,0,1,4,-2,0,4,-2,0,4,-3,-1,3,2,1,0,1,1,1,-4,0,1,-1,-1,2,-1,0,1,-2,0,1,0,0,0,1,-1,1,-1,9,1,8,8,3,5,3,-1,-3,7,2,1,-1,-1,-2,3,2,0,4,0,-1,4,0,1,2,0,1,0,3,2,0,0,1,0,1,1,2,0,0,0,2,1,3,0,3,12,2,10,5,3,-2,1,0,-4,1,1,1,0,-1,-2,4,2,-3,1,1,-2,6,0,1,2,2,1,1,0,1,-1,0,1,5,0,0,3,2,0
32,32068,Ramirás,2085,36,19,17,41,21,20,-4,2,0,10,25,2,-5,3,1,9,7,4,1,-1,-1,1,18,-2,0,2,7,7,18,7,0,0,5,7,5,4,0,2,2,0,13,3,-4,-9,5,30,15,15,-2,1,-2,-2,10,-9,0,-1,0,-5,2,-5,-2,2,-2,3,8,-4,9,0,6,2,8,5,7,0,2,2,2,2,2,0,4,0,6,3,-13,-7,-6,26,12,14,-5,2,-9,-1,4,-4,-4,2,-6,2,1,-2,-1,0,-3,-3,3,-2,8,6,-2,6,5,3,6,3,-2,3,0,2,2,3,0,3,5,1,33,21,12,55,33,22,6,-6,10,6,14,2,4,-6,6,4,8,4,2,0,4,2,6,-2,11,3,11,4,11,14,7,3,5,2,6,9,4,0,6,2,5,5,56,29,27,39,22,17,7,4,-6,5,16,29,7,0,-6,3,11,13,0,4,0,2,5,16,9,0,4,5,12,8,7,0,2,2,7,3,2,0,2,3,5,5,20,1,19,36,16,20,1,6,-6,-1,9,9,0,3,-2,-6,4,1,1,3,-4,5,5,8,7,4,6,0,13,6,4,2,3,-1,5,3,3,2,3,1,8,3,51,33,18,37,27,10,5,1,7,4,9,24,4,3,3,4,5,14,1,-2,4,0,4,10,1,4,7,7,7,10,1,3,7,5,4,7,0,1,0,2,3,3,12,9,3,42,27,15,0,5,-2,-1,8,2,1,3,2,-4,8,-2,-1,2,-4,3,0,4,4,4,8,8,14,4,3,4,7,2,9,2,1,0,1,6,5,2,-8,6,-14,24,17,7,-2,-6,-12,8,10,-7,-2,-2,-6,9,7,-2,0,-4,-6,-1,3,-5,4,0,-1,7,9,5,2,-1,-1,6,7,4,2,1,0,1,2,1,-5,1,-6,4,-1,5,-14,-5,-3,0,12,3,-10,-3,-2,1,9,5,-4,-2,-1,-1,3,-2,-1,-2,0,4,5,-2,-3,-2,-1,2,5,-2,2,0,1,2,0,0,0,-1,1,5,3,2,-1,-2,-2,2,7,-4,-3,0,3,-3,2,0,2,-2,-5,5,5,-4,1,-1,3,-5,3,4,1,0,2,-5,0,5,0,-1,1,0,3,-1,15,12,3,10,5,5,0,-2,0,-1,4,13,-1,1,0,3,2,6,1,-3,0,-4,2,7,1,2,-1,2,3,3,-1,2,-1,2,2,1,2,0,0,0,1,2,-43,-16,-27,-21,-7,-14,-7,-6,-4,-6,-4,-16,-5,-4,-2,-1,-3,-1,-2,-2,-2,-5,-1,-15,-1,-3,-2,-6,-5,-4,1,-1,0,-3,-3,-1,-2,-2,-2,-3,-2,-3,-19,-11,-8,-13,-5,-8,3,1,-14,-6,1,-5,1,0,-6,-6,-1,0,2,1,-8,0,2,-5,2,-1,-2,-3,-1,-8,0,-1,-1,-2,-2,1,2,0,-1,-1,1,-9,-5,0,-5,-10,-5,-5,0,0,4,-2,2,-8,0,-2,3,-1,-1,1,0,2,1,-1,3,-9,1,-2,-2,0,-1,-6,1,-1,-2,0,-1,-2,0,-1,0,0,0,-4,9,3,6,18,7,11,7,3,-7,4,4,-2,4,2,-5,1,4,-3,3,1,-2,3,0,1,6,0,-1,5,8,0,3,0,-2,2,4,0,3,0,1,3,4,0,5,-7,12,23,8,15,1,-2,-1,1,3,3,-1,0,-3,-1,0,-1,2,-2,2,2,3,4,4,-2,6,0,3,11,1,-1,2,0,1,5,3,-1,4,0,2,6,26,21,5,36,16,20,2,5,-1,2,20,-1,4,1,3,-1,14,0,-2,4,-4,3,6,-1,3,7,6,2,10,8,3,1,3,-1,6,4,0,6,3,3,4,4
32,32069,Ribadavia,5556,-22,-9,-13,10,6,4,2,-6,-18,-5,6,-1,1,-2,-11,-3,8,-1,1,-4,-7,-2,-2,0,1,0,1,4,3,1,1,0,1,1,2,1,0,0,0,3,1,0,17,14,3,25,14,11,-2,-3,6,9,7,-2,-3,-3,5,7,6,2,1,0,1,2,1,-4,7,1,2,6,5,4,2,1,2,4,3,2,5,0,0,2,2,2,68,36,32,17,17,0,24,7,13,17,10,-7,11,6,7,10,6,-3,13,1,6,7,4,-4,0,3,-1,3,10,2,0,5,1,3,7,1,0,-2,-2,0,3,1,-11,-6,-5,26,15,11,0,0,-27,4,6,3,0,5,-17,3,3,-1,0,-5,-10,1,3,4,5,1,2,8,6,4,4,1,1,3,4,2,1,0,1,5,2,2,21,-3,24,39,17,22,6,-2,20,-8,3,2,-6,-7,11,-5,-1,2,12,5,9,-3,4,0,3,9,7,7,11,2,2,1,3,3,6,2,1,8,4,4,5,0,-7,-20,13,33,15,18,5,-4,-14,-12,14,2,0,-5,-15,-9,6,3,5,1,1,-3,8,-1,6,9,2,2,9,3,3,4,-1,1,4,2,3,5,3,1,5,1,-26,-33,7,42,21,21,0,1,-7,3,2,-23,2,-7,-9,-6,2,-13,-2,8,2,9,0,-10,2,15,10,11,2,2,0,5,7,6,2,1,2,10,3,5,0,1,85,55,30,48,23,25,8,4,28,23,18,2,6,7,10,21,10,-1,2,-3,18,2,8,3,3,5,15,9,15,1,0,4,6,5,8,0,3,1,9,4,7,1,50,38,12,40,20,20,13,6,-2,4,16,13,9,2,4,6,7,10,4,4,-6,-2,9,3,4,9,10,3,10,4,2,2,6,2,5,3,2,7,4,1,5,1,10,1,9,28,13,15,-3,-3,-16,16,9,7,-1,1,-8,10,2,-2,-2,-4,-8,6,7,9,0,7,5,7,7,2,0,3,4,5,2,-1,0,4,1,2,5,3,3,-2,5,22,5,17,4,-7,13,-8,8,-11,6,0,8,-17,4,-5,-2,-7,5,9,4,-6,1,5,2,6,7,1,0,3,0,0,3,-1,1,2,2,6,4,2,-87,-50,-37,8,2,6,-13,-3,-50,-5,0,-15,-5,-2,-30,-3,-5,-7,-8,-1,-20,-2,5,-8,0,5,-1,1,4,-1,0,2,-1,0,2,-1,0,3,0,1,2,0,-9,0,-9,0,3,-3,7,11,2,-14,-1,-14,0,6,10,-12,0,-6,7,5,-8,-2,-1,-8,-1,0,3,0,0,-2,-1,0,2,0,2,0,0,0,1,0,-2,-2,7,8,-1,10,5,5,-2,-4,7,-3,6,3,2,1,1,-1,3,3,-4,-5,6,-2,3,0,0,4,2,2,1,1,0,3,1,0,0,1,0,1,1,2,1,0,-17,-7,-10,11,0,11,1,-2,-8,-2,5,-11,-1,2,-5,1,1,-5,2,-4,-3,-3,4,-6,2,1,5,3,1,-1,0,0,2,0,0,-2,2,1,3,3,1,1,-12,-5,-7,-5,2,-7,5,-4,0,3,-3,-16,8,-7,-2,-6,4,-5,-3,3,2,9,-7,-11,-1,-1,-4,-1,2,-1,-1,1,-1,0,3,-1,0,-2,-3,-1,-1,0,18,9,9,24,8,16,-1,0,0,2,-2,14,-5,-2,6,-2,5,3,4,2,-6,4,-7,11,3,4,3,0,7,7,0,1,3,-2,4,2,3,3,0,2,3,5,-28,-6,-22,15,10,5,-5,4,-7,-12,3,-12,-1,4,-2,-10,3,-3,-4,0,-5,-2,0,-9,3,6,-3,0,4,4,1,4,0,-2,4,2,2,2,-3,2,0,2
32,32071,Riós,2328,-35,-22,-13,3,2,1,-3,-7,-8,-7,1,-11,-1,-8,-2,-4,1,-8,-2,1,-6,-3,0,-3,1,0,1,0,0,1,1,0,0,0,0,1,0,0,1,0,0,0,-22,1,-23,13,7,6,-4,-11,-6,-5,7,-3,-3,0,0,1,3,0,-1,-11,-6,-6,4,-3,0,2,4,0,5,2,0,1,3,0,3,0,0,1,1,0,2,2,13,4,9,9,3,6,7,0,2,-1,7,-1,4,-4,0,-1,4,1,3,4,2,0,3,-2,1,6,0,3,-1,0,1,2,0,0,-1,1,0,4,0,3,0,-1,-18,-6,-12,10,8,2,-7,-12,-15,5,9,3,0,-8,-8,2,5,4,-7,-4,-7,3,4,-1,1,-1,2,1,5,2,1,0,1,1,4,1,0,-1,1,0,1,1,13,7,6,27,9,18,5,-3,2,10,10,-10,0,-3,4,3,6,-2,5,0,-2,7,4,-8,0,11,6,6,3,1,0,2,2,3,1,1,0,9,4,3,2,0,11,7,4,10,4,6,-3,-9,-14,8,8,21,-2,-5,-6,6,7,8,-1,-4,-8,2,1,13,-1,1,1,2,7,0,-1,-1,1,2,3,0,0,2,0,0,4,0,-16,-4,-12,8,4,4,-2,-3,-7,-4,4,-4,0,-1,-3,0,2,-2,-2,-2,-4,-4,2,-2,0,6,-3,1,4,0,0,2,-1,1,2,0,0,4,-2,0,2,0,8,-3,11,19,6,13,2,7,-1,10,3,-13,-3,1,-4,6,2,-5,5,6,3,4,1,-8,4,2,8,2,3,0,1,1,2,2,0,0,3,1,6,0,3,0,-23,-14,-9,9,4,5,-5,-5,-21,-1,11,-1,-3,-3,-10,-2,4,0,-2,-2,-11,1,7,-1,0,3,-1,1,4,2,0,1,0,1,1,1,0,2,-1,0,3,1,-3,15,-18,18,16,2,2,4,-6,1,3,-3,3,5,2,8,1,-2,-1,-1,-8,-7,2,-1,1,6,0,9,4,-2,1,3,2,8,2,0,0,3,-2,1,2,-2,13,11,2,6,4,2,-5,1,7,2,6,2,-1,-2,10,6,3,-4,-4,3,-3,-4,3,6,-1,0,0,4,2,1,-1,0,1,2,2,0,0,0,-1,2,0,1,3,4,-1,10,5,5,1,6,-8,6,-2,-1,3,4,-5,5,-4,1,-2,2,-3,1,2,-2,0,1,3,2,1,2,0,0,3,1,0,1,0,1,0,1,1,1,-4,1,-5,4,2,2,-7,1,3,-6,-1,5,-2,2,1,-5,1,3,-5,-1,2,-1,-2,2,1,0,1,2,-2,2,1,0,-1,0,0,2,0,0,2,2,-2,0,-15,-12,-3,-16,-7,-9,-2,2,-7,3,-1,-10,-4,-1,-4,3,0,-6,2,3,-3,0,-1,-4,-1,0,-5,-3,-2,-5,0,0,-2,-1,-2,-2,-1,0,-3,-2,0,-3,24,17,7,3,3,0,4,1,10,-2,3,7,4,2,6,0,1,4,0,-1,4,-2,2,3,0,2,0,0,1,0,0,2,1,0,0,0,0,0,-1,0,1,0,3,1,2,6,2,4,-7,2,-7,-5,9,10,-6,0,-2,-7,7,9,-1,2,-5,2,2,1,0,0,-1,1,6,0,0,0,-1,-1,4,0,0,0,0,2,2,0,-12,-6,-6,-5,-5,0,0,-4,-1,-6,-4,2,-1,-2,-2,-5,-3,6,1,-2,1,-1,-1,-4,0,0,2,-6,0,-1,0,0,2,-6,-1,0,0,0,0,0,1,-1,9,8,1,12,8,4,-4,1,-4,-5,5,15,-1,3,2,-3,2,4,-3,-2,-6,-2,3,11,1,0,3,3,1,4,0,0,2,2,1,3,1,0,1,1,0,1
32,32072,"Rúa, A",4951,72,44,28,14,9,5,2,7,8,-6,7,54,2,2,6,-1,6,29,0,5,2,-5,1,25,2,2,0,5,3,2,1,2,0,3,2,1,1,0,0,2,1,1,105,44,61,5,4,1,2,2,6,12,15,70,2,2,2,9,7,23,0,0,4,3,8,47,0,1,1,0,3,0,0,1,1,0,2,0,0,0,0,0,1,0,-5,-3,-2,9,6,3,-3,0,-14,-12,10,11,-6,-6,0,-5,5,6,3,6,-14,-7,5,5,0,-1,2,-1,6,3,1,0,1,0,2,2,-1,-1,1,-1,4,1,-29,-15,-14,13,7,6,1,-10,-42,-7,8,24,-3,-3,-19,-4,4,11,4,-7,-23,-3,4,13,0,4,-2,1,5,5,0,3,-1,0,2,3,0,1,-1,1,3,2,29,7,22,18,7,11,17,-1,6,-9,-4,21,5,3,0,-8,-2,11,12,-4,6,-1,-2,10,5,2,4,4,2,1,3,0,1,1,1,1,2,2,3,3,1,0,-1,12,-13,21,13,8,-9,2,-14,9,5,6,-4,8,-7,7,2,6,-5,-6,-7,2,3,0,1,6,0,5,8,1,1,5,0,2,4,1,0,1,0,3,4,0,-39,-26,-13,21,8,13,-3,6,-21,-14,-10,4,-3,-3,-15,-5,-8,8,0,9,-6,-9,-2,-4,2,5,6,3,2,3,0,1,2,2,1,2,2,4,4,1,1,1,-22,-7,-15,11,6,5,4,-9,-4,-14,-5,7,2,-9,-2,-3,-1,8,2,0,-2,-11,-4,-1,2,1,5,4,-1,0,1,1,2,2,0,0,1,0,3,2,-1,0,20,21,-1,18,8,10,3,15,-21,-3,7,18,9,12,-9,0,2,7,-6,3,-12,-3,5,11,5,3,-1,7,4,0,3,2,0,3,1,-1,2,1,-1,4,3,1,-34,-17,-17,13,7,6,-12,-3,-22,-2,-2,7,-9,-4,-1,-5,-4,4,-3,1,-21,3,2,3,0,3,4,5,0,0,0,1,2,2,1,0,0,2,2,3,-1,0,-4,6,-10,21,9,12,4,5,-4,-8,-4,0,3,3,2,-2,3,-4,1,2,-6,-6,-7,4,4,11,1,1,3,1,2,5,0,1,1,0,2,6,1,0,2,1,13,15,-2,26,14,12,3,9,-5,5,8,-1,3,10,-3,6,8,-3,0,-1,-2,-1,0,2,3,7,1,2,8,5,1,4,1,2,5,1,2,3,0,0,3,4,63,46,17,3,0,3,16,3,6,2,5,31,8,5,4,9,1,19,8,-2,2,-7,4,12,2,2,2,-1,1,-3,0,0,0,0,1,-1,2,2,2,-1,0,-2,13,-3,16,15,5,10,4,-7,-9,2,10,12,-2,-7,-3,1,-2,10,6,0,-6,1,12,2,3,5,-6,3,5,5,1,1,-4,2,0,5,2,4,-2,1,5,0,-8,-9,1,-1,3,-4,-4,-11,-22,14,8,5,-4,-7,-10,5,6,0,0,-4,-12,9,2,5,-2,0,-6,2,3,1,-1,1,-4,4,2,0,-1,-1,-2,-2,1,1,2,-8,10,12,4,8,-9,2,-10,-7,4,24,-2,3,-7,-7,2,3,-7,-1,-3,0,2,21,-2,7,0,-1,2,6,-1,3,-2,0,1,2,-1,4,2,-1,1,4,-13,-14,1,5,0,5,-2,3,-12,-12,5,4,-2,2,-6,-11,5,-2,0,1,-6,-1,0,6,3,2,0,-1,2,-1,0,0,1,-2,1,0,3,2,-1,1,1,-1,-34,-24,-10,8,3,5,-14,-20,-9,-9,6,10,-4,-9,-7,-6,5,-3,-10,-11,-2,-3,1,13,-1,1,-1,2,1,5,1,1,0,2,0,-1,-2,0,-1,0,1,6
32,32075,San Cibrao das Viñas,3553,60,18,42,46,17,29,6,31,6,15,1,0,2,7,5,9,-1,-4,4,24,1,6,2,4,8,13,8,9,4,4,5,2,0,5,3,2,3,11,8,4,1,2,77,54,23,27,16,11,8,18,10,18,10,10,8,12,9,10,5,10,0,6,1,8,5,0,2,4,9,5,5,2,2,1,4,4,3,2,0,3,5,1,2,0,115,57,58,50,21,29,15,42,24,16,22,-5,13,15,14,7,10,-2,2,27,10,9,12,-3,6,11,10,12,8,1,3,5,4,3,3,1,3,6,6,9,5,0,70,45,25,23,17,6,5,29,-1,16,13,7,2,12,1,15,10,4,3,17,-2,1,3,3,1,3,1,7,7,4,1,1,1,5,5,4,0,2,0,2,2,0,80,49,31,25,11,14,9,14,23,29,3,1,6,6,17,17,2,0,3,8,6,12,1,1,3,5,6,6,4,1,1,1,3,3,2,1,2,4,3,3,2,0,139,62,77,18,9,9,19,22,51,26,12,2,7,6,28,6,11,1,12,16,23,20,1,1,3,1,5,5,2,1,2,0,1,3,2,1,1,1,4,2,0,0,76,57,19,41,18,23,19,14,16,23,6,-4,16,7,9,14,12,-1,3,7,7,9,-6,-3,10,12,7,5,6,1,3,3,4,3,5,0,7,9,3,2,1,1,30,26,4,36,21,15,-5,-1,1,22,10,0,0,-3,0,24,4,0,-5,2,1,-2,6,0,2,6,12,6,6,4,3,2,5,5,4,2,-1,4,7,1,2,2,120,81,39,30,19,11,2,14,42,42,17,-1,-1,15,32,27,7,-1,3,-1,10,15,10,0,2,2,7,13,4,2,1,2,4,8,4,0,1,0,3,5,0,2,136,84,52,29,19,10,10,33,40,44,11,-7,0,24,27,23,7,-1,10,9,13,21,4,-6,1,3,6,14,4,1,-1,2,5,11,2,0,2,1,1,3,2,1,135,77,58,28,23,5,26,21,44,26,7,2,16,8,27,14,4,1,10,13,17,12,3,1,9,2,9,7,0,-1,6,1,6,7,1,0,3,1,3,0,-1,-1,159,83,76,16,8,8,10,23,46,55,24,-3,8,7,21,33,17,-4,2,16,25,22,7,1,1,3,4,6,4,-2,1,1,1,3,3,-1,0,2,3,3,1,-1,189,96,93,20,9,11,27,17,43,46,32,13,6,9,22,22,22,12,21,8,21,24,10,1,6,3,4,1,4,1,3,0,1,1,3,1,3,3,3,0,1,0,86,45,41,6,1,5,-1,6,36,41,8,-4,1,2,25,17,2,-2,-2,4,11,24,6,-2,3,4,2,-2,0,-1,1,1,2,-1,0,-2,2,3,0,-1,0,1,93,40,53,6,-2,8,9,11,23,38,9,2,1,5,11,14,3,7,8,6,12,24,6,-5,2,-1,0,5,-3,3,0,-2,0,0,-2,2,2,1,0,5,-1,1,85,50,35,1,2,-1,19,12,56,4,7,-17,7,3,29,12,4,-6,12,9,27,-8,3,-11,3,-2,-1,1,-1,1,3,-2,0,1,-1,1,0,0,-1,0,0,0,83,33,50,14,5,9,17,3,30,26,-1,5,5,3,17,11,-7,-1,12,0,13,15,6,6,4,0,5,5,-2,2,2,0,2,2,-1,0,2,0,3,3,-1,2,61,27,34,25,17,8,14,2,11,34,3,-5,6,2,-10,21,5,2,8,0,21,13,-2,-7,3,2,4,6,3,7,1,2,3,4,2,5,2,0,1,2,1,2
32,32084,Verea,1515,-11,-14,3,11,5,6,-1,-4,-10,-4,5,3,-1,-3,-9,-3,-1,3,0,-1,-1,-1,6,0,1,2,1,1,2,4,0,0,1,1,0,3,1,2,0,0,2,1,-5,3,-8,11,8,3,-4,3,-12,-1,5,3,-2,1,-4,2,2,3,-2,2,-8,-3,3,0,0,1,1,2,4,2,0,1,1,2,1,2,0,0,0,0,3,0,4,0,4,25,12,13,0,2,-1,-1,4,0,0,1,0,1,0,-2,0,1,-1,-2,4,2,0,1,9,0,7,8,0,0,4,0,3,5,0,1,5,0,4,3,32,13,19,24,13,11,3,12,2,6,6,3,-1,2,3,4,1,4,4,10,-1,2,5,-1,1,4,-1,6,6,8,-1,3,0,3,1,7,2,1,-1,3,5,1,-22,-5,-17,16,7,9,-3,1,-18,2,4,-9,-1,2,-5,-1,2,-2,-2,-1,-13,3,2,-7,1,2,2,2,5,3,0,2,1,1,1,2,1,0,1,1,4,1,-5,-1,-4,11,5,6,5,-1,-11,4,-1,-1,1,-1,-3,1,0,1,4,0,-8,3,-1,-2,0,0,2,1,3,5,0,0,1,-1,2,3,0,0,1,2,1,2,-19,-7,-12,0,4,-4,-7,-1,-10,-2,10,-9,-2,1,-2,-6,7,-5,-5,-2,-8,4,3,-4,-2,-1,1,0,2,0,0,0,1,1,3,-1,-2,-1,0,-1,-1,1,24,10,14,16,9,7,2,1,2,3,15,2,1,-1,4,2,4,0,1,2,-2,1,11,2,2,1,3,4,4,2,1,1,3,2,0,2,1,0,0,2,4,0,-3,-4,1,15,7,8,4,-3,-1,5,11,-17,0,-3,1,3,6,-10,4,0,-2,2,5,-7,4,0,1,3,5,2,2,0,-1,3,2,1,2,0,2,0,3,1,-13,-7,-6,10,1,9,0,2,-9,-3,7,-8,-3,2,-3,-1,2,-3,3,0,-6,-2,5,-5,1,4,2,1,4,-2,0,0,1,0,1,-1,1,4,1,1,3,-1,14,13,1,-7,-5,-2,-1,5,10,8,7,-13,-1,4,7,5,4,-5,0,1,3,3,3,-8,-2,-1,-1,-2,0,-1,-1,-1,0,-2,0,-1,-1,0,-1,0,0,0,-46,-25,-21,5,4,1,-5,-8,-8,-9,-2,-13,-4,-5,-3,-6,-1,-6,-1,-3,-5,-3,-1,-7,1,-2,-1,1,6,0,0,0,0,0,4,0,1,-2,-1,1,2,0,-15,-6,-9,11,6,5,-3,3,-2,-1,-2,-10,-2,1,0,-1,1,-5,-1,2,-2,0,-3,-5,-1,3,1,3,3,2,-1,2,0,1,2,2,0,1,1,2,1,0,-34,-13,-21,-17,-7,-10,-2,2,-8,-11,-5,-10,-2,2,-3,-4,-1,-5,0,0,-5,-7,-4,-5,1,-4,-4,-4,-5,-1,1,-2,-2,-1,-2,-1,0,-2,-2,-3,-3,0,11,9,2,2,2,0,-1,4,-6,6,6,2,-1,3,-4,2,5,4,0,1,-2,4,1,-2,0,1,0,0,1,0,0,0,1,0,1,0,0,1,-1,0,0,0,-34,-4,-30,-4,-1,-3,-5,-4,-3,-7,0,-15,-2,-2,2,1,0,-3,-3,-2,-5,-8,0,-12,0,1,-1,-2,-1,-1,0,0,1,-1,-2,1,0,1,-2,-1,1,-2,-10,-7,-3,2,0,2,-4,3,-7,-7,2,3,-2,2,-2,-8,-1,4,-2,1,-5,1,3,-1,-1,-1,-2,-1,4,3,-1,0,-1,-3,2,3,0,-1,-1,2,2,0,-3,-2,-1,7,3,4,0,1,-2,-3,4,-3,0,1,-2,-3,3,-1,0,0,0,0,1,-2,0,0,-1,-1,4,5,0,0,-1,-1,2,3,0,0,0,0,2,2
32,32085,Verín,12765,304,123,181,247,97,150,12,47,79,50,45,65,12,5,27,21,24,32,0,42,52,29,21,33,20,52,84,43,31,15,10,14,29,21,14,9,10,38,55,22,17,6,249,104,145,222,94,128,32,33,85,43,29,23,9,5,38,23,18,12,23,28,47,20,11,11,30,53,72,43,17,4,15,13,28,25,10,3,15,40,44,18,7,1,336,192,144,237,120,117,71,60,54,62,53,36,40,21,43,46,26,19,31,39,11,16,27,17,47,57,58,40,24,6,27,20,31,23,13,4,20,37,27,17,11,2,127,74,53,223,121,102,10,20,9,33,19,38,7,18,-1,15,14,20,3,2,10,18,5,18,34,50,67,43,18,9,20,24,36,25,9,6,14,26,31,18,9,3,109,50,59,115,49,66,-19,27,25,19,25,31,-15,5,20,17,7,14,-4,22,5,2,18,17,-3,36,43,22,7,4,-3,5,24,19,3,0,0,31,19,3,4,4,293,143,150,248,114,134,25,56,67,31,74,29,9,17,33,11,48,18,16,39,34,20,26,11,21,62,74,42,34,11,12,26,23,29,19,5,9,36,51,13,15,6,295,127,168,224,110,114,28,55,35,71,37,68,16,15,6,41,19,35,12,40,29,30,18,33,25,49,48,58,27,16,13,15,21,35,13,14,12,34,27,23,14,2,254,183,71,308,177,131,1,47,34,38,90,26,6,25,44,28,55,14,-5,22,-10,10,35,12,38,87,68,47,57,5,26,40,43,29,34,3,12,47,25,18,23,2,227,123,104,189,97,92,19,41,58,27,24,47,9,18,41,16,18,17,10,23,17,11,6,30,22,53,57,19,31,5,12,22,26,10,22,4,10,31,31,9,9,1,351,187,164,166,88,78,55,34,74,60,70,49,30,25,39,37,39,15,25,9,35,23,31,34,22,39,51,21,26,3,9,19,33,9,14,2,13,20,18,12,12,1,74,38,36,12,11,1,27,8,-36,32,10,28,6,-2,-9,21,0,22,21,10,-27,11,10,6,-6,13,-17,13,11,-3,-11,4,-3,15,6,0,5,9,-14,-2,5,-3,165,35,130,62,7,55,46,5,35,32,27,12,22,-17,6,-2,22,1,24,22,29,34,5,11,13,10,25,-6,19,-3,10,-4,14,-14,4,-5,3,14,11,8,15,2,138,59,79,-27,-10,-17,53,-2,21,40,4,21,24,-1,3,25,-5,12,29,-1,18,15,9,9,-5,-5,-19,8,-11,3,-2,1,-7,5,-10,2,-3,-6,-12,3,-1,1,80,15,65,-147,-97,-50,48,-11,-4,18,28,-2,22,-12,-11,9,14,-7,26,1,7,9,14,5,-22,0,-56,-55,-3,-10,-13,-1,-32,-38,-7,-5,-9,1,-24,-17,4,-5,-378,-260,-118,-239,-165,-74,0,-46,-103,-102,-85,-45,-5,-22,-73,-59,-65,-37,5,-24,-30,-43,-20,-8,9,-15,-74,-85,-53,-23,7,-6,-51,-54,-47,-16,2,-9,-23,-31,-6,-7,-57,-36,-21,-43,-26,-17,-13,-31,-35,-27,12,33,-7,-10,-14,-26,7,11,-6,-21,-21,-1,5,22,1,0,-22,-19,1,-5,-3,5,-7,-17,1,-5,4,-5,-15,-2,0,0,-113,-65,-48,-104,-72,-32,-12,-3,-81,-53,3,32,1,-13,-34,-30,-10,20,-13,10,-47,-23,13,12,0,8,-37,-41,-29,-9,7,-1,-20,-28,-25,-8,-7,9,-17,-13,-4,-1,-19,-40,21,-22,-40,18,-3,-1,-25,-47,24,35,-13,-7,-13,-27,3,19,10,6,-12,-20,21,16,2,17,-21,-16,-7,4,0,8,-21,-15,-11,1,2,9,0,-1,4,3
32,32032,Xinzo de Limia,9511,185,112,73,81,39,42,41,37,46,34,15,9,24,20,22,25,12,7,17,17,24,9,3,2,16,13,22,20,6,4,8,7,8,12,1,3,8,6,14,8,5,1,-31,2,-33,21,10,11,1,-6,-32,1,12,-8,2,-1,-14,2,7,3,-1,-5,-18,-1,5,-11,6,2,4,4,5,0,2,0,2,3,3,0,4,2,2,1,2,0,51,32,19,36,18,18,7,-5,4,28,10,8,2,-3,9,19,4,1,5,-2,-5,9,6,7,8,0,8,14,2,3,3,0,4,8,0,2,5,0,4,6,2,1,31,14,17,40,15,25,13,11,-3,-17,20,6,5,10,-5,-10,9,4,8,1,2,-7,11,2,13,0,6,3,13,4,4,1,2,1,4,3,9,-1,4,2,9,1,54,11,43,89,52,37,18,11,2,-2,17,5,3,0,6,-7,9,-1,15,11,-4,5,8,6,14,20,14,16,20,5,5,14,10,9,12,2,9,6,4,7,8,3,114,60,54,118,67,51,10,-1,15,34,36,17,4,1,-2,26,19,11,6,-2,17,8,17,6,14,16,26,25,29,8,6,10,16,16,15,4,8,6,10,9,14,4,86,39,47,90,43,47,29,30,-15,14,21,14,12,13,-10,0,14,11,17,17,-5,14,7,3,18,13,20,14,17,8,8,8,10,4,9,4,10,5,10,10,8,4,50,35,15,92,48,44,22,25,-20,-8,17,11,15,10,-8,-6,11,9,7,15,-12,-2,6,2,24,20,14,11,21,1,14,8,5,5,14,1,10,12,9,6,7,0,169,71,98,83,37,46,21,21,32,37,28,25,14,3,15,24,12,1,7,18,17,13,16,24,16,14,20,21,9,2,10,4,8,11,5,-1,6,10,12,10,4,3,131,67,64,64,32,32,15,19,27,30,19,12,6,16,11,20,0,9,9,3,16,10,19,3,9,12,15,15,8,3,4,7,5,9,5,1,5,5,10,6,3,2,117,70,47,38,20,18,6,11,9,42,12,35,9,10,7,19,7,16,-3,1,2,23,5,19,4,14,-2,6,10,4,2,9,-2,2,5,2,2,5,0,4,5,2,101,52,49,29,13,16,21,18,38,-6,12,11,11,13,14,-5,6,12,10,5,24,-1,6,-1,9,1,9,9,1,-1,5,-2,5,3,0,1,4,3,4,6,1,-2,4,-12,16,14,5,9,-12,22,3,-5,16,-17,-12,9,4,-10,10,-11,0,13,-1,5,6,-6,0,6,3,3,6,-4,0,2,3,0,2,-2,0,4,0,3,4,-2,-4,-12,8,8,6,2,9,6,-27,-1,-1,6,2,4,-24,1,0,2,7,2,-3,-2,-1,4,2,11,-9,3,-1,0,0,6,-8,6,-2,3,2,5,-1,-3,1,-3,-96,-58,-38,-1,2,-3,1,-38,-43,-14,-1,-4,-5,-24,-19,-6,2,-7,6,-14,-24,-8,-3,3,-6,5,-8,-8,12,3,-5,0,-3,3,5,2,-1,5,-5,-11,7,1,3,-11,14,13,0,13,14,4,9,-16,10,-15,11,-1,1,-9,0,-10,3,5,8,-7,10,-5,9,4,-1,-3,2,2,5,2,-3,-4,0,0,4,2,2,1,2,2,-37,-28,-9,33,17,16,-11,-10,-10,-15,14,-6,-5,-8,-20,-8,12,1,-6,-2,10,-7,2,-7,8,7,4,1,7,5,7,1,3,-1,5,2,1,6,1,2,2,3,41,9,32,18,8,10,21,3,-7,-1,14,13,11,-3,-16,5,4,9,10,6,9,-6,10,4,1,3,0,4,7,3,-1,1,-2,6,1,3,2,2,2,-2,6,0
33,33002,Aller,15775,-184,-92,-92,23,11,12,-10,-35,-47,-21,-21,-51,-8,-18,-29,-7,-9,-21,-2,-17,-18,-14,-12,-30,4,3,6,7,3,0,2,2,1,4,2,0,2,1,5,3,1,0,-210,-107,-103,16,10,6,-17,-46,-69,-26,-8,-44,-10,-20,-41,-14,-3,-19,-7,-26,-28,-12,-5,-25,1,2,6,5,2,0,0,2,4,2,2,0,1,0,2,3,0,0,-265,-118,-147,8,4,4,-21,-29,-74,-63,-34,-45,-1,-11,-39,-27,-16,-23,-20,-18,-35,-36,-18,-22,1,4,1,3,0,-1,1,2,2,1,-1,-1,0,2,-1,2,1,0,-169,-68,-101,17,8,9,-16,-5,-66,-45,7,-42,-4,11,-41,-22,3,-14,-12,-16,-25,-23,4,-28,3,2,4,3,4,1,1,0,1,3,3,0,2,2,3,0,1,1,-225,-108,-117,26,11,15,-22,-37,-74,-30,-8,-49,-18,-8,-35,-21,-4,-19,-4,-29,-39,-9,-4,-30,5,4,3,6,5,3,3,3,1,1,1,2,2,1,2,5,4,1,-187,-85,-102,33,17,16,-9,-38,-61,-44,-18,-17,-4,-25,-25,-23,-7,-1,-5,-13,-36,-21,-11,-16,7,7,6,8,0,4,4,4,3,4,0,2,3,3,3,4,0,2,-98,-41,-57,35,17,18,-11,1,-53,-24,8,-15,-10,16,-22,-22,2,-1,-1,-15,-31,-2,6,-14,5,5,8,11,3,3,-1,3,4,6,2,3,6,2,4,5,1,0,-125,-58,-67,51,25,26,13,13,-77,-3,-18,-48,-2,9,-40,0,-6,-16,15,4,-37,-3,-12,-32,6,13,13,11,5,3,1,7,7,6,3,1,5,6,6,5,2,2,-72,-37,-35,17,7,10,20,-8,-36,-25,6,-27,11,-9,-21,-12,5,-10,9,1,-15,-13,1,-17,5,9,6,-1,-3,0,5,5,-1,0,-2,-1,0,4,7,-1,-1,1,-65,-15,-50,3,-5,8,-1,9,-27,-2,2,-43,1,6,4,-3,1,-20,-2,3,-31,1,1,-23,1,3,-1,-1,1,0,2,-1,-1,-4,-1,0,-1,4,0,3,2,0,-109,-49,-60,3,-2,5,-1,-9,-30,-18,-4,-50,0,1,-14,-11,-2,-22,-1,-10,-16,-7,-2,-28,3,2,-2,-2,0,2,3,-1,-3,-3,0,2,0,3,1,1,0,0,-92,-37,-55,7,1,6,-7,-7,-37,-21,4,-20,-2,-6,-7,-18,1,-5,-5,-1,-30,-3,3,-15,1,4,-2,2,0,2,-1,1,0,0,0,1,2,3,-2,2,0,1,-111,-49,-62,-1,-4,3,-8,-10,-29,-17,-18,-32,-6,-9,-21,-11,-1,-5,-2,-1,-8,-6,-17,-27,0,-1,-1,-2,0,-1,0,-1,-2,-3,0,0,0,0,1,1,0,-1,-11,-7,-4,0,-5,5,14,-3,-8,-14,-3,4,8,-1,-8,-2,-5,2,6,-2,0,-12,2,2,0,-1,0,0,3,-2,1,-2,-4,1,0,-1,-1,1,4,-1,3,-1,-97,-37,-60,-9,-3,-6,-8,-7,-33,-28,-8,-10,0,-3,-11,-16,-6,-3,-8,-4,-22,-12,-2,-7,2,2,-7,-5,2,-3,2,1,-3,-4,2,-1,0,1,-4,-1,0,-2,-101,-61,-40,-10,-14,4,-13,-11,-36,-31,-6,2,-8,-8,-21,-18,-1,-2,-5,-3,-15,-13,-5,4,0,-4,-1,-6,-3,5,-1,-3,-5,-3,-2,0,1,-1,4,-3,-1,5,-79,-43,-36,6,2,4,-9,-11,-54,-11,0,3,-14,5,-30,-8,1,0,5,-16,-24,-3,-1,3,3,4,-2,-1,2,-1,1,3,-1,-1,1,-1,2,1,-1,0,1,0,-83,-36,-47,8,3,5,5,-12,-30,-18,-8,-16,3,-5,-13,-15,-9,3,2,-7,-17,-3,1,-19,2,1,-3,1,5,2,0,0,-3,0,3,3,2,1,0,1,2,-1
33,33004,Avilés,84519,-484,-260,-224,86,36,50,-60,-100,-234,-37,-20,-27,-32,-41,-135,-24,-14,-16,-28,-59,-99,-13,-6,-11,21,12,20,18,8,6,8,7,6,8,2,4,13,5,14,10,6,2,-295,-157,-138,162,74,88,-21,-16,-168,-74,-28,15,5,2,-107,-37,-23,6,-26,-18,-61,-37,-5,9,26,37,55,24,18,2,10,16,27,11,9,1,16,21,28,13,9,1,-14,-78,64,241,95,146,48,98,-88,-20,-15,-32,19,33,-54,-29,-19,-25,29,65,-34,9,4,-7,50,69,48,50,20,3,24,24,19,20,7,1,26,45,29,30,13,2,-222,-126,-96,192,94,98,6,-24,-88,-47,-41,-4,10,-26,-43,-23,-18,-12,-4,2,-45,-24,-23,8,36,58,48,34,11,4,22,16,29,22,5,-1,14,42,19,12,6,5,54,22,32,254,108,146,97,22,-67,-16,-16,37,58,7,-25,-15,-18,14,39,15,-42,-1,2,23,31,67,89,45,15,6,15,22,43,19,6,2,16,45,46,26,9,4,130,42,88,351,151,200,76,129,-64,-9,5,-5,31,49,-29,-8,7,-2,45,80,-35,-1,-2,-3,62,124,86,50,15,13,28,53,40,21,4,5,34,71,46,29,11,8,216,72,144,418,205,213,112,71,25,3,16,-3,44,16,13,-3,14,-7,68,55,12,6,2,4,69,101,134,75,29,7,31,45,67,39,16,4,38,56,67,36,13,3,263,154,109,460,295,165,110,119,-88,52,-32,97,61,74,-41,32,-4,27,49,45,-47,20,-28,70,101,140,119,72,16,8,47,87,83,59,12,6,54,53,36,13,4,2,721,419,302,703,435,268,144,182,144,157,12,61,63,87,110,122,7,17,81,95,34,35,5,44,96,181,215,156,44,9,53,93,135,120,28,4,43,88,80,36,16,5,183,102,81,293,183,110,107,61,-31,38,-3,2,46,20,2,32,-1,0,61,41,-33,6,-2,2,75,71,59,62,20,-1,40,36,50,44,12,1,35,35,9,18,8,-2,-66,-45,-21,318,155,163,69,25,-102,19,-69,-10,32,18,-53,8,-37,-11,37,7,-49,11,-32,1,57,88,92,53,15,7,25,41,51,29,3,4,32,47,41,24,12,3,-268,-155,-113,62,7,55,-36,-27,-134,-73,20,-3,-5,-1,-74,-62,-2,-12,-31,-26,-60,-11,22,9,42,28,4,-26,5,3,22,9,-3,-25,0,0,20,19,7,-1,5,3,-212,-189,-23,-201,-204,3,76,-15,-68,-102,-67,-31,40,-9,-39,-112,-44,-20,36,-6,-29,10,-23,-11,19,-11,-92,-83,-28,-8,-1,-17,-75,-89,-20,-4,20,6,-17,6,-8,-4,-363,-288,-75,-124,-116,-8,-33,-28,-130,-104,-62,8,-37,-15,-96,-109,-32,11,4,-13,-34,5,-30,-3,9,-16,-42,-46,-28,-5,0,-7,-43,-47,-18,-3,9,-9,1,1,-10,-2,-264,-174,-90,-5,-3,-2,-11,0,-162,-41,-27,-17,18,2,-125,-28,-23,-9,-29,-2,-37,-13,-4,-8,17,7,-21,-3,0,-6,25,0,-25,2,-3,-3,-8,7,4,-5,3,-3,-372,-245,-127,-45,-68,23,11,-19,-228,-107,-3,-31,-4,-8,-121,-83,-18,-14,15,-11,-107,-24,15,-17,23,40,-63,-33,-12,-8,11,15,-39,-31,-18,-9,12,25,-24,-2,6,1,-110,-67,-43,96,37,59,46,-22,-41,-40,-41,-15,31,-8,-41,-30,-26,3,15,-14,0,-10,-15,-18,52,19,14,3,-5,10,30,9,2,-9,-2,5,22,10,12,12,-3,5,-220,-136,-84,126,50,76,-10,-27,-84,-90,-27,20,-11,-22,-50,-54,-20,20,1,-5,-34,-36,-7,0,34,43,41,-12,14,3,19,18,26,-19,4,-1,15,25,15,7,10,4
33,33008,Cabrales,2367,29,21,8,31,19,12,9,6,8,5,3,-1,7,3,5,5,2,0,2,3,3,0,1,-1,7,2,9,3,5,5,7,1,4,2,2,3,0,1,5,1,3,2,3,6,-3,11,8,3,-1,-1,2,-4,5,1,0,-2,4,0,2,1,-1,1,-2,-4,3,0,3,1,3,0,3,0,3,0,3,0,1,0,0,1,0,0,2,0,2,-2,4,24,10,14,3,4,-7,0,4,-2,4,3,-7,-3,0,1,-1,1,0,3,4,-3,8,5,5,2,3,1,5,3,2,-1,0,1,3,2,3,3,3,0,-4,2,-6,25,11,14,-2,-5,-4,2,11,-6,-3,-2,0,1,5,1,1,-3,-4,1,6,-7,1,1,4,5,12,2,0,0,2,2,5,2,1,1,2,3,7,0,-19,-12,-7,23,13,10,-8,-11,3,-5,4,-1,-2,-9,1,-6,5,0,-6,-2,2,1,-1,-1,0,2,6,5,4,6,0,1,4,2,3,3,0,1,2,3,1,3,13,10,3,19,12,7,0,-1,7,0,4,2,2,1,2,1,1,2,-2,-2,5,-1,3,0,1,3,4,2,2,6,1,3,0,1,2,4,0,0,4,1,0,2,-11,-1,-10,12,5,7,-7,3,-19,3,11,-2,-3,1,-10,4,7,0,-4,2,-9,-1,4,-2,0,2,-1,6,2,3,1,0,-2,3,2,1,-1,2,1,3,0,2,37,20,17,35,14,21,1,7,7,8,13,1,3,2,4,6,6,-1,-2,5,3,2,7,2,3,6,10,3,6,7,2,1,5,1,2,3,1,5,5,2,4,4,19,15,4,40,15,25,1,9,1,3,9,-6,3,1,3,3,4,-1,-2,8,-2,0,5,-5,6,9,7,12,7,-1,2,1,5,4,3,0,4,8,2,8,4,-1,44,18,26,35,18,17,6,6,3,13,13,2,1,1,4,5,5,1,5,5,-1,8,8,1,9,7,3,9,3,3,3,4,2,5,1,2,6,3,1,4,2,1,2,3,-1,14,4,10,-5,0,2,4,3,-3,-2,-5,2,2,3,2,-3,5,0,2,0,-5,4,6,2,-1,2,0,2,1,1,-2,2,-1,2,5,1,1,0,1,-23,-20,-3,1,-3,4,-7,-6,-6,-2,-1,0,-4,-6,-1,-8,2,-3,-3,0,-5,6,-3,3,1,-2,3,0,-1,0,1,-2,2,-2,-2,0,0,0,1,2,1,0,-2,-3,1,-2,0,-2,2,1,3,1,-7,-2,0,-1,1,2,-6,0,2,2,2,-1,-1,-2,-2,-1,0,-4,1,3,-2,-2,0,-1,2,2,0,1,0,-3,-1,1,-5,3,-8,0,2,-2,1,-8,-2,1,6,-3,1,-3,-2,6,1,0,0,-5,0,-5,5,-3,0,-1,-1,-2,2,2,0,-1,0,0,1,2,0,0,-1,-2,1,0,23,1,22,10,4,6,6,5,3,8,0,3,3,2,1,-3,-2,2,3,3,2,11,2,1,0,1,1,1,5,2,0,0,0,1,2,1,0,1,1,0,3,1,-24,-16,-8,0,2,-2,-3,5,-4,-13,-2,-7,-3,2,-1,-5,-5,-4,0,3,-3,-8,3,-3,2,2,-1,-3,-1,-1,1,0,1,-1,0,-1,1,2,-2,-2,-1,0,-14,0,-14,-1,1,-2,2,2,5,-7,1,-17,5,2,0,-4,6,-9,-3,0,5,-3,-5,-8,-1,1,0,-2,3,-2,2,0,0,-3,3,-1,-3,1,0,1,0,-1,28,19,9,14,6,8,2,0,0,11,4,8,1,-1,6,5,3,3,1,1,-6,6,1,5,2,0,1,3,2,6,1,0,0,1,1,3,1,0,1,2,1,3
33,33012,Cangas de Onís,6287,12,3,9,23,11,12,-2,0,-4,4,9,3,-1,-1,-1,-1,6,1,-1,1,-3,5,3,2,2,1,7,5,4,4,1,0,2,3,3,2,1,1,5,2,1,2,37,28,9,35,15,20,3,5,3,12,8,5,3,7,7,2,2,6,0,-2,-4,10,6,-1,4,6,9,5,7,4,0,3,4,2,3,3,4,3,5,3,4,1,79,43,36,40,23,17,8,8,20,29,9,6,-1,7,7,24,1,4,9,1,13,5,8,2,7,8,6,6,11,2,4,7,3,4,3,2,3,1,3,2,8,0,169,81,88,89,46,43,18,20,35,25,24,46,13,2,19,14,14,17,5,18,16,11,10,29,17,13,25,14,12,6,7,6,12,7,6,6,10,7,13,7,6,0,104,42,62,61,33,28,15,23,29,8,22,8,2,6,20,-6,14,6,13,17,9,14,8,2,10,11,14,10,12,4,4,7,7,7,6,2,6,4,7,3,6,2,94,52,42,58,28,30,21,4,29,17,16,6,16,1,9,11,6,6,5,3,20,6,10,0,5,14,12,9,12,6,4,3,6,6,5,4,1,11,6,3,7,2,74,35,39,85,42,43,18,4,4,17,14,17,9,0,3,10,3,10,9,4,1,7,11,7,21,16,18,12,10,8,11,5,11,8,3,4,10,11,7,4,7,4,159,93,66,145,86,59,8,40,53,22,25,14,9,23,28,16,11,8,-1,17,25,6,14,6,19,29,49,27,18,3,10,16,32,18,8,2,9,13,17,9,10,1,41,17,24,98,45,53,8,4,6,12,7,6,-4,5,-6,18,3,2,12,-1,12,-6,4,4,19,26,19,21,9,4,8,14,5,14,3,1,11,12,14,7,6,3,63,37,26,38,21,17,10,-7,31,22,5,3,6,-3,17,16,3,-2,4,-4,14,6,2,5,8,7,14,8,2,-1,2,3,9,4,3,0,6,4,5,4,-1,-1,102,62,40,41,18,23,18,9,24,32,17,-2,15,10,11,13,11,0,3,-1,13,19,6,-2,6,11,8,8,5,3,4,6,2,2,3,1,2,5,6,6,2,2,25,0,25,28,14,14,4,-1,23,-9,3,-2,1,3,0,-4,0,-2,3,-4,23,-5,3,0,6,7,9,1,2,0,3,4,3,1,2,1,3,3,6,0,0,-1,30,17,13,22,10,12,14,-4,5,1,9,4,8,2,-4,-3,7,6,6,-6,9,4,2,-2,6,7,1,1,4,3,2,5,1,-2,2,2,4,2,0,3,2,1,-30,-3,-27,11,11,0,-11,7,-1,-11,-13,-4,-8,7,5,-3,-6,1,-3,0,-6,-8,-7,-5,4,6,1,1,0,-1,5,3,1,2,0,0,-1,3,0,-1,0,-1,-18,-5,-13,8,5,3,-9,3,-10,-12,-2,9,1,1,-9,-2,-5,7,-10,2,-1,-10,3,2,5,2,-6,2,2,2,4,1,-3,2,0,1,1,1,-3,0,2,1,-29,-18,-11,14,5,9,-13,-13,0,-16,-1,10,-9,-10,-3,2,-5,5,-4,-3,3,-18,4,5,2,0,1,-2,5,8,0,-1,-1,-1,3,5,2,1,2,-1,2,3,-27,-23,-4,-6,-6,0,6,-15,-13,5,-3,-2,-2,-9,-5,0,-3,-2,8,-6,-8,5,0,0,-1,3,-2,-2,-2,-2,-1,2,-2,-2,-2,-1,0,1,0,0,0,-1,-25,-6,-19,31,11,20,-6,-3,5,-31,-3,12,-5,5,-1,-18,0,12,-1,-8,6,-13,-3,0,7,7,7,-4,6,6,1,6,-1,0,0,4,6,1,8,-4,6,2
33,33011,Cangas del Narcea,17593,-238,-137,-101,21,8,13,-32,-67,-69,-44,-19,-9,-19,-37,-32,-28,-14,-7,-13,-30,-37,-16,-5,-2,3,5,5,5,1,2,2,2,1,2,0,1,1,3,4,3,1,1,-166,-94,-72,20,5,15,-24,-45,-42,-56,-11,9,-8,-24,-26,-34,-6,4,-16,-21,-16,-22,-5,5,3,2,6,1,1,4,1,1,2,0,0,1,2,1,4,1,1,3,-189,-107,-82,32,13,19,-29,-34,-63,-58,-2,-6,-20,-22,-34,-32,2,-3,-9,-12,-29,-26,-4,-3,0,13,11,1,5,2,0,7,5,0,0,1,0,6,6,1,5,1,-224,-94,-130,38,27,11,-26,-37,-81,-60,-21,-1,-9,-10,-36,-30,-16,5,-17,-27,-45,-30,-5,-6,5,17,11,1,3,1,5,10,9,0,2,1,0,7,2,1,1,0,-259,-121,-138,96,68,28,-47,-48,-60,-58,-24,-14,-25,-21,-29,-23,-13,-5,-22,-27,-31,-35,-11,-9,9,27,30,23,7,0,2,22,24,17,3,0,7,5,6,6,4,0,-160,-80,-80,72,44,28,-21,-33,-63,-46,-10,12,-10,-11,-34,-28,-2,7,-11,-22,-29,-18,-8,5,9,20,30,10,2,0,4,12,21,5,2,0,5,8,9,5,0,0,-224,-107,-117,48,25,23,-22,-54,-58,-63,-12,-16,-14,-19,-33,-26,-6,-8,-8,-35,-25,-37,-6,-8,11,16,10,6,2,2,7,7,7,2,2,0,4,9,3,4,0,2,-214,-119,-95,68,36,32,-14,-47,-104,-24,-17,-6,-3,-26,-64,-11,-9,-5,-11,-21,-40,-13,-8,-1,11,17,18,12,8,2,7,8,11,6,4,0,4,9,7,6,4,2,-118,-55,-63,60,30,30,4,-36,-57,10,-7,-25,-2,-17,-25,10,-6,-8,6,-19,-32,0,-1,-17,8,16,18,18,1,-1,4,6,10,10,0,0,4,10,8,8,1,-1,-67,-34,-33,21,7,14,13,-14,-35,-17,-2,-14,7,-4,-18,-14,-3,-5,6,-10,-17,-3,1,-9,10,1,9,2,-3,1,5,-2,6,0,-3,0,5,3,3,2,0,1,-81,-45,-36,28,8,20,0,-13,-35,1,-20,-13,9,-13,-25,7,-15,-5,-9,0,-10,-6,-5,-8,6,5,4,10,-2,5,7,0,0,4,-5,2,-1,5,4,6,3,3,-27,-11,-16,35,13,22,26,-16,-37,5,-2,-3,11,-10,-10,9,-2,-9,15,-6,-27,-4,0,6,8,11,6,9,2,-1,5,2,5,2,0,-1,3,9,1,7,2,0,-99,-50,-49,-5,-4,-1,4,-9,-57,-11,-18,-9,1,-3,-31,-4,-9,-4,3,-6,-26,-7,-9,-5,5,-3,-1,-4,-2,0,1,-1,1,-4,-2,1,4,-2,-2,0,0,-1,-65,-38,-27,-13,-12,-1,1,-21,-34,0,-8,-6,-5,-13,-20,-5,1,-1,6,-8,-14,5,-9,-5,-1,1,-5,-8,1,-1,-4,0,-5,-4,-1,2,3,1,0,-4,2,-3,-111,-51,-60,25,10,15,-2,-23,-68,6,-13,-10,1,-9,-38,6,-6,-5,-3,-14,-30,0,-7,-5,2,1,6,16,-2,2,5,-1,0,8,-2,0,-3,2,6,8,0,2,-111,-50,-61,10,6,4,-12,-13,-54,-7,-11,-14,-4,-8,-25,-3,-3,-8,-8,-5,-29,-4,-8,-6,5,7,0,5,-4,-3,2,2,-1,5,0,-2,3,5,1,0,-4,-1,-137,-92,-45,-3,-6,3,-10,-23,-67,-21,-7,-10,0,-18,-42,-22,-3,-6,-10,-5,-25,1,-4,-4,1,1,-5,-2,1,1,2,-3,-2,-4,1,0,-1,4,-3,2,0,1,-245,-119,-126,-16,-11,-5,-24,-39,-75,-41,-38,-21,-10,-13,-43,-20,-25,-6,-14,-26,-32,-21,-13,-15,2,2,-7,-3,-7,-3,1,3,-3,-4,-6,-2,1,-1,-4,1,-1,-1
33,33014,Carreño,10610,46,24,22,15,4,11,3,-2,11,19,3,9,-2,-4,4,16,3,6,5,2,7,3,0,3,0,6,3,1,1,4,0,2,0,0,0,2,0,4,3,1,1,2,-1,-3,2,18,7,11,3,-11,17,-10,12,-15,0,-4,4,-7,10,-8,3,-7,13,-3,2,-7,7,3,3,2,2,0,4,0,1,1,1,0,3,3,2,1,1,0,-40,23,-63,8,6,2,-5,-14,-10,-15,4,-3,4,-5,13,-4,8,4,-9,-9,-23,-11,-4,-7,1,-1,4,0,0,4,1,0,1,0,0,4,0,-1,3,0,0,0,123,64,59,43,20,23,22,16,36,19,21,7,5,11,9,14,18,5,17,5,27,5,3,2,11,7,6,13,3,2,4,3,3,8,1,0,7,4,3,5,2,2,66,10,56,24,11,13,0,13,14,22,8,8,-10,7,-7,12,4,4,10,6,21,10,4,4,3,7,9,1,2,1,1,3,4,0,1,1,2,4,5,1,1,0,118,55,63,32,12,20,29,17,22,35,17,-3,17,3,11,10,8,3,12,14,11,25,9,-6,7,7,11,1,5,1,3,3,4,0,1,1,4,4,7,1,4,0,112,92,20,50,23,27,13,32,23,25,23,-4,19,21,21,17,14,1,-6,11,2,8,9,-5,9,20,17,2,1,1,4,10,9,0,-1,1,5,10,8,2,2,0,104,50,54,43,23,20,21,5,46,27,12,-7,1,2,27,18,8,-4,20,3,19,9,4,-3,7,10,9,9,6,2,4,5,3,6,3,2,3,5,6,3,3,0,142,83,59,26,14,12,12,20,52,37,25,-5,6,10,28,23,18,-2,6,10,24,14,7,-3,2,8,6,8,3,-1,2,3,2,6,2,-1,0,5,4,2,1,0,82,40,42,19,9,10,12,15,7,35,-4,11,12,7,3,17,-2,0,0,8,4,18,-2,11,4,8,-2,6,1,2,3,4,-2,3,0,1,1,4,0,3,1,1,0,-17,17,4,-4,8,8,-5,-13,7,11,-6,-3,-9,-9,4,7,-5,11,4,-4,3,4,-1,8,4,-12,1,0,2,2,0,-7,0,0,0,6,4,-5,1,0,2,68,27,41,0,-2,2,13,1,18,25,5,6,13,6,3,7,-2,2,0,-5,15,18,7,4,2,0,-2,2,-1,-1,1,1,-3,0,0,-1,1,-1,1,2,-1,0,-33,-20,-13,-25,-17,-8,-3,-8,-9,-20,10,-3,1,-7,-18,-2,9,-3,-4,-1,9,-18,1,0,-1,-3,-11,-11,2,-1,0,-2,-8,-8,2,-1,-1,-1,-3,-3,0,0,-55,-36,-19,-10,-7,-3,-10,-8,-34,-16,3,12,-4,-3,-18,-9,-3,3,-6,-5,-16,-7,6,9,3,-1,-5,-6,-1,0,3,-1,-4,-4,-1,0,0,0,-1,-2,0,0,70,12,58,-4,-5,1,14,1,26,13,-12,21,11,-8,8,9,-13,6,3,9,18,4,1,15,0,3,2,-10,0,1,0,1,1,-6,0,0,0,2,1,-4,0,1,28,13,15,-4,0,-4,3,8,11,-6,-9,18,3,1,3,0,3,2,0,7,8,-6,-12,16,1,0,0,-3,-3,0,1,-1,1,-1,-1,0,0,1,-1,-2,-2,0,29,22,7,21,5,16,11,0,-2,-2,14,3,5,3,-3,-8,15,7,6,-3,1,6,-1,-4,6,5,3,2,5,-1,2,2,1,-2,1,1,4,3,2,4,4,-2,-9,-11,2,5,8,-3,9,-4,-18,6,0,1,1,-2,-2,0,-2,-5,8,-2,-16,6,2,6,0,0,3,1,2,-1,1,2,3,0,3,-1,-1,-2,0,1,-1,0
33,33016,Castrillón,22515,56,-2,58,29,16,13,35,-11,40,15,-19,-5,10,-12,12,10,-16,-6,25,1,28,5,-3,1,1,3,10,10,3,2,1,2,4,6,1,2,0,1,6,4,2,0,39,10,29,32,12,20,30,-33,6,29,5,2,13,-21,-1,12,5,2,17,-12,7,17,0,0,9,4,9,6,3,1,4,1,4,2,1,0,5,3,5,4,2,1,97,49,48,53,24,29,30,-33,13,32,12,34,26,-21,5,17,3,15,4,-12,8,15,9,19,13,6,-1,22,8,5,10,3,0,6,1,4,3,3,-1,16,7,1,178,138,40,51,18,33,28,2,49,65,12,14,15,11,39,55,8,6,13,-9,10,10,4,8,17,6,6,14,4,4,7,2,2,4,1,2,10,4,4,10,3,2,75,16,59,62,24,38,37,-14,-1,32,13,8,2,-7,2,12,3,4,35,-7,-3,20,10,4,17,11,10,11,9,4,6,3,5,4,4,2,11,8,5,7,5,2,-48,-26,-22,69,34,35,12,-33,-50,20,-7,7,8,-13,-36,14,-4,4,4,-20,-14,6,-3,3,14,11,17,16,4,5,6,6,6,10,3,2,8,5,11,6,1,3,-61,-15,-46,37,18,19,-10,-10,-16,-10,-22,4,5,-7,-9,-4,-7,2,-15,-3,-7,-6,-15,2,0,14,12,4,8,-1,3,5,4,1,5,0,-3,9,8,3,3,-1,59,76,-17,74,40,34,17,12,20,42,-22,-10,11,18,35,20,-13,1,6,-6,-15,22,-9,-11,17,15,24,12,6,0,6,9,16,7,3,-1,11,6,8,5,3,1,68,48,20,81,50,31,35,2,31,-10,21,-7,27,-10,33,-3,7,-4,8,12,-2,-7,14,-3,27,15,23,13,4,-2,15,4,20,9,1,0,12,11,3,4,3,-2,-64,-44,-20,12,7,5,-2,-14,-29,-43,4,17,9,-6,-20,-37,5,6,-11,-8,-9,-6,-1,11,8,-1,-1,3,1,2,6,-1,1,0,-1,2,2,0,-2,3,2,0,76,18,58,-16,-16,0,14,30,-16,29,-12,23,10,15,-21,19,-11,1,4,15,5,10,-1,22,-9,8,-11,-5,-1,3,-7,5,-7,-2,-4,0,-2,3,-4,-3,3,3,100,44,56,10,-5,15,19,5,1,67,6,0,10,-2,2,29,4,2,9,7,-1,38,2,-2,4,1,-7,4,-1,7,2,-2,-6,-2,0,3,2,3,-1,6,-1,4,-53,-29,-24,3,-3,6,11,-15,-42,-9,-1,3,-3,-3,-17,-6,-3,2,14,-12,-25,-3,2,1,-2,1,-1,4,2,-1,0,-3,0,-1,0,1,-2,4,-1,5,2,-2,18,-35,53,2,-5,7,5,-3,25,-3,-13,1,-6,-4,-9,2,-13,-8,11,1,34,-5,0,9,0,5,-6,1,3,-3,-3,1,-3,2,-2,-1,3,4,-3,-1,5,-2,-6,-17,11,-10,-1,-9,-2,3,-43,27,-10,15,-9,-4,-16,12,-8,1,7,7,-27,15,-2,14,-4,-3,-3,-6,3,3,-3,1,0,-1,1,1,-1,-4,-3,-5,2,2,-3,-9,6,-21,-18,-3,21,12,-19,-11,-1,-3,29,4,-19,-20,2,-5,-8,8,0,9,-3,2,0,4,-16,-13,4,-2,3,2,-11,-13,1,-2,-3,2,-5,0,3,0,-57,-56,-1,6,-4,10,12,-30,-44,-13,3,16,-2,-12,-22,-18,0,-2,14,-18,-22,5,3,18,4,0,-5,0,5,2,4,-3,-4,0,-1,0,0,3,-1,0,6,2,63,47,16,15,8,7,46,-11,-7,30,-3,6,31,-4,3,18,-5,-1,15,-7,-10,12,2,7,15,-1,-2,-1,3,1,7,2,-4,2,1,0,8,-3,2,-3,2,1
33,33021,Cudillero,6172,-10,0,-10,4,3,1,3,-10,-24,0,15,8,4,-3,-14,4,4,6,-1,-7,-10,-4,11,2,0,1,0,1,2,0,0,0,0,1,2,0,0,1,0,0,0,0,31,11,20,5,1,4,-6,-7,12,10,12,10,-2,-5,8,4,7,-1,-4,-2,4,6,5,11,1,0,1,1,2,0,0,0,0,0,1,0,1,0,1,1,1,0,61,36,25,22,12,10,7,3,-3,28,19,5,3,-1,-1,17,12,5,4,4,-2,11,7,0,4,4,2,6,4,1,2,2,1,4,2,0,2,2,1,2,2,1,41,14,27,11,4,7,5,-5,9,12,7,15,3,-1,3,2,3,5,2,-4,6,10,4,10,1,2,2,4,1,1,0,0,2,1,0,1,1,2,0,3,1,0,48,19,29,26,11,15,4,-1,12,18,26,-12,-2,1,-1,10,15,-4,6,-2,13,8,11,-8,7,1,10,3,3,1,3,0,5,1,1,1,4,1,5,2,2,0,23,19,4,33,14,19,2,-1,-19,12,24,7,4,-5,-4,2,15,7,-2,4,-15,10,9,0,6,5,9,11,0,1,2,2,4,5,0,1,4,3,5,6,0,0,33,1,32,27,16,11,5,-6,7,12,13,1,-1,-5,-10,7,9,1,6,-1,17,5,4,0,1,7,13,3,2,1,0,2,9,3,1,1,1,5,4,0,1,0,10,33,-23,63,36,27,5,-8,9,22,10,-22,9,-3,17,10,11,-7,-4,-5,-8,12,-1,-15,9,13,23,16,0,2,4,8,13,10,1,0,5,5,10,6,-1,2,3,-4,7,35,13,22,11,-3,-9,11,10,-18,7,2,-11,-2,3,-3,4,-5,2,13,7,-15,6,15,3,10,1,0,3,8,-1,2,1,0,3,7,4,8,0,0,26,20,6,16,7,9,3,-1,14,3,9,-4,-2,1,12,3,8,-2,5,-2,2,0,1,-2,3,6,2,2,1,1,2,1,1,2,0,1,1,5,1,0,1,0,28,28,0,47,17,30,7,7,-24,14,31,-6,6,6,-10,7,14,6,1,1,-14,7,17,-12,15,12,7,7,4,1,4,7,2,2,1,1,11,5,5,5,3,0,19,3,16,26,10,16,6,19,-4,6,16,-21,4,5,-2,-7,8,-4,2,14,-2,13,8,-17,5,5,5,9,1,1,2,1,3,3,1,0,3,4,2,6,0,1,-15,3,-18,3,2,1,1,-7,-3,2,3,-13,-3,-1,2,8,-1,-3,4,-6,-5,-6,4,-10,2,0,-1,2,1,-1,1,0,0,2,0,-1,1,0,-1,0,1,0,-80,-26,-54,16,10,6,-11,-12,-14,-23,-9,-10,-1,-3,1,-12,-4,-8,-10,-9,-15,-11,-5,-2,5,2,5,3,1,0,4,1,2,2,1,0,1,1,3,1,0,0,-39,-12,-27,12,8,4,-8,-5,-31,4,10,-8,-3,-5,-18,4,10,0,-5,0,-13,0,0,-8,4,3,-5,8,2,0,4,1,-1,2,2,0,0,2,-4,6,0,0,-48,-37,-11,-7,-11,4,5,-12,-10,-6,-14,-14,-1,-7,-11,-6,-3,-9,6,-5,1,0,-11,-5,2,4,-5,-7,-3,2,0,3,-6,-6,-2,0,2,1,1,-1,-1,2,25,25,0,29,20,9,1,8,-9,13,15,0,-7,10,1,15,7,0,8,-2,-10,-2,8,0,4,4,6,11,5,-1,2,4,4,9,1,0,2,0,2,2,4,-1,-19,-22,3,17,8,9,4,-5,-2,-12,1,-5,1,-2,-10,-11,4,-3,3,-3,8,-1,-3,-2,2,3,1,6,3,2,0,1,1,2,3,1,2,2,0,4,0,1
33,33024,Gijón,267980,2226,1015,1211,1351,595,756,328,426,526,456,206,271,151,170,229,221,116,119,177,256,297,235,90,152,188,301,423,208,136,86,95,105,180,100,67,44,93,196,243,108,69,42,1585,692,893,1486,696,790,409,343,232,342,47,195,215,141,86,165,1,69,194,202,146,177,46,126,285,303,468,241,112,62,142,132,219,117,51,28,143,171,249,124,61,34,1934,873,1061,1802,923,879,522,268,248,502,128,258,266,115,122,238,49,83,256,153,126,264,79,175,348,369,431,337,179,117,193,172,246,159,87,55,155,197,185,178,92,62,2304,1076,1228,1744,809,935,462,495,401,466,192,258,233,211,238,236,64,92,229,284,163,230,128,166,301,372,484,271,197,101,141,164,242,123,88,46,160,208,242,148,109,55,1986,809,1177,1509,628,881,305,397,346,398,235,291,140,172,145,151,101,94,165,225,201,247,134,197,239,317,439,268,150,85,104,129,196,104,62,29,135,188,243,164,88,56,1682,720,962,1519,699,820,298,344,244,312,233,228,156,123,131,125,88,96,142,221,113,187,145,132,243,327,444,273,136,85,116,132,214,129,65,36,127,195,230,144,71,49,1258,412,846,1595,737,858,402,317,165,235,33,101,207,120,20,60,-3,7,195,197,145,175,36,94,306,364,461,256,138,57,159,159,231,114,46,23,147,205,230,142,92,34,1814,884,930,1410,782,628,360,579,321,235,61,237,176,312,183,113,20,73,184,267,138,122,41,164,310,502,333,187,54,2,172,278,206,91,21,4,138,224,127,96,33,-2,2530,1323,1207,1845,1003,842,492,545,683,434,163,176,244,293,390,236,58,74,248,252,293,198,105,102,318,470,490,355,140,47,164,253,276,209,70,20,154,217,214,146,70,27,1252,407,845,1129,531,598,316,310,237,214,28,144,148,143,59,62,-43,36,168,167,178,152,71,108,212,347,278,170,79,28,118,170,132,70,20,14,94,177,146,100,59,14,943,351,592,872,401,471,303,314,55,166,-5,87,131,137,14,31,13,12,172,177,41,135,-18,75,213,266,152,141,61,17,96,120,72,72,24,6,117,146,80,69,37,11,1846,818,1028,1173,582,591,368,364,440,368,153,147,174,167,172,198,65,34,194,197,268,170,88,113,240,341,263,181,94,39,127,170,150,74,31,19,113,171,113,107,63,20,971,419,552,473,197,276,181,269,89,243,22,176,102,150,-3,107,9,68,79,119,92,136,13,108,116,206,31,76,3,29,61,93,8,12,-3,21,55,113,23,64,6,8,445,131,314,-193,-138,-55,183,106,-39,23,52,103,84,26,-60,-31,47,48,99,80,21,54,5,55,-6,56,-160,-109,6,13,-3,36,-100,-88,10,3,-3,20,-60,-21,-4,10,-478,-484,6,-1144,-712,-432,199,128,-356,-396,-115,39,94,33,-211,-326,-112,22,105,95,-145,-70,-3,17,48,81,-397,-545,-233,-110,25,32,-207,-361,-166,-42,23,49,-190,-184,-67,-68,987,448,539,209,69,140,287,292,67,101,79,135,174,162,23,22,0,45,113,130,44,79,79,90,95,203,-23,-92,-1,13,68,99,-31,-68,-10,1,27,104,8,-24,9,12,898,321,577,311,100,211,178,184,150,182,114,70,98,89,19,70,39,-1,80,95,131,112,75,71,68,163,-21,11,47,25,48,76,-35,-16,12,9,20,87,14,27,35,16,710,286,424,225,71,154,270,136,-26,47,150,118,145,81,-30,-33,87,36,125,55,4,80,63,82,161,143,-75,-67,16,22,87,70,-50,-60,1,14,74,73,-25,-7,15,8
33,33025,Gozón,11337,-34,-9,-25,18,7,11,-6,-6,-17,5,-8,-2,-5,-8,6,-2,0,1,-1,2,-23,7,-8,-3,4,3,7,2,2,0,2,0,2,2,1,0,2,3,5,0,1,0,-54,-42,-12,21,6,15,-8,-20,-25,-2,6,-8,-11,-9,-25,1,5,-4,3,-11,0,-3,1,-4,5,3,8,1,3,0,1,1,2,1,1,0,4,2,6,0,2,0,-1,5,-6,19,15,4,8,-23,-12,12,-2,17,8,-12,-4,10,-1,5,0,-11,-8,2,-1,12,8,1,2,4,1,2,6,2,1,4,0,1,2,-1,1,0,1,1,40,10,30,30,14,16,7,5,-15,-1,30,9,-1,-1,-13,4,15,5,8,6,-2,-5,15,4,3,9,8,4,3,1,0,5,3,2,3,1,3,4,5,2,0,0,-45,-9,-36,23,9,14,-23,-29,-15,19,4,-1,-8,-14,-2,20,3,-8,-15,-15,-13,-1,1,7,4,4,9,4,2,0,2,1,4,1,1,0,2,3,5,3,1,0,70,40,30,31,12,19,39,-4,20,-4,12,5,29,1,4,-9,13,-1,10,-5,16,5,-1,6,11,6,7,3,4,0,6,2,2,1,1,0,5,4,5,2,3,0,63,37,26,30,18,12,-3,5,15,27,16,8,-11,9,9,17,8,8,8,-4,6,10,8,0,6,4,6,13,1,0,2,4,5,7,0,0,4,0,1,6,1,0,85,65,20,52,29,23,8,8,18,33,20,0,3,1,17,27,9,8,5,7,1,6,11,-8,6,14,12,14,4,2,2,3,9,10,3,2,4,11,3,4,1,0,89,33,56,51,21,30,16,-10,10,38,32,8,10,-4,-1,15,18,-4,6,-6,11,23,14,12,13,4,7,12,10,6,8,2,2,6,1,2,5,2,5,6,9,4,108,63,45,2,2,0,10,8,28,47,17,-1,8,3,23,25,9,-2,2,5,5,22,8,1,-1,5,-3,0,0,1,0,4,-2,1,-1,0,-1,1,-1,-1,1,1,104,56,48,34,18,16,24,18,22,29,10,1,9,11,6,17,10,1,15,7,16,12,0,0,11,6,5,3,6,3,6,4,1,3,3,1,5,2,4,0,3,2,0,1,-1,20,5,15,-11,2,3,-16,9,16,-8,-1,8,0,4,-1,-3,3,-5,-16,5,17,3,1,5,5,5,1,1,0,1,2,1,0,2,1,4,3,4,1,83,34,49,-2,-7,5,17,-7,-4,41,14,19,5,-5,-3,17,11,7,12,-2,-1,24,3,12,1,-3,-3,2,0,0,-2,-2,-2,1,-2,-1,3,-1,-1,1,2,1,-12,-23,11,-56,-31,-25,8,-3,-23,-4,-2,8,5,-1,-17,-11,-4,5,3,-2,-6,7,2,3,-6,-3,-14,-23,-6,-4,-1,1,-8,-17,-5,-1,-5,-4,-6,-6,-1,-3,-22,-7,-15,0,-4,4,-8,-10,-21,17,2,-5,-5,-6,-11,17,6,-10,-3,-4,-10,0,-4,5,4,-3,-9,6,2,0,2,-3,-7,2,2,0,2,0,-2,4,0,0,25,-1,26,2,2,0,10,8,28,-5,-12,1,4,1,13,-11,-8,2,6,7,15,6,-4,-1,-4,7,-1,-1,-1,1,-2,3,-1,-2,1,2,-2,4,0,1,-2,-1,1,6,-5,2,3,-1,-15,-3,-1,-7,17,8,-3,-4,3,-7,12,6,-12,1,-4,0,5,2,3,0,5,-6,2,-2,3,1,4,-4,0,-1,0,-1,1,-2,2,-1,78,52,26,5,4,1,12,7,11,34,18,-7,10,2,12,14,13,1,2,5,-1,20,5,-8,-2,4,-5,5,1,0,-2,1,-1,4,-1,1,0,3,-4,1,2,-1
33,33026,Grado,11805,-12,-15,3,9,4,5,4,-7,-8,-4,9,-7,-6,-3,0,-9,2,2,10,-4,-8,5,7,-9,1,0,2,1,2,3,0,0,1,1,0,2,1,0,1,0,2,1,17,9,8,21,10,11,3,10,7,-8,-3,5,4,10,-5,-3,1,0,-1,0,12,-5,-4,5,6,3,3,3,1,3,4,2,0,1,0,2,2,1,3,2,1,1,-31,-10,-21,23,12,11,-11,-8,-22,-6,-9,24,-9,-2,-9,1,-3,13,-2,-6,-13,-7,-6,11,4,7,7,3,2,0,0,5,2,4,1,0,4,2,5,-1,1,0,-56,-29,-27,15,8,7,-2,-1,-42,-6,7,-14,-4,-1,-17,-7,4,-4,2,0,-25,1,3,-10,4,2,3,3,2,1,2,1,2,2,1,0,2,1,1,1,1,1,-15,-4,-11,63,36,27,8,-4,-22,-7,4,4,3,-5,-7,0,5,-1,5,1,-15,-7,-1,5,11,9,23,11,5,2,6,5,12,7,3,1,5,4,11,4,2,1,-47,-11,-36,63,29,34,-32,8,-31,2,3,1,-14,5,-9,-1,2,4,-18,3,-22,3,1,-3,6,25,13,12,3,4,3,12,7,3,1,3,3,13,6,9,2,1,38,6,32,64,26,38,22,17,6,9,2,-14,19,0,5,-4,-2,-9,3,17,1,13,4,-5,5,19,18,14,6,2,4,7,9,5,1,0,1,12,9,9,5,2,176,102,74,153,82,71,51,40,29,40,13,1,26,27,24,24,5,-4,25,13,5,16,8,5,32,39,39,31,6,3,15,18,27,16,1,3,17,21,12,15,5,0,102,53,49,77,40,37,29,25,14,16,10,4,15,10,4,16,2,4,14,15,10,0,8,0,9,26,21,15,4,2,4,14,7,12,2,1,5,12,14,3,2,1,61,13,48,11,-10,21,0,28,-28,13,2,44,-2,11,-23,6,4,15,2,17,-5,7,-2,29,8,4,-2,1,-2,2,1,-4,-6,-2,0,1,7,8,4,3,-2,1,-10,-5,-5,-1,-10,9,8,-18,3,-11,16,-8,4,-9,2,-6,10,-6,4,-9,1,-5,6,-2,3,6,1,-5,-6,0,4,1,-2,-8,-5,0,-1,5,3,3,-1,0,-53,-22,-31,33,19,14,-20,-2,-35,-2,0,5,-10,-4,-16,-2,2,8,-10,2,-19,0,-2,-3,-1,8,5,10,7,3,-1,4,6,3,5,2,0,4,-1,7,2,1,-46,-26,-20,-16,-13,-3,10,3,-41,-1,-9,-2,9,-3,-19,-8,-1,-3,1,6,-22,7,-8,1,2,2,-12,-2,-6,0,2,1,-10,-3,-3,0,0,1,-2,1,-3,0,-18,-10,-8,-7,3,-10,3,-1,4,-15,-5,-5,-1,3,5,-9,-2,-8,4,-4,-1,-6,-3,3,-2,3,-5,-3,-1,0,2,2,-2,0,0,0,-4,1,-3,-3,-1,0,-60,-53,-7,-16,-16,0,1,5,-19,-31,-11,-4,-7,8,-20,-27,-10,5,8,-3,1,-4,-1,-9,-1,3,-2,-9,-6,-1,-2,2,-2,-9,-4,-1,1,1,0,0,-2,0,-44,-19,-25,20,7,13,-10,11,-31,-14,-1,3,-5,2,-12,-9,2,4,-5,9,-19,-5,-3,-1,4,12,-2,-1,6,1,3,3,0,-3,3,1,1,9,-2,2,3,0,-19,11,-30,-11,-8,-3,3,-14,-20,5,5,1,3,-10,-5,13,7,2,0,-4,-15,-8,-2,-1,2,-2,-7,-3,0,-1,0,-2,-2,-1,-2,-1,2,0,-5,-2,2,0,0,9,-9,26,18,8,12,4,-10,-2,3,-9,11,4,-5,3,2,-6,1,0,-5,-5,1,-3,8,5,3,3,6,1,6,-1,5,4,3,1,2,6,-2,-1,3,0
33,33031,Langreo,49771,-393,-200,-193,10,6,4,-6,-80,-89,-101,-50,-68,-6,-45,-48,-48,-34,-23,0,-35,-41,-53,-16,-45,0,1,2,2,2,2,0,1,1,1,1,1,0,0,1,1,1,1,-462,-214,-248,3,2,1,-35,-73,-128,-112,-59,-60,-20,-20,-59,-62,-34,-22,-15,-53,-69,-50,-25,-38,0,0,0,1,1,0,0,0,0,0,1,0,0,0,0,1,0,0,-335,-166,-169,2,6,-4,-44,-17,-118,-71,-43,-40,-29,-8,-62,-35,-19,-11,-15,-9,-56,-36,-24,-29,1,-3,-4,0,3,5,1,1,-2,1,1,4,0,-4,-2,-1,2,1,-415,-216,-199,7,5,2,-23,-58,-107,-73,-69,-73,-18,-28,-71,-33,-37,-24,-5,-30,-36,-40,-32,-49,0,4,1,-1,0,3,0,3,1,0,-1,2,0,1,0,-1,1,1,-249,-143,-106,86,42,44,9,-29,-113,-38,-43,-34,-2,-14,-80,-4,-24,-17,11,-15,-33,-34,-19,-17,17,33,18,13,2,3,7,19,9,5,1,1,10,14,9,8,1,2,-238,-106,-132,96,44,52,-8,-16,-96,-50,-21,-50,-7,-6,-58,-23,-1,-13,-1,-10,-38,-27,-20,-37,17,40,17,15,5,0,8,18,5,8,3,0,9,22,12,7,2,0,18,-1,19,110,49,61,48,1,4,15,-16,-37,10,2,-4,18,-13,-16,38,-1,8,-3,-3,-21,22,27,32,19,7,2,8,15,14,11,1,0,14,12,18,8,6,2,162,78,84,112,53,59,72,31,13,32,3,11,42,14,-3,24,-3,5,30,17,16,8,6,6,26,26,21,22,11,1,16,16,9,6,6,-1,10,10,12,16,5,2,166,141,25,238,158,80,72,25,16,84,5,-33,35,27,20,69,-2,-4,37,-2,-4,15,7,-29,34,48,60,80,16,-1,13,32,39,65,8,0,21,16,21,15,8,-1,166,120,46,93,49,44,41,48,81,42,1,-47,14,27,48,25,9,-5,27,21,33,17,-8,-42,20,21,15,20,11,3,8,10,5,18,6,1,12,11,10,2,5,2,63,14,49,78,36,42,13,46,6,31,5,-39,0,28,8,-2,-9,-12,13,18,-2,33,14,-27,15,16,21,21,5,-1,6,4,12,12,2,0,9,12,9,9,3,-1,-82,-73,-9,12,-6,18,20,16,-70,-52,18,-8,4,8,-62,-32,12,4,16,8,-8,-20,6,-12,5,13,4,-13,4,-3,3,6,0,-12,-2,-2,2,7,4,-1,6,-1,-203,-121,-82,-22,-17,-5,-38,-31,-100,-17,9,-28,-22,-9,-62,-12,-7,-6,-16,-22,-38,-5,16,-22,4,-3,-16,-7,-1,1,5,1,-12,-10,-3,1,-1,-4,-4,3,2,0,-217,-122,-95,-66,-54,-12,7,-38,-71,-31,-55,-39,-2,-27,-36,-26,-20,-12,9,-11,-35,-5,-35,-27,-8,-7,-19,-22,-11,-2,-7,-7,-17,-15,-8,-1,-1,0,-2,-7,-3,-1,-377,-198,-179,-123,-86,-37,-35,-16,-123,-82,-64,-52,-29,0,-79,-26,-40,-28,-6,-16,-44,-56,-24,-24,-11,-4,-30,-37,-38,-3,-4,-2,-24,-26,-28,-2,-7,-2,-6,-11,-10,-1,-146,-32,-114,-54,-36,-18,9,-10,-95,-19,-1,-30,16,2,-50,0,2,-2,-7,-12,-45,-19,-3,-28,-7,8,-32,-10,-9,-4,-5,5,-20,-9,-6,-1,-2,3,-12,-1,-3,-3,-189,-85,-104,9,4,5,-1,-20,-66,-82,5,-25,7,-5,-35,-52,9,-8,-8,-15,-31,-30,-4,-17,6,8,-6,-13,6,8,4,7,-7,-6,2,4,2,1,1,-7,4,4,-151,-58,-93,10,0,10,7,22,-99,-22,-36,-21,12,22,-49,-21,-18,0,-5,0,-50,-1,-18,-21,14,23,-19,-9,0,1,3,11,-8,-8,1,1,11,12,-11,-1,-1,0
33,33032,Laviana,14893,-69,-12,-57,12,7,5,-15,-16,-29,-7,-5,3,-3,1,-14,-6,-1,10,-12,-17,-15,-1,-4,-7,1,0,0,3,4,4,1,0,0,1,3,2,0,0,0,2,1,2,-40,-27,-13,19,9,10,-6,-17,-36,-13,12,18,-5,-6,-15,-12,9,2,-1,-11,-21,-1,3,16,2,3,2,5,7,0,2,0,1,2,4,0,0,3,1,3,3,0,-50,-41,-9,25,10,15,-6,-11,-11,-14,-9,-3,-5,-8,-7,-11,-11,0,-1,-3,-4,-3,2,-3,3,5,3,8,3,3,2,1,2,3,1,1,1,4,1,5,2,2,50,1,49,32,17,15,22,20,13,-22,3,10,6,2,1,-13,-2,5,16,18,12,-9,5,5,6,6,8,4,3,5,3,3,4,2,2,3,3,3,4,2,1,2,55,26,29,73,46,27,5,-10,29,14,11,5,2,-7,8,18,-1,4,3,-3,21,-4,12,1,7,5,15,29,9,8,2,2,12,23,1,6,5,3,3,6,8,2,1,2,-1,57,27,30,15,10,-2,-18,-11,13,11,2,5,-12,-4,5,4,8,-7,-6,-7,8,19,16,6,15,2,-2,12,8,0,5,2,-1,7,8,6,10,0,-1,19,7,12,36,17,19,24,4,-1,-7,-5,7,13,1,2,1,-8,1,11,3,-3,-8,3,6,3,12,8,7,2,4,2,6,6,4,-1,0,1,6,2,3,3,4,-4,8,-12,60,30,30,19,3,-19,-9,5,-2,14,8,-9,-13,4,4,5,-5,-10,4,1,-6,13,17,14,9,5,2,7,11,6,1,3,2,6,6,8,8,2,0,7,4,3,38,19,19,-16,-3,-8,-6,18,19,-10,5,-3,-2,1,11,-6,-8,-5,-4,17,8,5,5,11,9,5,3,3,2,6,4,1,3,2,3,5,5,4,0,17,-3,20,24,4,20,14,24,7,-24,-11,4,1,11,1,-13,-7,3,13,13,6,-11,-4,1,3,4,4,2,7,4,-1,2,0,-1,2,2,4,2,4,3,5,2,2,-2,4,-2,-3,1,8,1,-18,-3,11,0,7,-2,-4,-3,-1,1,1,3,-14,0,12,-1,3,-3,1,-1,-3,1,0,0,1,0,-4,0,3,-3,0,-1,1,1,66,12,54,4,-6,10,14,-7,6,15,-2,37,12,-7,-3,3,-3,8,2,0,9,12,1,29,-2,1,-6,4,2,4,0,-2,-3,-2,-2,3,-2,3,-3,6,4,1,-63,-41,-22,-1,-7,6,-11,-26,-30,-11,2,12,-5,-14,-18,-11,5,1,-6,-12,-12,0,-3,11,6,-1,-11,6,-2,1,2,-1,-9,1,-1,1,4,0,-2,5,-1,0,10,-18,28,-26,-16,-10,17,2,-14,-7,3,8,7,-5,-15,-8,3,1,10,7,1,1,0,7,-2,-3,-10,-10,-1,-1,-1,-4,-4,-5,-1,-1,-1,1,-6,-5,0,0,-103,-51,-52,-11,-6,-5,4,-25,-27,-38,-15,-2,4,-7,-16,-23,-11,1,0,-18,-11,-15,-4,-3,-1,-5,-4,1,0,-2,2,-2,-5,-1,0,0,-3,-3,1,2,0,-2,-72,-28,-44,-4,-2,-2,-11,-35,-32,-16,15,10,0,-17,-21,-3,11,2,-11,-18,-11,-13,4,8,-2,0,-5,1,0,2,-1,-1,-1,0,1,0,-1,1,-4,1,-1,2,-27,-40,13,0,-5,5,2,-2,-25,-16,1,7,0,-2,-25,-21,4,2,2,0,0,5,-3,5,1,-2,-11,3,6,2,1,-2,-7,-2,3,1,0,0,-4,5,3,1,-21,-26,5,21,7,14,-11,-1,5,-18,-3,6,-7,-8,-3,-9,1,1,-4,7,8,-9,-4,5,2,9,11,-3,-1,2,0,4,5,0,-1,-1,2,5,6,-3,0,3
33,33033,Lena,14030,-62,-34,-28,33,12,21,-5,-24,-15,-24,7,0,0,-14,-14,-11,3,0,-5,-10,-1,-13,4,0,11,7,9,2,2,2,5,2,2,1,1,1,6,5,7,1,1,1,-37,-26,-11,29,10,19,2,-8,-15,-14,-3,3,-1,-11,-7,-5,-4,3,3,3,-8,-9,1,0,5,9,9,5,0,0,2,4,3,1,0,0,3,5,6,4,0,0,-96,-42,-54,65,33,32,-5,-24,-30,-19,-3,-16,-3,-6,-15,-9,-2,-8,-2,-18,-15,-10,-1,-8,17,13,10,17,5,3,6,7,5,11,4,0,11,6,5,6,1,3,-114,-50,-64,50,23,27,19,-36,-41,-35,-9,-14,12,-18,-21,-13,-4,-8,7,-18,-20,-22,-5,-6,13,10,20,5,0,1,8,4,6,5,0,0,5,6,14,0,0,1,-56,-33,-23,69,38,31,3,-7,-37,-4,-10,2,3,-10,-19,3,-7,0,0,3,-18,-7,-3,2,12,10,17,20,8,2,6,3,8,13,7,1,6,7,9,7,1,1,-44,-17,-27,110,57,53,11,10,-34,-11,-20,-3,11,10,-19,-4,-16,0,0,0,-15,-7,-4,-3,29,24,17,25,11,2,16,15,7,11,6,1,13,9,10,14,5,1,-9,-10,1,92,34,58,4,12,-41,-10,13,13,5,6,-18,-12,12,-1,-1,6,-23,2,1,14,21,19,23,19,7,2,10,8,10,5,1,0,11,11,13,14,6,2,18,25,-7,93,41,52,26,1,-15,5,1,2,22,3,-4,0,4,1,4,-2,-11,5,-3,1,25,21,16,18,8,5,12,13,6,3,3,4,13,8,10,15,5,1,-86,-47,-39,50,15,35,8,-8,-29,-2,-24,-33,3,-2,-18,5,-19,-16,5,-6,-11,-7,-5,-17,9,5,18,15,0,1,1,1,12,2,-2,1,8,4,6,13,2,0,9,16,-7,39,22,17,8,25,-18,2,4,-8,2,10,-2,5,5,-2,6,15,-16,-3,-1,-6,4,13,8,10,4,0,6,5,4,6,2,-1,-2,8,4,4,2,1,-92,-62,-30,24,7,17,-8,-11,-36,-16,-3,-11,-9,-12,-14,-19,0,-5,1,1,-22,3,-3,-6,7,4,6,6,1,0,6,0,2,0,0,-1,1,4,4,6,1,1,-54,-44,-10,37,21,16,-22,-14,-20,1,4,-1,-5,-16,-29,1,5,3,-17,2,9,0,-1,-4,5,8,9,9,3,1,5,4,3,6,2,0,0,4,6,3,1,1,-50,-20,-30,25,13,12,9,-4,-27,0,-16,-7,8,4,-24,1,-4,-3,1,-8,-3,-1,-12,-4,6,8,11,0,0,0,5,4,4,0,0,0,1,4,7,0,0,0,-60,-32,-28,1,-5,6,2,-12,-34,-6,-2,-7,0,-8,-16,-9,2,-2,2,-4,-18,3,-4,-5,2,5,-5,2,0,-3,0,2,-5,1,-1,-2,2,3,0,1,1,-1,-154,-74,-80,-42,-21,-21,0,-17,-57,-56,-30,5,6,-3,-28,-32,-16,-2,-6,-14,-29,-24,-14,7,6,-7,-13,-20,-9,1,3,-4,-3,-14,-3,0,3,-3,-10,-6,-6,1,-39,-51,12,1,-5,6,4,-3,-34,-20,14,-6,-4,-3,-23,-22,10,-10,8,0,-11,2,4,4,-1,4,-6,-2,4,0,-3,2,-5,-2,2,0,2,2,-1,0,2,0,-25,-4,-21,9,10,-1,7,12,-37,10,-22,4,11,4,-12,6,-12,1,-4,8,-25,4,-10,3,1,8,-5,6,-1,0,2,5,-3,4,1,1,-1,3,-2,2,-2,-1,-72,-23,-49,18,11,7,11,-7,-31,-23,-5,-20,9,-1,-22,-3,-2,-5,2,-6,-9,-20,-3,-15,2,9,4,1,2,0,1,6,3,-1,2,0,1,3,1,2,0,0
33,33035,Llanera,11798,231,118,113,38,14,24,48,32,64,52,19,16,23,16,32,30,12,9,25,16,32,22,7,7,8,5,12,8,3,2,2,2,5,3,1,1,6,3,7,5,2,1,188,92,96,20,9,11,27,27,83,22,21,-2,18,6,39,9,14,0,9,21,44,13,7,-2,3,6,9,1,1,0,1,3,3,1,1,0,2,3,6,0,0,0,69,32,37,36,18,18,-7,20,38,3,4,9,-12,11,18,7,2,4,5,9,20,-4,2,5,11,9,8,2,3,2,6,3,5,2,1,1,5,6,3,0,2,1,277,159,118,34,20,14,56,29,107,57,10,11,33,27,48,32,11,4,23,2,59,25,-1,7,13,6,8,5,0,2,9,6,2,2,0,1,4,0,6,3,0,1,205,96,109,69,37,32,21,10,83,50,21,16,11,7,53,7,12,2,10,3,30,43,9,14,21,14,16,15,1,2,11,6,8,11,0,1,10,8,8,4,1,1,-39,-2,-37,49,26,23,-3,-13,-15,-1,-7,-4,5,-5,-5,14,-9,-4,-8,-8,-10,-15,2,0,8,11,10,13,5,2,2,8,6,5,4,1,6,3,4,8,1,1,153,47,106,75,28,47,48,16,53,23,0,10,10,11,31,1,-4,0,38,5,22,22,4,10,21,18,20,8,6,2,10,7,7,2,2,0,11,11,13,6,4,2,115,47,68,66,18,48,28,-12,73,33,0,-7,17,-6,25,9,1,-3,11,-6,48,24,-1,-4,10,14,26,8,6,0,4,2,6,4,0,0,6,12,20,4,6,0,254,148,106,40,22,18,49,42,81,52,31,0,29,29,50,21,20,1,20,13,31,31,11,-1,9,14,10,8,-1,0,7,8,6,1,0,0,2,6,4,7,-1,0,130,59,71,34,11,23,40,-6,49,23,2,13,19,-9,21,18,0,5,21,3,28,5,2,8,7,10,10,4,1,2,3,3,4,1,1,-1,4,7,6,3,0,3,141,73,68,32,18,14,42,5,-1,81,15,-7,27,-3,4,40,7,-7,15,8,-5,41,8,0,6,5,2,13,4,-1,5,1,1,6,3,1,1,4,1,7,1,-2,148,71,77,34,18,16,62,-14,28,40,11,12,31,-4,13,14,12,3,31,-10,15,26,-1,9,13,3,8,0,6,4,7,5,2,0,3,1,6,-2,6,0,3,3,1,3,-2,25,11,14,22,0,14,-25,-2,-9,9,-2,3,0,-3,-2,13,2,11,-25,1,-7,10,0,11,2,1,0,6,1,4,-2,1,1,4,-1,7,4,0,-1,-59,-16,-43,-36,-18,-18,-12,-16,-49,14,1,5,1,-6,-40,13,11,4,-13,-10,-9,1,-10,1,-6,-7,-9,-7,-4,-3,-2,-3,-6,-4,-2,-1,-4,-4,-3,-3,-2,-2,-96,-63,-33,-44,-23,-21,3,-25,-12,-52,-11,3,-3,-21,-7,-34,2,2,6,-4,-5,-18,-13,1,-7,-12,-15,-10,0,0,0,-10,-7,-7,1,0,-7,-2,-8,-3,-1,0,-9,-13,4,-37,-25,-12,10,12,-19,7,-14,-9,6,8,-20,-1,-4,-6,4,4,1,8,-10,-3,0,-6,-12,-10,-4,-5,-1,-4,-7,-8,-3,-2,1,-2,-5,-2,-1,-3,6,17,-11,26,15,11,25,-24,-6,14,-11,8,18,-13,-6,18,1,-1,7,-11,0,-4,-12,9,3,5,5,9,3,1,-1,1,5,8,2,0,4,4,0,1,1,1,-69,-50,-19,26,14,12,-1,-31,2,-18,-33,13,7,-14,-13,-3,-27,-2,-8,-17,15,-15,-6,15,12,4,7,-3,2,3,7,2,3,-1,0,2,5,2,4,-2,2,1
33,33036,Llanes,13212,86,53,33,106,46,60,-4,-6,22,17,35,19,7,-2,13,4,20,10,-11,-4,9,13,15,9,10,22,28,17,21,8,7,9,7,6,12,5,3,13,21,11,9,3,33,19,14,72,33,39,4,-6,-4,2,28,8,2,-15,-1,6,19,8,2,9,-3,-4,9,0,14,21,9,13,10,4,8,7,5,4,7,2,6,14,4,9,3,2,77,47,30,133,56,77,17,-4,7,22,24,10,18,3,-8,14,11,10,-1,-7,15,8,13,0,21,20,32,22,20,18,11,9,6,7,10,13,10,11,26,15,10,5,125,46,79,143,59,84,22,19,6,33,20,24,1,16,-3,13,13,5,21,3,9,20,7,19,23,27,34,20,21,18,7,11,9,10,14,8,16,16,25,10,7,10,222,120,102,149,70,79,33,4,60,35,69,19,17,-4,36,18,39,13,16,8,24,17,30,6,25,26,40,21,23,12,14,9,18,11,9,8,11,17,22,10,14,4,237,135,102,141,68,73,27,10,47,71,45,38,13,7,27,42,25,22,14,3,20,29,20,16,26,24,37,20,16,17,14,12,18,7,10,7,12,12,19,13,6,10,235,109,126,147,81,66,42,24,46,43,63,17,10,13,7,33,33,15,32,11,39,10,30,2,20,30,34,33,21,9,9,18,16,24,11,3,11,12,18,9,10,6,299,163,136,228,109,119,68,41,44,100,44,3,29,27,34,49,24,-1,39,14,10,51,20,4,39,54,56,53,24,1,13,26,30,27,11,1,26,28,26,26,13,0,114,73,41,116,66,50,7,16,38,20,21,11,0,4,26,20,9,11,7,12,12,0,12,0,20,26,34,21,12,3,7,11,22,15,7,4,13,15,12,6,5,-1,2,-1,3,83,35,48,15,-7,23,-1,-2,-22,13,-4,13,-11,-2,-8,2,-3,10,10,0,-14,13,25,22,13,6,4,9,7,10,4,4,1,4,18,12,9,2,3,185,97,88,114,50,64,23,52,41,23,29,15,16,31,21,8,18,2,7,21,20,15,11,13,22,28,22,16,13,13,11,15,12,4,4,4,11,13,10,12,9,9,49,46,3,82,37,45,8,-13,-8,28,12,23,12,1,-7,11,11,19,-4,-14,-1,17,1,4,14,11,17,20,10,9,6,6,6,8,4,7,8,5,11,12,6,2,-3,11,-14,54,22,32,2,-4,5,1,6,-14,0,-3,5,7,4,-1,2,-1,0,-6,2,-13,13,8,3,12,10,6,8,1,0,5,4,3,5,7,3,7,6,3,53,32,21,28,5,23,12,-18,18,17,21,3,2,-4,10,12,11,1,10,-14,8,5,10,2,9,1,2,7,1,9,3,1,-3,3,0,2,6,0,5,4,1,7,-96,-58,-38,14,3,11,-4,-30,-32,-15,4,-22,-3,-16,-24,-12,4,-9,-1,-14,-8,-3,0,-13,7,-1,-2,-3,12,0,3,-2,-6,3,5,0,4,1,4,-6,7,0,-30,-32,2,-23,-17,-6,3,-3,-17,-22,3,8,-1,1,-27,-10,4,3,4,-4,10,-12,-1,5,10,3,-14,-20,-3,1,5,0,-13,-15,0,6,5,3,-1,-5,-3,-5,78,27,51,74,35,39,20,12,-10,-11,32,31,12,-4,-9,-8,20,16,8,16,-1,-3,12,15,21,17,1,10,16,7,12,6,1,3,8,4,9,11,0,7,8,3,25,23,2,70,38,32,23,6,-15,22,2,-18,11,14,-7,15,-8,-4,12,-8,-8,7,10,-14,17,19,5,14,9,6,5,14,5,10,-1,5,12,5,0,4,10,1
33,33037,Mieres,50578,-413,-210,-203,131,64,67,-8,-56,-150,-65,-54,-76,2,-39,-78,-25,-33,-32,-10,-17,-72,-40,-21,-44,22,33,32,35,7,2,13,14,13,19,4,1,9,19,19,16,3,1,-278,-139,-139,146,79,67,-19,-39,-120,-58,-10,-36,-17,-15,-53,-37,-6,-14,-2,-24,-67,-21,-4,-22,29,30,36,40,6,3,13,18,18,26,2,1,16,12,18,14,4,2,-528,-241,-287,86,53,33,-23,-90,-159,-107,-77,-64,-12,-34,-74,-48,-39,-30,-11,-56,-85,-59,-38,-34,14,14,19,32,4,2,8,6,11,22,4,1,6,8,8,10,0,1,-588,-339,-249,72,20,52,-45,-69,-198,-128,-61,-78,-34,-44,-108,-74,-36,-35,-11,-25,-90,-54,-25,-43,12,22,22,11,4,0,2,8,6,2,2,0,10,14,16,9,2,0,-431,-241,-190,137,75,62,-27,-45,-107,-132,-67,-50,-7,-32,-56,-88,-42,-13,-20,-13,-51,-44,-25,-37,19,28,37,34,8,10,8,19,20,21,3,4,11,9,17,13,5,6,-271,-114,-157,147,66,81,-2,-22,-99,-59,-47,-38,0,-12,-43,-28,-18,-15,-2,-10,-56,-31,-29,-23,26,21,43,41,8,8,10,6,18,28,1,3,16,15,25,13,7,5,-300,-115,-185,132,86,46,-4,-28,-121,-55,-34,-55,2,-12,-56,-27,-11,-11,-6,-16,-65,-28,-23,-44,25,26,31,40,8,0,13,17,18,30,7,0,12,9,13,10,1,0,-220,-89,-131,131,77,54,25,-22,-155,1,-12,-51,9,-8,-68,-1,-3,-15,16,-14,-87,2,-9,-36,23,26,16,56,11,-1,14,16,14,30,5,-1,9,10,2,26,6,0,-52,-43,-9,161,85,76,47,52,-113,-10,-28,-2,20,19,-67,-12,-8,2,27,33,-46,2,-20,-4,32,40,38,41,8,0,13,17,18,33,2,0,19,23,20,8,6,0,-35,-27,-8,104,46,58,41,-10,-70,11,13,-15,-2,-2,-28,0,-2,7,43,-8,-42,11,15,-22,25,18,16,29,14,2,5,9,9,13,6,4,20,9,7,16,8,-2,-357,-218,-139,-28,-35,7,10,8,-171,-93,-68,-38,5,-1,-100,-79,-38,-7,5,9,-71,-14,-30,-31,10,7,-10,-21,-16,-2,2,2,-6,-18,-19,1,8,5,-4,-3,3,-3,-168,-86,-82,11,-9,20,5,-21,-49,-28,-36,-32,3,-11,-14,-31,-23,-7,2,-10,-35,3,-13,-25,5,8,-10,14,-8,2,4,2,-8,-2,-5,0,1,6,-2,16,-3,2,-282,-145,-137,-50,-52,2,-5,-18,-112,-64,-21,-62,-12,-16,-53,-35,-13,-19,7,-2,-59,-29,-8,-43,-5,0,-16,-25,-5,-1,-7,-4,-12,-27,-3,0,2,4,-4,2,-2,-1,-291,-122,-169,2,-3,5,-11,-34,-118,-51,-17,-54,-11,0,-70,-15,-9,-15,0,-34,-48,-36,-8,-39,8,-2,-14,5,-1,3,5,-2,-9,-2,0,3,3,0,-5,7,-1,0,-261,-128,-133,-15,-18,3,-30,-6,-112,-55,-20,-35,-17,0,-60,-18,-22,-12,-13,-6,-52,-37,2,-23,2,15,-7,-18,-8,1,-4,9,-2,-12,-9,0,6,6,-5,-6,1,1,-373,-161,-212,-46,-12,-34,-23,-58,-146,-26,-46,-66,5,-37,-66,-27,-30,-2,-28,-21,-80,1,-16,-64,1,-4,-11,-7,-20,-5,6,-1,-3,-4,-9,-1,-5,-3,-8,-3,-11,-4,-164,-87,-77,-1,-14,13,13,1,-75,-40,-10,-54,1,-8,-28,-32,-6,-14,12,9,-47,-8,-4,-40,0,11,-1,-9,2,-4,0,4,-2,-7,-4,-5,0,7,1,-2,6,1,-135,-80,-55,20,-1,21,29,-2,-80,-15,-26,-39,6,-3,-58,-4,-10,-10,23,1,-22,-11,-16,-29,13,7,-1,3,-5,1,4,-3,-2,4,-4,0,9,10,1,-1,-1,1
33,33040,Nava,5684,-26,-19,-7,20,5,15,-2,-9,-8,6,-3,-9,-2,-1,-10,-2,-2,-2,0,-8,2,8,-1,-7,4,1,9,6,0,0,0,1,3,1,0,0,4,0,6,5,0,0,14,5,9,20,12,8,-2,2,-12,10,4,11,0,-4,-4,7,0,5,-2,6,-8,3,4,6,2,3,9,1,1,4,2,1,4,0,1,4,0,2,5,1,0,0,17,-1,18,20,8,12,15,3,4,-5,4,-5,3,-5,3,-1,1,-2,12,8,1,-4,3,-3,3,5,8,1,2,1,0,3,4,0,1,0,3,2,4,1,1,1,27,5,22,25,11,14,1,-7,22,12,-2,2,2,-11,12,2,-2,1,-1,4,10,10,0,1,2,3,10,4,4,2,1,0,6,1,2,1,1,3,4,3,2,1,12,3,9,15,7,8,5,8,0,8,-4,-5,-3,4,3,4,-4,-1,8,4,-3,4,0,-4,0,2,9,2,1,1,0,0,5,1,0,1,0,2,4,1,1,0,49,32,17,30,13,17,17,-15,22,3,17,7,9,1,8,4,8,4,8,-16,14,-1,9,3,5,8,7,0,6,4,2,5,2,0,2,2,3,3,5,0,4,2,65,24,41,47,21,26,14,17,27,1,-1,6,5,8,5,2,1,3,9,9,22,-1,-2,3,9,10,13,10,3,2,3,4,5,6,2,1,6,6,8,4,1,1,70,37,33,31,13,18,7,12,-3,30,17,5,5,3,2,13,10,4,2,9,-5,17,7,1,1,8,9,7,5,0,1,4,5,1,2,0,0,4,4,6,3,0,89,46,43,34,17,17,15,7,14,21,19,11,10,2,5,15,10,2,5,5,9,6,9,9,2,10,11,3,5,1,0,5,5,2,3,1,2,5,6,1,2,0,62,33,29,10,1,9,13,-6,24,9,15,4,6,-3,16,4,9,0,7,-3,8,5,6,4,3,4,0,1,0,2,1,1,-1,0,0,0,2,3,1,1,0,2,18,3,15,10,1,9,9,-9,-6,16,8,-1,4,-6,-9,12,5,-3,5,-3,3,4,3,2,7,-1,1,-1,3,1,1,-1,-1,-1,2,1,6,0,2,0,1,0,40,28,12,5,5,0,8,2,13,8,-8,14,4,2,7,5,-1,9,4,0,6,3,-7,5,1,1,2,1,-1,1,0,2,1,0,1,1,1,-1,1,1,-2,0,-25,-28,3,0,-2,2,-4,-6,-6,-1,3,-8,-4,-6,-3,-2,-5,-6,0,0,-3,1,8,-2,5,0,-4,-1,0,-1,3,0,-4,-1,0,-1,2,0,0,0,0,0,-14,7,-21,-6,-4,-2,13,-12,-10,2,-2,-2,11,0,-4,1,2,-3,2,-12,-6,1,-4,1,-2,0,0,-4,2,-2,-3,1,-1,-1,2,-2,1,-1,1,-3,0,0,5,2,3,12,7,5,-9,-1,-18,20,4,9,-2,0,-19,17,2,4,-7,-1,1,3,2,5,3,4,-2,1,2,4,1,2,-1,2,1,2,2,2,-1,-1,1,2,-19,-9,-10,-4,-5,1,-1,-8,2,-3,-7,-6,-1,-4,1,-2,1,-5,0,-4,1,-1,-8,-1,3,-1,-3,-1,0,-2,0,-1,-1,0,0,-3,3,0,-2,-1,0,1,23,20,3,3,3,0,-1,2,-7,18,7,5,5,2,-4,12,2,3,-6,0,-3,6,5,2,1,2,-5,3,3,-1,2,1,-3,1,2,0,-1,1,-2,2,1,-1,55,23,32,12,7,5,3,-4,4,11,26,15,1,-2,-2,4,18,6,2,-2,6,7,8,9,-1,3,4,4,1,0,-1,2,2,2,1,0,0,1,2,2,0,0
33,33041,Navia,9154,-7,-9,2,7,4,3,4,-18,3,-4,9,-3,4,-15,6,-7,4,-2,0,-3,-3,3,5,-1,1,0,3,0,2,0,0,0,2,0,2,0,1,0,1,0,0,0,0,0,0,18,8,10,-1,-1,-1,7,-5,-1,-2,1,0,1,-5,3,1,-2,-1,6,0,-4,2,5,2,4,3,2,0,1,1,3,2,1,2,4,1,1,1,1,7,-1,8,27,17,10,-9,6,-5,3,7,0,-7,0,-6,4,7,-2,-2,6,1,-1,0,2,6,7,7,7,0,0,3,5,2,7,0,0,3,2,5,0,0,0,-5,3,-8,21,4,17,0,-17,2,1,8,-1,1,-6,-6,4,7,2,-1,-11,8,-3,1,-3,5,7,1,3,5,0,1,2,-2,1,2,0,4,5,3,2,3,0,-4,16,-20,46,35,11,1,-4,-6,3,-3,4,2,4,1,7,0,0,-1,-8,-7,-4,-3,4,5,11,20,2,4,4,5,9,15,2,2,2,0,2,5,0,2,2,44,18,26,32,20,12,5,12,-2,7,14,9,0,4,2,2,8,2,5,8,-4,5,6,7,4,7,12,8,1,0,3,4,6,6,1,0,1,3,6,2,0,0,67,24,43,53,18,35,17,-3,9,24,14,4,6,-3,0,6,7,6,11,0,9,18,7,-2,11,9,14,10,4,4,6,1,6,2,2,1,5,8,8,8,2,3,104,57,47,95,45,50,28,-10,33,48,-3,13,17,-9,21,29,-4,5,11,-1,12,19,1,8,16,16,34,19,4,5,7,5,19,11,1,1,9,11,15,8,3,4,105,97,8,152,111,41,11,21,19,46,11,-3,-2,19,25,43,11,0,13,2,-6,3,0,-3,23,26,51,40,14,-3,10,17,38,37,10,-2,13,9,13,3,4,-1,-66,-32,-34,6,-2,8,-1,4,-30,-27,-12,1,3,-1,-14,-16,-3,2,-4,5,-16,-11,-9,-1,6,7,-3,-4,0,0,2,2,-2,-5,1,0,4,5,-1,1,-1,0,-28,-26,-2,-17,-18,1,-8,5,-11,-18,4,-2,-6,0,-6,-8,-4,-3,-2,5,-5,-10,8,1,-3,6,-10,-3,-3,-5,-4,3,-8,-3,-5,-1,1,3,-2,0,2,-4,-13,-19,6,8,0,8,5,-3,-9,-15,-1,7,3,-7,-7,-13,1,3,2,4,-2,-2,-2,4,2,5,2,0,-1,0,1,2,0,-2,0,-1,1,3,2,2,-1,1,-88,-55,-33,-70,-63,-7,3,-18,-34,-16,-21,-4,11,-11,-13,-19,-21,-1,-8,-7,-21,3,0,-3,0,-8,-21,-23,-15,-4,2,-9,-20,-18,-16,-2,-2,1,-1,-5,1,-2,-13,-11,-2,-18,-9,-9,-10,3,1,-16,5,3,-8,-1,2,-2,0,-1,-2,4,-1,-14,5,4,-5,-1,-3,-8,-1,0,-3,-1,-3,-2,0,0,-2,0,0,-6,-1,0,-55,-28,-27,12,7,5,-3,-13,-13,-12,-9,-1,-4,-1,-9,-5,-7,1,1,-12,-4,-7,-2,-2,0,5,4,2,0,1,0,3,4,1,-1,0,0,2,0,1,1,1,-35,-24,-11,3,-1,4,1,-2,-12,-17,-2,1,2,-1,-8,-12,-2,0,-1,-1,-4,-5,0,1,3,1,5,-6,2,-2,0,0,2,-2,1,-2,3,1,3,-4,1,0,-30,-15,-15,9,10,-1,-7,5,-7,-12,-7,-3,0,5,-8,-7,-2,-3,-7,0,1,-5,-5,0,1,5,5,-2,2,-2,3,3,0,1,3,0,-2,2,5,-3,-1,-2,36,20,16,11,5,6,23,17,-23,17,-11,9,11,9,-12,11,-4,4,12,8,-11,6,-7,5,3,12,-5,1,-2,2,1,5,-1,0,-1,1,2,7,-4,1,-1,1
33,33042,Noreña,4274,46,22,24,12,2,10,13,-5,15,23,1,0,11,-6,3,14,1,0,2,1,12,9,0,0,1,5,6,0,0,0,1,0,1,0,0,0,0,5,5,0,0,0,91,35,56,24,7,17,10,4,39,11,8,18,3,1,12,6,2,10,7,3,27,5,6,8,2,9,6,4,1,2,0,3,1,1,0,2,2,6,5,3,1,0,88,46,42,25,10,15,20,3,21,18,15,10,5,1,9,8,10,12,15,2,12,10,5,-2,8,3,5,4,3,1,2,0,2,2,2,1,6,3,3,2,1,0,75,42,33,12,7,5,14,6,29,16,4,4,3,7,17,11,2,1,11,-1,12,5,2,3,0,-1,6,3,2,2,0,0,3,2,1,1,0,-1,3,1,1,1,167,72,95,14,6,8,28,12,76,30,7,13,8,5,35,15,4,4,20,7,41,15,3,9,2,1,4,6,0,1,1,0,2,3,0,0,1,1,2,3,0,1,211,87,124,16,4,12,43,21,58,64,15,5,16,3,28,29,8,0,27,18,30,35,7,5,4,5,2,3,1,1,0,1,2,0,1,0,4,4,0,3,0,1,155,70,85,12,5,7,23,39,63,15,9,2,12,6,31,14,4,1,11,33,32,1,5,1,-1,4,6,1,1,0,0,0,2,1,1,0,-1,4,4,0,0,0,119,70,49,23,17,6,32,-3,46,35,3,1,24,1,27,14,2,1,8,-4,19,21,1,0,8,6,4,5,-1,1,5,4,6,2,0,0,3,2,-2,3,-1,1,117,69,48,14,8,6,7,14,60,20,13,-1,4,13,35,8,9,-2,3,1,25,12,4,1,3,3,2,2,3,1,3,2,1,0,2,0,0,1,1,2,1,1,48,20,28,-2,-3,1,6,4,8,21,8,3,0,6,2,6,4,3,6,-2,6,15,4,0,3,5,-8,-3,1,-1,2,2,-6,-3,1,0,1,3,-2,0,0,-1,-35,-23,-12,13,9,4,-7,-19,5,-7,-8,3,-8,-11,5,-3,-7,1,1,-8,0,-4,-1,2,7,3,2,1,1,-1,5,1,2,1,0,0,2,2,0,0,1,-1,-2,5,-7,1,-2,3,-6,-16,1,6,7,2,2,-5,7,-3,2,-1,-8,-11,-6,9,5,3,-1,-2,0,1,3,-1,0,-1,-1,-2,1,0,-1,-1,1,3,2,-1,23,6,17,10,8,2,13,2,4,-6,4,1,7,-4,0,-2,2,0,6,6,4,-4,2,1,5,3,-2,-2,4,2,5,0,-1,-1,4,1,0,3,-1,-1,0,1,14,5,9,4,3,1,15,-6,0,-5,7,2,6,-2,-1,-1,1,1,9,-4,1,-4,6,1,3,1,0,-2,1,1,2,1,1,-1,0,0,1,0,-1,-1,1,1,-62,-50,-12,-8,-6,-2,-8,-9,-11,-24,-6,0,-5,-13,-4,-18,-7,-4,-3,4,-7,-6,1,4,-4,-1,-2,-3,1,1,-5,0,-1,0,0,0,1,-1,-1,-3,1,1,-40,-4,-36,4,2,2,-13,-15,1,-11,-2,-1,4,-6,-2,-8,4,2,-17,-9,3,-3,-6,-3,-1,2,0,5,-4,2,-1,2,-1,0,0,2,0,0,1,5,-4,0,-31,-21,-10,-5,-4,-1,1,-2,2,-16,-14,-3,-8,-2,2,-10,-6,2,9,0,0,-6,-8,-5,1,4,0,-5,-4,-1,0,1,0,-3,-3,1,1,3,0,-2,-1,-2,-24,-18,-6,-7,-3,-4,-4,-7,-1,-14,-2,2,-1,-2,1,-8,-5,-4,-3,-5,-2,-6,3,6,0,-6,2,-3,-1,1,0,-2,1,-2,-1,1,0,-4,1,-1,0,0
33,33043,Onís,903,7,3,4,5,3,2,1,-4,2,2,4,1,0,-1,0,0,3,0,1,-3,2,2,1,1,0,0,1,1,2,1,0,0,0,1,1,1,0,0,1,0,1,0,-4,-3,-1,2,1,1,-2,-2,0,-4,-1,5,-1,-1,0,-4,0,3,-1,-1,0,0,-1,2,1,0,0,1,0,0,0,0,0,1,0,0,1,0,0,0,0,0,2,3,-1,13,7,6,1,-1,0,1,5,-4,2,-1,-1,1,3,-1,-1,0,1,0,2,-3,2,0,2,3,2,4,2,0,0,2,1,2,0,0,2,1,1,2,15,12,3,11,7,4,-1,-1,5,1,13,-3,-2,0,5,2,6,0,1,-1,0,-1,7,-3,1,1,3,0,5,1,1,1,2,0,2,1,0,0,1,0,3,0,14,3,11,11,5,6,1,0,10,-1,7,-2,0,-2,3,0,2,1,1,2,7,-1,5,-3,0,0,4,0,4,3,0,0,2,0,1,2,0,0,2,0,3,1,-7,-1,-6,6,5,1,-6,1,4,-2,-5,1,-3,3,3,-4,-2,2,-3,-2,1,2,-3,-1,1,3,2,0,-1,1,1,2,1,0,0,1,0,1,1,0,-1,0,-7,-3,-4,8,4,4,-3,-4,1,4,1,-6,-3,-2,3,3,0,-4,0,-2,-2,1,1,-2,1,0,2,3,1,1,0,0,2,1,0,1,1,0,0,2,1,0,25,6,19,20,6,14,10,-1,4,3,8,1,4,-3,0,1,2,2,6,2,4,2,6,-1,4,3,4,2,6,1,1,0,1,1,2,1,3,3,3,1,4,0,-4,-5,1,6,0,6,-3,-2,-1,9,3,-8,-5,0,-1,6,3,-6,2,-2,0,3,0,-2,0,2,-1,4,0,1,-1,0,-1,2,0,0,1,2,0,2,0,1,10,5,5,5,-1,6,2,0,2,2,-1,4,3,-1,2,-1,-1,3,-1,1,0,3,0,1,1,3,0,0,1,-1,0,0,0,-1,0,0,1,3,0,1,1,-1,24,17,7,9,5,4,4,2,2,6,8,3,4,3,0,5,4,1,0,-1,2,1,4,2,2,0,2,1,4,0,3,0,0,0,2,0,-1,0,2,1,2,0,6,1,5,8,3,5,0,4,-1,-1,10,-5,-2,3,0,1,3,-3,2,1,-1,-2,7,-2,2,0,0,1,3,2,1,0,0,1,1,0,1,0,0,0,2,2,9,7,2,10,7,3,1,9,-1,1,2,-3,0,4,2,0,3,-2,1,5,-3,1,-1,-1,3,3,2,1,0,1,2,2,1,1,0,1,1,1,1,0,0,0,-13,-7,-6,4,1,3,-1,3,-4,-8,3,-2,-2,2,0,-5,2,-2,1,1,-4,-3,1,0,0,1,1,1,2,-1,0,0,0,1,1,-1,0,1,1,0,1,0,9,7,2,-1,0,-1,5,-1,-2,6,-1,2,4,-2,-2,5,0,2,1,1,0,1,-1,0,2,0,-2,0,-1,0,1,-1,0,0,0,0,1,1,-2,0,-1,0,7,6,1,6,3,3,4,1,3,5,2,-8,1,0,5,3,2,-5,3,1,-2,2,0,-3,1,2,-1,2,1,1,0,1,0,1,1,0,1,1,-1,1,0,1,-4,1,-5,0,3,-3,-3,-2,3,-3,1,0,2,-2,2,0,0,-1,-5,0,1,-3,1,1,0,-2,2,1,-1,0,0,0,2,1,0,0,0,-2,0,0,-1,0,7,7,0,5,2,3,1,-1,2,-1,8,-3,0,0,2,0,5,-1,1,-1,0,-1,3,-2,2,1,1,0,2,-1,0,1,1,0,1,-1,2,0,0,0,1,0
33,33044,Oviedo,200453,1201,310,891,1568,594,974,141,350,402,179,41,90,84,52,98,32,15,32,57,298,304,147,26,58,204,403,561,254,91,36,105,123,207,95,40,17,99,280,354,159,51,19,2123,922,1201,1649,738,911,341,595,556,413,66,153,178,209,271,168,32,61,163,386,285,245,34,92,276,467,507,270,77,42,135,172,254,117,35,20,141,295,253,153,42,22,2366,1115,1251,1722,822,900,450,565,527,511,153,173,239,247,275,249,59,52,211,318,252,262,94,121,349,477,456,272,110,44,177,205,226,144,48,15,172,272,230,128,62,29,2631,1137,1494,1667,784,883,528,693,668,472,126,151,223,287,289,232,49,66,305,406,379,240,77,85,363,433,426,247,120,65,173,213,200,112,54,27,190,220,226,135,66,38,3023,1415,1608,1451,680,771,534,621,835,623,167,225,248,259,459,269,62,108,286,362,376,354,105,117,212,360,459,255,108,48,114,168,222,109,44,19,98,192,237,146,64,29,3366,1484,1882,1941,894,1047,565,712,995,680,173,230,265,289,426,301,79,115,300,423,569,379,94,115,313,523,633,297,131,36,154,220,305,141,55,17,159,303,328,156,76,19,3068,1434,1634,1940,888,1052,698,624,784,623,163,147,328,261,405,324,56,35,370,363,379,299,107,112,359,551,603,245,118,45,166,228,288,131,51,11,193,323,315,114,67,34,4247,2139,2108,2990,1619,1371,747,1126,1207,815,151,174,343,555,754,373,67,39,404,571,453,442,84,135,597,918,877,450,117,27,312,490,538,219,50,9,285,428,339,231,67,18,3585,1729,1856,2100,1014,1086,577,1051,1184,464,92,177,297,521,566,232,23,71,280,530,618,232,69,106,384,716,673,204,101,10,200,350,329,91,34,4,184,366,344,113,67,6,1548,728,820,1328,639,689,344,381,298,324,53,104,180,131,171,146,26,42,164,250,127,178,27,62,261,414,407,153,48,31,138,198,211,58,15,10,123,216,196,95,33,21,560,218,342,557,146,411,232,311,-52,24,-78,87,147,100,-33,-8,-43,37,85,211,-19,32,-35,50,189,298,104,-57,-4,12,108,96,11,-72,-18,11,81,202,93,15,14,1,1102,395,707,793,279,514,251,321,119,135,56,160,122,114,25,1,10,80,129,207,94,134,46,80,177,322,175,61,34,15,87,110,59,10,1,5,90,212,116,51,33,10,-127,-246,119,115,-40,155,59,204,-480,-65,-16,110,71,31,-338,-91,1,31,-12,173,-142,26,-17,79,59,246,-134,-66,0,-12,61,73,-115,-74,-5,8,-2,173,-19,8,5,-20,-549,-367,-182,-279,-191,-88,38,178,-565,-198,-16,-27,26,42,-331,-89,-13,-17,12,136,-234,-109,-3,-10,46,124,-276,-133,-39,-18,40,24,-171,-78,-12,-4,6,100,-105,-55,-27,-14,-1052,-808,-244,-889,-595,-294,-6,99,-677,-309,-165,-31,-16,4,-407,-277,-118,-13,10,95,-270,-32,-47,-18,-29,53,-466,-321,-118,-26,-26,8,-280,-217,-77,-14,-3,45,-186,-104,-41,-12,-330,-329,-1,-178,-164,-14,66,127,-267,-191,-90,-16,16,41,-193,-125,-82,-4,50,86,-74,-66,-8,-12,28,99,-128,-148,-54,8,3,27,-71,-92,-35,-3,25,72,-57,-56,-19,11,613,123,490,452,161,291,187,367,-159,-22,96,124,93,158,-119,-80,11,44,94,209,-40,58,85,80,88,329,-10,-41,27,36,59,150,-21,-52,-3,14,29,179,11,11,30,22,638,238,400,748,307,441,239,278,-40,-3,42,77,124,99,-51,-22,3,57,115,179,11,19,39,20,201,281,123,55,42,20,112,103,48,13,9,12,89,178,75,42,33,8
33,33045,Parres,5627,45,28,17,35,16,19,4,11,17,2,9,1,7,5,6,1,8,1,-3,6,11,1,1,0,4,5,9,7,4,4,4,0,4,2,3,3,0,5,5,5,1,1,67,31,36,22,13,9,16,11,23,0,11,5,13,9,3,1,5,0,3,2,20,-1,6,5,3,4,7,2,3,3,3,2,5,2,0,1,0,2,2,0,3,2,48,24,24,53,25,28,9,2,12,11,18,-4,9,0,5,6,10,-6,0,2,7,5,8,2,10,6,13,12,8,3,4,5,6,4,4,2,6,1,7,8,4,1,98,62,36,43,25,18,16,12,34,12,20,3,10,14,12,5,12,7,6,-2,22,7,8,-4,9,3,9,8,8,6,5,4,5,4,6,1,4,-1,4,4,2,5,46,27,19,60,33,27,11,6,14,4,18,-8,6,3,7,5,9,-3,5,3,7,-1,9,-5,10,12,21,8,6,2,7,8,11,3,3,1,3,4,10,5,3,1,67,38,29,62,30,32,10,12,20,6,14,6,4,5,10,8,11,2,6,7,10,-2,3,4,14,15,15,9,7,2,5,8,6,6,3,2,9,7,9,3,4,0,56,31,25,62,37,25,11,15,22,10,2,-3,4,6,21,3,0,-3,7,9,1,7,2,0,6,16,24,13,1,2,0,9,18,7,0,3,6,7,6,6,1,-1,121,59,62,118,56,62,37,2,25,33,8,12,13,4,18,13,2,6,24,-2,7,20,6,6,29,19,34,24,10,1,11,10,17,12,5,1,18,9,17,12,5,0,88,43,45,56,24,32,22,7,23,21,18,-2,11,4,15,7,6,0,11,3,8,14,12,-2,11,12,16,14,1,2,6,4,8,6,-1,1,5,8,8,8,2,1,-7,-8,1,18,7,11,-2,-3,-8,0,-2,9,-6,-3,-5,4,-1,2,4,0,-3,-4,-1,7,7,3,7,1,0,-2,3,0,1,3,-1,-1,4,3,6,-2,1,-1,36,3,33,27,4,23,-5,1,20,9,7,4,-3,-6,6,2,5,0,-2,7,14,7,2,4,6,11,-2,3,4,3,2,5,-3,-2,1,0,4,6,1,5,3,3,-36,-11,-25,6,5,1,0,-10,-13,-3,-2,-7,1,-4,0,-4,-5,3,-1,-6,-13,1,3,-10,5,5,-8,2,2,0,5,2,-6,1,3,0,0,3,-2,1,-1,0,-19,-18,-1,7,-3,10,-5,0,-1,-17,1,3,2,-2,-2,-13,-3,0,-7,2,1,-4,4,3,1,7,1,-6,3,1,2,2,0,-7,-1,1,-1,5,1,1,4,0,27,11,16,-4,-3,-1,-4,-7,6,17,11,4,0,-5,2,7,6,1,-4,-2,4,10,5,3,3,-2,-3,2,-4,0,5,-1,-2,0,-5,0,-2,-1,-1,2,1,0,-33,-21,-12,-26,-13,-13,0,-10,-12,-12,-2,4,1,-6,-5,-13,1,1,-1,-4,-7,1,-3,3,-3,-3,-6,-13,-1,-1,-1,1,-3,-11,0,0,-2,-4,-3,-2,-1,-1,41,26,15,6,8,-2,13,-1,6,11,-1,13,9,5,2,1,5,4,4,-6,4,10,-6,9,4,3,5,-6,1,-1,2,3,2,-1,2,0,2,0,3,-5,-1,-1,-37,-19,-18,3,0,3,-8,-17,-20,6,-5,8,-8,-8,-6,1,-2,3,0,-9,-14,5,-3,5,1,3,0,-2,-3,4,0,2,0,-1,-2,1,1,1,0,-1,-1,3,11,5,6,8,-4,12,-2,3,-2,4,15,-5,-3,-1,-7,13,4,-1,1,4,5,-9,11,-4,2,5,-1,0,2,0,-2,2,-4,1,0,-1,4,3,3,-1,2,1
33,33049,Piloña,8976,-39,-10,-29,24,13,11,-18,-10,-25,5,5,5,-15,0,-12,1,5,11,-3,-10,-13,4,0,-6,2,5,5,5,1,6,2,3,2,0,1,5,0,2,3,5,0,1,-32,-23,-9,29,11,18,-20,13,-23,-1,8,-10,-15,2,-7,-2,5,-6,-5,11,-16,1,3,-4,0,12,8,3,4,2,0,4,4,0,1,2,0,8,4,3,3,0,28,9,19,62,27,35,-2,8,-1,12,7,3,4,1,-6,3,2,4,-6,7,5,9,5,-1,2,11,14,10,11,13,1,3,8,4,5,5,1,8,6,6,6,8,-6,10,-16,35,18,17,4,-19,-5,11,11,-9,9,-10,-8,13,12,-5,-5,-9,3,-2,-1,-4,6,1,9,10,4,5,5,0,2,7,1,3,1,1,7,3,3,2,-58,-24,-34,21,8,13,-6,-3,-16,-15,-6,-11,-10,3,1,-8,-4,-6,4,-6,-17,-7,-2,-5,2,4,10,2,2,1,0,0,5,1,1,1,2,4,5,1,1,0,32,15,17,27,13,14,11,9,-17,22,18,-9,8,0,-7,11,10,-6,3,9,-10,11,8,-3,4,4,5,7,5,2,2,2,1,2,4,2,2,2,4,5,1,0,35,11,24,49,17,32,1,-14,0,21,29,-1,1,-6,-4,8,14,-2,0,-8,4,13,15,1,6,7,18,9,8,1,4,5,5,1,3,-1,2,2,13,8,5,2,3,18,-15,51,27,24,14,4,-12,6,5,-15,8,3,2,1,6,-2,6,1,-14,5,-1,-13,16,10,9,11,3,2,8,4,3,8,2,2,8,6,6,3,1,0,-5,-16,11,37,15,22,5,2,-7,-1,6,-7,0,-3,0,-7,-2,-2,5,5,-7,6,8,-5,8,11,5,4,3,6,4,4,1,1,2,3,4,7,4,3,1,3,24,25,-1,0,-2,2,2,12,-6,12,9,-4,6,6,-7,10,8,3,-4,6,1,2,1,-7,-1,3,3,0,-4,-1,-1,2,1,0,-3,-1,0,1,2,0,-1,0,-24,-13,-11,7,1,6,3,-4,-6,-12,2,-11,-1,1,-1,-16,1,-1,4,-5,-5,4,1,-10,3,0,-2,6,1,-1,1,0,-2,2,0,0,2,0,0,4,1,-1,-30,-15,-15,13,11,2,-1,10,-25,-12,7,-6,0,2,-12,-7,2,2,-1,8,-13,-5,5,-8,2,2,-2,0,7,3,3,1,0,0,4,2,-1,1,-2,0,3,1,-33,-2,-31,2,-2,4,6,-20,-13,-7,2,-1,2,-3,-2,2,1,-1,4,-17,-11,-9,1,0,-2,0,-1,-2,5,2,-2,0,-1,-1,2,0,0,0,0,-1,3,2,-28,-9,-19,1,-2,3,-10,0,-19,-11,7,4,-4,-2,-11,-5,7,7,-6,2,-8,-6,0,-3,-1,4,-1,-4,1,2,-1,1,-1,-3,0,2,0,3,0,-1,1,0,-20,9,-29,3,1,2,-5,5,-15,7,12,-19,-5,9,-2,8,7,-5,0,-4,-13,-1,5,-14,2,1,3,-5,2,-1,2,-1,3,-3,1,-2,0,2,0,-2,1,1,11,7,4,11,2,9,8,4,-7,4,8,-9,11,-2,-5,-5,7,0,-3,6,-2,9,1,-9,2,2,1,0,2,3,0,0,0,-1,1,2,2,2,1,1,1,1,-33,-13,-20,5,2,3,13,-16,-9,-3,-2,-15,11,-5,-3,-1,-5,-10,2,-11,-6,-2,3,-5,5,1,-7,5,2,-1,2,0,-3,0,3,0,3,1,-4,5,-1,-1,16,14,2,16,9,7,4,6,-16,7,22,-8,-1,4,-3,4,10,0,5,2,-13,3,12,-8,0,5,5,2,8,-4,-1,3,3,0,4,0,1,2,2,2,4,-4
33,33051,Pravia,9515,-17,-36,19,14,6,8,-23,-11,-18,-20,15,39,-12,-10,-15,-12,5,7,-11,-1,-3,-8,10,32,2,3,1,4,1,3,1,1,0,3,1,0,1,2,1,1,0,3,16,5,11,25,11,14,7,14,-10,-8,4,8,5,3,-6,-4,6,2,2,11,-4,-4,-2,6,7,3,8,5,2,0,4,1,3,2,1,0,3,2,5,3,1,0,23,15,8,29,16,13,15,-6,-1,17,-2,-3,10,-1,-3,9,-2,-1,5,-5,2,8,0,-2,4,4,11,7,2,1,3,2,4,4,1,2,1,2,7,3,1,-1,-24,5,-29,31,14,17,-7,-7,-17,-2,5,-1,-1,3,-4,3,3,-2,-6,-10,-13,-5,2,1,3,3,11,5,3,6,3,0,4,4,1,2,0,3,7,1,2,4,116,71,45,61,40,21,27,25,28,17,12,6,14,16,20,12,7,2,13,9,8,5,5,4,8,11,21,12,2,6,5,6,14,9,1,4,3,5,7,3,1,2,74,52,22,60,36,24,28,-1,25,21,0,-1,12,5,24,12,-2,-1,16,-6,1,9,2,0,15,14,21,8,1,0,6,12,11,5,1,0,9,2,10,3,0,0,8,-1,9,18,3,15,8,3,-29,11,17,-3,1,-8,-15,3,11,7,7,11,-14,8,6,-10,4,7,0,7,2,-2,2,1,-2,1,1,0,2,6,2,6,1,-2,106,36,70,48,26,22,30,27,24,-2,12,9,10,9,8,3,5,-1,20,18,16,-5,7,10,7,27,13,-2,2,1,4,16,4,-1,2,1,3,11,9,-1,0,0,51,23,28,47,20,27,11,13,25,6,8,-14,8,3,13,2,3,-9,3,10,12,4,5,-5,8,15,16,7,3,-2,3,8,6,3,2,-2,5,7,10,4,1,0,-42,-21,-21,26,8,18,-11,-11,-3,-16,3,-6,1,-4,2,-17,1,-3,-12,-7,-5,1,2,-3,12,4,4,2,2,2,7,1,1,-3,1,1,5,3,3,5,1,1,28,13,15,19,16,3,13,12,-9,9,5,-1,2,5,-5,7,2,2,11,7,-4,2,3,-3,2,5,4,2,5,0,1,4,4,4,2,0,1,1,0,-2,3,0,89,58,31,41,31,10,15,4,30,19,16,3,6,5,9,23,11,3,9,-1,21,-4,5,0,5,5,4,22,3,2,4,7,2,15,2,1,1,-2,2,7,1,1,-24,-35,11,-3,-5,2,-3,-3,-29,-29,8,29,-5,-4,-19,-23,4,11,2,1,-10,-6,4,18,2,2,1,-7,-1,0,2,-1,0,-5,0,-1,0,3,1,-2,-1,1,-14,-1,-13,2,-2,4,-11,-15,5,5,6,2,-3,-4,6,-3,1,3,-8,-11,-1,8,5,-1,0,0,0,-1,0,2,-1,1,-1,-1,0,-1,1,-1,1,0,0,3,-74,-36,-38,-14,-10,-4,-5,-6,-12,-20,-15,-13,-2,1,-11,-14,-6,-3,-3,-7,-1,-6,-9,-10,-2,0,-3,-6,-2,-1,0,0,-3,-5,-2,0,-2,0,0,-1,0,-1,-46,-26,-20,13,5,8,1,-6,-13,-14,-9,-5,-5,-1,-1,-10,-4,-5,6,-5,-12,-4,-5,0,3,2,4,2,-1,3,2,0,3,0,1,-1,1,2,1,2,-2,4,2,2,0,4,6,-2,-1,3,-32,12,-5,25,4,-1,-19,7,-5,15,-5,4,-13,5,0,10,0,4,-3,1,0,1,2,0,-1,2,0,2,-2,4,-2,-1,0,-1,-2,-11,9,7,6,1,7,-5,-10,1,8,-1,1,-3,-7,1,-1,1,6,-2,-3,0,9,-2,-1,1,-1,3,7,-2,-1,3,1,1,4,-2,0,-2,-2,2,3,0
33,33056,Ribadesella,6291,4,-9,13,55,18,37,-2,-10,-11,7,17,3,-4,-10,-10,4,11,0,2,0,-1,3,6,3,10,12,11,9,11,2,3,0,4,4,6,1,7,12,7,5,5,1,36,10,26,49,20,29,7,1,25,-5,1,7,9,1,5,-3,0,-2,-2,0,20,-2,1,9,10,11,16,7,2,3,6,4,5,3,1,1,4,7,11,4,1,2,2,4,-2,40,17,23,-1,-11,-13,8,22,-3,-5,-5,-1,5,9,2,4,-6,-12,3,13,-5,6,4,10,8,10,2,1,2,5,4,3,2,5,2,5,4,7,0,116,54,62,60,31,29,13,0,22,36,36,7,5,3,8,20,18,-1,8,-3,14,16,18,8,15,6,14,9,13,2,7,4,5,5,7,2,8,2,9,4,6,0,21,7,14,48,24,24,-18,7,-8,7,17,20,-11,-2,3,4,8,7,-7,9,-11,3,9,13,1,6,16,8,8,9,0,3,8,5,2,6,1,3,8,3,6,3,67,26,41,63,21,42,6,26,17,10,12,-3,-2,3,11,4,7,3,8,23,6,6,5,-6,5,26,16,11,3,2,1,4,8,5,1,2,4,22,8,6,2,0,66,33,33,66,22,44,6,19,16,27,8,-9,1,4,13,8,5,1,5,15,3,19,3,-10,9,20,14,13,8,2,4,4,3,6,3,2,5,16,11,7,5,0,54,32,22,73,29,44,2,22,5,12,3,8,-3,10,4,11,4,4,5,12,1,1,-1,4,10,28,13,17,2,3,3,7,7,11,1,0,7,21,6,6,1,3,33,10,23,64,25,39,9,-3,14,4,8,1,-1,5,1,5,3,-2,10,-8,13,-1,5,3,12,11,19,13,4,5,4,6,4,7,1,3,8,5,15,6,3,2,72,34,38,42,13,29,7,10,25,13,9,9,5,1,9,6,10,4,2,9,16,7,-1,5,5,23,7,6,1,0,2,5,2,3,1,0,3,18,5,3,0,0,12,5,7,38,17,21,19,-1,-14,1,12,-5,5,-2,-3,7,1,-3,14,1,-11,-6,11,-2,13,12,5,8,-1,0,7,4,2,6,-3,1,6,8,3,2,2,-1,29,13,16,39,17,22,4,15,-6,5,0,6,2,9,-3,-3,1,3,2,6,-3,8,-1,3,8,12,4,4,1,9,3,7,-1,2,0,5,5,5,5,2,1,4,-47,-22,-25,21,11,10,7,-21,-18,-10,-1,-3,9,-8,-9,-9,-2,-1,-2,-13,-9,-1,1,-2,11,4,4,1,1,0,7,2,2,0,0,0,4,2,2,1,1,0,-22,1,-23,6,3,3,-2,-12,-5,-10,8,0,3,-7,2,-2,3,2,-5,-5,-7,-8,5,-2,0,1,1,4,0,0,-2,1,1,4,-1,0,2,0,0,0,1,0,-29,-15,-14,-4,-2,-2,-10,6,-20,-17,13,-1,-6,2,-10,-5,6,-1,-4,4,-10,-12,7,0,-4,1,-2,-5,4,2,-1,-1,0,-3,1,2,-3,2,-2,-2,3,0,-24,-1,-23,-15,-5,-10,-1,-8,-22,-4,11,-1,-2,-4,-4,4,2,2,1,-4,-18,-8,9,-3,7,-1,-12,-6,0,-3,1,0,-2,-2,-1,-1,6,-1,-10,-4,1,-2,-23,-12,-11,26,7,19,11,-1,-2,-1,-16,-14,5,-2,-5,1,-4,-6,6,1,3,-2,-12,-8,4,9,3,4,3,2,0,2,-1,2,3,1,4,7,4,2,0,1,30,7,23,42,11,31,16,0,-3,9,9,-1,9,-11,2,-2,10,-1,7,11,-5,11,-1,0,7,12,8,6,11,-2,2,0,4,0,7,-2,5,12,4,6,4,0
33,33059,Salas,7154,-49,-27,-22,7,2,5,-11,-12,-15,-1,-1,-7,-8,-3,-10,-3,2,-3,-3,-9,-5,2,-3,-4,0,2,1,3,1,0,0,0,0,1,1,0,0,2,1,2,0,0,-46,-15,-31,11,6,5,-6,-8,-13,-14,1,-4,-1,-3,-3,-7,-2,1,-5,-5,-10,-7,3,-5,1,4,2,4,0,0,1,1,2,2,0,0,0,3,0,2,0,0,-43,-21,-22,32,14,18,-17,-14,-2,-10,8,-6,-8,-7,-3,-4,7,-5,-9,-7,1,-6,1,-1,1,2,11,5,6,7,0,0,5,3,4,2,1,2,6,2,2,5,-22,-21,-1,22,10,12,-3,-5,-34,13,7,2,-1,0,-23,2,6,-4,-2,-5,-11,11,1,6,2,5,3,9,1,2,0,1,3,5,0,1,2,4,0,4,1,1,-70,-31,-39,27,14,13,-6,-9,-46,-5,2,-7,-5,-5,-19,-5,3,-1,-1,-4,-27,0,-1,-6,0,7,3,3,8,5,0,4,2,0,4,3,0,3,1,3,4,2,-30,-13,-17,26,18,8,1,-10,-8,-21,2,6,-3,-2,-1,-10,1,3,4,-8,-7,-11,1,3,4,10,4,6,1,1,2,5,6,4,0,1,2,5,-2,2,1,0,-10,2,-12,26,14,12,9,-9,-4,2,3,-9,5,0,0,-4,3,-1,4,-9,-4,6,0,-8,2,6,8,5,1,4,2,4,4,1,0,3,0,2,4,4,1,1,-2,12,-14,34,19,15,2,5,-15,-7,12,0,0,1,-4,0,7,8,2,4,-11,-7,5,-8,4,9,9,8,4,0,0,4,7,4,4,0,4,5,2,4,0,0,17,20,-3,56,24,32,10,8,-6,4,7,-9,8,6,2,1,5,-2,2,2,-8,3,2,-7,10,17,14,11,2,2,6,5,8,3,2,0,4,12,6,8,0,2,28,27,1,9,2,7,16,6,4,4,8,-9,8,4,9,-2,5,3,8,2,-5,6,3,-12,0,6,2,1,0,-1,0,2,0,-1,0,0,0,4,2,2,0,-1,-38,-16,-22,11,7,4,-2,0,-24,-5,6,-13,2,-1,-13,-1,2,-5,-4,1,-11,-4,4,-8,2,1,-1,4,4,1,2,1,0,2,1,1,0,0,-1,2,3,0,-25,-16,-9,18,9,9,-5,-1,-11,-6,2,-6,-5,-3,-4,-6,0,0,0,2,-7,0,2,-6,2,4,5,3,2,1,1,1,3,2,1,0,1,3,2,1,1,1,-4,-1,-3,5,2,3,12,9,-3,-4,-2,-15,7,6,-4,-5,-2,-3,5,3,1,1,0,-12,3,3,-1,1,-1,0,1,2,0,-1,0,0,2,1,-1,2,-1,0,-12,-2,-10,-11,-2,-9,-1,-5,-6,-3,5,-4,2,-5,-3,-3,7,-1,-3,0,-3,0,-2,-3,-2,-3,-1,-5,0,0,0,-2,2,-2,0,0,-2,-1,-3,-3,0,0,-66,-26,-40,-19,-16,-3,-10,-15,-27,-5,10,-19,-6,-3,-18,0,8,-7,-4,-12,-9,-5,2,-12,-3,-1,-11,-2,0,-2,-3,1,-9,-3,-1,-1,0,-2,-2,1,1,-1,-53,-28,-25,5,3,2,-10,-9,-16,-9,7,-15,-7,-2,-9,-6,1,-5,-3,-7,-7,-3,6,-10,4,1,-1,0,0,1,3,0,-1,0,0,1,1,1,0,0,0,0,-52,-25,-27,3,-1,4,-7,-4,-11,-18,0,-11,-6,-1,2,-18,3,-4,-1,-3,-13,0,-3,-7,1,4,3,-5,0,0,2,1,1,-5,0,0,-1,3,2,0,0,0,29,12,17,9,5,4,14,8,-9,13,6,-3,4,5,-4,6,5,-3,10,3,-5,7,1,0,3,1,3,-1,2,0,0,0,3,-1,3,0,3,1,0,0,-1,0
33,33060,San Martín del Rey Aurelio,21414,-196,-83,-113,47,16,31,-23,-23,-27,-55,-53,-13,-12,-12,-10,-21,-22,-4,-11,-11,-17,-34,-31,-9,7,15,13,7,2,2,4,3,4,3,1,1,3,12,9,4,1,1,-172,-83,-89,47,29,18,-8,-18,-48,-55,-19,-24,1,-6,-32,-24,-16,-6,-9,-12,-16,-31,-3,-18,11,10,15,7,3,1,8,5,7,5,3,1,3,5,8,2,0,0,-127,-74,-53,59,28,31,-2,-10,-57,-20,-30,-14,-5,-10,-24,-13,-18,-6,3,0,-33,-7,-12,-8,17,15,10,9,1,5,9,7,3,5,1,3,8,8,7,4,0,2,-113,-51,-62,58,29,29,23,-31,-45,-48,-1,-17,5,-12,-9,-31,1,-9,18,-19,-36,-17,-2,-8,14,11,14,8,7,2,5,5,9,4,3,1,9,6,5,4,4,1,-172,-65,-107,51,23,28,10,-17,-98,-13,-24,-29,19,-6,-46,-11,-10,-11,-9,-11,-52,-2,-14,-18,11,6,14,10,6,3,8,2,5,6,1,1,3,4,9,4,5,2,-107,-43,-64,75,40,35,12,-7,-38,-23,-27,-20,19,0,-24,-13,-12,-10,-7,-7,-14,-10,-15,-10,23,12,15,21,1,3,16,4,7,12,0,1,7,8,8,9,1,2,-175,-85,-90,61,30,31,5,-14,-50,-47,-38,-29,-1,1,-21,-28,-19,-15,6,-15,-29,-19,-19,-14,17,8,17,12,8,-2,8,5,7,7,3,-1,9,3,10,5,5,-1,-128,-36,-92,65,37,28,31,-12,-90,-17,-5,-38,18,-1,-55,2,1,-5,13,-11,-35,-19,-6,-33,22,13,17,8,1,3,15,8,8,3,1,1,7,5,9,5,0,2,-16,0,-16,78,34,44,39,12,-30,-16,4,-24,24,8,-11,-13,-1,-5,15,4,-19,-3,5,-19,19,14,25,16,3,0,8,7,10,9,0,-1,11,7,15,7,3,1,-79,-49,-30,40,14,26,18,-22,-44,-18,-2,-10,5,-10,-36,2,-8,-2,13,-12,-8,-20,6,-8,6,9,14,6,3,2,0,3,5,5,0,1,6,6,9,1,3,1,-114,-54,-60,38,14,24,24,-6,-70,-17,-24,-21,7,1,-34,-8,-5,-12,17,-7,-36,-9,-19,-9,8,4,8,12,4,1,3,3,2,5,1,0,5,1,6,7,3,1,-158,-72,-86,18,11,7,-11,0,-41,-37,-30,-41,-9,-2,-22,-15,-16,-9,-2,2,-19,-22,-14,-32,4,4,3,6,-1,2,2,3,0,6,-2,2,2,1,3,0,1,0,-56,-31,-25,10,3,7,16,-10,-47,1,-5,-14,7,-2,-31,3,-7,0,9,-8,-16,-2,2,-14,5,1,2,-2,1,2,2,0,1,-1,0,1,3,1,1,-1,1,1,-116,-67,-49,5,-1,6,2,-20,-43,-18,-19,-16,3,-9,-33,-12,-16,-1,-1,-11,-10,-6,-3,-15,7,5,-6,-1,-2,2,1,0,-3,1,-1,1,6,5,-3,-2,-1,1,-92,-41,-51,19,5,14,12,-8,-49,-26,2,-31,16,-6,-20,-24,8,-19,-4,-2,-29,-2,-6,-12,8,4,3,3,2,-4,4,3,-3,1,0,-2,4,1,6,2,2,-2,-139,-68,-71,-23,-7,-16,-27,10,-54,-43,3,-27,-20,7,-23,-23,-3,-7,-7,3,-31,-20,6,-20,0,2,-9,-13,-1,-2,2,4,-5,-5,-1,-2,-2,-2,-4,-8,0,0,-86,-44,-42,-8,-7,-1,-16,3,-29,-14,-3,-27,-6,0,-17,-3,-6,-13,-10,3,-12,-11,3,-14,-3,3,-5,-6,0,3,-1,2,-4,-3,-2,1,-2,1,-1,-3,2,2,-161,-92,-69,-58,-37,-21,-7,-18,-51,-21,-38,-30,-11,-12,-24,-12,-27,-11,4,-6,-27,-9,-11,-19,-6,-7,-11,-16,-17,-2,-4,-4,-11,-9,-10,1,-2,-3,0,-7,-7,-3
33,33066,Siero,47270,955,433,522,200,86,114,123,152,310,135,62,141,61,58,143,83,37,39,62,94,167,52,25,102,35,39,60,30,26,7,20,13,22,13,15,2,15,26,38,17,11,5,244,128,116,176,83,93,36,3,95,72,5,29,19,10,28,64,-3,8,17,-7,67,8,8,21,29,27,67,33,10,8,15,13,27,19,3,5,14,14,40,14,7,3,48,35,13,11,9,2,51,-34,36,17,-7,-26,32,-21,26,16,-8,-13,19,-13,10,1,1,-13,10,2,-6,7,0,-2,5,-1,0,8,-1,-2,5,3,-6,-1,1,0,138,86,52,232,114,118,45,18,25,-9,9,37,22,16,35,-10,5,14,23,2,-10,1,4,23,52,53,59,36,20,10,25,23,30,22,10,3,27,30,29,14,10,7,185,88,97,249,101,148,16,51,-7,54,31,40,20,30,-10,22,9,17,-4,21,3,32,22,23,45,68,63,39,21,13,18,26,34,14,6,3,27,42,29,25,15,10,349,127,222,240,96,144,92,48,69,82,12,47,31,12,22,44,15,4,61,36,47,38,-3,43,53,51,63,49,12,10,26,14,31,16,6,3,27,37,32,33,6,7,402,256,146,246,119,127,65,56,122,79,60,13,38,38,78,61,33,6,27,18,44,18,27,7,32,73,70,39,22,9,17,33,31,23,12,3,15,40,39,16,10,6,873,508,365,287,151,136,138,149,259,199,35,65,101,77,146,135,12,22,37,72,113,64,23,43,46,68,89,56,16,7,27,31,51,32,6,2,19,37,38,24,10,5,1043,555,488,238,148,90,207,124,351,237,80,22,127,40,194,135,48,2,80,84,157,102,32,20,48,65,63,46,13,0,35,25,45,35,6,-1,13,40,18,11,7,1,626,329,297,129,56,73,124,77,153,145,59,43,72,53,85,68,22,19,52,24,68,77,37,24,31,40,40,21,-1,-4,11,18,18,7,0,1,20,22,22,14,-1,-5,445,243,202,31,-6,37,100,50,147,97,26,24,60,33,88,35,9,17,40,17,59,62,17,7,24,33,-18,-8,-3,0,9,13,-16,-11,-3,0,15,20,-2,3,0,0,315,117,198,-17,-43,26,90,30,98,66,5,26,47,5,32,42,0,-3,43,25,66,24,5,29,22,14,-3,-48,-12,5,9,2,-6,-39,-13,2,13,12,3,-9,1,3,277,107,170,32,-3,35,70,-10,101,53,53,8,37,-5,38,28,13,-3,33,-5,63,25,40,11,31,5,-6,-10,6,4,12,-4,-12,-4,0,4,19,9,6,-6,6,0,215,120,95,-22,-15,-7,22,24,41,77,22,21,15,-4,39,37,21,12,7,28,2,40,1,9,10,-1,-20,-6,-2,-3,5,4,-11,-7,-3,-3,5,-5,-9,1,1,0,-24,-20,-4,-95,-65,-30,25,-1,-56,-26,6,37,6,5,-19,-16,4,5,19,-6,-37,-10,2,32,-4,-6,-35,-46,-5,0,2,-4,-15,-39,-7,-2,-6,-2,-20,-7,2,2,30,-28,58,-50,-51,1,42,-35,-57,-24,-4,111,25,-39,-20,-27,-2,31,17,4,-37,3,-2,80,10,0,-32,-31,-2,3,10,-13,-14,-32,-7,4,0,13,-18,1,5,-1,28,11,17,25,8,17,18,1,-67,24,-26,74,11,15,-43,15,-16,29,7,-14,-24,9,-10,45,18,28,-8,-10,-7,2,3,18,-3,-12,-3,4,15,10,-5,2,-4,-2,166,137,29,44,38,6,72,-53,63,47,3,36,44,-30,40,60,9,17,28,-23,23,-13,-6,19,32,6,-3,-5,7,4,21,10,-4,6,2,2,11,-4,1,-11,5,2
33,33070,Tapia de Casariego,4394,-2,-3,1,5,1,4,-6,-5,8,0,3,-1,-3,-2,2,-1,3,-1,-3,-3,6,1,0,0,0,0,4,0,1,0,0,0,0,0,1,0,0,0,4,0,0,0,26,18,8,18,7,11,-6,2,3,5,14,8,-1,6,1,1,7,4,-5,-4,2,4,7,4,1,4,10,2,0,1,1,0,5,0,0,1,0,4,5,2,0,0,33,14,19,25,12,13,3,-5,12,5,11,4,2,-2,5,1,5,2,1,-3,7,4,6,2,9,2,8,3,1,2,5,1,3,1,0,2,4,1,5,2,1,0,25,15,10,12,4,8,8,-2,-4,6,11,9,-1,0,-5,10,5,7,9,-2,1,-4,6,2,2,0,1,1,6,2,1,0,0,0,3,0,1,0,1,1,3,2,4,-9,13,16,6,10,2,10,-14,-1,-1,7,-1,7,-12,-5,-1,3,3,3,-2,4,0,4,6,4,3,1,1,1,3,1,1,0,0,1,3,3,2,1,1,0,19,10,9,25,9,16,5,7,-15,4,11,9,4,4,-9,3,9,0,1,3,-6,1,2,9,8,8,5,2,2,1,5,0,1,1,2,1,3,8,4,1,0,0,35,9,26,23,16,7,-1,-11,-2,-10,9,48,0,-4,0,-7,3,16,-1,-7,-2,-3,6,32,2,3,12,2,2,2,2,2,9,2,1,0,0,1,3,0,1,2,7,6,1,24,15,9,-5,-9,8,6,5,3,-8,-2,6,6,4,0,3,-7,2,0,1,3,2,1,11,6,2,2,0,0,6,6,2,1,2,1,5,0,0,1,-1,-3,2,21,9,12,-3,-10,1,-5,1,14,0,-5,-1,-4,1,5,-3,-5,2,-1,0,9,0,2,9,6,3,1,0,1,2,4,2,0,0,1,7,2,1,1,-16,-14,-2,3,-1,4,2,-3,-9,-6,2,-3,1,0,-4,-7,-2,-3,1,-3,-5,1,4,0,2,1,1,0,-1,0,1,1,0,-2,-1,0,1,0,1,2,0,0,-29,-22,-7,-16,-16,0,-1,-4,-15,-16,1,7,-3,-2,-11,-10,2,4,2,-2,-4,-6,-1,3,-2,-1,-6,-8,1,0,-2,-1,-6,-8,0,1,0,0,0,0,1,-1,-11,-4,-7,-17,-9,-8,-6,-7,-9,6,4,-1,-5,-1,-5,2,2,2,-1,-6,-4,4,2,-3,0,-1,-10,-3,-2,-1,0,0,-3,-3,-2,-1,0,-1,-7,0,0,0,-1,18,-19,0,3,-3,5,-1,2,3,-5,-5,5,1,5,7,-1,2,0,-2,-3,-4,-4,-7,1,0,0,-1,0,0,1,0,1,1,0,0,0,0,-1,-2,0,0,-28,-13,-15,-13,-8,-5,5,-2,-24,3,-8,1,2,-2,-9,2,-6,1,3,0,-15,1,-2,0,2,0,-6,-4,-4,-1,1,0,-3,-2,-4,0,1,0,-3,-2,0,-1,19,16,3,1,-1,2,9,2,-6,9,-2,6,7,1,-4,11,-2,2,2,1,-2,-2,0,4,1,1,-1,1,-1,0,1,0,-2,1,-1,0,0,1,1,0,0,0,3,-5,8,0,2,-2,-1,-1,4,-9,9,1,1,-2,1,-10,3,2,-2,1,3,1,6,-1,0,1,2,-1,0,-2,0,0,3,-1,0,0,0,1,-1,0,0,-2,20,3,17,2,0,2,10,2,-14,15,1,6,3,1,-8,-1,3,5,7,1,-6,16,-2,1,1,1,-1,2,0,-1,0,0,-1,1,0,0,1,1,0,1,0,-1,-3,1,-4,-1,-4,3,0,-8,-4,-13,15,9,2,-4,-1,-5,8,2,-2,-4,-3,-8,7,7,1,1,-1,-4,0,2,1,0,-2,-2,-1,0,0,1,1,-2,1,2
33,33073,Tineo,13200,-111,-43,-68,23,11,12,-16,-32,-5,-36,-6,-15,-6,-6,-5,-15,-5,-5,-10,-26,0,-21,-1,-10,5,3,6,1,3,5,3,1,3,0,2,2,2,2,3,1,1,3,-70,-26,-44,12,5,7,-8,-23,-8,-17,-6,-6,-2,-14,-1,-6,-4,2,-6,-9,-7,-11,-2,-8,2,1,8,0,0,1,2,0,2,0,0,1,0,1,6,0,0,0,-106,-27,-79,40,27,13,-26,-16,-19,-31,-11,-10,-17,-4,6,-12,-6,0,-9,-12,-25,-19,-5,-10,1,13,11,5,1,4,0,5,9,4,1,4,1,8,2,1,0,0,-147,-69,-78,22,8,14,-15,-42,-57,-13,-10,-11,-6,-20,-27,-6,-5,-5,-9,-22,-30,-7,-5,-6,2,5,7,5,1,2,1,2,4,1,0,0,1,3,3,4,1,2,-106,-40,-66,51,29,22,-11,-20,-29,-25,-2,-19,-8,-2,-11,-13,0,-5,-3,-18,-18,-12,-2,-14,4,17,19,7,0,4,2,8,13,4,0,2,2,9,6,3,0,2,-99,-36,-63,77,53,24,-22,-14,-32,-11,-12,-7,-16,5,-11,-5,-10,2,-6,-19,-21,-6,-2,-9,7,25,23,18,2,2,3,20,18,10,0,2,4,5,5,8,2,0,-110,-74,-36,56,25,31,7,-10,-41,-39,-4,-23,3,-4,-33,-26,-7,-8,4,-6,-8,-13,3,-15,8,14,19,10,7,-2,5,5,7,6,3,-1,3,9,12,4,4,-1,-34,-12,-22,117,67,50,4,12,-21,4,-15,-14,3,4,-17,0,-2,2,1,8,-4,4,-13,-16,19,40,32,23,4,-1,11,21,19,12,4,0,8,19,13,11,0,-1,-105,-48,-57,58,29,29,-3,-16,-71,2,-5,-9,-1,-9,-28,-3,-2,-5,-2,-7,-43,5,-3,-4,12,12,16,11,4,3,7,4,10,6,1,1,5,8,6,5,3,2,-23,-4,-19,48,23,25,-3,20,-17,-9,-6,-9,-1,8,-1,-4,-6,-1,-2,12,-16,-5,0,-8,3,19,13,8,5,0,3,5,9,3,2,1,0,14,4,5,3,-1,-71,-44,-27,37,13,24,3,2,-38,8,-10,-32,3,0,-27,1,-5,-11,0,2,-11,7,-5,-21,2,12,9,13,1,0,2,3,3,6,-1,0,0,9,6,7,2,0,-28,-29,1,29,8,21,7,18,-33,-16,3,-9,-1,4,-26,-6,4,-3,8,14,-7,-10,-1,-6,6,16,5,0,3,-2,4,1,1,1,2,-1,2,15,4,-1,1,-1,-79,-42,-37,18,5,13,1,-11,-33,-20,3,-17,-1,-5,-20,-15,5,-5,2,-6,-13,-5,-2,-12,2,8,3,1,4,0,1,1,0,1,2,0,1,7,3,0,2,0,-16,-7,-9,24,9,15,8,-5,-12,14,-12,-7,5,1,-2,9,-12,-6,3,-6,-10,5,0,-1,12,6,0,4,2,0,5,3,0,1,0,0,7,3,0,3,2,0,-192,-94,-98,-101,-58,-43,-7,-20,-78,-31,-23,-29,-1,-5,-46,-16,-16,-9,-6,-15,-32,-15,-7,-20,-5,0,-39,-38,-16,-3,-3,2,-25,-18,-13,-1,-2,-2,-14,-20,-3,-2,-107,-20,-87,16,8,8,-3,-10,-28,-33,1,-30,3,-6,-2,-16,8,-5,-6,-4,-26,-17,-7,-25,2,8,3,-1,3,1,1,4,3,-2,1,1,1,4,0,1,2,0,-63,-30,-33,10,4,6,-7,-5,-43,-1,1,-7,-2,1,-18,-6,0,-6,-5,-6,-25,5,1,-1,3,3,1,6,-3,0,0,2,1,2,-1,0,3,1,0,4,-2,0,-40,-4,-36,11,3,8,9,-17,-9,3,-5,-20,5,-6,0,6,-1,-7,4,-11,-9,-3,-4,-13,6,1,6,-2,3,-3,3,-1,3,-2,1,-1,3,2,3,0,2,-2
33,33034,Valdés,15556,-114,-67,-47,23,13,10,-26,-22,-51,-4,0,-9,-14,-9,-36,-5,1,-4,-12,-13,-15,1,-1,-5,4,5,5,5,1,3,3,2,2,4,1,1,1,3,3,1,0,2,-79,-37,-42,22,11,11,-10,-33,-32,-6,9,-7,-5,-16,-10,-9,8,-5,-5,-17,-22,3,1,-2,2,2,7,6,5,0,1,1,5,1,3,0,1,1,2,5,2,0,-68,-37,-31,37,19,18,3,-15,-50,-2,8,-15,6,-11,-34,3,8,-11,-3,-4,-16,-5,0,-4,8,9,5,6,8,1,4,4,3,4,5,-1,4,5,2,2,3,2,-92,-39,-53,25,10,15,-17,-22,-47,-13,17,-9,-9,0,-31,-6,7,0,-8,-22,-16,-7,10,-9,0,5,8,3,6,3,0,3,1,1,2,3,0,2,7,2,4,0,-82,-52,-30,25,7,18,-6,-29,-54,0,10,2,-5,-14,-36,1,3,1,-1,-15,-18,-1,7,1,4,4,11,4,1,1,2,0,5,1,0,-1,2,4,6,3,1,2,-37,-20,-17,48,19,29,-7,-14,-20,5,-3,0,-3,-4,-11,0,-3,0,-4,-10,-9,5,0,0,5,14,13,11,1,3,1,5,8,4,0,1,4,9,5,7,1,2,-45,-26,-19,52,23,29,6,-8,-34,3,12,-27,7,-3,-26,5,5,-14,-1,-5,-8,-2,7,-13,2,10,18,14,4,2,2,3,5,9,3,1,0,7,13,5,1,1,-26,8,-34,122,74,48,21,-20,-58,25,14,-3,14,0,-30,19,8,-2,7,-20,-28,6,6,-1,17,25,33,32,11,3,10,15,20,21,6,2,7,10,13,11,5,1,-57,-29,-28,66,33,33,2,-9,-34,7,-6,-14,-5,-5,-9,-2,-3,-4,7,-4,-25,9,-3,-10,4,20,15,21,3,3,-2,10,7,15,1,2,6,10,8,6,2,1,1,-2,3,74,29,45,5,1,1,-1,8,-12,3,-1,4,-4,-1,-4,2,2,-3,3,9,-8,11,17,22,12,8,1,4,6,10,4,3,0,7,11,12,8,5,1,-24,-14,-10,33,14,19,3,-11,-25,16,3,-11,8,-2,-29,2,6,0,-5,-9,4,14,-3,-11,7,9,14,-1,2,1,7,5,7,-5,0,-1,0,4,7,4,2,2,-47,-26,-21,22,1,21,13,-26,-17,-4,1,-9,5,-21,-6,-1,5,-6,8,-5,-11,-3,-4,-3,7,7,-3,5,4,2,3,-2,0,-1,0,1,4,9,-3,6,4,1,-35,-14,-21,26,12,14,17,4,-34,17,-13,-22,13,5,-22,4,-8,-2,4,-1,-12,13,-5,-20,11,6,1,11,-1,-2,5,2,1,4,-1,1,6,4,0,7,0,-3,-88,-43,-45,2,1,1,2,-25,-32,-22,7,-19,-4,-10,-16,-14,8,-10,6,-15,-16,-8,-1,-9,8,-3,-2,-1,0,0,6,-1,-2,-2,0,0,2,-2,0,1,0,0,-52,-53,1,-29,-11,-18,-3,-4,-28,-21,8,-4,-9,-6,-25,-5,2,-8,6,2,-3,-16,6,4,-2,0,-13,-13,0,-1,-2,0,-7,-3,1,0,0,0,-6,-10,-1,-1,-31,0,-31,-15,-8,-7,6,-22,-30,-5,8,13,10,-4,-13,-6,4,8,-4,-18,-17,1,4,5,-3,1,-3,-10,0,0,-3,0,0,-6,0,1,0,1,-3,-4,0,-1,-130,-68,-62,-49,-33,-16,-2,-13,-47,-32,-13,-21,-7,-3,-26,-12,-13,-8,5,-10,-21,-20,0,-13,2,-1,-23,-16,-5,-6,3,-1,-16,-8,-6,-5,-1,0,-7,-8,1,-1,-86,-49,-37,-27,-15,-12,-6,-14,-36,-25,-6,-1,-3,-12,-15,-19,-1,-3,-3,-2,-21,-6,-5,2,-2,4,-10,-11,-11,3,0,1,-6,-7,-5,2,-2,3,-4,-4,-6,1
33,33076,Villaviciosa,14348,93,47,46,72,29,43,40,5,-6,31,24,0,30,2,-11,11,11,4,10,3,5,20,13,-4,18,12,15,19,5,3,8,7,3,7,2,2,10,5,12,12,3,1,130,56,74,62,29,33,13,5,48,25,32,7,1,6,23,12,14,0,12,-1,25,13,18,7,11,10,21,10,7,3,5,6,8,6,2,2,6,4,13,4,5,1,205,121,84,79,44,35,24,34,65,38,37,4,17,20,29,20,28,4,7,14,36,18,9,0,18,16,23,10,5,6,11,11,11,4,4,2,7,5,12,6,1,4,175,95,80,74,38,36,20,8,20,76,49,0,18,8,9,30,25,1,2,0,11,46,24,-1,14,23,8,16,8,5,5,16,4,6,5,2,9,7,4,10,3,3,316,152,164,60,22,38,50,17,120,81,46,1,25,2,58,43,26,-3,25,15,62,38,20,4,9,14,18,11,6,1,3,8,5,4,2,-1,6,6,13,7,4,2,267,130,137,79,38,41,50,11,52,101,46,4,21,2,18,53,33,4,29,9,34,48,13,0,15,11,18,23,10,2,8,3,10,9,7,1,7,8,8,14,3,1,210,120,90,79,33,46,24,9,51,69,37,17,12,5,30,38,24,11,12,4,21,31,13,6,11,24,17,20,6,1,7,10,8,7,2,-1,4,14,9,13,4,2,206,110,96,50,26,24,47,28,38,66,36,-12,27,15,6,42,21,-2,20,13,32,24,15,-10,13,16,10,6,4,1,3,7,7,4,2,3,10,9,3,2,2,-2,224,110,114,91,43,48,32,30,92,59,15,-3,17,11,43,29,7,0,15,19,49,30,8,-3,22,17,30,15,6,2,12,7,16,4,3,1,10,10,14,11,3,1,212,122,90,60,32,28,27,26,48,57,46,10,16,13,27,38,25,6,11,13,21,19,21,4,8,12,9,10,15,5,3,8,4,8,6,3,5,4,5,2,9,2,241,127,114,65,32,33,38,24,57,77,28,12,15,8,30,55,17,1,23,16,27,22,11,11,13,18,14,12,3,1,7,2,10,5,3,2,6,16,4,7,0,-1,135,68,67,70,26,44,33,25,1,45,31,-2,26,17,-8,20,11,-1,7,8,9,25,20,-1,15,14,17,11,1,11,6,4,7,2,0,6,9,10,10,9,1,5,78,35,43,26,9,17,30,-1,7,17,18,3,16,-3,11,3,8,-2,14,2,-4,14,10,5,9,6,1,8,0,0,5,3,-3,4,0,-1,4,3,4,4,0,1,52,20,32,19,9,10,20,-1,-12,3,45,-4,11,6,-13,-5,21,2,9,-7,1,8,24,-6,7,4,-1,3,6,0,5,1,0,1,2,0,2,3,-1,2,4,0,24,-5,29,-43,-31,-12,36,-14,10,-10,7,-7,17,-7,0,-17,9,-8,19,-7,10,7,-2,1,-6,-4,-14,-19,0,0,-7,-4,-5,-15,1,-1,1,0,-9,-4,-1,1,84,50,34,43,21,22,10,-13,12,19,16,38,8,-6,6,19,15,10,2,-7,6,0,1,28,10,12,0,9,6,6,7,7,3,2,-1,3,3,5,-3,7,7,3,10,6,4,29,4,25,-4,-10,-21,34,1,14,2,-6,-18,24,1,7,-6,-4,-3,10,0,7,7,7,5,0,8,2,4,0,0,-3,4,-1,3,7,5,3,4,3,168,78,90,46,20,26,43,2,23,45,35,16,29,-5,8,16,18,7,14,7,15,29,17,9,5,10,11,4,10,6,2,3,4,2,7,2,3,7,7,2,3,4
34,34004,Aguilar de Campoo,7734,2,3,-1,51,31,20,-5,-19,16,-11,9,3,-3,-15,14,-5,2,6,-2,-4,2,-6,7,-3,1,11,29,2,4,4,1,6,19,2,1,2,0,5,10,0,3,2,5,1,4,42,16,26,-3,10,-34,21,7,1,-1,1,-18,11,6,1,-2,9,-16,10,1,0,0,18,16,5,1,0,0,7,4,3,1,0,0,11,12,2,0,0,-71,-32,-39,14,0,14,-6,-36,-19,-21,6,-2,1,-18,-14,-10,2,1,-7,-18,-5,-11,4,-3,1,4,3,4,1,1,0,-1,-1,1,0,1,1,5,4,3,1,0,-40,-14,-26,37,15,22,-20,-9,-5,-28,6,6,-15,1,-6,-8,2,6,-5,-10,1,-20,4,0,6,14,12,2,3,0,3,5,3,3,1,0,3,9,9,-1,2,0,-21,-9,-12,56,24,32,-7,-20,9,-1,-6,-5,1,-13,12,-6,-2,-3,-8,-7,-3,5,-4,-2,9,10,18,8,6,3,5,2,9,5,1,2,4,8,9,3,5,1,86,44,42,58,31,27,19,29,19,-5,4,16,12,14,13,-3,3,4,7,15,6,-2,1,12,11,26,15,5,0,1,8,11,10,3,-1,0,3,15,5,2,1,1,-12,-11,-1,50,17,33,15,-8,6,-2,-8,-20,2,-1,3,-4,-5,-5,13,-7,3,2,-3,-15,12,9,21,7,0,0,5,5,6,2,-1,0,7,4,15,5,1,0,-17,-20,3,77,35,42,3,-12,-4,-25,-1,17,5,-10,-16,-12,3,6,-2,-2,12,-13,-4,11,11,26,19,14,7,-1,5,11,9,5,4,0,6,15,10,9,3,-1,51,28,23,72,38,34,18,18,11,1,-2,-3,10,13,5,-3,4,-3,8,5,6,4,-6,0,16,13,20,18,2,0,9,8,10,10,1,0,7,5,10,8,1,0,2,18,-16,46,19,27,4,12,9,-11,-5,-19,-2,5,14,-3,5,-4,6,7,-5,-8,-10,-15,14,13,14,5,0,-2,2,7,7,3,1,-1,12,6,7,2,-1,-1,-7,-18,11,46,19,27,12,-6,0,0,-17,1,0,-10,2,-2,-9,-2,12,4,-2,2,-8,3,15,9,14,5,0,1,6,2,7,2,0,0,9,7,7,3,0,1,2,5,-3,15,8,7,8,-13,-9,11,1,3,1,-3,-5,6,3,1,7,-10,-4,5,-2,2,4,5,5,1,0,-2,1,1,3,2,0,-1,3,4,2,-1,0,-1,-13,8,-21,18,8,10,-4,-10,11,-5,2,-10,3,-4,13,-2,0,-5,-7,-6,-2,-3,2,-5,5,4,4,2,1,2,4,-1,4,0,0,1,1,5,0,2,1,1,-35,-37,2,-25,-21,-4,2,-2,-9,-11,-14,-1,0,2,-14,-12,-12,-1,2,-4,5,1,-2,0,-3,1,-8,-11,-1,-3,-4,-1,-5,-8,-1,-2,1,2,-3,-3,0,-1,-7,2,-9,23,12,11,19,-4,4,-3,-3,-19,13,-2,-1,2,-1,-7,6,-2,5,-5,-2,-12,12,3,4,5,0,-1,8,1,2,1,0,0,4,2,2,4,0,-1,-31,-17,-14,-13,-16,3,-3,-11,-10,-12,-6,11,-7,-3,-12,1,-1,6,4,-8,2,-13,-5,5,-3,3,-6,-6,-2,0,-5,0,-7,-3,-1,0,2,3,1,-3,-1,0,-11,1,-12,11,4,7,0,-10,0,3,-3,3,0,-5,1,6,-3,4,0,-5,-1,-3,0,-1,1,1,4,4,0,1,0,1,1,1,1,0,1,0,3,3,-1,1,-22,-14,-8,6,3,3,4,-3,-6,-4,-2,-15,-1,0,-1,-2,1,-14,5,-3,-5,-2,-3,-1,4,1,-1,2,0,0,1,0,-2,3,1,0,3,1,1,-1,-1,0
34,34047,Carrión de los Condes,2466,4,-1,5,8,6,2,0,-3,4,-2,1,4,-2,-2,6,-2,-1,1,2,-1,-2,0,2,3,0,1,4,3,0,0,0,0,4,2,0,0,0,1,0,1,0,0,-19,-7,-12,5,2,3,-8,-6,-3,-12,0,10,-1,-3,2,-8,-2,5,-7,-3,-5,-4,2,5,2,0,0,1,2,0,1,0,0,0,1,0,1,0,0,1,1,0,-34,-8,-26,17,10,7,-2,-5,-20,0,2,-10,-2,-1,-9,4,0,0,0,-4,-11,-4,2,-10,5,3,4,4,1,0,2,3,0,4,1,0,3,0,4,0,0,0,50,31,19,19,10,9,8,8,13,9,8,4,3,3,10,7,7,1,5,5,3,2,1,3,2,6,7,4,0,0,1,2,5,2,0,0,1,4,2,2,0,0,23,2,21,28,11,17,5,1,10,-5,4,8,-1,-1,1,-4,3,4,6,2,9,-1,1,4,1,10,12,1,4,0,0,2,6,0,3,0,1,8,6,1,1,0,3,12,-9,29,13,16,-1,9,-20,8,6,1,4,2,0,0,2,4,-5,7,-20,8,4,-3,4,9,8,5,2,1,4,2,4,1,1,1,0,7,4,4,1,0,24,2,22,32,9,23,1,5,-9,5,12,12,3,1,-4,-4,3,5,-2,4,-5,9,9,7,9,6,8,7,2,0,3,1,3,2,0,0,6,5,5,5,2,0,31,29,2,21,14,7,-1,17,-8,1,2,20,2,14,0,0,-1,14,-3,3,-8,1,3,6,0,11,4,3,3,0,0,8,5,0,1,0,0,3,-1,3,2,0,-13,-6,-7,15,8,7,-3,-4,-8,-4,-2,8,-1,2,-7,0,-3,3,-2,-6,-1,-4,1,5,1,10,3,1,0,0,1,5,1,1,0,0,0,5,2,0,0,0,-17,-1,-16,14,12,2,0,6,-14,-12,0,3,2,8,-7,-5,1,0,-2,-2,-7,-7,-1,3,4,4,4,1,0,1,2,5,3,1,0,1,2,-1,1,0,0,0,-8,-5,-3,9,-1,10,-2,-2,-12,-2,4,8,-2,1,-9,-1,3,4,0,-3,-3,-1,1,4,1,7,-1,2,1,-1,0,1,-3,2,0,-1,1,6,2,0,1,0,7,-4,11,-1,-1,0,-4,11,-2,1,3,-2,-2,7,-5,0,-2,-1,-2,4,3,1,5,-1,0,-2,0,-1,3,-1,0,0,-1,-1,1,0,0,-2,1,0,2,-1,-8,-10,2,8,0,8,7,-2,-14,0,1,0,4,-2,-7,-4,0,-1,3,0,-7,4,1,1,0,-1,3,0,3,3,0,0,-1,-1,2,0,0,-1,4,1,1,3,28,8,20,-7,-6,-1,1,11,-4,-9,-3,30,2,2,-3,-4,-3,12,-1,9,-1,-5,0,18,-2,1,-3,-3,0,0,-1,-2,-2,-1,0,0,-1,3,-1,-2,0,0,-7,-1,-6,-2,0,-2,9,0,-17,4,-1,-2,2,-1,-3,-2,3,-1,7,1,-14,6,-4,-1,1,-2,0,-1,0,0,0,0,1,-1,0,0,1,-2,-1,0,0,0,2,-7,9,3,-1,4,-6,-1,-8,0,12,4,-5,-3,-9,-1,8,3,-1,2,1,1,4,1,0,4,-1,1,0,-1,0,1,-1,-1,0,0,0,3,0,2,0,-1,-11,-13,2,2,1,1,-3,-14,-3,-3,4,9,-3,-8,-5,-1,4,2,0,-6,2,-2,0,7,0,1,0,0,1,0,0,0,0,0,1,0,0,1,0,0,0,0,15,15,0,20,10,10,9,-3,-5,9,-2,6,8,1,0,6,-3,4,1,-4,-5,3,1,2,6,5,5,1,2,1,2,2,4,0,1,1,4,3,1,1,1,0
34,34056,Cervera de Pisuerga,2747,7,6,1,25,21,4,-8,16,0,-2,3,-3,-6,8,3,0,3,-2,-2,8,-3,-2,0,-1,3,7,10,4,0,0,2,6,10,3,0,0,1,1,0,1,0,0,-3,5,-8,14,4,10,-1,-4,-6,2,3,3,0,-2,-3,3,4,3,-1,-2,-3,-1,-1,0,8,1,5,0,0,0,3,0,1,0,0,0,5,1,4,0,0,0,7,-2,9,6,2,4,3,2,-6,3,5,1,2,-3,-4,2,1,1,1,5,-2,1,4,0,5,1,-1,1,0,0,4,0,-2,0,0,0,1,1,1,1,0,0,37,24,13,12,6,6,10,4,7,5,11,0,6,2,4,4,4,5,4,2,3,1,7,-5,3,2,2,2,2,0,3,0,1,1,1,0,0,2,1,1,1,0,6,11,-5,24,21,3,4,12,-8,-1,7,-6,3,10,-3,-1,3,1,1,2,-5,0,4,-7,0,9,6,9,0,0,0,8,6,7,0,0,0,1,0,2,0,0,-33,-23,-10,17,7,10,-6,-10,5,-15,-3,-7,-3,-6,-1,-9,1,-6,-3,-4,6,-6,-4,-1,3,4,8,1,0,1,1,2,4,0,0,0,2,2,4,1,0,1,7,9,-2,12,3,9,-8,-2,7,5,7,-2,-4,-2,3,4,4,4,-4,0,4,1,3,-6,-3,4,7,5,-1,0,-3,1,3,3,-1,0,0,3,4,2,0,0,-16,3,-19,23,12,11,1,3,-6,0,5,-21,0,5,-4,1,6,-6,1,-2,-2,-1,-1,-15,4,5,6,4,2,1,2,2,3,2,2,0,2,3,3,2,0,1,-23,-10,-13,10,6,4,-3,-7,-1,2,-7,-8,-4,-1,4,0,-6,-3,1,-6,-5,2,-1,-5,0,6,1,1,2,0,1,4,0,0,1,0,-1,2,1,1,1,0,32,6,26,3,0,3,10,7,-2,9,8,-4,-2,1,-5,4,5,1,12,6,3,5,3,-5,-1,0,0,2,2,0,-1,0,0,0,1,0,0,0,0,2,1,0,29,17,12,11,4,7,6,-3,0,2,10,10,7,-3,-4,3,7,5,-1,0,4,-1,3,5,5,0,0,2,2,0,4,-1,-2,0,1,0,1,1,2,2,1,0,17,15,2,-1,4,-5,4,-3,1,6,-2,11,1,2,3,5,0,4,3,-5,-2,1,-2,7,5,-4,-2,-1,-1,1,3,0,-1,0,0,1,2,-4,-1,-1,-1,0,-16,-3,-13,-4,-3,-1,1,-1,-10,-6,6,-4,1,2,-3,-6,2,2,0,-3,-7,0,4,-6,2,1,-3,-2,0,-2,2,1,-3,-2,0,-1,0,0,0,0,0,-1,-27,-15,-12,-5,-3,-2,4,-11,-3,-14,-7,4,3,-1,-3,-10,-5,1,1,-10,0,-4,-2,3,1,-1,0,-2,0,-3,0,0,0,-2,0,-1,1,-1,0,0,0,-2,5,4,1,3,-2,5,7,3,-3,-1,-1,-1,6,0,-3,-1,0,2,1,3,0,0,-1,-3,1,1,1,0,0,0,1,-2,-1,0,0,0,0,3,2,0,0,0,-23,-14,-9,-3,-2,-1,-3,0,-4,-8,-4,-5,-6,-2,-1,-2,2,-5,3,2,-3,-6,-6,0,0,2,-3,-1,0,-1,0,2,-2,-1,0,-1,0,0,-1,0,0,0,-23,-1,-22,4,5,-1,-6,-1,-5,-11,2,1,-1,4,-4,-5,1,5,-5,-5,-1,-6,1,-4,0,0,-3,3,2,2,0,1,-1,2,2,1,0,-1,-2,1,0,1,-9,-5,-4,0,1,-1,0,-2,-10,1,0,2,1,-2,-4,-1,-2,3,-1,0,-6,2,2,-1,2,-2,-1,1,0,0,1,1,-2,1,0,0,1,-3,1,0,0,0
34,34069,Dueñas,2966,12,8,4,18,6,12,-1,6,7,-2,4,-1,-2,5,9,-3,-1,1,1,1,-2,1,5,-2,1,3,9,4,1,0,0,1,5,0,0,0,1,2,4,4,1,0,40,25,15,29,16,13,7,16,6,7,2,1,7,9,0,5,1,2,0,7,6,2,1,-1,3,10,13,3,0,0,2,7,6,1,0,0,1,3,7,2,0,0,19,22,-3,34,24,10,7,-4,14,9,0,-11,7,-6,15,7,-1,-2,0,2,-1,2,1,-9,4,4,16,9,0,1,4,1,12,7,-1,1,0,3,4,2,1,0,51,51,0,56,41,15,5,0,20,18,8,-1,1,2,22,16,6,3,4,-2,-2,2,2,-4,9,1,27,14,3,1,5,1,19,12,2,1,4,0,8,2,1,0,27,15,12,39,18,21,5,5,-2,8,4,2,4,4,-4,6,2,2,1,1,2,2,2,0,4,7,10,11,4,1,1,6,4,4,2,0,3,1,6,7,2,1,50,47,3,67,55,12,-1,20,24,6,4,-3,-1,18,22,5,4,-1,0,2,2,1,0,-2,8,18,23,16,2,0,5,14,18,16,2,0,3,4,5,0,0,0,-29,-7,-22,27,16,11,-14,10,-15,-6,-1,-6,-6,8,-9,0,0,-1,-8,2,-6,-6,-1,-5,5,9,8,6,-1,0,3,7,5,2,0,-1,2,2,3,4,-1,1,-30,-21,-9,19,5,14,-2,-1,-16,-12,4,-4,0,-4,-11,-10,6,-3,-2,3,-5,-2,-2,-1,6,4,6,3,0,0,4,1,2,-2,0,0,2,3,4,5,0,0,11,13,-2,47,25,22,1,-1,18,-1,1,-6,0,1,13,-2,3,-2,1,-2,5,1,-2,-4,7,7,16,11,4,0,0,2,13,5,4,0,7,5,3,6,0,0,-62,-53,-9,-20,-26,6,-5,0,-18,-24,-10,-3,-6,-1,-16,-21,-8,1,1,1,-2,-3,-2,-4,0,5,-10,-11,-6,2,0,2,-11,-12,-6,1,0,3,1,1,0,1,-66,-31,-35,-8,-2,-6,-17,-9,-14,-15,-4,-4,-8,-4,-6,-9,-1,-2,-9,-5,-8,-6,-3,-2,0,-2,-4,-4,1,1,2,-1,-2,-3,1,1,-2,-1,-2,-1,0,0,-25,-11,-14,-6,-10,4,-3,6,-16,-3,-3,-4,2,4,-4,-5,-5,0,-5,2,-12,2,2,-4,-6,5,-3,1,-3,0,-4,2,-2,-2,-4,0,-2,3,-1,3,1,0,-14,-14,0,-8,-7,-1,1,8,-9,-2,-3,-10,-1,3,-7,-4,-1,-4,2,5,-2,2,-2,-6,0,1,-6,-2,-1,0,0,1,-4,-3,-1,0,0,0,-2,1,0,0,-1,-2,1,-2,1,-3,3,-6,-4,2,2,3,2,-1,-7,3,2,0,1,-5,3,-1,0,3,2,-2,1,-2,0,-1,2,0,-1,-1,1,0,0,-2,2,-1,-1,-1,0,-12,12,-1,-2,1,4,-6,0,-8,-4,14,1,-4,-2,-11,-2,6,3,-2,2,3,-2,8,1,0,2,-1,-2,-1,0,0,1,-2,-1,0,1,0,1,1,-1,-1,-30,-21,-9,-10,-7,-3,-4,-8,-8,-6,-14,10,0,-2,-8,-1,-10,0,-4,-6,0,-5,-4,10,1,-3,-7,2,-4,1,1,-2,-5,1,-2,0,0,-1,-2,1,-2,1,-25,-7,-18,-1,5,-6,-3,1,-7,-2,-6,-7,-1,0,4,-5,-2,-2,-2,1,-11,3,-4,-5,-1,0,1,1,0,-1,2,0,4,0,0,0,-3,0,-3,1,0,-1,-14,-8,-6,3,1,2,-5,1,0,-6,-2,-1,-5,-1,5,-5,-1,0,0,2,-5,-1,-1,-1,3,-1,5,-3,-1,0,2,-1,3,-3,0,0,1,0,2,0,-1,0
34,34120,Palencia,80332,300,114,186,165,64,101,111,-30,41,71,32,76,64,-6,-4,17,9,34,47,-24,45,54,23,42,22,44,59,20,4,15,10,18,19,6,2,9,12,26,40,14,2,6,-23,-15,-8,38,17,21,68,-69,-109,60,-6,39,35,-23,-72,30,-3,21,33,-46,-37,30,-3,18,10,3,7,9,4,5,3,1,3,4,2,4,7,2,4,5,2,1,41,-47,88,38,22,16,80,-7,-41,28,-43,11,38,-25,-36,-6,-38,14,42,18,-5,34,-5,-3,18,6,-10,10,7,5,7,5,-5,5,6,3,11,1,-5,5,1,2,-212,-147,-65,2,1,1,18,-118,-112,-25,-13,36,6,-54,-79,-15,-6,4,12,-64,-33,-10,-7,32,0,-1,-7,-2,9,3,0,1,-3,-3,5,1,0,-2,-4,1,4,2,316,74,242,409,167,242,88,79,4,65,25,44,27,6,4,23,12,-1,61,73,0,42,13,45,69,108,117,68,24,16,30,31,48,37,9,8,39,77,69,31,15,8,568,157,411,429,171,258,174,104,58,105,45,76,42,35,-4,42,10,26,132,69,62,63,35,50,90,114,109,72,31,9,40,45,41,31,12,0,50,69,68,41,19,9,154,72,82,500,228,272,100,41,-44,67,-17,18,75,6,-26,32,-18,7,25,35,-18,35,1,11,109,131,137,89,24,7,60,49,61,42,10,4,49,82,76,47,14,3,375,217,158,649,347,302,108,92,32,50,40,66,39,77,44,28,2,34,69,15,-12,22,38,32,155,149,180,117,30,15,84,76,95,77,12,4,71,73,85,40,18,11,146,50,96,365,178,187,92,22,-53,36,-5,57,35,28,-31,-6,-14,34,57,-6,-22,42,9,23,104,94,92,28,26,17,63,47,39,7,13,7,41,47,53,21,13,10,-290,-182,-108,93,32,61,35,-44,-226,-68,-41,54,35,-32,-126,-56,-28,31,0,-12,-100,-12,-13,23,68,31,-5,-9,3,0,41,10,-5,-15,0,-1,27,21,0,6,3,1,-475,-287,-188,63,21,42,6,-107,-284,-42,-76,20,7,-64,-169,-23,-62,14,-1,-43,-115,-19,-14,6,27,32,4,6,-3,-7,14,13,-5,4,-5,-2,13,19,9,2,2,-5,-192,-195,3,105,31,74,58,-81,-187,-82,-34,129,26,-47,-126,-78,-20,49,32,-34,-61,-4,-14,80,51,32,13,12,-8,1,27,4,0,-1,-5,3,24,28,13,13,-3,-2,-443,-266,-177,-84,-75,-9,-26,-89,-260,-26,-38,2,-8,-45,-145,-39,-29,3,-18,-44,-115,13,-9,-1,9,-3,-50,-27,-19,4,5,-13,-34,-30,-6,2,4,10,-16,3,-13,2,-278,-208,-70,-51,-47,-4,2,-53,-268,43,-22,23,-19,-31,-145,-2,-18,13,21,-22,-123,45,-4,10,14,-6,-41,-10,-4,-3,6,-13,-32,-10,2,-1,8,7,-9,0,-6,-2,-253,-159,-94,12,-6,18,-3,-81,-74,-50,-44,-5,-6,-48,-51,-18,-37,1,3,-33,-23,-32,-7,-6,10,32,-27,-1,-6,-1,3,9,-13,-1,-7,1,7,23,-14,0,1,-2,-242,-119,-123,-18,-25,7,13,-24,-136,-73,-44,9,36,-29,-83,-42,-29,14,-23,5,-53,-31,-15,-5,-2,6,-13,-12,-5,5,1,-9,-4,-9,-6,-1,-3,15,-9,-3,1,6,77,22,55,100,41,59,59,34,-77,36,-12,36,29,28,-44,7,-18,20,30,6,-33,29,6,16,38,46,8,15,-10,1,17,23,1,6,-8,1,21,23,7,9,-2,0,20,-12,32,222,102,120,72,-11,-25,-9,-36,26,40,28,-43,-19,-31,15,32,-39,18,10,-5,11,40,117,42,16,-5,11,20,71,8,6,-8,4,20,46,34,10,3,7
34,34157,Saldaña,3180,-18,-5,-13,6,5,1,-2,4,-17,-3,-11,9,-4,2,-4,1,-6,4,2,2,-13,-4,-5,5,2,2,1,1,0,0,1,2,1,1,0,0,1,0,0,0,0,0,20,12,8,7,4,3,4,-3,9,0,6,7,5,-3,0,1,5,5,-1,0,9,-1,1,2,1,1,3,0,2,0,1,0,2,0,1,0,0,1,1,0,1,0,-14,-25,11,19,7,12,-9,2,-4,-7,2,4,-6,0,-9,-6,-1,-1,-3,2,5,-1,3,5,5,6,6,1,1,0,2,2,4,-1,0,0,3,4,2,2,1,0,-74,-29,-45,9,6,3,-13,-16,-30,-13,1,-3,-6,-5,-13,-5,-1,1,-7,-11,-17,-8,2,-4,4,2,2,1,0,0,4,1,0,1,0,0,0,1,2,0,0,0,17,20,-3,25,18,7,-1,-8,12,7,4,6,-3,-7,12,12,3,3,2,-1,0,-5,1,3,4,6,9,3,3,0,1,3,8,3,3,0,3,3,1,0,0,0,-26,-13,-13,13,11,2,-6,2,-8,-17,6,-4,-1,4,-5,-11,2,-2,-5,-2,-3,-6,4,-2,1,6,3,3,0,0,0,4,4,3,0,0,1,2,-1,0,0,0,22,1,21,39,24,15,7,14,12,-7,-2,-4,-2,5,6,-2,-4,-1,9,9,6,-5,2,-3,5,13,10,6,4,0,1,9,7,5,2,0,4,4,3,1,2,0,33,24,9,51,30,21,2,6,3,14,5,2,-1,5,4,11,5,-1,3,1,-1,3,0,3,9,16,12,6,6,1,5,7,8,5,4,0,4,9,4,1,2,1,1,2,-1,42,28,14,5,2,3,2,-1,-9,7,-1,-2,2,0,-3,-2,3,5,0,-1,-6,9,13,10,6,4,0,6,10,4,4,4,0,3,3,6,2,0,0,-52,-31,-21,-14,-13,-1,-9,-7,-18,-6,-10,-1,-7,-4,-9,-5,-5,-1,-2,-3,-9,-1,-5,0,1,-1,-5,-6,-3,0,-1,-2,-3,-6,-1,0,2,1,-2,0,-2,0,10,6,4,12,4,8,-1,-2,1,8,7,-3,0,-2,3,7,1,-3,-1,0,-2,1,6,0,4,5,4,-1,1,-1,1,2,2,-1,0,0,3,3,2,0,1,-1,-2,-15,13,14,0,14,0,2,4,-2,-4,-2,0,-2,-2,-4,-4,-3,0,4,6,2,0,1,4,5,4,1,0,-1,2,0,0,-1,-1,-1,2,5,4,2,1,0,-18,-24,6,-17,-15,-2,6,-7,1,-26,2,7,-2,-2,-6,-14,-3,4,8,-5,7,-12,5,3,-1,-1,2,-12,-5,0,-2,0,1,-10,-4,0,1,-1,1,-2,-1,0,-3,-4,1,-13,-10,-3,16,-3,0,-4,-8,-4,8,-3,2,-3,-6,-2,8,0,-2,-1,-2,-2,-3,-1,-1,-2,-6,0,0,-2,-1,-2,-5,0,-3,1,0,0,-1,0,-36,-14,-22,-13,-6,-7,-19,1,-7,-7,-2,-1,-8,4,-3,-5,-2,0,-11,-3,-4,-2,0,-1,-4,0,-5,-3,0,-1,-2,0,-1,-2,-1,0,-2,0,-4,-1,1,-1,-12,0,-12,11,6,5,11,3,-16,-8,-2,0,10,1,-11,0,1,1,1,2,-5,-8,-3,-1,4,5,0,2,1,-1,4,1,-1,2,1,-1,0,4,1,0,0,0,-13,-7,-6,7,1,6,-9,-3,-1,1,-7,4,-10,-2,4,-3,-1,5,1,-1,-5,4,-6,-1,0,2,3,0,0,2,0,1,1,-2,0,1,0,1,2,2,0,1,-59,-27,-32,-3,-5,2,-15,-17,-4,-33,0,10,-7,-8,3,-18,0,3,-8,-9,-7,-15,0,7,0,1,-1,-6,3,0,-2,1,1,-5,0,0,2,0,-2,-1,3,0
34,34023,Venta de Baños,6303,-81,-31,-50,4,2,2,-13,-19,-29,-18,-1,-1,0,-9,-14,-8,1,-1,-13,-10,-15,-10,-2,0,0,1,2,0,1,0,0,0,1,0,1,0,0,1,1,0,0,0,13,13,0,13,8,5,7,1,11,-6,0,-2,7,-3,7,1,1,-1,0,4,4,-7,-1,-1,2,1,8,0,2,0,1,1,4,0,2,0,1,0,4,0,0,0,30,8,22,19,11,8,17,-10,-3,-1,-7,30,10,-3,0,-2,-5,4,7,-7,-3,1,-2,26,7,2,8,0,1,0,5,0,5,0,0,0,2,2,3,0,1,0,-18,-17,-1,11,3,8,2,-1,-12,4,-12,1,-1,-2,-9,0,-6,1,3,1,-3,4,-6,0,2,3,3,0,3,0,1,1,0,0,1,0,1,2,3,0,2,0,20,13,7,13,7,6,1,10,-4,9,-2,5,7,2,-2,4,-1,4,-6,8,-2,5,-1,1,1,6,3,2,0,1,1,3,0,2,0,1,0,3,3,0,0,0,-11,-13,2,10,3,7,20,0,-9,-15,-5,-3,7,-6,0,-11,-3,-1,13,6,-9,-4,-2,-2,6,1,3,0,0,0,2,0,1,0,0,0,4,1,2,0,0,0,97,58,39,29,21,8,26,22,28,16,-2,7,17,14,15,10,-3,4,9,8,13,6,1,3,8,7,5,6,3,0,7,5,1,5,3,0,1,2,4,1,0,0,211,120,91,66,39,27,54,24,77,30,4,10,28,7,48,31,1,1,26,17,29,-1,3,9,11,13,18,17,5,0,6,3,12,16,2,0,5,10,6,1,3,0,109,79,30,56,31,25,14,32,39,12,17,-10,10,14,31,11,11,-1,4,18,8,1,6,-9,6,18,14,10,6,1,3,7,9,8,3,1,3,11,5,2,3,0,29,4,25,41,18,23,6,-6,20,6,5,-4,4,-4,2,1,2,-1,2,-2,18,5,3,-3,9,10,12,6,3,0,6,2,7,2,1,0,3,8,5,4,2,0,39,16,23,23,11,12,8,0,13,10,7,-1,2,-3,9,-1,4,1,6,3,4,11,3,-2,4,2,5,10,0,0,0,0,3,5,1,0,4,2,2,5,-1,0,22,7,15,13,9,4,-2,-9,17,4,6,1,-1,-3,1,7,3,-3,-1,-6,16,-3,3,4,2,4,6,0,0,0,0,4,4,0,0,0,2,0,2,0,0,0,0,-2,2,-22,-12,-10,17,1,5,-16,-5,1,11,-2,3,-11,-4,1,6,3,2,-5,-1,0,0,0,-8,-8,-5,-1,-1,1,-4,-5,-2,-1,1,-1,-4,-3,-3,0,-33,-7,-26,-17,-16,-1,-3,-1,-9,-3,-8,-9,-5,0,-2,3,-3,1,2,-1,-7,-6,-5,-10,-3,-1,-3,-5,-6,0,-4,-2,-3,-3,-4,0,1,1,0,-2,-2,0,-18,-2,-16,7,9,-2,-13,1,2,-1,1,-7,-9,4,1,0,0,1,-4,-3,1,-1,1,-8,-2,1,0,5,3,0,1,1,1,4,2,0,-3,0,-1,1,1,0,11,11,0,-18,-13,-5,10,1,3,1,1,-5,10,3,6,-1,-6,0,0,-2,-3,2,7,-5,1,4,-10,-7,-5,-1,3,2,-5,-6,-6,-1,-2,2,-5,-1,1,0,-17,-3,-14,17,5,12,1,3,-7,-15,4,-4,-2,4,1,-7,2,-1,3,-1,-8,-8,2,-3,6,4,2,1,4,0,0,2,1,0,2,0,6,2,1,1,2,0,-38,-18,-20,20,10,10,-2,6,-24,-3,-7,-2,-4,4,-14,1,2,-3,2,2,-10,-4,-9,1,6,5,4,3,0,2,4,4,0,1,1,0,2,1,4,2,-1,2
34,34225,Villamuriel de Cerrato,4649,144,71,73,27,14,13,10,31,70,6,9,14,6,8,44,2,2,7,4,23,26,4,7,7,2,7,11,6,1,0,1,4,6,2,1,0,1,3,5,4,0,0,104,55,49,27,16,11,22,24,50,5,-6,4,10,16,26,6,-8,0,12,8,24,-1,2,4,5,10,9,2,1,0,3,6,5,1,1,0,2,4,4,1,0,0,68,29,39,19,10,9,14,-5,45,1,4,10,7,-6,13,7,5,2,7,1,32,-6,-1,8,6,6,3,1,1,2,5,2,1,1,0,1,1,4,2,0,1,1,111,58,53,18,6,12,27,16,43,7,16,-1,8,11,22,4,9,2,19,5,21,3,7,-3,6,2,4,2,4,0,2,0,1,2,1,0,4,2,3,0,3,0,96,70,26,18,8,10,18,14,48,6,2,3,15,7,32,10,1,1,3,7,16,-4,1,2,2,7,6,2,1,0,1,3,3,1,0,0,1,4,3,1,1,0,155,108,47,25,14,11,27,24,65,36,-2,1,25,25,33,26,-2,0,2,-1,32,10,0,1,4,5,9,4,3,0,1,2,5,4,2,0,3,3,4,0,1,0,159,91,68,41,16,25,28,17,62,23,13,14,11,7,43,14,9,7,17,10,19,9,4,7,8,9,13,4,5,0,2,3,5,2,2,0,6,6,8,2,3,0,81,24,57,46,22,24,20,8,33,21,5,-8,3,-3,13,14,1,-4,17,11,20,7,4,-4,8,15,9,12,2,0,3,8,5,6,0,0,5,7,4,6,2,0,98,47,51,26,8,18,22,10,27,17,16,7,13,3,10,12,9,-2,9,7,17,5,7,9,8,9,6,-1,3,0,4,5,-1,-2,1,0,4,4,7,1,2,0,-3,3,-6,19,3,16,-3,-1,6,6,-12,0,1,2,1,2,-5,0,-4,-3,5,4,-7,0,3,7,7,1,1,0,1,3,0,-1,0,0,2,4,7,2,1,0,20,-6,26,17,4,13,1,2,10,5,-3,7,-4,0,-2,1,-4,5,5,2,12,4,1,2,3,8,-2,5,2,0,1,3,-1,1,0,0,2,5,-1,4,2,0,-9,-12,3,2,3,-1,-6,-10,-3,15,-2,-6,-6,-3,1,-1,-1,-5,0,-7,-4,16,-1,-1,-2,1,0,3,-1,0,-1,0,2,2,-1,0,-1,1,-2,1,0,0,25,11,14,3,2,1,15,6,7,0,-4,-4,10,-4,8,3,-1,-4,5,10,-1,-3,-3,0,3,4,2,-2,-4,-1,2,1,2,0,-2,-1,1,3,0,-2,-2,0,-5,-3,-2,-13,-7,-6,11,-9,3,2,-8,-4,4,-12,0,8,-4,-1,7,3,3,-6,-4,-3,-6,1,-4,-2,-3,0,-4,-3,1,1,-2,0,-2,4,-5,-3,-1,0,-102,-37,-65,-12,-6,-6,-19,-8,-40,-22,-17,-1,-7,0,-19,-8,-7,1,-12,-8,-21,-14,-10,-2,-3,1,-7,-3,-2,1,-1,0,-4,-2,0,0,-2,1,-3,-1,-2,1,13,3,10,4,-3,7,18,4,8,-12,-10,4,4,6,5,-11,-4,2,14,-2,3,-1,-6,2,3,3,1,-5,0,1,2,1,-2,-5,0,0,1,2,3,0,0,1,59,33,26,22,11,11,15,11,43,-12,-2,-6,5,1,25,1,-4,-1,10,10,18,-13,2,-5,7,7,6,1,1,1,2,3,4,2,1,0,5,4,2,-1,0,1,5,4,1,17,5,12,3,-7,2,-1,6,-3,-5,5,2,-2,3,-2,8,-12,0,1,3,-1,5,2,4,0,4,2,1,2,1,-2,2,1,4,0,3,2,2,1
35,35001,Agaete,5789,-141,-68,-73,21,12,9,-23,-23,-65,-28,-1,0,-6,-12,-35,-15,0,0,-17,-11,-30,-13,-1,0,3,2,2,6,3,5,3,1,2,2,2,2,0,1,0,4,1,3,4,15,-11,33,20,13,-6,7,11,-4,-2,-1,-1,9,15,-5,-5,2,-5,-2,-4,1,3,-3,9,7,8,3,5,1,5,4,7,1,3,0,4,3,1,2,2,1,16,15,1,12,8,4,-10,17,-17,7,22,-4,-3,12,-7,3,11,-1,-7,5,-10,4,11,-3,-1,1,0,0,11,1,1,1,1,0,4,1,-2,0,-1,0,7,0,37,20,17,11,3,8,9,0,7,10,0,9,5,3,2,3,2,2,4,-3,5,7,-2,7,3,2,2,3,0,1,1,1,0,2,-2,1,2,1,2,1,2,0,74,33,41,15,6,9,22,7,20,16,3,1,9,5,9,5,1,0,13,2,11,11,2,1,4,0,6,3,2,0,1,0,2,2,1,0,3,0,4,1,1,0,47,18,29,22,12,10,4,3,2,23,12,5,-6,-3,9,11,7,2,10,6,-7,12,5,3,3,4,6,2,7,0,2,1,3,1,5,0,1,3,3,1,2,0,58,16,42,24,9,15,-5,3,19,24,10,2,-6,1,4,10,7,-2,1,2,15,14,3,4,4,2,6,4,5,3,1,1,2,3,2,0,3,1,4,1,3,3,28,10,18,26,12,14,1,0,-10,12,21,2,-1,-2,-5,8,6,1,2,2,-5,4,15,1,5,4,5,5,4,3,3,0,1,4,1,3,2,4,4,1,3,0,48,16,32,12,6,6,2,-6,9,29,14,-2,-5,-8,5,17,8,-1,7,2,4,12,6,-1,1,0,3,3,4,1,-1,0,3,0,3,1,2,0,0,3,1,0,-24,5,-29,17,5,12,-13,1,3,-8,5,-6,3,5,3,1,-2,-2,-16,-4,0,-9,7,-4,1,1,4,1,10,0,0,1,1,0,3,0,1,0,3,1,7,0,41,21,20,13,6,7,-12,2,5,25,21,-4,-3,-1,2,15,11,-3,-9,3,3,10,10,-1,3,1,3,2,3,1,2,0,1,1,2,0,1,1,2,1,1,1,24,5,19,16,4,12,8,11,9,3,-2,-5,1,2,8,-2,-3,-1,7,9,1,5,1,-4,3,2,4,5,4,-2,1,1,1,1,2,-2,2,1,3,4,2,0,38,9,29,5,3,2,7,2,27,-3,-1,2,-1,-2,15,-3,0,-1,8,4,12,0,-1,3,0,-1,5,1,0,0,1,-1,1,2,1,-1,-1,0,4,-1,-1,1,-26,-15,-11,-4,0,-4,-12,-7,-2,-7,7,-5,-3,-4,-4,-5,0,0,-9,-3,2,-2,7,-5,-2,-5,2,0,6,-5,0,-2,0,1,2,-1,-2,-3,2,-1,4,-4,-10,-8,-2,16,9,7,5,9,-8,-13,0,-1,3,0,-2,-6,0,-1,2,9,-6,-7,0,0,1,3,1,8,2,0,0,1,0,4,2,1,1,2,1,4,0,-1,-35,-29,-6,-2,-5,3,-13,8,-5,5,-10,-25,-12,5,-14,-2,-1,-8,-1,3,9,7,-9,-17,5,2,-1,7,1,-16,1,1,-3,3,2,-9,4,1,2,4,-1,-7,-5,3,-8,33,14,19,1,2,-15,-8,9,6,4,1,-2,-7,6,2,-3,1,-13,-1,3,4,5,7,3,9,1,7,3,1,2,5,0,3,2,6,1,4,1,4,96,50,46,36,18,18,7,18,20,6,28,11,0,7,15,3,17,5,7,11,5,3,11,6,7,2,9,0,14,5,3,3,4,1,6,2,4,-1,5,-1,8,3
35,35002,Agüimes,19933,730,421,309,271,165,106,101,134,315,71,75,30,55,72,176,55,44,13,46,62,139,16,31,17,38,55,87,46,33,12,18,36,56,31,18,6,20,19,31,15,15,6,815,459,356,308,166,142,95,152,314,153,89,14,43,84,192,82,51,6,52,68,122,71,38,8,60,49,96,61,34,5,33,25,54,32,18,1,27,24,42,29,16,4,902,487,415,338,180,158,118,181,381,108,70,31,56,89,225,57,39,14,62,92,156,51,31,17,77,57,116,51,25,9,39,27,66,28,15,5,38,30,50,23,10,4,1077,544,533,312,163,149,133,234,367,189,99,30,68,114,181,111,48,9,65,120,186,78,51,21,64,72,78,58,29,9,34,38,41,31,12,5,30,34,37,27,17,4,860,416,444,316,169,147,128,193,319,127,42,31,43,85,177,67,27,12,85,108,142,60,15,19,48,67,84,69,36,9,20,35,46,44,19,5,28,32,38,25,17,4,758,397,361,238,100,138,169,126,226,153,60,24,91,61,109,91,33,12,78,65,117,62,27,12,42,52,70,51,16,7,16,14,31,29,10,0,26,38,39,22,6,7,862,399,463,285,127,158,155,120,346,127,61,36,89,39,168,56,25,16,66,81,178,71,36,20,61,44,88,38,36,11,33,21,36,16,12,5,28,23,52,22,24,6,624,336,288,215,112,103,80,120,218,128,52,19,29,54,133,77,30,10,51,66,85,51,22,9,40,57,53,47,14,1,25,30,29,17,9,1,15,27,24,30,5,0,560,288,272,216,97,119,109,113,160,92,41,29,67,47,87,59,8,11,42,66,73,33,33,18,36,39,44,53,33,11,16,13,23,27,14,4,20,26,21,26,19,7,352,152,200,29,24,5,55,61,145,36,30,17,14,17,61,29,13,10,41,44,84,7,17,7,26,13,12,-24,-4,4,13,12,7,-12,-3,7,13,1,5,-12,-1,-3,217,61,156,101,39,62,39,54,16,25,-3,88,27,8,8,0,-13,35,12,46,8,25,10,53,7,23,19,31,10,7,2,13,5,14,5,-1,5,10,14,17,5,8,136,23,113,44,6,38,21,22,25,1,29,36,17,6,-2,-28,3,23,4,16,27,29,26,13,19,1,-15,24,16,-1,9,-6,-8,9,1,1,10,7,-7,15,15,-2,259,132,127,6,1,5,76,4,74,72,8,13,42,15,50,18,-3,0,34,-11,24,54,11,13,-2,1,1,-3,6,2,-2,-1,7,-3,1,-1,0,2,-6,0,5,3,123,94,29,7,6,1,-30,20,94,-12,22,20,-3,26,54,-4,10,10,-27,-6,40,-8,12,10,9,-1,10,-2,-6,-3,6,2,9,-8,-4,2,3,-3,1,6,-2,-5,-30,6,-36,6,-12,18,-21,10,9,-44,9,7,-4,-9,23,-34,11,11,-17,19,-14,-10,-2,-4,5,-1,-11,0,15,-2,2,-7,-8,-2,3,0,3,6,-3,2,12,-2,290,146,144,38,16,22,43,53,81,53,10,46,18,13,29,53,14,13,25,40,52,0,-4,33,2,10,0,16,5,3,-8,6,4,9,2,2,10,4,-4,7,3,1,141,101,40,-120,-75,-45,-3,12,75,23,44,-13,-8,24,36,23,29,-7,5,-12,39,0,15,-6,7,0,2,-53,-27,-49,2,3,-3,-34,-17,-26,5,-3,5,-19,-10,-23,244,102,142,155,77,78,59,28,52,-2,74,24,31,0,16,-19,49,22,28,28,36,17,25,2,55,20,31,20,27,0,28,9,11,10,11,6,27,11,20,10,16,-6
35,35020,"Aldea de San Nicolás, La",8073,-48,-28,-20,21,12,9,-4,3,-29,-13,5,-11,3,2,-18,-11,2,-7,-7,1,-11,-2,3,-4,5,3,7,5,1,0,2,2,5,3,0,0,3,1,2,2,1,0,-21,-10,-11,40,14,26,6,5,-25,2,0,-7,9,0,-12,0,-2,-4,-3,5,-13,2,2,-3,10,13,4,9,4,0,5,3,2,3,1,0,5,10,2,6,3,0,12,16,-4,39,25,14,-4,11,-4,11,0,1,-7,13,-4,11,0,3,3,-2,0,0,0,-2,6,14,11,5,3,0,3,9,8,4,1,0,3,5,3,1,2,0,-41,-19,-22,26,17,9,-15,-7,-24,-4,9,-2,-14,-2,-11,0,9,0,-1,-5,-13,-4,0,-2,2,7,12,3,1,0,1,4,8,3,1,0,1,3,4,0,0,0,167,138,29,193,148,45,-1,59,76,31,5,-4,-3,49,61,32,1,-4,2,10,15,-1,4,0,4,61,88,33,5,1,4,51,62,27,2,1,0,10,26,6,3,0,152,115,37,218,142,76,-17,48,86,33,7,-2,-13,43,61,17,6,1,-4,5,25,16,1,-3,2,53,123,36,3,1,0,40,78,21,2,1,2,13,45,15,1,0,80,18,62,253,117,136,-28,20,79,16,-7,1,-10,19,29,-15,-7,2,-18,1,50,31,0,-1,8,62,119,61,1,1,1,39,56,18,1,1,7,23,63,43,0,0,26,-9,35,236,108,128,-27,19,19,24,-6,-1,-14,7,3,-1,-5,1,-13,12,16,25,-1,-2,9,39,115,67,3,1,3,23,51,27,1,1,6,16,64,40,2,0,-14,-10,-4,124,63,61,-14,26,-26,18,-5,-12,-13,10,-10,12,-2,-6,-1,16,-16,6,-3,-6,8,35,49,30,3,-1,4,21,25,11,3,-1,4,14,24,19,0,0,86,75,11,127,66,61,14,28,21,22,6,-6,10,16,18,24,5,0,4,12,3,-2,1,-6,15,31,42,35,3,0,9,13,21,19,3,0,6,18,21,16,0,0,49,42,7,112,62,50,5,14,5,13,12,-3,2,16,6,10,10,-4,3,-2,-1,3,2,1,19,29,33,24,5,1,13,20,16,9,4,0,6,9,17,15,1,1,1,-2,3,108,53,55,9,32,-16,-15,-2,-10,4,15,-9,-6,1,-8,5,17,-7,-9,-3,-2,26,37,24,15,4,0,14,16,11,9,2,0,12,21,13,6,2,0,-34,-13,-21,43,16,27,0,20,-27,-21,-2,-5,-1,11,-20,-5,0,1,1,9,-7,-16,-2,-6,15,24,-1,2,2,0,8,11,-4,0,0,0,7,13,3,2,2,0,-112,-70,-42,10,6,4,-15,-9,-52,-39,5,-2,-14,0,-28,-23,-4,-1,-1,-9,-24,-16,9,-1,4,6,-1,0,1,0,2,5,-2,1,0,0,2,1,1,-1,1,0,-170,-86,-84,-33,-23,-10,-29,-22,-71,-38,-5,-7,-16,-14,-38,-16,-2,-1,-13,-8,-33,-22,-3,-6,-4,0,-18,-7,-3,-2,-2,-1,-12,-4,-4,0,-2,1,-6,-3,1,-2,-46,-11,-35,21,5,16,-18,-10,2,-11,1,-10,-8,-3,7,-7,1,-2,-10,-7,-5,-4,0,-8,1,9,13,-2,0,0,-2,4,7,-5,0,1,3,5,6,3,0,-1,-72,-39,-33,55,26,29,-12,0,-35,-30,4,1,-8,0,-25,-6,1,-2,-4,0,-10,-24,3,3,6,21,13,6,3,5,3,10,5,4,1,2,3,11,8,2,2,3,-448,-230,-218,-399,-209,-190,-12,-10,-101,-272,-46,-13,-13,-5,-52,-129,-27,-6,1,-5,-49,-143,-19,-7,-1,-4,-82,-260,-45,-9,-1,-1,-48,-126,-27,-6,0,-3,-34,-134,-18,-3
35,35003,Antigua,4240,985,604,381,481,272,209,92,284,349,186,49,9,52,144,228,138,33,1,40,140,121,48,16,8,71,88,176,108,26,4,38,40,108,68,16,0,33,48,68,40,10,4,877,514,363,490,293,197,127,250,278,163,47,8,63,147,165,107,28,2,64,103,113,56,19,6,94,87,168,106,27,6,54,49,99,71,17,3,40,38,69,35,10,3,396,245,151,250,148,102,57,91,90,101,35,12,39,57,44,67,24,8,18,34,46,34,11,4,33,57,68,69,20,0,22,27,41,42,14,0,11,30,27,27,6,0,399,227,172,411,221,190,57,69,62,118,79,12,21,26,46,72,50,12,36,43,16,46,29,0,64,66,115,99,53,11,33,30,61,56,33,8,31,36,54,43,20,3,619,320,299,518,273,245,79,137,172,139,74,16,37,68,97,71,38,10,42,69,75,68,36,6,82,94,134,116,72,13,47,45,70,60,39,9,35,49,64,56,33,4,671,342,329,500,262,238,82,127,176,163,112,2,40,57,95,86,58,2,42,70,81,77,54,0,66,72,134,110,103,11,31,31,74,62,53,8,35,41,60,48,50,3,837,440,397,581,289,292,43,176,237,196,141,36,30,86,136,104,60,18,13,90,101,92,81,18,59,96,135,145,111,25,40,52,53,74,53,12,19,44,82,71,58,13,511,235,276,575,309,266,64,91,114,103,111,12,26,54,48,31,58,5,38,37,66,72,53,7,83,95,125,136,108,20,47,58,67,68,54,10,36,37,58,68,54,10,38,-18,56,312,149,163,-39,43,-86,35,58,13,-24,17,-59,2,31,5,-15,26,-27,33,27,8,23,78,50,70,75,6,10,37,23,27,43,2,13,41,27,43,32,4,-37,-35,-2,266,135,131,-21,-6,-83,-14,67,24,0,3,-60,-13,29,8,-21,-9,-23,-1,38,16,24,30,30,72,85,20,15,12,8,40,43,14,9,18,22,32,42,6,58,24,34,149,85,64,26,22,-36,-17,53,15,27,-4,-14,-18,28,8,-1,26,-22,1,25,7,13,22,3,25,67,14,13,3,2,11,43,9,0,19,1,14,24,5,559,274,285,373,167,206,77,115,85,107,121,40,32,59,28,59,63,24,45,56,57,48,58,16,35,78,44,70,105,33,18,27,17,34,50,17,17,51,27,36,55,16,395,198,197,404,189,215,4,109,32,79,120,47,6,52,28,25,54,31,-2,57,4,54,66,16,34,71,71,76,117,32,14,32,34,34,51,22,20,39,37,42,66,10,132,51,81,171,77,94,-13,76,16,-30,52,24,-11,24,10,-13,26,11,-2,52,6,-17,26,13,11,58,16,6,58,18,3,21,7,8,25,11,8,37,9,-2,33,7,-324,-184,-140,-295,-195,-100,-47,-2,-40,-93,-105,-40,-17,-13,-13,-58,-63,-20,-30,11,-27,-35,-42,-20,-38,6,-48,-94,-93,-32,-29,-15,-33,-58,-53,-9,-9,21,-15,-36,-40,-23,42,31,11,24,-9,33,-11,2,30,57,-16,-38,5,-9,22,29,0,-29,-16,11,8,28,-16,-9,-7,-1,10,42,12,-37,-6,-9,2,16,13,-26,-1,8,8,26,-1,-11,166,101,65,135,76,59,9,42,46,23,61,-16,9,16,27,25,27,-3,0,26,19,-2,34,-13,8,27,20,14,75,-14,0,10,17,14,35,-1,8,17,3,0,40,-13,474,234,240,308,146,162,53,70,123,57,152,20,21,36,68,17,73,28,32,34,55,40,79,-8,35,27,60,43,122,14,19,17,25,7,55,21,16,10,35,36,67,-7
35,35004,Arrecife,42231,1657,841,816,1523,811,712,254,473,611,287,38,-8,121,229,348,129,15,-9,133,244,263,158,23,1,263,306,606,274,47,15,127,159,345,141,25,7,136,147,261,133,22,8,2024,1015,1009,1792,883,909,426,498,630,352,82,26,219,267,319,167,33,8,207,231,311,185,49,18,423,373,597,309,66,14,210,180,291,163,31,4,213,193,306,146,35,10,1433,745,688,1796,941,855,215,461,445,306,3,21,127,188,256,169,7,6,88,273,189,137,-4,15,377,400,567,367,58,16,212,179,316,195,29,5,165,221,251,172,29,11,894,509,385,1347,745,602,135,360,203,181,25,-1,70,194,147,76,11,8,65,166,56,105,14,-9,292,342,379,227,76,20,161,189,221,121,31,15,131,153,158,106,45,5,1430,864,566,1514,935,579,221,455,426,228,72,31,113,267,301,150,27,9,108,188,125,78,45,22,268,362,501,257,93,23,149,222,341,163,46,8,119,140,160,94,47,15,1348,772,576,1406,791,615,233,429,401,263,52,2,103,253,258,172,10,-9,130,176,143,91,42,11,289,349,399,266,71,23,155,206,239,154,31,3,134,143,160,112,40,20,1437,806,631,1455,755,700,308,525,372,222,3,-1,161,277,248,125,-6,-9,147,248,124,97,9,8,332,366,404,256,68,21,166,189,221,145,24,7,166,177,183,111,44,14,1533,873,660,1873,979,894,364,555,358,256,44,-35,223,312,193,165,-6,-10,141,243,165,91,50,-25,462,491,479,320,97,14,256,268,255,159,31,5,206,223,224,161,66,9,-305,-223,-82,1070,520,550,-113,185,-139,-182,-15,-33,-89,90,-76,-113,-1,-20,-24,95,-63,-69,-14,-13,250,300,285,160,50,7,116,146,141,83,27,-1,134,154,144,77,23,8,-1500,-984,-516,-26,-93,67,-224,-111,-546,-450,-122,-27,-129,-91,-338,-312,-92,-11,-95,-20,-208,-138,-30,-16,47,61,-45,-73,-29,4,14,18,-50,-75,-12,6,33,43,5,2,-17,-2,-1066,-569,-497,74,-17,91,-156,-56,-444,-261,-85,-61,-51,-30,-266,-171,-28,-23,-105,-26,-178,-90,-57,-38,57,61,-55,7,0,-5,39,20,-58,-20,-3,-1,18,41,3,27,3,-4,-588,-423,-165,9,-56,65,23,77,-321,-253,-78,-40,-16,33,-189,-178,-46,-25,39,44,-132,-75,-32,-15,113,95,-73,-91,-35,-7,43,57,-58,-77,-25,1,70,38,-15,-14,-10,-8,-303,-267,-36,-411,-291,-120,5,79,-142,-157,-76,-32,0,14,-92,-138,-54,-10,5,65,-50,-19,-22,-22,-17,-14,-144,-140,-85,-19,-9,-26,-109,-90,-47,-14,-8,12,-35,-50,-38,-5,-197,-151,-46,-293,-221,-72,-71,55,39,-163,-73,10,-12,-2,1,-94,-45,-1,-59,57,38,-69,-28,11,-48,13,-53,-147,-54,-5,-20,-10,-43,-100,-45,-3,-28,23,-10,-47,-9,-2,259,132,127,-268,-174,-94,117,163,52,-43,-33,-27,52,66,58,-14,-35,-10,65,97,-6,-29,2,-17,18,18,-91,-148,-54,-12,14,6,-55,-99,-36,-4,4,12,-36,-49,-18,-8,1183,536,647,545,307,238,218,303,388,197,107,-25,103,158,191,72,27,-12,115,145,197,125,80,-13,84,146,151,79,65,17,53,80,97,30,32,13,31,66,54,49,33,4,1457,838,619,684,296,388,232,336,345,349,121,38,142,176,230,189,71,8,90,160,115,160,50,30,143,180,130,104,69,39,87,86,69,24,14,6,56,94,61,80,55,33,1389,687,702,930,437,493,215,374,452,299,43,-6,121,168,211,167,21,-7,94,206,241,132,22,1,203,253,262,179,13,9,125,121,118,63,3,2,78,132,144,116,10,7
35,35006,Arucas,31175,402,224,178,68,35,33,44,39,203,64,39,4,22,23,114,40,21,-1,22,16,89,24,18,5,7,13,19,14,8,6,4,3,13,10,3,2,3,10,6,4,5,4,175,75,100,67,30,37,8,37,94,21,16,1,7,18,52,-3,7,-4,1,19,42,24,9,5,13,18,12,13,10,1,6,9,5,4,6,0,7,9,7,9,4,1,152,36,116,83,43,40,16,5,101,40,10,-16,-13,-7,36,25,2,-9,29,12,65,15,8,-7,28,10,25,11,9,0,16,5,16,2,4,0,12,5,9,9,5,0,192,110,82,55,26,29,-18,24,144,18,14,9,0,12,89,3,7,1,-18,12,55,15,7,8,8,11,18,5,7,5,5,4,9,3,4,0,3,7,9,2,3,5,352,184,168,67,29,38,22,56,199,77,-6,6,11,25,99,55,-10,5,11,31,100,22,4,1,13,19,15,19,1,0,5,7,5,12,0,0,8,12,10,7,1,0,518,247,271,74,31,43,70,90,196,110,30,14,28,39,99,65,9,7,42,51,97,45,21,7,19,21,11,14,4,2,6,12,3,6,2,2,13,9,8,8,2,0,315,140,175,52,19,33,66,73,156,26,-21,7,37,32,71,19,-15,-2,29,41,85,7,-6,9,6,18,8,9,9,2,-1,5,5,5,3,2,7,13,3,4,6,0,196,104,92,60,27,33,-6,44,110,-8,35,16,8,15,63,-13,19,10,-14,29,47,5,16,6,9,10,16,11,10,3,7,3,9,5,3,0,2,7,7,6,7,3,456,217,239,82,45,37,71,52,280,29,20,-6,21,21,138,17,10,6,50,31,142,12,10,-12,13,13,23,18,8,4,10,10,9,6,5,3,3,3,14,12,3,1,340,153,187,47,23,24,32,36,155,67,10,38,22,-2,82,26,6,15,10,38,73,41,4,23,10,9,11,12,2,2,7,1,7,5,1,1,3,8,4,7,1,1,75,-3,78,47,25,22,40,35,49,-29,-4,-17,2,7,13,-15,-6,-8,38,28,36,-14,2,-9,12,9,10,8,8,-1,4,6,8,4,3,-1,8,3,2,4,5,0,41,59,-18,60,28,32,-41,23,13,24,17,-4,-2,14,41,0,11,-3,-39,9,-28,24,6,-1,18,10,12,14,7,-2,6,6,8,5,3,-1,12,4,4,9,4,-1,50,33,17,19,8,11,15,-7,23,4,6,2,12,-4,-4,15,5,5,3,-3,27,-11,1,-3,6,6,3,8,-1,-3,4,2,0,2,0,0,2,4,3,6,-1,-3,65,29,36,37,10,27,29,12,41,-11,-2,-6,31,4,25,-23,-1,-3,-2,8,16,12,-1,-3,7,6,15,6,2,0,5,1,2,3,-1,-1,2,5,13,3,3,1,6,-29,35,13,0,13,-41,10,50,-6,-8,6,-23,6,2,-7,-9,3,-18,4,48,1,1,3,6,11,-1,-4,-1,2,6,3,-2,-8,0,1,0,8,1,4,-1,1,185,90,95,38,16,22,35,44,46,17,5,35,26,6,41,4,-10,24,9,38,5,13,15,11,8,11,12,7,-3,2,6,1,3,6,-3,2,2,10,9,1,0,0,145,68,77,48,13,35,1,2,50,29,33,20,-8,7,19,15,9,15,9,-5,31,14,24,5,12,11,1,13,10,0,8,8,-1,-4,3,-2,4,3,2,17,7,2,331,169,162,128,61,67,77,16,105,66,15,26,46,10,31,43,15,10,31,6,74,23,0,16,40,13,32,28,4,8,21,2,14,19,0,3,19,11,18,9,4,5
35,35008,Firgas,6747,54,31,23,17,11,6,-2,23,7,22,5,0,-2,17,7,7,2,0,0,6,0,15,3,0,1,5,6,1,4,0,1,3,5,0,2,0,0,2,1,1,2,0,24,11,13,7,4,3,-6,5,-4,18,13,-2,-1,0,-8,11,9,0,-5,5,4,7,4,-2,1,2,1,1,0,0,1,1,0,1,0,0,0,1,1,0,0,0,114,77,37,-3,-2,-1,28,32,23,21,7,5,17,25,14,18,4,1,11,7,9,3,3,4,-1,0,0,-1,-1,0,-1,0,-1,0,0,0,0,0,1,-1,-1,0,2,2,0,13,7,6,11,-6,-6,8,6,-7,2,0,-1,1,6,-7,9,-6,-5,7,0,0,4,1,3,4,1,0,1,1,2,2,1,0,3,0,1,2,0,0,23,15,8,6,2,4,7,3,15,5,-7,3,11,6,1,-1,0,1,-4,-3,14,6,-7,2,2,2,1,0,0,0,1,1,0,0,0,0,1,1,1,0,0,0,-12,0,-12,4,1,3,-13,-14,25,-6,0,-4,-5,-11,15,-4,5,0,-8,-3,10,-2,-5,-4,2,2,0,0,0,0,0,1,0,0,0,0,2,1,0,0,0,0,98,61,37,24,24,0,-4,28,18,33,12,5,-13,17,17,22,7,5,9,11,1,11,5,0,-1,5,6,12,2,0,0,5,6,11,2,0,-1,0,0,1,0,0,59,48,11,16,13,3,7,2,20,35,-12,4,8,1,11,24,-2,3,-1,1,9,11,-10,1,3,2,2,7,0,0,2,2,2,4,1,0,1,0,0,3,-1,0,85,47,38,5,5,0,10,12,32,19,5,-2,10,3,17,12,6,-3,0,9,15,7,-1,1,-3,3,3,0,-1,0,-1,2,4,0,-1,0,-2,1,-1,0,0,0,31,15,16,14,5,9,22,13,1,2,3,-13,11,3,6,-1,3,-5,11,10,-5,3,0,-8,10,2,0,2,0,-1,5,0,-1,1,0,0,5,2,1,1,0,-1,60,45,15,5,2,3,10,1,32,21,-1,-3,9,-1,25,14,-2,0,1,2,7,7,1,-3,0,1,2,1,1,0,0,1,0,1,0,0,0,0,2,0,1,0,-16,-19,3,2,0,2,13,-20,0,-14,2,-1,3,-14,-3,-9,1,2,10,-6,3,-5,1,-3,1,0,0,-2,1,1,-1,1,0,-2,0,1,2,-1,0,0,1,0,-59,-52,-7,-31,-33,2,15,-11,-21,-10,-20,-9,6,-2,-17,-20,-14,-6,9,-9,-4,10,-6,-3,-3,0,-3,-18,-7,0,-3,-1,-4,-18,-7,0,0,1,1,0,0,0,17,1,16,6,-1,7,9,-1,-18,4,18,-2,-1,-6,-9,7,5,2,10,5,-9,-3,13,-4,1,3,-3,3,3,-1,0,0,-3,2,0,0,1,3,0,1,3,-1,-99,-64,-35,6,4,2,-20,-8,-21,-17,-22,-13,-11,-7,-18,-6,-17,-6,-9,-1,-3,-11,-5,-7,2,1,4,1,0,-2,2,0,3,0,0,-1,0,1,1,1,0,-1,26,16,10,14,5,9,13,5,28,-17,-6,-4,10,4,10,-10,4,-4,3,1,18,-7,-10,0,4,1,3,1,2,3,2,0,2,-1,2,0,2,1,1,2,0,3,105,55,50,26,13,13,40,16,43,9,1,-6,19,5,32,0,-2,-1,21,11,11,9,3,-5,7,2,6,3,5,3,3,1,5,0,2,2,4,1,1,3,3,1,-76,-31,-45,8,10,-2,-10,11,-30,-32,-3,-12,1,7,-15,-15,-5,-3,-11,4,-15,-17,2,-9,-4,5,1,3,3,0,0,3,2,2,3,0,-4,2,-1,1,0,0
35,35009,Gáldar,22220,192,111,81,56,34,22,31,41,56,31,23,6,9,21,41,18,15,5,22,20,15,13,8,1,6,12,13,16,4,3,4,3,10,13,2,0,2,9,3,3,2,3,228,130,98,40,24,16,43,66,74,36,7,1,20,45,40,20,5,0,23,21,34,16,2,1,12,13,9,3,3,0,7,12,3,1,1,0,5,1,6,2,2,0,156,71,85,42,28,14,23,34,50,34,14,-6,12,16,18,20,5,-4,11,18,32,14,9,-2,5,12,15,6,1,2,3,9,9,5,1,1,2,3,6,1,0,1,172,97,75,39,15,24,20,33,68,35,17,-3,12,18,41,15,13,-1,8,15,27,20,4,-2,5,5,10,13,2,3,2,3,3,7,0,0,3,2,7,6,2,3,141,101,40,40,18,22,15,55,28,29,21,-8,22,29,30,10,10,-4,-7,26,-2,19,11,-4,5,6,9,8,12,0,1,4,4,3,6,0,4,2,5,5,6,0,164,81,83,73,36,37,37,9,52,39,10,8,25,2,17,26,5,2,12,7,35,13,5,6,15,11,18,21,3,4,6,4,13,9,3,1,9,7,5,12,0,3,52,29,23,65,38,27,5,25,4,7,9,4,5,24,7,-5,-1,0,0,1,-3,12,10,4,5,14,21,13,7,5,3,10,14,4,3,4,2,4,7,9,4,1,129,69,60,93,37,56,36,16,25,41,13,-5,13,1,8,39,5,-1,23,15,17,2,8,-4,10,20,28,31,4,0,5,7,11,12,1,0,5,13,17,19,3,0,60,39,21,74,31,43,16,26,2,-3,14,1,11,10,5,-4,8,8,5,16,-3,1,6,-7,13,12,30,16,3,0,6,5,16,5,-1,0,7,7,14,11,4,0,40,19,21,45,22,23,10,9,-1,-1,8,9,11,13,-4,-9,0,4,-1,-4,3,8,8,5,13,7,13,8,4,0,6,3,6,6,1,0,7,4,7,2,3,0,-83,-43,-40,35,26,9,-11,-2,-35,-45,7,1,-10,4,-18,-25,0,4,-1,-6,-17,-20,7,-3,8,8,10,4,4,-1,7,6,7,2,3,0,1,2,3,2,1,-1,30,17,13,42,24,18,23,7,-3,3,14,-17,8,0,-9,11,13,-8,15,7,6,-8,1,-9,6,2,13,14,5,2,2,2,6,10,4,0,4,0,7,4,1,2,-61,-45,-16,17,7,10,-7,-4,-10,-7,-8,-16,1,-11,-12,-3,-5,-10,-8,7,2,-4,-3,-6,1,3,10,6,2,-4,1,2,6,0,0,-2,0,1,4,6,2,-2,-67,-34,-33,-25,-12,-13,1,9,-25,-24,-19,-12,9,-1,-13,-17,-11,-2,-8,10,-12,-7,-8,-10,2,-1,-3,-14,-7,-4,0,-4,0,-5,-3,-1,2,3,-3,-9,-4,-3,-27,-7,-20,-57,-39,-18,-10,10,8,-32,-9,5,-2,16,3,-19,-9,5,-8,-6,5,-13,0,0,-3,-2,-20,-19,-11,-2,-3,-3,-14,-9,-9,-1,0,1,-6,-10,-2,-1,106,54,52,-6,-11,5,41,8,35,1,18,-3,22,-4,20,4,14,-6,19,12,15,-3,4,3,2,4,0,-4,-2,-6,1,3,-2,-4,-5,-4,1,1,2,0,3,-2,72,35,37,47,18,29,8,-2,20,23,31,-13,4,0,10,10,16,-7,4,-2,10,13,15,-6,6,11,7,3,15,4,2,3,4,2,5,1,4,8,3,1,10,3,65,20,45,71,40,31,0,24,-20,6,54,1,-4,24,-18,-2,19,2,4,0,-2,8,35,-1,8,12,12,12,15,9,9,8,5,6,6,4,-1,4,7,6,9,5
35,35010,Haría,4022,139,90,49,114,67,47,43,34,16,28,13,4,33,18,5,19,11,4,10,16,11,9,2,0,22,11,28,32,16,5,15,8,13,19,9,3,7,3,15,13,7,2,211,115,96,101,44,57,24,19,72,48,37,9,13,11,37,27,23,3,11,8,35,21,14,6,16,9,29,23,19,4,8,2,10,10,12,1,8,7,19,13,7,3,263,117,146,123,58,65,26,50,68,49,62,4,11,25,30,21,27,1,15,25,38,28,35,3,12,18,26,34,29,2,8,10,12,14,11,1,4,8,14,20,18,1,195,98,97,86,47,39,16,37,46,37,54,3,9,21,17,20,34,-2,7,16,29,17,20,5,5,5,15,28,26,7,3,3,8,15,15,3,2,2,7,13,11,4,122,96,26,119,64,55,-5,26,48,9,29,13,3,16,29,19,18,9,-8,10,19,-10,11,4,12,19,27,22,29,8,8,4,18,12,15,5,4,15,9,10,14,3,166,100,66,115,64,51,6,24,29,41,54,7,12,15,12,22,29,7,-6,9,17,19,25,0,10,8,33,27,27,9,8,5,16,16,14,5,2,3,17,11,13,4,52,34,18,96,50,46,3,25,-21,24,14,9,3,10,-9,14,8,7,0,15,-12,10,6,2,14,12,15,29,18,7,8,3,6,18,10,5,6,9,9,11,8,2,120,67,53,107,57,50,-3,30,35,4,24,25,5,16,27,0,10,8,-8,14,8,4,14,17,12,8,23,21,27,16,7,6,11,13,12,8,5,2,12,8,15,8,64,22,42,54,20,34,5,7,3,16,18,15,0,6,-2,-1,12,8,5,1,5,17,6,7,3,7,12,16,8,8,1,1,6,6,4,2,2,6,6,10,4,6,10,4,6,35,17,18,-3,1,-5,-7,15,10,-9,4,1,-6,9,6,6,-3,-6,-1,6,4,4,5,0,7,13,6,0,3,1,3,7,3,4,2,-1,4,6,3,-18,-16,-2,32,15,17,-17,18,-29,-5,-2,15,-10,5,-17,-1,-4,10,-7,13,-12,-4,2,5,8,2,4,3,10,4,4,2,0,2,5,2,4,0,4,1,5,2,30,16,14,31,14,17,14,5,3,4,17,-12,5,6,7,3,2,-7,9,-1,-4,1,15,-5,2,5,4,6,15,-1,2,2,2,3,5,0,0,3,2,3,10,-1,-18,-16,-2,8,5,3,-11,-12,-7,-11,13,11,-11,-3,-3,-7,5,2,0,-9,-4,-4,8,9,3,-2,-3,-1,10,1,1,1,-4,0,6,1,2,-3,1,-1,4,0,-29,0,-29,23,9,14,-5,-7,-2,-7,-3,-3,0,-5,2,-2,6,0,-5,-2,-4,-5,-9,-3,0,0,5,10,7,1,0,-1,2,4,4,0,0,1,3,6,3,1,9,10,-1,-13,-5,-8,4,-3,-5,15,6,-8,3,-3,4,4,4,-4,1,0,-9,11,2,-4,4,0,4,4,-6,-20,0,-1,8,1,-2,-12,4,1,-4,3,-4,-8,44,27,17,42,26,16,-9,4,-4,17,28,7,-4,-1,-2,15,22,-3,-5,5,-2,2,6,10,5,-1,5,15,20,-1,3,0,1,11,13,-2,2,-1,4,4,7,1,112,36,76,4,-4,8,28,14,26,21,10,7,15,4,10,-1,5,4,13,10,16,22,5,3,7,1,3,-3,-2,-4,1,-1,0,-3,-2,1,6,2,3,0,0,-5,178,88,90,82,42,40,20,7,37,55,38,19,13,6,23,31,9,4,7,1,14,24,29,15,9,5,20,25,16,7,5,3,9,14,8,3,4,2,11,11,8,4
35,35011,Ingenio,24004,314,180,134,115,66,49,42,77,133,34,26,4,25,38,81,16,17,2,17,39,52,18,9,2,20,23,42,17,11,1,7,12,27,12,7,1,13,11,15,5,4,0,264,134,130,142,82,60,69,63,100,32,-1,2,32,41,52,10,-1,-1,37,22,48,22,0,3,31,37,41,19,10,4,17,24,26,10,4,1,14,13,15,9,6,3,492,250,242,236,139,97,82,104,188,77,43,2,40,41,105,40,18,5,42,63,83,37,25,-3,42,55,82,34,21,1,23,33,56,14,11,2,19,22,26,20,10,-1,315,172,143,154,84,70,81,56,122,34,-1,10,52,25,63,16,-1,5,29,31,59,18,0,5,40,40,39,26,7,2,25,23,23,12,1,0,15,17,16,14,6,2,351,200,151,145,82,63,67,68,136,48,7,22,40,39,67,39,7,8,27,29,69,9,0,14,18,37,45,25,14,6,10,18,29,14,7,4,8,19,16,11,7,2,363,205,158,131,58,73,31,86,188,30,12,10,19,37,121,11,12,3,12,49,67,19,0,7,30,17,38,24,18,3,9,7,27,8,7,0,21,10,11,16,11,3,322,178,144,157,76,81,68,99,115,5,30,10,43,43,73,0,15,4,25,56,42,5,15,6,37,32,36,28,15,8,23,15,19,8,7,4,14,17,17,20,8,4,519,303,216,121,55,66,59,157,213,61,10,4,37,79,126,41,12,3,22,78,87,20,-2,1,17,41,29,20,8,4,11,14,7,12,8,2,6,27,22,8,0,2,392,195,197,129,62,67,57,103,143,46,29,3,27,48,62,24,22,0,30,55,81,22,7,3,19,32,34,28,11,5,9,17,13,11,9,3,10,15,21,17,2,2,145,39,106,68,15,53,17,39,71,13,-1,5,14,-1,19,18,-9,1,3,40,52,-5,8,4,26,17,1,12,9,1,12,3,-7,4,4,-1,14,14,8,8,5,2,118,78,40,84,44,40,23,21,57,-6,3,8,15,9,27,4,3,8,8,12,30,-10,0,0,10,24,20,18,9,0,6,11,12,9,3,0,4,13,8,9,6,0,183,96,87,18,3,15,14,54,60,31,11,2,0,15,45,21,10,0,14,39,15,10,1,2,-5,8,-3,4,11,2,-4,2,-1,-1,5,1,-1,6,-2,5,6,1,-74,-26,-48,-43,-33,-10,-22,21,-31,-20,-3,-11,-14,5,-9,0,3,-2,-8,16,-22,-20,-6,-9,-5,0,-14,-11,-7,-8,-2,-5,-12,-8,-6,-2,-3,5,-2,-3,-1,-6,53,56,-3,15,13,2,41,-4,3,-6,11,3,25,15,-4,5,8,5,16,-19,7,-11,3,-2,-7,12,-2,16,-2,-3,-3,5,2,10,-1,0,-4,7,-4,6,-1,-3,-61,-16,-45,-85,-39,-46,-26,7,-30,-8,2,-22,-17,7,-7,0,1,-8,-9,0,-23,-8,1,-14,-7,10,-23,-37,-18,-12,-2,6,-6,-23,-11,-5,-5,4,-17,-14,-7,-7,42,-39,81,59,36,23,22,-18,31,14,-21,8,3,-17,-3,-2,-26,3,19,-1,34,16,5,5,22,13,9,19,-10,6,15,10,7,8,-9,5,7,3,2,11,-1,1,151,52,99,110,40,70,27,68,69,-38,24,-5,12,20,37,-24,5,3,15,48,32,-14,19,-8,29,30,31,12,5,2,12,9,13,7,-3,2,17,21,18,5,8,0,237,101,136,97,39,58,4,81,53,43,26,20,14,29,27,-3,22,10,-10,52,26,46,4,10,12,26,16,15,13,13,10,10,1,7,5,5,2,16,15,8,8,8
35,35012,Mogán,12256,991,611,380,1046,594,452,91,201,261,215,166,49,55,119,163,128,102,37,36,82,98,87,64,12,132,175,286,218,175,52,74,96,162,112,106,38,58,79,124,106,69,14,871,480,391,986,541,445,92,128,234,209,143,59,48,69,124,106,93,37,44,59,110,103,50,22,138,145,268,215,159,54,73,70,137,125,94,37,65,75,131,90,65,17,603,381,222,867,470,397,39,119,151,127,128,31,44,68,104,82,61,20,-5,51,47,45,67,11,126,133,232,192,141,36,66,69,132,107,74,19,60,64,100,85,67,17,723,378,345,879,445,434,99,161,158,113,143,53,48,95,85,51,72,32,51,66,73,62,71,21,127,128,197,176,175,71,57,68,96,80,99,42,70,60,101,96,76,29,542,308,234,909,483,426,39,119,56,164,120,38,30,64,46,90,55,15,9,55,10,74,65,23,134,143,223,214,148,40,70,64,133,111,80,18,64,79,90,103,68,22,1044,536,508,1092,584,508,113,160,260,217,212,66,69,63,126,108,121,36,44,97,134,109,91,30,134,158,269,244,221,56,74,69,141,129,131,33,60,89,128,115,90,23,1282,665,617,1163,562,601,164,170,247,293,296,93,89,62,145,168,143,54,75,108,102,125,153,39,160,152,199,264,286,90,79,51,96,134,145,52,81,101,103,130,141,38,1444,694,750,1485,726,759,208,223,333,263,284,119,102,95,151,132,146,60,106,128,182,131,138,59,215,210,319,295,306,129,107,80,158,148,162,64,108,130,161,147,144,65,1182,604,578,1219,623,596,76,182,240,206,304,159,43,94,118,104,151,90,33,88,122,102,153,69,97,165,246,233,310,160,63,78,116,122,154,88,34,87,130,111,156,72,810,402,408,911,428,483,30,124,74,173,209,189,28,50,33,85,99,104,2,74,41,88,110,85,68,115,104,194,240,184,39,35,40,94,115,104,29,80,64,100,125,80,799,414,385,829,401,428,65,107,102,163,189,162,36,62,51,87,81,84,29,45,51,76,108,78,81,112,111,159,197,162,46,46,44,83,91,84,35,66,67,76,106,78,816,415,401,747,345,402,81,109,99,179,181,142,55,39,54,102,85,68,26,70,45,77,96,74,98,73,91,149,188,135,54,14,42,72,91,64,44,59,49,77,97,71,507,266,241,506,257,249,43,93,79,98,125,58,33,34,45,56,68,25,10,59,34,42,57,33,52,68,78,111,120,68,34,29,39,56,64,30,18,39,39,55,56,38,190,73,117,214,112,102,1,54,81,44,8,0,-11,7,60,13,7,0,12,47,21,31,1,0,8,49,54,65,29,7,4,18,33,33,21,3,4,31,21,32,8,4,-1834,-962,-872,-1773,-924,-849,-243,-139,-147,-495,-377,-439,-123,-70,-51,-229,-224,-264,-120,-69,-96,-266,-153,-175,-210,-133,-156,-487,-355,-430,-103,-66,-56,-240,-204,-252,-107,-67,-100,-247,-151,-178,-332,-207,-125,-158,-111,-47,-16,10,-71,-107,-65,-92,-21,-11,-29,-52,-42,-60,5,21,-42,-55,-23,-32,16,15,-1,-53,-56,-85,2,-5,7,-35,-27,-58,14,20,-8,-18,-29,-27,-1594,-814,-780,-1404,-712,-692,-103,-46,-209,-373,-398,-468,-54,-32,-59,-202,-226,-247,-49,-14,-150,-171,-172,-221,-41,-47,-169,-339,-354,-458,-17,-31,-50,-180,-198,-239,-24,-16,-119,-159,-156,-219,334,183,151,380,194,186,16,76,70,81,67,21,-9,37,45,44,41,17,25,39,25,37,26,4,43,60,95,79,71,24,20,25,45,44,37,18,23,35,50,35,34,6
35,35014,"Oliva, La",9547,1252,709,543,779,441,338,156,374,424,209,80,12,74,204,257,127,41,6,82,170,167,82,39,6,88,171,304,141,60,10,49,87,178,86,34,5,39,84,126,55,26,5,1337,678,659,725,359,366,182,378,454,177,112,26,92,193,237,83,56,12,90,185,217,94,56,14,108,156,242,133,75,9,55,80,117,65,38,3,53,76,125,68,37,6,1193,704,489,819,453,366,163,289,357,222,125,19,91,176,221,129,66,12,72,113,136,93,59,7,116,173,260,155,96,13,61,107,147,76,51,9,55,66,113,79,45,4,1445,865,580,896,491,405,228,340,362,317,129,22,141,166,247,198,72,12,87,174,115,119,57,10,163,174,258,179,98,17,94,83,152,92,59,8,69,91,106,87,39,9,1081,629,452,950,534,416,116,279,318,208,124,26,54,168,194,130,63,12,62,111,124,78,61,14,149,169,291,200,118,17,81,96,167,114,62,10,68,73,124,86,56,7,1756,996,760,1315,737,578,137,481,492,364,219,38,59,261,317,208,112,23,78,220,175,156,107,15,165,287,361,285,167,38,80,156,220,164,85,22,85,131,141,121,82,16,1347,726,621,1075,584,491,167,268,463,283,123,31,73,144,270,154,65,15,94,124,193,129,58,16,158,222,309,216,145,24,75,120,180,121,77,10,83,102,129,95,68,14,1066,559,507,1092,565,527,103,292,380,118,159,7,62,137,221,51,83,1,41,155,159,67,76,6,141,239,334,175,173,20,75,118,182,86,92,8,66,121,152,89,81,12,473,225,248,832,437,395,16,156,100,66,106,32,39,68,41,0,63,18,-23,88,59,66,43,14,104,174,238,150,130,27,63,83,121,72,79,15,41,91,117,78,51,12,287,110,177,803,404,399,14,127,-17,21,109,32,3,44,-34,23,49,23,11,83,17,-2,60,9,101,164,208,142,143,36,45,77,103,83,68,23,56,87,105,59,75,13,509,287,222,780,409,371,62,115,143,63,103,14,57,51,86,33,34,17,5,64,57,30,69,-3,89,156,233,147,112,34,59,71,119,82,51,22,30,85,114,65,61,12,1126,565,561,991,531,460,83,230,375,206,181,45,25,126,185,114,90,20,58,104,190,92,91,25,100,186,288,193,157,56,48,105,156,107,79,28,52,81,132,86,78,28,890,417,473,845,446,399,94,172,283,179,114,24,22,65,132,115,56,12,72,107,151,64,58,12,78,158,242,196,121,35,40,75,120,118,66,19,38,83,122,78,55,16,221,116,105,222,87,135,-56,125,122,-45,62,3,-30,46,79,-26,25,15,-26,79,43,-19,37,-12,-9,84,64,-21,83,7,-10,21,32,-20,41,17,1,63,32,-1,42,-10,1287,699,588,1205,660,545,162,207,374,238,201,83,111,98,195,114,116,54,51,109,179,124,85,29,130,165,320,284,207,78,77,67,179,162,118,47,53,98,141,122,89,31,1147,539,608,1307,656,651,111,188,259,263,244,68,61,82,108,136,118,31,50,106,151,127,126,37,137,180,339,306,259,73,76,72,161,172,132,38,61,108,178,134,127,35,1458,732,726,1491,764,727,132,281,409,285,243,84,75,110,221,155,114,46,57,171,188,130,129,38,151,234,356,346,296,89,85,97,183,190,148,53,66,137,173,156,148,36,1198,616,582,1399,707,692,91,269,301,242,239,52,40,114,154,145,127,30,51,155,147,97,112,22,164,213,350,316,277,68,91,87,172,173,141,35,73,126,178,143,136,33
35,35015,Pájara,10132,2113,1335,778,815,536,279,130,744,678,398,135,12,54,436,482,264,89,-1,76,308,196,134,46,13,64,175,298,182,81,8,27,114,202,140,47,2,37,61,96,42,34,6,872,447,425,701,412,289,44,443,211,90,62,19,37,201,123,46,21,13,7,242,88,44,41,6,59,171,242,117,88,18,30,87,151,80,49,10,29,84,91,37,39,8,772,451,321,628,345,283,69,310,163,120,75,24,47,195,104,57,35,11,22,115,59,63,40,13,73,134,176,112,107,25,41,71,94,65,59,15,32,63,82,47,48,10,981,500,481,625,323,302,61,383,243,168,92,23,24,183,170,72,37,9,37,200,73,96,55,14,68,142,168,131,88,24,37,74,78,75,42,14,31,68,90,56,46,10,850,442,408,690,372,318,88,390,150,92,78,30,52,183,111,35,36,18,36,207,39,57,42,12,50,173,205,122,100,29,31,75,123,66,56,17,19,98,82,56,44,12,873,434,439,936,503,433,37,393,130,174,106,23,5,185,76,99,44,14,32,208,54,75,62,9,86,278,279,164,89,29,43,134,158,95,46,22,43,144,121,69,43,7,517,274,243,908,498,410,1,308,66,69,46,23,-3,180,54,19,7,19,4,128,12,50,39,4,107,224,281,163,92,29,64,108,159,99,46,18,43,116,122,64,46,11,493,204,289,813,375,438,11,267,46,60,31,33,11,127,35,3,-13,23,0,140,11,57,44,10,98,251,206,109,79,33,52,106,89,56,33,21,46,145,117,53,46,12,379,191,188,793,379,414,17,243,65,-12,10,33,10,148,33,-35,-2,22,7,95,32,23,12,11,118,227,218,124,51,35,67,106,95,55,24,22,51,121,123,69,27,13,-352,-263,-89,513,229,284,-46,21,-178,-114,-42,2,-22,-18,-103,-77,-39,-6,-24,39,-75,-37,-3,8,68,133,140,96,58,13,33,43,66,56,26,2,35,90,74,40,32,11,-304,-260,-44,217,50,167,-22,-5,-166,-109,-7,13,0,-32,-130,-85,-15,8,-22,27,-36,-24,8,5,40,66,13,33,48,12,23,14,-29,9,19,9,17,52,42,24,29,3,-29,-116,87,364,137,227,46,87,-93,-64,-17,6,15,2,-65,-54,-15,3,31,85,-28,-10,-2,3,68,88,78,68,40,15,31,14,25,39,18,8,37,74,53,29,22,7,221,23,198,379,146,233,8,124,115,-37,-7,5,11,48,30,-60,-21,6,-3,76,85,23,14,-1,22,103,140,60,33,16,12,35,52,19,14,9,10,68,88,41,19,7,386,151,235,390,164,226,38,191,126,21,-6,9,23,91,32,11,-9,-3,15,100,94,10,3,12,31,114,149,47,36,9,19,41,66,16,15,5,12,73,83,31,21,4,-155,-145,-10,-58,-63,5,-14,143,1,-127,-95,-69,-11,39,6,-86,-62,-36,-3,104,-5,-41,-33,-33,22,92,7,-86,-45,-55,7,31,2,-45,-31,-30,15,61,5,-41,-14,-25,-97,-75,-22,33,-19,52,-36,229,-5,-136,-68,-80,-31,100,12,-94,-29,-34,-5,129,-17,-42,-39,-46,11,162,67,-96,-47,-70,3,56,25,-50,-25,-31,8,106,42,-46,-22,-39,390,199,191,380,183,197,-27,287,104,32,6,-18,-28,127,87,27,-1,-16,1,160,17,5,7,-2,14,209,113,19,30,-10,3,79,66,18,19,-6,11,130,47,1,11,-4,602,320,282,453,202,251,49,356,111,37,48,2,30,157,72,34,19,6,19,199,39,3,29,-4,40,241,81,18,63,4,23,85,50,10,24,6,17,156,31,8,39,-2
35,35016,"Palmas de Gran Canaria, Las",354757,1594,673,921,4064,2092,1972,222,537,313,328,98,118,113,275,71,126,28,67,109,262,242,202,70,51,665,789,1352,797,313,120,353,402,676,425,161,58,312,387,676,372,152,62,3313,1662,1651,4546,2361,2185,563,1016,803,603,201,115,255,544,396,331,77,55,308,472,407,272,124,60,851,1042,1340,878,298,112,462,519,729,443,140,57,389,523,611,435,158,55,2102,1141,961,4517,2354,2163,408,1088,270,207,129,-5,222,644,214,35,6,9,186,444,56,172,123,-14,913,1046,1212,831,363,113,472,534,693,413,174,49,441,512,519,418,189,64,365,4,361,3713,1910,1803,261,489,-494,68,6,16,101,222,-332,23,-47,32,160,267,-162,45,53,-16,672,874,967,696,314,150,341,405,555,365,144,83,331,469,412,331,170,67,909,296,613,3838,2047,1791,236,609,-300,201,124,21,127,274,-209,62,14,20,109,335,-91,139,110,1,606,911,1142,684,292,155,306,480,662,370,134,72,300,431,480,314,158,83,1449,516,933,3955,2038,1917,433,759,-21,111,137,17,161,324,-66,66,37,2,272,435,45,45,100,15,621,1022,1136,716,310,101,288,501,617,404,151,51,333,521,519,312,159,50,1088,290,798,4166,2055,2111,280,967,-245,72,60,-23,128,410,-193,-46,-14,11,152,557,-52,118,74,-34,622,1262,1156,695,300,91,323,575,628,333,139,40,299,687,528,362,161,51,1932,640,1292,4406,2204,2202,414,1187,-14,310,92,-60,210,491,-120,57,26,-8,204,696,106,253,66,-52,644,1459,1219,657,292,114,344,697,657,316,126,55,300,762,562,341,166,59,1636,640,996,3856,1930,1926,196,1024,14,332,131,-71,71,490,-43,99,39,-21,125,534,57,233,92,-50,450,1157,1114,721,289,91,219,597,559,360,136,40,231,560,555,361,153,51,1333,485,848,2391,1153,1238,445,647,-56,252,120,-97,206,345,-119,44,48,-41,239,302,63,208,72,-56,391,674,619,405,201,66,189,349,287,192,90,28,202,325,332,213,111,38,796,249,547,2292,1158,1134,255,601,-153,165,23,-79,173,264,-179,54,-1,-40,82,337,26,111,24,-39,403,669,552,394,172,79,229,340,264,196,86,36,174,329,288,198,86,43,800,190,610,2015,926,1089,328,392,-75,162,60,-56,144,212,-137,30,-33,-26,184,180,62,132,93,-30,418,539,407,380,186,72,216,242,180,185,69,25,202,297,227,195,117,47,2131,990,1141,1777,831,946,236,643,409,533,284,40,117,293,152,249,149,14,119,350,257,284,135,26,291,547,367,289,190,75,160,235,169,130,87,36,131,312,198,159,103,39,2486,1026,1460,1632,709,923,344,974,540,343,213,50,137,385,220,140,93,35,207,589,320,203,120,15,236,720,274,168,140,79,111,295,135,61,60,39,125,425,139,107,80,40,1488,594,894,1712,789,923,288,740,21,275,147,20,132,325,-86,128,66,31,156,415,107,147,81,-11,240,672,261,276,160,88,121,296,101,133,81,51,119,376,160,143,79,37,-6685,-3640,-3045,-5554,-3061,-2493,-412,37,-1900,-2333,-1286,-747,-236,25,-1040,-1324,-744,-297,-176,12,-860,-1009,-542,-450,-255,28,-1364,-2137,-1202,-634,-130,-23,-785,-1189,-675,-263,-125,51,-579,-948,-527,-371,314,-90,404,1507,641,866,118,553,-111,-105,-100,-39,76,201,-142,-88,-135,-5,42,352,31,-17,35,-34,283,649,282,148,70,45,165,246,102,72,11,26,118,403,180,76,59,19,2296,787,1509,2811,1175,1636,349,1123,349,286,140,91,174,391,98,85,38,31,175,732,251,201,102,60,448,943,575,431,257,120,220,355,236,181,119,43,228,588,339,250,138,77
35,35017,Puerto del Rosario,20218,1307,725,582,452,251,201,165,374,460,223,47,15,98,194,244,146,25,6,67,180,216,77,22,9,62,116,165,79,19,7,39,65,91,43,9,3,23,51,74,36,10,4,-839,-454,-385,33,17,16,-145,-170,-321,-137,-47,-16,-74,-92,-165,-83,-31,-5,-71,-78,-156,-54,-16,-11,9,6,9,8,0,0,5,2,7,3,0,0,4,4,2,5,0,0,-1145,-638,-507,-19,-8,-11,-217,-230,-387,-211,-54,-24,-129,-112,-207,-127,-36,-15,-88,-118,-180,-84,-18,-9,-2,-4,-11,-2,-1,1,-1,-2,-6,0,0,1,-1,-2,-5,-2,-1,0,1682,912,770,490,255,235,306,361,606,320,83,26,134,198,350,199,35,7,172,163,256,121,48,19,112,108,141,97,22,6,52,55,79,54,9,3,60,53,62,43,13,3,1678,924,754,642,350,292,230,450,543,321,87,34,128,245,288,191,54,13,102,205,255,130,33,21,129,161,167,113,47,19,75,85,96,64,19,10,54,76,71,49,28,9,878,503,375,580,288,292,123,263,249,167,34,10,68,132,155,114,19,4,55,131,94,53,15,6,127,146,165,84,35,17,60,72,90,40,17,7,67,74,75,44,18,10,1200,677,523,844,464,380,233,367,374,131,65,21,137,205,212,69,44,6,96,162,162,62,21,15,188,223,221,125,60,18,100,125,127,69,29,7,88,98,94,56,31,11,1263,613,650,1036,550,486,267,332,376,184,85,24,145,155,206,70,40,14,122,177,170,114,45,10,233,249,274,183,76,18,119,150,147,88,37,9,114,99,127,95,39,9,-189,-186,-3,719,339,380,-61,106,-99,-130,-23,30,-19,65,-81,-106,-45,7,-42,41,-18,-24,22,23,211,158,174,121,30,14,120,73,75,47,9,7,91,85,99,74,21,7,-621,-494,-127,122,-1,123,-117,43,-318,-178,-64,8,-62,13,-228,-162,-61,2,-55,30,-90,-16,-3,6,66,57,-5,-7,-4,6,30,26,-35,-14,-9,-1,36,31,30,7,5,7,-205,-114,-91,114,39,75,-71,64,-98,-115,2,-1,-6,18,-58,-69,-4,0,-65,46,-40,-46,6,-1,31,31,18,23,15,-9,18,8,5,6,6,-5,13,23,13,17,9,-4,465,239,226,304,144,160,79,173,98,67,22,20,46,105,59,32,-12,4,33,68,39,35,34,16,63,98,57,51,22,7,25,58,27,20,6,3,38,40,30,31,16,4,369,190,179,10,-2,12,69,99,126,24,20,22,63,29,84,-16,6,15,6,70,42,40,14,7,3,18,-3,-10,1,1,7,7,-7,-10,2,0,-4,11,4,0,-1,1,314,143,171,30,13,17,28,99,113,-17,45,29,4,61,63,-38,30,17,24,38,50,21,15,12,7,15,7,-9,5,0,5,5,6,-8,2,1,2,10,1,-1,3,-1,-123,-85,-38,-589,-356,-233,53,65,-50,-148,-68,5,25,18,-25,-79,-40,1,28,47,-25,-69,-28,4,-22,-48,-157,-230,-103,-32,0,-31,-87,-151,-74,-14,-22,-17,-70,-79,-29,-18,776,335,441,290,142,148,148,126,170,175,57,85,76,42,44,94,29,45,72,84,126,81,28,40,63,54,52,64,24,27,39,18,20,29,13,20,24,36,32,35,11,7,623,333,290,221,109,112,88,110,221,111,26,43,58,41,123,69,4,23,30,69,98,42,22,20,50,51,67,22,17,10,33,21,37,12,2,2,17,30,30,10,15,8,292,128,164,124,31,93,50,92,87,14,16,8,42,47,30,-6,6,-11,8,45,57,20,10,19,78,58,16,-19,-15,-2,38,26,1,-22,-12,-5,40,32,15,3,-3,3
35,35018,San Bartolomé,11576,989,518,471,464,241,223,109,286,363,131,60,24,39,138,209,78,35,11,70,148,154,53,25,13,65,72,184,86,34,16,28,35,99,49,20,6,37,37,85,37,14,10,822,450,372,490,233,257,105,263,230,147,55,19,54,122,154,83,27,10,51,141,76,64,28,9,79,95,160,91,52,9,39,38,78,45,29,3,40,57,82,46,23,6,747,380,367,456,231,225,92,214,254,116,50,12,62,106,120,69,12,5,30,108,134,47,38,7,79,80,149,88,47,9,39,36,76,51,22,5,40,44,73,37,25,4,157,53,104,299,140,159,-21,96,47,-36,29,29,-6,30,23,-17,8,7,-15,66,24,-19,21,22,59,62,72,46,39,19,31,25,38,23,14,8,28,37,34,23,25,11,367,232,135,404,225,179,50,154,67,37,39,19,62,89,35,27,11,5,-12,65,32,10,28,14,96,67,113,78,42,5,57,38,62,44,19,3,39,29,51,34,23,2,406,220,186,395,210,185,56,156,45,75,36,28,25,87,28,37,19,13,31,69,17,38,17,15,82,66,109,70,42,19,41,36,64,34,18,11,41,30,45,36,24,8,309,119,190,382,194,188,18,72,118,22,33,28,9,30,53,-8,6,17,9,42,65,30,27,11,73,70,96,62,49,27,36,33,56,27,27,14,37,37,40,35,22,13,-146,-77,-69,293,149,144,-68,51,-34,-82,1,4,-26,15,-25,-38,1,4,-42,36,-9,-44,0,0,57,63,77,52,34,9,38,30,38,27,12,4,19,33,39,25,22,5,133,50,83,268,143,125,30,53,62,-27,4,11,24,3,52,-24,-13,12,6,50,10,-3,17,-1,54,52,69,56,22,10,34,23,39,26,10,8,20,29,30,30,12,2,-175,-110,-65,149,69,80,-62,20,-24,-79,-41,3,-39,18,-27,-44,-27,3,-23,2,3,-35,-14,0,24,36,46,20,13,6,12,16,18,8,7,6,12,20,28,12,6,0,-8,-22,14,123,64,59,12,23,-20,-69,17,14,7,7,1,-50,-2,7,5,16,-21,-19,19,7,12,24,43,23,15,3,4,13,24,14,7,1,8,11,19,9,8,2,186,44,142,132,64,68,30,37,91,6,21,-1,14,17,24,-16,4,3,16,20,67,22,17,-4,19,18,38,30,19,6,12,9,18,12,11,1,7,9,20,18,8,5,-136,-82,-54,129,55,74,-40,-1,-17,-47,-18,-9,-19,0,-12,-39,2,-11,-21,-1,-5,-8,-20,2,18,26,33,16,24,10,9,14,11,6,12,2,9,12,22,10,12,8,213,89,124,118,58,60,19,6,63,61,32,25,-4,5,18,39,12,12,23,1,45,22,20,13,19,16,30,30,11,11,11,6,18,11,6,6,8,10,12,19,5,5,91,60,31,113,62,51,15,19,47,-20,21,9,28,-12,34,2,5,5,-13,31,13,-22,16,4,13,16,22,21,28,10,9,2,17,16,13,4,4,14,5,5,15,6,-322,-159,-163,-302,-140,-162,-37,11,-39,-124,-89,-46,-24,11,-15,-65,-43,-22,-13,0,-24,-59,-46,-24,-38,7,-75,-109,-52,-39,-21,4,-41,-53,-16,-16,-17,3,-34,-56,-36,-23,158,48,110,167,87,80,-3,51,79,-10,22,11,-12,32,22,2,-2,2,9,19,57,-12,24,9,16,19,39,30,36,22,4,10,15,19,22,14,12,9,24,11,14,8,99,31,68,186,81,105,-30,49,54,-7,26,3,-24,19,43,-14,11,-9,-6,30,11,7,15,12,30,30,42,37,33,11,9,11,19,22,13,5,21,19,23,15,20,6
35,35019,San Bartolomé de Tirajana,38729,790,495,295,1265,721,544,18,183,253,139,151,39,15,107,151,90,92,31,3,76,102,49,59,8,136,239,410,221,188,52,72,125,236,127,115,34,64,114,174,94,73,18,1489,815,674,1533,817,716,153,329,427,283,215,53,59,172,255,165,120,29,94,157,172,118,95,24,189,249,463,312,230,70,90,121,246,177,131,42,99,128,217,135,99,28,1707,945,762,1625,903,722,230,373,522,250,222,89,107,207,319,141,113,49,123,166,203,109,109,40,244,293,493,276,219,86,124,161,279,165,118,50,120,132,214,111,101,36,1461,871,590,1573,852,721,140,241,375,253,309,130,89,122,225,156,180,82,51,119,150,97,129,48,193,238,401,282,318,126,103,94,215,182,180,70,90,144,186,100,138,56,1057,532,525,1502,768,734,81,160,321,174,237,78,36,83,150,84,133,49,45,77,171,90,104,29,161,249,461,298,234,84,71,114,231,163,131,50,90,135,230,135,103,34,1585,930,655,1736,934,802,124,313,403,378,259,93,68,172,275,232,128,45,56,141,128,146,131,48,169,337,482,356,278,107,76,158,288,209,147,51,93,179,194,147,131,56,1735,1025,710,1758,989,769,123,356,412,413,322,108,76,195,233,268,191,61,47,161,179,145,131,47,174,301,457,408,297,110,100,159,240,247,171,67,74,142,217,161,126,43,1463,816,647,1605,833,772,112,287,353,334,237,126,65,140,191,219,130,62,47,147,162,115,107,64,164,306,395,350,257,122,92,130,209,201,125,69,72,176,186,149,132,53,972,525,447,1342,711,631,-26,181,177,272,239,125,-19,53,106,182,125,70,-7,128,71,90,114,55,98,249,352,286,244,107,43,102,201,171,134,55,55,147,151,115,110,52,1319,756,563,1217,657,560,91,271,308,274,267,99,50,114,209,178,148,56,41,157,99,96,119,43,101,237,291,233,232,113,55,102,163,139,133,61,46,135,128,94,99,52,1324,778,546,1183,620,563,67,223,309,294,299,121,44,100,188,190,182,67,23,123,121,104,117,54,91,195,300,247,227,114,56,84,147,143,121,64,35,111,153,104,106,50,1428,818,610,1140,590,550,136,263,429,302,215,83,79,118,242,199,124,47,57,145,187,103,91,36,83,200,279,244,220,105,45,81,136,147,115,57,38,119,143,97,105,48,564,254,310,518,238,280,26,152,114,133,106,14,13,74,11,93,58,-4,13,78,103,40,48,18,49,92,115,97,110,47,29,40,42,44,62,17,20,52,73,53,48,30,-1138,-560,-578,-1415,-726,-689,-30,25,-63,-359,-251,-476,-32,-6,11,-165,-127,-253,2,31,-74,-194,-124,-223,-78,-39,-170,-396,-280,-457,-34,-29,-73,-206,-142,-243,-44,-10,-97,-190,-138,-214,228,125,103,42,19,23,64,153,191,103,-20,-275,39,64,119,43,17,-157,25,89,72,60,-37,-118,55,86,130,27,-3,-263,24,24,83,28,11,-153,31,62,47,-1,-14,-110,56,0,56,70,0,70,110,69,135,11,-123,-156,48,31,95,7,-79,-110,62,38,40,4,-44,-46,80,88,91,3,-57,-141,25,32,60,6,-34,-92,55,56,31,-3,-23,-49,841,444,397,998,536,462,175,220,163,151,184,-70,92,96,120,58,121,-53,83,124,43,93,63,-17,161,187,257,223,195,-33,76,82,153,130,112,-21,85,105,104,93,83,-12,-1407,-705,-702,-1012,-520,-492,-9,58,-240,-401,-394,-434,-13,15,-59,-200,-243,-214,4,43,-181,-201,-151,-220,70,83,-175,-288,-300,-415,31,30,-27,-185,-175,-201,39,53,-148,-103,-125,-214
35,35021,Santa Brígida,17706,58,30,28,93,45,48,10,27,-6,39,-9,-2,1,16,7,18,-2,-7,9,11,-13,21,-7,5,17,17,27,24,4,2,10,9,12,11,2,0,7,8,15,13,2,2,342,201,141,102,56,46,93,42,100,99,3,4,61,31,46,56,2,5,32,11,54,43,1,-1,26,15,34,21,2,4,15,11,16,11,1,2,11,4,18,10,1,2,85,23,62,62,28,34,27,12,19,11,9,0,18,-7,6,-4,5,2,9,19,13,15,4,-2,11,13,19,18,0,-2,7,7,8,5,1,-1,4,6,11,13,-1,-1,33,-1,34,85,38,47,20,12,8,23,-27,-4,5,-6,4,12,-16,-1,15,18,4,11,-11,-3,27,14,19,23,1,1,16,4,4,13,0,1,11,10,15,10,1,0,93,25,68,83,47,36,34,-1,31,24,-1,5,9,12,-6,11,-5,7,25,-13,37,13,4,-2,17,15,36,9,5,1,13,10,19,3,1,1,4,5,17,6,4,0,-327,-159,-168,29,7,22,-66,-25,-143,-70,-22,-6,-31,-17,-63,-38,-13,-4,-35,-8,-80,-32,-9,-2,5,13,4,9,0,-2,0,6,0,2,0,-1,5,7,4,7,0,-1,164,65,99,112,47,65,56,32,30,35,1,0,23,12,15,16,2,-7,33,20,15,19,-1,7,19,42,21,16,10,2,5,25,6,5,4,0,14,17,15,11,6,2,-58,-23,-35,120,61,59,4,30,-40,-40,-22,7,8,25,-22,-16,-20,0,-4,5,-18,-24,-2,7,10,49,26,16,14,5,6,31,11,5,6,2,4,18,15,11,8,3,74,14,60,92,31,61,23,0,-7,13,-19,64,-1,18,-17,-5,-5,27,24,-18,10,18,-14,37,13,24,26,29,0,0,3,15,3,12,-1,-1,10,9,23,17,1,1,-68,-37,-31,7,-11,18,20,-41,-34,-20,-13,11,3,-29,-7,-5,-13,8,17,-12,-27,-15,0,3,9,-13,-1,6,6,-4,-1,-12,-3,3,3,-2,10,-1,2,3,3,-2,-286,-147,-139,-214,-118,-96,4,-50,-87,-102,-50,-10,-7,-19,-44,-51,-31,-4,11,-31,-43,-51,-19,-6,-24,-31,-52,-70,-26,-16,-13,-18,-33,-39,-13,-6,-11,-13,-19,-31,-13,-10,-11,-13,2,-55,-37,-18,40,0,-74,-4,4,21,29,-11,-48,-4,13,4,11,11,-26,0,-9,17,-1,-9,-19,-12,-8,-5,-3,-9,-11,-8,-3,-3,2,0,-8,-4,-5,-2,116,76,40,84,52,32,40,15,20,14,3,21,29,16,14,18,-6,3,11,-1,6,-4,9,18,27,4,13,24,12,4,17,6,6,16,6,0,10,-2,7,8,6,4,-148,-94,-54,-35,-25,-10,-9,-24,-77,-26,-11,2,-23,-25,-48,0,1,3,14,1,-29,-26,-12,-1,-5,0,-13,-13,-1,-4,-9,0,-6,-8,0,-3,4,0,-7,-5,-1,-1,-132,-70,-62,10,6,4,17,-34,-58,-3,-54,3,8,-15,-41,5,-31,4,9,-19,-17,-8,-23,-1,15,-2,-7,-4,6,2,6,-4,-3,0,4,3,9,2,-4,-4,2,-1,-146,-46,-100,-73,-31,-42,12,-32,-44,-27,-42,-17,5,-12,-9,0,-19,-13,7,-20,-35,-27,-23,-4,7,-4,-18,-20,-28,-10,7,-1,-8,-10,-14,-5,0,-3,-10,-10,-14,-5,-52,-5,-47,66,25,41,-1,22,-66,-12,-1,0,1,13,-32,-7,10,5,-2,9,-34,-5,-11,-5,21,10,6,18,4,5,9,2,0,9,1,2,12,8,6,9,3,3,50,23,27,20,8,12,20,13,-2,5,-11,18,5,9,-3,-8,7,7,15,4,1,13,-18,11,12,1,11,-9,-4,8,7,0,3,-2,-4,3,5,1,8,-7,0,5
35,35022,Santa Lucía de Tirajana,43543,2017,1127,890,915,548,367,311,514,683,336,112,37,153,279,393,224,58,11,158,235,290,112,54,26,126,189,310,185,75,25,69,116,193,127,32,9,57,73,117,58,43,16,1059,581,478,399,208,191,148,246,357,162,108,22,84,130,196,89,59,13,64,116,161,73,49,9,84,89,110,74,30,5,36,42,68,41,16,2,48,47,42,33,14,3,860,440,420,98,50,48,110,220,303,120,50,32,61,100,165,55,27,15,49,120,138,65,23,17,22,25,18,14,10,7,8,14,11,6,5,4,14,11,7,8,5,3,169,60,109,32,14,18,46,87,29,16,-2,3,24,19,37,-7,1,-2,22,68,-8,23,-3,5,11,11,1,1,6,0,6,5,0,-3,6,0,5,6,1,4,0,0,1457,707,750,811,398,413,236,275,523,222,100,46,112,92,287,113,38,28,124,183,236,109,62,18,134,148,242,138,65,37,66,62,129,70,29,16,68,86,113,68,36,21,937,497,440,593,295,298,139,193,338,108,69,27,79,81,189,37,50,16,60,112,149,71,19,11,140,122,140,77,52,14,74,57,77,33,22,6,66,65,63,44,30,8,1581,832,749,950,500,450,254,374,422,319,125,50,136,198,213,172,75,19,118,176,209,147,50,31,196,180,247,171,113,30,105,98,134,92,52,17,91,82,113,79,61,13,1723,773,950,798,367,431,356,341,506,260,154,96,173,121,264,97,68,44,183,220,242,163,86,52,196,204,202,112,65,11,98,93,110,22,30,9,98,111,92,90,35,2,1827,877,950,1200,600,600,247,388,588,364,177,45,109,160,309,186,85,20,138,228,279,178,92,25,201,296,322,222,122,20,96,142,180,98,65,10,105,154,142,124,57,10,568,301,267,311,135,176,67,153,133,92,40,69,41,73,57,54,25,37,26,80,76,38,15,32,74,107,47,52,24,-12,45,40,19,17,13,-9,29,67,28,35,11,-3,689,243,446,255,74,181,85,137,104,189,71,67,31,38,26,69,28,34,54,99,78,120,43,33,9,53,16,92,44,19,13,18,-10,31,11,0,-4,35,26,61,33,19,1037,494,543,890,449,441,45,141,259,309,131,53,53,52,95,153,63,25,-8,89,164,156,68,28,98,146,171,248,110,17,61,77,71,119,59,9,37,69,100,129,51,8,1016,535,481,673,342,331,209,153,198,243,81,27,136,74,105,125,35,0,73,79,93,118,46,27,103,108,90,207,68,13,69,54,29,98,34,6,34,54,61,109,34,7,576,296,280,360,183,177,56,172,95,85,57,53,37,102,66,24,22,19,19,70,29,61,35,34,18,91,71,58,57,5,12,50,35,24,29,5,6,41,36,34,28,0,669,239,430,452,193,259,118,94,165,91,92,31,44,-20,98,26,40,2,74,114,67,65,52,29,57,83,76,124,39,7,19,25,41,58,18,-4,38,58,35,66,21,11,630,301,329,324,141,183,62,134,188,77,64,27,44,76,70,26,30,20,18,58,118,51,34,7,15,89,69,44,24,9,10,35,27,13,10,7,5,54,42,31,14,2,1312,672,640,753,384,369,200,231,305,258,197,50,92,92,147,169,110,26,108,139,158,89,87,24,127,134,167,142,109,20,68,57,82,69,66,12,59,77,85,73,43,8,1602,833,769,1124,539,585,229,315,465,309,145,66,122,127,292,162,67,21,107,188,173,147,78,45,175,235,270,202,139,42,94,98,159,87,63,10,81,137,111,115,76,32
35,35023,Santa María de Guía de Gran Canaria,13897,63,32,31,13,3,10,16,6,7,20,11,-1,13,6,-4,13,8,-4,3,0,11,7,3,3,3,3,1,4,1,0,3,0,0,0,0,0,0,3,1,4,1,0,-36,-16,-20,28,12,16,3,-5,-28,-6,-2,1,-2,-5,-6,-2,-2,0,5,0,-22,-4,0,1,7,4,8,7,1,1,3,2,4,3,0,0,4,2,4,4,1,1,-98,-17,-81,34,17,17,4,-25,-59,6,-16,-2,13,-11,-20,10,-7,3,-9,-14,-39,-4,-9,-5,10,4,3,10,4,2,3,1,4,6,1,1,7,3,-1,4,3,1,-94,-43,-51,15,13,2,-18,-16,-35,-18,3,-9,-12,-10,-3,-6,-6,-7,-6,-6,-32,-12,9,-2,2,4,7,1,1,0,1,4,6,1,1,0,1,0,1,0,0,0,-111,-68,-43,21,9,12,-11,-39,-26,-33,-3,4,-17,-21,-17,-18,3,4,6,-18,-9,-15,-6,0,7,3,6,2,1,2,2,0,4,1,1,1,5,3,2,1,0,1,-51,-16,-35,38,22,16,-27,7,-16,-9,6,-11,-14,5,-6,-3,7,-5,-13,2,-10,-6,-1,-6,6,6,18,4,3,0,2,4,12,2,1,0,4,2,6,2,2,0,2,16,-14,33,24,9,16,5,-21,0,12,-6,5,4,6,4,6,-4,11,1,-27,-4,6,-2,3,8,12,5,2,2,3,5,11,4,1,0,0,3,1,1,1,2,47,35,12,60,40,20,13,-3,26,26,-1,-12,-3,-5,28,15,4,-3,16,2,-2,11,-5,-9,7,13,22,13,1,4,4,9,16,11,-1,1,3,4,6,2,2,3,-71,-30,-41,28,23,5,11,-23,-48,-7,0,-4,16,1,-29,-16,1,-2,-5,-24,-19,9,-1,-2,6,8,9,3,1,0,6,7,6,2,1,0,0,1,3,1,0,0,-7,-12,5,31,11,20,3,-8,4,4,-6,-1,-2,-3,-7,3,-1,-3,5,-5,11,1,-5,2,10,4,7,6,2,1,3,0,3,2,1,1,7,4,4,4,1,0,57,31,26,13,5,8,35,3,15,19,-18,-3,25,6,1,10,-10,-3,10,-3,14,9,-8,0,2,5,3,-1,0,3,2,2,2,-3,-1,2,0,3,1,2,1,1,-70,-44,-26,-9,-8,-1,-3,-18,-26,-13,-3,-3,-2,-3,-26,-14,-1,3,-1,-15,0,1,-2,-6,2,4,-9,-6,1,-1,1,4,-8,-6,0,1,1,0,-1,0,1,-2,78,85,-7,14,8,6,19,-8,33,23,9,0,24,7,30,15,1,7,-5,-15,3,8,8,-7,4,-4,4,5,5,0,5,-2,4,-1,1,1,-1,-2,0,6,4,-1,-29,-27,-2,-24,-23,-1,-2,-15,-31,8,8,3,0,-16,-22,3,5,2,-2,1,-9,5,3,1,-2,-9,-12,-4,1,0,-2,-10,-8,-4,-1,1,0,1,-4,0,2,-1,-9,6,-15,12,9,3,-1,7,-4,-13,0,0,2,7,-9,4,5,-2,-3,0,5,-17,-5,2,4,7,1,1,-2,1,2,5,1,2,-2,1,2,2,0,-1,0,0,-12,-11,-1,19,5,14,26,-23,-15,1,-3,3,16,-17,-2,-2,-6,4,10,-6,-13,3,3,-1,6,1,5,2,3,2,4,-2,3,0,-1,1,2,3,2,2,4,1,-45,-7,-38,25,11,14,5,-6,-29,5,-10,-5,3,7,-5,-1,-4,-4,2,-13,-24,6,-6,-1,7,7,1,9,1,0,5,5,2,1,-1,-1,2,2,-1,8,2,1,40,35,5,50,29,21,14,0,-9,23,12,2,14,3,8,3,6,2,0,-3,-17,20,6,0,12,8,16,9,1,3,10,5,8,3,1,1,2,3,8,6,0,2
35,35024,Teguise,11534,679,363,316,342,190,152,72,118,266,125,84,16,39,50,152,67,45,10,33,68,114,58,39,6,44,46,102,70,67,12,26,23,64,36,34,6,18,23,38,34,33,6,616,311,305,412,202,210,96,110,204,108,76,19,42,56,92,63,42,15,54,54,112,45,34,4,92,44,122,74,63,15,36,18,54,43,40,11,56,26,68,31,23,4,581,302,279,432,212,220,81,99,199,96,74,22,47,52,114,42,33,12,34,47,85,54,41,10,87,48,137,71,71,15,41,22,71,33,35,9,46,26,66,38,36,6,663,312,351,443,230,213,131,90,222,151,61,17,67,32,101,78,28,11,64,58,121,73,33,6,95,57,116,105,50,19,50,28,58,62,23,9,45,29,58,43,27,10,1026,486,540,506,251,255,154,175,336,208,113,34,68,90,162,95,46,20,86,85,174,113,67,14,68,102,126,101,84,21,31,52,67,48,37,14,37,50,59,53,47,7,718,375,343,533,284,249,72,113,268,111,119,29,29,64,148,59,66,9,43,49,120,52,53,20,56,81,128,111,121,29,29,45,66,61,67,13,27,36,62,50,54,16,1075,531,544,585,294,291,101,201,359,181,170,49,69,87,181,89,78,22,32,114,178,92,92,27,67,98,139,117,119,40,42,44,71,60,54,19,25,54,68,57,65,21,843,455,388,434,204,230,137,138,215,189,126,21,62,61,130,109,66,16,75,77,85,80,60,5,49,59,86,109,95,30,18,23,41,58,48,13,31,36,45,51,47,17,441,244,197,344,172,172,70,79,37,139,86,21,53,30,16,73,46,11,17,49,21,66,40,10,38,61,52,81,83,23,26,24,24,44,36,13,12,37,28,37,47,10,571,266,305,269,111,158,90,102,148,130,76,19,41,40,69,69,38,7,49,62,79,61,38,12,35,52,59,57,46,19,14,12,26,27,20,11,21,40,33,30,26,8,493,202,291,181,71,110,82,64,200,72,56,20,19,7,128,28,16,7,63,57,72,44,40,13,29,47,38,30,27,8,10,15,21,12,11,2,19,32,17,18,16,6,223,124,99,-113,-59,-54,60,23,85,32,19,-1,27,10,44,32,0,9,33,13,41,0,19,-10,-14,0,-22,-63,-10,-10,-6,-7,-3,-29,-13,-1,-8,7,-19,-34,3,-9,-29,-15,-14,-274,-161,-113,34,-9,72,-45,-55,-31,28,0,19,-17,-26,-20,6,-9,53,-28,-29,-11,-29,-19,-24,-91,-68,-45,-14,-16,-12,-52,-42,-25,-15,-3,-12,-39,-26,-20,-107,-56,-51,-397,-209,-188,1,47,67,-106,-80,-55,12,14,49,-77,-37,-29,-11,33,18,-29,-43,-26,-28,-16,-76,-118,-93,-69,-9,-9,-37,-72,-46,-38,-19,-7,-39,-46,-47,-31,250,151,99,113,72,41,40,35,47,73,64,-17,30,17,26,38,49,-12,10,18,21,35,15,-5,25,19,23,29,34,-20,18,4,18,21,21,-11,7,15,5,8,13,-9,194,118,76,47,27,20,93,32,17,24,35,-12,65,0,11,13,30,-5,28,32,6,11,5,-7,19,30,12,-13,26,-28,12,4,16,-6,18,-18,7,26,-4,-7,8,-10,284,123,161,213,89,124,53,94,72,49,8,0,30,24,29,41,-3,-2,23,70,43,8,11,2,33,46,58,65,14,-11,16,16,26,33,-1,-4,17,30,32,32,15,-7,213,91,122,211,95,116,87,5,10,40,53,8,49,9,15,-15,23,3,38,-4,-5,55,30,5,41,34,20,49,56,8,19,10,6,24,29,5,22,24,14,25,27,3
35,35026,Telde,86037,190,129,61,29,15,14,-25,-46,146,18,53,45,19,-35,101,10,24,9,-44,-11,45,8,29,36,6,4,8,3,6,2,1,2,6,2,4,0,5,2,2,1,2,2,414,168,246,113,54,59,74,36,202,18,30,46,20,-9,78,32,11,32,54,45,124,-14,19,14,27,17,31,17,14,6,10,6,18,8,7,5,17,11,13,9,7,1,1305,628,677,286,133,153,135,238,542,171,67,139,67,136,266,90,40,35,68,102,276,81,27,104,69,58,67,54,21,11,35,27,27,29,11,2,34,31,40,25,10,9,688,341,347,388,218,170,116,68,301,103,58,46,65,12,158,63,32,18,51,56,143,40,26,28,87,67,102,77,38,13,48,37,59,48,19,6,39,30,43,29,19,7,802,266,536,390,179,211,66,133,297,119,71,128,19,20,128,32,32,43,47,113,169,87,39,85,67,78,105,90,30,15,31,33,55,39,10,8,36,45,50,51,20,7,734,235,499,391,181,210,106,131,238,116,29,100,35,49,89,13,5,38,71,82,149,103,24,62,77,81,95,68,40,27,41,32,56,29,14,8,36,49,39,39,26,19,520,138,382,369,171,198,66,24,218,75,39,79,4,-22,75,35,7,32,62,46,143,40,32,47,81,75,78,68,48,13,34,40,30,39,21,4,47,35,48,29,27,9,369,102,267,407,182,225,33,10,136,24,63,103,7,-60,89,5,22,35,26,70,47,19,41,68,83,82,105,76,43,12,36,25,55,40,19,5,47,57,50,36,24,7,376,163,213,144,70,74,59,51,179,20,-1,66,51,22,62,3,9,11,8,29,117,17,-10,55,40,60,47,-7,1,-3,15,34,28,-14,8,-5,25,26,19,7,-7,2,413,214,199,23,-7,30,88,27,202,45,-24,63,54,10,126,3,-13,29,34,17,76,42,-11,34,27,31,-5,-20,-7,-6,10,13,-8,-19,-6,2,17,18,3,-1,-1,-8,288,118,170,101,42,59,50,10,102,67,28,10,13,3,45,50,10,-7,37,7,57,17,18,17,38,21,10,12,18,-2,19,12,-2,2,10,1,19,9,12,10,8,-3,4,-58,62,149,78,71,-14,-23,17,-101,-2,108,-17,-65,47,-63,-9,34,3,42,-30,-38,7,74,31,28,18,41,21,8,22,15,9,18,13,-1,9,13,9,23,8,9,524,214,310,121,57,64,13,32,224,75,41,106,-19,0,128,19,34,39,32,32,96,56,7,67,45,21,20,17,15,0,20,11,3,6,11,5,25,10,17,11,4,-5,-226,-149,-77,-19,-13,-6,-8,-70,-106,-54,-33,41,17,-23,-86,-24,-29,-9,-25,-47,-20,-30,-4,50,3,1,-23,0,0,-3,3,-8,-11,5,0,-4,0,9,-12,-5,0,1,1,-27,28,55,15,40,-1,18,-92,7,-11,64,-7,9,-38,-2,-4,13,6,9,-54,9,-7,51,18,12,6,0,10,3,7,4,-2,-2,4,1,11,8,8,2,6,2,88,-8,96,114,61,53,17,21,30,-33,7,47,-4,21,5,-43,-1,7,21,0,25,10,8,40,24,38,10,18,9,9,15,20,8,5,4,4,9,18,2,13,5,5,337,117,220,184,88,96,77,30,133,15,-18,97,27,4,58,-4,-14,44,50,26,75,19,-4,53,43,18,44,22,41,11,21,9,20,6,20,8,22,9,24,16,21,3,481,139,342,372,152,220,93,36,174,75,6,82,42,9,30,32,-17,26,51,27,144,43,23,56,70,47,94,85,48,22,26,21,34,38,17,11,44,26,60,47,31,11
35,35027,Teror,11654,184,96,88,31,12,19,54,37,67,29,13,-15,25,16,39,7,12,0,29,21,28,22,1,-15,7,9,5,4,2,4,4,2,2,0,1,3,3,7,3,4,1,1,127,66,61,23,13,10,21,28,52,25,11,-12,15,2,29,14,11,-7,6,26,23,11,0,-5,3,4,7,5,2,2,2,1,5,2,2,1,1,3,2,3,0,1,-69,-15,-54,32,22,10,-36,-1,-7,-19,9,-9,-17,4,5,-15,10,0,-19,-5,-12,-4,-1,-9,9,7,7,5,1,2,6,3,6,2,1,3,3,4,1,3,0,-1,203,81,122,64,35,29,52,42,55,44,26,-15,17,15,34,15,9,-6,35,27,21,29,17,-9,21,7,19,10,6,0,11,5,11,5,2,0,10,2,8,5,4,0,-113,-27,-86,25,11,14,-47,0,-34,-20,2,-11,-11,-7,6,-14,6,-7,-36,7,-40,-6,-4,-4,5,6,8,2,3,1,2,3,3,1,1,1,3,3,5,1,2,0,48,49,-1,41,20,21,15,-17,21,20,2,6,14,-2,11,13,4,9,1,-15,10,7,-2,-3,5,4,7,10,10,4,5,2,4,3,4,2,0,2,3,7,6,2,76,42,34,14,3,11,10,6,35,12,18,-8,0,-1,19,13,10,-2,10,7,16,-1,8,-6,1,2,6,-1,5,0,0,0,1,-2,3,1,1,2,5,1,2,-1,93,58,35,35,17,18,42,10,32,9,9,-11,29,7,7,1,9,1,13,3,25,8,0,-12,3,7,9,11,1,3,0,5,5,5,0,1,3,2,4,6,1,2,73,51,22,20,9,11,24,10,30,27,-9,-12,17,12,13,17,-6,-5,7,-2,17,10,-3,-7,12,4,2,3,-2,-1,6,2,2,1,-2,-1,6,2,0,2,0,0,-25,-12,-13,11,4,7,1,8,16,-29,-7,-13,-8,5,12,-11,2,-8,9,3,4,-18,-9,-5,3,2,1,3,1,1,2,1,0,3,-2,0,1,1,1,0,3,1,9,12,-3,12,2,10,-6,26,-13,12,13,-22,1,10,-7,5,8,-6,-7,16,-6,7,5,-16,3,1,3,3,1,1,1,-2,1,3,-1,0,2,3,2,0,2,1,-110,-34,-76,-1,-1,0,-32,4,-46,-21,4,-20,-7,-2,-16,-10,7,-9,-25,6,-30,-11,-3,-11,-2,-1,-1,1,1,1,-1,-1,-1,0,1,1,-1,0,0,1,0,0,-47,-17,-30,0,2,-2,4,-2,-8,-12,-9,-20,-8,2,5,-1,-10,-5,12,-4,-13,-11,1,-15,3,5,-2,-3,-2,-1,2,2,1,-2,0,-1,1,3,-3,-1,-2,0,-99,-34,-65,13,5,8,-18,-17,-12,-25,-9,-12,-4,-7,-13,3,-7,-4,-14,-10,1,-28,-2,-8,-1,3,2,2,3,3,0,1,2,0,1,1,-1,2,0,2,2,2,-107,-40,-67,-4,-6,2,-6,-15,-17,-19,-19,-30,4,-3,-9,-6,-10,-15,-10,-12,-8,-13,-9,-15,3,-2,3,-8,3,-4,1,-1,0,-4,0,-3,2,-1,3,-4,3,-1,35,2,33,-2,-5,3,49,3,17,-3,-7,-28,22,-6,9,-11,-2,-11,27,9,8,8,-5,-17,4,0,-1,1,-2,-4,3,0,-1,-3,-2,-2,1,0,0,4,0,-2,-14,3,-17,2,3,-1,16,5,-7,2,-15,-17,16,7,-6,-3,-5,-3,0,-2,-1,5,-10,-14,1,2,0,-1,1,-1,3,0,0,-1,1,0,-2,2,0,0,0,-1,95,48,47,59,27,32,30,15,31,53,-15,-22,12,5,18,37,-12,-15,18,10,13,16,-3,-7,14,13,10,18,7,-3,4,4,5,9,5,0,10,9,5,9,2,-3
35,35028,Tías,12684,900,497,403,981,548,433,83,245,269,172,97,36,33,136,180,84,49,18,50,109,89,88,48,18,129,178,307,213,121,32,67,98,193,108,67,14,62,80,114,105,54,18,656,309,347,885,432,453,101,241,92,74,108,35,62,108,47,25,45,18,39,133,45,49,63,17,168,163,224,158,133,33,87,68,115,75,65,19,81,95,109,83,68,14,316,209,107,762,410,352,28,121,49,38,78,4,28,76,40,22,38,5,0,45,9,16,40,-1,132,137,222,139,103,23,81,64,124,76,50,11,51,73,98,63,53,12,727,358,369,885,470,415,74,177,158,133,141,48,39,89,63,72,74,25,35,88,95,61,67,23,137,130,253,158,158,43,63,73,130,88,88,25,74,57,123,70,70,18,801,431,370,1100,589,511,10,199,270,142,137,45,-15,108,178,73,65,25,25,91,92,69,72,20,135,198,317,223,161,59,55,98,191,124,80,35,80,100,126,99,81,24,882,472,410,1121,584,537,53,238,221,115,183,82,32,123,127,72,79,45,21,115,94,43,104,37,121,216,295,197,207,83,64,106,164,109,93,47,57,110,131,88,114,36,747,382,365,1042,540,502,77,181,144,136,135,78,44,90,74,83,52,40,33,91,70,53,83,38,123,186,258,223,173,72,71,82,135,128,82,40,52,104,123,95,91,32,958,439,519,1001,463,538,83,272,173,130,210,88,34,133,90,33,99,45,49,139,83,97,111,43,119,230,231,161,193,57,57,99,104,78,90,28,62,131,127,83,103,29,376,191,185,666,328,338,31,97,61,49,92,48,9,46,56,10,49,19,22,51,5,39,43,29,84,139,147,115,125,48,44,51,73,54,71,31,40,88,74,61,54,17,-34,-23,-11,286,134,152,-19,10,-71,-64,67,46,-4,2,-45,-39,40,22,-15,8,-26,-25,27,24,34,70,54,29,65,32,25,24,22,6,34,20,9,46,32,23,31,12,172,65,107,194,74,120,23,56,59,-15,21,25,9,43,37,-29,8,0,14,13,22,14,13,25,38,59,61,15,25,-7,16,30,24,1,5,-3,22,29,37,14,20,-4,103,26,77,43,14,29,17,70,51,-7,-22,-17,10,12,22,-1,-12,-15,7,58,29,-6,-10,-2,24,57,42,-40,-5,-39,12,25,22,-22,-4,-22,12,32,20,-18,-1,-17,233,47,186,-18,-42,24,105,71,52,43,2,-56,40,15,5,29,-8,-41,65,56,47,14,10,-15,21,52,38,-29,-16,-92,3,13,14,-9,-16,-53,18,39,24,-20,0,-39,-148,-65,-83,-296,-160,-136,22,68,-48,-24,-29,-150,12,35,-7,-13,-20,-76,10,33,-41,-11,-9,-74,3,25,-66,-73,-30,-161,4,7,-31,-47,-15,-80,-1,18,-35,-26,-15,-81,-472,-221,-251,-566,-263,-303,-90,47,-62,-67,-123,-174,-38,43,-10,-47,-64,-103,-52,4,-52,-20,-59,-71,-64,10,-91,-125,-109,-190,-33,16,-25,-61,-55,-106,-31,-6,-66,-64,-54,-84,-51,-5,-46,169,103,66,-81,71,7,-19,26,-58,-59,22,14,26,13,-19,-22,49,-7,-45,13,-39,6,70,68,40,50,-72,-2,29,46,34,26,-31,8,41,22,6,24,-41,115,46,69,226,125,101,-12,80,69,13,1,-40,-1,22,61,-19,7,-22,-11,58,8,32,-6,-18,12,79,94,44,27,-39,14,32,55,18,17,-15,-2,47,39,26,10,-24,114,85,29,263,122,141,-36,110,21,26,10,-19,-9,55,14,38,-5,-6,-27,55,7,-12,15,-13,13,100,98,61,32,-44,9,50,52,23,7,-22,4,50,46,38,25,-22
35,35029,Tinajo,4149,297,169,128,95,55,40,35,71,119,45,19,4,21,34,69,30,12,1,14,37,50,15,7,3,5,13,49,14,12,1,2,7,27,12,6,0,3,6,22,2,6,1,216,128,88,91,47,44,11,66,92,34,11,-2,6,35,64,19,2,-1,5,31,28,15,9,-1,11,24,30,18,6,0,4,12,19,7,3,0,7,12,11,11,3,0,105,52,53,75,33,42,20,30,11,33,8,5,8,18,4,15,3,4,12,12,7,18,5,1,10,21,18,21,4,1,2,10,6,12,2,1,8,11,12,9,2,0,36,27,9,63,38,25,-8,19,24,-11,6,1,4,15,12,-4,2,-2,-12,4,12,-7,4,3,10,9,23,9,8,4,9,7,11,5,5,1,1,2,12,4,3,3,87,52,35,91,48,43,-4,16,33,14,20,6,-2,9,21,8,13,3,-2,7,12,6,7,3,9,22,26,17,13,4,3,11,17,9,6,2,6,11,9,8,7,2,209,111,98,97,50,47,31,48,83,27,9,6,19,12,58,9,7,3,12,36,25,18,2,3,15,19,36,16,6,3,8,7,23,4,4,2,7,12,13,12,2,1,128,68,60,96,56,40,10,50,38,13,8,7,7,25,28,2,3,1,3,25,10,11,5,6,8,19,42,13,10,1,4,9,26,9,5,1,4,10,16,4,5,0,67,31,36,52,25,27,2,27,28,-7,13,4,0,14,12,-2,6,1,2,13,16,-5,7,3,2,21,10,7,9,3,4,5,5,4,7,0,-2,16,5,3,2,3,57,25,32,38,18,20,26,-1,13,-8,8,20,16,1,4,-6,2,7,10,-2,9,-2,6,13,5,13,6,6,7,0,0,7,1,6,3,0,5,6,5,0,4,0,-34,-18,-16,-17,-9,-8,6,26,-24,-18,-14,-10,-4,19,-8,-15,-5,-6,10,7,-16,-3,-9,-4,-3,3,-11,-2,-1,-3,-2,2,-3,-3,0,-3,-1,1,-8,1,-1,0,51,-6,57,14,5,9,15,14,9,-1,12,3,6,-5,-1,-2,1,-3,9,19,10,1,11,6,1,11,1,-4,4,-2,1,3,5,-5,1,-2,0,8,-4,1,3,0,-9,-1,-8,20,5,15,2,11,4,-27,6,-5,1,7,-2,-9,4,-3,1,4,6,-18,2,-2,5,7,2,2,4,-1,4,2,-3,0,1,0,1,5,5,2,3,-1,37,27,10,3,2,1,12,6,4,9,-2,4,12,5,9,1,1,-1,0,1,-5,8,-3,5,7,9,-9,2,-5,-2,5,5,-2,-3,-2,-1,2,4,-7,5,-3,-1,12,-7,19,5,-6,11,7,-6,5,-5,12,-3,-2,-3,-8,-3,5,3,9,-3,13,-2,7,-6,4,9,-9,-4,2,3,1,2,-7,-3,-1,2,3,7,-2,-1,3,1,0,10,-10,32,21,11,-2,15,-1,-2,0,-13,3,7,2,4,1,-8,-5,8,-3,-6,-1,-5,0,16,13,4,4,-6,-1,10,10,0,4,-2,1,6,3,4,0,-4,82,47,35,39,18,21,14,11,61,6,-8,-10,17,5,37,-7,1,-8,-3,6,24,13,-9,-2,1,15,25,3,-1,-6,0,9,11,0,2,-4,1,6,14,3,-3,-2,78,53,25,21,9,12,12,7,15,32,8,-2,-2,5,12,29,7,0,14,2,3,3,1,-2,5,-1,-1,10,5,1,-1,-4,-2,9,5,1,6,3,1,1,0,0,100,74,26,39,31,8,20,18,30,-3,29,1,27,12,15,-1,14,4,-7,6,15,-2,15,-3,2,15,10,-7,18,1,3,11,4,-3,13,3,-1,4,6,-4,5,-2
35,35030,Tuineje,9130,673,370,303,184,101,83,123,172,215,107,30,17,69,80,122,68,20,6,54,92,93,39,10,11,27,35,79,31,6,6,13,22,46,15,3,2,14,13,33,16,3,4,411,222,189,298,166,132,27,139,112,85,24,12,18,61,67,50,13,7,9,78,45,35,11,5,45,71,96,62,18,2,21,33,59,40,9,2,24,38,37,22,9,0,342,175,167,179,110,69,41,108,98,72,19,-3,23,52,51,35,9,-2,18,56,47,37,10,-1,23,44,52,44,13,2,14,26,36,24,8,1,9,18,16,20,5,1,429,199,230,194,113,81,80,100,129,73,21,12,34,32,69,52,1,4,46,68,60,21,20,8,44,32,57,32,20,8,28,15,38,18,10,3,16,17,19,14,10,5,578,335,243,379,232,147,78,127,185,106,46,17,37,74,122,55,28,7,41,53,63,51,18,10,49,95,136,61,26,11,18,58,93,41,16,6,31,37,43,20,10,5,365,198,167,377,223,154,58,133,108,31,27,7,20,59,70,27,20,7,38,74,38,4,7,0,60,87,124,69,25,9,36,52,76,42,12,5,24,35,48,27,13,4,285,173,112,386,220,166,40,82,16,71,75,7,40,53,6,28,44,5,0,29,10,43,31,2,66,100,114,61,37,2,36,57,66,37,19,2,30,43,48,24,18,0,439,179,260,421,221,200,93,80,91,84,71,14,34,34,36,28,37,9,59,46,55,56,34,5,73,83,109,83,55,16,39,43,58,42,28,10,34,40,51,41,27,6,27,-32,59,243,124,119,25,18,-5,-18,-5,13,11,0,-23,-11,-13,6,14,18,18,-7,8,7,47,56,73,38,18,10,25,29,37,20,5,7,22,27,36,18,13,3,-112,-43,-69,169,80,89,-47,1,-59,-19,5,8,-22,6,-29,-11,7,8,-25,-5,-30,-8,-2,0,26,36,39,37,22,7,17,14,18,13,14,3,9,22,21,24,8,4,-66,-57,-9,135,64,71,-30,10,-54,-18,17,4,-13,0,-32,-22,9,-2,-17,10,-22,4,8,6,17,30,25,25,28,9,13,10,11,11,15,4,4,20,14,14,13,5,-258,-207,-51,-330,-241,-89,-6,15,-166,-41,-52,-4,-8,3,-113,-54,-28,-6,2,12,-53,13,-24,2,-20,-12,-173,-84,-34,-8,-7,-10,-119,-81,-21,-4,-13,-2,-54,-3,-13,-4,275,142,133,104,48,56,48,32,90,44,38,16,15,27,46,17,28,5,33,5,44,27,10,11,12,17,21,28,14,12,6,10,5,15,6,6,6,7,16,13,8,6,197,111,86,137,74,63,34,42,33,38,33,16,31,6,24,28,12,8,3,36,9,10,21,8,12,35,39,16,21,13,9,15,24,12,9,5,3,20,15,4,12,8,181,89,92,63,23,40,7,34,74,43,6,11,-1,17,37,18,6,10,8,17,37,25,0,1,4,11,14,6,20,7,-1,1,6,-5,14,7,5,10,8,11,6,0,185,110,75,142,67,75,21,48,52,20,23,11,16,21,33,13,13,13,5,27,19,7,10,-2,21,33,25,21,30,11,15,10,10,10,17,5,6,23,15,11,13,6,-225,-150,-75,-459,-280,-179,31,11,13,-78,-78,-122,11,-6,6,-44,-47,-69,20,17,7,-34,-31,-53,-1,-25,-54,-133,-116,-131,-1,-24,-25,-90,-68,-73,0,-1,-29,-43,-48,-58,360,198,162,132,66,66,81,65,89,79,59,-18,47,47,39,52,25,-17,34,18,50,27,34,-1,38,30,21,33,22,-15,22,18,13,13,9,-12,16,12,8,20,13,-3
35,35031,Valsequillo de Gran Canaria,7905,128,77,51,43,23,20,32,16,45,28,13,-6,20,8,21,22,9,-2,12,8,24,6,4,-4,17,5,8,10,2,0,8,2,3,7,2,0,9,3,5,3,0,0,97,41,56,57,25,32,21,25,37,10,10,-8,8,10,22,-1,2,-1,13,15,15,11,8,-7,19,10,14,8,5,1,9,4,6,4,2,0,10,6,8,4,3,1,28,13,15,49,20,29,-8,17,14,-3,10,-4,-5,2,6,5,5,-2,-3,15,8,-8,5,-2,13,13,9,9,4,1,4,6,4,5,1,0,9,7,5,4,3,1,84,44,40,62,32,30,19,16,45,20,-12,-5,6,8,20,17,-2,-4,13,8,25,3,-10,-1,18,12,17,13,1,1,6,8,9,8,0,1,12,4,8,5,1,0,77,54,23,70,39,31,14,12,34,6,8,3,6,14,18,1,7,7,8,-2,16,5,1,-4,24,7,24,9,4,2,11,5,16,3,3,1,13,2,8,6,1,1,-99,-61,-38,42,17,25,-55,7,-31,-13,-4,-6,-27,-14,-9,-10,-4,-1,-28,21,-22,-3,0,-5,11,6,10,10,2,1,7,-1,6,4,-1,1,4,7,4,6,3,0,55,50,5,66,37,29,15,16,8,2,18,-6,15,12,12,2,12,-3,0,4,-4,0,6,-3,22,13,18,9,1,1,10,8,12,6,0,1,12,5,6,3,1,0,22,8,14,71,39,32,19,23,4,-12,-7,-6,14,7,6,-11,-2,-4,5,16,-2,-1,-5,-2,18,19,21,7,2,3,12,12,11,2,0,2,6,7,10,5,2,1,61,46,15,50,22,28,35,21,-18,29,7,-13,21,17,-10,24,3,-8,14,4,-8,5,4,-5,12,8,7,15,6,1,4,5,2,6,4,0,8,3,5,9,2,1,12,-9,21,13,3,10,-8,4,30,-6,-14,5,-8,-1,9,0,-10,1,0,5,21,-6,-4,4,2,3,4,5,1,-2,2,0,2,-1,1,-1,0,3,2,6,0,-1,4,22,-18,20,13,7,-14,1,27,-19,2,4,2,4,24,-12,0,2,-16,-3,3,-7,2,2,6,12,3,-3,1,1,5,8,3,-3,-1,1,1,4,0,0,2,0,138,46,92,22,5,17,45,26,44,16,3,4,18,7,14,4,3,1,27,19,30,12,0,3,9,2,7,2,1,1,5,1,0,-1,0,0,4,1,7,3,1,1,6,13,-7,24,12,12,10,6,5,2,-2,-11,-2,6,6,8,-2,-2,12,0,-1,-6,0,-9,9,4,-2,13,0,0,4,3,0,5,0,0,5,1,-2,8,0,0,42,26,16,18,8,10,25,22,-12,-3,0,8,10,15,-4,-2,4,1,15,7,-8,-1,-4,7,4,11,2,-3,2,2,3,6,2,-2,-2,1,1,5,0,-1,4,1,27,19,8,29,10,19,23,-3,23,-19,8,-3,17,0,7,-3,5,-5,6,-3,16,-16,3,2,5,3,10,10,1,0,5,2,2,2,0,-1,0,1,8,8,1,1,-60,-43,-17,-11,-3,-8,-17,3,-14,-14,-20,7,-10,2,-10,-15,-11,1,-7,1,-4,1,-9,6,-1,-3,-3,-7,3,0,0,-4,-2,2,1,0,-1,1,-1,-9,2,0,-24,-5,-19,37,15,22,-9,4,-29,-2,14,-3,-4,2,-11,-1,10,-2,-5,2,-18,-1,4,-1,6,7,11,9,3,0,4,2,3,1,3,1,2,5,8,8,0,-1,41,21,20,-1,1,-2,17,-5,-7,8,28,-3,5,2,-3,-1,16,0,12,-7,-4,9,12,-3,2,-4,6,-2,-3,0,2,-5,3,0,1,0,0,1,3,-2,-4,0
35,35033,Vega de San Mateo,7281,-8,17,-25,3,1,2,-19,5,9,10,-18,0,-4,4,7,10,-7,3,-15,1,2,0,-11,-3,0,1,1,0,1,0,0,0,1,0,0,0,0,1,0,0,1,0,30,15,15,34,20,14,7,10,7,13,-5,-2,0,4,3,12,0,-4,7,6,4,1,-5,2,11,3,8,7,3,2,8,1,3,5,2,1,3,2,5,2,1,1,11,5,6,11,5,6,9,-7,12,4,2,-8,2,-2,10,0,4,-6,7,-5,2,4,-2,-2,1,5,2,3,0,0,0,3,1,1,0,0,1,2,1,2,0,0,21,-7,28,10,3,7,18,-3,0,2,13,-8,11,-9,-15,4,5,-3,7,6,15,-2,8,-5,3,0,2,1,3,1,2,-1,-1,1,1,1,1,1,3,0,2,0,51,22,29,7,3,4,13,17,23,12,-8,-7,6,2,15,6,-3,-4,7,15,8,6,-5,-3,2,2,1,2,0,0,0,2,1,0,0,0,2,0,0,2,0,0,60,43,17,11,5,6,2,1,28,25,5,1,4,0,19,11,5,5,-2,1,9,14,0,-4,2,2,5,1,1,0,0,1,3,1,0,0,2,1,2,0,1,0,55,38,17,16,6,10,5,18,24,2,9,-2,-1,14,13,9,6,-1,6,4,11,-7,3,-1,3,4,4,2,1,1,0,1,3,2,0,0,3,3,1,0,1,1,8,-11,19,28,8,20,-1,25,-2,-1,-12,-7,0,4,-3,-1,-7,-8,-1,21,1,0,-5,1,8,6,6,6,0,1,4,1,1,1,0,0,4,5,5,5,0,1,55,26,29,12,3,9,17,2,33,-2,9,-9,16,-6,17,-4,0,-1,1,8,16,2,9,-8,2,3,4,2,1,-1,0,0,1,2,0,-1,2,3,3,0,1,0,78,46,32,15,5,10,16,21,30,33,-11,-13,10,10,6,25,-1,-4,6,11,24,8,-10,-9,2,6,6,0,0,0,1,2,2,0,0,0,1,4,4,0,0,0,122,70,52,23,15,8,9,22,9,33,48,2,12,22,-6,16,27,2,-3,0,15,17,21,0,8,7,5,3,0,0,6,7,1,1,0,0,2,0,4,2,0,0,64,35,29,15,7,8,13,10,4,34,2,4,7,-5,5,19,8,1,6,15,-1,15,-6,3,6,5,-3,5,2,0,4,2,-1,1,1,0,2,3,-2,4,1,0,46,19,27,11,9,2,14,15,19,-6,5,4,5,3,15,-7,-1,4,9,12,4,1,6,0,7,3,2,0,0,-1,5,2,3,0,0,-1,2,1,-1,0,0,0,-48,-25,-23,2,1,1,2,-18,-27,10,1,-19,-6,-13,-7,3,7,-11,8,-5,-20,7,-6,-8,0,1,-3,-1,4,0,1,0,-1,-2,2,0,-1,1,-2,1,2,0,-14,10,-24,15,9,6,-7,1,-16,0,19,-9,-2,1,-4,3,15,-4,-5,0,-12,-3,4,-5,2,0,6,5,3,-1,2,-1,5,3,1,-1,0,1,1,2,2,0,-32,7,-39,2,-2,4,-12,6,-3,-9,-5,-9,2,8,1,4,-2,-6,-14,-2,-4,-13,-3,-3,0,1,1,5,-2,-3,0,1,-2,3,-1,-3,0,0,3,2,-1,0,-38,2,-40,-5,-2,-3,-14,18,-24,-7,-2,-3,-1,16,-5,3,-4,-2,-13,2,-19,-10,2,-1,-3,2,-7,-1,2,2,0,0,-4,0,1,1,-3,2,-3,-1,1,1,78,54,24,29,11,18,22,7,8,21,19,-1,14,0,10,12,16,0,8,7,-2,9,3,-1,7,2,2,8,6,3,4,-2,0,3,4,1,3,4,2,5,2,2
35,35034,Yaiza,4179,1210,775,435,441,269,172,60,449,285,276,119,18,41,246,223,180,72,13,19,203,62,96,47,5,28,86,126,101,85,15,15,52,91,57,43,11,13,34,35,44,42,4,841,483,358,540,302,238,82,239,212,160,118,29,45,142,126,85,68,18,37,97,86,75,50,11,77,99,128,103,101,31,40,53,78,55,57,19,37,46,50,48,44,12,712,428,284,447,258,189,67,225,183,121,83,37,26,149,125,67,41,23,41,76,58,54,42,14,52,84,118,76,79,34,26,58,70,41,42,20,26,26,48,35,37,14,892,491,401,501,273,228,96,229,294,133,107,28,50,134,170,73,44,15,46,95,124,60,63,13,66,91,122,102,96,23,35,56,68,57,43,14,31,35,54,45,53,9,609,312,297,471,263,208,81,152,138,106,102,21,63,73,64,43,46,16,18,79,74,63,56,5,51,94,121,83,102,16,28,52,68,46,56,12,23,42,53,37,46,4,824,483,341,579,328,251,106,200,254,153,94,20,71,108,157,98,43,10,35,92,97,55,51,10,93,125,135,103,103,17,57,74,80,55,53,9,36,51,55,48,50,8,1157,672,485,768,429,339,130,271,305,234,183,31,64,161,202,125,103,20,66,110,103,109,80,11,89,154,202,158,130,34,43,85,126,90,62,22,46,69,76,68,68,12,884,384,500,606,235,371,168,198,179,162,121,40,84,88,43,91,49,22,84,110,136,71,72,18,132,152,90,90,109,31,69,53,13,31,49,18,63,99,77,59,60,13,765,376,389,818,415,403,169,176,100,136,139,44,91,91,46,53,73,24,78,85,54,83,66,20,135,163,179,163,128,46,65,86,95,79,62,25,70,77,84,84,66,21,22,-54,76,130,37,93,41,11,-134,17,56,33,32,-9,-97,-26,22,19,9,20,-37,43,34,14,20,29,-19,29,49,21,15,-1,-23,11,22,12,5,30,4,18,27,9,527,231,296,368,170,198,47,128,139,71,95,34,31,39,72,22,45,17,16,89,67,49,50,17,39,75,88,70,76,18,21,19,51,27,40,11,18,56,37,43,36,7,265,119,146,-23,-30,7,78,117,52,-5,20,-11,36,37,32,-4,19,-6,42,80,20,-1,1,-5,7,40,0,-33,-12,-29,5,12,-8,-23,-3,-16,2,28,8,-10,-9,-13,318,90,228,138,20,118,33,161,49,25,64,-16,12,73,-4,0,12,-8,21,88,53,25,52,-8,27,82,24,-23,36,-11,18,14,-1,-22,12,-3,9,68,25,-1,24,-8,244,89,155,124,26,98,17,147,95,34,-35,-7,8,55,64,15,-29,-18,9,92,31,19,-6,11,22,82,17,28,-10,-17,13,21,2,17,-9,-18,9,61,15,11,-1,1,399,244,155,26,15,11,37,191,154,74,35,-98,27,71,103,44,41,-46,10,120,51,30,-6,-52,22,77,13,-21,24,-91,6,18,15,-9,31,-47,16,59,-2,-12,-7,-44,326,142,184,196,108,88,59,153,95,-49,82,-15,32,85,40,-55,43,-4,27,68,55,6,39,-11,4,85,64,-21,81,-18,11,42,47,-29,45,-8,-7,43,17,8,36,-10,306,127,179,209,92,117,55,235,-7,-7,56,-32,27,104,-5,-16,29,-15,28,131,-2,9,27,-17,36,122,16,-7,45,-8,14,54,10,-10,23,0,22,68,6,3,22,-8,93,39,54,203,76,127,-22,223,-41,-13,-6,-49,-21,99,25,-41,5,-27,-1,124,-66,28,-11,-22,36,116,32,32,17,-31,14,34,40,-1,5,-17,22,82,-8,33,12,-14
36,36020,Agolada,4457,-13,-13,0,7,1,6,-1,-1,-11,-6,12,-5,-2,2,-14,-1,4,-2,1,-3,3,-5,8,-3,0,2,2,0,3,0,0,0,0,0,1,0,0,2,2,0,2,0,-26,-14,-12,6,1,5,-10,-9,-6,-6,2,3,-4,-6,-2,-4,-2,4,-6,-3,-4,-2,4,-1,0,2,1,1,0,2,0,0,0,0,0,1,0,2,1,1,0,1,-33,-21,-12,-3,-2,-1,-1,-5,-15,-4,-7,-2,2,-5,-7,-4,-7,0,-3,0,-8,0,0,-2,0,0,-2,-1,0,0,0,0,-1,-1,0,0,0,0,-1,0,0,0,-91,-48,-43,-2,-1,-1,-11,-17,-35,-21,-2,-5,-4,-12,-15,-14,-1,-2,-7,-5,-20,-7,-1,-3,0,0,0,0,-1,-1,0,0,0,0,0,-1,0,0,0,0,-1,0,-33,-10,-23,12,6,6,-5,-5,-20,-5,8,-4,-4,-1,-6,-2,4,1,-1,-4,-14,-3,4,-5,3,1,9,-1,0,0,1,0,5,0,0,0,2,1,4,-1,0,0,-23,-10,-13,12,4,8,2,5,-8,-3,-11,-10,3,0,0,-3,-3,-7,-1,5,-8,0,-8,-3,2,2,3,2,3,0,0,0,3,0,1,0,2,2,0,2,2,0,-34,-13,-21,7,2,5,-3,-5,-14,-2,0,-10,-2,-2,-6,-1,0,-2,-1,-3,-8,-1,0,-8,2,1,0,4,0,0,1,0,-1,2,0,0,1,1,1,2,0,0,-2,7,-9,14,9,5,-3,3,-12,2,10,-3,-2,3,-7,4,9,0,-1,0,-5,-2,1,-3,2,4,5,2,2,-1,2,2,3,1,2,-1,0,2,2,1,0,0,-18,-4,-14,8,4,4,-2,2,-11,-1,4,-10,0,3,-6,2,2,-4,-2,-1,-5,-3,2,-6,2,3,2,1,0,0,1,1,1,1,0,0,1,2,1,0,0,0,-21,-5,-16,5,3,2,2,0,-14,2,-6,-6,-1,-1,-5,3,-2,1,3,1,-9,-1,-4,-7,3,1,1,0,0,0,1,0,1,0,0,1,2,1,0,0,0,-1,-26,-10,-16,4,1,3,0,-8,-15,4,-4,-2,-2,-1,-6,3,-2,-2,2,-7,-9,1,-2,0,-1,2,2,2,-1,0,-1,1,1,1,-1,0,0,1,1,1,0,0,-15,-8,-7,0,0,0,-1,3,-4,-6,4,-10,-2,0,-1,-3,1,-2,1,3,-3,-3,3,-8,0,2,1,0,-1,-2,0,1,0,0,0,-1,0,1,1,0,-1,-1,-45,-18,-27,0,-2,2,2,-8,-8,-4,-8,-20,4,-2,-6,-1,-4,-9,-2,-6,-2,-3,-4,-11,1,1,-1,1,-1,-2,0,0,-1,2,-1,-2,1,1,0,-1,0,0,-48,-21,-27,-8,-4,-4,0,-4,-11,-11,-6,-15,-2,-2,-3,-5,-3,-5,2,-2,-8,-6,-3,-10,0,-2,-1,-4,-1,0,0,-1,0,-3,0,0,0,-1,-1,-1,-1,0,-20,-16,-4,3,1,2,2,1,-9,0,-1,-12,2,0,-6,-1,-2,-8,0,1,-3,1,1,-4,0,2,0,0,0,1,0,1,0,0,0,0,0,1,0,0,0,1,-24,-12,-12,2,1,1,-4,-5,-13,0,0,-3,-3,-2,-6,1,-1,-2,-1,-3,-7,-1,1,-1,1,0,0,1,0,0,1,0,0,0,0,0,0,0,0,1,0,0,-39,-14,-25,9,4,5,-9,-2,-7,-3,1,-18,-3,0,-3,-2,1,-7,-6,-2,-4,-1,0,-11,0,1,4,3,1,0,0,1,1,2,0,0,0,0,3,1,1,0,-15,-6,-9,1,1,0,4,1,2,-9,1,-13,4,0,-1,-5,1,-5,0,1,3,-4,0,-8,1,1,2,-3,2,-2,1,1,0,-2,1,0,0,0,2,-1,1,-2
36,36001,Arbo,4459,-18,-10,-8,7,5,2,-9,7,-17,-1,9,-6,-4,1,-10,2,2,0,-5,6,-7,-3,7,-6,0,1,0,2,3,1,0,1,0,2,1,1,0,0,0,0,2,0,-23,-6,-17,5,4,1,-2,-19,-5,-1,7,-2,-3,-5,-3,3,2,0,1,-14,-2,-4,5,-2,1,0,1,2,0,1,0,0,1,2,0,1,1,0,0,0,0,0,6,0,6,14,6,8,-2,0,-12,5,11,3,-1,0,-8,-2,8,3,-1,0,-4,7,3,0,3,4,4,1,2,0,2,4,1,-2,1,0,1,0,3,3,1,0,-13,12,-25,11,6,5,-7,-6,-2,3,5,-4,-4,1,6,7,2,2,-3,-7,-8,-4,3,-6,1,1,3,4,0,2,0,0,2,3,0,1,1,1,1,1,0,1,18,18,0,15,10,5,12,-3,2,4,9,-7,6,-1,0,3,10,-1,6,-2,2,1,-1,-6,3,1,3,3,5,0,2,1,1,2,4,0,1,0,2,1,1,0,21,12,9,28,11,17,11,2,5,8,2,-9,4,-1,0,6,3,-1,7,3,5,2,-1,-8,9,3,8,4,-1,4,2,0,2,4,-1,3,7,3,6,0,0,1,17,3,14,9,2,7,-2,5,-14,10,15,0,1,5,-10,-1,4,2,-3,0,-4,11,11,-2,1,3,1,2,4,-3,0,1,0,1,1,-2,1,2,1,1,3,-1,27,3,24,20,10,10,3,7,5,16,4,-11,-2,0,-1,8,0,-4,5,7,6,8,4,-7,3,7,2,6,2,0,2,3,0,4,1,0,1,4,2,2,1,0,-23,-8,-15,10,5,5,-1,-6,-8,-1,7,-18,-2,-2,-7,-1,6,-4,1,-4,-1,0,1,-14,2,1,3,1,0,0,1,0,1,1,0,0,1,1,2,0,0,0,6,29,-23,6,4,2,7,3,-6,10,6,-15,8,1,4,5,6,2,-1,2,-10,5,0,-17,2,0,2,2,1,-1,1,0,1,2,0,0,1,0,1,0,1,-1,-18,-20,2,-2,-6,4,-13,-4,-21,12,9,-1,-10,-6,-15,6,5,1,-3,2,-6,6,4,-2,-5,1,0,0,1,0,-4,-1,-1,-1,1,0,-1,2,1,1,0,0,-11,-1,-10,-1,-4,3,-3,2,-14,-2,12,-9,2,0,-8,0,6,-2,-5,2,-6,-2,6,-7,0,-1,-1,-2,3,-2,0,0,-2,-1,0,-1,0,-1,1,-1,3,-1,-11,5,-16,10,5,5,0,6,-7,0,-4,-6,0,5,4,1,0,-4,0,1,-11,-1,-4,-2,3,0,2,0,2,3,1,0,2,-1,1,2,2,0,0,1,1,1,14,25,-11,0,2,-2,6,-3,1,20,2,-10,2,0,3,20,2,0,4,-3,-2,0,0,-10,-2,-1,0,4,-1,0,-1,0,0,3,0,0,-1,-1,0,1,-1,0,-6,-6,0,4,2,2,-2,-4,-4,-5,15,-6,1,-4,-7,-4,8,1,-3,0,3,-1,7,-7,0,-1,1,1,2,1,0,0,0,0,1,1,0,-1,1,1,1,0,-46,-22,-24,-3,-2,-1,-5,-10,-9,-16,-5,0,-3,-6,-2,-11,0,1,-2,-4,-7,-5,-5,-1,0,-3,-1,-3,1,3,0,-2,0,-2,0,2,0,-1,-1,-1,1,1,-32,-11,-21,-1,1,-2,-3,1,-4,-9,-6,-11,-4,3,1,-5,-3,-3,1,-2,-5,-4,-3,-8,-1,1,-2,-1,2,0,0,1,-1,-1,2,0,-1,0,-1,0,0,0,-45,-22,-23,-6,-5,-1,-9,-9,-17,-4,5,-9,-4,-4,-7,-5,5,-6,-5,-5,-10,1,0,-3,-1,0,-2,-1,1,-3,0,0,-1,-1,0,-3,-1,0,-1,0,1,0
36,36003,Baiona,10659,119,48,71,43,20,23,23,7,16,40,16,13,9,-2,0,23,6,8,14,9,16,17,10,5,10,7,13,4,5,2,4,3,4,3,2,2,6,4,9,1,3,0,59,26,33,73,36,37,-3,-1,34,-7,34,2,-1,-3,12,-4,21,2,-2,2,22,-3,13,0,20,6,24,8,8,6,5,3,15,6,5,2,15,3,9,2,3,4,159,91,68,142,77,65,22,18,28,34,42,8,7,12,25,19,21,3,15,6,3,15,21,5,25,20,37,26,25,8,12,13,21,15,12,4,13,7,16,11,13,4,226,104,122,119,58,61,43,7,51,77,26,15,19,-7,20,45,13,9,24,14,31,32,13,6,23,11,29,29,19,4,13,4,12,16,9,2,10,7,17,13,10,2,169,99,70,58,31,27,18,12,64,22,35,9,12,10,41,13,17,3,6,2,23,9,18,6,15,4,20,7,12,-1,5,4,10,3,8,0,10,0,10,4,4,-1,153,59,94,75,34,41,19,18,47,45,24,1,5,12,25,17,3,-3,14,6,22,28,21,4,18,7,21,18,8,3,9,4,10,7,3,1,9,3,11,11,5,2,141,82,59,75,37,38,2,14,33,64,15,5,2,11,14,37,8,4,0,3,19,27,7,1,11,15,17,14,18,0,6,7,10,6,8,0,5,8,7,8,10,0,102,67,35,104,59,45,15,23,28,21,20,-5,7,10,17,22,11,0,8,13,11,-1,9,-5,17,17,34,22,10,2,8,8,19,15,5,2,9,9,15,7,5,0,91,56,35,50,32,18,11,14,31,31,5,1,12,5,14,24,6,-1,-1,9,17,7,-1,2,6,10,21,7,1,2,5,4,14,7,1,0,1,6,7,0,0,2,28,10,18,15,14,1,5,16,-3,3,10,-5,-11,13,3,-3,3,2,16,3,-6,6,7,-7,3,6,4,3,2,-3,0,2,4,7,3,-2,3,4,0,-4,-1,-1,98,55,43,39,17,22,28,18,29,30,0,1,20,9,4,24,-1,4,8,9,25,6,1,-3,10,6,7,11,-1,5,6,1,3,5,0,1,4,5,4,6,-1,4,-5,-14,9,24,10,14,-12,-6,19,-9,-1,6,-4,2,5,-12,-2,-1,-8,-8,14,3,1,7,7,7,9,-1,3,-1,3,3,4,1,1,-2,4,4,5,-2,2,1,7,1,6,-2,-2,0,-4,6,-11,6,9,2,2,0,7,-12,0,4,-6,6,-18,18,9,-2,1,1,-5,-3,1,3,0,0,-2,-2,-1,3,1,1,-3,-1,2,0,14,-3,17,-33,-22,-11,5,3,-18,-5,14,3,-1,6,-12,-4,3,-2,6,-3,-6,-1,11,5,-1,2,-12,-13,-6,-3,0,1,-7,-10,-4,-2,-1,1,-5,-3,-2,-1,-50,-35,-15,-9,-9,0,-7,-8,-20,-3,-8,-2,-6,-2,-12,-6,-9,0,-1,-6,-8,3,1,-2,0,-4,-3,-4,0,0,-3,-3,-1,-2,-2,1,3,-1,-2,-2,2,-1,-82,-33,-49,-99,-52,-47,0,-8,-39,-22,-8,-5,2,-10,-19,-12,-4,10,-2,2,-20,-10,-4,-15,-5,-10,-14,-19,-34,-18,-5,-7,-11,-10,-19,-1,0,-3,-3,-9,-15,-17,49,16,33,9,3,6,10,-11,-5,38,14,0,6,-12,6,15,3,-2,4,1,-11,23,11,2,2,-3,4,7,-1,-3,1,-3,2,4,-2,0,1,0,2,3,1,-3,48,15,33,24,4,20,-8,-4,18,-2,29,15,-6,-1,3,-1,15,6,-2,-3,15,-1,14,9,6,2,6,4,5,1,2,1,4,-2,2,-3,4,1,2,6,3,4
36,36002,Barro,3533,-13,-12,-1,18,8,10,-5,-3,-15,-1,9,2,-6,-3,-8,-3,7,2,1,0,-7,2,2,0,3,2,1,5,4,3,1,0,1,2,3,1,2,2,0,3,1,2,15,20,-5,14,10,4,2,-3,13,-2,3,0,-1,4,11,1,2,1,3,-7,2,-3,1,-1,2,3,2,5,1,0,2,2,1,4,0,0,0,1,1,1,1,0,-12,-11,-1,6,2,4,0,-6,-4,2,-3,1,-1,-4,-7,2,-1,0,1,-2,3,0,-2,1,3,1,2,0,0,0,1,1,1,0,-1,0,2,0,1,0,1,0,-22,9,-31,14,7,7,-12,-1,-13,6,2,-2,-2,-1,6,3,3,0,-10,0,-19,3,-1,-2,0,4,2,6,1,1,0,2,1,3,1,0,0,2,1,3,0,1,-7,-5,-2,20,10,10,-4,0,-11,4,1,0,-5,2,-10,6,0,1,1,-2,-1,-2,1,-1,2,5,4,2,5,1,0,3,2,2,1,1,2,2,2,0,4,0,-2,-2,0,8,2,6,0,-6,-3,3,2,0,1,-1,-2,1,-2,1,-1,-5,-1,2,4,-1,2,0,2,2,1,1,1,0,1,0,-1,1,1,0,1,2,2,0,30,22,8,7,3,4,-3,9,9,5,4,5,2,3,13,3,1,0,-5,6,-4,2,3,5,0,3,1,2,1,0,0,0,1,1,1,0,0,3,0,1,0,0,96,50,46,4,5,-1,20,9,30,21,10,5,11,3,15,13,7,1,9,6,15,8,3,4,2,-1,0,2,1,0,2,1,1,1,0,0,0,-2,-1,1,1,0,86,56,30,-3,-2,-1,4,6,53,13,8,1,0,5,34,11,4,1,4,1,19,2,4,0,-1,0,0,0,-3,1,0,0,0,0,-2,0,-1,0,0,0,-1,1,77,50,27,-2,-1,-1,15,13,18,22,4,6,15,2,10,15,4,4,0,11,8,7,0,2,0,1,-1,-1,-2,1,0,1,-1,-1,0,0,0,0,0,0,-2,1,15,-4,19,9,4,5,11,-3,-3,3,5,0,0,-5,-4,1,3,0,11,2,1,2,2,0,1,0,4,2,2,0,0,0,1,1,2,0,1,0,3,1,0,0,35,22,13,4,3,1,4,1,19,14,0,-4,6,2,11,4,2,-3,-2,-1,8,10,-2,-1,-2,1,1,3,2,-1,-1,1,1,1,2,-1,-1,0,0,2,0,0,3,3,0,7,4,3,0,-5,1,-1,4,1,3,-8,7,-4,2,0,-3,3,-6,3,2,1,0,1,-1,-1,4,4,-1,1,0,0,3,1,1,0,-1,-1,1,3,4,9,-5,-3,-3,0,-7,-5,16,2,-4,2,-3,-4,15,3,-4,1,-4,-1,1,-1,0,1,0,0,0,-2,0,-1,0,0,0,-2,0,-1,0,0,0,0,0,0,41,19,22,0,-1,1,15,6,11,-3,9,3,7,5,9,-9,5,1,8,1,2,6,4,2,2,0,1,-1,-3,1,2,0,0,-1,-2,0,0,0,1,0,-1,1,31,22,9,2,3,-1,7,-1,7,9,8,1,6,2,2,4,6,1,1,-3,5,5,2,0,1,-1,0,1,0,0,1,0,0,1,0,0,0,-1,0,0,0,0,-24,-5,-19,-1,-1,0,-6,-3,-15,1,4,-2,-5,-1,-4,5,2,-2,-1,-2,-11,-4,2,0,0,1,-3,0,0,1,0,0,0,-1,0,0,0,1,-3,1,0,1,28,12,16,-6,-3,-3,16,4,13,-17,11,0,5,2,7,-8,6,0,11,2,6,-9,5,0,-3,1,-2,-2,2,-2,-2,1,-1,-2,2,-1,-1,0,-1,0,0,-1
36,36004,Bueu,12517,-25,2,-27,40,19,21,-12,-14,-20,14,7,2,-1,0,-8,7,5,2,-11,-14,-12,7,2,0,9,4,10,9,5,3,4,3,4,4,3,1,5,1,6,5,2,2,-35,-26,-9,28,13,15,5,-31,-23,11,7,-4,2,-16,-18,0,7,-2,3,-15,-5,11,0,-2,10,1,6,5,5,1,5,1,1,2,3,1,5,0,5,3,2,0,-100,-46,-54,21,9,12,-9,-17,-38,-28,0,-7,-5,-13,-12,-15,1,-2,-4,-4,-26,-13,-1,-5,7,7,4,-2,2,3,3,2,2,-2,2,2,4,5,2,0,0,1,23,5,18,14,7,7,-6,-12,8,10,17,6,-5,-14,5,5,12,3,-1,2,3,5,5,3,0,0,3,-2,7,6,0,1,1,-3,4,4,0,-1,2,1,3,2,36,12,24,41,20,21,8,-3,-2,14,11,6,9,-5,-9,4,7,3,-1,2,7,10,4,3,8,3,8,12,5,5,4,2,2,6,3,3,4,1,6,6,2,2,-33,-23,-10,30,13,17,-4,-14,-32,16,3,2,-2,-11,-22,12,-4,6,-2,-3,-10,4,7,-4,6,3,8,8,2,3,3,0,4,4,0,2,3,3,4,4,2,1,-97,-40,-57,23,14,9,-19,-19,-37,-9,1,-12,-9,-5,-12,-4,2,-10,-10,-14,-25,-5,-1,-2,7,1,6,5,3,0,4,1,2,4,3,-1,3,0,4,1,0,1,-75,-36,-39,27,17,10,-29,-6,-46,9,0,-4,-14,-2,-26,1,3,0,-15,-4,-20,8,-3,-4,5,2,5,5,7,1,2,2,3,2,6,1,3,0,2,3,1,0,-33,-5,-28,8,0,8,-1,-6,-16,-3,8,-10,7,-3,-13,2,7,-3,-8,-3,-3,-5,1,-7,-1,2,3,-1,2,3,-1,0,-1,-1,2,1,0,2,4,0,0,2,47,35,12,9,4,5,2,10,2,24,5,4,-3,7,2,21,6,2,5,3,0,3,-1,2,1,0,-1,7,3,-1,0,0,-2,5,2,-1,1,0,1,2,1,0,-22,-4,-18,-10,-12,2,7,4,-37,-13,17,-3,8,1,-16,-12,13,-1,-1,3,-21,-1,4,-2,2,0,-9,-8,3,2,0,0,-8,-7,2,1,2,0,-1,-1,1,1,16,30,-14,6,7,-1,-4,-14,22,13,6,-8,5,-5,12,12,5,0,-9,-9,10,1,1,-8,0,0,2,-3,7,0,0,1,2,-1,5,0,0,-1,0,-2,2,0,40,13,27,11,1,10,17,-1,19,15,-4,-7,8,-12,11,11,-1,-5,9,11,8,4,-3,-2,4,4,2,3,0,-2,0,-1,-1,3,0,0,4,5,3,0,0,-2,32,13,19,-6,-6,0,22,-5,14,-13,10,1,9,-1,8,-15,8,4,13,-4,6,2,2,-3,2,-3,-1,-6,6,-4,-2,-4,0,-5,6,-1,4,1,-1,-1,0,-3,-67,-19,-48,-14,-7,-7,-19,4,-30,-18,-6,-2,-8,-1,0,-5,-4,0,-11,5,-30,-13,-2,-2,2,1,-11,0,-5,-1,1,1,-3,-2,-4,0,1,0,-8,2,-1,-1,-24,-28,4,11,6,5,10,-7,-33,-3,15,-7,0,6,-25,-12,4,-3,10,-13,-8,9,11,-4,7,3,1,-6,7,-1,2,3,0,-5,6,0,5,0,1,-1,1,-1,-3,18,-21,11,7,4,-5,-3,-6,2,1,5,6,1,-1,10,-1,1,-11,-4,-5,-8,2,4,-2,2,-4,7,4,1,-1,2,-3,5,2,0,-1,0,-1,2,2,1,48,13,35,16,5,11,14,3,23,-14,17,-1,8,-7,11,-15,9,2,6,10,12,1,8,-3,2,3,3,0,5,0,0,1,4,-3,4,-3,2,2,-1,3,1,3
36,36005,Caldas de Reis,9405,16,-12,28,32,17,15,14,-18,9,10,-1,2,0,-17,2,7,-3,1,14,-1,7,3,2,1,8,9,8,2,2,1,3,6,4,1,1,1,5,3,4,1,1,0,21,15,6,31,19,12,-1,11,14,-3,6,-6,3,3,5,-3,6,1,-4,8,9,0,0,-7,5,4,13,5,2,1,3,2,8,3,2,1,2,2,5,2,0,0,86,34,52,72,37,35,37,-6,8,8,22,13,19,-3,-1,3,9,7,18,-3,9,5,13,6,18,7,17,8,13,8,11,3,10,4,6,3,7,4,7,4,7,5,71,45,26,47,31,16,3,15,41,7,0,0,0,7,24,11,-4,4,3,8,17,-4,4,-4,5,6,12,11,8,4,3,2,9,9,4,3,2,4,3,2,4,1,146,74,72,52,31,21,26,26,35,36,11,10,12,22,12,19,4,6,14,4,23,17,7,4,7,15,10,11,5,3,3,11,6,7,2,1,4,4,4,4,3,2,99,31,68,52,21,31,8,18,44,7,8,12,-1,-5,27,3,4,2,9,23,17,4,4,10,13,12,12,6,6,2,4,5,3,5,3,0,9,7,9,1,3,2,127,77,50,75,42,33,38,4,52,7,17,13,21,1,37,5,7,8,17,3,15,2,10,5,17,12,15,14,10,6,9,6,8,9,3,6,8,6,7,5,7,0,197,133,64,136,85,51,33,32,52,37,16,23,33,12,43,26,7,10,0,20,9,11,9,13,22,23,51,29,8,3,13,12,37,16,6,1,9,11,14,13,2,2,102,44,58,43,21,22,34,4,13,28,5,14,21,-4,0,15,5,7,13,8,13,13,0,7,4,10,12,9,5,3,3,2,4,7,3,2,1,8,8,2,2,1,21,9,12,8,4,4,8,4,-1,-3,7,-2,1,-1,6,-16,8,6,7,5,-7,13,-1,-8,0,3,2,2,0,1,1,1,-2,1,2,1,-1,2,4,1,-2,0,-2,5,-7,-2,-4,2,-13,19,-17,-6,10,1,-7,10,-1,-5,8,-1,-6,9,-16,-1,2,2,4,7,-13,-3,1,1,2,4,-7,-3,0,-1,2,3,-6,0,1,2,-36,-36,0,0,-3,3,-11,-10,-28,-1,4,10,-16,-16,-16,4,2,5,5,6,-12,-5,2,5,7,0,1,-6,-2,0,1,-5,-2,3,-2,2,6,5,3,-9,0,-2,-7,-20,13,-19,-18,-1,6,13,-27,-15,9,0,2,10,-21,-17,2,2,4,3,-6,2,7,-2,-1,0,-7,-12,0,1,0,-2,-5,-9,-2,0,-1,2,-2,-3,2,1,-87,-49,-38,-13,-12,-1,-24,-8,-22,-34,5,-3,-17,-9,-10,-17,6,-1,-7,1,-12,-17,-1,-2,-1,3,-6,-8,0,-1,0,0,-4,-8,0,0,-1,3,-2,0,0,-1,-21,-13,-8,1,2,-1,-4,-8,-9,-19,3,12,-5,-6,-4,-9,0,8,1,-2,-5,-10,3,4,6,2,2,-7,1,-3,5,1,-2,-3,1,0,1,1,4,-4,0,-3,22,16,6,31,4,27,-7,9,-9,-1,15,10,-3,1,3,3,11,1,-4,8,-12,-4,4,9,5,9,10,-1,2,6,1,2,1,-5,2,3,4,7,9,4,0,3,31,16,15,20,3,17,-5,9,-7,23,8,5,-6,-1,2,12,9,-2,1,10,-9,11,-1,7,2,8,3,5,3,-1,0,1,2,1,0,-1,2,7,1,4,3,0,52,15,37,47,17,30,22,-13,14,1,6,15,8,-12,14,-11,0,11,14,-1,0,12,6,4,9,8,11,8,5,3,3,4,3,2,1,2,6,4,8,6,4,1
36,36006,Cambados,13067,-2,-1,-1,35,20,15,-3,-18,13,-8,8,6,-2,-9,9,-4,2,3,-1,-9,4,-4,6,3,10,1,11,7,6,0,7,0,4,6,3,0,3,1,7,1,3,0,-8,-32,24,23,11,12,0,-34,7,3,8,7,-4,-24,-4,-2,2,0,4,-10,11,5,6,7,3,3,3,6,6,2,1,2,2,2,3,1,2,1,1,4,3,1,56,42,14,5,5,0,28,6,19,9,-3,-5,18,6,10,8,3,-3,10,0,9,1,-6,-2,1,0,-4,4,3,1,2,0,-4,4,3,0,-1,0,0,0,0,1,63,31,32,13,4,9,19,8,-13,23,8,21,12,-5,2,13,6,5,7,13,-15,10,2,16,4,2,-1,3,4,1,3,0,-1,1,1,0,1,2,0,2,3,1,-13,-9,-4,60,39,21,-28,-6,18,-9,2,8,-25,2,20,-5,1,-1,-3,-8,-2,-4,1,9,3,14,27,7,7,0,0,9,20,6,4,0,3,5,7,1,3,0,3,18,-15,47,29,18,0,3,13,-14,-5,8,1,10,16,-7,-1,-1,-1,-7,-3,-7,-4,9,4,18,19,8,0,-2,1,10,14,5,1,-2,3,8,5,3,-1,0,15,7,8,80,56,24,23,-15,-21,4,9,12,14,-6,-8,0,3,5,9,-9,-13,4,6,7,11,14,34,16,2,2,6,12,28,9,0,0,5,2,6,7,2,2,9,31,-22,70,43,27,10,-4,-14,7,0,13,6,-1,0,12,6,7,4,-3,-14,-5,-6,6,16,16,27,5,5,0,6,11,19,4,2,1,10,5,8,1,3,-1,113,43,70,104,45,59,23,8,40,22,16,7,8,-1,22,2,8,4,15,9,18,20,8,3,29,24,37,14,3,-3,15,9,18,5,0,-2,14,15,19,9,3,-1,144,66,78,29,10,19,29,15,51,29,-1,22,21,7,20,11,-2,9,8,8,31,18,1,13,4,4,14,3,1,1,1,1,6,-1,0,2,3,3,8,4,1,-1,58,17,41,18,7,11,16,-7,9,16,7,15,3,-10,-4,15,7,7,13,3,13,1,0,8,5,5,-1,4,2,3,3,4,-4,1,0,3,2,1,3,3,2,0,16,1,15,31,12,19,9,10,1,-7,9,-6,1,10,-11,2,3,-4,8,0,12,-9,6,-2,11,2,6,4,6,1,9,0,-1,0,4,0,2,2,7,4,2,1,-1,22,-23,26,12,14,-4,13,-6,-12,4,7,6,8,8,-7,6,2,-10,5,-14,-5,-2,5,6,14,3,-1,3,1,5,9,-1,-2,0,1,1,5,4,1,3,0,-210,-104,-106,-34,-27,-7,-40,-20,-74,-50,-10,-18,-15,-16,-29,-34,-6,-9,-25,-4,-45,-16,-4,-9,-5,-1,-14,-10,-3,-1,-3,-3,-8,-8,-3,-2,-2,2,-6,-2,0,1,29,16,13,6,-1,7,-4,-5,-8,29,14,6,2,-3,-6,19,8,-4,-6,-2,-2,10,6,10,-1,-1,0,7,0,-1,-3,0,-4,6,0,-1,2,-1,4,1,0,0,10,-10,20,-43,-24,-19,16,1,3,-7,-4,2,6,-4,9,-14,-7,0,10,5,-6,7,3,2,-2,0,-10,-23,-7,-1,0,3,-8,-15,-4,0,-2,-3,-2,-8,-3,-1,-39,-25,-14,-11,-6,-5,4,-18,-25,-14,3,9,-5,1,-19,-2,2,-1,9,-19,-6,-12,1,10,6,-1,-6,-8,-6,5,1,0,-2,-3,-3,2,5,-1,-4,-5,-3,3,-32,-17,-15,15,0,15,10,-2,-35,-7,8,-7,11,-3,-13,-12,2,-4,-1,1,-22,5,6,-3,9,10,-1,-1,2,-4,3,3,1,-5,-1,-1,6,7,-2,4,3,-3
36,36008,Cangas,23413,57,26,31,62,29,33,20,-23,13,22,25,1,7,-8,8,7,13,0,13,-15,5,15,12,1,18,7,11,10,9,7,9,3,5,5,4,3,9,4,6,5,5,4,198,140,58,52,30,22,36,-3,78,48,27,12,15,18,51,34,17,5,21,-21,27,14,10,7,9,7,12,9,8,7,3,6,8,6,4,3,6,1,4,3,4,4,139,55,84,45,21,24,27,26,25,29,15,16,0,16,11,12,11,5,27,10,14,17,4,11,10,12,12,4,1,5,4,7,7,-1,1,2,6,5,5,5,0,3,143,79,64,50,24,26,39,0,40,11,48,2,12,-6,28,8,28,6,27,6,12,3,20,-4,19,-2,16,9,8,-1,8,0,9,3,3,0,11,-2,7,6,5,-1,276,134,142,107,57,50,57,16,106,32,33,25,16,-1,59,23,20,14,41,17,47,9,13,11,24,17,20,18,12,12,11,5,15,11,6,7,13,12,5,7,6,5,288,153,135,108,62,46,46,19,99,56,67,0,18,12,58,26,33,2,28,7,41,30,34,-2,35,15,27,13,15,2,17,9,16,10,7,2,18,6,11,3,8,0,136,69,67,68,40,28,-4,34,37,45,27,-2,1,9,23,11,21,3,-5,25,14,34,6,-5,-2,26,16,15,11,2,1,12,12,8,6,1,-3,14,4,7,5,1,97,25,72,37,11,26,22,21,19,6,26,5,10,5,-12,12,12,1,12,16,31,-6,14,4,7,14,20,-5,3,-2,5,5,2,-3,3,-1,2,9,18,-2,0,-1,159,73,86,103,56,47,31,-6,34,46,38,10,18,8,8,7,23,10,13,-14,26,39,15,0,25,15,18,29,9,4,14,12,9,11,6,4,11,3,9,18,3,0,102,81,21,22,18,4,16,14,25,23,17,-2,23,15,13,24,1,3,-7,-1,12,-1,16,-5,9,3,10,0,-1,-1,8,1,8,3,-2,-1,1,2,2,-3,1,0,230,95,135,17,-6,23,11,20,40,49,4,100,-2,10,22,31,3,28,13,10,18,18,1,72,12,7,5,-6,-8,3,3,0,0,-5,-7,2,9,7,5,-1,-1,1,17,-2,19,23,5,18,3,18,-40,17,23,-3,-6,7,-17,4,15,-3,9,11,-23,13,8,0,14,6,5,-1,3,-5,4,1,3,-4,3,-2,10,5,2,3,0,-3,38,5,33,28,14,14,1,-10,-5,1,29,18,5,10,-18,-10,13,5,-4,-20,13,11,16,13,11,6,-9,6,10,3,5,6,-8,3,7,1,6,0,-1,3,3,2,46,25,21,20,11,9,29,0,17,-13,3,6,8,3,14,-9,4,-1,21,-3,3,-4,-1,7,2,3,3,1,10,0,-1,3,1,-1,8,0,3,0,2,2,2,0,-15,-10,-5,1,-7,8,-7,-20,-26,4,20,13,-8,-11,-14,6,7,11,1,-9,-12,-2,13,2,-2,-3,-8,-1,8,5,-2,-2,-6,-4,3,3,0,-1,-2,3,5,2,9,26,-17,7,4,3,-20,13,-27,1,31,10,9,4,-15,3,17,8,-29,9,-12,-2,14,2,7,6,-8,-6,7,-2,5,0,-10,0,8,-1,2,6,2,-6,-1,-1,-39,-26,-13,-16,-12,-4,1,-19,-11,-13,-13,9,-2,-3,-22,2,-16,9,3,-16,11,-15,3,0,5,0,-11,-13,-1,2,3,2,-10,-7,-5,5,2,-2,-1,-6,4,-3,26,-1,27,-1,-16,15,5,0,-13,18,15,0,1,2,-9,-5,7,2,4,-2,-4,23,8,-2,9,1,-9,-3,-3,2,4,2,-9,-10,-5,0,5,-1,0,7,2,2
36,36009,"Cañiza, A",7176,80,46,34,43,27,16,11,25,18,15,14,-4,8,11,9,10,8,0,3,14,9,5,6,-4,4,3,11,11,10,3,3,1,9,8,5,1,1,2,2,3,5,2,-20,-11,-9,9,4,5,-10,4,-16,-11,-7,21,-4,4,-5,-6,-4,4,-6,0,-11,-5,-3,17,3,1,2,2,1,0,1,1,0,1,1,0,2,0,2,1,0,0,-81,-41,-40,-6,-6,0,-7,-21,-36,5,1,-24,-12,-7,-24,8,1,-8,5,-14,-12,-3,0,-16,-1,2,1,-4,2,-6,-1,-1,1,-1,0,-4,0,3,0,-3,2,-2,25,21,4,47,27,20,0,-1,21,-2,5,4,1,-3,13,-2,6,8,-1,2,8,0,-1,-4,7,5,14,7,3,10,2,3,10,3,2,7,5,2,4,4,1,3,32,26,6,37,19,18,4,1,-5,3,16,11,4,2,6,5,4,5,0,-1,-11,-2,12,6,5,2,12,5,7,6,2,1,9,3,3,1,3,1,3,2,4,5,55,34,21,36,25,11,21,2,22,4,18,-13,10,3,11,5,12,-8,11,-1,11,-1,6,-5,7,3,15,1,9,1,5,4,10,1,5,0,2,-1,5,0,4,1,80,30,50,29,15,14,11,11,13,12,22,10,5,8,7,1,2,7,6,3,6,11,20,3,2,9,5,6,4,3,3,4,4,2,-1,3,-1,5,1,4,5,0,53,54,-1,40,20,20,20,6,11,10,23,-16,14,3,16,8,15,-3,6,3,-5,2,8,-13,12,8,4,7,7,2,7,3,4,3,3,0,5,5,0,4,4,2,21,10,11,32,20,12,10,3,9,1,9,-11,2,4,8,-5,8,-6,8,-1,1,6,1,-5,9,4,9,0,5,5,5,3,7,-1,4,2,4,1,2,1,1,3,15,9,6,28,13,15,2,-2,-1,3,10,3,-1,-3,2,3,5,3,3,1,-3,0,5,0,4,4,6,1,10,3,1,2,4,2,5,-1,3,2,2,-1,5,4,24,25,-1,33,25,8,0,10,-2,4,8,3,9,7,-2,1,10,1,-9,3,0,3,-2,2,7,8,7,3,2,6,7,4,7,0,3,4,0,4,0,3,-1,2,23,11,12,24,12,12,12,3,3,4,4,-6,-1,4,-1,4,1,2,13,-1,4,0,3,-8,7,6,2,1,2,4,2,6,0,-1,-1,4,5,0,2,2,3,0,28,14,14,10,5,5,5,-4,3,11,6,3,1,-6,1,8,3,6,4,2,2,3,3,-3,1,1,2,-1,3,3,0,0,0,0,2,3,1,1,2,-1,1,0,29,16,13,-8,-4,-4,6,10,-6,4,14,0,9,4,-5,3,3,0,-3,6,-1,1,11,0,2,3,-2,-5,0,-6,2,2,-2,-3,0,-3,0,1,0,-2,0,-3,-20,1,-21,-9,-2,-7,-7,-11,-6,-4,1,6,-9,-5,-4,10,0,9,2,-6,-2,-14,1,-3,-2,-1,1,-5,0,-2,-2,1,1,-1,1,-2,0,-2,0,-4,-1,0,23,18,5,-12,-12,0,-5,1,-14,11,13,17,-6,7,-6,4,6,11,1,-6,-8,7,7,6,-1,-3,-6,-4,0,1,-1,-4,-4,-6,0,2,0,1,-2,2,0,-1,80,32,48,20,8,12,0,10,-10,-6,6,79,-3,6,-3,-6,10,29,3,4,-7,0,-4,50,10,0,1,5,0,4,4,1,0,0,0,3,6,-1,1,5,0,1,32,26,6,9,7,2,5,-11,1,4,1,32,5,-2,10,0,1,13,0,-9,-9,4,0,19,1,-2,8,1,0,0,1,-2,7,2,0,-1,0,0,1,-1,0,1
36,36013,Covelo,4112,13,3,10,13,8,5,8,-5,5,-1,7,-2,4,-6,1,-2,3,3,4,1,4,1,4,-5,0,1,5,1,3,3,0,1,2,1,1,3,0,0,3,0,2,0,32,19,13,25,15,10,4,5,6,5,13,-2,3,4,0,2,7,2,1,1,6,3,6,-4,9,3,6,1,1,4,4,2,4,0,1,3,5,1,2,1,0,1,52,25,27,-8,1,-9,2,0,-21,-2,40,32,0,3,-5,-3,26,4,2,-3,-16,1,14,28,2,-1,-5,-2,0,-2,1,1,-2,0,2,-1,1,-2,-3,-2,-2,-1,83,45,38,26,13,13,-4,13,0,25,25,25,3,5,-3,15,14,13,-7,8,3,10,11,12,2,7,2,3,5,7,2,3,1,2,2,3,0,4,1,1,3,4,-8,7,-15,21,13,8,0,-9,-5,14,8,-16,0,-5,-2,15,6,-8,0,-4,-3,-1,2,-8,3,2,2,7,4,2,1,1,2,5,3,0,2,1,0,2,1,2,3,4,-1,19,12,7,6,-3,-11,8,1,2,-2,0,-3,4,4,1,8,-3,-8,4,-3,1,0,3,2,5,1,6,0,1,2,3,2,3,0,2,0,2,-1,3,-24,-2,-22,10,4,6,-1,-4,-2,-2,-4,-13,-1,-2,0,-7,5,2,0,-2,-2,5,-9,-15,2,0,0,0,5,2,1,0,-1,-1,3,2,1,0,1,1,2,0,-7,15,-22,7,5,2,6,-3,-7,12,8,-23,5,-1,-2,1,15,-3,1,-2,-5,11,-7,-20,0,2,-1,0,6,0,0,2,-1,-2,6,0,0,0,0,2,0,0,-15,-8,-7,3,0,3,8,-4,7,-1,-4,-20,2,-4,1,2,-1,-7,6,0,6,-3,-3,-13,0,1,1,-1,3,-1,0,1,-1,1,-1,0,0,0,2,-2,4,-1,-14,7,-21,-2,0,-2,6,-6,6,8,1,-27,4,-1,5,10,2,-11,2,-5,1,-2,-1,-16,0,-2,1,-1,2,-2,0,-2,1,0,1,0,0,0,0,-1,1,-2,-61,-20,-41,-2,-2,0,-4,-6,-14,-4,-4,-28,-5,-2,-6,2,-1,-7,1,-4,-8,-6,-3,-21,2,0,-1,-3,-3,2,1,0,-1,-3,-1,2,1,0,0,0,-2,0,-21,-2,-19,1,-1,2,3,0,-1,0,-1,-21,3,2,-1,-1,-2,-2,0,-2,0,1,1,-19,0,-1,1,1,0,0,0,-1,-1,1,0,0,0,0,2,0,0,0,-62,-43,-19,3,-4,7,0,-2,-29,-3,-13,-15,-2,-2,-17,-4,-7,-11,2,0,-12,1,-6,-4,1,-1,-3,0,4,1,0,-1,-2,-3,0,1,1,0,-1,3,4,0,-20,-9,-11,-5,-6,1,2,0,2,-7,-12,-5,3,-3,2,-2,-8,-1,-1,3,0,-5,-4,-4,2,1,-1,0,-3,-4,1,1,-2,1,-4,-3,1,0,1,-1,1,-1,-43,-25,-18,4,2,2,-2,-13,-3,5,-6,-23,-10,-8,0,2,-1,-8,8,-5,-3,3,-5,-15,1,0,-1,2,1,1,-1,0,0,2,1,0,2,0,-1,0,0,1,-47,-19,-28,-8,-3,-5,-7,-1,-10,-15,-1,-14,-2,1,-1,-10,-1,-6,-5,-2,-9,-5,0,-8,3,0,-2,-2,-5,-2,3,0,-1,-3,-4,2,0,0,-1,1,-1,-4,19,10,9,3,0,3,10,-8,7,10,3,-2,7,-8,4,5,3,-1,3,0,3,5,0,-1,-1,1,2,-1,-1,3,-1,1,1,0,-1,0,0,0,1,-1,0,3,-40,-7,-33,-1,2,-3,-4,0,-3,-5,-6,-21,-3,3,3,-3,0,-7,-1,-3,-6,-2,-6,-14,0,-1,-2,2,1,-1,0,-1,0,2,0,1,0,0,-2,0,1,-2
36,36014,Crecente,3062,-24,-16,-8,14,7,7,-5,-21,-19,6,14,2,-6,-7,-15,5,6,2,1,-14,-4,1,8,0,1,1,2,4,6,0,0,0,1,3,3,0,1,1,1,1,3,0,-1,-2,1,7,4,3,-4,-5,-18,6,16,5,-2,-6,-9,6,10,-1,-2,1,-9,0,6,6,0,1,1,3,2,0,0,0,1,1,2,0,0,1,0,2,0,0,97,42,55,14,7,7,5,8,11,14,35,25,4,1,4,1,18,14,1,7,7,13,17,11,0,3,0,1,4,6,0,1,0,0,1,5,0,2,0,1,3,1,35,3,32,8,4,4,-6,1,-4,15,15,14,-5,3,-4,10,3,-4,-1,-2,0,5,12,18,1,0,1,3,3,0,1,0,1,1,1,0,0,0,0,2,2,0,-12,-5,-7,10,5,5,-4,7,-13,-1,0,-4,1,4,-7,-5,6,-4,-5,3,-6,4,-6,0,0,1,2,2,2,2,0,1,0,0,2,2,0,0,2,2,0,0,-35,-10,-25,14,7,7,-3,-11,-7,3,3,-20,0,-7,-2,4,4,-9,-3,-4,-5,-1,-1,-11,1,1,0,2,6,4,1,1,0,0,3,2,0,0,0,2,3,2,58,38,20,29,12,17,3,2,11,14,19,8,3,2,7,10,8,7,0,0,4,4,11,1,2,5,8,1,8,4,2,2,3,1,2,1,0,3,5,0,6,3,-10,-1,-9,14,5,9,-5,7,-11,7,0,-9,-7,10,-3,3,3,-6,2,-3,-8,4,-3,-3,1,2,3,5,0,3,0,2,1,2,0,0,1,0,2,3,0,3,-10,15,-25,9,8,1,1,-3,-1,-9,9,-7,0,1,2,-2,11,3,1,-4,-3,-7,-2,-10,1,0,5,2,1,0,0,1,3,1,2,1,1,-1,2,1,-1,-1,-22,-3,-19,-3,-1,-2,-6,4,-6,9,-3,-20,0,3,-1,6,-2,-9,-6,1,-5,3,-1,-11,0,1,1,0,-1,-4,0,1,1,0,-1,-2,0,0,0,0,0,-2,48,29,19,12,6,6,6,8,6,8,14,4,2,7,2,4,10,2,4,1,4,4,4,2,3,0,1,2,3,3,2,0,0,1,2,1,1,0,1,1,1,2,-29,-11,-18,3,1,2,-3,1,-20,-3,9,-13,0,2,-9,-4,2,-2,-3,-1,-11,1,7,-11,0,0,1,-1,2,1,0,0,1,-1,0,1,0,0,0,0,2,0,-11,-2,-9,0,-2,2,4,0,-6,1,-4,-5,4,-5,-4,-3,4,2,0,5,-2,4,-8,-7,-1,-1,2,0,-2,2,-1,-1,1,-1,0,0,0,0,1,1,-2,2,15,3,12,1,3,-2,11,3,2,4,-5,-2,3,1,0,3,-2,-3,8,2,2,1,-3,1,0,0,2,2,2,-5,0,0,3,2,1,-3,0,0,-1,0,1,-2,53,18,35,1,2,-1,-3,9,-2,14,21,14,-3,5,-1,6,5,5,0,4,-1,8,16,9,-1,0,-1,0,0,2,0,0,-1,0,0,2,-1,0,0,0,0,0,-44,-28,-16,4,1,3,-2,-9,-11,-7,-6,-8,0,-5,-10,-5,-4,-4,-2,-4,-1,-2,-2,-4,0,1,1,0,2,0,0,0,0,0,0,1,0,1,1,0,2,-1,-5,3,-8,-4,-4,0,3,-7,-2,-4,8,-3,4,-2,0,-1,2,0,-1,-5,-2,-3,6,-3,0,-2,0,0,-1,-1,0,-2,0,0,0,-2,0,0,0,0,-1,1,-13,-3,-10,3,-1,4,0,2,-9,-4,-9,6,2,3,-4,-4,-3,2,-2,-1,-5,0,-6,4,1,1,2,-2,-2,3,0,0,0,-1,-2,2,1,1,2,-1,0,1
36,36015,Cuntis,5637,4,4,0,26,15,11,10,-17,-10,14,0,8,9,-4,-11,5,1,5,1,-13,1,9,-1,3,5,3,4,9,4,1,3,1,3,5,3,0,2,2,1,4,1,1,7,11,-4,31,19,12,-1,-15,0,7,13,3,3,-7,0,5,6,4,-4,-8,0,2,7,-1,8,3,4,8,5,3,5,1,1,7,3,2,3,2,3,1,2,1,-52,-22,-30,16,6,10,-18,-6,-15,-14,5,-4,-12,0,-1,-10,3,-1,-6,-6,-14,-4,2,-3,2,3,6,4,0,0,1,2,2,2,-1,0,1,1,4,2,1,0,-44,-14,-30,-14,-6,-8,3,-19,-28,7,-3,-3,4,-9,-13,5,-1,0,-1,-10,-15,2,-2,-3,-2,-3,-2,-3,-3,-1,-1,-1,0,-2,-1,-1,-1,-2,-2,-1,-2,0,-68,-26,-42,2,2,0,-9,-22,-25,-9,3,-2,2,-14,-9,-8,3,1,-11,-8,-16,-1,0,-3,-2,2,2,1,-1,0,0,0,2,1,-1,0,-2,2,0,0,0,0,-65,-28,-37,-3,-3,0,-12,2,-37,-16,7,-9,-7,4,-16,-10,6,-5,-5,-2,-21,-6,1,-4,2,0,0,-4,0,-1,0,-1,0,-2,1,-1,2,1,0,-2,-1,0,-54,-40,-14,7,3,4,-6,2,-24,-17,1,-9,-4,0,-17,-15,0,-2,-2,2,-7,-2,1,-7,0,1,1,4,0,0,0,1,1,1,0,0,0,0,0,3,0,0,15,21,-6,34,28,6,-4,-1,-1,5,13,5,1,2,4,5,9,1,-5,-3,-5,0,4,4,0,6,11,8,7,2,1,4,11,5,6,1,-1,2,0,3,1,1,4,14,-10,7,8,-1,-5,-1,-10,12,8,1,-2,1,-3,10,7,0,-3,-2,-7,2,1,1,-1,1,4,-1,3,1,0,0,5,0,3,0,-1,1,-1,-1,0,1,-1,3,-4,12,-3,15,20,-1,-16,-3,3,-2,8,-2,-3,-4,7,-3,12,1,-13,1,-4,1,16,-3,-2,4,-2,-1,6,-2,-5,0,-1,-1,10,-1,3,4,-1,0,-5,-1,-4,3,1,2,0,-6,-11,18,-1,-4,7,0,-8,9,-6,-3,-7,-6,-3,9,5,-1,1,1,2,2,0,-3,2,1,2,-1,-1,-2,-1,0,0,3,1,-1,-34,-13,-21,10,7,3,3,-3,-8,-25,9,-11,2,-3,-8,-15,9,0,1,0,0,-10,0,-11,5,1,-2,-1,5,1,3,3,-1,-3,3,1,2,-2,-1,2,2,0,-30,-14,-16,-6,-2,-4,-1,-6,-21,-3,3,0,-1,-5,-13,6,1,-1,0,-1,-8,-9,2,1,-1,-2,-5,-2,3,1,-1,-2,-1,-1,2,1,0,0,-4,-1,1,0,59,39,20,6,6,0,9,3,29,11,7,0,6,3,17,8,5,1,3,0,12,3,2,-1,2,0,1,-1,3,1,2,1,1,0,1,1,0,-1,0,-1,2,0,-19,-10,-9,-13,-11,-2,10,-4,-18,-4,5,-7,9,-3,-11,-6,3,-1,1,-1,-7,2,2,-6,-1,-1,-5,-6,0,0,-2,-1,-4,-4,0,0,1,0,-1,-2,0,0,-50,-30,-20,0,1,-1,1,-13,-26,-8,3,-5,3,-5,-19,-8,0,0,-2,-8,-7,0,3,-5,-1,-2,-3,1,3,2,0,-1,0,0,1,1,-1,-1,-3,1,2,1,-2,8,-10,-3,-1,-2,9,-1,5,-3,4,-13,6,-3,3,3,3,-2,3,2,2,-6,1,-11,2,0,-4,0,2,-3,1,0,-4,1,2,-1,1,0,0,-1,0,-2,-12,1,-13,9,4,5,2,-8,-6,2,4,-3,0,0,-2,2,2,0,2,-8,-4,0,2,-3,1,0,2,2,3,1,1,0,0,1,1,1,0,0,2,1,2,0
36,36017,"Estrada, A",22331,59,24,35,162,81,81,23,0,-12,-10,36,17,13,7,-18,-13,23,10,10,-7,6,3,13,7,32,19,36,28,29,15,16,10,15,13,17,9,16,9,21,15,12,6,-18,3,-21,77,43,34,-11,2,-38,7,19,2,-2,10,-22,6,10,0,-9,-8,-16,1,9,2,20,13,12,14,15,2,14,7,4,6,10,1,6,6,8,8,5,1,50,50,0,93,59,34,18,-14,12,9,18,5,6,-2,15,9,9,11,12,-12,-3,0,9,-6,20,10,28,10,20,5,12,8,16,5,12,6,8,2,12,5,8,-1,14,28,-14,94,56,38,-3,-2,-29,19,18,12,-12,9,-7,17,15,7,9,-11,-22,2,3,5,14,11,13,23,21,11,5,7,7,16,14,6,9,4,6,7,7,5,35,11,24,117,50,67,14,6,4,13,11,-13,5,-3,-1,9,4,-2,9,9,5,4,7,-11,28,16,24,28,15,5,14,5,9,12,7,3,14,11,15,16,8,2,55,32,23,92,49,43,7,0,3,26,9,4,-8,-2,18,10,11,2,15,2,-15,16,-2,2,13,11,10,22,17,17,7,7,5,11,11,8,6,4,5,11,6,9,12,-1,13,106,48,58,6,6,-30,3,36,-4,-5,-2,-11,-8,21,9,11,8,-19,11,15,-13,17,9,24,16,25,13,8,4,11,6,15,4,9,5,13,10,10,9,48,56,-8,100,53,47,10,18,-8,18,22,-13,2,13,18,13,10,-1,8,5,-26,5,12,-12,18,11,12,30,19,7,11,6,7,14,10,3,7,5,5,16,9,4,44,40,4,16,20,-4,20,0,6,-1,24,-11,16,-3,17,0,5,4,4,3,-11,-1,19,-15,1,3,4,-10,11,6,2,3,8,-4,6,5,-1,0,-4,-6,5,1,103,53,50,79,41,38,22,36,26,1,19,0,10,16,3,10,11,5,12,20,23,-9,8,-5,15,10,19,8,12,13,2,6,9,6,8,9,13,4,10,2,4,4,35,33,2,71,37,34,8,14,-1,0,16,-3,-3,9,-6,15,8,9,11,5,5,-15,8,-12,19,8,13,8,15,7,5,7,13,2,5,5,14,1,0,6,10,2,8,34,-26,24,5,19,7,20,-27,16,2,-12,11,18,-6,5,-1,4,-4,2,-21,11,3,-16,5,14,-1,-3,2,8,5,5,-1,-7,0,3,0,9,0,4,2,5,-73,-43,-30,-28,-21,-7,-3,-3,-49,-11,3,-11,-8,-9,-17,-7,4,-7,5,6,-32,-4,-1,-4,0,-4,-20,-5,-2,3,1,-2,-15,-3,-4,3,-1,-2,-5,-2,2,0,-151,-80,-71,-2,-8,6,-20,-19,-45,-44,0,-24,-10,-12,-25,-18,-2,-9,-10,-7,-20,-26,2,-15,4,-4,-2,-7,3,3,3,-3,-5,-4,0,1,1,-1,3,-3,3,2,-27,-16,-11,-4,-10,6,10,-8,-22,-13,16,-11,11,1,-22,-10,4,-2,-1,-9,0,-3,12,-9,0,-3,-4,-1,3,1,-1,-4,-5,-1,0,1,1,1,1,0,3,0,-35,12,-47,12,3,9,1,-3,-31,-26,22,0,7,4,-9,-12,15,7,-6,-7,-22,-14,7,-7,8,-5,3,-9,10,5,4,-1,-1,-5,5,1,4,-4,4,-4,5,4,-30,-8,-22,46,32,14,9,-5,-30,-9,-1,9,11,-5,-21,-9,-1,17,-2,0,-9,0,0,-8,12,4,-8,11,8,19,11,2,-4,5,4,14,1,2,-4,6,4,5,64,7,57,81,33,48,25,14,-22,16,24,-1,12,3,-22,4,11,-1,13,11,0,12,13,0,14,13,13,16,10,13,6,2,8,5,6,6,8,11,5,11,4,7
36,36018,Forcarei,4892,8,0,8,34,18,16,-12,-2,-11,11,10,11,-7,-5,-6,3,8,7,-5,3,-5,8,2,4,1,2,4,8,8,10,0,0,3,3,6,6,1,2,1,5,2,4,-6,-1,-5,12,9,3,2,3,-13,-4,4,1,2,2,-7,0,0,1,0,1,-6,-4,4,0,4,1,2,1,2,1,2,1,1,1,2,1,2,0,1,0,0,0,15,11,4,18,13,5,1,-1,-5,-2,18,4,4,0,-2,-8,13,4,-3,-1,-3,6,5,0,1,-3,2,2,13,3,3,-1,1,0,7,3,-2,-2,1,2,6,0,1,7,-6,32,16,16,3,-1,-17,8,8,0,6,2,-14,5,5,3,-3,-3,-3,3,3,-3,8,1,6,4,5,8,4,1,1,2,3,5,4,0,5,2,2,3,-14,-12,-2,34,17,17,1,0,-26,0,5,5,-3,0,-13,-1,3,1,4,0,-13,1,2,4,10,3,2,6,9,4,3,2,1,1,7,3,7,1,1,5,2,1,-6,1,-7,22,11,11,8,-7,-10,4,5,-5,6,-4,-5,4,2,-1,2,-3,-5,0,3,-4,5,-2,6,2,12,-1,3,-2,4,2,5,-1,2,0,2,0,7,0,-12,-1,-11,23,15,8,2,-6,1,-8,4,-6,1,-5,0,-1,4,-1,1,-1,1,-7,0,-5,2,2,3,3,5,8,0,2,3,3,3,4,2,0,0,0,2,4,-53,-24,-29,12,7,5,-9,1,-30,-6,4,-12,-6,0,-12,-6,-1,1,-3,1,-18,0,5,-13,2,1,-2,3,8,0,1,1,0,0,5,0,1,0,-2,3,3,0,-73,-33,-40,-2,2,-4,-11,0,-22,-10,-10,-20,-6,-2,-11,-3,-4,-6,-5,2,-11,-7,-6,-14,0,1,0,3,-5,-1,0,0,1,2,-1,0,0,1,-1,1,-4,-1,-38,-10,-28,3,1,2,-3,7,-7,-5,-3,-29,0,4,-2,-1,-2,-11,-3,3,-5,-4,-1,-18,1,1,4,0,1,-4,0,1,3,0,0,-3,1,0,1,0,1,-1,-5,11,-16,19,10,9,-5,-4,-25,16,12,2,-1,-1,-11,10,6,10,-4,-3,-14,6,6,-8,0,2,2,6,6,2,0,0,1,4,2,3,0,2,1,2,4,-1,-17,-11,-6,0,-1,1,0,1,-1,-9,1,-6,-2,1,0,-6,1,-2,2,0,-1,-3,0,-4,0,3,1,-3,-1,0,0,1,0,-2,0,0,0,2,1,-1,-1,0,-31,-22,-9,-11,-7,-4,0,-9,-1,-10,-3,-6,4,-5,1,-8,-2,-9,-4,-4,-2,-2,-1,3,0,0,2,-6,-3,-4,0,0,3,-5,-1,-4,0,0,-1,-1,-2,0,-33,-21,-12,3,3,0,-6,-2,-7,-13,4,-8,-4,1,-8,-6,1,-4,-2,-3,1,-7,3,-4,0,0,0,-3,7,-1,-1,1,-1,-1,4,1,1,-1,1,-2,3,-2,35,19,16,6,6,0,3,6,-4,6,14,11,2,3,4,0,11,0,1,3,-8,6,3,11,0,0,2,-2,6,0,0,1,1,0,4,0,0,-1,1,-2,2,0,8,14,-6,14,7,7,3,0,-4,-10,7,9,4,1,-1,-3,3,9,-1,-1,-3,-7,4,0,2,1,1,0,4,6,1,1,0,0,1,4,1,0,1,0,3,2,-27,-11,-16,1,0,1,-12,-6,-7,-7,3,3,-2,-2,-4,-2,3,-3,-10,-4,-3,-5,0,6,-1,-1,4,-3,3,-1,0,0,0,-2,3,-1,-1,-1,4,-1,0,0,-6,8,-14,22,11,11,1,0,-5,-9,10,-2,3,0,2,-3,7,0,-2,0,-7,-6,3,-2,3,2,0,6,5,6,3,2,-1,2,2,3,0,0,1,4,3,3
36,36019,Fornelos de Montes,2343,17,10,7,7,4,3,1,8,2,6,2,-2,0,3,0,3,4,0,1,5,2,3,-2,-2,1,2,1,0,2,1,1,1,0,0,1,1,0,1,1,0,1,0,-30,-13,-17,5,4,1,-12,-7,-7,-8,4,0,-6,-2,-3,-4,2,0,-6,-5,-4,-4,2,0,2,0,0,0,2,1,1,0,0,0,2,1,1,0,0,0,0,0,-19,-7,-12,0,-3,3,-2,-3,-13,4,-6,3,0,2,-7,0,-1,0,-2,-5,-6,4,-5,3,3,2,-2,-1,-3,1,1,2,-1,-3,-1,-1,2,0,-1,2,-2,2,-16,-11,-5,1,-2,3,-6,-1,-12,2,3,-1,1,-3,-8,-1,1,0,-7,2,-4,3,2,-1,0,0,0,0,3,-2,-1,0,0,-1,1,-1,1,0,0,1,2,-1,-40,-16,-24,-5,-1,-4,-5,-16,-6,-8,-2,-4,-1,-8,-2,-5,0,-1,-4,-8,-4,-3,-2,-3,-2,-2,1,-2,0,0,-1,-2,1,-1,2,0,-1,0,0,-1,-2,0,-1,-2,1,-1,-2,1,1,-4,2,2,0,-1,1,2,0,-1,-1,-2,0,-6,2,3,1,1,-1,-1,0,-3,3,1,0,1,-1,-3,1,0,-1,-2,1,0,2,1,-13,-6,-7,-5,-4,-1,-13,4,0,-1,3,-7,-9,0,1,-1,5,-2,-4,4,-1,0,-2,-5,-1,0,0,-2,-1,-1,-1,-1,0,-1,-1,0,0,1,0,-1,0,-1,-24,-1,-23,0,1,-1,-5,-2,-9,-8,1,-1,1,0,0,-5,0,3,-6,-2,-9,-3,1,-4,2,2,-1,-1,-3,1,2,1,0,-1,-1,0,0,1,-1,0,-2,1,-2,-4,2,2,1,1,3,0,-5,8,0,-7,0,-3,-7,4,1,-1,3,3,2,4,-1,-6,1,1,0,2,-2,0,1,0,-1,2,-2,1,0,1,1,0,0,-1,5,14,-9,-2,-1,-1,1,1,-2,0,7,-2,2,3,3,3,4,-1,-1,-2,-5,-3,3,-1,-1,-2,-1,0,2,0,0,-2,0,1,1,-1,-1,0,-1,-1,1,1,49,26,23,6,4,2,4,5,7,11,13,8,1,3,5,3,10,3,3,2,2,8,3,5,-1,0,1,0,3,3,0,0,1,0,2,1,-1,0,0,0,1,2,9,1,8,-2,-2,0,3,9,-8,2,1,3,-2,3,-2,1,1,1,5,6,-6,1,0,2,0,-1,-2,-1,-1,3,0,0,-1,0,-2,1,0,-1,-1,-1,1,2,-17,-7,-10,5,4,1,-3,-3,-2,-6,1,-5,-1,0,-2,-5,2,-2,-2,-3,0,-1,-1,-3,2,0,0,-1,2,1,1,0,0,-1,1,2,1,0,0,0,1,-1,-26,-20,-6,2,0,2,-3,0,-10,-9,2,-6,-3,-1,-5,-8,-1,-2,0,1,-5,-1,3,-4,0,2,1,-1,2,-2,0,1,1,-2,1,-1,0,1,0,1,1,-1,42,32,10,6,0,6,7,2,3,9,11,10,4,3,3,10,6,6,3,-1,0,-1,5,4,1,1,0,1,-2,5,0,0,0,-1,-1,2,1,1,0,2,-1,3,-29,-10,-19,-3,-1,-2,-5,-3,-7,-10,5,-10,-1,-1,-4,-7,5,-2,-4,-2,-3,-3,0,-8,0,0,-1,-3,3,-2,0,-1,-1,-2,2,1,0,1,0,-1,1,-3,-34,-11,-23,3,4,-1,1,-8,-14,-4,-3,-6,-2,-2,-4,-3,1,-2,3,-6,-10,-1,-4,-4,-1,-1,0,3,2,0,0,0,0,1,3,0,-1,-1,0,2,-1,0,-18,-6,-12,12,3,9,4,-4,-15,3,4,-9,4,-2,-8,0,4,-3,0,-2,-7,3,0,-6,4,1,0,3,3,1,2,1,-1,1,1,-1,2,0,1,2,2,2
36,36021,Gondomar,11327,206,116,90,55,31,24,36,24,31,58,42,14,27,17,21,23,26,2,9,7,10,35,16,12,9,10,5,19,10,2,9,4,2,9,5,2,0,6,3,10,5,0,169,82,87,61,33,28,42,13,38,54,11,8,19,7,21,26,6,3,23,6,17,28,5,5,15,7,19,5,8,5,9,5,7,2,6,3,6,2,12,3,2,2,205,100,105,113,60,53,27,24,49,61,18,12,8,14,26,34,7,2,19,10,23,27,11,10,14,19,26,26,14,13,7,11,15,15,8,4,7,8,11,11,6,9,190,100,90,87,49,38,44,11,32,58,27,13,21,1,22,24,17,11,23,10,10,34,10,2,15,20,19,15,13,5,10,11,11,6,7,4,5,9,8,9,6,1,392,192,200,92,48,44,94,31,88,110,41,11,44,9,47,63,14,7,50,22,41,47,27,4,15,15,13,21,16,10,9,6,9,11,8,5,6,9,4,10,8,5,241,135,106,55,27,28,27,17,100,37,22,27,19,12,51,23,6,19,8,5,49,14,16,8,7,12,10,7,14,6,4,6,5,1,6,5,3,6,5,6,8,1,345,172,173,43,22,21,82,-4,113,62,22,65,36,5,62,39,6,21,46,-9,51,23,16,44,15,5,3,6,8,5,8,4,2,2,2,3,7,1,1,4,6,2,298,131,167,52,23,29,71,2,115,47,19,28,35,-4,41,31,11,10,36,6,74,16,8,18,13,9,8,11,4,5,8,5,2,4,2,2,5,4,6,7,2,3,157,79,78,30,12,18,18,16,35,41,15,25,10,8,23,25,1,5,8,8,12,16,14,20,9,5,9,6,3,-2,4,4,2,3,-1,0,5,1,7,3,4,-2,124,66,58,4,0,4,15,8,42,24,22,-7,4,4,20,23,12,-9,11,4,22,1,10,2,1,4,4,0,-1,-4,-2,2,1,1,1,-3,3,2,3,-1,-2,-1,-21,-7,-14,-16,-11,-5,-19,-5,7,-9,-12,3,-4,-4,12,-9,-7,-2,-15,-1,-5,0,-5,5,-4,0,-1,-5,-5,-1,-1,-1,-1,-4,-3,-1,-3,1,0,-1,-2,0,-49,-45,-4,-21,-15,-6,-13,-16,-20,-25,8,17,-18,1,-11,-27,0,12,5,-17,-9,2,8,5,-2,-3,-4,-4,-8,-1,-4,0,-4,0,-7,0,2,-3,0,-4,-1,-1,71,41,30,-4,-5,1,17,9,-1,23,15,3,5,6,4,10,7,6,12,3,-5,13,8,-3,2,-3,-2,-1,5,-6,-1,-2,-1,-2,3,-2,3,-1,-1,1,2,-4,-14,-16,2,-32,-23,-9,-17,4,6,-2,-1,-8,-11,0,-7,4,-1,-2,-6,4,13,-6,0,-6,-5,0,-7,-15,0,-5,-6,0,-5,-9,1,-4,1,0,-2,-6,-1,-1,-48,-4,-44,-3,-1,-2,-13,-15,-23,-4,14,-10,-7,-6,-3,4,9,-3,-6,-9,-20,-8,5,-7,5,-1,-3,-4,-1,1,2,1,-3,-3,0,2,3,-2,0,-1,-1,-1,6,31,-25,-27,-15,-12,12,-4,-16,6,10,1,10,-8,-5,17,10,6,2,4,-11,-11,0,-5,-1,-1,-18,-6,-2,1,0,-1,-9,0,-4,-1,-1,0,-9,-6,2,2,-31,-1,-30,5,5,0,-9,-18,19,-15,-4,3,3,-10,12,-2,0,1,-12,-8,7,-13,-4,2,4,4,4,-4,-2,-1,6,0,3,-1,-2,-1,-2,4,1,-3,0,0,-88,-35,-53,4,4,0,-4,-31,-21,-20,-7,-4,-8,-5,-5,-8,-4,-5,4,-26,-16,-12,-3,1,-3,-1,5,1,3,-1,-1,0,4,1,0,0,-2,-1,1,0,3,-1
36,36022,"Grove, O",11049,20,0,20,44,23,21,6,-3,-17,14,15,4,2,-5,-16,5,10,4,4,2,-1,9,5,0,3,6,10,8,12,5,1,3,5,4,7,3,2,3,5,4,5,2,-24,-13,-11,13,5,8,-9,-31,15,-4,4,1,-4,-17,5,-1,4,0,-5,-14,10,-3,0,1,3,1,4,2,3,0,1,0,1,1,2,0,2,1,3,1,1,0,-47,-36,-11,19,9,10,-10,-12,-34,-7,7,5,-8,-13,-18,-1,1,0,-2,1,-16,-6,6,5,6,1,-2,3,9,2,3,0,-1,0,5,2,3,1,-1,3,4,0,-37,-12,-25,19,11,8,-13,-14,-19,8,1,1,-5,-5,-7,6,2,-1,-8,-9,-12,2,-1,2,3,1,1,10,3,1,1,1,1,6,2,0,2,0,0,4,1,1,47,38,9,81,37,44,7,3,11,10,6,5,9,8,6,8,3,3,-2,-5,5,2,3,2,20,10,19,14,12,5,12,5,9,6,4,1,8,5,10,8,8,4,40,17,23,80,35,45,-1,27,-11,-1,15,8,-1,8,-5,0,4,10,0,19,-6,-1,11,-2,13,27,11,15,11,3,6,12,8,3,4,2,7,15,3,12,7,1,16,12,4,54,26,28,-12,-10,4,15,18,-3,3,-6,1,8,8,-3,-15,-4,3,7,10,0,4,7,16,16,9,1,5,6,4,7,3,1,-1,1,12,9,6,0,48,11,37,66,32,34,4,8,18,2,10,-2,-4,-2,6,-1,5,2,8,10,12,3,5,-4,6,17,23,8,8,1,4,4,15,3,3,1,2,13,8,5,5,0,32,6,26,64,26,38,13,3,20,-1,3,-2,3,-3,4,6,1,0,10,6,16,-7,2,-2,14,9,25,10,2,3,9,1,7,7,0,2,5,8,18,3,2,1,52,20,32,23,13,10,22,8,-1,14,6,0,9,6,-6,8,2,0,13,2,5,6,4,0,9,4,-1,8,2,1,4,2,1,7,-1,0,5,2,-2,1,3,1,-37,-9,-28,22,12,10,-23,-3,-14,-4,4,2,-6,-3,0,-6,4,0,-17,0,-14,2,0,2,1,7,11,1,0,2,0,4,6,1,0,1,1,3,5,0,0,1,53,23,30,43,19,24,21,13,4,-3,19,-3,10,7,-7,0,12,1,11,6,11,-3,7,-4,12,6,9,0,13,2,7,1,3,-2,9,1,5,5,6,2,4,1,-85,-36,-49,-3,-8,5,-11,-11,-18,-27,-6,-12,3,-4,-9,-17,-3,-5,-14,-7,-9,-10,-3,-7,0,0,-2,-3,3,-1,-1,0,-3,-4,1,-1,1,0,1,1,2,0,-80,-38,-42,-10,-7,-3,-20,-12,-36,-15,10,-8,-15,-2,-16,-9,5,-3,-5,-10,-20,-6,5,-5,-1,-3,-9,2,2,-2,-3,0,-5,0,0,0,2,-3,-4,2,2,-2,-8,-10,2,10,0,10,3,-7,-11,13,-5,-3,3,-3,-8,1,-2,-2,0,-4,-3,12,-3,-1,4,0,1,1,4,0,2,-1,-1,-2,2,0,2,1,2,3,2,0,-8,5,-13,10,5,5,8,-9,-26,12,2,-1,5,3,-13,11,3,-6,3,-12,-13,1,-1,5,1,0,-3,3,3,6,1,0,-3,3,3,1,0,0,0,0,0,5,23,16,7,6,2,4,0,2,0,1,13,7,6,-3,-3,3,7,5,-6,5,3,-2,6,2,1,1,-2,0,4,2,1,0,-3,2,1,1,0,1,1,-2,3,1,10,7,3,38,20,18,1,-1,-10,4,8,4,1,-2,-1,-1,5,2,0,1,-9,5,3,2,6,3,8,9,4,7,3,1,6,5,0,4,3,2,2,4,4,3
36,36023,"Guarda, A",9919,-28,0,-28,68,39,29,-11,-9,-18,-7,21,-1,-2,0,-6,-3,9,3,-9,-9,-12,-4,12,-4,15,7,13,12,16,4,8,5,8,7,9,2,7,2,5,5,7,2,6,0,6,53,27,26,-10,4,-2,-1,9,6,-3,0,-7,-1,6,5,-7,4,5,0,3,1,12,6,7,13,10,5,5,2,3,6,8,3,7,4,4,7,2,2,11,12,-1,12,11,1,2,-2,-6,2,4,9,0,3,1,7,0,-1,2,-5,-7,-5,4,10,1,2,-1,8,6,-4,1,3,2,6,3,-4,0,-1,-3,2,3,0,-2,-18,16,0,-2,2,3,-3,-6,2,-7,5,-1,-7,-10,2,-5,1,4,4,4,0,-2,4,2,0,1,1,-5,1,1,-2,1,0,-2,0,1,2,0,1,-3,1,30,21,9,53,25,28,3,-2,20,-9,9,1,9,-8,21,-12,4,2,-6,6,-1,3,5,-1,12,4,17,9,8,1,5,0,9,6,3,1,7,4,8,3,5,0,81,35,46,63,35,28,-4,-6,-7,11,22,64,-4,3,-4,5,10,24,0,-9,-3,6,12,40,9,5,15,12,12,8,6,1,9,4,8,6,3,4,6,8,4,2,115,22,93,82,48,34,-15,5,15,11,29,69,-17,-1,1,0,17,23,2,6,14,11,12,46,13,10,26,17,13,2,4,7,16,9,9,2,9,3,10,8,4,0,65,40,25,79,46,33,3,15,12,15,17,1,-9,8,17,10,5,8,12,7,-5,5,12,-7,9,20,22,17,6,4,2,13,13,14,1,2,7,7,9,3,5,2,-11,-5,-6,64,40,24,-14,-1,-6,19,6,-4,-11,-9,3,14,7,-1,-3,8,-9,5,-1,-3,4,17,17,16,10,0,2,9,14,6,8,1,2,8,3,10,2,-1,74,30,44,27,10,17,0,25,3,15,18,8,7,8,-11,10,11,4,-7,17,14,5,7,4,0,8,6,8,4,1,0,4,-1,4,2,1,0,4,7,4,2,0,41,16,25,12,8,4,13,-4,-10,23,3,10,-2,4,-9,17,-2,5,15,-8,-1,6,5,5,3,7,-1,-3,1,3,2,7,1,-3,-1,2,1,0,-2,0,2,1,37,27,10,22,17,5,7,5,-2,4,19,5,10,-8,9,4,12,1,-3,13,-11,0,7,4,2,4,2,6,4,4,2,0,4,5,4,2,0,4,-2,1,0,2,-13,-3,-10,-26,-18,-8,-6,0,-1,-1,-13,8,-5,0,-2,6,-9,8,-1,0,1,-7,-4,0,0,0,-13,-2,-11,-1,-1,-1,-8,-1,-8,1,1,1,-5,-1,-3,-2,-16,-9,-7,-4,-2,-2,-7,-4,-10,0,3,5,6,-4,4,-6,-4,-2,-13,0,-14,6,7,7,-1,-1,-4,1,1,0,1,-1,-4,0,1,1,-2,0,0,1,0,-1,-155,-104,-51,-75,-55,-20,-9,-23,-46,-53,-11,-9,-7,-14,-31,-38,-7,-5,-2,-9,-15,-15,-4,-4,-5,-6,-15,-26,-20,-3,-2,-6,-7,-23,-15,-2,-3,0,-8,-3,-5,-1,-15,-2,-13,15,8,7,-4,-13,-25,1,20,6,5,-10,-17,5,13,3,-9,-3,-8,-4,7,3,1,-2,-5,2,7,12,1,1,-3,3,2,4,0,-3,-2,-1,5,8,-39,-28,-11,-17,-14,-3,0,14,-36,-15,6,-1,-1,13,-31,-14,-2,10,1,1,-5,-1,8,-11,0,9,-13,-6,-5,-2,-1,5,-9,-1,-7,-1,1,4,-4,-5,2,-1,19,20,-1,55,35,20,5,-3,-22,14,7,15,2,3,-12,8,12,6,3,-6,-10,6,-5,9,10,7,1,26,6,5,4,6,-1,18,6,2,6,1,2,8,0,3
36,36901,"Illa de Arousa, A",4850,19,13,6,18,13,5,-2,6,7,1,6,1,1,3,6,-2,3,2,-3,3,1,3,3,-1,0,7,3,2,4,1,0,6,3,0,2,1,0,1,0,2,2,0,-68,-35,-33,10,3,7,-30,-7,-16,-14,1,-2,-12,-5,-7,-9,-1,-1,-18,-2,-9,-5,2,-1,3,2,2,2,1,0,1,1,1,0,0,0,2,1,1,2,1,0,-23,5,-28,29,19,10,-6,-9,-18,-1,11,1,2,2,-2,-4,7,1,-8,-11,-16,3,4,0,6,-1,4,6,9,4,4,3,3,3,5,1,2,-4,1,3,4,3,8,13,-5,20,7,13,-3,-7,5,2,5,4,1,-2,6,2,1,3,-4,-5,-1,0,4,1,4,2,3,0,7,4,3,0,1,-1,2,2,1,2,2,1,5,2,4,3,1,19,6,13,0,-1,-14,9,7,3,-2,-4,-3,8,3,2,2,3,-11,1,4,1,2,5,3,1,5,3,2,0,1,0,2,1,0,5,2,1,3,2,-28,-17,-11,9,2,7,-7,-8,-11,-7,7,-1,-2,-4,-7,-5,4,-2,-5,-4,-4,-2,3,1,0,0,1,1,7,0,0,0,-1,0,3,0,0,0,2,1,4,0,16,0,16,25,12,13,4,3,-9,6,9,3,1,2,-12,1,6,2,3,1,3,5,3,1,2,2,3,6,8,3,1,0,-1,5,4,2,1,2,4,1,4,1,23,3,20,12,5,7,-5,12,-1,11,6,1,-1,5,-1,2,0,0,-4,7,0,9,6,1,4,0,1,2,4,1,1,0,1,1,1,1,3,0,0,1,3,0,-9,-2,-7,25,12,13,-14,11,-4,-7,10,1,-8,10,1,-5,5,0,-6,1,-5,-2,5,1,7,5,7,3,2,1,1,4,4,2,1,0,6,1,3,1,1,1,16,6,10,10,0,10,-4,-3,2,8,4,5,-6,-1,4,4,2,1,2,-2,-2,4,2,4,1,1,0,2,2,4,-1,0,-1,0,1,1,2,1,1,2,1,3,11,14,-3,10,3,7,7,-8,3,11,3,-6,0,1,5,7,2,-3,7,-9,-2,4,1,-3,0,-1,2,3,4,2,-1,0,0,2,2,0,1,-1,2,1,2,2,-22,-13,-9,5,2,3,-13,-4,-16,2,9,-1,-7,-4,-9,2,5,-1,-6,0,-7,0,4,0,-1,1,-3,2,5,0,0,0,-1,2,1,0,-1,1,-2,0,4,0,34,16,18,0,2,-2,17,6,-9,11,2,7,11,4,-11,6,1,5,6,2,2,5,1,2,-1,0,-3,0,0,3,0,-2,-1,1,1,3,-1,2,-2,-1,-1,0,1,-4,5,-10,-10,0,17,-5,-6,2,-3,-1,2,-3,-8,7,1,0,15,-2,2,-5,-4,-1,3,-3,-2,-4,-3,-1,1,-1,-3,-4,-2,-1,2,-2,1,0,-1,0,-20,-9,-11,-4,-3,-1,-18,-3,3,-1,2,-3,-7,1,3,-2,-2,-1,-11,-4,0,1,4,-2,-1,0,1,-1,-3,0,0,0,0,0,-3,0,-1,0,1,-1,0,0,-16,-7,-9,-3,1,-4,-9,-6,5,-10,2,2,-5,-6,7,-7,2,2,-4,0,-2,-3,0,0,-1,0,-1,-1,-2,2,0,0,0,0,-1,2,-1,0,-1,-1,-1,0,63,32,31,0,1,-1,9,15,14,14,13,-1,4,5,12,6,8,-2,5,10,2,8,5,1,1,0,-3,1,1,0,1,0,-1,0,0,1,0,0,-2,1,1,-1,-7,6,-13,10,6,4,-2,-6,3,6,1,-9,5,-4,2,6,0,-3,-7,-2,1,0,1,-6,2,0,0,6,1,1,1,0,1,3,1,0,1,0,-1,3,0,1
36,36024,Lalín,20196,119,63,56,131,59,72,21,5,29,17,33,8,16,-2,12,13,21,1,5,7,17,4,12,7,20,16,25,32,31,6,10,7,9,15,16,2,10,9,16,17,15,4,153,64,89,106,54,52,20,34,33,29,28,9,7,8,20,11,15,5,13,26,13,18,13,4,24,16,25,14,18,8,9,8,14,8,9,6,15,8,11,6,9,2,317,167,150,218,114,104,56,55,74,61,30,38,25,22,54,33,7,22,31,33,20,28,23,16,36,42,53,38,20,25,13,21,34,21,6,16,23,21,19,17,14,9,284,137,147,200,116,84,60,12,119,32,28,25,30,4,47,12,22,19,30,8,72,20,6,6,44,25,53,30,29,16,25,13,31,15,18,12,19,12,22,15,11,4,132,40,92,175,85,90,25,37,24,11,32,-4,9,19,-8,2,18,-3,16,18,32,9,14,-1,26,29,39,26,41,14,11,15,17,14,23,5,15,14,22,12,18,9,185,109,76,163,84,79,23,35,55,34,22,5,18,14,30,23,8,7,5,21,25,11,14,-2,26,34,39,21,25,12,17,16,20,10,10,8,9,18,19,11,15,4,192,119,73,203,115,88,16,40,57,42,26,2,17,16,47,21,13,-2,-1,24,10,21,13,4,29,36,69,35,25,4,16,17,42,18,13,4,13,19,27,17,12,0,370,242,128,315,190,125,73,85,91,55,43,19,56,39,62,48,26,7,17,46,29,7,17,12,57,73,93,60,22,8,31,41,62,41,11,2,26,32,31,19,11,6,236,158,78,206,133,73,6,54,70,29,21,48,7,28,58,21,12,27,-1,26,12,8,9,21,24,51,73,38,10,6,19,31,55,19,3,4,5,20,18,19,7,2,117,70,47,119,71,48,-14,44,29,3,7,45,-9,18,30,15,-1,15,-5,26,-1,-12,8,30,16,35,24,24,9,8,12,21,9,19,3,5,4,14,15,5,6,3,66,22,44,-9,-19,10,22,15,20,-38,10,33,15,7,10,-30,3,14,7,8,10,-8,7,19,11,15,-4,-28,1,-4,4,6,-11,-22,4,0,7,9,7,-6,-3,-4,38,50,-12,78,41,37,0,27,-42,-7,19,43,7,12,3,-3,13,17,-7,15,-45,-4,6,26,17,22,23,0,10,5,6,14,16,-2,1,5,11,8,7,2,9,0,-182,-132,-50,-72,-61,-11,-13,-33,-114,-41,-4,22,-13,-14,-81,-27,-7,9,0,-19,-33,-14,3,13,-2,-3,-32,-19,-7,-11,-4,0,-27,-16,-5,-10,2,-3,-5,-3,-2,-1,109,49,60,-16,-14,-2,8,2,10,13,42,26,8,-3,-3,3,32,10,0,5,13,10,10,16,9,-3,-11,-7,4,-10,4,-2,-9,-2,0,-5,5,-1,-2,-5,4,-5,8,-3,11,36,14,22,9,13,-42,4,5,8,3,11,-25,-4,4,3,6,2,-17,8,1,5,6,5,4,18,8,-7,1,2,5,5,5,-5,5,3,-1,13,3,-2,163,89,74,93,43,50,2,24,41,21,29,50,4,5,21,21,21,22,-2,19,20,0,8,28,15,17,13,15,10,21,9,8,4,11,1,9,6,9,9,4,9,12,145,62,83,155,63,92,14,11,2,8,33,72,-6,-2,2,6,18,39,20,13,0,2,15,33,25,25,33,21,32,16,7,8,17,7,11,11,18,17,16,14,21,5,153,56,97,135,50,85,34,10,17,45,3,47,13,8,-1,16,4,21,21,2,18,29,-1,26,20,23,27,34,10,19,6,9,14,14,2,4,14,14,13,20,8,15
36,36025,"Lama, A",2985,-10,-13,3,34,17,17,-7,1,-13,2,6,0,-3,-4,-3,-1,1,-4,-4,5,-10,3,5,4,7,4,3,7,9,3,4,1,2,4,4,1,3,3,1,3,5,2,4,3,1,13,10,3,-7,1,5,-2,10,-4,-7,-3,5,2,5,1,0,4,0,-4,5,-5,0,1,4,3,3,2,0,1,3,3,2,1,0,0,1,0,1,1,-17,6,-23,-19,-3,-16,8,-2,-3,-6,-11,-5,6,3,2,0,-5,-1,2,-5,-5,-6,-6,-4,2,-2,-5,-3,-8,-4,2,0,0,-1,-4,-1,0,-2,-5,-2,-4,-3,12,6,6,31,16,15,-7,2,11,3,3,0,-2,2,6,0,1,-1,-5,0,5,3,2,1,5,2,15,6,-1,4,2,2,9,3,-1,1,3,0,6,3,0,3,36,19,17,53,24,29,1,0,-2,26,19,-5,4,1,-4,12,10,-2,-3,-1,2,14,9,-3,5,7,9,10,17,5,4,3,4,4,8,1,1,4,5,6,9,4,-15,-8,-7,35,12,23,-7,12,-12,-3,7,-13,-1,4,-8,0,4,-7,-6,8,-4,-3,3,-6,2,6,7,3,13,4,0,4,1,2,4,1,2,2,6,1,9,3,48,32,16,58,35,23,-2,-2,11,20,19,2,-7,-1,11,16,12,2,5,-1,0,4,7,0,7,4,10,17,9,10,3,3,7,13,4,5,4,1,3,4,5,5,41,21,20,40,19,21,11,8,10,11,15,-14,6,7,-5,3,14,-4,5,1,15,8,1,-10,8,3,5,11,13,-1,6,0,-1,4,10,-1,2,3,6,7,3,0,6,17,-11,16,14,2,5,0,-4,-2,9,-3,2,1,3,3,5,3,3,-1,-7,-5,4,-6,4,2,4,-3,4,4,4,3,2,0,1,4,0,-1,2,-3,3,0,0,0,0,43,19,24,0,7,-3,6,4,-13,3,0,1,0,3,-6,-3,7,-4,6,1,-7,5,6,10,11,6,4,4,0,6,6,3,0,1,6,4,5,3,4,41,41,0,29,19,10,4,-1,7,17,13,1,6,4,4,13,12,1,-2,-5,3,4,1,0,6,5,5,5,9,-1,4,3,2,2,8,0,2,2,3,3,1,-1,-2,13,-15,34,19,15,4,5,-1,-4,2,-9,2,2,3,3,3,0,2,3,-4,-7,-1,-9,3,9,5,5,6,5,2,5,3,4,2,3,1,4,2,1,4,2,-9,3,-12,17,14,3,2,-6,4,2,-6,-4,3,-1,2,3,-4,1,-1,-5,2,-1,-2,-5,3,1,7,4,-1,3,4,0,5,3,-1,3,-1,1,2,1,0,0,-66,-30,-36,-46,-18,-28,-7,-2,-22,-7,-16,-12,-5,-2,-13,-4,-5,-2,-2,0,-9,-3,-11,-10,-9,-2,-11,-9,-15,0,-5,0,-5,-4,-8,4,-4,-2,-6,-5,-7,-4,-1,-5,4,3,-5,8,4,4,-9,4,5,-8,-1,7,-13,5,-1,-1,5,-3,4,-1,6,-7,3,2,-2,-5,3,2,2,0,-5,-2,-2,2,1,2,3,-3,5,0,-51,-20,-31,-27,-18,-9,1,0,-6,-22,-5,-18,0,0,0,-10,-1,-8,1,0,-6,-12,-4,-10,0,-4,-2,-12,-5,-4,-1,-3,0,-9,-2,-3,1,-1,-2,-3,-3,-1,-52,-20,-32,-19,-2,-17,-6,-8,-5,-22,-4,-5,-3,-3,-2,-10,0,0,-3,-5,-3,-12,-4,-5,-1,-4,-3,-9,-5,2,1,-1,1,-2,-4,3,-2,-3,-4,-7,-1,-1,-5,-8,3,-3,-3,0,2,-1,-3,-10,6,0,2,-2,-3,-9,6,-3,0,1,0,-1,0,3,0,1,-6,-5,1,6,-1,0,-3,-3,0,4,1,1,-3,-2,1,2
36,36026,Marín,25421,-62,-29,-33,72,28,44,-42,-2,-44,-33,12,43,-20,1,-18,-18,6,14,-22,-3,-26,-15,6,29,10,22,25,5,7,3,3,6,12,2,4,1,7,16,13,3,3,2,-51,-36,-15,105,48,57,-10,-3,-39,-24,15,7,-8,-6,-21,-12,9,1,-2,3,-18,-12,6,6,16,34,26,16,6,4,8,13,16,6,2,2,8,21,10,10,4,2,-34,22,-56,146,86,60,-13,-6,-52,10,9,3,2,1,-14,17,4,4,-15,-7,-38,-7,5,-1,26,30,37,27,17,3,14,17,26,17,7,0,12,13,11,10,10,3,150,127,23,229,163,66,44,31,25,20,14,13,18,42,23,26,5,9,26,-11,2,-6,9,4,36,45,77,46,19,5,23,35,60,32,7,5,13,10,17,14,12,0,109,35,74,207,134,73,50,15,9,16,9,6,14,11,-1,10,-1,1,36,4,10,6,10,5,44,32,70,39,14,8,23,20,49,28,8,6,21,12,21,11,6,2,9,53,-44,191,132,59,9,-23,29,-4,11,-12,1,-4,34,13,11,-3,8,-19,-5,-17,0,-9,27,26,68,39,21,7,14,15,56,32,11,1,13,11,12,7,10,6,-106,-66,-40,191,114,77,-18,-4,-103,-2,7,17,-23,2,-52,-4,-7,15,5,-6,-51,2,14,2,43,38,40,38,20,10,23,29,18,29,8,5,20,9,22,9,12,5,-90,-65,-25,91,54,37,31,2,-73,-34,-8,-14,12,3,-34,-33,-5,-13,19,-1,-39,-1,-3,-1,35,29,14,8,-1,4,21,22,4,2,-1,4,14,7,10,6,0,0,26,58,-32,206,148,58,-16,45,5,-6,-6,7,-25,45,29,10,-3,4,9,0,-24,-16,-3,3,26,59,86,29,5,1,9,44,69,22,4,0,17,15,17,7,1,1,18,32,-14,114,82,32,7,30,-25,-14,24,-25,15,26,-9,-10,8,-6,-8,4,-16,-4,16,-19,14,34,36,10,14,4,11,28,23,6,9,3,3,6,13,4,5,1,-130,-43,-87,53,27,26,-4,-34,-45,-38,2,-5,3,-28,-8,-16,3,4,-7,-6,-37,-22,-1,-9,23,9,8,-2,12,3,14,1,4,-3,9,2,9,8,4,1,3,1,-372,-221,-151,51,17,34,-34,-54,-158,-82,-23,-9,-26,-32,-91,-58,-3,-8,-8,-22,-67,-24,-20,-1,13,9,3,9,15,2,5,0,-7,5,12,2,8,9,10,4,3,0,-135,-64,-71,-37,-43,6,-22,-24,-60,-24,0,0,-17,-6,-32,-9,-1,4,-5,-18,-28,-15,1,-4,0,0,-24,-4,-7,-2,-2,-2,-26,-8,-4,-1,2,2,2,4,-3,-1,-170,-91,-79,-36,-30,-6,-24,-12,-95,-16,-1,-18,-7,6,-67,-15,-3,-7,-17,-18,-28,-1,2,-11,6,1,-23,-14,-3,-4,4,5,-19,-18,-3,1,2,-4,-4,4,0,-5,-228,-122,-106,-88,-51,-37,5,-58,-55,-87,-13,-16,10,-32,-40,-59,3,-5,-5,-26,-15,-28,-16,-11,9,-26,-26,-37,-7,-1,9,-15,-14,-28,-3,0,0,-11,-12,-9,-4,-1,-131,-76,-55,17,13,4,-34,-14,-56,7,-22,-10,-18,-14,-37,3,-14,4,-16,0,-19,4,-8,-14,4,4,-3,8,3,0,6,1,0,0,4,2,-2,3,-3,8,-1,-2,-215,-153,-62,-6,-16,10,-51,-38,-77,-61,11,-4,-27,-27,-49,-51,6,-4,-24,-11,-28,-10,5,0,7,-4,1,-20,6,1,7,-4,-3,-17,-2,3,0,0,4,-3,8,-2,-202,-90,-112,-1,4,-5,-5,-38,-74,-29,-28,-27,-3,-11,-28,-18,-15,-16,-2,-27,-46,-11,-13,-11,9,-3,-7,-4,1,1,8,2,-1,-7,-2,2,1,-5,-6,3,3,-1
36,36027,Meaño,5419,-11,-11,0,20,11,9,2,-11,-7,-1,6,1,1,-2,-12,-2,3,1,1,-9,5,1,3,0,2,6,3,3,3,3,0,4,1,1,2,3,2,2,2,2,1,0,-22,-13,-9,21,11,10,-3,-7,-15,-1,1,3,0,-9,-8,0,3,2,-3,2,-7,-1,-2,1,4,4,3,7,1,1,3,1,0,6,0,1,1,3,3,1,1,0,1,3,-2,11,9,2,1,-10,7,6,1,-4,5,-5,3,5,1,-5,-4,-5,4,1,0,1,6,1,-4,6,2,0,3,3,-1,3,1,0,3,-2,-3,3,1,0,-11,4,-15,11,7,4,-4,-2,-13,-1,-2,5,-2,5,-9,2,1,2,-2,-7,-4,-3,-3,3,2,1,2,2,2,2,1,1,1,2,1,1,1,0,1,0,1,1,2,2,0,8,2,6,-4,-1,-2,7,6,-3,-4,2,-3,3,3,1,0,-3,1,4,3,-4,0,1,0,2,4,0,0,0,0,1,1,0,0,1,0,1,3,0,12,-2,14,14,7,7,5,-9,8,5,4,-1,1,-10,4,3,2,-1,4,1,4,2,2,0,3,0,1,9,1,0,1,1,0,6,-1,0,2,-1,1,3,2,0,-22,-3,-19,26,17,9,-2,-12,-11,1,7,-5,2,-7,0,2,5,-4,-4,-5,-11,-1,2,-1,4,-1,5,6,8,2,1,0,2,6,5,1,3,-1,3,0,3,1,-20,-2,-18,7,8,-1,-3,-8,-9,-9,9,1,-3,1,-4,-3,7,3,0,-9,-5,-6,2,-2,-2,3,5,3,0,-2,-1,3,3,4,0,-1,-1,0,2,-1,0,-1,7,14,-7,19,6,13,-2,18,-22,5,11,-4,-2,7,2,1,7,-2,0,11,-24,4,4,-2,2,13,2,0,3,-2,-1,5,3,0,1,-2,3,8,-1,0,2,0,-6,-1,-5,2,-2,4,-8,-1,-9,4,8,0,-2,5,-8,1,3,0,-6,-6,-1,3,5,0,-1,1,1,-1,3,-1,0,1,-2,-2,1,0,-1,0,3,1,2,-1,-4,-16,12,5,-5,10,5,3,-10,2,4,-9,-1,-4,-8,-1,-1,-2,6,7,-2,3,5,-7,3,1,1,1,1,-2,0,-2,-1,-1,0,-1,3,3,2,2,1,-1,41,27,14,0,2,-2,14,-2,5,10,11,5,13,0,2,3,10,1,1,-2,3,7,1,4,-1,1,0,0,0,0,0,2,0,0,0,0,-1,-1,0,0,0,0,2,-2,4,1,1,0,9,-9,-13,6,5,1,2,-5,-11,5,4,2,7,-4,-2,1,1,-1,1,-2,0,0,1,0,2,-1,-1,0,0,1,-1,-1,1,0,1,-1,32,16,16,-4,-4,0,2,-1,8,16,2,2,0,-2,4,9,4,-1,2,1,4,7,-2,3,-1,-1,-4,-1,2,1,0,-2,-3,-1,2,0,-1,1,-1,0,0,1,-25,-17,-8,4,1,3,-13,-4,-10,-5,2,6,-12,-3,-2,-3,3,1,-1,-1,-8,-2,-1,5,1,1,-2,0,0,4,0,0,-1,0,1,1,1,1,-1,0,-1,3,-10,0,-10,-5,-2,-3,-10,-2,0,1,-4,7,-5,-3,3,1,0,5,-5,1,-3,0,-4,2,-2,-2,-2,0,0,1,-2,-1,0,0,0,1,0,-1,-2,0,0,0,-13,-11,-2,-3,-4,1,3,-5,-7,-9,6,-1,-3,1,-5,-6,5,-3,6,-6,-2,-3,1,2,-1,3,-2,-5,2,0,-1,3,0,-5,0,-1,0,0,-2,0,2,1,5,2,3,10,-1,11,8,-3,-10,13,-2,0,4,-2,-6,5,3,-1,4,-1,-4,8,-5,1,4,2,-3,2,2,3,2,1,-6,0,2,0,2,1,3,2,0,3
36,36028,Meis,5001,-15,-9,-6,20,9,11,-2,-17,-7,0,6,4,2,-11,-4,-3,2,3,-4,-6,-3,3,4,1,0,2,5,6,4,3,0,0,2,4,2,1,0,2,3,2,2,2,10,11,-1,16,9,7,1,3,-7,-3,12,5,-1,6,1,-3,6,3,2,-3,-8,0,6,2,1,3,3,1,5,3,0,3,1,1,2,2,1,0,2,0,3,1,-15,-13,-2,-3,-1,-2,-1,-12,-3,8,-2,-5,3,-8,-6,4,-4,-1,-4,-4,3,4,2,-4,0,-1,2,0,-3,-1,0,-1,2,0,-1,-1,0,0,0,0,-2,0,-18,2,-20,0,2,-2,-2,-9,-13,6,1,-2,-2,5,-3,0,2,0,0,-14,-10,6,-1,-2,0,1,0,1,-1,-1,0,0,0,1,0,1,0,1,0,0,-1,-2,-11,-10,-1,18,9,9,0,-3,-24,9,3,4,2,-2,-13,2,0,2,-2,-1,-11,7,3,2,1,2,3,10,0,2,0,2,0,7,0,0,1,0,3,3,0,2,-21,-11,-10,14,6,8,-13,3,-11,0,11,-13,-7,3,-4,-1,6,-9,-6,0,-7,1,5,-4,1,2,8,0,4,-1,0,1,3,0,3,-1,1,1,5,0,1,0,8,12,-4,20,12,8,2,-8,11,6,-1,-4,0,-6,11,4,3,-1,2,-2,0,2,-4,-3,5,2,4,4,3,1,3,0,3,3,2,1,2,2,1,1,1,0,11,15,-4,19,18,1,22,-14,-17,28,3,-7,11,-2,-11,20,3,-5,11,-12,-6,8,0,-2,5,1,9,5,1,-2,3,3,7,4,2,-1,2,-2,2,1,-1,-1,26,2,24,-1,-1,0,-3,2,17,6,4,2,-9,1,0,6,3,2,6,1,17,0,1,0,1,-1,3,0,-2,-2,0,0,2,-1,-1,-1,1,-1,1,1,-1,-1,24,2,22,9,3,6,3,8,-10,6,11,1,-5,3,-1,-1,7,-4,8,5,-9,7,4,5,1,5,1,1,1,0,0,2,1,0,0,0,1,3,0,1,1,0,-15,-2,-13,-2,1,-3,1,-13,-1,8,-3,-8,-1,-6,-1,7,1,-2,2,-7,0,1,-4,-6,-1,2,0,-1,0,-3,0,2,1,-2,0,-1,-1,0,-1,1,0,-2,22,19,3,12,8,4,7,-11,-10,8,16,12,7,-2,-3,8,7,4,0,-9,-7,0,9,8,2,2,1,0,2,5,2,2,1,0,1,2,0,0,0,0,1,3,36,7,29,0,-6,6,6,6,11,6,3,5,2,-1,0,-1,2,6,4,7,11,7,1,-1,1,-2,-4,-2,3,3,0,-2,-5,-2,2,1,1,0,1,0,1,2,39,15,24,-26,-17,-9,14,13,-3,13,3,-1,10,4,-7,8,0,0,4,9,4,5,3,-1,-5,-3,-7,-7,-2,-2,-3,-3,-6,-2,-2,-1,-2,0,-1,-5,0,-1,23,38,-15,-10,-9,-1,8,2,-15,19,14,-6,9,8,-2,9,9,4,-1,-6,-13,10,5,-10,1,0,-2,-9,0,0,1,0,-2,-7,0,-1,0,0,0,-2,0,1,-109,-60,-49,-6,-3,-3,-24,-13,-24,-26,-10,-10,-13,-3,-11,-12,-11,-8,-11,-10,-13,-14,1,-2,-2,-3,1,-3,1,0,-2,-1,1,-1,0,0,0,-2,0,-2,1,0,-34,-24,-10,-8,-7,-1,-11,7,-22,-1,8,-15,-5,-3,-11,0,2,-6,-6,10,-11,-1,6,-9,-3,1,-1,-4,0,-1,-3,0,-2,-1,0,-1,0,1,1,-3,0,0,4,-1,5,8,4,4,5,0,-4,0,6,-2,4,2,-5,0,2,-3,1,-2,1,0,4,1,2,5,2,-3,1,1,1,2,1,-1,0,1,1,3,1,-2,1,0
36,36029,Moaña,17751,18,1,17,61,26,35,7,0,-27,25,8,5,-3,0,-13,16,2,-1,10,0,-14,9,6,6,16,9,17,9,8,2,6,2,9,5,4,0,10,7,8,4,4,2,-6,-2,-4,38,12,26,-2,-14,-22,19,16,-1,-8,-4,-12,13,7,3,6,-10,-10,6,9,-4,11,9,5,9,4,0,2,4,1,4,1,0,9,5,4,5,3,0,74,62,12,85,45,40,-9,-10,46,18,25,1,8,0,25,12,13,2,-17,-10,21,6,12,-1,18,6,30,12,9,8,11,3,16,4,4,5,7,3,14,8,5,3,222,127,95,122,61,61,28,33,69,59,32,-1,10,18,49,29,19,1,18,15,20,30,13,-2,24,18,36,17,17,10,10,5,23,9,9,5,14,13,13,8,8,5,-35,-23,-12,39,20,19,-12,-18,-21,2,2,13,-5,-2,-9,-7,-3,3,-7,-16,-12,9,5,10,2,8,5,9,5,9,0,4,3,4,2,6,2,4,2,5,3,3,48,66,-18,39,12,27,6,10,11,4,18,-2,17,6,16,17,9,3,-11,4,-5,-13,9,-5,9,8,8,5,7,2,4,4,2,0,1,1,5,4,6,5,6,1,112,37,75,55,32,23,32,9,36,13,11,5,14,8,4,9,-2,3,18,1,32,4,13,2,18,11,10,8,7,1,11,6,6,8,1,0,7,5,4,0,6,1,145,85,60,86,43,43,21,-13,74,49,13,-8,16,-10,38,25,6,8,5,-3,36,24,7,-16,18,13,27,14,8,4,10,3,14,9,4,2,8,10,13,5,4,2,262,161,101,92,60,32,50,35,56,59,41,11,33,20,32,40,23,10,17,15,24,19,18,1,16,13,23,16,14,9,12,9,12,11,9,6,4,4,11,5,5,3,156,59,97,45,15,30,4,42,58,11,39,-1,-7,19,23,2,22,-2,11,23,35,9,17,1,9,8,12,7,8,0,3,3,3,3,2,1,6,5,9,4,6,-1,131,73,58,15,4,11,49,2,10,47,19,-1,31,9,-2,18,15,-1,18,-7,12,29,4,0,7,-1,-2,1,10,-1,4,-1,-4,0,6,-1,3,0,2,1,4,0,27,18,9,19,11,8,2,-20,34,2,11,-5,2,-14,21,2,2,3,0,-6,13,0,9,-8,3,3,-1,3,8,3,1,1,0,3,4,2,2,2,-1,0,4,1,65,28,37,2,-3,5,27,6,17,19,-8,-7,13,2,3,14,-13,-1,14,4,14,5,5,-6,1,2,-1,-1,-3,3,-1,1,-1,-1,-5,3,2,1,0,0,2,0,-232,-153,-79,-213,-118,-95,-19,-43,-60,-46,-45,-20,-9,-26,-50,-35,-24,-10,-10,-17,-10,-11,-21,-10,-18,-13,-61,-52,-46,-22,-9,-7,-33,-29,-27,-12,-9,-6,-28,-23,-19,-10,51,49,2,11,17,-6,15,4,21,19,-9,0,17,9,20,12,-9,0,-2,-5,1,7,0,0,6,-1,1,7,-5,1,6,2,4,5,-2,0,0,-3,-3,2,-3,1,-12,-28,16,2,-4,6,26,5,-23,-34,21,-10,-3,0,-21,-23,17,1,29,5,-2,-11,4,-11,6,7,-5,-11,4,1,-1,3,-5,-6,3,2,7,4,0,-5,1,-1,47,-5,52,2,-3,5,5,-1,-15,6,41,13,-12,-3,-11,1,16,7,17,2,-4,5,25,6,-5,2,-2,-3,6,4,-4,1,0,-2,-2,4,-1,1,-2,-1,8,0,42,19,23,41,20,21,18,-2,9,-5,20,-1,14,3,-2,-11,10,3,4,-5,11,6,10,-4,11,6,13,1,9,1,3,4,7,-2,7,1,8,2,6,3,2,0
36,36032,Moraña,4402,7,13,-6,26,13,13,-5,2,0,-2,5,7,0,7,2,-1,1,4,-5,-5,-2,-1,4,3,6,3,7,6,2,1,3,2,3,2,1,1,3,1,4,4,1,0,8,-4,12,15,9,6,0,1,-8,7,9,-3,-1,-6,-8,4,8,-2,1,7,0,3,1,-1,0,5,1,3,6,0,0,3,0,2,4,0,0,2,1,1,2,0,7,-4,11,5,0,5,-5,3,-3,4,3,5,2,-6,-2,1,-1,2,-7,9,-1,3,4,3,-1,1,4,-2,1,2,-1,1,2,-2,-1,1,0,0,2,0,2,1,10,7,3,14,11,3,-7,8,-15,11,7,4,0,3,-11,5,9,0,-7,5,-4,6,-2,4,2,0,5,4,2,1,2,1,3,3,2,0,0,-1,2,1,0,1,46,30,16,28,12,16,13,7,5,8,13,-2,5,6,10,2,6,0,8,1,-5,6,7,-2,9,0,5,7,5,2,3,0,4,2,3,0,6,0,1,5,2,2,-7,-10,3,14,10,4,-3,10,-10,-6,4,-2,1,0,-8,-6,3,0,-4,10,-2,0,1,-2,-2,7,-1,2,7,1,-1,4,0,2,4,1,-1,3,-1,0,3,0,52,34,18,31,15,16,3,15,11,11,15,-5,-1,8,10,9,7,0,4,7,1,2,8,-5,7,5,6,5,6,1,3,2,5,3,1,1,4,3,1,2,5,0,60,40,20,25,17,8,5,19,21,11,7,-2,2,9,16,7,5,2,3,10,5,4,2,-4,3,6,9,5,2,0,3,3,5,4,2,0,0,3,4,1,0,0,83,42,41,30,16,14,20,14,32,12,5,-2,6,8,18,9,1,-2,14,6,14,3,4,0,9,3,10,6,2,0,4,3,4,4,1,0,5,0,6,2,1,0,34,24,10,14,9,5,8,-10,32,4,9,-8,4,-7,22,4,2,0,4,-3,10,0,7,-8,1,3,5,1,5,-1,1,2,2,1,3,0,0,1,3,0,2,-1,-2,2,-4,4,2,2,-9,0,-1,7,1,-2,-1,7,-2,-2,0,-1,-8,-7,1,9,1,-1,0,-2,5,0,0,0,-1,0,3,0,0,0,1,-2,2,0,0,0,30,4,26,1,-5,6,19,3,15,-7,2,-1,10,0,4,-9,2,-1,9,3,11,2,0,0,-2,2,2,-3,-1,3,-3,0,-2,-1,-1,2,1,2,4,-2,0,1,11,4,7,0,-3,3,-4,4,0,3,1,6,-6,4,1,1,1,2,2,0,-1,2,0,4,1,-2,-1,-1,1,2,0,-1,-2,-1,0,1,1,-1,1,0,1,1,-26,-15,-11,0,2,-2,-4,-9,1,-3,-4,-7,-4,-6,-4,-2,0,-1,0,-3,5,-1,-4,-6,-2,-2,2,-1,1,0,-2,0,2,-1,1,0,0,-2,0,0,0,0,9,7,2,5,1,4,0,5,-7,8,6,-2,5,3,0,1,1,-2,-5,2,-7,7,5,0,-1,1,0,-2,8,-1,-1,0,1,-1,3,-1,0,1,-1,-1,5,0,-21,-20,-1,-8,-3,-5,-8,5,-7,-2,-5,-1,-9,0,-5,-3,-1,1,1,5,-2,1,-4,-2,0,2,-1,-3,-4,-2,0,0,0,-2,-1,0,0,2,-1,-1,-3,-2,-34,-11,-23,-9,-3,-6,1,-10,-16,-10,4,-5,1,-7,-2,-4,-1,0,0,-3,-14,-6,5,-5,1,-2,-2,-7,0,0,1,-1,0,-3,-1,0,0,-1,-2,-4,1,0,-19,-7,-12,-1,2,-3,-8,7,-13,-3,2,-1,-2,2,-7,0,1,1,-6,5,-6,-3,1,-2,-2,1,-2,2,2,-2,0,1,-1,2,1,-1,-2,0,-1,0,1,-1
36,36033,Mos,13729,70,28,42,46,20,26,18,4,19,15,13,-3,6,2,4,4,12,-1,12,2,15,11,1,-2,12,10,18,4,2,0,6,5,7,1,1,0,6,5,11,3,1,0,45,42,3,40,20,20,4,-2,0,32,16,-3,5,9,0,18,13,-1,-1,-11,0,14,3,-2,9,10,9,11,1,0,3,4,5,7,1,0,6,6,4,4,0,0,84,45,39,47,22,25,34,-22,38,11,10,7,21,-17,23,7,2,5,13,-5,15,4,8,2,7,10,13,10,4,3,4,5,7,3,1,2,3,5,6,7,3,1,139,72,67,63,34,29,41,7,41,28,7,11,18,-3,19,25,4,4,23,10,22,3,3,7,10,11,15,11,14,2,7,2,7,9,8,1,3,9,8,2,6,1,72,26,46,38,18,20,54,5,-20,33,6,-4,27,2,-20,18,0,0,27,3,0,15,6,-4,11,6,4,8,8,1,7,1,3,3,4,0,4,5,1,5,4,1,1,6,-5,45,27,18,18,-13,-28,11,13,-5,10,-6,-13,2,7,3,8,-7,-15,9,6,-8,6,14,12,9,3,1,4,7,6,7,2,1,2,7,6,2,1,0,60,40,20,27,18,9,18,-3,22,17,1,-6,5,2,14,10,6,-1,13,-5,8,7,-5,-5,6,4,7,9,1,1,4,0,2,11,2,0,2,4,5,-2,-1,1,-18,-31,13,47,21,26,-11,-15,12,-1,-6,1,-18,-15,1,3,-1,-4,7,0,11,-4,-5,5,7,11,17,6,4,1,3,2,9,4,2,0,4,9,8,2,2,1,128,64,64,37,16,21,57,-16,35,42,1,5,23,6,8,21,3,2,34,-22,27,21,-2,3,8,5,13,7,1,0,3,3,6,2,1,0,5,2,7,5,0,0,59,55,4,38,27,11,31,3,-2,19,12,-7,26,5,2,11,6,2,5,-2,-4,8,6,-9,6,11,10,6,5,-1,3,5,8,7,3,1,3,6,2,-1,2,-2,112,87,25,37,31,6,34,7,29,34,-3,9,18,7,24,33,-1,5,16,0,5,1,-2,4,7,7,11,7,2,1,7,5,10,6,1,1,0,2,1,1,1,0,80,38,42,35,21,14,18,2,11,23,15,5,3,1,6,15,15,-3,15,1,5,8,0,8,6,6,8,5,6,4,4,3,6,2,5,1,2,3,2,3,1,3,1,9,-8,-56,-32,-24,2,-13,-6,1,5,7,6,-8,6,2,-2,3,-4,-5,-12,-1,7,4,-4,-11,-9,-25,-3,-5,-1,-3,-6,-16,-3,-3,-3,-8,-3,-9,0,-2,-66,-64,-2,-19,-20,1,13,-19,-23,-30,-5,-2,2,-10,-20,-26,-4,-4,11,-9,-3,-4,-1,2,2,-3,-9,-8,-1,-1,2,-3,-8,-9,-1,-1,0,0,-1,1,0,0,-28,-3,-25,-45,-27,-18,3,-18,-12,0,-10,3,19,2,-8,-5,-15,2,-16,-20,-4,5,5,1,-4,-2,-16,-13,-10,0,0,0,-6,-11,-11,1,-4,-2,-10,-2,1,-1,-60,-12,-48,3,1,2,-4,-20,-21,-2,-9,-1,-7,-2,-12,8,2,-2,3,-18,-9,-10,-11,1,0,-3,-11,7,5,3,-4,0,-8,6,4,2,4,-3,-3,1,1,1,-71,-31,-40,9,7,2,-17,5,-44,-22,-11,19,-4,3,-11,-11,-12,6,-13,2,-33,-11,1,13,5,3,1,-1,2,-1,5,2,3,-2,0,-1,0,1,-2,1,2,0,38,15,23,16,1,15,12,13,8,20,-20,1,2,15,1,13,-17,-1,10,-2,7,7,-3,2,3,15,-4,0,-1,3,0,14,-6,-6,-3,2,3,1,2,6,2,1
36,36034,"Neves, As",5027,-28,-15,-13,23,13,10,-8,-11,-21,-1,9,6,-1,-3,-17,-1,4,4,-7,-8,-4,0,5,2,5,4,2,3,7,2,3,3,0,1,4,2,2,1,2,2,3,0,47,29,18,13,9,4,1,18,-4,12,15,4,1,2,2,13,10,1,0,16,-6,-1,5,3,1,3,3,1,2,2,1,1,3,1,2,1,0,2,0,0,0,1,-31,-1,-30,8,5,3,-3,-2,-5,-2,4,-23,0,0,6,-6,5,-6,-3,-2,-11,4,-1,-17,5,2,4,1,1,-5,2,1,4,-1,0,-1,3,1,0,2,1,-4,-86,-43,-43,1,0,1,-12,-25,-24,-9,-9,-4,-4,-10,-13,-11,-7,3,-8,-15,-11,2,-2,-7,0,0,1,0,0,0,0,0,0,0,0,0,0,0,1,0,0,0,-23,-12,-11,6,5,1,-2,-1,-12,1,6,-16,-3,1,-13,2,4,-3,1,-2,1,-1,2,-13,0,-1,1,0,4,1,0,0,1,0,2,1,0,-1,0,0,2,0,35,28,7,15,10,5,13,1,-5,10,22,-4,7,0,0,7,15,0,6,1,-5,3,7,-4,1,3,1,1,7,2,0,2,1,0,5,2,1,1,0,1,2,0,22,8,14,21,10,11,21,-6,-7,5,11,-5,7,-8,-2,3,6,0,14,2,-5,2,5,-5,1,2,1,4,10,3,1,2,1,1,4,1,0,0,0,3,6,2,10,0,10,23,10,13,10,-4,-6,4,16,-8,3,-3,-8,4,9,-4,7,-1,2,0,7,-4,4,3,3,2,9,1,3,0,1,1,4,0,1,3,2,1,5,1,10,12,-2,20,14,6,6,4,3,4,7,-16,0,2,3,3,6,-4,6,2,0,1,1,-12,0,1,6,3,7,2,0,0,4,3,4,2,0,1,2,0,3,0,19,17,2,7,3,4,6,8,-5,4,6,3,8,5,-4,5,3,1,-2,3,-1,-1,3,2,-1,3,2,2,1,0,0,1,1,2,-1,0,-1,2,1,0,2,0,7,13,-6,10,5,5,10,-6,-7,16,9,-14,10,-3,-3,4,5,0,0,-3,-4,12,4,-14,1,2,1,0,6,0,1,0,0,0,3,1,0,2,1,0,3,-1,-10,-8,-2,0,-1,1,-1,1,-2,9,-8,-9,2,-6,-2,6,-7,-2,-3,7,0,3,-1,-7,1,-1,3,-3,-2,2,2,-1,3,-1,-3,-1,-1,0,0,-2,1,3,-7,-16,9,6,6,0,-2,-3,4,-7,4,-5,-3,-4,-2,-8,0,0,1,1,6,1,4,-5,-2,1,-3,3,3,4,0,1,-1,2,2,2,-2,0,-2,1,1,2,-32,-19,-13,-1,-3,2,5,-6,-15,-3,2,-14,-6,-2,-9,4,1,-5,11,-4,-6,-7,1,-9,2,-2,-2,-2,6,-3,1,-1,-2,0,1,-2,1,-1,0,-2,5,-1,-26,-11,-15,0,3,-3,-2,5,-24,-8,7,-4,-7,6,-14,-5,5,2,5,-1,-10,-3,2,-6,0,3,-3,-2,0,2,0,2,-2,0,1,2,0,1,-1,-2,-1,0,14,-8,22,11,4,7,-5,11,-1,0,15,-5,-1,5,-3,-12,7,-3,-4,6,2,12,8,-2,1,2,-1,-1,6,4,1,1,-1,-1,2,2,0,1,0,0,4,2,-21,-9,-12,-1,0,-1,4,-9,-9,4,0,-10,0,-3,0,1,-3,-5,4,-6,-9,3,3,-5,1,1,-2,0,1,-2,0,0,0,2,0,-2,1,1,-2,-2,1,0,-37,-15,-22,17,6,11,-5,-4,-1,-6,7,-29,-1,-3,-3,-1,3,-11,-4,-1,2,-5,4,-18,3,2,0,3,8,1,1,1,1,1,4,-2,2,1,-1,2,4,3
36,36035,Nigrán,15647,236,107,129,68,31,37,44,13,55,59,47,21,23,5,27,26,27,4,21,8,28,33,20,17,11,16,11,14,12,4,5,5,4,8,7,2,6,11,7,6,5,2,302,146,156,70,37,33,54,54,65,55,35,37,32,13,38,29,16,18,22,41,27,26,19,19,16,13,23,9,4,4,12,8,12,4,1,0,4,5,11,5,3,4,269,147,122,48,29,19,40,28,59,46,56,33,21,18,29,29,31,15,19,10,30,17,25,18,16,8,2,11,3,6,9,5,4,6,2,2,7,3,-2,5,1,4,237,199,38,112,74,38,18,50,55,56,27,26,18,43,56,44,25,13,0,7,-1,12,2,13,25,18,20,22,19,6,12,12,17,13,13,6,13,6,3,9,6,0,200,128,72,112,55,57,59,-4,61,40,24,18,37,-5,37,27,14,11,22,1,24,13,10,7,23,11,26,20,15,14,15,7,9,10,5,7,8,4,17,10,10,7,237,116,121,111,62,49,65,17,42,47,37,23,39,4,22,17,25,10,26,13,20,30,12,13,21,18,32,24,11,3,16,9,15,12,7,2,5,9,17,12,4,1,19,47,-28,115,58,57,7,-10,-52,32,37,10,13,9,-13,20,21,2,-6,-19,-39,12,16,8,16,22,29,21,24,2,10,9,16,12,10,1,6,13,13,9,14,1,225,121,104,167,97,70,48,17,53,50,31,20,30,23,14,24,16,7,18,-6,39,26,15,13,45,28,50,28,7,6,28,18,31,14,3,2,17,10,19,14,4,4,158,55,103,103,38,65,15,47,0,40,24,31,15,15,5,-4,15,7,0,32,-5,44,9,24,11,31,21,26,10,4,3,12,12,4,6,1,8,19,9,22,4,3,56,18,38,13,-2,15,8,-1,4,-2,17,33,-4,-8,15,3,8,7,12,7,-11,-5,9,26,3,8,-2,2,-1,1,-2,2,-1,0,-2,0,5,6,-1,2,1,1,-18,-23,5,15,8,7,-4,5,-36,-1,-4,14,-16,-7,-5,-6,-6,11,12,12,-31,5,2,3,2,3,2,7,0,0,1,-2,3,4,0,2,1,5,-1,3,0,-2,-8,13,-21,-38,-26,-12,6,0,14,-2,-34,7,2,8,14,5,-22,3,4,-8,0,-7,-12,4,8,-7,2,-21,-11,-9,4,-4,0,-15,-7,-4,4,-3,2,-6,-4,-5,-117,-99,-18,-81,-52,-29,-24,-9,-45,-20,-29,8,-13,-6,-39,-16,-24,-2,-11,-3,-6,-4,-5,10,-16,-15,-16,-21,-11,-2,-8,-9,-12,-11,-9,-3,-8,-6,-4,-10,-2,1,16,0,16,-21,-19,-2,36,-14,-15,14,-19,15,15,-2,-9,3,-11,8,21,-12,-6,11,-8,7,2,-4,-4,-10,-7,0,-3,-1,-3,-6,-6,0,5,-3,-1,-4,-1,0,-103,-20,-83,-4,-4,0,-9,-18,-34,-37,-9,15,8,-1,-12,-24,5,8,-17,-17,-22,-13,-14,7,0,1,-6,7,-3,-3,-1,1,-1,0,-1,-2,1,0,-5,7,-2,-1,9,-18,27,18,9,9,16,-13,-18,4,-13,27,6,-8,-8,-3,-9,2,10,-5,-10,7,-4,25,13,-1,2,-2,-1,6,8,0,1,1,-3,2,5,-1,1,-3,2,4,76,54,22,-8,-5,-3,22,4,-5,34,0,20,17,16,1,14,3,8,5,-12,-6,20,-3,12,1,0,-5,2,-11,5,4,3,-7,1,-7,1,-3,-3,2,1,-4,4,142,70,72,33,23,10,33,-4,20,49,-1,44,34,-5,13,8,0,21,-1,1,7,41,-1,23,14,1,2,6,6,4,15,-2,1,2,2,5,-1,3,1,4,4,-1
36,36036,Oia,2956,13,6,7,7,3,4,-2,-9,5,8,9,2,1,-5,0,6,4,0,-3,-4,5,2,5,2,0,0,1,3,3,0,0,0,0,1,2,0,0,0,1,2,1,0,-5,3,-8,7,4,3,4,-11,-2,3,6,-4,4,-5,-4,4,4,0,0,-6,2,-1,2,-4,1,0,2,1,3,0,1,0,1,0,2,0,0,0,1,1,1,0,25,12,13,3,-1,4,-3,5,8,6,8,1,-3,5,0,3,6,1,0,0,8,3,2,0,2,-1,1,-1,2,0,1,-1,0,-2,1,0,1,0,1,1,1,0,39,30,9,6,2,4,6,13,4,9,11,-5,7,7,2,9,6,-1,-1,6,2,0,5,-4,0,0,3,-1,2,2,0,0,2,-1,1,0,0,0,1,0,1,2,51,28,23,8,6,2,7,3,-4,25,12,6,2,0,-9,22,9,2,5,3,5,3,3,4,0,2,3,0,2,1,0,2,1,1,1,1,0,0,2,-1,1,0,38,37,1,10,6,4,7,4,1,17,10,-3,4,8,1,11,11,1,3,-4,0,6,-1,-4,2,3,2,0,2,0,2,1,1,0,2,0,0,2,1,0,0,0,62,45,17,10,12,-2,4,4,24,16,18,-1,0,4,19,13,12,-2,4,0,5,3,6,1,0,3,2,0,4,1,0,5,3,0,3,1,0,-2,-1,0,1,0,51,36,15,16,8,8,10,3,17,8,11,1,10,3,14,1,6,1,0,0,3,7,5,0,4,1,6,5,0,0,3,-1,3,3,0,0,1,2,3,2,0,0,26,14,12,7,5,2,7,-3,-10,15,7,11,5,-3,-4,9,0,7,2,0,-6,6,7,4,6,-2,4,0,0,-1,3,-1,3,1,-1,0,3,-1,1,-1,1,-1,-19,2,-21,0,0,0,-7,-5,-5,-1,0,0,-1,-2,2,1,0,2,-6,-3,-7,-2,0,-2,-1,1,0,-1,3,-2,-1,1,0,0,1,-1,0,0,0,-1,2,-1,-10,-5,-5,6,3,3,10,-10,-13,5,0,-4,4,-4,-4,2,1,-3,6,-6,-9,3,-1,-1,2,2,2,0,-1,0,2,1,2,-2,0,0,0,1,0,2,-1,0,-42,-17,-25,-4,-1,-3,-5,-1,-10,-13,-9,-3,-2,-4,-2,-4,-5,0,-3,3,-8,-9,-4,-3,1,1,-1,-2,-3,0,0,1,-2,0,-1,1,1,0,1,-2,-2,-1,0,-4,4,2,2,0,3,-2,-9,2,9,-6,2,2,-7,0,3,-4,1,-4,-2,2,6,-2,-1,1,0,1,-1,2,0,0,-1,2,0,1,-1,1,1,-1,-1,1,-3,5,-8,0,1,-1,-3,-10,2,13,-4,-3,-1,-3,1,7,3,-3,-2,-7,1,6,-7,0,-1,0,1,2,-2,-1,0,0,1,0,0,-1,-1,0,0,2,-2,0,2,13,-11,4,1,3,0,-5,-4,5,3,3,5,1,0,3,2,1,-5,-6,-4,2,1,2,0,0,2,0,1,1,1,0,0,-1,0,1,-1,0,2,1,1,0,19,11,8,5,7,-2,1,-1,2,6,8,-1,2,1,-1,5,3,-2,-1,-2,3,1,5,1,0,0,1,3,1,0,0,1,1,3,2,0,0,-1,0,0,-1,0,19,5,14,12,6,6,8,-2,1,2,6,3,1,-3,-1,2,4,2,7,1,2,0,2,1,3,2,2,4,1,0,0,2,1,3,0,0,3,0,1,1,1,0,15,20,-5,7,4,3,3,2,5,-2,2,5,2,2,6,2,3,5,1,0,-1,-4,-1,0,3,1,0,2,1,0,1,1,0,1,1,0,2,0,0,1,0,0
36,36037,Pazos de Borbén,3202,1,-7,8,6,5,1,-11,-2,-2,-3,2,19,-8,0,1,-2,1,3,-3,-2,-3,-1,1,16,0,0,1,1,3,1,0,0,1,0,3,1,0,0,0,1,0,0,14,12,2,3,2,1,5,3,2,10,0,-6,4,-3,4,5,2,0,1,6,-2,5,-2,-6,0,0,0,2,1,0,0,0,0,1,1,0,0,0,0,1,0,0,-1,5,-6,-8,-3,-5,-1,-11,0,10,3,-1,2,-3,-2,8,1,-1,-3,-8,2,2,2,0,-1,0,0,-2,-1,-4,1,0,0,-1,-1,-2,-2,0,0,-1,0,-2,65,31,34,9,5,4,2,16,21,9,12,4,1,7,8,0,8,5,1,9,13,9,4,-1,2,2,1,1,2,1,0,1,1,0,2,1,2,1,0,1,0,0,10,3,7,13,6,7,-16,-5,8,6,8,8,-6,0,-1,3,1,6,-10,-5,9,3,7,2,0,3,3,1,1,4,0,0,2,1,0,3,0,3,1,0,1,1,26,5,21,26,10,16,3,8,0,4,13,-3,3,1,-4,-2,11,-4,0,7,4,6,2,1,2,4,3,7,5,5,1,0,0,3,3,3,1,4,3,4,2,2,7,0,7,7,1,6,-1,14,-1,1,-1,-3,-1,6,-4,0,1,-1,0,8,3,1,-2,-2,2,2,2,0,0,1,0,1,0,0,0,0,2,1,2,0,0,1,43,23,20,7,5,2,0,10,10,15,8,-2,1,1,9,8,3,0,-1,9,1,7,5,-2,1,-1,1,4,2,0,1,0,1,3,1,-1,0,-1,0,1,1,1,-43,-4,-39,-1,5,-6,-9,-9,-19,-2,4,-8,-3,-3,-6,2,6,0,-6,-6,-13,-4,-2,-8,-4,1,0,3,-1,-1,-2,2,0,2,1,1,-2,-1,0,1,-2,-2,2,-3,5,1,-2,3,2,6,1,0,1,-8,0,9,-4,-2,2,-7,2,-3,5,2,-1,-1,0,2,0,-2,0,1,0,1,-1,-2,0,0,0,1,1,0,0,1,57,41,16,-3,-4,1,13,0,7,23,17,-2,5,-1,6,15,15,2,8,1,1,8,2,-4,3,1,-1,-1,-2,-3,0,-1,-1,0,0,-2,3,2,0,-1,-2,-1,5,7,-2,-1,-3,2,5,11,7,-11,1,-4,4,8,8,-9,1,-2,1,3,-1,-2,0,-2,3,-2,1,-1,-1,-1,2,-1,0,-4,0,0,1,-1,1,3,-1,-1,-34,-23,-11,-1,-2,1,-9,-6,-28,1,1,8,-4,-7,-15,-2,-3,9,-5,1,-13,3,4,-1,-1,0,-1,0,0,1,-1,-1,0,-1,0,1,0,1,-1,1,0,0,-10,-3,-7,6,-3,9,6,-2,-17,-5,5,2,1,-2,-6,-2,4,1,5,0,-11,-3,1,1,0,2,-2,0,3,3,-2,0,-2,-1,1,1,2,2,0,1,2,2,22,19,3,-4,-2,-2,4,-5,-1,0,6,20,4,-1,1,5,5,7,0,-4,-2,-5,1,13,0,2,-4,-2,0,0,0,1,-2,-1,1,-1,0,1,-2,-1,-1,1,-20,-26,6,-1,-5,4,-17,-11,-10,0,2,15,-12,-9,-6,0,-3,3,-5,-2,-4,0,5,12,0,0,-1,1,-2,1,0,-2,-1,1,-3,0,0,2,0,0,1,1,21,10,11,-5,-2,-3,8,1,-4,-9,7,15,6,4,-8,-2,3,5,2,-3,4,-7,4,10,0,-2,-3,1,0,-1,0,0,-2,1,0,-1,0,-2,-1,0,0,0,22,22,0,14,12,2,6,4,3,3,2,2,4,5,4,3,5,-2,2,-1,-1,0,-3,4,4,4,6,-1,3,-1,2,4,4,0,2,0,2,0,2,-1,1,-1
36,36041,Poio,13843,216,94,122,86,39,47,39,45,47,54,22,9,20,12,9,32,15,8,19,33,38,22,7,1,12,17,26,11,13,6,9,4,11,5,7,3,3,13,15,6,6,3,-28,-4,-24,49,30,19,-32,6,1,-15,12,8,-12,3,8,-14,7,7,-20,3,-7,-1,5,1,8,10,13,6,4,8,6,6,7,3,2,6,2,4,6,3,2,2,78,67,11,50,27,23,-8,35,20,-2,16,15,2,15,25,5,9,7,-10,20,-5,-7,7,8,9,8,9,5,9,10,5,2,6,1,7,6,4,6,3,4,2,4,25,30,-5,70,33,37,-18,15,24,11,1,-2,-4,4,27,9,-2,2,-14,11,-3,2,3,-4,19,6,30,7,3,4,7,5,15,4,0,1,12,1,15,3,3,3,175,106,69,108,58,50,2,23,87,17,33,9,13,8,44,11,25,4,-11,15,43,6,8,5,24,21,25,18,13,5,13,8,16,8,8,4,11,13,9,10,5,1,237,134,103,107,49,58,7,40,92,48,49,2,8,14,59,27,28,1,-1,26,33,21,21,1,22,21,23,21,15,5,9,7,9,15,7,2,13,14,14,6,8,3,251,91,160,106,46,60,28,41,74,47,40,17,10,7,41,10,22,1,18,34,33,37,18,16,21,21,20,19,22,0,10,10,10,9,6,0,11,11,10,10,16,0,302,162,140,121,70,51,38,50,120,68,15,6,24,21,63,41,6,6,14,29,57,27,9,0,17,33,28,28,15,0,8,15,21,17,9,0,9,18,7,11,6,0,187,80,107,88,48,40,35,16,56,60,22,1,12,3,31,32,15,-10,23,13,25,28,7,11,12,23,34,16,1,1,5,12,23,6,1,1,7,11,11,10,0,0,204,121,83,19,6,13,42,34,46,54,27,-4,11,24,33,34,20,-4,31,10,13,20,7,0,2,-3,9,6,7,-2,-4,-2,7,3,4,-2,6,-1,2,3,3,0,175,78,97,33,9,24,52,17,47,31,13,9,28,0,16,13,8,7,24,17,31,18,5,2,24,2,2,7,-5,1,11,0,-5,1,-1,1,13,2,7,6,-4,0,135,86,49,-2,-20,18,13,31,20,29,16,19,23,16,16,17,0,10,-10,15,4,12,16,9,8,-4,-7,-6,3,1,3,-2,-15,-8,-4,3,5,-2,8,2,7,-2,132,67,65,-34,-20,-14,38,13,8,32,22,17,20,2,8,11,12,13,18,11,0,21,10,4,-9,-1,-20,-15,1,9,-5,-1,-7,-13,-1,6,-4,0,-13,-2,2,3,12,13,-1,-7,-5,-2,4,6,-8,15,-12,5,11,6,-7,10,-7,3,-7,0,-1,5,-5,2,-1,3,1,-6,1,-5,0,1,2,-5,-1,-2,-1,2,-1,-1,2,-3,48,2,46,-35,-23,-12,25,23,-4,-3,7,-2,7,6,2,-9,0,-1,18,17,-6,6,7,-1,-1,4,-29,-7,-1,-2,1,1,-14,-5,-4,-2,-2,3,-15,-2,3,0,54,33,21,36,14,22,32,-26,2,16,9,21,19,-4,-10,16,4,12,13,-22,12,0,5,9,13,0,13,-2,4,8,7,0,4,-6,1,8,6,0,9,4,3,0,5,20,-15,-19,-13,-6,-8,7,-4,-5,11,2,7,4,6,-6,8,-4,-15,3,-10,1,3,6,2,-7,-4,-5,-4,-2,1,-1,-5,-5,-1,-2,1,-6,1,0,-3,0,159,97,62,68,31,37,21,31,28,58,2,20,14,18,17,29,1,15,7,13,11,29,1,5,26,15,7,12,0,6,12,11,1,5,-2,4,14,4,6,7,2,2
36,36043,Ponte Caldelas,6547,20,13,7,20,13,7,13,-7,1,8,11,-5,8,-3,1,1,6,1,5,-4,0,7,5,-6,2,2,2,3,8,2,2,1,1,1,5,2,0,1,1,2,3,0,2,-12,14,6,3,3,-1,1,-10,-1,9,5,-4,0,-8,-4,3,2,3,1,-2,3,6,3,1,1,0,2,0,2,0,0,0,2,0,1,1,1,0,0,0,1,52,23,29,16,7,9,9,0,13,17,10,3,-1,0,2,11,9,3,10,0,11,6,1,0,8,2,4,2,7,-7,1,1,2,0,7,-4,7,1,2,2,0,-3,50,42,8,37,25,12,-4,6,20,2,15,13,-1,7,12,7,8,11,-3,-1,8,-5,7,2,4,10,7,5,4,7,3,7,4,4,2,5,1,3,3,1,2,2,105,89,16,30,19,11,41,-1,20,28,13,3,32,5,22,19,6,4,9,-6,-2,9,7,-1,6,5,5,4,4,5,3,4,3,5,-1,4,3,1,2,-1,5,1,40,12,28,25,9,16,22,5,1,-2,7,5,5,3,-4,2,0,6,17,2,5,-4,7,-1,7,1,5,3,5,4,3,1,1,-1,2,3,4,0,4,4,3,1,57,7,50,34,11,23,23,1,14,10,7,-4,8,-4,2,3,-2,-2,15,5,12,7,9,-2,4,6,4,5,7,6,1,2,-2,2,4,4,3,4,6,3,3,2,42,10,32,24,8,16,18,9,4,-4,10,3,7,2,-1,-10,9,1,11,7,5,6,1,2,3,3,3,7,4,4,-1,3,-2,3,2,3,4,0,5,4,2,1,19,10,9,10,8,2,7,6,-5,14,5,-8,-3,5,3,5,2,-1,10,1,-8,9,3,-7,1,2,3,0,3,1,0,2,2,2,1,1,1,0,1,-2,2,0,-14,0,-14,5,7,-2,-8,-3,-10,11,10,-16,-4,1,-3,8,6,-9,-4,-4,-7,3,4,-7,-1,1,0,0,7,-4,1,1,1,2,3,-2,-2,0,-1,-2,4,-2,-11,16,-27,3,1,2,-5,11,-16,0,7,-4,-3,8,-3,4,8,3,-2,3,-13,-4,-1,-7,0,4,-1,-2,1,1,0,2,0,-2,0,1,0,2,-1,0,1,0,19,5,14,6,4,2,13,1,-5,17,0,-6,8,-3,-9,10,0,-2,5,4,4,7,0,-4,3,1,1,2,-1,0,3,-1,0,2,-1,1,0,2,1,0,0,-1,19,24,-5,0,1,-1,-3,1,-3,15,11,-4,5,3,1,9,9,-4,-8,-2,-4,6,2,0,-2,-2,2,-1,5,-2,0,-1,0,2,2,-2,-2,-1,2,-3,3,0,-3,3,-6,0,0,0,4,-16,-2,4,8,-3,4,-11,-1,2,5,3,0,-5,-1,2,3,-6,1,3,-4,0,1,-1,0,1,-3,0,1,1,1,2,-1,0,0,-2,-25,-18,-7,-3,-3,0,-7,3,-26,4,-4,6,-3,-2,-14,7,-7,3,-4,5,-12,-3,3,3,5,-3,1,-2,0,-4,4,-3,1,0,-1,-4,1,0,0,-2,1,0,41,16,25,-17,-12,-5,16,9,17,0,4,-4,5,5,10,-1,2,-5,11,4,7,1,2,1,1,1,-9,-2,-5,-3,0,1,-6,-2,-4,-1,1,0,-3,0,-1,-2,16,-13,29,-1,-7,6,14,0,-11,0,7,7,-1,-7,-8,-2,1,6,15,7,-3,2,6,1,1,-2,0,-6,1,5,1,-2,-1,-4,-3,2,0,0,1,-2,4,3,-22,-22,0,14,7,7,-16,-9,-6,-7,4,11,-6,-1,-13,-9,2,5,-10,-8,7,2,2,6,-2,0,1,1,7,7,2,0,0,2,3,0,-4,0,1,-1,4,7
36,36042,Ponteareas,17938,651,321,330,211,98,113,93,114,231,87,67,46,49,42,114,45,45,17,44,72,117,42,22,29,35,40,60,32,28,16,22,17,23,13,17,6,13,23,37,19,11,10,277,135,142,62,30,32,54,33,129,25,29,7,33,17,52,14,17,4,21,16,77,11,12,3,18,10,16,7,7,3,9,6,6,2,3,3,9,4,10,5,4,0,468,272,196,29,11,18,87,81,194,58,26,6,40,41,119,47,13,4,47,40,75,11,13,2,13,0,3,10,5,-4,3,2,6,2,0,-3,10,-2,-3,8,5,-1,528,278,250,60,31,29,105,66,218,82,39,-1,52,30,97,71,21,-1,53,36,121,11,18,0,15,16,20,12,4,-7,8,10,11,6,0,-4,7,6,9,6,4,-3,442,269,173,169,99,70,54,75,183,64,27,22,40,36,99,56,14,18,14,39,84,8,13,4,28,27,62,22,24,6,13,16,36,19,11,4,15,11,26,3,13,2,535,268,267,170,80,90,104,82,189,98,43,4,53,35,93,53,25,2,51,47,96,45,18,2,20,43,50,23,22,7,10,14,27,15,9,3,10,29,23,8,13,4,460,268,192,191,112,79,43,85,144,113,40,15,27,34,99,72,21,14,16,51,45,41,19,1,36,47,49,38,18,0,25,24,26,25,9,3,11,23,23,13,9,-3,244,113,131,211,77,134,46,24,120,22,10,28,33,10,55,-2,5,13,13,14,65,24,5,15,60,34,51,39,16,9,26,13,20,9,7,1,34,21,31,30,9,8,343,175,168,131,70,61,36,63,146,47,33,5,25,23,62,23,25,4,11,40,84,24,8,1,18,20,55,25,13,-1,13,4,30,17,8,-2,5,16,25,8,5,1,183,84,99,37,11,26,44,71,0,51,9,-7,33,37,-1,14,4,-10,11,34,1,37,5,3,22,27,-5,-5,1,-4,15,17,-4,-9,-2,-6,7,10,-1,4,3,2,195,82,113,96,57,39,29,38,59,27,18,27,2,23,13,19,13,15,27,15,46,8,5,12,24,28,10,16,12,7,14,16,9,9,9,1,10,12,1,7,3,6,-98,-30,-68,-61,-24,-37,-7,-49,-30,-20,4,-9,-2,-24,-8,-6,-4,3,-5,-25,-22,-14,8,-12,4,-11,-28,-27,-1,-1,3,-5,-17,-7,-3,2,1,-6,-11,-20,2,-3,-27,11,-38,-63,-31,-32,-13,-2,-1,-33,14,-3,-7,0,10,-9,9,1,-6,-2,-11,-24,5,-4,-3,3,-29,-26,-1,-7,-1,2,-12,-16,-2,-2,-2,1,-17,-10,1,-5,-158,-71,-87,-101,-62,-39,-28,-43,-1,-66,-17,-11,-12,-15,-8,-34,-1,-8,-16,-28,7,-32,-16,-3,-11,-15,-20,-40,-15,-1,-5,-11,-15,-25,-8,1,-6,-4,-5,-15,-7,-2,-97,-45,-52,-38,-21,-17,-20,-38,-38,-30,16,-7,1,-23,-25,-3,4,-6,-21,-15,-13,-27,12,-1,1,-11,-8,-13,-2,-6,0,-7,-3,-5,-2,-4,1,-4,-5,-8,0,-2,28,-7,35,-18,-11,-7,24,-19,25,-18,11,-12,3,-7,3,-17,2,0,21,-12,22,-1,9,-12,4,-4,0,-18,-7,4,0,-1,1,-11,-6,3,4,-3,-1,-7,-1,1,-44,-18,-26,43,19,24,-11,-6,-12,-49,20,2,4,-2,-14,-27,2,14,-15,-4,2,-22,18,-12,15,10,8,7,3,-1,7,10,0,-1,0,2,8,0,8,8,3,-3,-16,-30,14,-20,-17,-3,8,-27,-6,-31,24,11,4,-12,-16,-18,15,-4,4,-15,10,-13,9,15,2,6,-11,-21,-3,6,1,5,-10,-11,0,-2,1,1,-1,-10,-3,8
36,36044,Pontecesures,2981,-21,-11,-10,8,2,6,-10,-1,-1,-2,0,-7,-3,-3,4,0,-4,-4,-7,2,-5,-2,4,-3,1,1,1,1,4,0,1,0,0,0,1,0,0,1,1,1,3,0,34,19,15,17,7,10,-2,12,24,1,-2,0,0,5,11,2,0,0,-2,7,13,-1,-2,0,4,5,3,4,1,0,2,1,1,2,1,0,2,4,2,2,0,0,21,5,16,15,4,11,5,6,9,7,-1,-5,-1,5,3,1,1,-4,6,1,6,6,-2,-1,1,7,5,1,1,0,0,3,2,0,-1,0,1,4,3,1,2,0,-46,-26,-20,12,7,5,-15,-7,-20,-3,-2,1,-9,-7,-12,0,0,1,-6,0,-8,-3,-2,0,1,1,4,2,4,0,0,1,2,1,3,0,1,0,2,1,1,0,51,28,23,21,9,12,-3,19,15,17,3,-3,1,8,6,13,0,-1,-4,11,9,4,3,-2,3,5,5,2,4,2,1,3,1,2,1,1,2,2,4,0,3,1,-19,-9,-10,15,7,8,-16,9,-12,1,-4,1,-7,6,-8,1,-2,2,-9,3,-4,0,-2,-1,5,2,1,2,2,2,1,1,1,1,1,2,4,1,0,1,1,0,2,6,-4,8,5,3,-7,-2,0,5,9,-2,0,-1,-1,5,5,-1,-7,-1,1,0,4,-1,2,0,3,2,0,0,1,0,2,2,0,0,1,0,1,0,0,0,-28,-21,-7,19,14,5,-10,7,-17,-11,-1,1,-3,2,-18,-6,1,0,-7,5,1,-5,-2,1,3,5,2,6,1,1,3,2,1,6,1,0,0,3,1,0,0,1,10,10,0,9,14,-5,-9,20,8,-6,-3,-1,-4,9,10,-2,-1,-1,-5,11,-2,-4,-2,0,1,5,5,0,-1,-1,3,5,6,1,0,-1,-2,0,-1,-1,-1,0,-11,0,-11,0,3,-3,-12,-4,11,-4,2,-2,-10,1,16,-5,2,-2,-2,-5,-5,1,0,0,-1,0,-1,2,0,0,-1,1,0,2,1,0,0,-1,-1,0,-1,0,-14,-3,-11,7,3,4,-31,22,8,-12,-2,5,-16,10,3,-4,0,5,-15,12,5,-8,-2,0,-2,0,5,0,0,4,-3,0,4,0,0,2,1,0,1,0,0,2,-12,-7,-5,4,1,3,7,-5,-3,-1,-1,-6,5,-6,4,-4,-1,-2,2,1,-7,3,0,-4,0,2,2,1,1,-2,0,1,1,-1,1,-1,0,1,1,2,0,-1,-17,-11,-6,-21,-16,-5,-6,5,-6,-6,1,-3,-7,3,0,-4,0,-2,1,2,-6,-2,1,-1,0,0,-7,-9,-3,-1,0,1,-7,-6,-2,-1,0,-1,0,-3,-1,0,-16,-3,-13,2,2,0,8,-1,-8,-10,-3,-3,2,6,-2,-6,-1,0,6,-7,-6,-4,-2,-3,3,3,0,-3,-1,-1,2,2,0,-1,-1,0,1,1,0,-2,0,-1,-33,-36,3,-10,-7,-3,-7,-10,1,-11,-5,-2,-6,-9,-4,-13,-3,-2,-1,-1,5,2,-2,0,2,-1,-4,-6,-1,0,1,0,-3,-6,0,0,1,-1,-1,0,-1,0,-14,-10,-4,-15,-8,-7,3,2,-10,-1,-5,-4,-2,0,-3,-3,-1,-2,5,2,-7,2,-4,-2,-3,-3,-4,-2,-3,0,-2,-2,-2,-1,-1,0,-1,-1,-2,-1,-2,0,-2,-3,1,8,3,5,2,9,-10,8,-6,-4,0,7,-6,3,-4,-4,2,2,-4,5,-2,0,2,4,0,0,1,1,1,3,-1,0,0,0,1,1,1,0,1,1,-10,-9,-1,2,0,2,10,0,-8,-6,-1,-3,9,-2,-7,-7,0,0,1,2,-1,1,-1,-3,3,0,2,-1,0,-2,1,0,1,0,-1,-1,2,0,1,-1,1,-1
36,36038,Pontevedra,74139,76,-1,77,124,65,59,58,-144,142,-6,-1,34,40,-85,46,-4,1,9,18,-59,96,-2,-2,25,18,13,22,18,27,24,6,7,12,10,18,10,12,6,10,8,9,14,279,104,175,98,58,40,132,-32,71,62,-4,41,59,-22,35,15,-7,22,73,-10,36,47,3,19,23,11,12,21,14,17,16,9,8,10,4,11,7,2,4,11,10,6,23,20,3,114,76,38,59,-103,8,7,36,33,40,-64,19,0,13,22,19,-39,-11,7,23,11,40,6,13,28,11,16,24,4,12,18,6,12,16,2,1,10,5,4,135,-6,141,109,57,52,95,-80,24,62,1,39,35,-65,11,20,-9,5,60,-15,13,42,10,34,28,12,15,16,19,18,14,6,17,5,2,13,14,6,-2,11,17,5,381,183,198,539,224,315,108,26,90,91,5,68,55,21,36,49,-3,28,53,5,54,42,8,40,103,100,169,97,48,19,53,43,59,45,19,3,50,57,110,52,29,16,481,171,310,550,261,289,210,25,75,92,13,52,78,9,5,59,-10,30,132,16,70,33,23,22,134,129,129,91,39,20,70,62,58,46,15,9,64,67,71,45,24,11,350,230,120,594,332,262,110,17,99,90,-21,57,75,23,48,72,-18,30,35,-6,51,18,-3,27,109,164,135,116,45,21,66,90,73,64,22,14,43,74,62,52,23,7,163,95,68,412,196,216,40,38,-31,58,40,15,39,11,-39,36,28,17,1,27,8,22,12,-2,69,119,99,66,45,9,50,43,37,36,22,6,19,76,62,30,23,3,449,173,276,352,137,215,132,40,104,118,8,54,75,8,36,36,-2,18,57,32,68,82,10,36,74,87,94,60,17,19,35,30,41,19,6,5,39,57,53,41,11,14,105,-10,115,165,83,82,56,-58,49,7,-16,87,14,-42,17,-8,-4,25,42,-16,32,15,-12,62,55,49,23,12,24,1,33,14,9,6,17,3,22,35,14,6,7,-2,404,240,164,268,124,144,112,32,146,99,16,7,70,4,76,93,-5,12,42,28,70,6,21,-5,49,70,69,58,10,7,28,28,36,28,2,1,21,42,33,30,8,6,308,172,136,213,120,93,47,8,129,37,49,46,-9,9,107,11,30,29,56,-1,22,26,19,17,53,53,57,34,21,-7,29,29,38,21,6,-4,24,24,19,13,15,-3,179,120,59,23,-2,25,46,65,64,47,49,-85,43,18,33,24,29,-31,3,47,31,23,20,-54,9,36,-39,-17,19,10,5,8,-22,-5,6,3,4,28,-17,-12,13,7,-14,-30,16,-85,-31,-54,-35,18,13,-14,-45,49,-22,10,-11,1,-22,21,-13,8,24,-15,-23,28,-13,16,-62,-32,-8,8,-11,11,-25,-13,0,7,-2,5,-37,-19,-8,1,53,-22,75,161,60,101,18,19,-17,-6,-7,44,24,7,-43,-18,-17,24,-6,12,26,12,10,20,45,44,19,30,10,12,27,16,0,12,0,5,18,28,19,18,10,7,140,49,91,184,86,98,49,24,-15,36,-1,32,29,4,-4,11,-6,11,20,20,-11,25,5,21,34,67,12,21,25,22,11,29,9,17,8,12,23,38,3,4,17,10,303,158,145,246,123,123,91,-9,94,55,28,47,69,-14,61,17,14,20,22,5,33,38,14,27,38,49,55,43,40,20,29,15,27,19,21,12,9,34,28,24,19,8,365,130,235,420,189,231,111,67,62,78,50,-3,69,31,-6,13,21,5,42,36,68,65,29,-8,71,78,107,70,63,27,41,43,41,22,27,14,30,35,66,48,36,13
36,36039,"Porriño, O",15823,-41,-8,-33,71,39,32,-9,-6,-11,-10,-9,7,-6,-5,2,1,-5,7,-3,-1,-13,-11,-4,0,11,18,24,9,7,2,7,7,13,7,3,2,4,11,11,2,4,0,108,20,88,128,47,81,37,34,26,9,-3,2,8,2,1,5,1,2,29,32,25,4,-4,0,32,38,35,15,4,4,18,7,8,8,2,4,14,31,27,7,2,0,43,25,18,97,48,49,3,-27,13,43,8,2,11,-27,12,23,6,1,-8,0,1,20,2,1,21,18,23,20,12,1,7,10,11,8,11,0,14,8,12,12,1,1,2,3,-1,149,69,80,-32,28,-19,23,1,1,-17,19,-4,9,-2,0,-15,9,-15,14,3,1,23,41,31,32,19,3,12,17,13,18,8,1,11,24,18,14,11,2,44,5,39,162,68,94,-9,5,-3,-1,29,15,-10,4,-13,5,8,7,1,1,10,-6,21,8,33,33,46,24,19,7,14,13,14,14,8,5,19,20,32,10,11,2,42,64,-22,121,72,49,16,16,27,-26,-4,11,6,8,39,0,-1,7,10,8,-12,-26,-3,4,28,25,33,18,13,3,13,10,24,16,7,1,15,15,9,2,6,2,156,97,59,136,72,64,26,17,83,29,-1,0,22,1,54,24,-1,-4,4,16,29,5,0,4,29,21,43,25,14,2,13,10,25,14,9,0,16,11,18,11,5,2,401,236,165,176,100,76,70,65,193,55,13,6,40,44,115,31,10,-1,30,21,78,24,3,7,30,48,46,30,11,8,12,33,30,17,6,2,18,15,16,13,5,6,367,214,153,160,85,75,43,60,164,70,18,14,29,28,118,29,10,2,14,32,46,41,8,12,21,42,48,28,17,4,10,19,30,16,11,0,11,23,18,12,6,4,502,273,229,111,59,52,104,67,176,88,46,15,48,29,92,66,25,6,56,38,84,22,21,9,24,28,19,25,6,6,10,11,10,18,3,6,14,17,9,7,3,0,114,33,81,45,22,23,21,8,88,-17,15,-6,5,8,39,-24,8,-2,16,0,49,7,7,-4,15,13,14,-1,5,-2,10,7,8,-2,1,-2,5,6,6,1,4,0,-135,-56,-79,5,7,-2,-59,-28,-2,-36,-14,0,-28,-15,14,-19,-10,1,-31,-13,-16,-17,-4,-1,-4,-3,10,-8,4,5,0,-2,5,-3,3,4,-4,-1,5,-5,1,1,183,75,108,36,23,13,2,20,101,48,-3,12,-2,12,28,30,-4,7,4,8,73,18,1,5,6,6,5,10,3,3,6,2,3,7,3,2,0,4,2,3,0,1,-88,-53,-35,-38,-25,-13,-29,-12,-20,-20,7,-17,-24,-10,-10,-13,3,-1,-5,-2,-10,-7,4,-16,-3,-2,-17,-6,-5,-4,-1,-2,-12,-5,-5,0,-2,0,-5,-1,0,-4,30,30,0,27,20,7,8,-29,54,2,3,-10,-2,-13,42,-4,7,-1,10,-16,12,6,-4,-9,4,5,11,-3,10,-1,1,1,9,0,9,0,3,4,2,-3,1,-1,-4,16,-20,-86,-37,-49,12,-4,-19,-4,3,11,9,-1,-3,8,0,3,3,-3,-16,-12,3,8,-1,-8,-27,-36,-11,-2,2,-5,-11,-15,-6,-2,-3,-3,-16,-21,-5,0,-51,-12,-39,21,10,11,-31,2,10,-22,-11,1,-12,1,9,-9,-3,1,-19,1,1,-13,-8,0,-7,19,-1,1,-1,8,-6,6,3,3,2,2,-1,13,-4,-2,-3,6,105,59,46,104,48,56,-18,32,45,25,35,-17,0,8,25,26,17,-15,-18,24,20,-1,18,-2,23,26,19,19,10,6,15,8,7,11,6,0,8,18,12,8,4,6
36,36040,Portas,3215,-12,-7,-5,6,4,2,-13,2,-5,2,2,-2,-7,1,-2,1,0,-2,-6,1,-3,1,2,0,1,1,1,2,0,0,0,1,1,1,0,0,1,0,0,1,0,0,-5,-11,6,6,4,2,-2,-1,-5,0,3,1,-2,-4,-5,1,-1,0,0,3,0,-1,4,1,0,0,0,1,4,1,0,0,0,1,2,1,0,0,0,0,2,0,-15,-7,-8,1,-1,2,-7,-9,-2,-2,-3,8,-4,-3,-2,1,-3,3,-3,-6,0,-3,0,5,0,0,0,1,-2,2,0,0,0,0,-2,1,0,0,0,1,0,1,-1,4,-5,-2,-2,0,9,-8,-5,7,1,-6,7,-3,-2,3,1,-3,2,-5,-3,4,0,-3,0,0,-1,1,1,-3,0,0,0,0,0,-2,0,0,-1,1,1,-1,-2,-9,7,15,5,10,4,5,-8,-2,2,-5,-2,-2,-3,-2,2,-3,6,7,-5,0,0,-2,3,4,2,3,3,0,0,3,0,0,2,0,3,1,2,3,1,0,0,4,-4,7,5,2,11,-9,-3,1,2,-1,8,-2,-8,4,1,1,3,-7,5,-3,1,-2,0,0,2,1,2,2,0,0,1,1,1,2,0,0,1,0,1,0,-23,-5,-18,5,2,3,-5,-5,-11,0,0,-1,-5,-1,0,1,0,0,0,-4,-11,-1,0,-1,0,0,3,3,0,-1,0,0,2,1,0,-1,0,0,1,2,0,0,-30,-23,-7,5,1,4,-6,-4,-11,-8,-4,3,-5,0,-9,-6,-2,-1,-1,-4,-2,-2,-2,4,4,1,-1,0,-1,2,2,0,-2,1,-1,1,2,1,1,-1,0,1,9,15,-6,6,5,1,8,1,-6,1,9,-2,5,0,7,1,5,-1,3,1,-13,0,4,-1,3,0,0,1,2,0,2,0,2,1,1,-1,1,0,-2,0,1,1,6,5,1,-3,-1,-2,1,1,5,-1,-2,-6,1,7,-6,3,-2,-1,0,-6,11,-4,0,-5,0,0,0,0,-1,-2,0,0,0,0,-1,0,0,0,0,0,0,-2,-4,8,-12,-6,-3,-3,2,-3,5,4,0,-11,7,0,2,2,0,-3,-5,-3,3,2,0,-8,-1,0,-1,0,-2,-2,0,0,0,0,-1,-2,-1,0,-1,0,-1,0,6,10,-4,-6,-4,-2,1,5,-4,-6,3,4,2,3,-2,-4,4,4,-1,2,-2,-2,-1,0,-2,-2,0,-4,-1,3,-2,-2,-1,-1,0,2,0,0,1,-3,-1,1,-18,-6,-12,-1,-2,1,7,-15,-21,7,7,-2,2,-8,-7,6,4,-2,5,-7,-14,1,3,0,0,0,-3,0,1,1,0,0,-3,0,0,1,0,0,0,0,1,0,22,11,11,2,0,2,36,2,-6,-5,4,-8,25,0,-5,-9,2,-2,11,2,-1,4,2,-6,0,-1,1,1,-1,2,0,-1,0,1,-1,1,0,0,1,0,0,1,45,20,25,-3,0,-3,10,10,9,20,-6,2,2,7,3,13,-5,-1,8,3,6,7,-1,3,0,-1,0,0,-1,-1,0,0,0,0,0,0,0,-1,0,0,-1,-1,28,13,15,6,4,2,14,-5,10,-3,10,1,11,-4,3,-3,5,0,3,-1,7,0,5,1,-2,0,4,1,1,2,-1,0,4,0,1,0,-1,0,0,1,0,2,-16,-11,-5,-4,-3,-1,-4,-2,-9,-4,0,2,-5,0,-3,-4,2,-2,1,-2,-6,0,-2,4,0,1,-3,-1,-1,0,-1,1,-1,-1,-1,0,1,0,-2,0,0,0,-4,1,-5,2,1,1,1,-11,0,8,1,-3,2,-4,-4,9,0,-1,-1,-7,4,-1,1,-2,0,0,0,0,2,0,0,0,0,0,1,0,0,0,0,0,1,0
36,36045,Redondela,28943,31,2,29,88,45,43,4,-19,32,-6,9,13,2,-17,6,2,3,2,2,-2,26,-8,6,11,21,16,20,15,10,5,12,10,6,8,6,2,9,6,14,7,4,3,-49,-34,-15,38,17,21,-5,-34,-17,-7,3,9,2,-27,-8,-8,1,6,-7,-7,-9,1,2,3,7,3,9,6,8,5,5,0,5,4,1,2,2,3,4,2,7,3,-25,-34,9,2,-3,5,17,-3,-17,-12,-14,2,-11,-1,-15,-9,-6,6,28,-2,-2,-3,-8,-4,6,-1,-1,2,-5,1,1,-1,-1,1,-4,1,5,0,0,1,-1,0,-66,-56,-10,14,4,10,18,-36,-59,20,-14,-3,2,-22,-34,10,-7,-8,16,-14,-25,10,-7,5,3,6,-1,2,1,0,2,4,-3,-2,2,-1,1,2,2,4,-1,1,37,41,-4,119,54,65,12,-6,-16,24,18,1,17,-3,-6,16,8,6,-5,-3,-10,8,10,-5,23,19,26,20,22,8,9,8,7,14,11,4,14,11,19,6,11,4,149,83,66,120,64,56,41,6,64,51,-17,6,19,1,33,33,-8,4,22,5,31,18,-9,2,22,19,37,25,13,3,9,9,23,14,7,1,13,10,14,11,6,2,-19,-16,-3,89,40,49,26,-25,-66,29,22,-3,26,-12,-42,0,16,-6,0,-13,-24,29,6,3,20,20,12,16,12,8,9,8,5,8,7,3,11,12,7,8,5,5,21,35,-14,91,49,42,0,22,-7,-20,19,7,3,15,-3,1,18,-1,-3,7,-4,-21,1,8,17,28,25,10,8,2,7,13,16,4,6,3,10,15,9,6,2,-1,16,-8,24,86,44,42,33,-23,-23,45,-8,-12,14,-20,-28,29,-6,1,19,-3,5,16,-2,-13,21,7,37,14,6,0,10,1,18,12,4,-1,11,6,19,2,2,1,33,8,25,45,32,13,11,4,-5,24,5,-14,-9,-5,-5,28,-3,0,20,9,0,-4,8,-14,12,4,7,11,6,5,5,3,5,11,4,4,7,1,2,0,2,1,-89,-8,-81,14,15,-1,-23,-6,-60,-3,20,-12,7,6,-34,4,12,-3,-30,-12,-26,-7,8,-9,2,-3,-3,-2,9,9,6,-4,2,1,4,5,-4,1,-5,-3,5,4,33,11,22,34,22,12,-9,27,-37,40,3,3,-4,7,-29,24,-2,11,-5,20,-8,16,5,-8,6,8,-1,11,6,3,5,4,-2,10,3,1,1,4,1,1,3,2,-59,-31,-28,4,6,-2,12,-29,-26,-21,4,5,-7,-19,-15,8,-1,1,19,-10,-11,-29,5,4,3,2,-2,-3,4,-2,3,1,-2,1,2,0,0,1,0,-4,2,-2,87,65,22,4,-2,6,7,-14,54,44,6,-2,11,-12,48,15,10,-3,-4,-2,6,29,-4,1,3,-3,7,-7,1,1,5,-6,3,-5,-1,1,-2,3,4,-2,2,0,-236,-182,-54,-199,-139,-60,7,-34,-64,-87,-51,-9,-1,-23,-46,-68,-45,-5,8,-11,-18,-19,-6,-4,-10,-13,-33,-76,-50,-19,-8,-7,-17,-60,-39,-10,-2,-6,-16,-16,-11,-9,-113,-87,-26,-21,-12,-9,2,-5,-67,-10,-21,-13,-9,-6,-35,-18,-16,-4,11,1,-32,8,-5,-9,-12,-3,-15,0,9,-1,-7,0,-10,0,4,1,-5,-3,-5,0,5,-2,-61,-38,-23,46,21,25,-26,-8,-2,13,-35,-2,-19,4,0,3,-19,-2,-7,-12,-2,10,-16,0,15,7,3,9,5,6,5,3,0,5,4,3,10,4,3,4,1,3,-68,-26,-42,59,20,39,-5,-26,-34,-14,12,0,-2,-9,-4,-6,2,-9,-3,-17,-30,-8,10,9,12,1,22,13,2,7,5,-1,10,5,-3,3,7,2,12,8,5,4
36,36046,Ribadumia,4214,14,4,10,13,6,7,9,-3,-1,4,4,1,3,0,-3,1,0,2,6,-3,2,3,4,-1,0,2,3,1,5,2,0,1,1,1,1,2,0,1,2,0,4,0,-41,-18,-23,9,4,5,-2,-2,-28,-2,-7,0,1,-4,-13,1,-4,2,-3,2,-15,-3,-3,-2,1,2,3,2,0,1,1,0,1,1,0,1,0,2,2,1,0,0,-25,-11,-14,17,8,9,-9,-5,-7,-8,1,3,-2,-3,-5,-4,0,4,-7,-2,-2,-4,1,-1,4,1,3,3,2,4,2,1,1,1,-1,4,2,0,2,2,3,0,63,14,49,9,4,5,14,14,16,1,12,6,8,1,-3,0,6,3,6,13,19,1,6,3,3,1,0,1,1,2,1,1,-1,2,0,1,2,0,1,-1,1,1,78,42,36,40,22,18,13,21,27,12,4,2,12,9,15,2,4,-1,1,12,12,10,0,3,7,7,8,14,2,2,6,2,4,8,2,0,1,5,4,6,0,2,213,79,134,30,15,15,18,20,46,14,7,104,10,7,23,5,2,32,8,13,23,9,5,72,6,6,9,3,5,1,4,3,4,1,2,1,2,3,5,2,3,0,174,75,99,15,6,9,14,28,62,27,7,28,7,11,24,12,5,9,7,17,38,15,2,19,1,8,3,6,-3,0,1,4,0,1,-2,2,0,4,3,5,-1,-2,139,59,80,42,21,21,18,25,51,15,5,19,7,5,31,6,4,5,11,20,20,9,1,14,9,9,12,6,4,1,2,4,11,1,3,0,7,5,1,5,1,1,116,66,50,25,18,7,24,17,36,10,1,22,12,8,25,9,4,4,12,9,11,1,-3,18,5,4,3,11,2,0,5,3,2,6,3,-1,0,1,1,5,-1,1,138,72,66,18,4,14,19,39,39,14,6,23,9,18,20,14,1,11,10,21,19,0,5,12,4,9,3,3,0,-1,3,3,-1,1,-1,-1,1,6,4,2,1,0,102,49,53,0,0,0,9,12,34,10,9,25,8,6,25,-3,7,4,1,6,9,13,2,21,1,1,0,-1,-1,0,0,2,0,-1,-1,0,1,-1,0,0,0,0,88,41,47,-1,0,-1,-3,17,11,18,10,34,-3,7,4,11,7,12,0,10,7,7,3,22,-1,2,-3,0,2,-1,-2,1,-1,0,2,0,1,1,-2,0,0,-1,33,3,30,11,2,9,6,-9,1,14,-8,25,0,-3,-7,8,-6,7,6,-6,8,6,-2,18,2,2,2,-1,2,4,3,0,0,-2,-1,2,-1,2,2,1,3,2,-34,-22,-12,-16,-11,-5,-17,-5,-13,-15,-1,22,-10,-4,-9,-1,-3,8,-7,-1,-4,-14,2,14,-4,-2,-7,-6,1,2,-3,-2,-4,-4,0,2,-1,0,-3,-2,1,0,4,-1,5,-10,-5,-5,6,-10,-13,8,0,11,4,-6,-7,1,3,2,2,-4,-6,7,-3,9,2,-6,-5,4,-5,0,2,-3,-5,3,-2,0,0,-3,0,1,-3,0,36,24,12,-6,0,-6,11,4,18,-23,0,21,4,4,9,-11,2,11,7,0,9,-12,-2,10,1,-4,-1,-3,3,-2,1,-1,0,-1,2,-1,0,-3,-1,-2,1,-1,21,18,3,18,9,9,10,10,-7,-11,3,14,0,12,-1,-4,4,6,10,-2,-6,-7,-1,8,8,-1,4,6,2,-1,3,0,3,3,1,-1,5,-1,1,3,1,0,40,10,30,1,1,0,-5,7,20,4,-3,13,-7,1,5,6,0,3,2,6,15,-2,-3,10,-1,3,-1,-3,2,0,-1,3,-1,-1,0,0,0,0,0,-2,2,0
36,36047,Rodeiro,4396,-21,-13,-8,13,8,5,0,-4,-14,-2,-3,3,-2,1,-9,-2,-3,3,2,-5,-5,0,0,0,0,2,1,4,0,6,0,2,0,3,0,3,0,0,1,1,0,3,-25,-10,-15,6,4,2,-2,-1,-12,-4,-3,-2,0,1,-6,-3,-1,-1,-2,-2,-6,-1,-2,-1,2,2,0,0,1,1,2,1,0,0,1,0,0,1,0,0,0,1,-10,-3,-7,26,14,12,5,-15,5,-4,1,-2,1,-9,4,-4,0,5,4,-6,1,0,1,-7,8,0,4,2,6,6,4,0,2,1,3,4,4,0,2,1,3,2,-7,-2,-5,21,14,7,-1,2,-12,0,6,-2,-1,0,1,0,3,-4,0,2,-13,0,3,2,3,6,3,5,2,2,2,2,3,4,2,1,1,4,0,1,0,1,14,9,5,14,9,5,0,4,11,-4,-2,3,3,1,4,0,-3,3,-3,3,7,-4,1,0,3,1,4,1,4,1,2,1,2,1,2,1,1,0,2,0,2,0,-11,-2,-9,14,4,10,3,-1,-9,2,-3,-1,1,0,-7,1,1,3,2,-1,-2,1,-4,-4,6,0,3,2,2,1,0,0,1,1,1,1,6,0,2,1,1,0,-24,-13,-11,7,6,1,-3,-3,-19,-1,4,-1,-2,1,-10,-2,2,-1,-1,-4,-9,1,2,0,3,1,0,1,1,1,1,1,0,1,1,2,2,0,0,0,0,-1,-2,8,-10,10,6,4,0,4,-4,6,-5,-3,0,3,-2,4,-2,5,0,1,-2,2,-3,-8,2,1,0,4,0,2,1,1,0,3,0,1,1,0,0,1,0,1,-16,-8,-8,8,6,2,-4,4,-2,-8,4,-9,-2,4,-3,-6,5,-6,-2,0,1,-2,-1,-3,1,2,0,1,4,0,1,1,0,1,4,-1,0,1,0,0,0,1,-4,1,-5,4,2,2,1,-1,-5,7,1,-6,2,-2,1,1,0,0,-1,1,-6,6,1,-6,1,1,-1,0,4,-1,1,-1,-1,-1,3,1,0,2,0,1,1,-2,-19,-10,-9,5,3,2,-2,-3,-5,1,-2,-7,-1,0,-2,-2,1,-5,-1,-3,-3,3,-3,-2,0,1,0,1,2,1,0,1,0,1,1,0,0,0,0,0,1,1,-17,-14,-3,1,-1,2,2,1,-1,-7,1,-17,0,0,-5,-8,1,-4,2,1,4,1,0,-13,1,2,0,-3,1,-1,0,1,0,-2,1,-1,1,1,0,-1,0,0,-28,-12,-16,4,1,3,2,-1,-9,-10,1,-11,0,-1,-7,-2,3,-6,2,0,-2,-8,-2,-5,2,0,-1,2,0,1,1,0,0,0,-1,1,1,0,-1,2,1,0,-32,-15,-17,-3,-3,0,-5,-2,-3,-6,-6,-10,-3,-1,2,-3,-4,-5,-2,-1,-5,-3,-2,-5,0,0,-2,-1,-1,1,0,0,-1,-1,-1,0,0,0,-1,0,0,1,-22,-13,-9,-3,-1,-2,0,-4,-5,-6,-2,-6,1,-2,-1,-6,-1,-5,-1,-2,-4,0,-1,-1,0,-1,0,-2,0,0,0,0,1,-2,0,0,0,-1,-1,0,0,0,-27,-24,-3,-5,-4,-1,0,-3,-11,-8,-7,0,0,-1,-11,-6,-4,-2,0,-2,0,-2,-3,2,-2,-2,2,-2,-1,0,0,-1,0,-2,-1,0,-2,-1,2,0,0,0,-39,-10,-29,2,3,-1,-4,-3,-12,-9,3,-12,-1,1,-2,-4,3,-5,-3,-4,-10,-5,0,-7,-2,1,2,1,2,-2,-2,1,1,1,2,0,0,0,1,0,0,-2,-7,1,-8,12,6,6,-9,-2,6,-2,-2,2,-2,-1,2,2,-3,3,-7,-1,4,-4,1,-1,2,-1,5,5,-1,2,1,-1,3,2,-1,2,1,0,2,3,0,0
36,36048,"Rosal, O",5807,73,41,32,26,14,12,15,4,33,8,3,8,10,-1,15,6,5,3,5,5,18,2,-2,5,7,2,9,6,1,1,4,1,4,4,1,0,3,1,5,2,0,1,74,32,42,19,10,9,17,12,10,16,10,8,6,3,1,11,6,4,11,9,9,5,4,4,4,5,4,2,3,0,2,1,2,2,2,0,2,4,2,0,1,0,21,18,3,-4,-2,-2,6,-2,1,5,11,0,3,0,-1,6,7,3,3,-2,2,-1,4,-3,0,-4,-1,1,-1,1,-1,-1,-1,3,-3,1,1,-3,0,-2,2,0,90,46,44,34,19,15,26,1,30,23,10,-3,12,-4,19,12,8,-3,14,5,11,11,2,0,9,3,8,4,4,4,5,2,4,3,1,2,4,1,4,1,3,2,90,56,34,40,24,16,24,5,17,21,23,0,19,1,11,13,11,1,5,4,6,8,12,-1,8,3,10,9,6,4,6,2,6,5,2,3,2,1,4,4,4,1,105,52,53,34,15,19,17,2,42,23,13,3,8,-3,26,7,9,2,9,5,16,16,4,1,5,3,7,7,6,4,2,1,4,2,3,2,3,2,3,5,3,2,109,77,32,31,20,11,33,12,24,16,16,4,27,8,14,16,8,2,6,4,10,0,8,2,6,2,7,6,8,2,6,0,4,3,6,1,0,2,3,3,2,1,72,46,26,37,19,18,10,2,5,28,22,1,6,5,2,17,12,0,4,-3,3,11,10,1,4,3,8,11,9,0,0,1,4,6,6,0,4,2,4,5,3,0,113,57,56,41,16,25,20,13,35,23,9,7,3,4,21,17,6,3,17,9,14,6,3,4,9,8,9,7,4,2,2,1,4,4,3,1,7,7,5,3,1,1,41,37,4,4,4,0,14,-6,12,14,5,0,12,-3,7,10,6,4,2,-3,5,4,-1,-4,3,2,-1,0,0,0,1,2,-2,2,0,1,2,0,1,-2,0,-1,27,32,-5,1,0,1,0,5,-5,14,9,3,1,7,4,10,4,3,-1,-2,-9,4,5,0,-1,-2,0,0,2,1,-1,-1,-1,1,0,1,0,-1,1,-1,2,0,0,16,-16,-1,5,-6,0,-5,3,-3,7,-1,0,-1,4,3,7,3,0,-4,-1,-6,0,-4,-3,-3,0,3,4,-2,-3,-3,4,5,4,-2,0,0,-4,-2,0,0,-5,3,-8,12,8,4,4,-7,-4,3,0,-1,8,-4,0,-1,0,1,-4,-3,-4,4,0,-2,3,2,2,3,1,1,3,0,0,3,1,1,0,2,2,0,0,0,3,0,3,7,1,6,3,-4,-16,0,16,1,0,-3,-10,0,11,2,3,-1,-6,0,5,-1,0,1,-7,1,10,1,0,0,-5,0,6,0,0,1,-2,1,4,1,-12,-2,-10,-8,-2,-6,-17,6,0,-2,-6,2,-7,8,-3,4,-7,1,-10,-2,3,-6,1,1,-2,0,-1,-6,0,1,-2,2,1,-3,0,0,0,-2,-2,-3,0,1,-27,-10,-17,-25,-14,-11,-1,-20,-8,6,-3,-3,-3,-11,-3,5,-3,3,2,-9,-5,1,0,-6,-9,-5,-6,-7,3,-1,-4,-4,-5,-3,2,0,-5,-1,-1,-4,1,-1,-9,1,-10,-12,-4,-8,0,-2,-21,18,-4,0,0,0,-16,17,2,-2,0,-2,-5,1,-6,2,-5,-1,-8,1,0,1,-3,0,-3,0,2,0,-2,-1,-5,1,-2,1,-2,-4,2,5,5,0,-1,3,-9,5,3,-3,-3,-2,-1,-2,2,2,2,5,-8,7,1,-5,2,-4,1,0,4,2,2,-4,5,-1,1,2,0,0,-4,1,3,0
36,36049,Salceda de Caselas,6019,174,103,71,68,47,21,25,43,73,22,-1,4,17,28,42,16,-3,-2,8,15,31,6,2,6,8,21,18,11,4,5,5,17,13,9,1,2,3,4,5,2,3,3,173,81,92,61,34,27,15,32,63,26,24,12,7,16,25,15,13,4,8,16,38,11,11,8,4,16,14,11,10,6,2,10,7,5,5,5,2,6,7,6,5,1,157,96,61,77,46,31,39,38,37,20,14,5,27,23,23,10,10,1,12,15,14,10,4,4,20,11,16,12,9,8,14,7,9,7,5,4,6,4,7,5,4,4,192,106,86,64,42,22,21,31,73,37,26,0,12,15,35,28,15,1,9,16,38,9,11,-1,9,14,15,11,10,4,8,7,12,7,5,2,1,7,3,4,5,2,429,270,159,79,45,34,50,78,197,49,30,16,33,40,129,29,16,15,17,38,68,20,14,1,6,14,26,11,13,8,3,9,14,6,6,6,3,5,12,5,7,2,249,124,125,72,34,38,46,45,86,49,7,6,16,22,46,32,2,1,30,23,40,17,5,5,15,16,23,14,1,2,4,7,13,7,1,1,11,9,10,7,0,1,227,136,91,59,33,26,30,36,116,27,15,-4,12,20,69,17,10,4,18,16,47,10,5,-8,8,17,27,3,6,-2,4,7,16,3,3,0,4,10,11,0,3,-2,223,113,110,58,35,23,22,35,123,19,7,12,10,8,79,2,4,7,12,27,44,17,3,5,5,10,25,6,5,6,4,8,15,2,1,4,1,2,10,4,4,2,314,172,142,60,31,29,40,70,137,36,17,1,23,27,81,25,13,-2,17,43,56,11,4,3,12,18,24,7,3,-4,6,8,15,2,2,-2,6,10,9,5,1,-2,156,84,72,28,17,11,4,41,50,40,11,3,-2,20,34,24,2,4,6,21,16,16,9,-1,5,15,1,11,0,-5,3,5,2,9,0,-2,2,10,-1,2,0,-3,140,82,58,-20,-8,-12,16,14,82,26,0,-5,19,9,31,22,-1,-3,-3,5,51,4,1,-2,3,0,-18,1,-1,-6,1,0,-9,2,-1,-2,2,0,-9,-1,0,-4,121,60,61,14,18,-4,33,18,42,12,1,8,21,3,19,16,-6,1,12,15,23,-4,7,7,5,0,1,8,-1,0,5,3,4,9,-1,-2,0,-3,-3,-1,0,2,71,8,63,-39,-30,-9,28,-1,-2,22,0,20,6,-3,-9,2,5,3,22,2,7,20,-5,17,1,-3,-12,-13,-8,-4,1,-4,-9,-9,-6,-3,0,1,-3,-4,-2,-1,-51,-28,-23,-41,-27,-14,-24,-2,-15,-20,7,8,-19,4,-5,-17,3,8,-5,-6,-10,-3,4,0,-7,-5,-19,-10,2,-3,-3,-2,-14,-10,1,0,-4,-3,-5,0,1,-3,7,-13,20,-37,-31,-6,-8,12,12,-24,-1,12,-4,8,-3,-15,-1,2,-4,4,15,-9,0,10,-1,0,-13,-16,-8,0,-1,0,-13,-11,-5,-1,0,0,0,-5,-3,1,19,10,9,-11,-17,6,-5,10,20,0,6,-11,0,-1,25,-3,-1,-9,-5,11,-5,3,7,-2,-4,4,-8,1,-3,-1,-2,-1,-2,-3,-7,-2,-2,5,-6,4,4,1,68,31,37,14,2,12,8,-8,41,-19,22,17,2,-3,17,-7,7,8,6,-5,24,-12,15,9,9,0,1,2,2,0,3,1,-6,2,2,0,6,-1,7,0,0,0,112,46,66,16,5,11,16,8,25,18,4,30,10,2,7,10,-2,13,6,6,18,8,6,17,9,-2,-1,-3,2,7,6,0,-2,-4,0,3,3,-2,1,1,2,4
36,36050,Salvaterra de Miño,8453,-47,-28,-19,36,15,21,-10,-21,-30,1,5,6,-7,-16,-15,4,1,4,-3,-5,-15,-3,4,2,4,4,10,7,7,4,1,1,5,3,3,2,3,3,5,4,4,2,5,22,-17,25,16,9,-3,-5,6,6,5,-4,1,-4,12,1,8,5,-4,-1,-6,5,-3,-9,5,3,7,7,2,1,1,2,5,6,1,1,4,1,2,1,1,0,33,36,-3,24,20,4,13,13,-8,0,3,11,12,9,-2,6,5,6,1,4,-6,-6,-2,5,6,6,10,2,1,-1,3,4,8,1,3,1,3,2,2,1,-2,-2,66,46,20,32,24,8,14,-8,23,29,7,0,8,-4,14,16,7,4,6,-4,9,13,0,-4,4,9,9,11,-3,1,3,8,4,7,0,2,1,1,5,4,-3,-1,89,49,40,21,10,11,11,3,33,22,18,3,6,4,9,17,11,2,5,-1,24,5,7,1,3,3,4,3,6,2,2,3,-1,2,2,2,1,0,5,1,4,0,160,109,51,70,40,30,43,6,28,49,30,3,24,2,25,31,19,5,19,4,3,18,11,-2,19,9,16,4,13,8,6,4,15,3,9,3,13,5,1,1,4,5,304,194,110,76,52,24,64,34,90,64,40,11,45,19,49,44,23,11,19,15,41,20,17,0,8,15,25,12,12,4,5,9,17,10,9,2,3,6,8,2,3,2,427,274,153,110,76,34,69,68,133,104,42,6,42,43,90,63,27,6,27,25,43,41,15,0,21,17,30,29,8,4,12,11,27,17,7,1,9,6,3,12,1,3,209,150,59,81,58,23,31,36,87,41,17,-5,19,21,67,33,3,4,12,15,20,8,14,-9,18,13,30,20,5,-6,7,7,26,18,2,-3,11,6,4,2,3,-3,206,166,40,76,56,20,43,21,55,39,26,3,28,16,42,39,23,7,15,5,13,0,3,-4,13,10,20,15,11,5,10,7,16,9,10,4,3,3,4,6,1,1,180,143,37,50,34,16,27,22,62,41,17,7,30,8,57,24,15,3,-3,14,5,17,2,4,12,12,17,7,-3,4,8,8,14,1,0,2,4,4,3,6,-3,2,149,88,61,33,23,10,2,36,34,19,33,22,15,20,17,3,21,13,-13,16,17,16,12,9,5,6,12,0,3,7,4,4,9,-2,5,3,1,2,3,2,-2,4,137,62,75,44,20,24,26,27,26,34,32,-13,11,12,2,26,20,-9,15,15,24,8,12,-4,3,11,13,9,6,1,0,6,7,3,4,0,3,5,6,6,2,1,-3,21,-24,21,14,7,-9,0,-13,5,2,3,0,-1,2,8,1,4,-9,1,-15,-3,1,-1,6,6,7,8,0,-7,4,4,5,4,-1,-3,2,2,2,4,1,-4,61,21,40,-44,-26,-18,24,3,13,0,-3,17,16,0,1,0,-7,9,8,3,12,0,4,8,-4,-3,-12,-4,-17,-5,-3,-2,-10,0,-11,-1,-1,-1,-2,-4,-6,-4,12,13,-1,-2,-10,8,-24,20,14,-11,7,9,-21,12,18,-7,4,10,-3,8,-4,-4,3,-1,-4,6,8,-18,5,1,-5,4,3,-14,1,1,1,2,5,-4,4,0,12,-13,25,-56,-53,-3,30,8,-14,-21,0,7,21,4,-15,-25,-5,6,9,4,1,4,5,1,2,2,-11,-34,-10,-7,0,1,-13,-27,-12,-3,2,1,2,-7,2,-4,121,72,49,82,43,39,8,14,30,35,10,18,1,5,16,28,13,7,7,9,14,7,-3,11,11,5,19,24,15,8,3,2,10,19,8,1,8,3,9,5,7,7
36,36051,Sanxenxo,16022,-1,0,-1,56,29,27,-9,-9,-11,6,12,9,-4,-5,-2,1,3,8,-5,-4,-9,5,9,1,18,2,12,12,3,9,9,0,7,6,1,6,9,2,5,6,2,3,-41,-34,-7,22,11,11,-11,-28,-18,-4,13,10,-6,-15,-20,1,2,6,-5,-13,2,-5,11,4,6,1,6,3,4,2,2,0,5,2,2,0,4,1,1,1,2,2,67,29,38,47,21,26,15,5,-24,16,32,22,14,-11,-10,3,17,15,1,16,-14,13,15,7,18,2,2,8,11,6,8,4,0,1,4,4,10,-2,2,7,7,2,46,14,32,25,12,13,-5,-8,12,18,24,2,-1,-5,-2,2,10,7,-4,-3,14,16,14,-5,6,4,3,5,9,-2,3,1,2,4,3,-1,3,3,1,1,6,-1,140,70,70,87,45,42,5,20,34,38,30,9,4,6,29,18,13,-2,1,14,5,20,17,11,14,8,26,20,14,3,7,3,15,10,8,1,7,5,11,10,6,2,220,112,108,100,57,43,26,43,56,43,43,7,18,18,22,24,27,0,8,25,34,19,16,7,8,26,20,23,15,6,3,14,11,15,9,4,5,12,9,8,6,2,108,61,47,90,55,35,25,10,17,49,10,-1,1,13,24,24,2,-1,24,-3,-7,25,8,0,20,11,23,27,9,-1,9,6,16,17,5,1,11,5,7,10,4,-2,92,44,48,161,90,71,9,28,11,13,30,-2,6,11,-6,9,17,3,3,17,17,4,13,-5,15,32,45,36,23,7,7,18,22,24,13,4,8,14,23,12,10,3,78,34,44,68,39,29,16,13,2,30,25,-9,11,0,4,13,8,-3,5,13,-2,17,17,-6,5,18,27,13,5,0,3,10,17,7,1,1,2,8,10,6,4,-1,190,108,82,57,36,21,40,21,68,17,36,3,30,4,33,13,25,2,10,17,35,4,11,1,13,7,13,6,13,5,11,4,9,5,7,0,2,3,4,1,6,5,101,55,46,42,14,28,1,8,37,3,32,18,-3,0,23,4,22,6,4,8,14,-1,10,12,13,10,0,11,7,-1,5,2,-6,8,4,-1,8,8,6,3,3,0,34,22,12,6,5,1,14,-7,-3,15,11,5,0,9,1,10,5,-1,14,-16,-4,5,6,6,9,2,-6,-8,5,3,6,5,-4,-4,2,0,3,-3,-2,-4,3,3,10,16,-6,0,-5,5,-13,-2,13,-11,15,8,-3,-7,17,-10,11,8,-10,5,-4,-1,4,0,4,-2,0,-10,6,0,3,-1,0,-11,4,-1,1,-1,0,1,2,1,21,34,-13,-14,-11,-3,7,-11,0,-13,25,10,15,-2,1,-7,13,11,-8,-9,-1,-6,12,-1,-4,-1,-8,-6,5,-2,-3,-1,-5,-5,2,0,-1,0,-3,-1,3,-2,-198,-113,-85,-134,-79,-55,-35,6,-53,-67,-39,-7,-24,-3,-27,-23,-21,-13,-11,9,-26,-44,-18,6,-12,-6,-36,-47,-33,0,-12,-4,-18,-22,-18,-5,0,-2,-18,-25,-15,5,-48,-54,6,-31,-21,-10,-10,14,-37,-29,7,13,-19,7,-15,-30,-3,9,9,7,-22,1,10,4,5,-2,-30,-11,1,3,0,-1,-16,-9,2,3,5,-1,-14,-2,-1,0,-38,-9,-29,5,4,1,-11,7,-24,-16,2,2,1,8,-4,-8,-3,-1,-12,-1,-20,-8,5,3,3,6,-6,-7,5,4,5,4,-3,-5,0,3,-2,2,-3,-2,5,1,2,-8,10,30,20,10,12,-14,-2,-4,28,-15,11,-9,-13,5,13,-15,1,-5,11,-9,15,0,12,5,13,-7,7,0,12,3,4,-2,3,0,0,2,9,-5,4,0
36,36052,Silleda,9297,11,8,3,59,27,32,1,6,-12,9,8,-1,0,3,0,-1,3,3,1,3,-12,10,5,-4,7,13,11,13,11,4,3,6,5,6,5,2,4,7,6,7,6,2,43,18,25,79,35,44,7,15,11,-9,5,11,7,-3,2,-3,6,7,0,18,9,-6,-1,4,8,23,27,5,5,9,3,6,13,3,3,6,5,17,14,2,2,3,33,18,15,76,36,40,12,2,2,1,17,-1,0,6,0,2,7,4,12,-4,2,-1,10,-5,15,17,17,9,12,6,4,9,9,7,5,2,11,8,8,2,7,4,77,24,53,79,35,44,13,15,23,-1,15,13,4,-1,11,2,4,5,9,16,12,-3,11,8,9,14,14,15,17,10,3,4,8,8,5,7,6,10,6,7,12,3,109,81,28,121,77,44,11,19,19,24,12,26,13,14,10,19,9,15,-2,5,9,5,3,11,14,38,28,20,8,13,9,25,19,12,6,6,5,13,9,8,2,7,53,27,26,103,43,60,9,14,5,9,10,8,2,7,1,7,4,6,7,7,4,2,6,2,9,33,20,14,10,17,3,16,7,6,3,8,6,17,13,8,7,9,43,36,7,108,62,46,19,20,-10,16,1,-6,11,11,-2,15,1,-2,8,9,-8,1,0,-4,20,30,22,20,8,8,13,12,15,13,4,5,7,18,7,7,4,3,183,119,64,148,96,52,25,30,71,45,19,-10,14,23,45,30,10,-4,11,7,26,15,9,-6,14,41,48,34,16,-5,9,25,32,23,10,-3,5,16,16,11,6,-2,131,111,20,120,80,40,39,18,19,45,6,4,24,16,25,32,6,8,15,2,-6,13,0,-4,14,23,37,25,14,7,8,14,25,18,8,7,6,9,12,7,6,0,54,43,11,45,34,11,31,2,10,29,8,-27,15,7,5,19,3,-8,16,-5,5,10,5,-19,13,15,13,8,1,-6,10,7,9,8,1,-2,3,8,4,0,0,-4,3,4,-1,49,21,28,1,5,3,-11,7,-2,2,0,2,-6,5,1,-1,5,1,-5,2,-3,8,10,12,7,12,-1,5,3,3,3,7,0,3,7,9,4,5,-1,7,35,-28,44,31,13,-11,15,8,-5,15,-19,-5,15,13,4,10,-6,-6,0,-5,-9,5,-13,2,20,13,1,10,-2,1,13,8,1,8,0,1,7,5,0,2,-2,30,30,0,13,7,6,3,10,15,1,9,-13,0,10,6,7,5,-1,3,0,9,-6,4,-12,4,5,1,5,2,-5,1,2,0,3,0,0,3,3,1,2,2,-5,-61,-12,-49,9,5,4,-10,-14,-19,-8,6,-14,2,-2,-12,3,3,-2,-12,-12,-7,-11,3,-12,4,2,0,3,4,-5,5,1,-1,1,0,-1,-1,1,1,2,4,-4,2,5,-3,11,1,10,15,-11,-4,9,5,-12,11,-8,-6,8,5,-5,4,-3,2,1,0,-7,3,0,5,4,3,-4,1,-1,0,3,2,-4,2,1,5,1,1,0,-1,9,-10,22,14,8,4,-14,16,6,-8,-6,1,-9,9,9,-5,0,3,-5,7,-3,-3,-6,4,2,9,7,-6,6,4,0,4,5,-2,3,0,2,5,2,-4,3,33,24,9,48,19,29,5,14,-6,0,-1,17,3,8,4,3,-3,8,2,6,-10,-3,2,9,8,11,6,6,5,12,1,2,4,4,2,6,7,9,2,2,3,6,102,58,44,37,14,23,19,3,22,35,20,1,14,5,16,12,13,-4,5,-2,6,23,7,5,7,8,6,11,1,3,6,4,1,3,1,-1,1,4,5,8,0,4
36,36053,Soutomaior,5330,62,39,23,32,17,15,21,10,25,4,-4,7,11,7,16,5,-2,3,10,3,9,-1,-2,4,5,7,11,5,0,3,2,5,5,3,0,2,3,2,6,2,0,1,59,37,22,19,10,9,9,11,17,2,15,4,3,8,13,5,6,0,6,3,4,-3,9,4,1,6,5,5,2,0,1,3,2,2,2,0,0,3,3,3,0,0,59,21,38,8,3,5,22,9,35,-5,-3,1,8,3,14,2,-6,2,14,6,21,-7,3,-1,2,2,1,2,2,-1,0,1,1,1,1,-1,2,1,0,1,1,0,182,111,71,11,5,6,35,25,80,22,9,7,25,7,55,13,5,6,10,18,25,9,4,1,2,2,2,1,1,3,0,0,1,1,1,2,2,2,1,0,0,1,166,96,70,38,21,17,11,36,72,16,21,3,8,19,44,11,14,1,3,17,28,5,7,2,9,8,9,2,11,-1,5,3,6,1,7,-1,4,5,3,1,4,0,142,60,82,55,22,33,8,24,68,26,16,-1,7,6,30,11,7,0,1,18,38,15,9,-1,7,19,14,9,3,2,4,2,7,7,1,1,3,17,7,2,2,1,202,98,104,39,14,25,28,41,81,28,12,10,16,14,46,14,5,3,12,27,35,14,7,7,8,7,14,7,3,0,4,2,4,3,1,0,4,5,10,4,2,0,239,128,111,46,21,25,13,41,124,29,28,2,9,21,66,18,14,1,4,20,58,11,14,1,9,9,18,5,5,0,3,4,8,4,2,0,6,5,10,1,3,0,280,145,135,56,25,31,57,39,109,42,21,8,29,16,59,26,9,3,28,23,50,16,12,5,12,19,17,9,1,-2,6,8,7,5,0,-1,6,11,10,4,1,-1,241,124,117,17,3,14,46,34,110,34,14,3,29,19,47,15,9,3,17,15,63,19,5,0,5,7,2,4,1,-3,3,2,-2,1,-1,0,2,5,4,3,2,-3,52,24,28,30,12,18,-14,13,32,8,8,1,-4,-9,17,13,3,3,-10,22,15,-5,5,-2,4,5,7,3,7,3,4,-1,3,1,3,1,0,6,4,2,4,2,-37,-18,-19,18,6,12,-21,2,1,-14,0,-3,-14,0,10,1,-7,-6,-7,2,-9,-15,7,3,12,5,-2,4,1,-2,9,0,-2,2,-1,-2,3,5,0,2,2,0,16,25,-9,-11,-6,-5,4,9,-3,12,1,-6,6,5,5,9,0,-1,-2,4,-8,3,1,-5,-1,1,-4,-3,-1,-4,-1,1,-3,-1,-1,-1,0,0,-1,-2,0,-3,13,17,-4,11,2,9,1,15,3,-5,-3,2,3,7,-2,8,-5,5,-2,8,5,-13,2,-3,3,5,1,-1,3,0,0,1,1,-1,1,0,3,4,0,0,2,0,-57,-51,-6,-12,-6,-6,-19,-2,16,-43,-8,-7,-23,-4,7,-28,-4,-4,4,2,9,-15,-4,-3,-1,0,-6,-3,0,-1,-2,1,-3,-1,0,0,1,-1,-3,-2,0,-1,-96,-39,-57,-26,-17,-9,-45,-5,-26,-10,-9,3,-17,0,-14,1,-6,-2,-28,-5,-12,-11,-3,5,-4,1,-8,-14,0,-1,-1,1,-4,-11,0,-2,-3,0,-4,-3,0,1,-7,-27,20,-7,-8,1,13,2,-7,-24,9,1,1,0,-15,-19,3,2,12,2,8,-5,6,-1,2,1,-3,-10,2,1,0,0,-1,-7,0,0,2,1,-2,-3,2,1,68,40,28,14,9,5,11,9,40,6,1,-1,6,9,19,-4,5,2,5,0,21,10,-4,-3,2,2,1,10,-1,0,2,2,3,3,-1,0,0,0,-2,7,0,0
36,36054,Tomiño,10705,180,89,91,54,25,29,40,12,54,39,30,3,18,3,33,17,16,2,22,9,21,22,14,1,6,8,8,11,9,11,3,4,6,5,3,4,3,4,2,6,6,7,231,123,108,71,38,33,53,0,76,59,34,7,20,-2,51,32,17,4,33,2,25,27,17,3,21,11,12,16,5,4,12,4,7,11,1,2,9,7,5,5,4,2,93,50,43,47,30,17,13,9,28,27,16,1,6,7,18,15,8,-1,7,2,10,12,8,2,10,9,11,8,3,5,9,5,6,6,2,1,1,4,5,2,1,4,294,162,132,87,46,41,65,24,120,54,30,2,34,14,67,25,21,-1,31,10,53,29,9,3,16,11,34,8,10,8,9,4,21,4,6,2,7,7,13,4,4,6,160,82,78,115,62,53,23,4,48,29,47,5,12,-5,22,20,24,4,11,9,26,9,23,1,26,21,26,11,26,4,12,10,13,9,14,3,14,11,13,2,12,1,331,161,170,95,53,42,39,60,74,72,62,22,20,29,38,34,30,10,19,31,36,38,32,12,14,16,26,20,15,4,6,10,15,12,5,5,8,6,11,8,10,-1,341,205,136,123,72,51,76,31,91,82,56,9,49,15,61,52,28,4,27,16,30,30,28,5,23,18,24,28,23,7,13,10,16,15,14,4,10,8,8,13,9,3,345,203,142,74,44,30,70,20,129,67,32,20,40,10,76,42,20,13,30,10,53,25,12,7,15,4,27,16,13,-2,10,-1,15,8,11,0,5,5,12,8,2,-2,342,188,154,93,57,36,53,50,103,73,26,22,33,23,63,36,17,8,20,27,40,37,9,14,15,22,28,17,6,2,10,11,24,7,5,0,5,11,4,10,1,2,209,118,91,68,40,28,36,9,64,58,25,14,16,-8,38,42,18,9,20,17,26,16,7,5,11,15,3,14,12,12,5,2,3,12,8,9,6,13,0,2,4,3,128,86,42,14,8,6,30,-8,37,46,16,6,14,-13,33,35,16,-1,16,5,4,11,0,7,4,4,1,3,2,0,-1,-1,4,5,2,-1,5,5,-3,-2,0,1,144,71,73,47,32,15,19,9,29,36,38,4,6,14,11,14,22,4,13,-5,18,22,16,0,11,12,4,8,7,4,6,8,2,4,8,3,5,4,2,4,-1,1,64,34,30,-6,-6,0,1,3,-1,17,15,27,11,-6,-1,10,3,14,-10,9,0,7,12,13,-1,0,10,-11,-7,2,0,-1,8,-10,-7,3,-1,1,2,-1,0,-1,60,29,31,23,11,12,-4,17,0,11,20,13,8,7,-2,3,13,2,-12,10,2,8,7,11,10,6,6,1,1,-3,6,3,4,0,-1,-2,4,3,2,1,2,-1,8,17,-9,2,1,1,8,-17,-12,5,10,11,0,-9,5,0,8,10,8,-8,-17,5,2,1,-1,-3,-6,2,5,3,-3,0,-1,0,3,1,2,-3,-5,2,2,2,17,18,-1,17,4,13,-19,-5,-1,-24,32,34,-12,3,6,-8,17,12,-7,-8,-7,-16,15,22,5,1,8,-12,11,4,1,3,2,-7,4,1,4,-2,6,-5,7,3,115,74,41,51,31,20,25,-6,18,17,23,31,16,-5,16,12,14,19,9,-1,2,5,9,12,13,5,9,12,5,7,6,1,7,10,2,5,7,4,2,2,3,2,-59,-26,-33,-12,-13,1,-3,-15,-19,-15,-1,-6,8,-9,-1,-18,-2,-3,-11,-6,-18,3,1,-3,1,3,0,-11,-5,0,1,3,5,-17,-4,-1,0,0,-5,6,-1,1
36,36055,Tui,15827,120,60,60,116,67,49,27,3,24,5,22,34,16,9,5,7,10,12,11,-6,19,-2,12,22,19,24,34,21,11,7,9,13,21,13,8,3,10,11,13,8,3,4,83,35,48,103,52,51,17,13,20,25,1,2,14,1,9,12,-1,-1,3,12,11,13,2,3,18,21,32,19,8,3,14,10,13,11,3,0,4,11,19,8,5,3,67,12,55,51,31,20,31,-20,9,2,10,20,8,-20,0,7,2,5,23,0,9,-5,8,15,9,5,9,15,7,4,4,3,6,9,4,4,5,2,3,6,3,0,50,20,30,21,13,8,15,-3,-13,12,17,18,5,-4,-6,7,9,6,10,1,-7,5,8,12,2,4,3,2,9,1,0,3,2,2,5,1,2,1,1,0,4,0,263,151,112,131,82,49,38,1,116,50,34,25,34,-3,72,26,15,8,4,4,44,24,19,17,21,16,47,21,19,7,15,6,33,15,11,2,6,10,14,6,8,5,305,166,139,158,85,73,57,33,86,53,19,36,26,9,67,25,12,15,31,24,19,28,7,21,31,29,35,30,15,9,16,15,20,15,8,4,15,14,15,15,7,5,122,58,64,100,54,46,57,-23,26,30,11,9,35,-10,8,11,4,5,22,-13,18,19,7,4,23,15,32,15,8,-1,10,8,19,8,5,0,13,7,13,7,3,-1,98,19,79,153,67,86,32,1,7,-6,17,26,13,-6,-11,2,4,4,19,7,18,-8,13,22,39,21,39,25,18,7,16,10,16,16,6,1,23,11,23,9,12,6,70,48,22,98,55,43,41,-30,9,11,7,26,31,-12,13,7,2,2,10,-18,-4,4,5,24,24,12,29,19,12,1,16,6,19,10,5,-1,8,6,10,9,7,2,28,0,28,46,33,13,4,-4,-2,11,6,9,-4,-10,8,10,-2,1,8,6,-10,1,8,8,6,10,20,7,1,1,3,5,15,6,2,1,3,5,5,1,-1,0,-36,-18,-18,49,27,22,-20,-3,-36,-8,10,17,-19,1,-18,4,9,3,-1,-4,-18,-12,1,14,11,7,6,9,7,7,4,4,2,4,8,3,7,3,4,5,-1,4,79,42,37,24,7,17,41,-6,3,18,15,11,28,-3,4,9,10,-3,13,-3,-1,9,5,14,10,8,2,1,3,0,6,2,-1,0,1,-1,4,6,3,1,2,1,-14,-26,12,-6,-9,3,5,7,-25,-4,8,-4,-2,4,-14,-12,1,-2,7,3,-11,8,7,-2,-5,2,-1,-6,3,-1,-7,1,-1,-4,0,0,2,1,0,-2,3,-1,21,9,12,-30,-11,-19,14,-4,-9,-12,2,28,11,-1,-4,-9,0,10,3,-3,-5,-3,2,18,-8,3,-10,-15,1,-2,-3,3,-5,-9,1,1,-5,0,-5,-6,0,-3,-66,-38,-28,-22,-15,-7,-6,-35,-29,0,-4,11,5,-13,-22,0,-5,0,-11,-22,-7,0,1,11,-2,-7,-5,2,-7,-3,0,-3,-7,4,-7,-2,-2,-4,2,-2,0,-1,1,19,-18,14,13,1,-8,-16,13,-20,-2,32,-14,0,9,0,3,17,6,-16,4,-20,-5,15,4,-4,6,-6,-1,13,1,-3,10,1,-1,4,3,-1,-4,-7,0,9,-21,6,-27,41,22,19,2,-14,-15,-10,9,5,17,-14,1,-11,9,0,-15,0,-16,1,0,5,10,8,8,-1,7,5,7,3,4,1,2,2,3,5,4,-2,5,3,120,80,40,57,29,28,44,-17,0,56,15,22,24,-8,6,33,8,13,20,-9,-6,23,7,9,10,3,16,10,10,4,7,0,7,4,7,1,3,3,9,6,3,3
36,36056,Valga,6288,-5,-8,3,33,18,15,5,-5,-6,-1,1,4,0,-1,-4,-4,1,2,5,-4,-2,3,0,2,8,5,9,9,2,0,5,3,5,4,1,0,3,2,4,5,1,0,-64,-33,-31,10,7,3,-6,-18,-28,-17,7,-1,3,-11,-18,-12,5,0,-9,-7,-10,-5,2,-1,2,2,2,1,3,0,2,1,1,1,2,0,0,1,1,0,1,0,-74,-22,-52,-7,-4,-3,-7,-27,-23,-11,0,-1,1,-9,-7,-7,1,0,-8,-18,-16,-4,-1,-1,0,-3,-1,-4,0,1,0,-1,0,-4,0,1,0,-2,-1,0,0,0,17,7,10,22,14,8,20,-9,-17,16,0,5,15,-6,-18,12,-1,4,5,-3,1,4,1,1,7,1,2,8,2,2,6,1,1,5,0,1,1,0,1,3,2,1,-21,-18,-3,35,19,16,1,-22,-5,-4,4,5,0,-14,-9,0,3,2,1,-8,4,-4,1,3,6,4,9,7,5,3,3,1,7,2,4,1,3,3,2,5,1,2,-21,-7,-14,21,9,12,8,-14,-16,0,8,-5,2,-1,-9,2,2,-3,6,-13,-7,-2,6,-2,5,3,6,3,4,0,1,1,4,1,2,0,4,2,2,2,2,0,-11,-19,8,24,15,9,14,-23,-6,-5,7,-3,7,-17,-9,-6,5,-3,7,-6,3,1,2,0,5,0,9,2,7,0,3,1,6,1,3,0,2,-1,3,1,4,0,38,31,7,29,19,10,12,5,-8,22,11,-7,14,-3,4,11,7,-2,-2,8,-12,11,4,-5,3,1,10,12,4,-1,2,0,9,4,3,1,1,1,1,8,1,-2,20,7,13,23,8,15,4,-10,8,14,4,-1,-4,0,3,8,0,-1,8,-10,5,6,4,0,8,2,5,4,2,0,3,1,1,3,0,-1,5,1,4,1,2,1,19,13,6,0,-4,4,20,13,-9,4,-3,-6,7,2,-5,7,1,0,13,11,-4,-3,-4,-6,1,2,-2,0,-1,0,0,0,-2,-1,-1,0,1,2,0,1,0,0,-6,3,-9,-6,1,-7,14,-15,-2,-6,8,-8,2,-3,9,-7,6,-3,12,-12,-11,1,2,-5,-3,1,-2,-1,0,-1,-1,1,-1,1,1,0,-2,0,-1,-2,-1,-1,-30,-25,-5,0,2,-2,1,3,-23,-1,-1,-8,3,1,-21,-3,-1,-2,-2,2,-2,2,0,-6,3,0,-3,-1,3,-2,3,0,-2,1,1,-1,0,0,-1,-2,2,-1,12,9,3,3,1,2,0,-1,0,6,2,5,1,2,-5,8,0,2,-1,-3,5,-2,2,3,-2,1,-1,-1,4,2,-2,-1,0,0,3,1,0,2,-1,-1,1,1,26,10,16,-7,-2,-5,4,7,7,12,-5,-1,1,-1,10,5,-3,-4,3,8,-3,7,-2,3,0,-1,-2,-1,-2,-2,0,-1,1,0,-1,-2,0,0,-3,-1,-1,0,29,29,0,-1,-1,0,5,1,14,7,5,-4,0,2,13,6,7,-1,5,-1,1,1,-2,-3,0,0,2,-5,2,0,0,0,1,-5,3,0,0,0,1,0,-1,0,3,-1,4,7,6,1,-2,-1,-13,9,5,1,-2,-2,-11,4,4,4,0,1,-2,5,1,-3,3,1,0,1,1,1,2,1,1,0,1,1,1,0,-1,1,0,0,-34,-7,-27,0,4,-4,-1,-11,-8,-16,1,-1,-4,-3,4,-4,-2,0,3,-8,-12,-12,3,-1,-1,1,0,-2,0,1,-1,1,3,-1,0,1,0,0,-3,-1,0,0,-25,-3,-22,-4,-4,0,-9,2,-16,-11,0,6,0,2,-5,-5,-1,4,-9,0,-11,-6,1,2,-2,0,-1,-3,-1,3,-1,0,-1,-2,-2,2,-1,0,0,-1,1,1
36,36057,Vigo,283670,209,107,102,1659,873,786,133,9,163,-25,-88,12,47,6,70,0,-35,7,86,3,93,-25,-53,5,251,342,522,284,157,84,133,160,282,161,89,36,118,182,240,123,68,48,709,316,393,2069,1068,1001,338,153,198,70,-87,38,170,70,117,11,-64,6,168,83,81,59,-23,32,406,437,614,374,159,62,209,208,341,191,84,26,197,229,273,183,75,36,1141,604,537,2874,1562,1312,497,241,232,252,-76,28,262,141,158,96,-30,1,235,100,74,156,-46,27,590,538,777,565,288,89,314,274,447,311,155,43,276,264,330,254,133,46,396,113,283,2891,1469,1422,192,114,18,67,-32,99,135,35,-7,-1,-39,19,57,79,25,68,7,80,537,591,785,553,280,123,291,272,414,297,134,50,246,319,371,256,146,73,565,110,455,2595,1356,1239,262,154,1,38,-41,171,80,34,-37,4,-32,78,182,120,38,34,-9,93,479,513,727,478,249,125,246,248,400,271,126,59,233,265,327,207,123,66,1087,466,621,2663,1382,1281,219,266,335,133,33,119,118,102,169,41,3,41,101,164,166,92,30,78,443,620,751,501,234,91,240,283,414,288,109,36,203,337,337,213,125,55,1151,331,820,3298,1566,1732,297,344,356,53,-3,118,93,96,149,5,-55,47,204,248,207,48,52,71,583,694,979,590,297,124,278,303,493,306,120,48,305,391,486,284,177,76,772,180,592,2740,1313,1427,208,258,49,162,-74,206,94,114,-24,38,-61,32,114,144,73,124,-13,174,460,658,826,471,221,75,234,301,414,210,100,37,226,357,412,261,121,38,1145,456,689,1760,816,944,296,322,297,101,-11,177,147,166,109,11,-12,64,149,156,188,90,1,113,296,452,516,317,133,38,147,201,242,139,66,19,149,251,274,178,67,19,51,-49,100,558,320,238,67,53,-72,-1,-146,206,62,6,-54,-19,-74,64,5,47,-18,18,-72,142,103,204,178,84,-13,-12,60,79,99,64,17,-7,43,125,79,20,-30,-5,-427,-385,-42,169,47,122,66,11,-177,-172,-161,24,18,-29,-142,-100,-96,-20,48,40,-35,-72,-65,44,87,164,-36,-25,-13,-21,42,53,-9,-25,-12,-7,45,111,-27,0,-1,-14,352,182,170,297,139,158,233,89,-28,-22,11,80,141,26,-27,21,25,2,92,63,-1,-43,-14,78,122,176,-29,-16,22,7,74,86,-12,-16,2,3,48,90,-17,0,20,4,-272,-258,-14,72,4,68,50,-53,-155,-122,-41,72,5,2,-146,-80,-25,7,45,-55,-9,-42,-16,65,105,46,-67,-16,-8,1,54,22,-46,-24,-4,-3,51,24,-21,8,-4,4,70,-70,140,-40,-13,-27,79,25,-32,59,-65,15,41,-41,-70,33,-43,1,38,66,38,26,-22,14,54,42,-78,-47,-6,-15,35,12,-39,-20,6,-12,19,30,-39,-27,-12,-3,93,-127,220,161,51,110,105,95,2,-74,-70,42,34,9,-60,-56,-38,-15,71,86,62,-18,-32,57,101,79,-29,-39,28,9,55,38,-29,-38,16,7,46,41,0,-1,12,2,75,-122,197,215,76,139,93,45,-80,-22,-99,135,41,9,-132,-26,-72,53,52,36,52,4,-27,82,80,98,-38,13,10,35,38,39,-27,8,-3,8,42,59,-11,5,13,27,1001,343,658,882,383,499,384,193,186,202,6,8,197,46,39,74,-2,-22,187,147,147,128,8,30,232,233,202,94,80,27,108,97,99,29,36,10,124,136,103,65,44,17,-1577,-1402,-175,-1857,-1339,-518,51,223,-412,-820,-517,-122,2,70,-314,-661,-396,-107,49,153,-98,-159,-121,-15,6,164,-433,-840,-509,-265,-8,66,-252,-624,-378,-153,14,98,-181,-216,-131,-112
36,36059,Vila de Cruces,7219,-3,4,-7,27,12,15,-2,-8,-11,9,11,-2,-3,-3,-5,4,9,2,1,-5,-6,5,2,-4,3,3,5,9,6,1,0,2,2,4,4,0,3,1,3,5,2,1,-22,-6,-16,22,10,12,-2,-4,-16,-9,7,2,2,-4,-6,-8,6,4,-4,0,-10,-1,1,-2,4,1,7,5,2,3,1,1,0,3,2,3,3,0,7,2,0,0,-28,-15,-13,21,12,9,1,-3,-4,-7,2,-17,-4,-3,1,-4,2,-6,5,0,-5,-3,0,-11,4,5,6,1,4,0,0,2,4,3,2,1,4,3,2,-2,2,-1,-31,9,-40,34,27,7,0,-15,-27,-1,10,0,5,-4,-7,3,9,1,-5,-11,-20,-4,1,-1,6,3,8,8,3,6,5,3,7,7,3,2,1,0,1,1,0,4,-6,12,-18,32,12,20,-1,5,-14,-4,8,-3,1,8,0,-5,4,3,-2,-3,-14,1,4,-6,3,5,9,8,2,4,1,2,3,2,1,3,2,3,6,6,1,1,33,19,14,47,21,26,12,2,0,5,12,2,2,-3,6,9,3,1,10,5,-6,-4,9,1,6,8,13,10,6,2,3,2,7,6,2,0,3,6,6,4,4,2,-17,-7,-10,33,20,13,7,-16,-25,-7,1,25,7,-13,-12,-8,6,13,0,-3,-13,1,-5,12,13,4,1,9,2,4,9,0,3,4,2,2,4,4,-2,5,0,2,14,-2,16,57,33,24,10,-1,-5,-2,9,-1,2,2,-4,-7,6,-3,8,-3,-1,5,3,2,8,8,23,8,5,3,4,7,16,2,2,1,4,1,7,6,3,2,35,23,12,53,27,26,10,3,4,4,16,-4,5,2,2,0,11,0,5,1,2,4,5,-4,13,7,9,12,10,0,7,4,4,4,5,1,6,3,5,8,5,-1,36,39,-3,38,22,16,18,7,1,9,3,-3,11,5,8,10,5,-1,7,2,-7,-1,-2,-2,14,9,7,4,1,2,9,4,4,2,2,1,5,5,3,2,-1,1,-53,-22,-31,21,12,9,-14,-6,-24,-9,0,0,-5,-5,-11,-9,5,2,-9,-1,-13,0,-5,-2,-4,2,4,5,3,10,-3,1,1,4,1,7,-1,1,3,1,2,3,-27,-11,-16,7,3,4,6,1,-8,-21,6,-8,8,7,-7,-15,2,-4,-2,-6,-1,-6,4,-4,6,4,0,-1,-2,0,5,1,0,-2,0,-1,1,3,0,1,-2,1,-48,-38,-10,0,2,-2,-8,-10,-15,-7,-7,-1,-7,-6,-15,-6,-5,-1,-1,-4,0,-1,-2,0,-1,-1,-1,-3,5,1,0,0,-1,-1,3,1,-1,-1,0,-2,2,0,-110,-68,-42,-36,-16,-20,-15,-13,-39,-25,-6,-12,-11,-12,-26,-10,-6,-3,-4,-1,-13,-15,0,-9,-3,-5,-13,-7,-2,-6,0,-5,-5,-3,-1,-2,-3,0,-8,-4,-1,-4,-68,-33,-35,10,4,6,-12,-22,-20,-15,8,-5,-11,-14,-7,-7,6,-1,-1,-8,-13,-8,2,-4,2,-2,0,1,5,3,0,-2,1,1,2,1,2,0,-1,0,3,2,-77,-32,-45,-40,-20,-20,-2,-5,-33,-22,-6,-13,-1,0,-21,-9,-1,-3,-1,-5,-12,-13,-5,-10,0,-2,-14,-17,-6,-2,2,-1,-10,-9,-1,-1,-2,-1,-4,-8,-5,-1,-34,-26,-8,15,9,6,4,-9,-7,-16,-14,5,3,-7,-8,-7,-14,3,1,-2,1,-9,0,2,3,4,4,5,-3,1,1,2,2,4,-3,2,2,2,2,1,0,-1,-37,-14,-23,10,5,5,-9,-4,-22,1,-6,3,-4,-5,-9,0,-1,3,-5,1,-13,1,-5,0,1,1,0,2,6,0,0,0,1,1,4,-1,1,1,-1,1,2,1
36,36058,Vilaboa,5761,16,20,-4,86,57,29,1,12,-9,4,7,1,1,11,-4,5,6,1,0,1,-5,-1,1,0,24,21,18,15,6,2,14,15,13,10,4,1,10,6,5,5,2,1,-5,-12,7,28,12,16,4,-5,-15,7,2,-1,2,-5,-12,3,2,-2,2,0,-3,4,0,1,9,5,6,4,2,1,4,1,3,1,1,1,5,4,3,3,1,0,-33,-26,-7,-5,-5,0,-10,-12,-3,1,-7,-5,-10,-9,3,-6,-3,-3,0,-3,-6,7,-4,-2,0,0,-1,-1,-1,-2,0,-1,0,-1,-1,-2,0,1,-1,0,0,0,-11,-8,-3,16,6,10,5,-5,-8,-8,0,-3,6,-2,-12,-3,-4,1,-1,-3,4,-5,4,-4,3,6,3,2,1,0,1,3,1,1,0,0,2,3,2,1,1,0,43,16,27,33,18,15,20,-4,-10,10,16,7,12,-4,-13,10,8,2,8,0,3,0,8,5,6,9,6,4,3,2,4,4,4,3,2,1,2,5,2,1,1,1,103,40,63,33,21,12,-3,-12,-20,10,-3,130,1,-4,-9,9,2,39,-4,-8,-11,1,-5,91,5,10,9,6,1,0,4,8,5,4,0,-1,1,2,4,2,1,1,34,6,28,26,15,11,-4,-9,-4,1,3,42,0,-7,-1,3,0,11,-4,-2,-3,-2,3,31,3,3,7,7,2,2,3,1,3,6,0,2,0,2,4,1,2,0,-15,-27,12,24,12,12,0,-3,-26,-13,-1,24,-3,-5,-17,-3,-2,1,3,2,-9,-10,1,23,9,3,1,3,3,1,3,2,0,3,2,0,6,1,1,0,1,1,59,22,37,17,9,8,-9,17,-19,21,10,30,-4,8,-10,5,7,9,-5,9,-9,16,3,21,8,6,-2,2,-3,0,4,2,-1,1,-1,0,4,4,-1,1,-2,0,48,6,42,-14,-13,-1,12,-5,6,12,-2,23,8,-6,1,2,-7,6,4,1,5,10,5,17,2,-2,-8,-1,-3,-2,1,-3,-6,-2,-1,-2,1,1,-2,1,-2,0,94,28,66,11,5,6,17,1,-1,19,0,52,10,-4,1,9,0,8,7,5,-2,10,0,44,1,3,3,0,1,1,1,1,1,0,0,1,0,2,2,0,1,0,2,-4,6,-3,5,-8,-4,-10,-13,0,-4,32,3,-10,-7,0,-4,12,-7,0,-6,0,0,20,-5,1,2,1,0,-2,-2,1,3,2,1,0,-3,0,-1,-1,-1,-2,-22,-23,1,-8,-5,-3,-14,-10,-15,-10,-6,29,-7,-4,-17,-1,-3,6,-7,-6,2,-9,-3,23,-1,-1,-2,0,-6,0,0,-1,0,0,-5,-1,-1,0,-2,0,-1,1,23,-3,26,-17,-16,-1,11,-3,-16,4,-1,25,1,-2,-12,2,-2,9,10,-1,-4,2,1,16,0,0,-9,-10,-2,2,-1,-1,-6,-9,-2,2,1,1,-3,-1,0,0,67,21,46,2,3,-1,10,-4,-3,15,9,38,0,0,-3,5,5,13,10,-4,0,10,4,25,1,0,-4,5,-3,2,1,0,-2,6,-3,1,0,0,-2,-1,0,1,12,14,-2,-1,-4,3,-8,-1,-9,-4,2,34,-4,2,-1,2,1,15,-4,-3,-8,-6,1,19,0,-1,2,-2,0,0,0,-1,0,-2,0,-1,0,0,2,0,0,1,17,-3,20,-9,-12,3,-2,2,-10,5,-1,22,0,-3,1,-1,-5,5,-2,5,-11,6,4,17,1,3,-5,-5,-1,-2,0,0,-3,-5,-2,-2,1,3,-2,0,1,0,23,-11,34,-4,-5,1,-11,4,-15,-3,0,47,-9,-4,-5,-6,-1,15,-2,8,-10,3,1,32,-3,1,1,-6,0,2,-1,0,0,-6,0,1,-2,1,1,0,0,1
36,36060,Vilagarcía de Arousa,33909,105,42,63,217,96,121,28,-27,35,32,23,13,11,-15,13,13,12,7,17,-12,22,19,11,6,37,37,63,40,23,16,17,17,26,15,12,9,20,20,37,25,11,7,320,153,167,291,145,146,111,31,61,53,34,25,58,2,22,28,26,14,53,29,39,25,8,11,67,55,77,60,17,13,40,22,31,32,11,7,27,33,46,28,6,6,314,156,158,312,134,178,84,43,72,47,43,26,42,22,37,24,5,22,42,21,35,23,38,4,78,72,56,51,36,19,36,27,28,22,8,13,42,45,28,29,28,6,295,173,122,106,60,46,72,12,125,8,45,31,43,13,66,16,29,3,29,-1,59,-8,16,28,25,7,29,7,23,12,16,7,18,5,13,0,9,0,11,2,10,12,529,242,287,250,120,130,102,69,160,85,66,43,42,35,59,49,36,20,60,34,101,36,30,23,50,56,54,34,31,21,27,26,20,18,19,9,23,30,34,16,12,12,585,295,290,289,147,142,98,112,177,106,42,49,49,55,96,49,16,26,49,57,81,57,26,23,44,58,85,52,29,16,17,28,49,30,12,7,27,30,36,22,17,9,507,287,220,316,171,145,117,24,153,75,65,58,51,28,96,40,37,25,66,-4,57,35,28,33,62,60,75,52,46,19,22,32,49,33,25,8,40,28,26,19,21,11,541,267,274,305,169,136,97,75,173,96,58,25,40,39,77,63,28,15,57,36,96,33,30,10,58,62,89,44,29,11,35,32,52,26,14,3,23,30,37,18,15,8,325,161,164,239,118,121,49,41,86,42,50,38,40,13,37,21,30,10,9,28,49,21,20,28,40,64,46,37,28,22,23,29,22,20,16,9,17,35,24,17,12,13,330,149,181,155,74,81,82,59,37,66,57,34,45,19,19,33,21,18,37,40,18,33,36,16,40,30,34,11,25,13,22,14,15,5,9,9,18,16,19,6,16,4,-30,-73,43,-15,-21,6,49,11,-75,-4,-16,3,30,-5,-65,-23,-7,-9,19,16,-10,19,-9,12,9,18,-23,-9,-6,-6,2,2,-10,-12,-3,-1,7,16,-13,3,-3,-5,67,31,36,87,40,47,24,16,6,5,1,13,16,1,-6,20,-1,-1,8,15,12,-15,2,14,21,15,5,25,6,8,13,4,-1,15,3,2,8,11,6,10,3,6,86,36,50,-71,-57,-14,18,12,-25,19,10,31,4,14,-10,5,0,19,14,-2,-15,14,10,12,2,3,-37,-31,-1,-9,3,3,-28,-26,-7,-3,-1,0,-9,-5,6,-6,74,33,41,43,18,25,14,11,9,-21,45,7,2,9,-10,-11,29,5,12,2,19,-10,16,2,15,6,-4,7,14,1,11,3,-9,5,3,1,4,3,5,2,11,0,-194,-121,-73,-156,-82,-74,-35,-35,-71,-57,-15,23,-4,-18,-57,-32,-12,8,-31,-17,-14,-25,-3,15,-21,-8,-39,-51,-29,-9,-8,-8,-23,-29,-14,0,-13,0,-16,-22,-15,-9,-60,-23,-37,88,28,60,-17,-16,-36,-45,-3,52,-2,-12,-12,-31,1,32,-15,-4,-24,-14,-4,20,20,15,13,10,12,13,11,5,5,-5,4,7,9,10,8,15,8,6,216,99,117,120,48,72,52,17,30,37,35,30,19,4,23,0,20,25,33,13,7,37,15,5,32,17,21,10,13,22,10,7,10,4,3,12,22,10,11,6,10,10,69,32,37,81,22,59,34,8,15,-6,27,-20,11,5,5,-13,9,11,23,3,10,7,18,-31,19,24,5,-3,13,15,11,7,-1,-10,2,10,8,17,6,7,11,5
36,36061,Vilanova de Arousa,10277,-51,-41,-10,61,32,29,-9,-34,-21,-6,11,6,-5,-25,-15,-3,6,1,-4,-9,-6,-3,5,5,12,6,17,10,12,4,7,2,10,6,5,2,5,4,7,4,7,2,56,31,25,32,17,15,10,6,20,8,12,1,2,4,12,4,7,2,8,2,8,4,5,-1,5,5,7,9,5,1,4,4,3,3,2,1,1,1,4,6,3,0,-2,-1,-1,27,10,17,4,-11,-4,3,7,3,6,-9,0,5,1,-1,-2,-2,-4,-2,6,4,4,6,0,4,11,2,2,2,1,1,5,-1,2,4,-1,3,6,3,7,5,2,22,8,14,12,-7,-22,-6,13,14,4,1,-17,-6,10,11,8,-8,-5,0,3,3,1,4,-2,3,13,3,0,1,-1,1,7,0,1,3,-1,2,6,3,66,37,29,40,21,19,9,-13,2,23,20,20,6,-3,0,17,9,5,3,-10,2,6,11,15,7,8,1,11,9,4,2,4,0,9,6,0,5,4,1,2,3,4,47,28,19,43,27,16,3,10,-2,20,6,9,0,3,2,18,1,2,3,7,-4,2,5,7,8,8,7,9,11,-1,5,8,4,4,5,0,3,0,3,5,6,-1,61,23,38,42,15,27,-6,14,19,30,11,-1,3,2,2,10,8,1,-9,12,17,20,3,-2,4,10,13,8,6,0,1,2,6,2,4,0,3,8,7,6,2,0,30,22,8,47,28,19,18,5,-14,-2,5,13,12,1,0,0,2,3,6,4,-14,-2,3,10,8,12,13,5,6,2,6,7,7,3,3,1,2,5,6,2,3,1,84,36,48,36,16,20,15,23,15,10,19,2,8,8,-2,6,15,2,7,15,17,4,4,0,4,5,12,5,7,3,2,1,4,3,4,2,2,4,8,2,3,1,-9,11,-20,23,18,5,-16,-6,0,-3,17,-2,-10,2,11,6,5,-2,-6,-8,-11,-9,12,0,2,2,4,4,6,4,4,0,4,4,4,2,-2,2,0,0,2,2,-41,-30,-11,14,9,5,10,-3,-51,-22,20,8,2,4,-39,-6,15,-2,8,-7,-12,-16,5,10,0,1,4,2,9,-2,-1,1,2,2,6,-1,1,0,2,0,3,-1,-19,0,-19,19,11,8,-15,5,-5,-1,-11,0,3,3,-3,0,-7,1,-18,2,-2,-1,-4,-1,5,11,1,-4,4,2,6,6,1,-4,1,1,-1,5,0,0,3,1,-59,-16,-43,-27,-17,-10,-6,-3,-12,-28,1,-11,-8,3,2,-18,6,-3,2,-6,-14,-10,-5,-8,-4,-2,-6,-10,0,-5,-5,0,-4,-6,0,-2,1,-2,-2,-4,0,-3,-2,1,-3,4,5,-1,-15,3,-24,-13,6,38,-4,6,-12,-9,6,12,-11,-3,-12,-4,0,26,2,2,-1,-2,2,0,1,2,-1,0,2,0,1,0,0,-2,0,0,48,22,26,16,8,8,-6,14,-22,13,24,21,-2,-1,-11,6,16,11,-4,15,-11,7,8,10,0,5,-3,-2,8,7,2,2,-1,-2,4,3,-2,3,-2,0,4,4,46,22,24,2,-1,3,25,-9,5,20,8,-4,11,-4,-1,15,0,2,14,-5,6,5,8,-6,4,1,-9,6,-1,1,2,1,-7,3,-2,2,2,0,-2,3,1,-1,-10,-9,-1,21,10,11,-6,-7,-4,-10,-3,22,4,-6,-12,-7,-2,15,-10,-1,8,-3,-1,7,7,2,-1,4,5,4,6,1,-2,0,4,1,1,1,1,4,1,3,56,-4,60,22,4,18,18,-16,-16,1,8,63,3,-7,-14,-11,1,25,15,-9,-2,12,7,38,5,7,0,1,6,3,2,3,-2,-2,3,0,3,4,2,3,3,3
37,37046,Béjar,16025,-119,-70,-49,6,5,1,-20,-33,-54,-19,-4,4,-17,-18,-31,-3,-1,-3,-3,-15,-23,-16,-3,7,0,1,1,0,3,1,0,1,1,0,2,1,0,0,0,0,1,0,-149,-81,-68,23,10,13,-15,-31,-48,-29,-9,-16,-3,-19,-28,-14,-8,-8,-12,-12,-20,-15,-1,-8,4,4,6,3,5,1,2,1,3,2,2,0,2,3,3,1,3,1,-142,-69,-73,-5,-1,-4,-9,-53,-50,-30,-6,4,-11,-30,-20,-11,0,5,2,-23,-30,-19,-6,-1,0,-4,-5,1,1,2,0,-1,-2,0,1,1,0,-3,-3,1,0,1,-93,-42,-51,1,-3,4,-6,-11,-97,0,3,21,2,-10,-40,-4,3,9,-8,-1,-57,4,0,12,1,2,0,0,0,-2,0,-1,0,0,-1,-1,1,3,0,0,1,-1,33,49,-16,53,36,17,29,4,-27,14,14,-2,16,14,-6,14,7,1,13,-10,-21,0,7,-3,3,9,21,12,6,2,1,9,14,6,2,4,2,0,7,6,4,-2,5,24,-19,83,50,33,21,-2,-25,15,3,-14,20,-13,4,12,3,-5,1,11,-29,3,0,-9,12,15,26,17,10,1,8,8,20,9,5,0,4,7,6,8,5,1,186,81,105,150,69,81,64,0,-12,66,29,31,29,-6,-4,32,8,20,35,6,-8,34,21,11,33,17,48,32,15,3,13,5,27,17,4,2,20,12,21,15,11,1,161,95,66,201,126,75,30,39,-19,52,47,13,17,11,0,35,22,13,13,28,-19,17,25,0,27,49,37,48,33,7,16,23,26,37,20,4,11,26,11,11,13,3,-14,-8,-6,64,33,31,32,-9,-31,-1,-17,5,9,-5,-12,-4,-10,8,23,-4,-19,3,-7,-3,9,26,10,8,5,5,5,16,3,3,3,2,4,10,7,5,2,3,-110,-32,-78,-16,-23,7,-5,-12,-23,-36,-17,-17,5,1,-7,-22,-5,-4,-10,-13,-16,-14,-12,-13,4,8,0,-15,-8,-7,1,4,-4,-14,-7,-3,3,4,4,-1,-1,-4,-155,-69,-86,23,5,18,-20,-21,-57,-36,-16,-4,-11,-4,-28,-14,-14,1,-9,-17,-29,-22,-2,-5,-6,16,7,-4,8,-1,-5,12,0,-4,0,0,-1,4,7,0,8,-1,5,-6,11,19,11,8,23,15,-59,3,12,4,4,11,-39,0,4,11,19,4,-20,3,8,-7,5,5,2,4,1,2,2,5,1,0,2,2,3,0,1,4,-1,0,14,33,-19,-12,-11,-1,18,-9,22,4,-13,-11,10,-7,37,2,-12,0,8,-2,-15,2,-1,-11,3,2,-5,-5,-9,2,3,2,-6,-6,-5,1,0,0,1,1,-4,1,-196,-126,-70,-19,-11,-8,-8,-28,-92,-41,-6,-20,-4,-15,-68,-28,-4,-5,-4,-13,-24,-13,-2,-15,1,1,-5,-9,-2,-4,1,-1,-3,-1,-4,-2,0,2,-2,-8,2,-2,-102,-73,-29,-42,-30,-12,12,-10,-71,-23,-2,-8,12,-6,-54,-23,5,-5,0,-4,-17,0,-7,-3,0,-7,-21,-15,-1,1,1,-3,-16,-10,-1,-1,-1,-4,-5,-5,0,2,-181,-86,-95,-28,-24,-4,-36,-9,-81,-19,-15,-21,-23,8,-46,-10,-3,-8,-13,-17,-35,-9,-12,-13,-6,1,-10,-6,-7,0,-7,1,-11,-7,-1,1,1,0,1,1,-6,-1,-80,-76,-4,36,16,20,8,-18,-53,-5,-3,-9,-3,-15,-45,-6,-6,-2,11,-3,-8,1,3,-7,9,7,9,10,1,-1,2,3,3,8,0,0,7,4,6,2,1,-1,-110,-26,-84,20,16,4,-11,-44,-31,-20,-2,-2,-5,-16,-4,-8,2,6,-6,-28,-27,-12,-4,-8,4,-4,8,4,5,2,2,0,8,2,3,0,2,-4,0,2,2,2
37,37067,Cabrerizos,1775,227,115,112,13,4,9,55,42,80,33,6,7,33,20,32,19,6,3,22,22,48,14,0,4,7,0,2,4,0,0,2,0,0,2,0,0,5,0,2,2,0,0,131,64,67,3,2,1,31,17,39,35,8,1,20,5,16,20,3,0,11,12,23,15,5,1,1,0,0,1,1,0,1,0,0,1,0,0,0,0,0,0,1,0,81,48,33,14,7,7,20,4,28,20,5,3,7,4,22,13,1,1,13,0,6,7,4,2,8,-1,5,3,0,-1,3,0,3,2,0,-1,5,-1,2,1,0,0,140,77,63,8,6,2,38,26,39,35,-4,0,16,18,19,21,-2,1,22,8,20,14,-2,-1,3,2,1,3,0,-1,1,2,1,2,0,0,2,0,0,1,0,-1,273,140,133,23,13,10,65,17,103,69,11,0,36,8,51,39,5,0,29,9,52,30,6,0,11,1,2,6,0,1,9,0,1,3,0,0,2,1,1,3,0,1,161,83,78,17,7,10,45,21,30,43,15,-1,22,9,22,20,9,-2,23,12,8,23,6,1,8,5,-1,3,1,0,3,3,0,1,0,0,5,2,-1,2,1,0,177,99,78,25,14,11,74,1,39,39,8,6,38,3,24,19,4,5,36,-2,15,20,4,1,4,2,6,4,3,3,1,1,3,3,1,2,3,1,3,1,2,1,146,67,79,10,5,5,46,10,18,43,11,8,23,4,8,22,5,1,23,6,10,21,6,7,3,1,3,0,1,2,2,0,1,0,1,1,1,1,2,0,0,1,115,47,68,14,7,7,30,1,32,26,10,12,9,-4,18,14,6,1,21,5,14,12,4,11,5,1,6,1,0,0,4,0,2,1,0,0,1,1,4,0,0,0,108,60,48,11,4,7,28,5,18,45,4,6,11,5,15,20,4,3,17,0,3,25,0,3,0,2,5,4,0,0,-1,1,3,2,-1,0,1,1,2,2,1,0,41,22,19,6,6,0,9,2,0,4,14,11,8,2,-1,2,3,7,1,0,1,2,11,4,3,1,1,-1,2,1,3,1,1,-1,1,1,0,0,0,0,1,0,65,39,26,-4,-4,0,19,8,2,19,2,10,12,5,3,7,5,2,7,3,-1,12,-3,8,1,1,1,-4,-2,-1,0,0,0,-4,0,0,1,1,1,0,-2,-1,28,19,9,-2,0,-2,16,-6,4,6,8,0,15,-4,-3,6,5,-2,1,-2,7,0,3,2,1,-1,0,0,-1,-2,1,0,0,0,-1,-1,0,-1,0,0,0,-1,42,18,24,5,0,5,11,-2,-8,27,5,6,3,-4,-3,16,2,1,8,2,-5,11,3,5,2,0,-1,1,3,0,-1,-1,1,0,2,-1,3,1,-2,1,1,1,47,22,25,13,4,9,37,-1,7,10,-15,8,20,-6,0,7,-6,4,17,5,7,3,-9,4,3,0,4,2,-1,5,1,-2,2,2,-1,2,2,2,2,0,0,3,10,-2,12,1,0,1,-1,-4,1,2,8,4,-11,0,4,-1,3,3,10,-4,-3,3,5,1,0,-1,-2,1,1,2,0,-1,1,-1,1,0,0,0,-3,2,0,2,-11,-8,-3,3,1,2,9,-4,-9,-2,-6,1,4,0,-5,-1,-4,-1,5,-4,-4,-1,-2,2,1,1,1,1,0,-1,0,2,1,1,-2,-1,1,-1,0,0,2,0,35,16,19,7,0,7,7,-4,-3,6,10,19,1,-4,-1,11,2,7,6,0,-2,-5,8,12,4,3,0,1,-1,0,2,0,0,-1,0,-1,2,3,0,2,-1,1
37,37107,Ciudad Rodrigo,14502,-72,-39,-33,45,21,24,-27,-12,-31,-15,11,7,-13,-16,-9,-11,5,8,-14,4,-22,-4,6,-1,10,9,6,5,12,3,6,3,3,1,6,2,4,6,3,4,6,1,-6,4,-10,53,31,22,1,-13,5,6,1,-5,-9,-2,9,7,-1,1,10,-11,-4,-1,2,-6,15,8,19,9,1,1,7,6,12,5,1,0,8,2,7,4,0,1,-117,-66,-51,31,19,12,-9,-29,-64,-34,-5,31,-8,-16,-35,-13,-6,17,-1,-13,-29,-21,1,14,5,11,4,7,3,1,4,2,5,7,0,1,1,9,-1,0,3,0,25,25,0,83,46,37,2,8,5,-12,20,7,2,2,7,3,15,0,0,6,-2,-15,5,7,13,16,24,16,9,5,5,8,13,11,5,4,8,8,11,5,4,1,-29,-13,-16,74,33,41,6,-17,-36,1,17,0,8,-8,-24,-2,14,-2,-2,-9,-12,3,3,2,14,13,24,15,6,1,6,6,8,9,2,1,8,7,16,6,4,0,-10,-16,6,57,26,31,-6,-24,-19,-2,9,31,-19,-7,-8,-1,9,12,13,-17,-11,-1,0,19,9,9,20,11,7,2,0,1,11,9,5,1,9,8,9,2,2,1,-77,-36,-41,80,39,41,-5,-24,-57,12,3,-5,-7,-6,-38,10,4,2,2,-18,-19,2,-1,-7,12,13,14,23,11,4,4,5,8,11,7,3,8,8,6,12,4,1,113,75,38,163,91,72,24,20,-1,27,21,23,7,21,8,11,14,14,17,-1,-9,16,7,9,25,39,48,33,13,3,10,20,33,20,7,1,15,19,15,13,6,2,80,53,27,79,43,36,9,-3,13,43,13,11,16,3,-1,19,4,13,-7,-6,14,24,9,-2,13,14,29,17,5,0,5,7,15,10,5,1,8,7,14,7,0,-1,-79,-43,-36,-5,-11,6,12,-5,-67,-25,11,2,9,0,-42,-14,6,2,3,-5,-25,-11,5,0,11,14,-25,2,-5,-2,6,6,-18,0,-2,-3,5,8,-7,2,-3,1,18,26,-8,30,24,6,7,20,-26,-21,18,14,13,3,0,-11,14,3,-6,17,-26,-10,4,11,5,11,4,3,4,1,8,4,4,4,4,-2,-3,7,0,-1,0,3,-45,-52,7,-40,-25,-15,-3,-16,-17,-10,10,-5,-11,-8,-18,-12,2,-2,8,-8,1,2,8,-3,-8,-1,-22,-6,-4,0,-5,-4,-8,-4,-3,-1,-3,3,-14,-2,-1,1,-41,-17,-24,-19,-14,-5,7,-13,-24,-2,-14,3,10,-10,-12,7,-12,0,-3,-3,-12,-9,-2,3,3,4,-7,-15,-5,0,4,2,-5,-11,-3,-1,-1,2,-2,-4,-2,1,-136,-77,-59,-45,-33,-12,-10,-25,-52,-38,-13,0,-7,-15,-32,-18,-9,6,-3,-10,-20,-20,-4,-6,-6,-3,-9,-20,-6,-2,-5,-3,-8,-12,-4,-2,-1,0,-1,-8,-2,0,-94,-48,-46,-10,-4,-6,16,-19,-66,-15,4,-6,9,-14,-34,-8,6,-3,7,-5,-32,-7,-2,-3,9,-4,-4,-8,0,-3,3,-4,-2,-5,4,0,6,0,-2,-3,-4,-3,-51,-4,-47,18,16,2,-3,-19,-38,-2,-4,18,10,-12,-19,10,-4,13,-13,-7,-19,-12,0,5,2,3,5,1,3,4,2,0,8,4,1,1,0,3,-3,-3,2,3,-77,-60,-17,-22,-20,-2,-7,-27,-27,-10,-8,-2,-15,-8,-21,-13,-5,-1,8,-19,-6,3,-3,-1,-2,-3,-3,-8,-6,0,-4,0,-1,-10,-4,-1,2,-3,-2,2,-2,1,-114,-66,-48,-56,-41,-15,-1,-23,-53,-42,1,10,-4,-13,-31,-32,-1,15,3,-10,-22,-10,2,-5,0,-5,-17,-25,-8,0,-1,-2,-12,-21,-6,1,1,-3,-5,-4,-2,-1
37,37274,Salamanca,158720,-1301,-802,-499,92,40,52,-35,-250,-685,-163,-99,-38,-59,-127,-391,-114,-52,-27,24,-123,-294,-49,-47,-11,15,13,15,18,17,13,7,8,8,8,4,5,8,5,7,10,13,8,-2516,-1317,-1199,20,10,10,-182,-500,-996,-450,-226,-150,-123,-228,-540,-248,-117,-57,-59,-272,-456,-202,-109,-93,5,3,4,1,3,3,3,0,2,1,1,2,2,3,2,0,2,1,-1154,-652,-502,-16,-6,-10,100,-208,-714,-179,-117,-9,57,-85,-458,-102,-57,7,43,-123,-256,-77,-60,-16,23,-16,-63,8,16,13,11,-1,-32,7,5,4,12,-15,-31,1,11,9,-2055,-1200,-855,113,44,69,-144,-430,-801,-338,-195,-107,-102,-213,-450,-216,-136,-60,-42,-217,-351,-122,-59,-47,28,21,20,21,14,8,14,5,7,9,4,5,14,16,13,12,10,3,-303,-184,-119,1544,782,762,59,126,-411,-50,-42,25,42,28,-193,-28,-36,16,17,98,-218,-22,-6,9,212,455,518,246,78,24,112,197,288,133,36,11,100,258,230,113,42,13,-742,-541,-201,1292,581,711,-11,31,-681,-57,-40,48,2,-11,-435,-58,-25,2,-13,42,-246,1,-15,46,204,383,384,201,79,28,102,157,177,92,37,11,102,226,207,109,42,17,-1165,-812,-353,1458,655,803,-71,-28,-830,-165,-66,15,-49,-83,-521,-114,-41,3,-22,55,-309,-51,-25,12,243,357,419,276,105,39,116,144,191,125,51,18,127,213,228,151,54,21,-206,-239,33,1645,783,862,183,202,-544,-53,-39,84,70,97,-312,-54,-51,32,113,105,-232,1,12,52,261,487,520,242,95,32,128,222,268,110,36,16,133,265,252,132,59,16,141,8,133,1406,685,721,158,262,-174,-76,-48,46,117,75,-105,-63,-36,40,41,187,-69,-13,-12,6,230,448,492,182,41,6,138,186,247,88,17,6,92,262,245,94,24,0,-1202,-787,-415,63,-53,116,52,-83,-751,-334,-138,86,54,-81,-446,-236,-94,39,-2,-2,-305,-98,-44,47,117,103,-91,-62,-11,0,62,11,-60,-62,-4,-4,55,92,-31,0,-7,4,-498,-337,-161,390,172,218,150,89,-240,-237,-231,-33,37,93,-191,-158,-123,4,113,-4,-49,-79,-108,-37,97,237,42,-13,0,14,51,152,-14,-24,-7,8,46,85,56,11,7,6,-742,-462,-280,290,134,156,37,-71,-528,-120,-77,64,11,-48,-294,-90,-39,21,26,-23,-234,-30,-38,43,88,127,34,12,9,16,38,51,12,16,9,6,50,76,22,-4,0,10,-726,-472,-254,183,79,104,2,41,-535,-189,-39,15,-29,31,-307,-118,-63,15,31,10,-228,-71,24,0,50,166,-47,-12,9,14,23,101,-29,-26,2,5,27,65,-18,14,7,9,-872,-623,-249,-40,-120,80,-116,-52,-367,-189,-83,-44,-54,-48,-289,-134,-71,-17,-62,-4,-78,-55,-12,-27,1,24,-32,-46,6,1,5,-39,-54,-42,6,1,-4,63,22,-4,0,0,-868,-628,-240,-85,-97,12,-56,-165,-413,-189,-20,-17,-36,-144,-268,-146,-22,-5,-20,-21,-145,-43,2,-12,38,-13,-49,-62,-3,-2,28,-36,-30,-51,-4,-5,10,23,-19,-11,1,3,-639,-505,-134,89,-8,97,-14,-17,-511,-181,-2,82,-8,-67,-265,-171,-11,17,-6,50,-246,-10,9,65,70,104,-55,-44,3,9,31,3,-10,-38,-1,6,39,101,-45,-6,4,3,132,-50,182,204,43,161,84,90,-194,-112,109,124,28,6,-147,-62,10,91,56,84,-47,-50,99,33,70,97,68,-51,7,1,37,14,14,-23,-14,8,33,83,54,-28,21,-7,568,32,536,763,275,488,165,287,-47,-25,56,129,99,106,-143,-33,-31,33,66,181,96,8,87,96,159,239,248,64,14,26,83,85,88,8,0,6,76,154,160,56,14,20
37,37322,Terradillos,3037,-19,-10,-9,7,6,1,-19,11,-15,-17,14,2,-11,1,5,-14,6,1,-8,10,-20,-3,8,1,2,1,3,1,0,0,2,0,3,1,0,0,0,1,0,0,0,0,76,29,47,23,12,11,8,12,40,1,5,8,-2,1,26,-1,2,2,10,11,14,2,3,6,5,4,8,4,0,1,1,3,5,2,0,0,4,1,3,2,0,1,41,21,20,7,8,-1,7,-1,24,-12,18,5,3,0,18,-8,8,1,4,-1,6,-4,10,4,3,2,-1,3,0,0,3,3,0,2,0,0,0,-1,-1,1,0,0,28,9,19,11,7,4,22,0,-4,16,2,-6,15,-7,-6,9,-1,1,7,7,2,7,3,-7,1,1,4,2,3,0,0,2,1,1,3,0,1,-1,3,1,0,0,11,18,-7,32,12,20,-1,12,11,-18,8,3,-3,12,6,-10,9,3,2,0,5,-8,-1,0,7,10,9,2,1,3,2,6,2,-1,1,2,5,4,7,3,0,1,73,37,36,44,25,19,19,19,-3,14,16,3,7,8,-6,20,4,3,12,11,3,-6,12,0,15,9,10,3,6,1,8,6,7,2,2,0,7,3,3,1,4,1,87,44,43,41,24,17,20,14,46,3,10,-3,9,6,29,2,3,-2,11,8,17,1,7,-1,7,12,13,5,4,1,2,8,7,4,3,1,5,4,6,1,1,0,-6,-5,-1,55,28,27,-5,-2,23,-13,-1,-8,-4,-3,11,-6,-1,-3,-1,1,12,-7,0,-5,12,11,23,5,4,-1,5,4,12,4,2,0,7,7,11,1,2,-1,-6,-8,2,54,24,30,16,-2,-10,-2,-8,3,5,0,-3,-7,-2,1,11,-2,-7,5,-6,2,18,8,13,13,2,-1,8,4,7,6,0,-1,10,4,6,7,2,0,12,0,12,42,23,19,-7,17,-14,5,13,-3,-9,11,-5,-1,4,2,2,6,-9,6,9,-5,12,6,10,9,4,1,6,6,6,4,0,1,6,0,4,5,4,0,-51,-21,-30,19,14,5,-20,-17,-5,-1,-9,0,-9,-13,-4,3,0,2,-11,-4,-1,-4,-9,-2,3,4,5,6,0,1,2,2,4,5,0,1,1,2,1,1,0,0,-53,-17,-36,10,5,5,-20,-8,-8,-7,-4,-8,-8,-2,0,-3,-2,-3,-12,-6,-8,-4,-2,-5,1,0,5,2,1,0,1,-1,3,1,1,0,0,1,2,1,0,0,-50,-23,-27,-2,-1,-1,-12,-22,-7,-9,2,0,-9,-15,1,-1,0,2,-3,-7,-8,-8,2,-2,-2,-2,-2,1,1,2,-1,-1,-1,1,0,1,-1,-1,-1,0,1,1,-107,-83,-24,-18,-15,-3,-24,-8,-31,-32,-11,-3,-18,-9,-24,-24,-10,0,-6,1,-7,-8,-1,-3,-1,0,-5,-11,-1,0,1,0,-6,-10,0,0,-2,0,1,-1,-1,0,-73,-30,-43,-18,-10,-8,-23,-15,-15,-13,-2,-5,-7,-10,-1,-6,-4,-3,-16,-5,-14,-7,2,-2,-6,1,-5,-2,-3,-3,-3,2,-1,-1,-5,-2,-3,-1,-4,-1,2,-1,-51,-23,-28,-13,-9,-4,-9,4,-28,-1,-12,-6,-9,7,-12,0,-8,-3,0,-3,-16,-1,-4,-3,-2,-1,-9,0,-1,0,0,0,-6,-2,-1,0,-2,-1,-3,2,0,0,-39,-28,-11,3,1,2,-4,-7,-9,-16,-4,1,-3,-1,-6,-11,-5,-2,-1,-6,-3,-5,1,3,-1,5,1,2,-4,0,0,5,-1,0,-3,0,-1,0,2,2,-1,0,4,-7,11,10,4,6,-1,2,-5,9,2,-5,-4,2,-6,6,0,-4,3,0,1,3,2,-1,-1,4,4,2,1,0,-2,4,1,1,0,0,1,0,3,1,1,0
37,37354,Villamayor,2765,208,109,99,16,2,14,42,20,77,35,22,11,29,7,39,18,11,4,13,13,38,17,11,7,2,1,10,0,2,0,0,1,1,0,0,0,2,0,9,0,2,0,285,150,135,13,4,9,59,29,89,66,19,21,38,13,43,36,6,13,21,16,46,30,13,8,4,2,4,1,0,1,2,1,0,0,0,0,2,1,4,1,0,1,269,139,130,6,2,4,44,39,103,57,17,6,29,29,47,24,11,1,15,10,56,33,6,5,-1,4,2,0,1,0,0,1,0,0,1,0,-1,3,2,0,0,0,286,144,142,8,4,4,55,37,95,64,22,11,34,14,37,38,15,4,21,23,58,26,7,7,2,0,2,2,2,0,2,0,0,1,1,0,0,0,2,1,1,0,546,275,271,64,48,16,72,95,222,100,46,13,33,47,121,47,24,5,39,48,101,53,22,8,4,17,35,5,2,1,2,10,30,4,1,1,2,7,5,1,1,0,474,238,236,46,24,22,113,57,144,122,29,5,47,25,83,54,22,4,66,32,61,68,7,1,7,6,15,11,7,0,1,4,8,5,6,0,6,2,7,6,1,0,373,196,177,77,50,27,77,56,136,65,26,10,40,25,72,37,15,4,37,31,64,28,11,6,16,14,24,16,6,1,5,8,20,13,4,0,11,6,4,3,2,1,171,50,121,32,19,13,46,23,46,45,3,6,13,8,7,17,-1,3,33,15,39,28,4,3,4,5,13,8,2,-1,2,3,6,6,1,0,2,2,7,2,1,-1,140,68,72,56,26,30,-8,28,63,27,22,8,-10,14,29,21,9,7,2,14,34,6,13,1,1,14,27,14,0,0,0,9,10,8,-1,0,1,5,17,6,1,0,131,77,54,15,6,9,27,14,28,33,21,8,17,9,16,16,17,3,10,5,12,17,4,5,5,3,2,4,0,2,4,1,-2,1,0,2,1,2,4,3,0,0,96,38,58,16,4,12,35,18,33,4,2,9,20,13,10,1,-4,2,15,5,23,3,6,7,2,7,6,-3,2,0,-1,3,1,-2,1,0,3,4,5,-1,1,0,55,30,25,1,1,0,16,2,26,-9,9,13,6,0,17,1,2,5,10,2,9,-10,7,8,0,3,3,-5,0,0,0,1,1,-1,0,0,0,2,2,-4,0,0,114,46,68,8,0,8,24,25,7,39,3,15,15,15,0,13,4,1,9,10,7,26,-1,14,1,3,1,1,2,0,0,2,-1,-1,0,0,1,1,2,2,2,0,75,26,49,8,4,4,15,-15,56,6,9,4,10,-11,13,2,11,1,5,-4,43,4,-2,3,2,-1,6,3,-2,0,0,0,4,1,-1,0,2,-1,2,2,-1,0,-58,-34,-24,-33,-21,-12,-8,-13,-23,-24,0,12,-5,-1,-10,-23,4,3,-3,-12,-13,-1,-4,9,1,-4,-13,-12,-3,-2,1,-4,-6,-9,-1,-2,0,0,-7,-3,-2,0,55,41,14,-2,1,-3,23,1,19,7,1,8,6,4,10,14,0,8,17,-3,9,-7,1,0,2,1,-4,-1,0,0,2,0,-2,2,-1,0,0,1,-2,-3,1,0,31,10,21,-1,-3,2,7,2,14,1,5,0,13,-1,9,-4,-3,-4,-6,3,5,5,8,4,-5,3,0,1,-3,3,-2,-1,2,0,-4,2,-3,4,-2,1,1,1,65,29,36,13,6,7,13,-10,16,24,9,20,1,-10,3,10,15,11,12,0,13,14,-6,9,3,1,3,4,2,0,1,1,1,1,2,0,2,0,2,3,0,0
38,38001,Adeje,13605,666,337,329,90,53,37,24,296,217,100,20,8,12,131,126,53,12,4,12,165,91,47,8,4,6,17,25,30,10,1,3,7,15,16,10,1,3,10,10,14,0,0,1709,894,815,874,484,390,200,432,593,320,112,41,88,208,320,194,64,18,112,224,273,126,48,23,142,144,245,194,105,35,72,73,145,118,54,20,70,71,100,76,51,15,2216,1250,966,1565,848,717,337,533,575,416,275,61,205,302,319,219,155,43,132,231,256,197,120,18,234,296,434,290,251,51,132,157,235,147,138,34,102,139,199,143,113,17,2340,1197,1143,1623,840,783,428,412,685,452,277,72,216,215,344,226,155,36,212,197,341,226,122,36,276,261,423,359,232,62,133,126,229,189,129,28,143,135,194,170,103,34,3017,1645,1372,2466,1341,1125,369,681,806,581,443,131,186,337,474,322,239,77,183,344,332,259,204,54,285,512,678,486,368,125,151,266,379,267,199,72,134,246,299,219,169,53,2745,1392,1353,2283,1182,1101,306,705,650,461,472,131,166,373,331,220,233,64,140,332,319,241,239,67,272,489,541,423,414,123,145,234,283,229,217,65,127,255,258,194,197,58,2857,1365,1492,2346,1173,1173,313,620,713,538,450,206,138,269,336,275,224,111,175,351,377,263,226,95,254,443,588,472,399,179,118,198,301,243,206,104,136,245,287,229,193,75,2584,1305,1279,2566,1309,1257,252,580,680,502,410,144,143,262,387,234,190,89,109,318,293,268,220,55,307,508,647,506,426,156,157,230,350,254,220,92,150,278,297,252,206,64,1729,877,852,1592,799,793,225,426,495,199,304,74,143,203,245,95,144,44,82,223,250,104,160,30,192,346,447,258,265,65,94,161,227,138,133,38,98,185,220,120,132,27,311,148,163,592,294,298,15,173,5,41,78,-29,13,83,-1,0,50,-11,2,90,6,41,28,-18,89,143,105,141,91,0,67,44,34,75,58,2,22,99,71,66,33,-2,1155,572,583,916,439,477,169,256,355,220,120,17,71,89,193,137,69,3,98,167,162,83,51,14,169,178,243,202,102,3,84,61,127,108,52,-5,85,117,116,94,50,8,1595,777,818,1060,520,540,205,349,463,320,148,81,94,137,238,171,88,38,111,212,225,149,60,43,164,210,250,196,161,59,75,80,112,110,93,37,89,130,138,86,68,22,2063,1012,1051,1652,782,870,182,500,559,391,334,89,93,199,275,239,153,48,89,301,284,152,181,41,170,373,382,311,294,107,90,127,165,175,149,64,80,246,217,136,145,43,2237,1077,1160,1883,929,954,285,528,641,483,254,40,142,223,333,252,115,7,143,305,308,231,139,33,208,407,553,412,241,42,105,172,289,219,109,24,103,235,264,193,132,18,2161,1099,1062,1890,940,950,247,465,711,432,284,-13,149,199,372,226,134,-8,98,266,339,206,150,-5,260,389,547,459,233,-24,135,156,280,245,114,-6,125,233,267,214,119,-18,-5879,-3149,-2730,-5699,-3008,-2691,-228,-143,-802,-1693,-1473,-1556,-108,-92,-368,-902,-840,-843,-120,-51,-434,-791,-633,-713,-174,-183,-770,-1655,-1413,-1525,-66,-110,-356,-860,-803,-824,-108,-73,-414,-795,-610,-701,1476,735,741,1818,924,894,150,424,425,208,163,96,69,185,238,85,91,59,81,239,187,123,72,37,215,372,514,339,244,120,102,168,279,174,124,67,113,204,235,165,120,53,-627,-317,-310,-17,-68,51,90,241,-73,-421,-232,-260,62,149,11,-279,-114,-156,28,92,-84,-142,-118,-104,179,230,72,-199,-133,-195,96,119,36,-152,-65,-113,83,111,36,-47,-68,-82
38,38002,Agulo,1100,7,-2,9,9,5,4,-2,1,-6,5,7,2,-1,-3,-4,2,4,1,-1,4,-2,3,3,1,1,2,2,3,1,0,1,0,2,2,0,0,0,2,0,1,1,0,-1,8,-9,15,10,5,-3,0,-1,-5,5,2,2,-1,-1,0,4,3,-5,1,0,-5,1,-1,2,2,4,0,5,2,2,1,2,0,3,2,0,1,2,0,2,0,100,48,52,9,4,5,5,17,11,22,24,20,1,8,8,12,9,9,4,9,3,10,15,11,2,1,3,1,1,1,0,1,2,0,1,0,2,0,1,1,0,1,45,22,23,21,11,10,9,2,-3,5,23,5,1,2,0,4,8,5,8,0,-3,1,15,0,4,1,1,8,5,2,3,1,0,4,2,1,1,0,1,4,3,1,0,-2,2,10,5,5,-2,-5,-2,0,11,-5,-2,-1,-1,-5,6,-1,0,-4,-1,5,5,-4,1,1,2,1,4,1,1,1,1,-1,3,0,0,0,1,2,1,1,-4,0,-4,7,6,1,-1,3,-10,-2,1,6,-2,0,-2,2,-2,5,1,3,-8,-4,3,1,2,0,1,2,-1,3,1,0,0,2,0,3,1,0,1,0,-1,0,21,6,15,9,5,4,-9,3,-6,0,23,8,-8,0,-3,-3,15,4,-1,3,-3,3,8,4,0,0,1,0,5,3,0,0,0,0,3,2,0,0,1,0,2,1,9,9,0,3,0,3,2,4,-6,7,0,5,4,2,-4,4,-1,4,-2,2,-2,3,1,1,1,0,1,0,2,-1,0,0,0,0,1,-1,1,0,1,0,1,0,-4,5,-9,3,5,-2,-1,2,-2,8,0,-11,-2,4,-1,8,2,-6,1,-2,-1,0,-2,-5,-1,1,1,4,-1,-1,0,1,1,2,1,0,-1,0,0,2,-2,-1,-18,-5,-13,3,1,2,-6,1,-8,3,3,-11,-4,1,-3,5,2,-6,-2,0,-5,-2,1,-5,1,1,0,2,-1,0,2,0,-1,3,-3,0,-1,1,1,-1,2,0,28,18,10,5,3,2,10,3,5,5,6,1,7,3,5,0,3,0,3,0,0,5,3,1,4,0,2,1,-1,-1,3,0,1,0,0,-1,1,0,1,1,-1,0,-8,-1,-7,2,1,1,5,-4,-6,2,-5,1,2,0,-2,1,-2,1,3,-4,-4,1,-3,0,0,1,0,0,0,1,0,0,0,0,1,0,0,1,0,0,-1,1,-21,-11,-10,5,4,1,-6,0,-3,-2,-8,-3,-1,-2,-3,1,-2,-4,-5,2,0,-3,-6,1,2,0,1,1,2,-1,2,0,1,1,1,-1,0,0,0,0,1,0,-3,-6,3,6,0,6,0,-2,-3,4,5,-7,-1,-2,-2,1,2,-4,1,0,-1,3,3,-3,2,0,0,1,3,0,0,0,0,0,1,-1,2,0,0,1,2,1,20,16,4,5,3,2,5,-2,11,6,1,-3,4,-1,7,6,0,-1,1,-1,4,0,1,-2,3,-1,1,2,0,-1,2,-1,1,1,0,-1,1,0,0,1,0,0,10,7,3,2,1,1,-2,5,-2,7,10,-8,-3,3,1,5,4,-3,1,2,-3,2,6,-5,0,-1,0,2,1,0,0,-1,0,1,2,-1,0,0,0,1,-1,1,10,-3,13,6,-1,7,-2,2,-1,11,2,-1,-4,-1,-1,3,3,-2,2,3,0,8,-1,1,0,-1,0,3,3,1,-1,0,-1,1,0,0,1,-1,1,2,3,1,9,12,-3,20,9,11,-5,5,2,4,0,4,-3,3,4,4,0,4,-2,2,-2,0,0,0,2,3,3,3,4,5,0,1,1,1,2,4,2,2,2,2,2,1
38,38003,Alajeró,1267,39,24,15,14,3,11,4,7,19,6,3,1,3,4,10,7,1,0,1,3,9,-1,2,1,3,5,1,4,1,0,1,1,0,1,0,0,2,4,1,3,1,0,115,58,57,27,14,13,7,19,35,23,19,12,5,8,18,15,7,5,2,11,17,8,12,7,7,1,5,8,5,1,4,0,3,4,3,0,3,1,2,4,2,1,194,103,91,57,25,32,28,35,36,49,30,15,14,20,22,21,13,12,14,15,14,28,17,3,13,6,8,16,10,4,5,2,2,7,6,3,8,4,6,9,4,1,178,101,77,45,26,19,10,28,35,41,47,18,2,19,23,23,23,11,8,9,12,18,24,7,11,2,7,10,12,3,6,2,3,8,5,2,5,0,4,2,7,1,21,17,4,36,14,22,11,-3,11,11,-3,-3,13,-1,2,4,2,-2,-2,-2,9,7,-5,-1,3,4,8,9,7,5,1,1,1,5,5,1,2,3,7,4,2,4,82,60,22,45,31,14,15,23,10,17,15,-2,11,10,12,14,16,-3,4,13,-2,3,-1,1,7,7,14,10,6,0,5,4,10,6,6,0,2,3,4,4,0,0,112,82,30,65,36,29,1,11,20,36,20,22,7,7,19,35,6,8,-6,4,1,1,14,14,5,3,16,20,11,8,3,1,11,16,3,2,2,2,5,4,8,6,29,5,24,69,58,11,12,9,2,0,20,-15,0,7,-2,-7,13,-6,12,2,4,7,7,-9,8,14,18,21,10,-2,5,14,15,17,8,-1,3,0,3,4,2,-1,-13,-13,0,32,15,17,-2,9,4,-22,-3,-1,-4,4,5,-14,-3,-4,2,5,-1,-8,0,3,6,6,11,3,2,4,1,1,7,2,3,1,5,5,4,1,-1,3,-29,-26,-3,28,9,19,13,-9,-7,-10,-15,-2,8,-6,-8,-5,-14,-2,5,-3,1,-5,-1,0,4,3,2,4,7,5,1,1,0,1,2,2,3,2,2,3,5,3,-38,-13,-25,5,0,5,-5,-3,-17,-4,0,-6,-1,-2,-6,-2,2,-1,-4,-1,-11,-2,-2,-5,1,2,-2,-1,5,0,0,0,-1,-1,2,0,1,2,-1,0,3,0,44,18,26,17,8,9,11,7,13,5,7,1,1,4,6,2,5,0,10,3,7,3,2,1,7,4,4,0,0,1,4,2,0,0,0,2,3,2,4,0,0,-1,-7,-1,-6,24,11,13,-9,5,3,-12,-2,6,-6,5,0,-7,1,4,-3,0,3,-5,-3,2,2,2,5,2,4,9,0,0,3,1,2,5,2,2,2,1,2,4,-16,-8,-8,0,2,-2,2,-4,-12,4,-2,-4,4,0,-6,-2,-1,-2,-2,-4,-6,6,-1,-2,0,0,-2,1,0,1,1,0,0,1,0,0,-1,0,-2,0,0,1,20,7,13,8,5,3,1,1,5,8,0,4,2,-5,-1,5,3,3,-1,6,6,3,-3,1,-2,3,2,2,3,-1,0,0,1,1,3,0,-2,3,1,1,0,-1,-10,-1,-9,10,5,5,-2,5,-4,-21,11,3,1,-1,4,-14,6,3,-3,6,-8,-7,5,0,0,3,0,-1,7,1,0,0,0,0,3,2,0,3,0,-1,4,-1,26,19,7,13,8,5,-7,16,-1,5,15,0,-3,14,2,-2,8,1,-4,2,-3,7,7,-1,-2,3,2,3,3,4,0,2,2,1,1,2,-2,1,0,2,2,2,57,20,37,9,2,7,1,10,11,13,14,8,-7,2,3,7,8,7,8,8,8,6,6,1,0,2,4,3,0,0,-1,1,0,2,0,0,1,1,4,1,0,0
38,38004,Arafo,4669,28,13,15,19,11,8,3,0,21,11,-4,0,2,-4,15,5,-3,0,1,4,6,6,-1,0,4,1,8,3,2,1,1,1,5,2,1,1,3,0,3,1,1,0,79,39,40,31,10,21,22,13,15,8,16,5,13,9,6,2,7,3,9,4,9,6,9,2,15,1,6,3,3,3,6,1,2,1,0,0,9,0,4,2,3,3,36,38,-2,25,15,10,21,-11,26,-7,6,2,17,0,18,-5,9,0,4,-11,8,-2,-3,2,10,2,9,4,1,-1,5,2,6,1,1,0,5,0,3,3,0,-1,134,65,69,29,15,14,13,31,32,31,13,12,13,13,12,14,5,7,0,18,20,17,8,5,3,7,13,2,3,1,1,4,8,1,0,1,2,3,5,1,3,0,28,6,22,31,12,19,1,7,-6,19,2,5,-3,2,-4,11,0,0,4,5,-2,8,2,5,8,10,6,3,2,2,3,4,3,1,1,0,5,6,3,2,1,2,15,-9,24,33,16,17,8,-3,8,5,-5,0,-5,-3,-2,-1,1,0,13,0,10,6,-6,0,7,1,8,8,7,1,5,2,4,1,3,1,2,-1,4,7,4,0,79,38,41,16,6,10,9,9,27,27,10,-1,-3,6,16,13,8,-1,12,3,11,14,2,0,2,2,5,2,4,1,-1,1,2,1,2,1,3,1,3,1,2,0,-38,-11,-27,19,10,9,-26,1,13,-7,-10,-3,-16,0,17,-4,-7,2,-10,1,-4,-3,-3,-5,3,3,6,3,1,3,1,-1,4,3,1,2,2,4,2,0,0,1,80,44,36,15,4,11,29,1,37,20,-4,-2,18,5,10,9,2,1,11,-4,27,11,-6,-3,2,7,-2,3,7,-2,2,1,-2,0,5,-2,0,6,0,3,2,0,22,20,2,-8,1,-9,2,5,17,-7,-7,8,-5,8,18,-1,-5,4,7,-3,-1,-6,-2,4,3,1,-5,-8,0,1,3,0,0,-3,-1,2,0,1,-5,-5,1,-1,5,18,-13,13,9,4,-19,13,9,3,3,-9,-10,13,4,13,3,-7,-9,0,5,-10,0,-2,3,0,2,5,2,1,2,1,1,3,2,0,1,-1,1,2,0,1,10,-13,23,4,4,0,6,-10,7,11,-4,-4,-1,-9,-2,1,-2,-3,7,-1,9,10,-2,-1,1,-1,2,2,1,-1,-1,1,2,1,2,-1,2,-2,0,1,-1,0,26,15,11,2,0,2,3,11,1,6,6,-3,-2,5,8,1,6,-3,5,6,-7,5,0,0,0,1,-2,-1,4,0,0,0,-1,-1,2,0,0,1,-1,0,2,0,-1,5,-6,11,4,7,-12,-18,16,-6,17,1,-8,-8,11,-4,14,-1,-4,-10,5,-2,3,2,1,4,2,3,0,1,-1,2,1,1,0,1,2,2,1,2,0,0,46,28,18,7,4,3,16,0,27,8,-1,-9,23,3,11,0,-6,-3,-7,-3,16,8,5,-6,2,-1,4,1,1,-1,1,-1,3,0,1,0,1,0,1,1,0,-1,-17,-36,19,2,-4,6,-1,-9,-2,14,-13,-3,-10,-6,-1,-1,-14,-2,9,-3,-1,15,1,-1,0,0,2,-1,0,1,-1,-1,-1,-1,1,-1,1,1,3,0,-1,2,85,42,43,24,17,7,5,9,21,42,7,0,1,5,6,23,5,2,4,4,15,19,2,-2,1,2,0,10,9,2,3,1,1,4,6,2,-2,1,-1,6,3,0,51,10,41,31,20,11,27,-5,26,8,-2,-4,9,-3,9,8,-6,-6,18,-2,17,0,4,2,7,6,3,13,0,2,6,3,3,8,1,-1,1,3,0,5,-1,3
38,38005,Arico,5115,199,120,79,78,39,39,12,44,53,36,48,6,10,17,35,28,25,4,2,27,18,8,23,2,7,10,19,18,21,3,6,2,9,11,9,2,1,8,10,7,12,1,344,183,161,155,77,78,46,52,84,81,60,18,23,20,49,46,30,13,23,32,35,35,30,5,21,15,29,37,43,9,10,5,14,20,21,6,11,10,15,17,22,3,327,190,137,168,90,78,46,52,83,81,55,9,30,33,42,42,33,8,16,19,41,39,22,1,23,16,42,48,31,7,12,8,22,23,18,6,11,8,20,25,13,1,166,96,70,137,68,69,-2,30,24,47,52,10,0,12,20,26,33,6,-2,18,4,21,19,4,21,12,34,29,34,6,9,5,14,17,20,3,12,7,20,12,14,3,202,92,110,144,75,69,20,26,57,54,39,4,9,10,17,28,26,1,11,16,40,26,13,3,14,14,25,39,41,11,8,9,12,20,22,4,6,5,13,19,19,7,16,6,10,128,64,64,-30,2,-3,27,12,8,-21,1,-5,19,12,1,-9,1,2,8,0,7,22,13,28,34,16,12,12,9,10,19,7,5,10,4,18,15,9,7,275,133,142,207,97,110,14,32,68,89,57,15,11,6,37,46,26,6,3,26,31,43,31,9,14,34,46,71,29,10,6,16,20,35,12,6,8,18,26,36,17,4,134,67,67,180,84,96,-13,27,15,28,54,18,-8,14,8,11,29,10,-5,13,7,17,25,8,12,25,32,47,48,14,6,15,15,21,19,6,6,10,17,26,29,8,214,138,76,170,96,74,-12,39,55,62,40,24,-11,31,44,32,21,17,-1,8,11,30,19,7,12,30,41,47,27,11,8,16,22,31,10,9,4,14,19,16,17,2,72,46,26,64,25,39,4,-8,23,17,36,3,7,-12,22,13,15,0,-3,4,1,4,21,3,6,12,12,16,11,7,4,2,5,3,7,4,2,10,7,13,4,3,99,30,69,58,11,47,17,16,17,34,12,-1,-3,14,8,10,3,-3,20,2,9,24,9,2,3,13,10,28,6,-2,0,4,6,3,0,-2,3,9,4,25,6,0,202,110,92,89,42,47,23,28,41,41,49,18,18,13,22,19,31,8,5,15,19,22,18,10,5,7,13,22,32,10,3,4,6,8,17,5,2,3,7,14,15,5,154,115,39,101,76,25,22,38,61,22,3,-1,7,13,61,22,4,4,15,25,0,0,-1,-5,13,8,30,29,15,6,6,8,26,24,9,4,7,0,4,5,6,2,7,24,-17,71,44,27,-12,-4,-5,3,19,7,-10,5,-5,16,10,5,-2,-9,0,-13,9,2,5,9,15,20,20,1,2,4,11,15,10,2,3,5,4,5,10,-1,96,45,51,106,63,43,3,3,44,13,21,6,6,-6,13,15,12,5,-3,9,31,-2,9,1,17,8,30,21,23,2,11,3,15,16,14,3,6,5,15,5,9,-1,138,79,59,113,60,53,8,24,46,19,32,9,3,12,31,9,21,4,5,12,15,10,11,5,8,10,22,35,24,14,5,3,12,21,12,7,3,7,10,14,12,7,229,149,80,196,130,66,24,20,71,49,44,16,12,16,54,28,24,12,12,4,17,21,20,4,19,20,57,50,26,21,8,12,46,34,15,14,11,8,11,16,11,7,340,191,149,243,141,102,65,21,74,101,58,17,41,11,30,63,34,10,24,10,44,38,24,7,42,19,49,66,53,13,25,10,30,40,27,8,17,9,19,26,26,5
38,38006,Arona,29792,3634,2077,1557,2817,1625,1192,339,1037,1044,612,442,145,177,564,642,347,244,91,162,473,402,265,198,54,347,462,860,580,421,129,192,267,519,327,224,85,155,195,341,253,197,44,4193,2297,1896,3427,1885,1542,602,956,1227,775,484,129,316,460,729,453,250,79,286,496,498,322,234,50,528,578,1029,682,454,135,281,291,581,393,246,80,247,287,448,289,208,55,3731,2087,1644,3996,2165,1831,349,916,1090,666,553,156,181,464,662,396,289,90,168,452,428,270,264,66,540,755,1198,734,581,162,282,367,664,421,319,95,258,388,534,313,262,67,3905,2074,1831,3793,2026,1767,441,1047,962,651,566,202,224,524,529,360,312,108,217,523,433,291,254,94,517,653,1006,737,632,217,270,329,554,401,336,121,247,324,452,336,296,96,5103,2867,2236,4646,2500,2146,443,1226,1465,877,758,303,274,688,854,475,387,176,169,538,611,402,371,127,556,839,1325,855,749,291,295,453,743,454,379,163,261,386,582,401,370,128,4536,2423,2113,4453,2325,2128,450,1085,1031,820,796,310,226,541,627,438,384,180,224,544,404,382,412,130,543,830,1124,835,780,287,272,411,632,434,387,161,271,419,492,401,393,126,4081,2064,2017,4409,2236,2173,464,960,748,823,757,299,269,455,396,383,382,159,195,505,352,440,375,140,651,798,1015,865,753,278,323,369,519,454,387,155,328,429,496,411,366,123,3560,1851,1709,4203,2132,2071,386,995,589,557,704,336,246,459,324,298,358,174,140,536,265,259,346,162,541,908,956,739,706,309,302,408,487,405,350,160,239,500,469,334,356,149,2484,1338,1146,3544,1907,1637,153,747,360,500,510,195,89,381,260,242,247,105,64,366,100,258,263,90,414,798,817,683,591,209,233,403,473,377,296,110,181,395,344,306,295,99,1030,361,669,2133,1051,1082,90,297,99,47,276,238,22,102,-5,3,136,112,68,195,104,44,140,126,225,419,502,406,354,217,118,187,246,211,182,102,107,232,256,195,172,115,1501,752,749,2134,1078,1056,216,348,181,255,299,202,151,177,73,115,128,105,65,171,108,140,171,97,266,374,465,441,394,175,148,163,247,228,183,98,118,211,218,213,211,77,2267,1238,1029,2320,1211,1109,270,445,445,567,374,188,144,187,250,334,196,128,126,258,195,233,178,60,273,394,518,534,419,163,160,170,249,302,218,98,113,224,269,232,201,65,2968,1501,1467,2816,1378,1438,304,572,633,598,603,234,179,235,332,317,299,126,125,337,301,281,304,108,288,486,629,607,549,226,147,203,311,318,266,114,141,283,318,289,283,112,2933,1464,1469,2410,1212,1198,279,582,840,617,398,188,134,255,436,327,207,88,145,327,404,290,191,100,281,423,595,510,410,171,145,175,289,286,216,89,136,248,306,224,194,82,2803,1522,1281,2805,1436,1369,262,706,661,617,345,205,150,331,376,360,182,119,112,375,285,257,163,86,306,556,666,644,423,191,162,244,332,365,226,96,144,312,334,279,197,95,2349,1211,1138,2847,1421,1426,172,621,637,530,311,48,65,322,294,322,176,15,107,299,343,208,135,33,331,604,759,639,391,99,154,296,360,341,203,52,177,308,399,298,188,47,3437,1884,1553,3741,2026,1715,427,901,868,624,371,231,239,522,497,349,157,118,188,379,371,275,214,113,485,830,948,770,477,206,287,483,487,408,233,112,198,347,461,362,244,94,2676,1317,1359,3489,1735,1754,305,544,839,489,311,182,131,258,442,272,106,100,174,286,397,217,205,82,487,596,987,710,473,208,245,268,491,388,216,113,242,328,496,322,257,95
38,38007,Barlovento,2403,32,21,11,47,24,23,2,5,4,10,8,3,3,4,6,3,3,2,-1,1,-2,7,5,1,5,8,8,11,9,6,1,7,3,5,4,4,4,1,5,6,5,2,5,7,-2,20,11,9,1,6,0,1,1,-4,1,4,1,1,2,-2,0,2,-1,0,-1,-2,3,4,4,6,1,2,1,2,3,4,0,1,2,2,1,2,1,1,9,-3,12,29,11,18,8,3,-4,2,4,-4,5,2,-5,-1,-1,-3,3,1,1,3,5,-1,8,6,2,3,10,0,5,4,-1,2,2,-1,3,2,3,1,8,1,24,10,14,36,19,17,6,4,8,-4,9,1,1,-1,5,-2,6,1,5,5,3,-2,3,0,9,10,10,1,5,1,4,4,5,1,4,1,5,6,5,0,1,0,-11,-5,-6,29,14,15,-6,0,-12,-2,7,2,0,-3,-7,-3,3,5,-6,3,-5,1,4,-3,6,6,2,9,3,3,3,1,1,4,2,3,3,5,1,5,1,0,-34,-19,-15,19,11,8,-11,-2,-12,1,-1,-7,-10,-1,-5,1,1,-4,-1,-1,-7,0,-2,-3,3,0,5,8,5,-2,0,0,2,8,1,0,3,0,3,0,4,-2,-5,7,-12,32,18,14,-1,-2,-13,7,5,-1,0,1,-6,8,3,1,-1,-3,-7,-1,2,-2,5,4,9,5,6,3,5,1,5,2,4,1,0,3,4,3,2,2,16,9,7,32,14,18,12,4,-5,-3,9,1,5,2,-4,-3,9,1,7,2,-1,0,0,0,7,3,4,9,4,3,2,2,2,3,4,1,5,1,2,6,0,2,-4,-18,14,33,8,25,16,-1,-1,-7,-4,-6,1,0,-4,-6,-3,-6,15,-1,3,-1,-1,0,11,5,7,4,3,3,1,0,2,2,3,0,10,5,5,2,0,3,-43,-13,-30,8,8,0,-9,-10,-22,-2,-3,2,-4,-1,-13,1,1,3,-5,-9,-9,-3,-4,-1,-3,2,1,1,3,4,1,1,-1,0,3,4,-4,1,2,1,0,0,-33,-25,-8,14,3,11,-5,-3,-6,-11,-3,-6,-5,-2,-4,-7,-4,-3,0,-1,-2,-4,1,-3,3,1,6,3,1,-1,0,0,3,2,0,-2,3,1,3,1,1,1,-13,2,-15,6,2,4,3,-3,-5,-4,-1,-5,3,-2,0,2,1,-4,0,-1,-5,-6,-2,-1,3,1,4,-2,0,-1,1,2,2,-2,0,-1,2,-1,2,0,0,0,4,-4,8,5,0,5,3,4,7,-1,-6,-3,2,-2,1,-1,-4,0,1,6,6,0,-2,-3,3,1,2,1,-2,0,2,-1,1,-2,0,0,1,2,1,3,-2,0,-29,-17,-12,3,1,2,-3,-2,-10,-3,-3,-7,-4,-1,-5,-2,-1,-3,1,-1,-5,-1,-2,-4,3,0,1,3,-3,-2,2,0,3,0,-3,-2,1,0,-2,3,0,0,-43,-27,-16,-10,-6,-4,0,-8,-23,-3,-2,-5,0,-4,-14,-6,-3,1,0,-4,-9,3,1,-6,1,-4,-1,0,-8,2,1,-1,-1,-2,-5,2,0,-3,0,2,-3,0,-2,5,-7,10,4,6,-1,-5,-1,-11,11,2,1,-1,1,-8,7,2,-2,-4,-2,-3,4,0,2,-2,3,0,4,-1,0,-1,1,-1,2,0,2,-1,2,1,2,-1,-15,3,-18,20,13,7,-2,5,-13,3,-8,-1,0,8,-4,2,-3,0,-2,-3,-9,1,-5,-1,1,6,4,4,2,3,1,5,2,2,1,2,0,1,2,2,1,1,20,10,10,45,22,23,8,5,0,2,3,2,3,3,-2,1,1,4,5,2,2,1,2,-2,9,6,6,10,5,9,5,2,3,6,0,6,4,4,3,4,5,3
38,38008,Breña Alta,5866,168,85,83,85,29,56,24,37,61,30,17,-4,15,14,33,12,11,0,9,23,28,18,6,-4,7,14,29,17,15,2,4,2,5,6,9,2,3,12,24,11,6,0,235,109,126,68,30,38,44,60,75,25,20,10,20,32,30,13,7,6,24,28,45,12,13,4,10,20,17,10,8,3,7,5,9,3,4,2,3,15,8,7,4,1,218,100,118,73,30,43,58,32,68,41,14,7,27,-1,38,25,8,4,31,33,30,16,6,3,22,11,24,8,3,5,9,2,9,6,2,2,13,9,15,2,1,3,290,138,152,120,55,65,43,33,106,51,33,13,21,5,60,27,18,3,22,28,46,24,15,10,18,17,37,17,21,6,8,4,19,10,10,3,10,13,18,7,11,3,163,91,72,66,30,36,31,16,50,32,27,7,22,15,21,12,16,3,9,1,29,20,11,4,17,6,18,8,16,1,9,2,9,2,8,0,8,4,9,6,8,1,154,47,107,95,39,56,25,30,46,24,27,0,10,10,9,7,10,3,15,20,37,17,17,-3,16,10,25,16,21,6,5,5,7,11,7,4,11,5,18,5,14,2,31,25,6,46,23,23,17,3,-18,13,10,6,10,-3,-10,13,12,2,7,6,-8,0,-2,4,11,0,6,13,13,4,5,0,2,7,7,2,6,0,4,6,6,2,39,44,-5,57,30,27,-13,18,7,12,6,9,-1,18,11,11,1,3,-12,0,-4,1,5,6,7,7,9,14,11,8,6,6,5,6,4,2,1,1,4,8,7,6,82,31,51,70,32,38,16,14,18,28,-3,10,10,3,2,12,-1,7,6,11,16,16,-2,3,13,7,19,16,6,8,6,0,10,8,3,4,7,7,9,8,3,4,-15,9,-24,19,9,10,-9,-3,-7,-3,-3,4,1,0,-13,12,1,2,-10,-3,6,-15,-4,2,1,3,6,7,1,0,1,2,3,0,2,0,0,1,3,7,-1,0,8,-4,12,25,7,18,-16,-1,6,-7,9,17,-16,0,5,-9,7,8,0,-1,1,2,2,9,7,9,1,5,3,0,4,2,1,1,-1,0,3,7,0,4,4,0,-16,-10,-6,15,1,14,-2,-2,-26,11,9,0,-7,1,-18,12,6,-2,5,-3,-8,-1,3,2,5,0,3,6,3,-2,0,-1,0,3,1,-2,5,1,3,3,2,0,131,75,56,21,11,10,25,10,63,21,1,9,24,3,34,8,0,4,1,7,29,13,1,5,1,3,2,5,5,5,1,1,2,1,1,5,0,2,0,4,4,0,0,17,-17,18,9,9,12,-1,-14,2,6,-3,13,2,-3,7,0,-5,-1,-3,-11,-5,6,2,11,2,0,0,6,-3,6,2,0,-2,3,-2,5,0,0,2,3,-1,-85,-32,-53,-26,-15,-11,-18,-26,-32,5,-15,1,-7,-14,-15,5,-2,-1,-11,-12,-17,0,-13,2,-5,-3,-2,-7,-6,-5,-4,-1,-1,-7,-1,-3,-1,-2,-1,0,-5,-2,-41,-23,-18,14,7,7,-19,-4,11,-29,-2,1,-16,4,7,-23,6,-1,-3,-8,4,-6,-8,2,0,3,10,5,-3,-1,0,2,4,4,0,-3,0,1,6,1,-3,2,23,2,21,31,17,14,-8,5,4,7,15,-1,1,3,-4,-6,3,1,-9,2,8,13,12,-2,0,3,7,6,10,4,-1,1,6,2,4,4,1,2,1,4,6,0,72,29,43,38,19,19,21,4,16,14,9,7,1,4,-2,15,8,4,20,0,18,-1,1,3,13,7,1,11,8,-3,6,3,-1,3,8,-1,7,4,2,8,0,-2
38,38009,Breña Baja,3737,55,29,26,3,2,1,15,20,-3,15,10,-2,7,17,-6,8,5,-2,8,3,3,7,5,0,0,1,0,0,2,0,0,1,0,0,1,0,0,0,0,0,1,0,23,31,-8,5,2,3,-1,11,4,7,5,-5,4,12,5,5,5,-1,-5,-1,-1,2,0,-4,1,0,2,0,1,1,1,0,0,0,1,0,0,0,2,0,0,1,68,38,30,-6,-3,-3,-5,3,35,15,10,4,-9,4,28,7,5,-1,4,-1,7,8,5,5,-1,-2,0,1,-2,-2,-1,-2,0,1,0,-1,0,0,0,0,-2,-1,72,19,53,4,1,3,23,4,27,3,3,9,10,-5,15,-3,0,0,13,9,12,6,3,9,2,0,-1,3,0,0,1,-1,0,1,0,0,1,1,-1,2,0,0,169,75,94,59,29,30,30,28,57,17,20,11,9,11,33,8,6,5,21,17,24,9,14,6,14,9,12,9,15,0,7,4,4,6,8,0,7,5,8,3,7,0,64,50,14,38,14,24,0,12,33,10,0,6,5,8,18,8,1,6,-5,4,15,2,-1,0,4,9,7,9,6,3,2,2,1,4,3,2,2,7,6,5,3,1,183,121,62,54,22,32,24,56,41,35,27,-2,14,42,18,30,13,3,10,14,23,5,14,-5,15,7,12,7,8,4,6,4,2,4,3,2,9,3,10,3,5,2,208,101,107,70,30,40,42,14,82,33,24,10,29,-1,39,14,11,7,13,15,43,19,13,3,11,9,9,13,20,8,5,4,2,4,11,4,6,5,7,9,9,4,170,79,91,61,27,34,29,28,59,20,33,-1,20,16,17,4,20,0,9,12,42,16,13,-1,11,9,7,11,20,3,8,2,2,3,9,3,3,7,5,8,11,0,149,85,64,54,21,33,18,58,35,18,18,4,9,48,13,9,8,0,9,10,22,9,10,4,7,5,9,11,19,1,1,3,4,5,6,1,6,2,5,6,13,0,69,3,66,42,18,24,21,-21,1,40,20,1,16,-34,-13,23,7,-1,5,13,14,17,13,2,7,9,2,9,10,4,5,5,4,-1,3,1,2,4,-2,10,7,3,157,75,82,48,21,27,14,11,84,30,8,4,13,3,29,14,8,2,1,8,55,16,0,2,6,7,12,11,1,10,1,3,6,4,2,4,5,4,6,7,-1,6,15,11,4,53,30,23,-26,-10,-10,23,17,23,-16,-8,-6,22,9,11,-10,-2,-4,1,8,12,7,3,5,13,7,18,7,0,2,8,4,9,0,3,3,5,3,9,-12,-19,7,28,11,17,-17,-2,2,-4,-5,8,-18,-8,2,-1,2,2,1,6,0,-3,-7,6,4,2,9,3,2,7,2,-1,1,1,3,4,2,3,8,2,-1,3,-92,-70,-22,-125,-68,-57,10,-8,7,-38,-30,-39,9,-12,2,-26,-23,-19,1,4,5,-12,-7,-20,-6,-8,-19,-18,-26,-48,0,-8,-9,-16,-13,-22,-6,0,-10,-2,-13,-26,62,21,41,43,17,26,11,4,6,32,2,5,2,8,4,17,-9,0,9,-4,2,15,11,5,5,2,11,12,6,7,2,1,5,5,3,1,3,1,6,7,3,6,86,52,34,31,13,18,4,13,40,8,8,9,7,7,17,11,9,1,-3,6,23,-3,-1,8,0,8,5,3,8,7,-1,1,2,2,6,3,1,7,3,1,2,4,-42,12,-54,-57,-23,-34,-21,-7,6,-19,8,-15,-6,3,-4,2,16,-2,-15,-10,10,-21,-8,-13,2,3,-10,-14,-14,-23,-1,5,-6,-7,-4,-9,3,-2,-4,-7,-10,-14
38,38010,Buenavista del Norte,5469,-37,-19,-18,9,5,4,-3,-12,-18,-4,1,0,-1,-5,-11,0,-2,0,-2,-7,-7,-4,3,0,0,1,1,3,2,2,0,1,0,2,1,1,0,0,1,1,1,1,11,8,3,13,5,8,4,-1,2,-2,2,5,3,0,0,-3,3,4,1,-1,2,1,-1,1,4,2,1,0,2,4,1,1,1,0,1,1,3,1,0,0,1,3,-4,-3,-1,-12,-3,-9,11,-10,4,5,-9,-7,5,-7,3,2,-4,-3,6,-3,1,3,-5,-4,1,-6,-3,1,-3,-2,0,-3,1,0,0,-1,1,-3,-4,1,-3,-1,-75,-30,-45,12,5,7,-32,-5,-32,-6,4,-2,-22,7,-10,-5,-1,2,-10,-12,-22,-1,5,-4,6,1,1,2,1,1,4,-1,0,2,-1,1,2,2,1,0,2,0,13,5,8,58,31,27,12,10,-16,2,-2,5,10,9,-15,-3,2,1,2,1,-1,5,-4,4,14,10,8,11,6,7,9,6,3,5,3,4,5,4,5,6,3,3,-11,-13,2,36,16,20,6,-8,-18,-5,5,7,4,-12,-7,-7,2,4,2,4,-11,2,3,3,11,7,6,4,6,1,7,1,3,1,2,1,4,6,3,3,4,0,-7,-14,7,50,26,24,-10,8,-14,6,7,-5,-8,-3,-8,2,5,-2,-2,11,-6,4,2,-3,11,12,8,13,4,1,6,6,4,6,2,1,5,6,4,7,2,0,37,28,9,46,30,16,6,1,10,-1,18,2,7,6,3,2,8,3,-1,-5,7,-3,10,-1,19,2,14,-1,10,1,12,2,6,1,7,2,7,0,8,-2,3,-1,-13,5,-18,33,18,15,7,-10,-18,8,6,-6,1,0,-7,8,5,-1,6,-10,-11,0,1,-5,9,2,8,10,4,-1,4,3,2,6,4,-1,5,-1,6,4,0,0,-2,14,-16,7,7,0,-3,2,-10,7,0,3,0,-5,1,10,4,5,-3,7,-11,-3,-4,-2,0,-2,4,4,3,-1,4,-2,1,3,2,0,-4,0,3,1,1,-1,-15,-8,-7,9,5,4,7,12,-17,-9,1,-4,7,7,-8,-10,-3,1,0,5,-9,1,4,-5,4,0,0,1,4,0,3,4,0,-3,1,0,1,-4,0,4,3,0,-38,-16,-22,10,8,2,-10,5,-17,-3,-1,-11,-5,8,-10,-3,3,-7,-5,-3,-7,0,-4,-4,-1,6,3,2,2,-2,0,4,2,0,3,-1,-1,2,1,2,-1,-1,69,22,47,23,11,12,11,10,8,23,16,-2,7,-2,0,8,7,-1,4,12,8,15,9,-1,4,1,0,7,11,0,3,0,1,3,4,0,1,1,-1,4,7,0,42,6,36,-5,-6,1,-4,4,1,22,22,-4,-10,-3,4,12,7,-4,6,7,-3,10,15,0,-1,1,-3,2,1,-6,-1,0,-2,2,-1,-4,0,1,-1,0,2,-2,37,21,16,18,10,8,18,-2,11,-1,12,3,12,-2,3,-2,10,0,6,0,8,1,2,3,1,1,5,3,6,2,1,0,2,1,5,1,0,1,3,2,1,1,18,-2,20,16,5,11,2,1,2,14,-4,3,-3,-4,-4,9,-4,4,5,5,6,5,0,-1,2,3,2,1,3,5,1,1,0,1,-2,4,1,2,2,0,5,1,4,-7,11,27,9,18,3,-1,1,-5,5,-2,-3,2,1,-5,1,-3,6,-3,0,0,4,1,13,6,6,5,-3,-1,4,5,2,1,-1,-3,9,1,4,4,-2,2,13,22,-9,30,20,10,-10,14,0,-3,17,-4,-1,8,8,0,6,1,-9,6,-8,-3,11,-5,5,6,10,2,6,1,3,6,7,0,1,3,2,0,3,2,5,-2
38,38011,Candelaria,13356,260,127,133,128,68,60,-2,49,118,20,53,21,8,19,55,10,28,8,-10,30,63,10,25,13,21,24,28,34,15,6,12,16,12,15,10,3,9,8,16,19,5,3,926,474,452,191,94,97,124,125,317,204,100,50,73,59,163,107,51,19,51,66,154,97,49,31,44,25,49,41,16,14,24,11,25,20,10,4,20,14,24,21,6,10,1428,743,685,416,212,204,282,236,421,264,150,54,157,96,225,143,78,30,125,140,196,121,72,24,99,81,108,63,41,19,56,40,54,27,23,10,43,41,54,36,18,9,1491,725,766,527,259,268,280,242,398,309,140,106,143,110,210,146,60,48,137,132,188,163,80,58,94,108,148,98,46,30,51,53,79,48,16,12,43,55,69,50,30,18,1211,606,605,322,158,164,191,157,419,216,151,61,91,72,211,114,73,35,100,85,208,102,78,26,70,55,75,61,42,16,31,21,41,29,24,10,39,34,34,32,18,6,999,451,548,394,183,211,104,196,253,237,146,43,45,83,93,129,71,24,59,113,160,108,75,19,58,90,97,88,43,13,30,39,45,40,22,5,28,51,52,48,21,8,774,336,438,323,147,176,78,130,246,146,114,47,30,43,126,76,34,21,48,87,120,70,80,26,67,79,73,59,30,13,36,29,34,30,11,6,31,50,39,29,19,7,801,395,406,328,155,173,133,123,225,147,104,51,85,60,114,53,58,17,48,63,111,94,46,34,61,58,81,75,28,24,26,29,40,37,14,10,35,29,41,38,14,14,607,290,317,261,111,150,63,86,227,109,79,27,46,36,116,42,39,8,17,50,111,67,40,19,32,52,82,45,32,17,15,26,33,15,14,7,17,26,49,30,18,10,693,357,336,140,73,67,115,78,269,90,98,46,82,40,115,45,54,15,33,38,154,45,44,31,29,21,40,28,11,10,20,10,12,18,6,6,9,11,28,10,5,4,707,326,381,132,66,66,72,111,199,186,67,72,38,51,84,96,22,32,34,60,115,90,45,40,31,28,27,20,17,9,18,16,11,10,7,4,13,12,16,10,10,5,423,223,200,96,25,71,57,64,109,80,62,32,26,31,64,49,23,16,31,33,45,31,39,16,13,25,20,19,16,0,0,10,9,3,2,-1,13,15,11,16,14,1,188,59,129,29,18,11,16,21,59,16,42,32,2,19,14,1,12,13,14,2,45,15,30,19,7,1,-6,11,14,0,4,2,1,4,9,-3,3,-1,-7,7,5,3,242,117,125,87,38,49,30,46,48,26,54,32,17,11,15,12,38,27,13,35,33,14,16,5,11,19,14,14,18,11,3,7,5,4,8,11,8,12,9,10,10,0,141,43,98,47,16,31,42,32,84,-31,-5,17,22,-11,37,-20,-3,14,20,43,47,-11,-2,3,8,6,14,10,2,3,5,4,3,1,-5,6,3,2,11,9,7,-3,314,186,128,186,94,92,33,29,97,43,52,36,40,8,47,16,38,26,-7,21,50,27,14,10,34,22,35,50,27,13,27,9,14,23,13,5,7,13,21,27,14,8,415,179,236,244,116,128,89,28,69,114,68,41,14,13,26,80,28,15,75,15,43,34,40,26,54,32,34,50,39,31,18,20,16,27,15,18,36,12,18,23,24,13,493,224,269,308,143,165,62,47,84,107,100,80,34,22,31,50,44,41,28,25,53,57,56,39,56,45,66,53,46,37,33,22,30,22,15,19,23,23,36,31,31,18
38,38012,Fasnia,2496,51,31,20,11,7,4,16,3,21,5,6,-1,5,5,10,5,2,2,11,-2,11,0,4,-3,3,2,5,0,0,1,1,2,3,0,0,1,2,0,2,0,0,0,11,11,0,15,7,8,-2,3,-1,8,3,-1,-4,5,-1,6,4,0,2,-2,0,2,-1,-1,3,1,6,3,1,0,0,1,4,1,0,0,3,0,2,2,1,0,101,63,38,20,11,9,9,16,23,28,18,8,3,13,19,19,7,4,6,3,4,9,11,4,1,3,7,5,2,2,0,2,5,2,1,1,1,1,2,3,1,1,109,64,45,43,24,19,6,28,17,20,31,7,1,15,10,17,19,4,5,13,7,3,12,3,7,10,11,5,9,1,3,6,6,2,6,1,4,4,5,3,3,0,-22,-21,-1,18,11,7,-2,4,-9,-1,-7,-7,-6,-2,-8,-3,-1,-1,4,6,-1,2,-6,-6,3,6,1,1,7,0,2,4,1,0,4,0,1,2,0,1,3,0,53,33,20,34,23,11,-2,11,25,15,12,-7,2,2,13,11,7,-3,-4,9,12,4,5,-4,5,2,12,8,6,1,4,1,9,5,4,0,1,1,3,3,2,1,46,22,24,20,10,10,1,2,-3,18,22,5,0,-2,1,10,12,1,1,4,-4,8,10,4,7,1,6,4,1,1,4,0,3,1,1,1,3,1,3,3,0,0,113,59,54,14,8,6,5,0,18,32,12,45,8,3,7,19,12,9,-3,-3,11,13,0,36,1,1,7,5,0,0,1,1,5,2,0,-1,0,0,2,3,0,1,-24,-17,-7,2,0,2,-12,-4,-15,-9,-2,20,-5,-1,-3,-7,-3,4,-7,-3,-12,-2,1,16,1,1,0,1,-1,0,1,1,-1,0,-1,0,0,0,1,1,0,0,33,22,11,5,2,3,5,9,7,2,-1,10,0,8,7,5,-2,3,5,1,0,-3,1,7,3,-1,2,1,0,0,2,0,1,-1,0,0,1,-1,1,2,0,0,259,152,107,0,-4,4,17,38,28,92,63,23,3,22,24,52,44,8,14,16,4,40,19,15,0,2,0,-1,0,-1,-1,1,-2,-1,0,-1,1,1,2,0,0,0,-13,12,-25,8,6,2,4,3,-5,-8,-7,-1,6,4,2,2,-1,-3,-2,-1,-7,-10,-6,2,1,3,1,1,1,1,1,3,0,0,1,1,0,0,1,1,0,0,-37,-14,-23,2,4,-2,0,4,-2,-24,-6,-7,-2,2,0,-14,3,-1,2,2,-2,-10,-9,-6,-2,-1,2,0,2,1,-2,0,1,0,3,2,0,-1,1,0,-1,-1,-21,-18,-3,11,3,8,2,7,-5,-13,-4,-8,5,-2,2,-14,-5,-3,-3,9,-7,1,1,-5,3,0,1,2,3,2,1,-1,0,0,1,2,2,1,1,2,2,0,2,12,-10,6,3,3,-1,-7,-7,16,9,-6,3,-3,2,7,11,-7,-4,-4,-9,9,-2,1,2,0,3,0,1,0,0,1,3,0,0,-1,2,-1,0,0,1,1,-36,-19,-17,-24,-10,-14,3,-4,8,-19,-13,-7,3,0,-1,-14,-8,2,0,-4,9,-5,-5,-9,-1,0,-2,-11,-4,-6,0,-1,1,-8,-1,-1,-1,1,-3,-3,-3,-5,-3,4,-7,31,13,18,-10,3,-3,1,-5,9,-6,3,4,2,-6,4,-4,0,-7,-1,1,5,6,3,10,6,2,3,2,1,6,3,0,0,4,2,4,3,2,3,58,19,39,30,16,14,12,8,7,2,13,19,4,8,3,2,7,-2,8,0,4,0,6,21,3,4,8,5,7,3,2,3,5,3,3,0,1,1,3,2,4,3
38,38013,Frontera,4493,207,100,107,190,97,93,26,23,67,46,39,7,13,11,32,25,20,1,13,12,35,21,19,6,32,14,54,46,34,10,16,9,28,23,18,3,16,5,26,23,16,7,237,124,113,168,84,84,38,29,76,41,34,18,18,14,50,19,15,7,20,15,26,22,19,11,32,30,47,28,23,6,18,13,25,15,10,2,14,17,22,13,13,4,170,89,81,148,72,76,27,46,45,21,29,2,11,23,20,16,13,4,16,23,25,5,16,-2,34,27,38,21,28,0,19,11,19,11,10,2,15,16,19,10,18,-2,159,88,71,188,100,88,26,32,22,22,37,18,19,16,7,11,24,9,7,16,15,11,13,9,42,28,41,35,34,8,19,16,19,22,19,5,23,12,22,13,15,3,125,49,76,128,63,65,26,31,17,26,11,7,8,15,8,7,7,2,18,16,9,19,4,5,24,23,30,26,13,10,12,12,16,9,8,5,12,11,14,17,5,5,147,77,70,144,73,71,17,13,46,19,21,21,6,9,28,19,-1,12,11,4,18,0,22,9,28,18,44,17,24,13,17,10,25,7,6,8,11,8,19,10,18,5,74,45,29,95,43,52,14,15,-14,14,41,6,23,6,-7,1,18,5,-9,9,-7,13,23,1,22,9,21,21,17,5,9,3,12,11,7,1,13,6,9,10,10,4,-1757,-875,-882,125,64,61,-241,-146,-287,-381,-297,-399,-120,-74,-141,-206,-145,-189,-121,-72,-146,-175,-152,-210,25,18,25,30,22,4,13,10,10,19,9,2,12,8,15,11,13,2,109,65,44,84,47,37,32,18,1,46,18,-4,12,7,7,29,13,-2,20,11,-6,17,5,-2,18,16,19,21,12,-2,6,9,13,13,7,-1,12,7,6,8,5,-1,133,70,63,64,23,41,21,26,41,29,10,4,10,13,26,12,10,0,11,13,15,17,0,4,11,13,11,15,9,4,5,4,5,4,5,0,6,9,6,11,4,4,50,23,27,54,27,27,15,16,-2,14,0,4,8,9,1,7,-4,1,7,7,-3,7,4,3,11,12,11,9,6,5,7,7,4,3,3,3,4,5,7,6,3,2,13,2,11,26,10,16,5,4,6,4,-6,0,0,7,2,-4,-2,-1,5,-3,4,8,-4,1,9,2,4,6,3,2,7,3,1,0,-1,0,2,-1,3,6,4,2,-168,-88,-80,-130,-64,-66,-34,-6,-41,-50,-35,-2,-22,-5,-16,-26,-17,-1,-12,-1,-25,-24,-18,-1,-18,-12,-30,-38,-23,-9,-9,-4,-19,-19,-10,-3,-9,-8,-11,-19,-13,-6,-29,-16,-13,23,-4,27,3,-9,-12,-6,-1,-3,-4,0,-7,-5,3,-4,7,-9,-5,-1,-4,1,5,10,7,2,-1,-2,-2,2,0,-2,-1,-3,7,8,7,4,0,1,-42,-24,-18,-110,-51,-59,12,12,5,8,-36,-40,8,4,4,2,-18,-24,4,8,1,6,-18,-16,5,-2,-8,-20,-40,-46,6,1,-4,-8,-20,-26,-1,-3,-4,-12,-20,-20,42,37,5,-13,-4,-9,6,10,7,19,7,-5,7,2,3,17,8,1,-1,8,4,2,-1,-6,3,1,-2,2,0,-18,0,-2,0,4,3,-9,3,3,-2,-2,-3,-9,49,25,24,15,10,5,7,4,18,10,1,11,8,2,7,3,-1,6,-1,2,11,7,2,5,6,7,8,-3,-3,0,2,6,4,-2,0,0,4,1,4,-1,-3,0,35,13,22,45,18,27,4,6,20,-27,28,5,0,5,11,-15,8,5,4,1,9,-12,20,0,8,9,11,-5,19,3,6,5,7,-4,4,0,2,4,4,-1,15,3
38,38014,Fuencaliente de la Palma,1767,12,7,5,13,7,6,1,2,-5,3,8,2,2,2,-2,2,1,1,-1,0,-3,1,7,1,2,1,3,3,4,0,1,1,2,2,1,0,1,0,1,1,3,0,0,4,-4,17,8,9,-10,-3,6,-4,8,3,-5,0,5,0,2,2,-5,-3,1,-4,6,1,1,1,1,3,7,4,1,1,0,2,2,2,0,0,1,1,5,2,56,39,17,17,8,9,12,6,12,13,11,2,3,7,10,13,6,0,9,-1,2,0,5,2,4,2,3,3,3,2,2,1,0,2,2,1,2,1,3,1,1,1,32,9,23,27,11,16,1,6,1,10,12,2,-2,1,-7,6,11,1,3,5,8,4,1,1,1,5,5,3,9,4,0,2,0,0,7,2,1,3,5,3,2,2,34,21,13,27,14,13,-7,10,14,9,7,0,-2,6,10,2,3,1,-5,4,4,7,4,-1,2,5,5,7,5,3,1,1,4,4,2,2,1,4,1,3,3,1,27,12,15,40,20,20,10,6,-2,10,3,0,3,2,-6,13,0,0,7,4,4,-3,3,0,4,10,9,8,6,3,3,2,4,8,2,1,1,8,5,0,4,2,39,16,23,31,12,19,13,9,13,4,0,1,10,2,7,0,-1,-1,3,7,6,4,1,2,6,9,8,4,2,2,2,3,3,1,2,1,4,6,5,3,0,1,-22,-11,-11,20,11,9,-6,1,-10,-5,-1,1,-1,1,-5,-6,0,2,-5,0,-5,1,-1,-1,4,2,4,4,5,1,1,1,3,2,3,1,3,1,1,2,2,0,24,16,8,39,20,19,-1,10,-10,8,13,5,-4,3,0,7,7,3,3,7,-10,1,6,2,3,8,0,10,12,6,0,3,1,6,6,4,3,5,-1,4,6,2,-32,-21,-11,-3,-3,0,-6,3,-19,-15,6,-2,-1,1,-12,-10,0,1,-5,2,-7,-5,6,-3,1,0,-3,-2,0,1,0,1,-3,-2,0,1,1,-1,0,0,0,0,22,10,12,16,5,11,-1,9,8,5,-1,2,3,1,1,5,0,0,-4,8,7,0,-1,2,2,7,4,1,2,0,2,1,2,1,-1,0,0,6,2,0,3,0,-43,-21,-22,-1,-2,1,-12,-3,-23,-8,1,3,-7,2,-8,-8,-1,1,-5,-5,-15,0,2,2,0,0,-1,0,-1,1,0,-1,0,-1,-1,1,0,1,-1,1,0,0,-33,-16,-17,6,1,5,-5,0,-14,-5,-3,-7,-3,0,-6,-3,-3,-2,-2,0,-8,-2,0,-5,1,3,-3,2,2,1,1,1,-4,1,0,2,0,2,1,1,2,-1,-33,-15,-18,-11,-7,-4,-7,3,-1,-15,-1,-13,-3,0,-1,-3,-1,-8,-4,3,0,-12,0,-5,0,3,-3,-1,-1,-10,1,1,-3,-1,0,-6,-1,2,0,0,-1,-4,9,7,2,8,6,2,5,0,-6,4,2,1,3,2,-4,1,3,1,2,-2,-2,3,-1,0,1,3,-1,1,1,3,2,2,-1,2,-1,2,-1,1,0,-1,2,1,-5,-4,-1,0,-1,1,-1,11,-3,-12,5,-6,-2,3,-2,-4,1,-1,1,8,-1,-8,4,-5,0,1,0,-3,3,-2,0,0,0,-1,1,-2,0,1,0,-2,2,0,8,7,1,23,12,11,-3,10,4,0,5,-10,3,5,2,-4,2,-3,-6,5,2,4,3,-7,4,7,5,6,5,-4,3,1,3,3,3,-1,1,6,2,3,2,-3,23,11,12,37,12,25,2,5,0,10,-1,7,0,-1,-1,9,0,4,2,6,1,1,-1,3,6,10,6,7,1,7,1,1,3,2,1,4,5,9,3,5,0,3
38,38015,Garachico,5499,9,9,0,41,15,26,8,-10,7,1,3,1,2,-1,1,-1,3,3,6,-9,6,2,0,-2,9,5,11,6,5,5,0,2,5,2,3,3,9,3,6,4,2,2,5,-5,10,30,12,18,-1,3,-18,5,13,1,-2,4,-11,-1,2,1,1,-1,-7,6,11,0,5,4,3,5,9,4,2,2,2,1,3,2,3,2,1,4,6,2,17,-5,22,24,10,14,-4,17,3,4,0,1,-7,5,2,-1,1,-4,3,12,1,5,-1,5,4,1,2,11,7,-1,2,0,1,6,3,-2,2,1,1,5,4,1,30,33,-3,45,25,20,5,7,12,-2,7,4,5,3,15,2,7,3,0,4,-3,-4,0,1,10,7,6,12,7,3,4,4,4,7,4,2,6,3,2,5,3,1,24,16,8,26,10,16,15,4,-1,2,1,2,8,1,4,3,1,-1,7,3,-5,-1,0,3,2,7,5,5,4,3,1,4,3,1,0,1,1,3,2,4,4,2,-12,-1,-11,22,10,12,-11,13,-9,-10,10,-3,-6,10,-6,-7,8,2,-5,3,-3,-3,2,-5,3,5,0,1,10,3,3,4,-3,0,3,3,0,1,3,1,7,0,-32,5,-37,12,10,2,-7,-3,-19,-4,6,-8,2,5,-4,-4,6,-2,-9,-8,-15,0,0,-6,3,3,4,4,-2,0,2,5,2,1,1,-1,1,-2,2,3,-3,1,1,-2,3,28,12,16,0,4,-23,-7,15,12,0,6,-16,-3,5,5,0,-2,-7,-4,10,7,2,2,1,4,15,3,1,1,0,3,5,2,1,1,1,1,10,1,-15,-4,-11,23,11,12,1,3,-19,-3,7,-3,3,1,-4,-4,5,-3,-2,2,-15,1,2,0,11,8,2,0,4,-2,5,5,0,-2,4,-1,6,3,2,2,0,-1,28,4,24,16,8,8,3,8,-6,14,0,12,6,1,-10,5,-2,6,-3,7,4,9,2,6,4,3,1,4,2,2,3,2,1,1,0,1,1,1,0,3,2,1,-47,-33,-14,2,-2,4,-14,-8,-21,-17,10,4,-14,-4,-10,-7,1,3,0,-4,-11,-10,9,1,0,-1,3,-3,2,0,-1,0,1,-2,0,0,1,-1,2,-1,2,0,-23,-15,-8,-2,-2,0,4,-13,-12,-8,-10,15,-1,-3,-15,-2,-4,9,5,-10,3,-6,-6,6,3,2,-1,-6,0,0,1,0,-5,-1,2,1,2,2,4,-5,-2,-1,2,-3,5,15,10,5,0,9,-22,7,0,8,-1,2,-15,3,4,4,1,7,-7,4,-4,4,7,2,-3,3,1,3,3,2,-1,3,1,1,4,0,-2,0,0,2,9,12,-3,2,0,2,2,-4,3,-10,12,6,4,2,1,-4,7,1,-2,-6,2,-6,5,5,1,-1,2,-2,1,1,0,-1,2,-2,0,1,1,0,0,0,1,0,-43,-10,-33,-1,1,-2,-16,-8,-14,-14,7,3,-4,-9,-2,-3,7,2,-12,1,-12,-11,0,1,-2,2,-1,-2,2,0,0,1,-1,-1,2,0,-2,1,0,-1,0,0,40,22,18,9,10,-1,2,17,-18,8,1,28,-1,9,-5,2,1,17,3,8,-13,6,0,11,5,2,-4,3,3,0,4,3,-1,0,2,2,1,-1,-3,3,1,-2,10,5,5,29,13,16,-19,10,-3,-10,12,20,-6,3,0,-8,6,10,-13,7,-3,-2,6,10,-1,7,6,8,8,1,0,1,3,2,4,3,-1,6,3,6,4,-2,11,12,-1,13,-3,16,5,6,7,-9,20,-18,9,4,-4,-7,11,-4,-4,2,11,-2,9,-14,6,10,3,6,1,-15,4,3,-3,1,0,-10,2,7,6,5,1,-5
38,38016,Garafía,2020,-20,-9,-11,25,14,11,-4,-7,-3,-1,-2,-4,-3,-4,-1,0,0,-2,-1,-3,-2,-1,-2,-2,4,3,7,8,2,1,1,1,6,5,1,0,3,2,1,3,1,1,7,17,-10,25,15,10,-1,-1,1,-2,4,5,3,4,4,1,2,3,-4,-5,-3,-3,2,2,4,2,3,5,8,2,3,1,2,3,4,2,1,1,1,2,4,0,6,10,-4,27,18,9,-2,2,-9,12,3,2,-1,4,-4,8,1,4,-1,-2,-5,4,2,-2,6,3,1,9,4,4,3,3,1,6,1,4,3,0,0,3,3,0,17,15,2,17,12,5,5,5,-8,16,4,-3,5,1,-1,11,1,-1,0,4,-7,5,3,-2,3,1,1,8,6,-3,3,0,2,6,3,-2,0,1,-1,2,3,-1,-8,-6,-2,26,13,13,8,-4,2,-7,1,-8,4,-2,-1,-7,2,-2,4,-2,3,0,-1,-6,4,2,11,3,4,2,2,2,4,2,2,1,2,0,7,1,2,1,-29,-6,-23,21,10,11,-9,-9,-10,-5,1,2,-5,-2,-4,1,3,1,-4,-7,-6,-6,-2,1,3,1,4,7,5,1,0,0,1,5,3,1,3,1,3,2,2,0,3,-1,4,39,18,21,-2,3,-5,9,4,-6,1,1,-3,1,1,-2,-3,2,-2,8,3,-4,-1,5,6,17,9,3,-1,2,4,8,3,2,0,3,2,9,6,1,4,2,2,42,23,19,0,5,0,-2,9,-8,2,0,-4,5,6,-7,-2,5,4,-7,3,-1,5,3,11,8,13,1,3,1,3,6,8,1,2,2,8,2,5,0,-35,-10,-25,11,6,5,-12,-1,-15,-8,7,-6,-6,3,-5,-1,2,-3,-6,-4,-10,-7,5,-3,-1,1,1,1,9,0,-1,1,0,1,5,0,0,0,1,0,4,0,-75,-34,-41,-36,-19,-17,-12,-12,-16,-13,-14,-7,-6,-6,-8,-1,-9,-3,-6,-6,-8,-12,-5,-4,-4,-7,-5,-10,-9,-1,-2,-4,-2,-4,-7,0,-2,-3,-3,-6,-2,-1,10,0,10,20,9,11,6,-4,3,5,6,-5,3,-5,-1,3,2,-1,3,1,4,2,4,-4,3,0,6,8,4,-1,1,0,1,5,2,0,2,0,5,3,2,-1,18,9,9,30,14,16,-1,0,11,3,4,1,-2,3,6,-1,2,0,1,-3,5,4,2,1,6,2,9,7,5,0,4,1,4,1,2,1,2,1,5,6,3,-1,21,10,11,37,18,19,2,1,-8,10,16,-2,1,4,-7,6,4,1,1,-3,-1,4,12,-3,2,2,5,8,11,7,2,0,1,5,4,5,0,2,4,3,7,2,24,26,-2,28,17,11,-1,7,8,5,7,-3,3,7,5,5,7,-2,-4,0,3,0,0,-1,0,7,11,5,4,1,2,5,3,4,3,0,-2,2,8,1,1,1,30,16,14,33,16,17,-3,1,5,17,11,-1,-1,0,3,11,5,-2,-2,1,2,6,6,1,4,1,4,15,9,0,4,-1,1,8,5,-1,0,2,3,7,4,1,63,47,16,30,14,16,12,0,27,24,7,-8,8,3,12,20,7,-3,4,-3,15,4,0,-5,3,4,10,11,2,-1,1,2,2,6,2,1,2,2,8,5,0,-2,40,22,18,58,24,34,4,2,37,-5,1,0,2,-1,18,1,0,2,2,3,19,-6,1,-2,7,5,27,8,9,2,2,1,12,4,4,1,5,4,15,4,5,1,74,40,34,62,29,33,1,5,22,35,10,0,4,0,11,22,6,-3,-3,5,11,13,4,3,6,5,29,15,7,-1,2,0,17,12,2,-4,4,5,12,3,5,3
38,38018,"Guancha, La",5244,-6,-7,1,40,19,21,4,2,-12,-3,3,2,7,-4,-12,-2,4,2,-3,6,0,-1,-1,0,12,5,7,8,6,2,8,0,2,4,3,2,4,5,5,4,3,0,19,5,14,19,8,11,1,5,-5,8,8,2,-1,2,-1,0,5,0,2,3,-4,8,3,2,3,3,3,5,5,0,2,1,2,0,3,0,1,2,1,5,2,0,-37,-29,-8,10,5,5,-12,-4,-17,-8,2,0,-9,-6,-14,-2,1,1,-3,2,-3,-6,1,-1,4,0,1,2,1,1,0,0,0,2,1,2,4,0,1,0,0,-1,60,24,36,41,21,20,32,4,-3,14,10,0,14,5,-3,6,3,-2,18,-1,0,8,7,2,7,8,10,4,10,2,3,5,7,0,6,0,4,3,3,4,4,2,11,10,1,27,13,14,2,1,-1,3,5,3,4,0,-1,2,6,1,-2,1,0,1,-1,2,3,3,8,5,5,3,0,1,2,4,5,1,3,2,6,1,0,2,39,18,21,35,16,19,19,1,5,10,2,6,4,2,-4,11,3,2,15,-1,9,-1,-1,4,6,6,7,1,8,6,2,4,4,0,3,3,4,2,3,1,5,3,-61,-39,-22,26,14,12,-6,-18,-21,-5,-12,1,-5,-12,-15,1,-7,0,-1,-6,-6,-6,-5,1,6,3,8,10,-3,1,3,-1,4,8,0,0,3,4,4,2,-3,1,74,39,35,24,11,13,17,10,13,10,16,5,10,-1,10,2,13,4,7,11,3,8,3,1,5,3,4,6,3,2,3,0,2,2,3,1,2,3,2,4,0,1,23,22,1,26,12,14,-2,7,-4,8,9,1,-3,1,7,7,6,2,1,6,-11,1,3,-1,3,8,3,6,6,0,1,3,2,4,2,0,2,5,1,2,4,0,-7,3,-10,4,-2,6,2,-4,-7,-9,0,5,-5,5,-6,1,2,2,7,-9,-1,-10,-2,3,0,-1,1,1,2,1,-1,-2,0,0,1,0,1,1,1,1,1,1,-1,-1,0,-32,-22,-10,14,3,-3,-5,-9,-5,21,-3,-6,-6,-6,-4,-7,6,3,1,-3,-1,-1,-7,-5,-4,-10,-5,0,-2,-4,-4,-8,-4,-1,-5,-1,0,-2,-1,5,2,3,17,12,5,6,-2,-16,2,11,0,4,-3,-5,-2,4,1,2,1,-11,4,7,-1,6,3,-5,8,4,1,3,0,0,4,3,2,3,3,-5,4,1,-1,24,8,16,-6,-2,-4,14,-7,6,7,-1,0,6,-5,-3,6,1,0,8,-2,9,1,-2,0,3,-3,-2,-2,1,-3,3,-3,-2,0,1,-1,0,0,0,-2,0,-2,55,25,30,12,2,10,9,9,2,23,2,7,10,8,-2,7,-2,2,-1,1,4,16,4,5,4,3,-1,1,0,2,2,0,0,-1,-1,-1,2,3,-1,2,1,3,-27,-9,-18,-6,-2,-4,-14,2,2,-20,-2,6,-10,4,2,-8,0,3,-4,-2,0,-12,-2,3,1,1,-4,-2,-3,1,0,1,-2,0,-2,1,1,0,-2,-2,-1,0,7,-10,17,-3,-5,2,18,-5,2,2,-6,-4,4,-2,1,-6,-4,-4,14,-3,1,8,-2,0,6,-3,-3,-2,-1,0,3,-3,0,-3,-2,0,3,0,-3,1,1,0,31,27,4,21,13,8,9,-5,-2,9,12,2,9,-7,-5,13,9,3,0,2,3,-4,3,-1,6,0,2,2,6,3,4,0,0,5,3,-1,2,0,2,-3,3,4,13,-6,19,48,21,27,-11,6,12,-3,8,-1,-11,-5,2,3,9,-3,0,11,10,-6,-1,2,6,9,17,7,7,2,2,0,10,6,4,-1,4,9,7,1,3,3
38,38019,Guía de Isora,13761,676,378,298,474,272,202,144,99,209,136,66,16,62,56,126,74,41,12,82,43,83,62,25,4,85,78,138,78,75,18,38,44,85,49,43,11,47,34,53,29,32,7,771,401,370,662,351,311,145,186,172,143,103,10,81,86,98,78,49,5,64,100,74,65,54,5,127,139,172,119,81,13,72,75,93,62,38,7,55,64,79,57,43,6,465,241,224,456,238,218,81,67,123,85,80,27,30,36,74,47,45,13,51,31,49,38,35,14,76,72,107,84,89,21,28,38,60,43,54,12,48,34,47,41,35,9,595,328,267,552,303,249,100,106,141,103,124,23,65,64,76,41,61,23,35,42,65,62,63,0,84,86,153,92,102,31,50,52,87,44,49,19,34,34,66,48,53,12,248,159,89,415,230,185,34,48,36,33,62,29,13,44,31,18,37,13,21,4,5,15,25,16,61,76,103,70,74,28,29,43,61,39,39,16,32,33,42,31,35,12,439,260,179,493,253,240,35,94,118,87,68,36,7,70,87,50,28,20,28,24,31,37,40,16,74,93,99,109,78,36,29,49,61,55,40,18,45,44,38,54,38,18,82,7,75,425,213,212,5,23,-28,-7,67,23,-5,1,-14,-12,26,13,10,22,-14,5,41,10,75,68,89,77,88,26,35,33,47,39,42,15,40,35,42,38,46,11,590,298,292,560,281,279,120,119,126,74,101,46,39,71,65,38,56,27,81,48,61,36,45,19,108,119,117,88,87,36,49,67,60,37,46,19,59,52,57,51,41,17,341,230,111,374,193,181,53,43,74,81,78,18,39,28,54,60,39,13,14,15,20,21,39,5,53,69,93,60,68,29,30,41,48,26,30,18,23,28,45,34,38,11,47,-6,53,251,124,127,-48,47,-16,-19,47,37,-39,11,-8,-8,19,19,-9,36,-8,-11,28,18,26,48,53,43,55,26,13,16,30,23,26,16,13,32,23,20,29,10,3,13,-10,170,91,79,-12,28,-27,-19,9,18,-5,15,-15,-8,6,15,-7,13,-12,-11,3,3,17,47,37,19,35,15,14,23,16,7,20,10,3,24,21,12,15,5,145,67,78,184,97,87,22,52,-5,31,13,30,18,25,-12,16,0,17,4,27,7,15,13,13,18,38,44,32,28,20,13,21,17,21,15,7,5,17,27,11,13,13,241,117,124,287,130,157,-17,61,51,42,79,23,-15,30,36,15,32,16,-2,31,15,27,47,7,22,70,46,49,72,25,11,27,19,30,28,13,11,43,27,19,44,12,381,200,181,318,141,177,26,177,32,50,59,34,13,87,20,28,38,11,13,90,12,22,21,23,18,141,43,40,46,26,12,58,12,16,26,14,6,83,31,24,20,12,501,249,252,424,199,225,50,217,93,59,61,23,17,91,56,35,36,14,33,126,37,24,25,9,46,178,59,58,59,23,22,73,28,28,32,15,24,105,31,30,27,8,315,156,159,445,223,222,59,111,28,52,31,24,42,31,10,35,16,19,17,80,18,17,15,5,62,134,80,75,55,34,36,54,42,42,27,21,26,80,38,33,28,13,543,270,273,525,264,261,64,187,137,66,52,32,36,83,88,30,16,18,28,104,49,36,36,14,69,178,90,70,67,50,40,84,56,32,25,26,29,94,34,38,42,24,715,359,356,662,307,355,58,207,218,116,77,32,31,94,104,76,35,14,27,113,114,40,42,18,86,182,162,107,75,41,43,69,72,56,42,19,43,113,90,51,33,22
38,38021,Hermigua,2106,15,6,9,14,7,7,-1,0,15,-2,12,-8,4,0,5,-2,4,-5,-5,0,10,0,8,-3,2,1,5,2,4,0,2,0,1,1,3,0,0,1,4,1,1,0,52,23,29,12,5,7,4,10,5,10,20,4,2,4,2,2,11,3,2,6,3,8,9,1,1,1,4,2,4,0,1,0,1,1,2,0,0,1,3,1,2,0,55,32,23,16,9,7,-1,3,11,17,18,7,3,-3,10,8,11,2,-4,6,1,9,7,5,2,0,0,4,7,3,1,0,1,1,4,2,1,0,-1,3,3,1,23,16,7,20,8,12,-6,15,-7,5,13,4,-3,5,-2,8,4,4,-3,10,-5,-3,9,0,2,3,3,6,2,4,0,1,0,3,1,3,2,2,3,3,1,1,-17,-4,-13,13,5,8,-4,9,-10,-5,-2,-5,1,3,-2,-4,-2,0,-5,6,-8,-1,0,-5,2,2,3,1,4,1,1,1,2,0,1,0,1,1,1,1,3,1,16,13,3,25,12,13,0,0,1,6,7,2,-1,0,-2,3,9,3,1,0,3,3,-2,-1,5,3,3,7,6,1,2,1,0,3,5,1,3,2,3,4,1,0,15,3,12,8,3,5,-2,6,1,-2,10,4,-6,1,3,2,2,2,4,5,-2,-4,8,2,0,0,1,1,2,4,0,0,0,0,0,3,0,0,1,1,2,1,-5,-1,-4,14,3,11,-3,-5,6,5,-3,-6,-3,-1,4,4,-3,-3,0,-4,2,1,0,-3,3,1,3,4,1,1,0,0,1,1,0,0,3,1,2,3,1,1,24,11,13,16,4,12,10,10,-7,21,3,-10,5,7,-2,6,3,-5,5,3,-5,15,0,-5,4,2,2,7,2,-1,0,2,0,2,2,-2,4,0,2,5,0,1,-6,4,-10,9,5,4,-8,1,0,4,4,-7,-4,-1,3,6,2,-2,-4,2,-3,-2,2,-5,0,1,4,1,3,0,0,1,1,2,1,0,0,0,3,-1,2,0,60,25,35,9,5,4,3,11,-3,35,9,5,1,2,-3,17,7,1,2,9,0,18,2,4,0,5,1,0,2,1,0,2,1,-1,2,1,0,3,0,1,0,0,5,3,2,3,-2,5,4,4,5,-4,-1,-4,1,4,7,-3,-3,-3,3,0,-2,-1,2,-1,1,-1,3,1,-1,0,0,-1,1,0,-2,0,1,0,2,1,1,0,-39,-14,-25,-6,-4,-2,1,-5,-11,-13,-6,-3,4,-2,-9,-7,1,0,-3,-3,-2,-6,-7,-3,1,-1,0,-6,-2,1,1,0,-3,-4,1,1,0,-1,3,-2,-3,0,-45,-16,-29,-6,-1,-5,-4,-5,-12,-5,-6,-13,-5,0,-5,1,-3,-4,1,-5,-7,-6,-3,-9,0,-2,0,-3,2,-3,0,-1,0,0,2,-2,0,-1,0,-3,0,-1,-12,-11,-1,14,7,7,-1,10,-6,-9,-5,-4,-3,7,-4,-5,-4,-2,2,3,-2,-4,-1,-2,0,2,1,3,3,4,0,1,0,2,1,3,0,1,1,1,2,1,10,8,2,4,0,4,2,4,-11,11,-1,2,2,3,-6,7,-2,1,0,1,-5,4,1,1,6,-2,-2,-1,3,-1,3,0,-3,-1,1,-1,3,-2,1,0,2,0,-43,-9,-34,10,9,1,-19,-5,-18,-11,11,-2,-6,-2,-5,-6,10,0,-13,-3,-13,-5,1,-2,1,1,-1,1,7,1,2,0,1,0,5,1,-1,1,-2,1,2,0,16,-1,17,13,8,5,4,1,-1,8,7,0,1,1,-4,-3,7,-1,3,0,3,11,0,1,2,1,0,3,5,2,2,0,1,0,5,0,0,1,-1,3,0,2
38,38024,"Llanos de Aridane, Los",17910,445,212,233,343,182,161,72,69,124,102,66,11,29,25,63,54,39,4,43,44,61,48,27,7,47,44,102,83,59,7,23,19,59,44,32,4,24,25,43,39,27,3,232,125,107,337,164,173,50,55,49,42,32,3,24,30,34,16,20,0,26,25,15,26,12,3,70,63,79,74,40,10,35,29,37,35,21,6,35,34,42,39,19,4,278,151,127,218,123,95,79,56,44,37,44,19,50,33,22,14,24,13,29,23,22,23,20,6,44,24,53,44,40,11,27,19,21,23,25,8,17,5,32,21,15,3,252,126,126,239,122,117,73,37,56,24,39,21,37,12,34,8,24,11,36,25,22,16,15,10,47,27,55,50,43,16,26,13,30,24,21,8,21,14,25,26,22,8,74,21,53,247,120,127,13,7,-25,24,37,21,7,8,-17,4,6,15,6,-1,-8,20,31,6,48,31,55,47,56,9,23,18,23,27,21,8,25,13,32,20,35,1,208,96,112,249,135,114,22,48,1,40,64,32,14,21,2,14,23,21,8,27,-1,26,41,11,33,44,51,55,48,17,21,20,33,31,17,12,12,24,18,24,31,5,324,161,163,347,178,169,32,-5,104,58,67,52,4,-1,57,35,32,27,28,-4,47,23,35,25,61,47,93,62,47,32,30,24,45,33,24,19,31,23,48,29,23,13,431,187,244,298,158,140,78,69,90,88,55,38,43,27,32,43,16,15,35,42,58,45,39,23,53,41,72,60,51,18,31,23,34,31,26,10,22,18,38,29,25,8,377,181,196,267,131,136,61,48,84,26,104,37,33,29,34,3,54,21,28,19,50,23,50,16,44,43,46,37,65,30,18,23,23,17,34,15,26,20,23,20,31,15,188,75,113,133,65,68,46,27,29,18,40,22,13,0,10,9,21,18,33,27,19,9,19,4,24,12,23,26,35,10,8,4,9,14,21,7,16,8,14,12,14,3,216,81,135,207,90,117,63,38,26,38,25,16,25,24,-7,20,10,3,38,14,33,18,15,13,40,23,38,53,33,18,22,11,13,28,12,4,18,12,25,25,21,14,135,84,51,137,58,79,34,-3,17,60,7,19,17,-3,16,50,-2,8,17,0,1,10,9,11,22,22,16,41,17,17,12,5,0,23,4,13,10,17,16,18,13,4,118,27,91,159,60,99,7,17,39,19,19,10,-4,-7,16,1,10,9,11,24,23,18,9,1,2,21,36,44,42,10,0,8,15,13,18,3,2,13,21,31,24,7,-29,-10,-19,103,57,46,-9,-30,-1,-8,39,-29,5,-11,-12,-8,25,-11,-14,-19,11,0,14,-18,24,16,7,20,35,-4,10,8,3,14,21,-1,14,8,4,6,14,-3,39,22,17,118,54,64,9,-8,-4,17,-3,21,19,-2,-15,13,-5,11,-10,-6,11,4,2,10,16,22,14,29,25,9,11,11,8,9,8,7,5,11,6,20,17,2,-3,-7,4,114,55,59,-1,27,-12,4,15,-34,6,20,-4,-17,9,-21,-7,7,-8,21,6,-13,42,26,23,25,22,-24,25,15,8,10,10,-13,17,11,15,15,12,-11,287,128,159,255,123,132,57,22,59,60,52,24,28,-4,23,32,30,16,29,26,36,28,22,8,53,37,45,56,39,22,32,14,19,28,16,13,21,23,26,28,23,9,279,155,124,313,170,143,55,30,52,53,51,34,31,21,36,19,36,9,24,9,16,34,15,25,44,42,61,69,54,36,19,27,39,33,29,17,25,15,22,36,25,19
38,38025,"Matanza de Acentejo, La",6940,157,72,85,76,42,34,24,13,37,26,33,26,8,3,14,18,20,9,16,10,23,8,13,17,13,0,16,12,26,9,8,0,7,6,16,5,5,0,9,6,10,4,144,81,63,61,34,27,9,14,53,22,33,12,5,7,25,18,18,8,4,7,28,4,15,4,7,4,10,13,19,8,5,1,5,8,10,5,2,3,5,5,9,3,124,58,66,59,32,27,2,13,57,18,19,12,0,2,24,16,7,9,2,11,33,2,12,3,14,4,7,13,13,8,7,3,2,10,5,5,7,1,5,3,8,3,169,78,91,81,36,45,8,35,62,30,24,9,5,15,30,12,11,2,3,20,32,18,13,7,15,8,14,20,17,7,8,3,7,7,8,3,7,5,7,13,9,4,178,105,73,59,33,26,3,33,71,32,26,9,5,12,43,19,18,6,-2,21,28,13,8,3,4,7,10,10,20,8,3,2,5,7,12,4,1,5,5,3,8,4,142,66,76,64,33,31,21,14,37,36,26,6,12,7,12,20,14,3,9,7,25,16,12,3,6,3,9,15,24,7,2,0,4,10,13,4,4,3,5,5,11,3,165,74,91,60,26,34,-3,15,103,17,14,13,-14,4,57,12,5,7,11,11,46,5,9,6,5,4,19,10,14,8,2,2,5,4,7,6,3,2,14,6,7,2,119,72,47,56,32,24,1,16,56,29,7,11,10,10,25,12,5,9,-9,6,31,17,2,2,6,9,5,6,14,15,3,4,3,3,8,10,3,5,2,3,6,5,104,55,49,24,14,10,17,5,57,21,2,-2,11,2,30,10,3,-2,6,3,27,11,-1,0,4,-1,15,5,2,-1,2,-1,11,1,1,0,2,0,4,4,1,-1,87,51,36,22,13,9,10,1,60,5,1,5,1,-1,38,-2,5,5,9,2,22,7,-4,0,3,-1,6,3,8,3,0,-1,3,3,5,3,3,0,3,0,3,0,123,90,33,11,6,5,2,31,54,20,9,8,5,19,45,14,3,4,-3,12,9,6,6,4,0,6,-1,-4,7,3,1,2,3,-5,4,1,-1,4,-4,1,3,2,130,72,58,11,9,2,20,30,76,5,-5,0,17,19,35,-1,-1,3,3,11,41,6,-4,-3,-1,4,7,3,-2,-2,-1,3,5,3,-1,-1,0,1,2,0,-1,-1,94,25,69,25,13,12,16,0,59,13,15,-11,8,-9,19,4,11,-7,8,9,40,9,4,-4,4,3,8,1,6,3,3,2,4,-1,3,2,1,1,4,2,3,1,-77,-58,-19,-12,-7,-5,-26,3,-13,-17,-5,-15,-12,-5,-7,-22,-6,-5,-14,8,-6,5,1,-10,-1,2,-1,0,1,-13,0,1,0,-1,-1,-6,-1,1,-1,1,2,-7,7,-10,17,3,-4,7,0,13,-20,25,-1,-8,7,9,-16,2,-1,-8,-7,4,-4,23,0,0,3,0,1,-4,5,-3,1,-1,1,-4,0,-1,2,1,0,0,5,-2,-4,15,-19,-11,0,-11,-12,9,-6,-2,14,-3,-6,4,9,4,8,-6,-6,5,-15,-6,6,3,-4,3,2,-5,0,-9,0,4,0,-1,1,-6,-4,-1,2,-4,-1,-3,70,35,35,41,23,18,6,6,27,3,22,2,3,13,6,1,9,3,3,-7,21,2,13,-1,9,3,14,10,9,-5,6,3,9,4,3,-2,3,0,5,6,6,-3,94,51,43,44,20,24,12,18,20,27,21,0,8,6,14,14,9,1,4,12,6,13,12,-1,9,3,12,14,5,1,7,1,5,5,3,-1,2,2,7,9,2,2
38,38026,"Orotava, La",35775,211,79,132,255,128,127,56,11,50,30,49,16,9,9,16,14,21,11,47,2,34,16,28,5,40,28,54,50,56,26,16,12,27,24,32,16,24,16,27,26,24,10,333,160,173,223,114,109,81,23,115,51,42,18,54,16,28,32,23,7,27,7,87,19,19,11,51,29,39,49,39,12,30,17,18,26,16,6,21,12,21,23,23,6,386,189,197,315,141,174,137,8,94,68,58,18,79,1,41,36,27,4,58,7,53,32,31,14,85,33,70,60,49,15,42,13,23,30,24,7,43,20,47,30,25,8,329,162,167,344,160,184,106,25,-1,96,80,16,60,13,-4,37,40,10,46,12,3,59,40,6,76,44,63,66,70,23,34,13,28,35,35,14,42,31,35,31,35,9,183,35,148,211,82,129,59,26,24,57,-7,22,24,-7,-6,25,-11,8,35,33,30,32,4,14,30,47,48,53,23,8,10,15,23,23,7,3,20,32,25,30,16,5,88,59,29,192,86,106,56,3,-29,22,19,15,39,-4,3,10,11,3,17,7,-32,12,8,12,42,17,42,49,25,15,18,6,20,23,14,3,24,11,22,26,11,12,85,54,31,154,62,92,96,-11,-65,41,28,-7,63,-8,-22,9,13,-3,33,-3,-43,32,15,-4,33,33,35,22,23,5,17,9,14,10,8,3,16,24,21,12,15,2,350,172,178,224,118,106,105,32,73,50,46,38,64,-1,47,26,21,13,41,33,26,24,25,25,53,21,40,46,44,12,33,8,20,19,27,7,20,13,20,27,17,5,203,97,106,170,82,88,74,27,28,28,43,-8,36,14,24,-3,32,-7,38,13,4,31,11,-1,28,32,37,28,30,12,18,13,20,12,16,1,10,19,17,16,14,11,123,30,93,117,55,62,35,12,59,5,27,-13,17,-2,19,-4,3,4,18,14,40,9,24,-17,16,19,25,29,25,3,11,10,9,16,7,2,5,9,16,13,18,1,137,49,88,110,45,65,53,-5,19,68,-3,-3,24,-9,12,10,5,1,29,4,7,58,-8,-4,30,13,22,23,14,6,16,7,9,6,6,0,14,6,13,17,8,6,121,68,53,95,45,50,24,14,4,42,16,17,15,0,19,13,1,18,9,14,-15,29,15,-1,19,10,25,14,19,7,15,8,11,-2,7,5,4,2,14,16,12,2,268,157,111,74,27,47,91,18,58,88,36,-24,63,-4,33,49,23,-4,28,22,25,39,13,-20,26,0,13,18,18,-1,12,-7,7,11,9,-5,14,7,6,7,9,4,31,47,-16,62,20,42,16,4,-39,46,-5,-1,18,5,-19,49,-1,-11,-2,-1,-20,-3,-4,10,23,12,-1,20,15,-7,11,-1,1,12,5,-8,12,13,-2,8,10,1,249,94,155,118,47,71,109,-8,68,54,11,12,46,-24,39,23,13,-3,63,16,29,31,-2,15,25,22,25,18,20,9,15,8,8,-1,14,3,10,14,17,19,6,6,-9,-49,40,72,38,34,11,-21,32,-37,28,-26,-5,-15,-2,-34,12,-11,16,-6,34,-3,16,-15,25,12,20,-3,14,2,12,14,15,-4,1,-1,13,-2,5,1,13,3,236,54,182,204,73,131,91,28,-12,86,11,12,32,4,-34,41,4,-3,59,24,22,45,7,15,49,44,24,38,28,19,20,21,2,7,12,10,29,23,22,31,16,9,320,151,169,247,96,151,98,55,49,71,46,-15,64,26,33,19,15,-10,34,29,16,52,31,-5,60,54,47,44,30,7,33,19,24,9,11,-1,27,35,23,35,19,8
38,38027,"Paso, El",7268,93,47,46,131,64,67,31,-10,20,26,23,3,15,-3,10,11,12,1,16,-7,10,15,11,2,28,7,28,34,29,5,17,5,9,15,16,2,11,2,19,19,13,3,98,51,47,103,60,43,17,19,5,26,25,5,11,5,4,11,16,2,6,14,1,15,9,3,14,19,18,22,24,4,7,11,9,13,15,3,7,8,9,9,9,1,94,44,50,107,52,55,2,2,30,30,22,7,-1,-2,11,20,14,2,3,4,19,10,8,5,7,21,20,22,28,7,3,12,8,10,15,4,4,9,12,12,13,3,104,68,36,138,74,64,18,16,-6,40,32,7,9,20,-4,20,21,3,9,-4,-2,20,11,4,29,15,22,33,27,12,12,10,10,19,17,6,17,5,12,14,10,6,124,60,64,100,43,57,31,19,3,22,39,6,17,10,-6,7,26,2,14,9,9,15,13,4,15,10,11,24,28,10,5,5,3,9,14,5,10,5,8,15,14,5,94,39,55,98,48,50,20,1,7,27,25,14,14,-5,-12,17,16,8,6,6,19,10,9,6,7,9,14,28,25,15,2,4,4,17,13,8,5,5,10,11,12,7,115,66,49,113,56,57,40,18,6,18,28,3,27,10,3,7,14,3,13,8,3,11,14,0,20,15,13,28,29,8,12,10,5,11,14,4,8,5,8,17,15,4,148,61,87,122,56,66,17,11,36,37,39,0,-4,6,20,13,19,4,21,5,16,24,20,-4,13,14,16,35,34,8,2,7,6,19,16,5,11,7,10,16,18,3,139,67,72,104,48,56,32,2,22,34,34,20,12,-4,12,21,18,8,20,6,10,13,16,12,17,4,15,17,30,21,8,1,8,9,14,8,9,3,7,8,16,13,49,16,33,36,17,19,16,2,-5,23,13,0,2,-2,-3,8,10,1,14,4,-2,15,3,-1,11,0,0,11,9,5,5,-1,-2,8,5,2,6,1,2,3,4,3,111,43,68,55,22,33,21,11,20,47,8,0,4,-4,17,21,5,0,17,15,3,26,3,0,6,3,11,22,8,5,0,1,3,10,5,3,6,2,8,12,3,2,1,-9,10,33,17,16,-2,6,-13,-4,17,-2,0,3,-15,-4,9,-1,-2,3,2,0,8,-1,0,1,1,9,19,3,-1,0,0,5,12,1,1,1,1,4,7,2,99,51,48,62,30,32,16,3,-5,46,32,6,8,5,-3,21,13,7,8,-2,-2,25,19,-1,8,2,14,10,23,4,5,0,6,4,9,5,3,2,8,6,14,-1,-14,-21,7,35,15,20,-5,-7,-14,1,8,4,-8,-3,-10,2,0,1,3,-4,-4,-1,8,3,7,-2,2,8,21,-3,0,-1,0,7,9,0,7,-1,2,1,12,-3,32,2,30,37,18,19,17,7,-15,4,16,0,2,5,-9,-9,11,3,15,2,-6,13,5,-3,3,0,6,2,13,13,0,1,5,1,6,5,3,-1,1,1,7,8,-14,4,-18,14,5,9,4,-7,-3,1,11,-21,1,2,1,5,9,-13,3,-9,-4,-4,2,-8,2,7,1,12,10,-20,-1,2,1,5,9,-12,3,5,0,7,1,-8,64,54,10,42,30,12,0,15,0,40,19,-4,7,7,4,30,12,-4,-7,8,-4,10,7,0,10,4,7,7,15,-3,9,6,5,2,10,-3,1,-2,2,5,5,0,164,72,92,116,61,55,26,10,40,27,51,12,4,-6,24,12,24,16,22,16,16,15,27,-4,14,8,27,26,31,9,5,3,14,13,19,7,9,5,13,13,12,2
38,38028,Puerto de la Cruz,24050,646,318,328,565,273,292,61,111,116,112,154,90,34,43,55,61,79,47,27,68,61,51,75,43,55,62,132,98,149,66,23,29,62,53,71,33,32,33,70,45,78,33,952,423,529,752,343,409,133,169,144,185,202,107,36,40,84,100,91,65,97,129,60,85,111,42,104,96,173,139,155,76,42,33,87,66,78,35,62,63,86,73,77,41,907,473,434,859,450,409,49,228,63,168,252,142,40,116,27,81,139,66,9,112,36,87,113,76,89,123,181,130,212,114,53,54,101,68,110,57,36,69,80,62,102,57,753,328,425,851,417,434,70,171,58,99,247,93,36,64,43,41,96,46,34,107,15,58,151,47,79,134,150,136,232,113,47,51,88,67,106,56,32,83,62,69,126,57,654,288,366,723,341,382,11,129,59,116,228,109,0,59,31,38,98,60,11,70,28,78,130,49,72,87,161,133,165,99,37,34,82,60,71,53,35,53,79,73,94,46,401,209,192,544,263,281,-47,73,-12,79,172,136,-32,39,0,50,87,62,-15,34,-12,29,85,74,54,52,100,106,127,101,26,26,47,51,64,47,28,26,53,55,63,54,842,432,410,761,370,391,48,158,104,122,233,158,15,78,58,66,120,83,33,80,46,56,113,75,65,103,157,131,184,114,30,41,75,67,93,62,35,62,82,64,91,52,740,353,387,893,422,471,51,112,55,127,217,168,34,36,42,71,101,60,17,76,13,56,116,108,88,130,161,159,194,157,51,60,83,72,87,66,37,70,78,87,107,91,553,245,308,537,272,265,48,109,-22,102,188,134,36,54,-33,39,85,66,12,55,11,63,103,68,43,85,100,94,131,77,20,40,38,65,65,40,23,45,62,29,66,37,418,208,210,469,230,239,7,41,18,64,146,147,-5,22,24,41,70,64,12,19,-6,23,76,83,41,65,83,77,114,89,17,36,33,41,58,45,24,29,50,36,56,44,399,222,177,533,256,277,-34,35,29,20,188,166,-20,27,42,27,61,88,-14,8,-13,-7,127,78,47,50,80,81,157,113,23,30,37,37,66,62,24,20,43,44,91,51,222,139,83,392,187,205,-9,28,-54,41,109,98,3,6,-19,24,65,55,-12,22,-35,17,44,43,30,57,57,76,91,79,16,20,29,34,43,44,14,37,28,42,48,35,331,133,198,301,127,174,26,36,-9,94,70,104,15,12,-23,34,35,54,11,24,14,60,35,50,14,32,40,63,75,71,5,7,12,27,42,32,9,25,28,36,33,39,229,85,144,179,77,102,41,37,-18,36,73,54,26,5,-25,8,37,30,15,32,7,28,36,24,29,29,12,40,43,24,15,17,-4,25,14,9,14,12,16,15,29,15,290,149,141,392,183,209,-13,67,-36,74,108,86,-4,44,-14,44,41,37,-9,23,-22,30,67,49,48,50,53,81,90,66,23,29,19,34,43,34,25,21,34,47,47,32,419,169,250,552,256,296,36,39,34,92,139,84,-10,14,38,24,65,44,46,25,-4,68,74,40,80,58,96,126,112,77,29,26,51,53,57,37,51,32,45,73,55,40,599,311,288,678,345,333,31,119,81,85,160,125,19,48,53,47,70,77,12,71,28,38,90,48,67,97,115,124,143,127,34,45,62,61,67,75,33,52,53,63,76,52,831,412,419,806,399,407,99,120,109,148,171,177,55,51,61,76,74,87,44,69,48,72,97,90,87,120,136,161,183,109,44,49,70,79,85,65,43,71,66,82,98,44
38,38029,Puntagorda,1785,-19,-6,-13,18,9,9,-6,-8,-9,2,5,-3,-4,-5,-4,5,2,0,-2,-3,-5,-3,3,-3,3,2,2,3,8,0,2,1,0,2,4,0,1,1,2,1,4,0,35,12,23,15,7,8,6,5,10,7,3,2,1,1,5,1,2,0,5,4,5,6,1,2,3,1,3,3,2,1,0,0,1,1,2,1,3,1,2,2,0,0,25,22,3,7,7,0,5,2,12,1,7,-2,7,1,9,0,6,-2,-2,1,3,1,1,0,1,1,1,1,3,0,1,1,2,0,3,0,0,0,-1,1,0,0,-45,-21,-24,1,-1,2,-13,-5,-15,-9,-3,0,-6,-3,-9,-3,-1,1,-7,-2,-6,-6,-2,-1,0,0,2,0,-1,0,0,0,0,0,-1,0,0,0,2,0,0,0,19,16,3,25,12,13,8,1,-3,5,6,3,7,2,-3,2,6,3,1,-1,0,3,0,0,8,1,4,6,3,3,6,0,0,2,3,1,2,1,4,4,0,2,30,0,30,36,14,22,1,1,7,12,9,0,-5,-3,1,5,3,-1,6,4,6,7,6,1,6,7,4,10,7,2,1,2,3,5,3,0,5,5,1,5,4,2,59,35,24,38,19,19,8,5,22,5,14,3,6,2,15,2,8,2,2,3,7,3,6,1,7,5,7,5,9,4,3,3,3,3,5,2,4,2,4,2,4,2,-4,3,-7,25,9,16,-4,-5,1,-5,7,3,0,2,2,-3,3,0,-4,-7,-1,-2,4,3,3,4,5,5,6,2,2,2,1,1,3,0,1,2,4,4,3,2,93,54,39,35,22,13,15,7,29,21,16,4,5,3,18,17,7,4,10,4,11,4,9,0,4,3,5,12,9,2,2,2,3,9,5,1,2,1,2,3,4,1,9,15,-6,20,14,6,-6,4,-4,11,5,-3,2,1,-4,11,4,1,-8,3,0,0,1,-4,-2,3,3,9,4,2,-2,1,3,6,3,3,0,2,0,3,1,-1,16,19,-3,16,8,8,-16,11,-7,14,10,3,-11,7,3,11,6,2,-5,4,-10,3,4,1,1,3,0,8,3,1,0,0,1,5,2,0,1,3,-1,3,1,1,77,24,53,43,17,26,33,10,14,11,7,0,18,4,-1,-1,1,2,15,6,15,12,6,-2,10,10,6,8,8,1,5,4,-1,2,5,2,5,6,7,6,3,-1,89,43,46,27,13,14,8,11,20,23,24,2,4,6,4,16,11,0,4,5,16,7,13,2,3,3,3,1,18,-1,0,1,1,2,9,0,3,2,2,-1,9,-1,-3,2,-5,14,7,7,1,-5,-4,-5,11,-2,-2,0,1,-4,10,-2,3,-5,-5,-1,1,0,5,1,-1,1,11,-4,2,-1,1,-1,8,-2,3,2,-2,2,3,-2,29,16,13,16,12,4,8,7,5,-2,9,1,3,2,3,0,5,3,5,5,2,-2,4,-2,3,-2,5,2,8,0,2,0,3,3,4,0,1,-2,2,-1,4,0,25,3,22,9,2,7,-1,9,0,10,2,5,0,1,-4,3,-1,4,-1,8,4,7,3,1,-3,3,4,0,6,-1,0,1,1,-1,2,-1,-3,2,3,1,4,0,3,0,3,30,16,14,-11,-7,12,-5,8,6,-6,-2,10,-3,1,0,-5,-5,2,-2,7,6,3,1,10,4,11,1,2,1,5,4,6,-2,1,0,5,0,5,3,61,29,32,55,27,28,13,5,9,16,13,5,8,1,-1,8,8,5,5,4,10,8,5,0,8,9,13,7,10,8,6,5,5,1,2,8,2,4,8,6,8,0
38,38030,Puntallana,2205,46,19,27,33,15,18,7,9,9,8,11,1,1,2,3,2,9,1,6,7,6,6,2,0,4,3,11,6,8,1,1,0,3,4,6,1,3,3,8,2,2,0,58,32,26,41,18,23,2,21,14,9,12,-3,0,12,6,7,7,-1,2,9,8,2,5,-2,4,11,7,8,7,2,2,6,3,3,3,0,2,5,4,5,4,2,70,35,35,46,19,27,23,11,25,9,5,-3,17,2,9,9,-1,-1,6,9,16,0,6,-2,9,11,12,6,8,0,6,3,5,4,1,0,3,8,7,2,7,0,50,26,24,38,23,15,4,-1,13,10,18,5,-1,-1,7,7,12,2,5,0,6,3,6,3,3,3,9,6,13,4,3,2,5,4,8,1,0,1,4,2,5,3,42,26,16,43,21,22,14,9,2,7,8,1,7,9,2,-1,8,0,7,0,0,8,0,1,12,5,6,8,11,1,6,4,3,2,5,1,6,1,3,6,6,0,-24,-19,-5,29,13,16,-14,3,-30,1,12,4,-6,-2,-17,-1,6,2,-8,5,-13,2,6,2,4,5,2,7,5,6,2,1,2,4,2,2,2,4,0,3,3,4,69,44,25,32,21,11,20,7,15,25,-3,2,11,2,13,18,-4,4,9,5,2,7,1,-2,10,0,3,10,4,4,7,1,1,7,1,4,3,-1,2,3,3,0,20,13,7,29,16,13,-6,1,8,10,1,5,-3,4,7,3,1,1,-3,-3,1,7,0,4,4,3,4,6,8,4,3,1,3,3,4,2,1,2,1,3,4,2,33,31,2,5,0,5,4,12,8,5,5,-1,6,7,12,1,4,1,-2,5,-4,4,1,-2,1,-3,3,2,4,-2,0,-2,1,-1,2,0,1,-1,2,3,2,-2,-30,-14,-16,9,3,6,-13,-3,-7,-7,-2,-1,-3,-5,-3,-4,1,-2,-10,2,-4,-3,-3,1,0,1,0,2,6,0,0,1,-1,0,3,0,0,0,1,2,3,0,-14,4,-18,-9,-7,-2,-7,3,-16,-3,9,0,2,-1,-7,0,10,1,-9,4,-9,-3,-1,-1,-2,-1,-3,-7,3,1,0,-3,-3,-3,3,-1,-2,2,0,-4,0,2,49,19,30,24,9,15,12,18,9,15,-1,-3,1,8,9,4,-1,-2,11,10,0,11,0,-1,1,4,2,22,-2,-3,-1,2,2,11,-2,-3,2,2,0,11,0,0,-12,-2,-10,11,-3,14,-6,-2,0,2,-3,-4,-9,1,-1,8,2,-2,3,-3,1,-6,-5,-2,0,0,6,6,-1,0,-1,-1,1,1,-2,-1,1,1,5,5,1,1,24,8,16,4,1,3,9,3,-4,4,13,-1,8,-3,1,0,4,-1,1,6,-5,4,9,0,1,-3,1,4,3,-2,0,-2,2,1,1,-1,1,-1,-1,3,2,-1,23,13,10,2,0,2,0,2,6,6,12,-3,-2,1,0,8,5,0,2,1,6,-2,7,-3,0,2,-1,1,3,-3,-1,1,-2,2,0,0,1,1,1,-1,3,-3,12,3,9,0,0,0,10,-1,-14,12,0,3,4,0,-5,3,0,1,6,-1,-9,9,0,2,2,-2,0,0,1,-2,0,-1,1,1,0,-2,2,-1,-1,-1,1,0,60,28,32,35,20,15,5,10,17,1,5,22,1,4,10,4,4,5,4,6,7,-3,1,17,6,6,10,7,4,2,4,3,6,3,2,2,2,3,4,4,2,0,64,34,30,54,25,29,11,13,18,13,5,1,6,8,11,4,6,-2,5,5,7,9,-1,3,8,17,10,11,9,-2,5,8,7,4,4,-3,3,9,3,7,5,1
38,38031,"Realejos, Los",33575,160,77,83,248,121,127,-3,11,3,36,86,20,-7,1,7,14,45,11,4,10,-4,22,41,9,27,31,41,42,80,26,12,14,23,19,40,13,15,17,18,23,40,13,282,125,157,354,178,176,6,25,74,22,111,39,9,-5,40,3,54,22,-3,30,34,19,57,17,55,25,67,61,108,36,29,4,35,28,57,24,26,21,32,33,51,12,349,199,150,349,185,164,46,52,85,71,60,34,13,20,59,37,45,24,33,32,26,34,15,10,56,46,72,68,74,29,25,23,41,32,47,16,31,23,31,36,27,13,334,160,174,363,179,184,21,35,96,42,90,51,4,17,40,34,37,28,17,18,56,8,53,23,78,33,69,75,64,43,36,20,29,46,25,23,42,13,40,29,39,20,348,191,157,331,162,169,21,36,90,51,108,40,21,11,76,17,52,18,0,25,14,34,56,22,41,40,69,44,91,41,19,16,39,20,43,23,22,24,30,24,48,18,655,300,355,336,158,178,207,63,143,105,64,59,91,40,61,48,28,27,116,23,82,57,36,32,50,43,55,59,70,55,25,17,23,36,31,26,25,26,32,23,39,29,376,195,181,358,177,181,72,16,121,49,58,58,51,16,42,37,14,36,21,0,79,12,44,22,61,38,42,82,73,62,31,19,16,39,36,36,30,19,26,43,37,26,227,90,137,299,152,147,0,16,102,8,63,28,-14,9,45,-2,31,16,14,7,57,10,32,12,45,43,53,49,74,32,22,24,23,24,37,20,23,19,30,25,37,12,229,129,100,244,137,107,10,66,61,21,39,26,2,32,44,10,19,15,8,34,17,11,20,11,25,49,39,42,54,31,13,28,22,25,30,18,12,21,17,17,24,13,12,6,6,110,44,66,12,6,-55,23,28,5,14,7,-38,11,16,-3,-2,-1,-17,12,12,8,12,20,16,21,23,18,0,12,10,8,6,8,12,8,6,13,17,10,31,-6,37,105,43,62,19,-5,-34,12,36,4,15,-1,-27,-9,15,-3,4,-4,-7,21,21,7,19,9,13,21,36,7,12,3,2,6,15,5,7,6,11,15,21,2,-69,-24,-45,77,43,34,-11,8,-35,-33,5,7,17,-1,-26,-12,0,3,-28,9,-9,-21,5,4,13,9,9,14,22,8,8,8,5,8,11,2,5,1,4,6,11,6,-42,-33,-9,73,39,34,32,-27,-30,1,-13,-5,2,-14,-14,0,-2,1,30,-13,-16,1,-11,-6,13,4,14,24,7,10,6,1,7,13,3,9,7,3,7,11,4,1,-84,-74,-10,38,18,20,2,-28,-5,-30,-29,5,-9,-8,-28,-16,-14,-1,11,-20,23,-14,-15,6,13,5,2,21,3,-8,11,2,-4,9,4,-5,2,3,6,12,-1,-3,-180,-75,-105,40,27,13,-32,-53,-55,-32,4,-14,-23,-16,-21,-19,-2,3,-9,-37,-34,-13,6,-17,11,1,4,7,12,5,8,1,5,2,4,7,3,0,-1,5,8,-2,-53,14,-67,16,8,8,-10,10,14,-3,13,-74,13,11,1,13,12,-38,-23,-1,13,-16,1,-36,19,13,23,15,13,-68,9,11,9,6,11,-39,10,2,14,9,2,-29,174,103,71,213,102,111,59,26,33,51,21,-11,41,9,19,36,8,-4,18,17,14,15,13,-7,48,30,45,35,38,16,26,13,21,20,15,7,22,17,24,15,23,9,168,40,128,177,63,114,54,3,45,24,39,-5,4,6,17,10,1,-4,50,-3,28,14,38,-1,33,30,23,35,41,11,10,16,12,11,11,1,23,14,11,24,30,10
38,38032,"Rosario, El",11544,313,169,144,98,52,46,20,57,149,57,15,10,12,23,77,37,13,6,8,34,72,20,2,4,13,11,27,15,19,13,7,5,13,8,10,9,6,6,14,7,9,4,348,206,142,97,49,48,29,59,148,57,39,16,18,23,90,40,22,13,11,36,58,17,17,3,14,12,28,20,15,6,7,3,12,11,11,4,7,9,16,9,4,2,342,146,196,154,76,78,6,69,133,90,26,12,-15,29,68,50,11,2,21,40,65,40,15,10,34,25,41,29,14,9,19,12,22,18,3,1,15,13,19,11,11,8,557,248,309,232,103,129,68,73,252,90,58,-2,37,22,102,50,30,2,31,51,150,40,28,-4,49,31,52,52,40,8,24,12,18,25,18,6,25,19,34,27,22,2,375,226,149,140,75,65,84,40,122,82,24,8,79,20,53,46,13,8,5,20,69,36,11,0,27,25,41,21,14,12,15,10,25,11,7,7,12,15,16,10,7,5,-352,-186,-166,57,23,34,-95,-44,-65,-126,-19,-8,-44,-16,-32,-75,-14,-6,-51,-28,-33,-51,-5,-2,4,14,20,9,4,6,1,2,13,4,2,1,3,12,7,5,2,5,181,87,94,152,82,70,-2,73,60,26,27,5,-2,39,28,9,13,3,0,34,32,17,14,2,25,25,51,29,15,6,15,14,25,16,8,3,10,11,26,13,7,3,207,58,149,112,51,61,28,21,139,16,-11,-5,22,-18,62,-11,-8,-3,6,39,77,27,-3,-2,18,20,31,18,15,9,13,8,13,7,7,2,5,12,18,11,8,7,6,-32,38,125,52,73,-31,39,25,-47,10,1,-12,13,-13,-31,5,2,-19,26,38,-16,5,-1,24,25,27,22,17,10,11,8,8,10,9,6,13,17,19,12,8,4,182,155,27,270,207,63,33,131,4,-16,12,7,30,119,-4,2,-2,8,3,12,8,-18,14,-1,51,155,22,16,14,10,43,140,5,6,5,6,8,15,17,10,9,4,-88,-82,-6,18,6,12,0,-52,-21,-13,7,-9,13,-70,-3,-18,2,-8,-13,18,-18,5,5,-1,5,33,-14,-5,1,-2,3,19,-10,-6,0,0,2,14,-4,1,1,-2,58,12,46,73,25,48,-9,1,20,40,-7,7,-4,-14,11,19,-6,-1,-5,15,9,21,-1,8,13,17,10,13,9,11,6,2,4,3,5,5,7,15,6,10,4,6,-2,-48,46,-55,-46,-9,24,-46,61,-20,-13,-14,8,-45,14,-15,-3,-9,16,-1,47,-5,-10,-5,6,-41,-17,2,-4,-3,4,-47,-8,3,3,-1,2,6,-9,-1,-7,-2,-14,-12,-2,14,3,11,-5,9,40,-27,-38,3,-17,5,27,-14,-11,-5,12,4,13,-13,-27,8,9,8,1,8,-8,-6,2,2,-3,7,-2,-5,7,6,4,1,-6,-1,-164,-85,-79,-104,-66,-38,-8,7,22,-76,-55,-59,0,4,17,-44,-31,-33,-8,3,5,-32,-24,-26,10,-2,1,-36,-33,-46,4,-4,3,-22,-22,-26,6,2,-2,-14,-11,-20,-39,-37,-2,64,30,34,-56,5,49,-45,-7,1,-37,-9,34,-21,-11,-3,-19,14,15,-24,4,4,16,15,17,7,7,0,12,2,11,2,0,1,4,13,6,5,7,-1,107,41,66,53,16,37,4,20,83,29,-30,-11,5,3,49,7,-14,-13,-1,17,34,22,-16,2,11,22,16,-1,-5,4,7,8,9,-3,-5,-1,4,14,7,2,0,5,1,-11,12,50,25,25,-13,19,48,-36,-14,-18,-8,-4,22,-1,-19,-13,-5,23,26,-35,5,-5,13,17,12,6,10,-9,9,6,6,7,0,-3,4,11,6,-1,10,-6
38,38023,San Cristóbal de La Laguna,127945,1687,871,816,1028,518,510,220,447,530,269,137,80,116,213,303,135,69,35,104,234,227,134,68,45,173,252,260,180,112,48,87,126,145,87,48,25,86,126,115,93,64,23,1710,908,802,1092,569,523,281,467,545,282,108,18,173,210,316,134,62,10,108,257,229,148,46,8,185,262,315,179,105,37,97,127,175,93,54,18,88,135,140,86,51,19,969,541,428,1276,669,607,200,376,240,84,45,27,102,227,117,56,37,6,98,149,123,28,8,21,245,291,350,215,110,57,124,142,198,115,51,35,121,149,152,100,59,22,1599,841,758,1706,890,816,298,559,403,197,85,64,145,261,264,105,32,32,153,298,139,92,53,32,270,419,446,302,169,88,135,198,264,157,82,48,135,221,182,145,87,40,1677,911,766,1774,904,870,285,501,459,201,115,120,158,248,277,117,51,57,127,253,182,84,64,63,281,453,524,280,154,68,154,215,288,139,69,29,127,238,236,141,85,39,1862,889,973,1595,809,786,293,710,491,167,111,84,151,337,258,86,22,31,142,373,233,81,89,53,202,498,403,229,170,85,117,230,218,117,78,45,85,268,185,112,92,40,1648,785,863,1614,765,849,296,678,328,244,56,61,152,325,142,127,17,27,144,353,186,117,39,34,271,435,425,266,148,59,130,175,228,134,67,28,141,260,197,132,81,31,1523,666,857,1729,854,875,286,666,181,211,119,62,109,306,103,93,27,28,177,360,78,118,92,34,263,513,443,283,146,71,146,228,232,153,52,37,117,285,211,130,94,34,1821,811,1010,1555,771,784,274,682,298,244,216,59,155,312,113,98,86,26,119,370,185,146,130,33,204,542,357,239,145,55,114,244,193,117,66,29,90,298,164,122,79,26,1245,400,845,947,400,547,189,563,285,62,26,72,91,180,91,-14,23,6,98,383,194,76,3,66,105,445,211,112,48,15,58,176,77,63,24,1,47,269,134,49,24,14,816,354,462,1005,425,580,156,453,99,43,-14,55,82,154,74,-14,6,30,74,299,25,57,-20,25,124,433,199,138,65,35,63,157,96,51,31,19,61,276,103,87,34,16,261,-34,295,830,326,504,-57,480,-220,12,-14,22,-51,182,-115,-1,-55,-6,-6,298,-105,13,41,28,84,445,130,102,60,1,52,176,51,34,17,-5,32,269,79,68,43,6,780,366,414,664,271,393,131,385,45,89,13,73,94,145,11,64,-3,33,37,240,34,25,16,40,51,361,102,53,68,22,41,128,48,10,23,16,10,233,54,43,45,6,50,-107,157,-123,-163,40,23,323,-215,-25,-8,-51,7,109,-103,-54,-45,-29,16,214,-112,29,37,-22,12,283,-273,-101,-19,-31,-1,95,-136,-78,-33,-13,13,188,-137,-23,14,-18,-370,-220,-150,-391,-220,-171,126,317,-601,-93,-28,-101,72,137,-260,-136,-8,-40,54,180,-341,43,-20,-61,24,273,-533,-59,-4,-98,4,101,-210,-62,-3,-50,20,172,-323,3,-1,-48,-1355,-892,-463,-1052,-668,-384,-71,376,-594,-539,-288,-225,-92,140,-289,-379,-171,-92,21,236,-305,-160,-117,-133,-51,291,-468,-472,-222,-139,-33,93,-244,-306,-123,-61,-18,198,-224,-166,-99,-78,698,298,400,497,191,306,249,587,-200,26,47,-2,147,249,-55,-4,-29,7,102,338,-145,30,76,-9,211,378,-152,-16,54,13,117,162,-57,-24,-6,-4,94,216,-95,8,60,17,1996,902,1094,1337,614,723,480,680,275,254,183,77,262,259,170,104,66,21,218,421,105,150,117,56,326,440,72,249,157,75,179,172,56,114,61,26,147,268,16,135,96,49
38,38034,San Juan de la Rambla,4645,128,70,58,46,26,20,27,26,44,16,12,5,17,12,25,9,4,4,10,14,19,7,8,1,11,2,11,8,10,4,8,0,5,5,4,4,3,2,6,3,6,0,18,7,11,26,15,11,5,9,-3,-2,8,0,5,5,-5,-2,3,0,0,4,2,0,5,0,4,2,8,2,7,2,3,1,5,1,3,1,1,1,3,1,4,1,33,15,18,27,15,12,5,6,10,10,-4,4,4,3,4,4,-3,0,1,3,6,6,-1,4,8,3,9,6,-1,1,5,3,4,3,-2,1,3,0,5,3,1,0,7,0,7,51,24,27,0,6,-3,-5,3,3,-6,7,8,-11,1,1,6,-1,-11,6,2,2,9,11,13,6,7,2,6,4,7,3,2,1,3,7,6,3,5,1,65,28,37,36,15,21,19,19,14,7,3,3,6,7,5,5,4,-1,13,12,9,2,-1,4,10,7,2,10,6,1,6,2,0,3,4,0,4,5,2,7,2,1,23,17,6,13,5,8,-9,13,8,9,-2,3,-4,7,10,7,-3,0,-5,6,-2,2,1,3,1,4,2,0,2,4,2,0,1,0,0,2,-1,4,1,0,2,2,6,0,6,18,7,11,-15,10,-11,9,12,-1,-10,1,-2,4,7,-1,-5,9,-9,5,5,0,1,4,3,8,3,-1,0,1,2,3,1,0,1,3,1,5,2,-1,-1,1,-2,36,19,17,-9,3,-5,9,2,-1,-1,-2,-3,8,1,-2,-8,5,-2,1,1,1,6,1,11,12,5,1,3,0,5,7,3,1,3,1,6,5,2,0,-5,16,-21,15,13,2,3,6,2,-3,-5,-6,2,8,4,2,0,0,1,-2,-2,-5,-5,-6,4,5,2,2,1,0,3,2,2,3,2,0,1,3,0,-1,-1,0,-13,-9,-4,14,9,5,2,5,-7,-2,-2,-2,2,8,-6,-3,-5,-1,0,-3,-1,1,3,-1,4,3,2,3,1,1,4,2,1,1,1,0,0,1,1,2,0,1,21,14,7,15,5,10,2,7,0,2,12,-1,1,7,-1,6,4,-3,1,0,1,-4,8,2,2,2,6,3,2,0,1,2,2,1,1,-2,1,0,4,2,1,2,49,19,30,15,5,10,17,23,9,10,-4,-8,7,10,-3,5,0,-1,10,13,12,5,-4,-7,3,4,0,5,4,-1,2,1,-1,2,1,0,1,3,1,3,3,-1,27,22,5,-1,-1,0,20,4,5,3,1,-6,14,1,4,5,0,-3,6,3,1,-2,1,-3,2,-1,1,-2,0,-1,1,-1,0,1,0,-2,1,0,1,-3,0,1,-27,-16,-11,12,3,9,-11,-1,-22,3,3,-2,-9,-2,-10,4,1,-2,-2,1,-12,-1,2,0,6,0,0,6,2,-2,4,0,1,3,-1,-4,2,0,-1,3,3,2,-73,-29,-44,-11,-5,-6,-20,-1,-17,-12,-12,-9,-11,2,-11,-3,-4,-1,-9,-3,-6,-9,-8,-8,0,1,-3,-3,-4,-2,1,0,-2,-2,-2,0,-1,1,-1,-1,-2,-2,-25,-6,-19,20,12,8,-7,-15,-35,-8,12,27,3,-3,-14,-6,8,6,-10,-12,-21,-2,4,21,3,3,1,5,5,3,2,3,1,1,3,2,1,0,0,4,2,1,-77,-43,-34,-6,-9,3,-17,-6,-28,-26,-9,10,-17,-4,-9,-16,-5,8,0,-2,-19,-10,-4,2,-3,1,-4,-2,5,-3,-5,-1,-4,1,2,-2,2,2,0,-3,3,-1,3,-4,7,32,12,20,-4,2,2,-10,2,15,-3,0,2,-6,-3,8,-1,2,0,-4,5,7,7,6,6,5,4,4,3,2,3,1,1,2,4,4,3,4,3,2
38,38035,San Miguel de Abona,6645,400,213,187,12,3,9,69,74,157,65,23,9,37,28,92,39,11,4,32,46,65,26,12,5,2,1,3,2,3,1,0,0,1,0,2,0,2,1,2,2,1,1,329,157,172,11,8,3,26,72,132,73,19,5,15,32,54,38,16,2,11,40,78,35,3,3,0,3,1,3,2,2,0,3,1,1,1,2,0,0,0,2,1,0,370,210,160,11,11,0,89,48,147,57,23,3,46,20,83,36,15,7,43,28,64,21,8,-4,4,1,-1,4,3,-1,3,2,0,4,1,0,1,-1,-1,0,2,-1,260,132,128,65,30,35,39,35,87,81,15,7,22,7,50,33,14,5,17,28,37,48,1,2,12,10,9,22,7,6,2,2,0,17,4,5,10,8,9,5,3,1,917,469,448,564,305,259,142,135,254,183,140,52,73,64,140,108,64,21,69,71,114,75,76,31,65,70,94,153,142,36,38,38,48,92,69,19,27,32,46,61,73,17,753,413,340,497,279,218,148,42,237,188,117,20,81,18,122,115,60,15,67,24,115,73,57,5,62,45,108,132,118,32,39,19,73,71,60,17,23,26,35,61,58,15,1240,608,632,569,273,296,250,165,358,230,162,43,99,84,178,114,91,25,151,81,180,116,71,18,87,73,113,119,137,35,34,40,49,57,71,21,53,33,64,62,66,14,1124,580,544,612,324,288,210,174,299,208,150,48,118,88,157,112,62,24,92,86,142,96,88,24,93,80,110,127,147,51,53,37,65,67,68,30,40,43,45,60,79,21,928,463,465,523,263,260,164,95,267,200,130,62,77,42,136,101,67,37,87,53,131,99,63,25,91,54,91,124,106,48,44,28,44,65,49,29,47,26,47,59,57,19,438,213,225,266,127,139,44,25,140,97,95,26,29,1,75,45,44,16,15,24,65,52,51,10,39,30,48,61,66,22,19,6,29,30,28,15,20,24,19,31,38,7,232,73,159,202,93,109,1,10,78,23,85,23,-7,-8,25,13,38,8,8,18,53,10,47,15,9,14,37,37,81,21,9,2,15,18,40,8,0,12,22,19,41,13,338,191,147,250,117,133,33,32,83,42,105,39,33,22,35,36,50,14,0,10,48,6,55,25,4,32,34,55,91,31,4,10,17,28,44,13,0,22,17,27,47,18,563,294,269,346,178,168,72,55,166,106,96,57,34,9,102,54,56,30,38,46,64,52,40,27,60,31,48,95,75,32,26,8,23,54,43,21,34,23,25,41,32,11,458,197,261,190,88,102,86,80,85,103,72,25,54,16,42,40,24,19,32,64,43,63,48,6,30,22,27,30,58,18,17,4,13,8,25,19,13,18,14,22,33,-1,1044,543,501,598,315,283,182,99,267,286,151,46,75,40,136,174,83,28,107,59,131,112,68,18,103,67,116,141,113,54,50,30,63,78,60,31,53,37,53,63,53,23,900,453,447,511,265,246,162,118,272,157,141,45,84,56,134,85,70,22,78,62,138,72,71,23,96,42,133,116,95,27,51,18,67,62,50,16,45,24,66,54,45,11,1211,607,604,807,399,408,193,110,336,297,194,64,120,27,155,152,96,44,73,83,181,145,98,20,123,81,182,188,165,62,64,24,83,98,87,40,59,57,99,90,78,22,1188,611,577,935,448,487,169,181,343,241,166,75,109,88,146,123,91,43,60,93,197,118,75,32,141,144,211,213,157,65,76,65,84,111,73,36,65,79,127,102,84,29
38,38037,Santa Cruz de la Palma,18337,137,78,59,166,74,92,1,54,58,2,10,12,-8,28,35,5,6,11,9,26,23,-3,4,1,15,29,46,47,15,14,4,8,23,24,7,8,11,21,23,23,8,6,46,37,9,206,91,115,1,21,-3,1,6,17,4,24,8,-6,0,5,-3,-3,-11,7,6,12,47,39,67,29,20,2,24,18,28,10,10,0,23,21,39,19,10,2,-62,-6,-56,189,105,84,-52,28,-56,-9,-1,31,-29,16,-19,9,1,17,-23,12,-37,-18,-2,14,47,27,40,42,20,11,23,12,27,26,15,2,24,15,13,16,5,9,-182,-80,-102,235,134,101,-9,-3,-119,-55,-2,6,9,19,-65,-34,-11,5,-18,-22,-54,-21,9,1,56,42,55,39,27,11,37,26,28,26,11,4,19,16,27,13,16,7,-80,-59,-21,164,84,80,-21,7,-62,-14,15,-1,-24,-6,-33,7,4,-2,3,13,-29,-21,11,1,20,26,44,31,31,10,7,14,24,22,11,4,13,12,20,9,20,6,58,40,18,238,108,130,39,55,-24,-42,22,13,33,29,-6,-23,-3,9,6,26,-18,-19,25,4,38,51,49,39,41,20,24,21,25,13,14,10,14,30,24,26,27,10,-171,-107,-64,179,92,87,-31,-12,-94,-38,7,-9,-14,-12,-54,-29,-3,0,-17,0,-40,-9,10,-9,23,39,45,32,26,12,11,17,28,13,13,9,12,22,17,19,13,3,-137,-76,-61,176,81,95,-3,-9,-104,-21,10,0,-6,-2,-53,-8,1,-3,3,-7,-51,-13,9,3,18,39,47,36,28,7,7,16,23,20,12,3,11,23,24,16,16,4,-8,-17,9,203,94,109,4,-1,-38,7,29,0,4,-1,-12,-6,11,-7,0,0,-26,13,18,7,26,22,45,49,44,16,13,15,19,17,21,8,13,7,26,32,23,8,100,17,83,148,73,75,44,52,-44,-5,49,8,9,24,-18,-19,21,3,35,28,-26,14,28,5,18,31,24,27,39,9,7,18,12,14,18,4,11,13,12,13,21,5,-100,-30,-70,165,87,78,-15,8,-69,4,-2,-19,0,12,-24,-2,-5,-12,-15,-4,-45,6,3,-7,14,25,30,65,34,-4,10,14,15,34,15,-2,4,11,15,31,19,-2,-175,-79,-96,74,38,36,4,-36,-132,22,-24,-12,9,-14,-67,-2,-5,-2,-5,-22,-65,24,-19,-10,18,10,-13,58,7,-9,11,3,-5,17,11,-2,7,7,-8,41,-4,-7,-19,10,-29,122,72,50,40,-16,4,-29,8,-9,22,2,-1,-18,14,-4,18,-18,5,-11,-6,-5,17,20,24,30,25,5,10,13,10,15,19,4,7,7,14,15,6,1,-24,-10,-14,89,33,56,10,4,-34,38,-12,-26,-1,8,-16,12,-10,0,11,-4,-18,26,-2,-26,8,13,11,44,13,0,2,10,3,17,-2,3,6,3,8,27,15,-3,-110,-78,-32,68,30,38,9,-23,-42,-25,-12,-9,0,-15,-26,-19,-11,-6,9,-8,-16,-6,-1,-3,14,14,12,21,8,-1,8,7,5,8,1,1,6,7,7,13,7,-2,-94,-44,-50,85,33,52,32,-19,-34,-37,-14,-24,17,-12,-21,-14,-8,-10,15,-7,-13,-23,-6,-14,21,11,9,29,16,-1,3,6,6,15,6,-3,18,5,3,14,10,2,-44,-37,-7,118,58,60,4,7,-39,-23,16,-9,-12,6,-19,-16,9,-5,16,1,-20,-7,7,-4,23,27,16,19,27,5,14,11,8,12,12,0,9,16,8,7,15,5,154,67,87,224,98,126,72,56,-14,40,12,-10,38,13,0,15,14,-11,34,43,-14,25,-2,1,42,60,31,57,31,2,21,30,11,23,18,-5,21,30,20,34,13,7
38,38038,Santa Cruz de Tenerife,213050,-1136,-617,-519,387,208,179,-193,-71,-438,-251,-113,-40,-111,-37,-217,-149,-77,-12,-82,-34,-221,-102,-36,-28,53,31,106,73,72,51,32,15,59,45,36,20,21,16,47,28,36,31,-1840,-972,-868,186,99,87,-236,-217,-624,-418,-247,-102,-169,-94,-322,-214,-134,-42,-67,-123,-302,-204,-113,-60,46,13,33,28,33,28,18,3,21,19,20,15,28,10,12,9,13,13,-859,-446,-413,396,243,153,-261,182,-248,-318,-174,-20,-151,60,-89,-146,-103,-3,-110,122,-159,-172,-71,-17,112,22,58,73,67,58,57,13,49,46,45,31,55,9,9,27,22,27,-1478,-811,-667,809,388,421,-265,-83,-570,-306,-187,-24,-115,-13,-328,-193,-116,-25,-150,-70,-242,-113,-71,1,167,104,145,169,124,94,77,59,69,85,58,37,90,45,76,84,66,57,1363,619,744,2586,1291,1295,166,591,440,153,29,24,101,258,206,88,-20,2,65,333,234,65,49,22,424,582,802,473,196,96,221,272,416,245,87,45,203,310,386,228,109,51,1230,473,757,2338,1153,1185,207,517,347,181,-3,22,96,231,146,50,-38,1,111,286,201,131,35,21,398,578,682,396,184,89,186,278,356,207,73,45,212,300,326,189,111,44,597,208,389,2773,1343,1430,266,490,1,-8,-75,-49,126,187,-24,17,-56,-27,140,303,25,-25,-19,-22,495,699,766,470,232,98,250,300,381,250,113,42,245,399,385,220,119,56,255,-4,259,2450,1190,1260,45,481,-22,-101,-28,-66,40,188,-76,-51,-54,-10,5,293,54,-50,26,-56,418,677,645,404,221,70,224,319,334,201,84,23,194,358,311,203,137,47,962,218,744,2163,979,1184,174,588,141,72,-74,25,70,195,26,-37,-66,5,104,393,115,109,-8,20,346,548,546,390,177,72,176,235,257,155,75,33,170,313,289,235,102,39,-85,-117,32,1095,506,589,-30,229,-161,-8,9,-86,-42,117,-97,-48,-10,-29,12,112,-64,40,19,-57,177,309,270,190,110,23,96,141,115,90,48,8,81,168,155,100,62,15,-2168,-1277,-891,-339,-183,-156,-187,-84,-737,-631,-276,-246,-132,-11,-428,-457,-152,-84,-55,-73,-309,-174,-124,-162,-14,15,-161,-110,-45,-37,1,14,-80,-105,-18,-3,-15,1,-81,-5,-27,-34,-945,-665,-280,264,77,187,-76,37,-521,-228,-72,-77,-47,8,-309,-218,-72,-20,-29,29,-212,-10,0,-57,36,122,-22,51,46,23,21,46,-12,19,-7,7,15,76,-10,32,53,16,650,338,312,724,322,402,118,225,162,105,51,-7,56,92,139,45,5,-6,62,133,23,60,46,-1,121,179,145,161,63,43,55,84,74,66,16,18,66,95,71,95,47,25,-281,-243,-38,69,6,63,-37,193,-242,-34,-85,-64,-27,60,-137,-20,-73,-31,-10,133,-105,-14,-12,-33,38,102,-65,-16,23,-32,23,41,-29,-28,-1,-11,15,61,-36,12,24,-21,-1618,-757,-861,-1408,-711,-697,-192,77,-701,-507,-141,-173,-105,33,-261,-278,-90,-69,-87,44,-440,-229,-51,-104,-87,-24,-513,-483,-180,-134,-31,-36,-215,-275,-105,-56,-56,12,-298,-208,-75,-78,-56,-61,5,165,54,111,212,208,-256,-94,-50,-100,121,102,-176,-43,-25,-63,91,106,-80,-51,-25,-37,141,161,-37,-30,-47,-48,72,75,-6,-40,-22,-39,69,86,-31,10,-25,-9,881,459,422,1225,592,633,225,355,119,15,107,50,158,164,63,-23,62,11,67,191,56,38,45,39,269,316,214,174,156,77,147,154,106,70,61,43,122,162,108,104,95,34,2014,942,1072,2278,1074,1204,411,534,424,364,240,52,213,218,244,122,122,34,198,316,180,242,118,18,432,486,503,399,304,130,212,220,250,180,129,66,220,266,253,219,175,64
38,38039,Santa Úrsula,10186,389,246,143,178,103,75,39,40,148,66,73,18,33,19,82,51,42,15,6,21,66,15,31,3,20,8,46,34,52,15,10,3,26,21,28,12,10,5,20,13,24,3,385,182,203,203,88,115,30,73,133,83,52,11,6,36,72,37,25,5,24,37,61,46,27,6,29,22,45,42,46,16,12,9,16,20,21,10,17,13,29,22,25,6,329,153,176,189,93,96,50,40,129,35,66,2,20,14,64,19,26,4,30,26,65,16,40,-2,38,14,43,31,49,12,16,7,22,18,20,9,22,7,21,13,29,3,388,201,187,213,100,113,28,47,141,92,45,33,10,21,68,58,31,14,18,26,73,34,14,19,32,35,40,46,38,20,15,14,12,25,24,9,17,21,28,21,14,11,367,186,181,227,108,119,43,41,165,48,60,5,22,22,68,29,32,7,21,19,97,19,28,-2,43,28,54,39,49,11,21,18,19,16,23,9,22,10,35,23,26,2,64,41,23,129,63,66,-10,14,20,24,19,1,-1,3,13,18,12,-3,-9,11,7,6,7,4,27,11,30,22,26,13,12,7,16,12,12,4,15,4,14,10,14,9,372,177,195,202,97,105,42,81,109,69,54,17,37,35,48,34,17,7,5,46,61,35,37,10,31,27,50,41,45,8,16,9,25,23,18,6,15,18,25,18,27,2,318,148,170,212,97,115,56,42,63,68,68,12,21,9,16,50,38,8,35,33,47,18,30,4,39,29,45,39,43,16,16,11,16,24,21,9,23,18,29,15,22,7,146,60,86,137,75,62,17,22,5,55,31,19,5,8,5,19,16,6,12,14,0,36,15,13,19,21,29,26,27,15,15,10,12,18,12,8,4,11,17,8,15,7,67,48,19,63,27,36,-20,16,38,0,9,21,-15,17,17,19,-2,7,-5,-1,21,-19,11,14,3,12,17,9,15,5,1,8,7,5,5,0,2,4,10,4,10,5,170,87,83,106,57,49,57,29,25,48,3,10,32,9,16,24,2,5,25,20,9,24,1,5,31,16,23,43,-7,-2,21,3,13,23,-4,-1,10,13,10,20,-3,-1,-7,-24,17,-97,-56,-41,15,6,7,-7,4,-34,-6,8,-8,3,-4,-22,21,-2,15,-10,8,-12,-7,-7,-18,-11,-18,-38,-6,-3,-9,-3,-14,-22,-1,-4,-9,-8,-4,-16,130,75,55,21,9,12,10,36,29,54,22,-17,8,17,20,29,6,-10,2,19,9,25,16,-7,10,13,-3,4,11,-15,5,6,2,0,6,-10,5,7,-5,4,5,-5,50,10,40,55,31,24,30,0,-10,11,19,-5,17,-5,-16,-1,11,0,13,5,6,12,8,-5,13,1,15,2,23,-2,9,2,5,0,14,-1,4,-1,10,2,9,-1,34,15,19,29,17,12,3,6,32,-8,2,-4,8,-5,24,-9,-1,-3,-5,11,8,1,3,-1,3,9,-1,6,8,3,3,5,5,0,2,2,0,4,-6,6,6,1,-417,-210,-207,-375,-192,-183,-10,-23,-55,-76,-120,-132,-12,-4,-30,-28,-66,-68,2,-19,-25,-48,-54,-64,-15,-26,-27,-92,-91,-128,-11,-11,-8,-46,-52,-66,-4,-15,-19,-46,-39,-62,103,50,53,95,51,44,23,6,46,6,16,3,10,11,24,-6,7,3,13,-5,22,12,9,0,32,14,27,19,6,-6,20,7,12,9,6,-4,12,7,15,10,0,-2,273,151,122,218,108,110,12,39,73,68,56,29,18,21,35,38,24,20,-6,18,38,30,32,9,38,36,54,37,30,22,23,20,19,20,13,12,15,16,35,17,17,10
38,38040,Santiago del Teide,8454,98,55,43,20,10,10,6,19,35,22,7,11,7,15,16,10,5,2,-1,4,19,12,2,9,0,1,5,9,2,3,0,0,4,4,2,0,0,1,1,5,0,3,40,29,11,21,11,10,-3,37,8,-1,-10,13,3,18,12,-3,-2,3,-6,19,-4,2,-8,10,4,1,5,2,5,4,2,0,3,1,3,2,2,1,2,1,2,2,-19,-9,-10,18,10,8,-7,18,2,-12,-9,-7,-6,1,8,-6,-5,1,-1,17,-6,-6,-4,-8,9,3,0,5,1,0,4,2,-2,4,0,2,5,1,2,1,1,-2,90,37,53,113,55,58,0,18,38,11,12,7,-5,10,16,10,3,0,5,8,22,1,9,7,15,20,17,23,25,13,6,10,9,11,12,7,9,10,8,12,13,6,355,207,148,439,231,208,34,79,55,45,113,26,10,48,45,25,61,16,24,31,10,20,52,10,57,60,90,81,121,28,31,29,50,43,61,15,26,31,40,38,60,13,252,147,105,340,180,160,22,67,35,35,71,16,27,38,18,14,33,13,-5,29,17,21,38,3,46,42,73,64,87,25,31,25,31,32,42,17,15,17,42,32,45,8,303,142,161,341,170,171,22,39,47,69,97,31,6,6,35,39,48,9,16,33,12,30,49,22,36,35,71,69,98,31,20,15,39,33,51,12,16,20,32,36,47,19,337,167,170,340,165,175,43,49,48,82,72,39,18,28,35,35,26,20,25,21,13,47,46,19,51,49,70,59,77,32,21,25,41,24,36,16,30,24,29,35,41,16,190,76,114,357,177,180,-44,55,30,23,88,32,-36,20,14,7,50,15,-8,35,16,16,38,17,29,61,77,64,89,32,12,23,40,32,46,20,17,38,37,32,43,12,105,57,48,198,95,103,0,16,-25,30,58,25,7,12,-4,7,19,13,-7,4,-21,23,39,12,18,20,25,41,67,26,6,9,14,20,30,16,12,11,11,21,37,10,197,117,80,222,116,106,33,12,24,45,53,28,21,4,13,26,34,19,12,8,11,19,19,9,31,22,38,49,52,28,13,10,18,25,32,16,18,12,20,24,20,12,222,90,132,208,94,114,33,24,59,42,41,24,5,0,27,26,17,16,28,24,32,16,24,8,23,25,34,51,51,23,13,9,13,23,20,15,10,16,21,28,31,8,27,25,2,1,-11,12,0,25,-29,2,38,-8,-1,0,-3,5,25,-1,1,25,-26,-3,13,-7,2,12,-38,-14,36,2,-2,-2,-21,-12,16,9,4,14,-17,-2,20,-7,96,15,81,36,8,28,8,14,41,3,27,1,-10,-2,8,2,9,7,18,16,33,1,18,-6,-16,5,6,0,37,1,-15,-1,-6,2,21,5,-1,6,12,-2,16,-4,435,202,233,371,187,184,65,73,120,71,67,35,28,38,48,36,29,20,37,35,72,35,38,15,64,26,83,86,78,28,29,9,34,53,36,21,35,17,49,33,42,7,-271,-114,-157,-341,-177,-164,38,65,37,-14,-63,-337,19,35,32,-13,-15,-174,19,30,5,-1,-48,-163,24,31,28,-19,-70,-339,11,13,10,-18,-19,-176,13,18,18,-1,-51,-163,-621,-285,-336,-749,-366,-383,104,52,62,4,-60,-785,66,25,36,27,-32,-405,38,27,26,-23,-28,-380,76,42,30,-35,-81,-787,48,18,18,-1,-45,-405,28,24,12,-34,-36,-382,683,312,371,529,252,277,93,96,161,120,115,86,46,31,72,49,61,48,47,65,89,71,54,38,78,60,118,92,101,71,37,21,53,44,55,39,41,39,65,48,46,32
38,38041,"Sauzal, El",7474,110,58,52,51,28,23,2,18,51,24,6,11,0,9,27,15,2,5,2,9,24,9,4,6,5,4,20,9,9,3,2,1,10,6,5,3,3,3,10,3,4,0,178,81,97,66,35,31,31,16,47,53,26,5,10,2,20,30,17,2,21,14,27,23,9,3,13,4,11,14,16,7,6,2,4,10,9,4,7,2,7,4,7,3,144,61,83,47,23,24,23,-4,75,19,22,6,8,5,31,6,10,-1,15,-9,44,13,12,7,6,3,7,8,19,2,4,0,4,5,9,1,2,3,3,3,10,1,92,44,48,45,19,26,23,1,17,24,10,17,15,-2,9,18,2,1,8,3,8,6,8,16,9,3,5,12,12,3,3,1,2,6,4,2,6,2,3,6,8,1,139,81,58,50,31,19,34,11,43,38,11,1,19,11,25,16,10,-1,15,0,18,22,1,2,6,3,14,9,14,4,5,1,10,5,7,3,1,2,4,4,7,1,221,108,113,62,30,32,39,18,77,50,28,9,22,4,44,19,12,6,17,14,33,31,16,3,2,9,8,18,18,7,3,3,3,8,7,6,-1,6,5,10,11,1,183,115,68,55,29,26,22,18,80,20,43,-1,16,2,50,14,27,5,6,16,30,6,16,-6,9,7,9,9,16,5,4,3,3,5,9,5,5,4,6,4,7,0,94,45,49,37,12,25,15,9,29,21,11,3,-1,1,19,13,7,4,16,8,10,8,4,-1,5,4,8,7,5,7,-1,1,4,3,2,3,6,3,4,4,3,4,34,17,17,-6,-9,3,3,3,7,20,8,-1,0,-1,12,16,-5,0,3,4,-5,4,13,-1,2,-2,3,-6,-2,-1,0,-2,1,-3,-5,0,2,0,2,-3,3,-1,-45,-23,-22,22,8,14,-23,-14,-3,-7,5,0,-9,-7,-5,-5,5,0,-14,-7,2,-2,0,0,2,3,8,4,4,1,1,1,2,1,3,0,1,2,6,3,1,1,35,6,29,-13,-8,-5,23,-1,14,7,1,-5,16,2,5,-6,1,-9,7,-3,9,13,0,4,4,-3,4,-3,5,-21,4,-2,1,-2,2,-12,0,-1,3,-1,3,-9,-71,-32,-39,-36,-18,-18,-18,4,-33,-19,14,-18,-8,13,-21,-14,10,-10,-10,-9,-12,-5,4,-8,-1,1,-2,-18,2,-18,1,0,-1,-13,3,-8,-2,1,-1,-5,-1,-10,24,10,14,5,5,0,12,8,-18,23,-4,2,15,-3,-13,8,1,1,-3,11,-5,15,-5,1,-7,4,0,4,7,-3,-1,2,0,0,5,-1,-6,2,0,4,2,-2,-74,-59,-15,-65,-30,-35,12,-25,-3,-7,-3,-48,3,-21,-10,-8,2,-27,9,-4,7,1,-5,-21,7,0,-4,-2,-10,-56,4,0,-3,0,-3,-28,3,0,-1,-2,-7,-28,-122,-55,-67,-72,-37,-35,-21,-20,-12,-6,-17,-46,-10,-12,-2,1,-7,-25,-11,-8,-10,-7,-10,-21,5,-4,-7,0,-16,-50,1,-4,-3,1,-5,-27,4,0,-4,-1,-11,-23,-42,-17,-25,18,11,7,9,-2,0,-28,-11,-16,6,5,-4,-14,-4,-10,3,-7,4,-14,-7,-6,11,0,3,7,1,-5,5,1,2,5,0,-2,6,-1,1,2,1,-3,25,21,4,27,15,12,0,2,7,11,-2,4,1,0,9,-1,5,6,-1,2,-2,12,-7,-2,4,7,0,8,5,2,1,6,0,3,4,1,3,1,0,5,1,1,52,9,43,60,32,28,10,7,9,12,19,-10,-3,-2,1,13,6,-7,13,9,8,-1,13,-3,11,6,11,15,19,-3,4,5,5,11,7,0,7,1,6,4,12,-3
38,38042,"Silos, Los",5230,47,26,21,41,20,21,-2,12,3,5,22,3,-2,3,6,6,10,3,0,9,-3,-1,12,0,5,3,9,6,13,4,2,1,5,4,5,3,3,2,4,2,8,1,46,22,24,51,24,27,3,8,17,6,7,3,1,2,11,1,4,3,2,6,6,5,3,0,3,5,15,12,10,5,2,2,6,6,6,2,1,3,9,6,4,3,12,15,-3,18,12,6,4,-21,6,1,14,3,6,-4,4,-1,7,1,-2,-17,2,2,7,2,0,0,2,5,8,2,0,1,1,4,5,1,0,-1,1,1,3,1,46,24,22,64,32,32,24,12,-17,16,9,3,13,2,-4,7,6,1,11,10,-13,9,3,2,9,8,8,10,19,10,2,5,2,6,10,7,7,3,6,4,9,3,2,-10,12,53,26,27,-4,-8,-7,-1,22,-1,-2,-10,-4,-4,9,1,-2,2,-3,3,13,-2,4,5,9,13,17,5,2,2,5,4,9,4,2,3,4,9,8,1,26,26,0,25,18,7,3,4,11,-5,9,0,4,6,9,1,2,2,-1,-2,2,-6,7,-2,-1,7,9,1,7,0,0,5,6,5,2,-1,-1,2,3,-4,5,1,-47,-8,-39,26,18,8,1,-9,4,-10,-21,-9,0,-4,7,1,-10,-3,1,-5,-3,-11,-11,-6,5,7,9,5,-2,1,1,3,7,5,1,0,4,4,2,0,-3,1,13,16,-3,42,28,14,-2,-5,10,-3,13,1,-1,-7,16,4,6,-3,-1,2,-6,-7,7,4,4,1,16,8,12,1,2,1,12,8,5,0,2,0,4,0,7,1,-25,-5,-20,10,5,5,-14,8,-6,-1,-2,-8,-8,6,0,3,0,-4,-6,2,-6,-4,-2,-4,0,2,5,1,3,-1,0,2,1,2,1,-1,0,0,4,-1,2,0,22,2,20,11,4,7,13,-2,13,-2,4,-7,2,4,3,-8,4,-3,11,-6,10,6,0,-4,2,-3,4,2,6,0,2,-3,1,0,3,1,0,0,3,2,3,-1,-18,-10,-8,11,3,8,-9,-5,-11,-12,14,6,-6,0,-5,-9,7,3,-3,-5,-6,-3,7,3,1,-1,-3,0,9,4,0,0,-2,0,4,1,1,-1,-1,0,5,3,-23,-1,-22,5,5,0,-3,-9,3,-14,4,-3,-3,-4,6,0,3,-1,0,-5,-3,-14,1,-2,1,3,2,0,2,-3,0,2,1,1,2,-1,1,1,1,-1,0,-2,6,11,-5,4,-3,7,3,-3,2,1,3,0,9,-2,-3,4,3,0,-6,-1,5,-3,0,0,1,1,0,-1,0,3,0,0,-2,-1,-1,1,1,1,2,0,1,2,-9,-11,2,12,4,8,-2,-6,-5,1,7,-1,-2,0,-1,-5,1,-5,0,-6,-4,6,6,4,4,1,1,3,7,-5,2,0,0,1,2,-2,2,1,1,2,5,-3,4,-3,7,10,9,1,4,5,-1,-5,4,-5,-1,2,-2,-7,3,-1,5,3,1,2,1,-4,-1,2,5,3,4,-2,1,0,3,1,2,2,-2,2,2,2,2,-4,-71,-32,-39,-66,-34,-32,1,6,10,-15,-5,-68,1,7,2,-8,0,-35,0,-1,8,-7,-5,-33,1,6,-1,-3,-8,-61,1,2,0,-3,-5,-29,0,4,-1,0,-3,-32,88,39,49,63,28,35,28,16,7,12,10,15,16,10,2,-2,8,6,12,6,5,14,2,9,16,6,11,16,12,3,7,2,6,7,5,2,9,4,5,9,7,1,-25,-2,-23,41,24,17,-5,-13,3,-1,7,-14,2,-3,-4,-2,9,-4,-7,-10,7,1,-2,-10,11,4,12,15,7,-8,6,2,5,5,8,-2,5,2,7,10,-1,-6
38,38043,Tacoronte,20349,202,103,99,65,28,37,26,9,82,27,31,25,9,7,44,13,19,9,17,2,38,14,12,16,8,5,17,12,13,10,4,2,6,6,6,4,4,3,11,6,7,6,214,110,104,80,41,39,48,27,65,42,26,3,28,19,18,29,12,2,20,8,47,13,14,1,18,9,11,12,23,7,11,6,2,5,14,3,7,3,9,7,9,4,334,174,160,96,55,41,64,76,128,41,22,-1,33,31,75,20,12,0,31,45,53,21,10,-1,17,15,31,14,15,4,11,8,13,10,9,4,6,7,18,4,6,0,297,154,143,147,72,75,44,9,152,54,29,4,11,15,82,29,13,3,33,-6,70,25,16,1,35,30,31,25,22,3,20,14,17,9,10,2,15,16,14,16,12,1,342,150,192,129,57,72,41,52,105,91,32,10,14,17,46,42,13,10,27,35,59,49,19,0,20,26,36,22,16,9,11,9,16,10,7,4,9,17,20,12,9,5,164,91,73,76,37,39,5,13,97,11,28,8,-1,9,60,5,13,3,6,4,37,6,15,5,9,17,15,12,16,7,4,11,10,5,5,2,5,6,5,7,11,5,289,136,153,99,59,40,45,31,127,38,37,7,19,9,55,23,28,1,26,22,72,15,9,6,29,18,26,10,12,1,20,11,18,3,7,-1,9,7,8,7,5,2,348,155,193,132,70,62,49,39,134,58,35,23,35,17,46,32,7,12,14,22,88,26,28,11,22,35,28,21,18,9,18,17,14,12,5,4,4,18,14,9,13,5,113,50,63,46,14,32,19,-12,67,9,5,17,-5,-4,42,-5,14,4,24,-8,25,14,-9,13,14,9,8,10,1,4,3,1,7,1,1,1,11,8,1,9,0,3,88,65,23,20,11,9,37,10,-20,32,24,4,24,3,-16,34,14,4,13,7,-4,-2,10,0,15,-7,7,8,3,-7,6,-2,2,5,1,-2,9,-5,5,3,2,-5,-40,6,-46,2,0,2,-23,19,-26,-5,-7,3,7,7,-13,0,-2,5,-30,12,-13,-5,-5,-2,6,1,-4,5,-2,-4,5,3,-6,0,-1,-1,1,-2,2,5,-1,-3,37,32,5,-19,-12,-7,6,8,23,-11,13,-2,9,6,10,9,8,-7,-3,2,13,-20,5,5,-2,-6,-2,-9,0,-1,1,-5,-5,-2,0,-1,-3,-1,3,-7,0,0,57,17,40,-24,-13,-11,41,-24,14,21,19,-11,22,-13,2,5,6,2,19,-11,12,16,13,-13,1,0,-11,-6,3,-13,-2,-1,-5,-3,3,-5,3,1,-6,-3,0,-8,85,16,69,-34,-16,-18,-15,29,29,34,7,-13,-5,12,8,1,-2,-2,-10,17,21,33,9,-11,-5,-2,-9,-2,1,-18,0,-3,-5,-2,0,-6,-5,1,-4,0,1,-12,-53,-47,-6,4,5,-1,0,-13,13,-38,-25,-2,-5,-13,-10,-21,-8,5,5,0,23,-17,-17,-7,9,3,0,6,-6,-9,7,-2,0,1,1,-2,2,5,0,5,-7,-7,-85,-58,-27,-21,-7,-14,-20,-2,2,-50,6,-26,-23,-13,6,-8,1,-20,3,11,-4,-42,5,-6,-2,-1,-9,-6,5,-9,-6,-2,-3,6,2,-4,4,1,-6,-12,3,-5,71,41,30,81,45,36,20,14,49,-22,-8,8,28,-3,30,-9,-7,-3,-8,17,19,-13,-1,11,16,21,11,14,12,5,9,8,12,3,6,6,7,13,-1,11,6,-1,157,37,120,102,25,77,9,41,17,40,24,13,-1,21,-4,9,9,-2,10,20,21,31,15,15,22,14,22,25,13,1,9,7,3,0,3,1,13,7,19,25,10,0
38,38044,"Tanque, El",3242,6,-1,7,13,9,4,-3,5,-6,4,5,0,-1,2,-4,0,1,1,-2,3,-2,4,4,-1,0,7,0,2,3,1,0,4,0,2,2,1,0,3,0,0,1,0,12,14,-2,37,23,14,2,0,-2,6,7,3,3,1,0,5,6,2,-1,-1,-2,1,1,1,6,6,6,9,6,4,3,5,3,5,5,2,3,1,3,4,1,2,19,3,16,35,12,23,10,3,7,-9,3,4,2,-2,0,-3,0,3,8,5,7,-6,3,1,12,8,8,1,2,4,5,2,3,1,-1,2,7,6,5,0,3,2,14,14,0,43,22,21,3,10,-6,9,1,-3,4,7,-2,6,0,-1,-1,3,-4,3,1,-2,9,9,10,13,1,1,4,2,7,8,0,1,5,7,3,5,1,0,-29,-12,-17,54,29,25,-18,0,-19,0,14,-3,-9,-3,-8,2,8,-2,-9,3,-11,-2,6,-1,10,13,14,3,12,2,7,6,8,1,7,0,3,7,6,2,5,2,0,-2,2,38,18,20,7,2,-8,-6,2,2,6,4,-3,-10,0,1,1,-2,-5,4,2,1,9,7,6,10,4,1,6,5,2,3,1,1,3,2,4,7,3,0,3,-4,7,33,12,21,-2,1,-8,2,9,1,0,-2,-8,0,7,0,-2,3,0,2,2,1,4,7,6,6,6,3,1,2,3,1,4,1,3,5,3,5,2,2,-16,-17,1,17,10,7,1,0,-7,-8,-2,-1,-1,-2,-2,-10,-2,0,2,2,-5,2,0,-1,8,3,0,3,1,0,6,1,2,0,0,0,2,2,-2,3,1,0,-13,-6,-7,11,1,10,2,0,-9,-3,-2,-5,-5,-3,3,-3,-3,0,7,3,-12,0,1,-5,0,1,1,6,4,-1,-1,-1,0,1,2,0,1,2,1,5,2,-1,-30,-7,-23,-1,0,-1,-5,-9,-6,-2,-5,-3,-1,-2,-2,-3,1,0,-4,-7,-4,1,-6,-3,-1,1,-2,1,-3,3,0,-1,0,0,-1,2,-1,2,-2,1,-2,1,-36,-15,-21,-16,-8,-8,-7,-1,-1,-7,-11,-9,-4,-2,1,-3,-3,-4,-3,1,-2,-4,-8,-5,4,-2,-1,-6,-5,-6,0,-1,0,-2,-2,-3,4,-1,-1,-4,-3,-3,-6,0,-6,3,-1,4,11,-3,11,-6,-11,-9,11,-7,3,2,-5,-5,0,4,8,-8,-6,-4,3,-1,3,3,-2,-3,2,-1,0,1,-1,-2,1,0,3,2,-1,-1,-21,-12,-9,14,8,6,-3,-11,-8,2,0,0,-3,-9,0,1,0,-1,0,-2,-8,1,0,1,6,-2,4,3,0,3,2,-1,2,2,1,2,4,-1,2,1,-1,1,-35,-13,-22,2,6,-4,0,-7,-7,-5,-10,-5,8,-4,-6,-2,-4,-2,-8,-3,-1,-3,-6,-3,-3,1,4,0,-2,1,1,0,4,-1,2,0,-4,1,0,1,-4,1,-32,-14,-18,6,3,3,-11,-3,-18,-2,0,-2,-5,4,-15,1,2,-3,-6,-7,-3,-3,-2,1,0,3,0,-1,5,-1,0,5,-1,0,3,-4,0,-2,1,-1,2,3,-15,-13,-2,2,0,2,-1,-1,-13,3,3,-5,-3,-1,-9,-2,2,0,2,0,-4,5,1,-5,-3,2,1,2,3,-3,-2,0,-1,0,3,0,-1,2,2,2,0,-3,14,-1,15,14,1,13,12,0,-7,11,1,-4,1,-1,0,2,-2,-1,11,1,-7,9,3,-3,4,-1,2,8,2,-1,2,-2,1,4,-2,-2,2,1,1,4,4,1,45,27,18,44,28,16,14,5,8,6,9,-3,3,4,6,7,7,-2,11,1,2,-1,2,-1,12,4,12,6,5,3,6,4,10,3,4,0,6,0,2,3,1,3
38,38045,Tazacorte,6500,74,55,19,29,15,14,7,7,23,12,17,4,9,7,9,10,14,2,-2,0,14,2,3,2,4,1,2,9,10,3,2,1,1,4,6,1,2,0,1,5,4,2,16,-3,19,44,22,22,8,1,0,-3,10,0,7,0,-7,-6,4,-1,1,1,7,3,6,1,12,4,6,7,13,2,7,1,3,3,7,1,5,3,3,4,6,1,-31,-31,0,11,5,6,3,3,-16,-11,-2,-8,-7,1,-10,-7,-2,-6,10,2,-6,-4,0,-2,2,1,3,4,5,-4,2,0,0,3,2,-2,0,1,3,1,3,-2,45,11,34,37,16,21,8,14,1,7,16,-5,2,9,-7,-1,4,0,6,5,8,8,12,-5,7,3,4,9,14,0,4,1,1,5,4,1,3,2,3,4,10,-1,-17,-12,-5,26,14,12,-1,6,-23,4,9,-13,-12,0,-5,2,9,-5,11,6,-18,2,0,-8,3,3,2,10,8,0,0,2,0,6,6,0,3,1,2,4,2,0,25,22,3,35,17,18,-2,6,-6,2,16,8,-3,-7,7,6,14,4,1,13,-13,-4,2,4,4,2,3,6,12,7,3,0,1,1,7,4,1,2,2,5,5,3,112,49,63,45,21,24,17,23,17,28,17,6,9,13,0,17,6,1,8,10,17,11,11,5,6,5,10,14,5,5,1,3,6,9,0,2,5,2,4,5,5,3,30,14,16,59,29,30,-6,13,-8,8,12,11,-5,6,2,1,0,11,-1,7,-10,7,12,0,16,5,10,13,8,6,6,1,5,8,4,4,10,4,5,5,4,2,9,9,0,15,6,9,-1,-1,-2,-10,22,-1,2,-4,2,-7,18,-4,-3,3,-4,-3,4,3,-3,2,2,5,10,-1,0,0,0,1,8,-3,-3,2,2,4,2,2,0,4,-4,21,10,11,-1,5,-41,7,9,14,1,5,-23,7,4,6,-2,0,-18,0,5,8,2,2,3,2,5,7,2,0,3,0,3,2,0,2,0,2,2,5,-45,-24,-21,37,14,23,-16,-14,-6,-11,-4,10,-13,-3,-2,-5,-6,9,-3,-11,-4,-6,2,1,4,9,3,5,9,7,-1,3,0,3,5,4,5,6,3,2,4,3,34,24,10,46,24,22,-8,18,-15,16,18,6,-1,13,-8,8,10,3,-7,5,-7,8,8,3,4,3,2,13,10,14,3,2,0,7,4,8,1,1,2,6,6,6,-31,-8,-23,-18,-4,-14,-9,-2,-7,-16,15,-10,-4,1,4,-18,10,0,-5,-3,-11,2,5,-10,-2,-3,-1,-18,6,-1,-1,1,1,-11,4,2,-1,-4,-2,-7,2,-3,69,45,24,30,22,8,14,0,22,12,17,3,8,2,8,9,13,3,6,-2,14,3,4,0,0,3,5,4,11,7,0,3,2,5,7,5,0,0,3,-1,4,2,-13,2,-15,18,12,6,6,5,-13,-2,3,-10,6,5,-3,-3,2,-3,0,0,-10,1,1,-7,2,-2,3,12,9,-8,3,0,2,5,3,-3,-1,-2,1,7,6,-5,-31,-5,-26,4,-1,5,-22,3,5,-22,4,-3,-11,3,4,-6,-2,5,-11,0,1,-16,6,-8,5,1,5,-2,2,-8,3,2,1,-3,-2,-2,2,-1,4,1,4,-6,32,16,16,52,24,28,14,-3,-7,4,11,10,6,-3,-3,-1,7,5,8,0,-4,5,4,5,9,3,4,14,9,13,4,0,2,9,4,5,5,3,2,5,5,8,8,6,2,52,23,29,2,2,-8,-2,-6,17,1,6,1,-2,-11,10,1,-4,-9,0,5,7,14,8,2,15,2,11,10,6,-2,7,-2,4,4,2,4,8,4,7
38,38046,Tegueste,8853,213,107,106,22,14,8,40,30,76,45,11,8,22,17,34,23,6,4,18,13,42,22,5,4,6,4,2,4,4,2,4,2,1,3,3,1,2,2,1,1,1,1,144,87,57,28,12,16,28,24,35,28,24,5,20,12,17,26,10,2,8,12,18,2,14,3,8,1,10,5,2,2,3,1,4,3,0,1,5,0,6,2,2,1,156,61,95,38,11,27,32,6,53,34,9,13,12,-4,20,20,3,4,20,10,33,14,6,9,7,3,13,6,2,5,4,-1,5,0,-1,2,3,4,8,6,3,3,197,80,117,41,15,26,40,26,60,37,10,20,15,5,25,19,4,8,25,21,35,18,6,12,7,7,11,5,6,5,2,3,2,3,2,3,5,4,9,2,4,2,98,51,47,39,21,18,20,4,38,12,17,4,12,1,18,3,14,-1,8,3,20,9,3,5,7,3,8,9,7,5,4,0,4,6,5,2,3,3,4,3,2,3,137,71,66,30,12,18,38,10,41,34,18,-10,22,0,19,20,10,-1,16,10,22,14,8,-9,8,6,2,8,4,0,3,2,1,4,2,0,5,4,1,4,2,0,68,37,31,37,18,19,-6,21,27,14,6,6,-5,10,19,9,1,3,-1,11,8,5,5,3,2,11,15,1,5,2,-1,7,10,0,2,0,3,4,5,1,3,2,132,61,71,38,13,25,26,18,54,19,5,11,18,5,21,10,2,5,8,13,33,9,3,6,2,11,4,13,6,2,0,3,1,7,1,1,2,8,3,6,5,1,38,34,4,58,31,27,-2,12,6,2,3,21,0,11,15,4,-4,10,-2,1,-9,-2,7,11,7,15,11,13,8,4,4,13,4,5,2,3,3,2,7,8,6,1,35,27,8,23,21,2,12,-2,14,15,-4,0,15,-2,8,12,-6,1,-3,0,6,3,2,-1,-1,13,2,5,2,1,5,10,2,3,0,0,-6,3,0,2,2,1,82,38,44,40,17,23,23,25,16,20,4,-4,13,13,10,1,5,-1,10,12,6,19,-1,-3,8,8,11,6,3,5,4,3,3,3,2,2,4,5,8,3,1,3,64,24,40,7,3,4,16,-8,39,12,7,2,8,-5,21,0,3,0,8,-3,18,12,4,2,3,1,-2,3,1,1,1,0,-2,1,2,1,2,1,0,2,-1,0,105,34,71,10,4,6,20,12,26,30,1,12,14,4,-4,13,1,5,6,8,30,17,0,7,2,3,1,3,2,-2,4,0,-2,1,1,-1,-2,3,3,2,1,-1,0,15,-15,-7,-5,-2,2,9,-18,-2,5,-1,7,3,-7,7,0,2,-5,6,-11,-9,5,-3,1,3,-5,-4,-2,0,0,1,0,-2,-4,0,1,2,-5,-2,2,0,-21,-14,-7,-51,-25,-26,6,-16,-5,14,-6,-13,0,-15,-5,12,1,-5,6,-1,0,2,-7,-8,-4,-16,-18,-6,-1,-8,1,-12,-8,-4,1,-3,-5,-4,-10,-2,-2,-5,-8,-11,3,-5,-6,1,31,-10,-17,1,-17,9,22,-8,-9,-9,-8,2,9,-2,-8,10,-9,7,-1,6,-4,-7,2,-1,-2,5,-2,-6,0,-1,1,1,-2,-1,2,0,19,12,7,31,16,15,9,0,1,1,14,-2,-3,8,-7,7,11,-2,12,-8,8,-6,3,0,6,1,13,2,3,6,3,2,3,2,3,3,3,-1,10,0,0,3,97,53,44,32,20,12,20,5,29,35,-12,16,9,1,13,20,-5,12,11,4,16,15,-7,4,3,6,6,6,0,8,4,4,5,1,1,3,-1,2,1,5,-1,5
38,38047,Tijarafe,2637,70,39,31,58,33,25,9,9,7,24,21,-2,4,7,1,14,13,-1,5,2,6,10,8,-1,8,4,9,20,13,2,5,2,3,12,9,1,3,2,6,8,4,1,25,17,8,26,16,10,0,7,0,15,7,-5,-1,2,-2,13,4,0,1,5,2,2,3,-5,4,1,3,7,10,1,2,0,2,5,6,1,2,1,1,2,4,0,-12,-11,-1,30,9,21,-4,-11,0,8,-4,-3,-4,-5,2,2,-5,-1,0,-6,-2,6,1,-2,7,-2,8,8,5,3,3,-2,4,2,0,1,4,0,4,6,5,2,32,14,18,44,23,21,0,14,4,0,13,0,-1,4,3,3,6,-1,1,10,1,-3,7,1,7,10,7,10,9,1,3,3,4,7,5,1,4,7,3,3,4,0,49,27,22,57,28,29,6,-2,7,16,18,3,9,-3,3,8,8,2,-3,1,4,8,10,1,10,5,11,14,12,4,7,1,6,8,4,2,3,4,5,6,8,2,29,18,11,55,28,27,9,-6,0,13,11,3,6,0,-3,9,6,1,3,-6,3,4,5,2,10,3,10,16,11,5,3,1,6,8,8,2,7,2,4,8,3,3,48,15,33,50,22,28,15,6,10,7,11,-4,6,3,3,-2,3,0,9,3,7,9,8,-4,9,4,12,14,11,-2,3,3,6,7,3,0,6,1,6,7,8,-2,-1,9,-10,53,29,24,-7,0,-16,4,15,4,1,-1,-9,7,12,0,-8,1,-7,-3,3,4,9,3,11,14,12,4,6,1,3,10,8,1,3,2,8,4,4,3,18,1,17,35,16,19,-4,-2,-1,-1,18,6,-8,0,-2,0,6,3,4,-2,1,-1,12,3,2,1,5,2,20,4,0,0,1,2,9,3,2,1,4,0,11,1,26,14,12,30,8,22,5,0,4,2,16,-3,2,-1,1,1,12,-3,3,1,3,1,4,0,4,1,10,1,13,1,1,-2,1,0,9,-1,3,3,9,1,4,2,22,4,18,19,4,15,3,-1,10,12,6,-6,2,1,-2,2,3,-2,1,-2,12,10,3,-4,2,4,7,2,7,-3,2,2,0,-2,3,-1,0,2,7,4,4,-2,23,11,12,45,22,23,-4,5,3,-4,18,3,-3,4,2,-2,8,2,-1,1,1,-2,10,1,8,6,6,13,10,2,4,5,5,5,3,0,4,1,1,8,7,2,36,28,8,22,16,6,7,2,-10,28,14,-3,6,4,-6,15,12,-3,1,-2,-4,13,2,0,4,0,-4,17,4,1,4,-1,0,7,5,1,0,1,-4,10,-1,0,-8,-9,1,12,6,6,8,-1,-4,-2,-1,-7,3,-3,-7,2,0,-3,5,2,3,-4,-1,-4,6,-1,2,4,6,-5,0,-1,-1,3,6,-1,6,0,3,1,0,-4,-120,-55,-65,-100,-45,-55,-17,-13,-16,-21,-14,-38,-8,-9,-3,-9,-9,-18,-9,-4,-13,-12,-5,-20,-8,-3,-24,-17,-16,-33,-4,0,-6,-10,-8,-17,-4,-3,-18,-7,-8,-16,-28,-22,-6,-32,-20,-12,-1,-2,6,-2,-7,-21,-3,-4,6,-5,-4,-12,2,2,0,3,-3,-9,2,1,-4,-5,-11,-15,2,-1,0,-3,-9,-9,0,2,-4,-2,-2,-6,46,24,22,27,17,10,19,4,7,12,12,-10,6,1,5,11,2,-3,13,3,2,1,10,-7,10,-1,9,7,7,-5,5,1,5,6,3,-3,5,-2,4,1,4,-2,-6,-1,-5,11,5,6,-2,1,-2,9,8,-22,2,0,-4,5,8,-11,-4,1,2,4,0,-11,2,2,6,1,6,-7,1,0,1,1,5,-3,1,2,5,0,1,-4
38,38049,Valle Gran Rey,3713,85,34,51,95,49,46,10,15,23,24,14,-1,8,3,8,10,7,-1,2,12,15,14,7,0,14,10,28,23,17,2,11,3,12,10,11,2,3,7,16,13,6,0,129,63,66,66,29,37,10,14,37,38,15,15,3,9,13,24,6,8,7,5,24,14,9,7,4,4,24,19,10,5,0,2,8,11,4,4,4,2,16,8,6,1,200,102,98,134,67,67,27,32,45,43,47,5,12,13,22,24,29,1,15,19,23,19,18,4,14,17,43,33,25,1,6,7,18,20,16,-1,8,10,25,13,9,2,234,106,128,157,73,84,29,28,82,71,15,8,10,12,33,40,1,9,19,16,49,31,14,-1,24,21,42,55,12,2,9,11,19,27,2,4,15,10,23,28,10,-2,145,76,69,164,81,83,14,15,26,54,32,3,-2,5,21,30,20,2,16,10,5,24,12,1,19,15,39,54,26,10,6,5,19,31,16,4,13,10,20,23,10,6,188,110,78,227,110,117,5,31,29,81,29,9,7,8,20,45,18,9,-2,23,9,36,11,0,24,33,56,76,26,9,14,13,22,39,14,6,10,20,34,37,12,3,162,68,94,184,88,96,17,31,45,40,17,12,12,2,28,18,1,6,5,29,17,22,16,6,24,27,55,52,15,10,12,9,29,27,5,5,12,18,26,25,10,5,125,66,59,155,73,82,23,20,14,34,31,2,11,12,8,9,20,4,12,8,6,25,11,-2,22,30,20,53,23,5,10,15,6,21,15,4,12,15,14,32,8,1,-25,-29,4,60,23,37,-7,-15,-10,3,15,-5,3,-16,-12,-3,7,-5,-10,1,2,6,8,0,6,-7,8,30,22,0,3,-10,5,15,11,-2,3,3,3,15,11,2,47,25,22,88,45,43,8,9,-6,5,22,7,1,12,-5,2,8,6,7,-3,-1,3,14,1,10,0,13,30,22,11,5,1,4,16,10,8,5,-1,9,14,12,3,227,148,79,74,32,42,-2,24,56,78,56,15,-5,16,31,55,41,11,3,8,25,23,15,4,12,6,20,20,11,3,4,3,6,11,6,1,8,3,14,9,5,2,-270,-119,-151,-194,-83,-111,-22,-11,-47,-114,-58,-22,-4,-1,-21,-60,-27,-9,-18,-10,-26,-54,-31,-13,-22,-10,-20,-93,-44,-6,-12,-4,-7,-37,-22,-2,-10,-6,-13,-56,-22,-4,-533,-247,-286,-511,-237,-274,-10,2,-61,-225,-156,-82,-7,-3,-21,-93,-74,-48,-3,5,-40,-132,-82,-34,-6,0,-61,-230,-144,-70,-4,-3,-22,-99,-68,-41,-2,3,-39,-131,-76,-29,-45,-28,-17,24,4,20,-2,-3,-8,-4,-20,-8,1,-7,-9,-1,-10,-2,-3,4,1,-3,-10,-6,4,-1,6,12,3,-2,2,-4,2,7,-2,-1,2,3,4,5,5,-1,72,40,32,50,29,21,22,7,12,26,12,-7,15,1,10,9,9,-5,7,6,2,17,3,-2,11,6,8,20,13,-9,10,3,4,8,11,-8,1,3,4,12,2,-1,96,50,46,94,52,42,14,11,23,28,15,2,12,7,8,17,6,0,2,4,15,11,9,2,18,9,17,28,15,6,14,5,7,14,8,4,4,4,10,14,7,2,108,41,67,114,49,65,5,6,17,28,39,10,-1,0,7,8,16,10,6,6,10,20,23,0,21,7,18,23,40,4,8,1,8,7,21,3,13,6,10,16,19,1,136,60,76,128,59,69,15,27,29,21,42,4,9,11,17,7,17,1,6,16,12,14,25,3,13,15,26,29,38,7,7,8,11,15,16,2,6,7,15,14,22,5
38,38050,Vallehermoso,2693,105,57,48,78,41,37,28,-5,9,27,30,16,14,2,1,13,17,10,14,-7,8,14,13,6,23,2,16,17,14,6,13,1,3,10,10,4,10,1,13,7,4,2,160,88,72,39,23,16,18,17,27,23,45,30,8,9,15,17,26,13,10,8,12,6,19,17,5,3,9,8,11,3,3,1,5,4,8,2,2,2,4,4,3,1,134,64,70,50,21,29,17,16,12,33,38,16,8,6,4,17,18,9,9,10,8,16,20,7,7,7,10,8,11,7,4,3,5,2,4,3,3,4,5,6,7,4,102,59,43,48,28,20,4,24,11,20,35,11,4,13,8,8,24,5,0,11,3,12,11,6,6,6,12,9,12,3,5,4,4,5,7,3,1,2,8,4,5,0,-37,-8,-29,29,18,11,-9,-5,-32,-1,9,4,-4,1,-14,2,6,2,-5,-6,-18,-3,3,2,1,6,6,7,8,1,1,4,4,3,5,1,0,2,2,4,3,0,-11,-11,0,22,13,9,-3,-11,-10,4,-1,8,1,-7,-10,1,-1,6,-4,-4,0,3,0,2,0,2,8,4,3,5,0,2,4,2,1,4,0,0,4,2,2,1,53,18,35,47,23,24,6,-1,-1,17,28,5,0,0,-1,1,13,6,6,-1,0,16,15,-1,9,6,8,11,8,6,3,2,4,4,5,5,6,4,4,7,3,1,27,19,8,39,18,21,3,2,5,2,20,-5,7,-1,1,-1,14,-1,-4,3,4,3,6,-4,7,10,2,9,11,0,3,6,1,1,7,0,4,4,1,8,4,0,45,36,9,57,32,25,6,4,-13,18,30,0,2,0,-3,12,22,3,4,4,-10,6,8,-3,7,6,7,15,15,7,3,2,3,10,9,5,4,4,4,5,6,2,4,27,-23,32,20,12,-3,13,-7,14,-1,-12,-2,18,0,12,2,-3,-1,-5,-7,2,-3,-9,4,6,3,10,9,0,0,4,1,6,8,1,4,2,2,4,1,-1,53,21,32,19,4,15,15,11,1,4,24,-2,5,1,0,3,12,0,10,10,1,1,12,-2,2,5,4,2,7,-1,2,1,-1,-1,3,0,0,4,5,3,4,-1,-23,2,-25,21,10,11,-7,-5,-7,-6,13,-13,-5,-2,0,5,9,-7,-2,-3,-7,-11,4,-6,4,0,3,5,7,1,2,0,2,3,2,0,2,0,1,2,5,1,-23,-21,-2,27,8,19,0,-5,-6,-14,9,-7,-3,-2,-2,-13,4,-4,3,-3,-4,-1,5,-3,4,0,7,3,12,1,1,-1,3,1,4,0,3,1,4,2,8,1,12,11,1,9,4,5,-6,0,2,8,11,-3,-3,-1,0,6,11,-1,-3,1,2,2,0,-2,1,-1,7,3,2,-2,3,-1,3,1,1,-2,-2,0,4,2,1,0,40,18,22,19,11,8,0,4,-12,12,26,13,0,2,-7,11,9,4,0,2,-5,1,17,9,1,2,-2,7,5,6,1,1,0,6,0,3,0,1,-2,1,5,3,40,20,20,27,17,10,0,1,-7,19,21,7,-1,0,-2,11,5,8,1,1,-5,8,16,-1,2,-1,3,10,10,3,0,-1,2,8,5,3,2,0,1,2,5,0,33,28,5,28,14,14,12,6,13,5,-3,-1,4,4,3,10,-2,9,8,2,10,-5,-1,-10,2,7,9,7,3,-1,1,5,4,4,1,-1,1,2,5,3,2,0,0,13,-13,29,16,13,1,13,-14,6,8,-13,2,7,-4,6,8,-6,-1,6,-10,0,0,-7,10,3,6,5,4,1,7,0,2,3,2,2,3,3,4,2,2,-1
38,38048,Valverde,3589,235,139,96,52,26,26,49,42,53,53,22,14,31,23,37,30,12,5,18,19,16,23,10,9,10,6,13,8,13,2,8,3,5,5,4,1,2,3,8,3,9,1,227,108,119,127,63,64,37,42,44,69,34,1,19,18,10,39,19,4,18,24,34,30,15,-3,26,24,22,34,17,3,12,9,10,18,12,2,14,15,12,16,5,1,99,62,37,93,50,43,-16,34,22,14,35,8,-2,19,22,4,13,6,-14,15,0,10,22,2,14,9,22,25,16,6,10,6,12,10,8,3,4,3,10,15,8,3,176,82,94,105,49,56,39,36,32,29,20,13,19,9,13,21,12,8,20,27,19,8,8,5,22,16,22,20,18,4,10,7,12,8,11,1,12,9,10,12,7,3,45,44,1,82,49,33,3,11,3,13,18,-2,3,9,12,3,15,1,0,2,-9,10,3,-3,24,15,12,15,13,3,10,10,9,9,8,3,14,5,3,6,5,0,79,49,30,100,50,50,11,37,0,12,20,0,8,23,1,5,13,-1,3,14,-1,7,7,1,19,25,14,12,25,4,10,17,5,4,12,2,9,8,9,8,13,2,-20,-23,3,48,21,27,-15,-9,-1,-1,7,-2,-12,-7,-2,-6,0,3,-3,-2,1,5,7,-5,6,9,10,6,13,2,2,2,7,0,6,2,4,7,3,6,7,0,14,26,-12,48,27,21,-30,20,10,2,10,1,-15,15,7,8,5,4,-15,5,3,-6,5,-3,5,9,7,9,13,4,3,4,5,3,7,4,2,5,2,6,6,0,59,30,29,65,24,41,5,13,17,10,9,3,0,13,9,3,3,3,5,0,8,7,6,0,18,15,12,12,6,1,6,6,7,4,1,0,12,9,5,8,5,1,55,43,12,21,13,8,5,12,-6,26,14,4,2,9,7,18,5,2,3,3,-13,8,9,2,4,3,0,8,2,4,2,3,1,3,3,1,2,0,-1,5,-1,3,20,13,7,26,10,16,-23,-1,24,5,25,-9,-5,-1,9,8,12,-7,-18,0,15,-3,13,-2,-5,7,2,11,7,3,-2,4,0,7,1,0,-3,3,2,4,6,3,113,87,26,21,12,9,5,42,25,28,10,7,9,23,27,17,9,7,-4,19,-2,11,1,0,2,6,6,2,3,2,2,2,5,1,2,0,0,4,1,1,1,2,-84,-48,-36,-63,-30,-33,-10,-7,-40,-21,-6,1,-3,-2,-21,-21,-2,4,-7,-5,-19,0,-4,-3,-5,-6,-27,-15,-8,-2,-2,0,-13,-14,-4,3,-3,-6,-14,-1,-4,-5,-68,-41,-27,-42,-22,-20,8,-2,-16,-14,-27,-16,7,-6,-15,-9,-8,-9,1,4,-1,-5,-19,-7,0,2,-7,-6,-19,-12,-2,-1,-5,-4,-4,-6,2,3,-2,-2,-15,-6,-57,-22,-35,-26,-18,-8,-17,-13,6,-14,-3,-17,-7,-8,2,-6,4,-8,-10,-5,4,-8,-7,-9,-2,-3,-5,-1,-6,-10,0,-3,-5,-4,-2,-4,-2,0,0,3,-4,-6,33,10,23,22,10,12,2,2,4,8,7,8,-7,-5,-1,9,0,12,9,7,5,-1,7,-4,8,2,5,4,4,-2,3,0,-3,4,3,3,5,2,8,0,1,-5,39,6,33,-10,-16,6,13,12,-4,18,-4,4,6,10,-7,1,-8,2,7,2,3,17,4,2,2,4,-6,2,-7,-4,0,1,-5,0,-7,-4,2,3,-1,2,0,0,56,35,21,62,33,29,5,10,20,-2,11,13,2,2,12,3,15,-1,3,8,8,-5,-4,14,7,7,16,16,7,9,4,5,11,5,8,0,3,2,5,11,-1,9
38,38051,"Victoria de Acentejo, La",8122,1,1,0,12,7,5,8,-10,-1,7,-2,-2,5,-7,-3,4,2,0,3,-3,2,3,-4,-2,2,2,2,4,1,1,1,1,1,2,1,1,1,1,1,2,0,0,4,4,0,11,5,6,0,4,11,1,-12,0,0,2,8,1,-7,-1,0,2,3,0,-5,1,1,0,2,3,4,1,0,0,1,3,0,1,1,0,1,0,4,0,32,28,4,15,7,8,0,18,3,15,1,-3,7,13,0,11,-1,-1,-7,5,3,4,2,-2,0,2,3,0,6,4,0,1,2,0,2,2,0,1,1,0,4,2,85,45,40,9,7,2,28,9,37,3,0,8,16,-1,23,3,2,2,12,10,14,0,-2,6,-1,1,3,2,-1,5,-1,1,3,2,-1,3,0,0,0,0,0,2,-10,1,-11,45,24,21,-18,4,2,-16,16,7,-6,1,0,-4,8,2,-12,3,2,-12,8,5,6,9,15,6,6,3,3,5,7,4,4,1,3,4,8,2,2,2,16,17,-1,29,14,15,-19,8,21,-3,7,3,-10,6,16,-1,3,3,-9,2,5,-2,4,0,2,4,10,6,6,1,0,3,4,4,2,1,2,1,6,2,4,0,221,105,116,34,18,16,15,44,92,49,14,5,12,13,51,19,7,2,3,31,41,30,7,3,3,6,9,5,9,1,2,3,5,2,5,0,1,3,4,3,4,1,181,94,87,48,19,29,23,40,80,33,12,-3,12,13,44,24,5,0,11,27,36,9,7,-3,6,7,10,12,9,3,3,1,3,5,5,1,3,6,7,7,4,2,102,66,36,26,15,11,13,15,60,7,10,-2,12,4,26,14,10,0,1,11,34,-7,0,-2,9,3,9,5,2,-2,6,1,2,4,2,0,3,2,7,1,0,-2,16,-11,27,19,7,12,-14,18,13,-12,2,12,-8,8,0,-16,3,6,-6,10,13,4,-1,6,5,1,-3,5,5,5,-1,1,-3,1,4,4,6,0,0,4,1,1,-20,3,-23,18,10,8,3,-5,-40,9,18,-4,11,-6,-13,4,11,-4,-8,1,-27,5,7,0,5,0,4,6,3,-1,3,0,2,4,1,-1,2,0,2,2,2,0,11,8,3,10,6,4,-7,-8,5,-2,19,5,2,-6,10,-12,12,3,-9,-2,-5,10,7,2,-4,2,-2,9,3,2,0,1,-3,4,2,2,-4,1,1,5,1,0,15,7,8,13,4,9,-4,-8,16,11,2,-4,-9,4,5,10,-1,-1,5,-12,11,1,3,-3,1,0,2,6,5,-1,2,0,0,3,0,-1,-1,0,2,3,5,0,41,23,18,0,2,-2,2,-8,32,16,0,-3,-4,2,16,9,2,-1,6,-10,16,7,-2,-2,1,-3,-3,1,4,0,2,-2,-2,2,2,0,-1,-1,-1,-1,2,0,-136,-40,-96,-138,-65,-73,-2,6,-5,-45,-24,-65,11,2,7,-16,-11,-30,-13,4,-12,-29,-13,-35,-3,-10,-12,-38,-16,-59,1,0,-4,-23,-9,-30,-4,-10,-8,-15,-7,-29,-17,5,-22,8,6,2,-2,-2,7,-12,-4,-4,10,5,9,-10,-6,-2,-12,-7,-2,-2,2,-2,1,2,3,2,0,1,0,2,2,0,2,1,1,0,1,2,-2,0,37,33,4,25,15,10,-7,16,17,-4,15,1,-4,12,16,0,10,1,-3,4,1,-4,5,0,1,6,10,-1,7,2,1,4,5,3,1,1,0,2,5,-4,6,1,43,0,43,68,31,37,16,1,18,-4,5,11,9,-6,0,-7,-1,7,7,7,18,3,6,4,19,13,18,3,7,7,6,7,10,2,2,4,13,6,8,1,5,3
38,38052,Vilaflor,1643,10,5,5,28,16,12,-7,3,1,-1,13,0,-7,1,1,1,9,-1,0,2,0,-2,4,1,2,6,7,4,8,1,1,1,6,3,5,0,1,5,1,1,3,1,65,36,29,40,22,18,10,14,11,22,8,-1,6,4,6,16,5,-1,4,10,5,6,3,0,6,5,9,14,5,0,1,1,8,9,3,0,5,4,1,5,2,0,43,28,15,46,23,23,1,1,16,15,10,0,-2,3,11,8,8,0,3,-2,5,7,2,0,8,5,18,10,5,0,1,2,11,6,3,0,7,3,7,4,2,0,105,63,42,39,18,21,15,17,32,17,19,4,6,11,18,12,13,2,9,6,14,5,6,2,6,8,13,5,3,3,2,3,6,3,2,2,4,5,7,2,1,1,35,12,23,27,15,12,2,2,7,14,10,0,1,-2,0,8,6,-1,1,4,7,6,4,1,3,3,4,10,5,2,1,2,4,8,0,0,2,1,0,2,5,2,-7,-1,-6,15,6,9,0,-3,-1,-3,-2,0,3,2,-3,-3,0,0,-3,-5,2,0,-2,0,3,3,4,2,1,1,2,0,1,2,0,1,1,3,3,0,1,0,0,-11,11,27,4,23,5,4,-5,-1,-1,-2,0,-4,-6,-1,-2,2,5,8,1,0,1,-4,10,5,3,5,3,1,0,2,1,0,0,1,10,3,2,5,3,0,-26,-8,-18,13,9,4,-7,-7,-6,0,3,-6,-7,-2,-3,5,0,-1,0,-5,-3,-5,3,-5,1,2,6,2,2,0,1,1,3,2,1,1,0,1,3,0,1,-1,11,10,1,9,6,3,1,-9,-3,19,2,0,-2,-6,-1,12,5,1,3,-3,-2,7,-3,-1,2,1,1,6,-3,2,1,0,0,3,1,1,1,1,1,3,-4,1,-3,0,-3,7,0,7,-5,-2,-3,2,5,0,-4,1,0,2,1,0,-1,-3,-3,0,4,0,0,-1,2,1,4,1,0,-1,-1,1,1,0,0,0,3,0,3,1,-3,-1,-2,9,4,5,2,-5,0,0,5,-3,0,0,-2,1,2,-1,2,-5,2,-1,3,-2,0,2,1,3,1,2,-1,1,1,2,0,1,1,1,0,1,1,1,2,8,-6,2,2,0,-4,8,1,2,-4,-2,1,3,2,2,0,-1,-5,5,-1,0,-4,-1,1,-1,2,2,0,-2,0,0,0,2,1,-1,1,-1,2,0,-1,-1,-4,-5,1,4,3,1,3,6,-15,5,-1,-2,-3,4,-11,3,3,-1,6,2,-4,2,-4,-1,-1,4,-1,3,1,-2,0,1,-1,2,2,-1,-1,3,0,1,-1,-1,-28,-15,-13,6,2,4,-5,-8,-5,-6,-1,-5,-4,-4,-5,5,-4,-3,-1,-4,0,-11,3,-2,1,0,1,2,1,0,0,0,0,1,1,0,1,0,1,1,0,0,-2,-1,-1,4,4,0,5,-2,2,8,-11,-4,1,-3,-1,6,-5,1,4,1,3,2,-6,-5,-1,1,3,3,-1,-1,0,0,0,4,0,0,-1,1,3,-1,-1,-1,-19,-8,-11,9,3,6,-3,1,-2,-12,4,-7,1,1,1,-6,-1,-4,-4,0,-3,-6,5,-3,5,1,2,1,1,-1,2,1,1,-1,0,0,3,0,1,2,1,-1,1,5,-4,17,15,2,0,-2,4,4,-5,-1,3,2,3,-1,-3,0,-3,-4,1,5,-2,-1,4,4,4,1,5,-1,4,4,3,1,3,0,0,0,1,0,2,-1,-30,-20,-10,-46,-30,-16,14,4,0,-15,-13,-21,10,-1,2,-11,-6,-13,4,5,-2,-4,-7,-8,2,0,-3,-12,-15,-18,1,0,0,-10,-9,-12,1,0,-3,-2,-6,-6
38,38053,Villa de Mazo,4645,4,10,-6,25,13,12,-5,6,2,-1,0,2,-4,3,8,2,-1,2,-1,3,-6,-3,1,0,1,5,5,2,10,2,0,3,4,1,3,2,1,2,1,1,7,0,134,64,70,46,24,22,30,10,50,23,19,1,15,-1,23,12,14,-1,15,11,27,11,5,2,9,7,7,6,13,3,6,2,3,2,8,2,3,5,4,4,5,1,83,45,38,56,29,27,8,7,39,17,7,3,3,6,25,4,9,-2,5,1,14,13,-2,5,9,7,22,13,1,3,5,4,11,6,1,2,4,3,11,7,0,1,89,48,41,90,47,43,12,5,30,27,14,2,1,5,17,15,5,4,11,0,13,12,9,-2,11,5,32,18,15,9,6,4,14,10,6,7,5,1,18,8,9,2,-156,-84,-72,3,2,1,-23,-26,-51,-32,-11,-11,-14,-14,-27,-15,-4,-9,-9,-12,-24,-17,-7,-2,0,0,2,1,0,0,0,0,1,1,0,0,0,0,1,0,0,0,94,52,42,65,35,30,8,16,22,12,27,9,4,6,15,8,13,5,4,10,7,4,14,4,10,7,10,10,18,10,9,3,5,4,9,5,1,4,5,6,9,5,29,28,1,50,29,21,-6,18,-9,5,18,3,-4,17,3,0,11,2,-2,1,-12,5,7,1,1,11,5,11,15,7,1,6,2,7,9,4,0,5,3,4,6,3,46,20,26,55,27,28,11,1,0,23,6,5,1,4,-4,12,4,4,10,-3,4,11,2,1,5,4,8,15,13,10,1,5,0,7,8,6,4,-1,8,8,5,4,-78,-30,-48,5,0,5,-27,-11,-17,-3,-10,-9,-9,-5,-8,-1,-6,-2,-18,-6,-9,-2,-4,-7,-1,-1,5,4,2,-4,-1,-1,1,1,0,0,0,0,4,3,2,-4,25,21,4,34,15,19,2,-6,3,14,12,-3,0,-2,6,7,7,2,2,-4,-3,7,5,-5,13,5,3,3,7,3,6,1,1,0,5,2,7,4,2,3,2,1,43,28,15,47,23,24,11,8,12,7,5,2,14,0,6,-2,6,5,-3,8,6,9,-1,-3,13,7,8,6,11,2,7,2,2,1,10,1,6,5,6,5,1,1,14,20,-6,12,10,2,2,2,6,7,10,-15,-2,3,8,7,5,-3,4,-1,-2,0,5,-12,-5,0,3,6,7,1,-1,0,5,2,2,2,-4,0,-2,4,5,-1,34,2,32,10,8,2,-7,1,-1,14,18,6,-3,-8,-3,-1,14,3,-4,9,2,15,4,3,-9,4,6,2,6,0,-2,0,2,5,2,0,-7,4,4,-3,4,0,120,57,63,38,8,30,22,11,41,23,12,8,9,5,25,10,5,1,13,6,16,13,7,7,8,-1,8,10,9,3,2,-3,5,2,3,-1,6,2,3,8,6,4,-25,-30,5,-15,-8,-7,1,-3,-10,-8,-1,-9,-5,-5,-8,-5,-5,-7,6,2,-2,-3,4,-2,-2,3,3,-10,-1,-8,0,1,2,-4,0,-7,-2,2,1,-6,-1,-1,-31,-20,-11,-25,-18,-7,-5,11,-6,1,-6,-34,-3,-1,1,-3,2,-18,-2,12,-7,4,-8,-16,0,3,-5,-1,2,-24,-5,1,1,-2,-1,-12,5,2,-6,1,3,-12,-20,12,-32,53,27,26,0,-11,-9,2,11,-11,12,-2,-2,2,4,-1,-12,-9,-7,0,7,-10,19,0,9,20,5,-1,13,-1,3,9,0,2,6,1,6,11,5,-3,77,32,45,93,45,48,23,10,8,29,11,-5,5,8,4,4,10,-1,18,2,4,25,1,-4,23,14,14,18,17,6,10,11,5,6,13,0,13,3,9,12,4,6
39,39001,Alfoz de Lloredo,2608,-14,0,-14,3,1,2,-6,-9,-3,-4,5,2,0,-3,0,0,3,0,-6,-6,-3,-4,2,2,1,1,1,0,0,0,1,0,0,0,0,0,0,1,1,0,0,0,2,4,-2,3,1,2,6,-2,-9,7,0,0,6,-4,-1,3,1,-1,0,2,-8,4,-1,1,0,0,2,0,1,0,0,0,0,0,1,0,0,0,2,0,0,0,4,7,-3,10,7,3,-3,2,-12,13,6,-2,-1,4,-5,8,4,-3,-2,-2,-7,5,2,1,2,4,1,4,-1,0,2,2,0,3,0,0,0,2,1,1,-1,0,25,8,17,15,7,8,-4,6,-5,9,16,4,-4,2,-2,1,9,2,0,4,-3,8,7,2,2,1,4,4,3,1,1,0,2,2,1,1,1,1,2,2,2,0,17,11,6,14,7,7,8,2,-4,8,6,-3,5,0,-4,8,4,-2,3,2,0,0,2,-1,3,1,5,3,3,-1,1,1,3,1,1,0,2,0,2,2,2,-1,-41,-25,-16,-1,-6,5,-6,-1,-33,2,0,1,-7,1,-13,-3,2,-1,1,-2,-20,5,-2,2,2,2,-2,-2,-1,0,0,0,-2,-3,-1,0,2,2,0,1,0,0,-6,-1,-5,12,5,7,-2,3,-7,-7,6,3,6,-1,-5,-1,1,0,-8,4,-2,-6,5,3,5,0,2,3,1,1,4,-1,1,1,0,0,1,1,1,2,1,1,-15,-13,-2,10,6,4,2,-8,-9,5,4,-9,-3,-6,-10,3,5,-3,5,-2,1,2,-1,-6,0,2,3,6,0,-1,0,-1,3,5,0,-1,0,3,0,1,0,0,7,-8,15,3,-2,5,11,1,2,0,-4,-3,1,-3,0,-3,-4,1,10,4,2,3,0,-4,3,1,-1,0,0,0,0,0,-2,0,0,0,3,1,1,0,0,0,8,9,-1,-1,-2,1,-1,-4,7,-2,7,1,3,-2,4,-1,3,2,-4,-2,3,-1,4,-1,0,-1,1,-3,2,0,0,-1,0,-1,0,0,0,0,1,-2,2,0,-4,1,-5,-1,-1,0,-3,-1,-3,0,6,-2,-2,-1,0,-2,6,0,-1,0,-3,2,0,-2,0,0,2,-4,0,1,1,0,2,-3,-1,0,-1,0,0,-1,1,1,43,18,25,1,1,0,11,8,11,19,-3,-2,4,7,3,9,-2,-2,7,1,8,10,-1,0,-2,0,0,2,1,0,-1,0,0,0,1,1,-1,0,0,2,0,-1,15,12,3,2,0,2,5,0,4,3,7,-2,6,2,1,2,3,-2,-1,-2,3,1,4,0,0,0,1,1,0,0,0,0,0,0,0,0,0,0,1,1,0,0,-13,-2,-11,-2,0,-2,-1,6,-9,-2,-8,0,-3,2,0,-2,-1,2,2,4,-9,0,-7,-2,-1,-2,-2,2,1,0,0,0,-1,1,0,0,-1,-2,-1,1,1,0,5,6,-1,1,2,-1,7,6,0,1,-6,-3,4,2,5,-1,-4,0,3,4,-5,2,-2,-3,3,0,-2,0,0,0,2,0,-1,0,1,0,1,0,-1,0,-1,0,-2,-4,2,2,2,0,0,-8,0,7,-1,1,1,1,-7,3,-2,0,-1,-9,7,4,1,1,0,0,1,2,-2,1,0,0,0,2,-1,1,0,0,1,0,-1,0,5,5,0,1,2,-1,5,6,-3,5,-3,-3,6,3,-8,5,0,0,-1,3,5,0,-3,-3,2,1,-1,0,1,-2,2,0,-1,0,1,0,0,1,0,0,0,-2,-18,-13,-5,2,0,2,1,-1,-7,-5,-1,-3,-1,-3,0,-6,1,-3,2,2,-7,1,-2,0,0,2,1,0,0,-1,-1,1,1,0,0,-1,1,1,0,0,0,0
39,39002,Ampuero,3497,19,14,5,9,6,3,-3,-7,8,6,9,5,-1,-1,5,6,4,1,-2,-6,3,0,5,4,1,0,5,2,0,1,1,0,3,1,0,1,0,0,2,1,0,0,42,20,22,16,10,6,4,2,35,10,-3,-5,0,-2,15,10,-2,-1,4,4,20,0,-1,-4,1,3,5,6,1,0,1,2,2,4,1,0,0,1,3,2,0,0,29,25,4,7,5,2,5,5,17,-5,6,2,5,0,15,3,1,1,0,5,2,-8,5,1,4,0,3,1,-1,0,2,0,1,2,0,0,2,0,2,-1,-1,0,46,13,33,15,5,10,2,8,20,19,-3,-1,1,-2,5,8,0,1,1,10,15,11,-3,-2,6,1,3,4,1,0,2,1,0,1,1,0,4,0,3,3,0,0,3,-1,4,12,5,7,-10,16,11,-9,-1,0,-5,9,4,-5,-2,0,-5,7,7,-4,1,0,2,7,2,2,-1,0,1,4,1,0,-1,0,1,3,1,2,0,0,161,88,73,23,15,8,25,17,70,23,15,9,10,10,43,17,3,3,15,7,27,6,12,6,3,8,4,7,0,1,0,5,4,5,0,1,3,3,0,2,0,0,116,61,55,25,11,14,19,3,34,43,11,5,10,2,23,23,1,2,9,1,11,20,10,3,4,6,7,5,3,0,3,3,1,4,0,0,1,3,6,1,3,0,79,51,28,38,29,9,7,15,26,19,9,6,1,10,18,18,4,4,6,5,8,1,5,2,7,11,8,10,1,0,5,8,5,9,2,0,2,3,3,1,-1,0,96,60,36,19,4,15,3,14,50,12,12,6,4,8,30,12,3,3,-1,6,20,0,9,3,6,6,4,2,1,0,3,1,1,-1,0,0,3,5,3,3,1,0,18,12,6,4,3,1,3,2,-5,3,8,9,2,4,6,-12,7,6,1,-2,-11,15,1,3,1,2,-3,4,0,1,1,2,0,1,-1,1,0,0,-3,3,1,0,33,22,11,6,5,1,13,-2,-4,9,11,4,7,6,-8,6,10,1,6,-8,4,3,1,3,-2,3,5,0,0,0,-1,2,3,1,0,0,-1,1,2,-1,0,0,46,35,11,14,7,7,5,-7,23,12,1,11,2,-5,19,8,3,8,3,-2,4,4,-2,3,3,3,1,1,4,1,2,1,0,0,2,1,1,2,1,1,2,0,10,1,9,-5,-2,-3,11,7,14,-21,-2,0,10,-2,10,-13,-3,-1,1,9,4,-8,1,1,-1,4,-5,-2,-2,1,-1,2,-1,-1,-1,0,0,2,-4,-1,-1,1,-19,-3,-16,-9,-2,-7,4,-10,-4,-16,9,0,4,0,-2,-10,3,0,0,-10,-2,-6,6,0,-3,2,-4,-2,0,-2,-1,2,-2,-1,0,0,-2,0,-2,-1,0,-2,-45,-29,-16,-23,-18,-5,-1,-3,-18,-13,-7,-2,2,-3,-14,-9,-6,1,-3,0,-4,-4,-1,-3,1,-2,-11,-6,-3,-2,1,-1,-7,-6,-4,-1,0,-1,-4,0,1,-1,11,12,-1,6,0,6,14,-5,13,-5,-5,-4,10,-1,11,-4,-2,-2,4,-4,2,-1,-3,-2,-3,2,4,-1,2,1,-1,1,0,-1,0,1,-2,1,4,0,2,0,42,7,35,17,6,11,1,8,7,5,7,14,0,4,-1,-1,2,4,1,4,8,6,5,10,7,3,6,0,0,1,3,0,3,-1,0,1,4,3,3,1,0,0,3,-9,12,-3,-4,1,3,-4,-11,-1,12,8,1,-5,-3,-4,3,2,2,1,-8,3,9,6,-2,2,1,-2,-1,-1,-2,-1,2,-1,-1,-1,0,3,-1,-1,0,0
39,39008,"Astillero, El",13263,448,213,235,72,29,43,69,89,202,34,21,23,27,34,115,20,4,10,42,55,87,14,17,13,6,14,37,10,3,2,1,7,17,2,1,1,5,7,20,8,2,1,349,164,185,100,34,66,40,72,164,54,10,7,25,27,72,31,7,5,15,45,92,23,3,2,17,33,31,14,1,1,5,7,11,9,1,0,12,26,20,5,0,1,298,123,175,42,13,29,42,50,137,35,11,20,21,0,66,14,10,8,21,50,71,21,1,12,7,17,9,7,1,1,2,4,4,3,0,0,5,13,5,4,1,1,335,172,163,52,24,28,31,53,180,18,37,9,28,15,99,12,11,5,3,38,81,6,26,4,9,15,15,8,4,1,4,4,10,4,1,1,5,11,5,4,3,0,116,9,107,85,26,59,-7,27,68,15,1,13,-12,7,10,-2,5,3,5,20,58,17,-4,10,19,18,26,13,5,4,8,4,5,5,3,1,11,14,21,8,2,3,361,169,192,85,47,38,50,49,163,51,30,19,22,20,82,22,15,8,28,29,81,29,15,11,17,19,29,14,4,2,7,9,21,8,2,0,10,10,8,6,2,2,358,164,194,107,42,65,45,80,130,60,27,17,27,30,62,32,6,7,18,50,68,28,21,10,23,22,35,16,9,2,11,6,15,8,2,0,12,16,20,8,7,2,560,273,287,184,97,87,57,129,222,71,53,20,14,62,130,34,21,8,43,67,92,37,32,12,37,50,52,29,11,3,18,25,32,14,4,2,19,25,20,15,7,1,217,123,94,173,89,84,37,51,99,7,13,17,15,29,65,13,-4,8,22,22,34,-6,17,9,42,47,47,24,11,2,19,22,26,15,6,1,23,25,21,9,5,1,140,71,69,107,55,52,-5,16,63,14,18,25,0,5,30,12,8,11,-5,11,33,2,10,14,22,32,34,13,6,0,13,15,15,9,4,-1,9,17,19,4,2,1,107,36,71,84,43,41,14,21,71,14,-5,-5,-13,10,50,4,-5,-2,27,11,21,10,0,-3,18,21,20,16,8,1,9,9,11,8,5,1,9,12,9,8,3,0,229,132,97,84,42,42,18,46,107,20,30,10,9,25,60,18,22,4,9,21,47,2,8,6,16,30,23,8,7,0,4,14,13,5,6,0,12,16,10,3,1,0,-3,-26,23,36,21,15,-1,21,-24,21,-14,-4,-2,1,-20,7,-6,-1,1,20,-4,14,-8,-3,7,7,6,13,4,-1,3,3,8,5,4,-2,4,4,-2,8,0,1,290,155,135,52,28,24,35,58,91,66,21,26,13,29,65,30,12,10,22,29,26,36,9,16,9,16,7,9,7,3,4,10,4,4,4,2,5,6,3,5,3,1,41,27,14,27,9,18,7,7,-8,-1,17,13,14,-4,-10,14,15,-5,-7,11,2,-15,2,18,-1,7,3,10,3,2,-3,2,2,6,1,0,2,5,1,4,2,2,-130,-90,-40,14,12,2,-33,-1,-14,-53,-24,1,-16,-9,-4,-45,-14,-3,-17,8,-10,-8,-10,4,6,7,13,-6,-2,-5,4,3,7,-2,-1,0,2,4,6,-4,-1,-5,35,11,24,88,37,51,2,15,0,-7,14,5,6,7,11,-22,0,3,-4,8,-11,15,14,2,26,14,17,19,9,3,13,6,11,4,1,2,13,8,6,15,8,1,37,36,1,63,36,27,8,10,53,-31,-1,5,5,7,38,-6,2,-6,3,3,15,-25,-3,11,13,11,25,6,6,1,6,6,19,2,3,0,7,5,6,4,3,1
39,39012,Cabezón de la Sal,6988,72,33,39,16,9,7,18,2,37,8,-6,13,9,0,18,5,-7,8,9,2,19,3,1,5,4,3,7,0,1,1,3,1,4,0,0,1,1,2,3,0,1,0,159,79,80,34,20,14,33,48,48,1,11,17,13,26,23,4,3,8,20,22,25,-3,8,9,4,9,9,6,4,2,2,6,5,4,2,1,2,3,4,2,2,1,163,67,96,59,33,26,29,29,30,35,3,35,13,10,17,21,-3,8,16,19,13,14,6,27,10,9,21,14,1,4,7,4,11,10,-1,2,3,5,10,4,2,2,175,89,86,28,11,17,36,13,48,25,19,32,17,-1,28,18,13,15,19,14,20,7,6,17,7,5,7,6,1,2,2,1,3,3,1,1,5,4,4,3,0,1,66,32,34,25,14,11,9,9,15,2,12,15,3,7,15,-4,7,4,6,2,0,6,5,11,4,7,6,6,1,0,2,4,2,4,2,0,2,3,4,2,-1,0,78,6,72,34,17,17,5,23,-2,15,13,22,10,1,-24,2,6,10,-5,22,22,13,7,12,6,11,8,4,3,1,2,6,2,4,2,1,4,5,6,0,1,0,57,21,36,35,12,23,17,-11,27,13,2,11,7,-3,19,-2,0,2,10,-8,8,15,2,9,12,5,11,5,1,1,5,0,5,1,1,0,7,5,6,4,0,1,47,9,38,38,24,14,10,-2,15,0,15,8,5,-3,-9,-4,12,6,5,1,24,4,3,2,3,9,11,10,4,0,2,7,5,6,4,0,1,2,6,4,0,0,83,46,37,43,17,26,21,9,13,12,3,19,18,4,4,2,4,12,3,5,9,10,-1,7,6,14,8,6,4,4,4,5,1,2,2,3,2,9,7,4,2,1,-69,-23,-46,-32,-13,-19,3,-27,-33,-16,-3,6,2,-7,-8,-12,-4,6,1,-20,-25,-4,1,0,-8,-1,-19,-7,-1,3,-4,-1,-8,-2,-1,2,-4,0,-11,-5,0,1,-4,-6,2,24,12,12,11,-1,-25,6,1,4,7,1,-13,-4,3,3,4,-2,-12,10,-2,1,9,7,5,0,3,0,5,2,4,-1,2,0,4,5,1,1,1,0,-17,-5,-12,7,2,5,-11,-14,10,-4,-7,8,-5,-4,9,0,-6,1,-6,-10,1,-4,-1,7,3,0,0,3,0,1,2,0,-1,0,0,1,1,0,1,3,0,0,52,10,42,17,9,8,13,9,4,7,7,13,2,2,3,-5,2,6,11,7,1,12,5,7,2,5,6,2,1,1,1,3,4,1,0,0,1,2,2,1,1,1,39,29,10,17,12,5,19,-7,4,1,1,23,12,-5,8,2,3,8,7,-2,-4,-1,-2,15,6,2,4,4,0,1,4,3,2,2,0,1,2,-1,2,2,0,0,58,15,43,12,9,3,22,8,0,5,-10,26,8,9,-5,-2,-2,6,14,-1,5,7,-8,20,2,2,3,2,2,1,1,2,2,2,1,1,1,0,1,0,1,0,2,-10,12,-3,2,-5,2,-22,-10,1,8,25,2,-17,-5,-3,1,13,0,-5,-5,4,7,12,1,3,-5,-3,2,-1,1,2,-2,0,1,0,0,1,-3,-3,1,-1,22,15,7,14,8,6,9,-15,14,8,-11,17,-1,-3,4,9,-1,9,10,-12,10,-1,-10,8,-2,4,5,1,1,4,-2,1,5,2,0,2,0,3,0,-1,1,2,57,-5,62,16,3,13,24,-5,-21,-7,-1,64,7,4,-23,-5,-3,15,17,-9,2,-2,2,49,4,3,6,2,-2,3,0,2,0,1,0,0,4,1,6,1,-2,3
39,39015,Camaleño,1101,0,6,-6,5,2,3,-3,0,1,-2,6,-2,-1,2,2,-1,4,0,-2,-2,-1,-1,2,-2,0,1,2,0,0,2,0,0,1,0,0,1,0,1,1,0,0,1,22,12,10,13,5,8,3,7,7,4,2,-1,0,7,2,1,2,0,3,0,5,3,0,-1,3,2,2,4,0,2,1,1,1,0,0,2,2,1,1,4,0,0,22,13,9,8,6,2,-4,5,10,-2,10,3,-3,5,5,-2,4,4,-1,0,5,0,6,-1,0,3,2,0,2,1,0,2,1,0,2,1,0,1,1,0,0,0,33,13,20,12,6,6,3,2,6,6,14,2,-2,1,6,2,7,-1,5,1,0,4,7,3,0,2,5,5,1,-1,-1,2,2,4,0,-1,1,0,3,1,1,0,-11,-11,0,16,6,10,-4,-1,-3,-6,2,0,-3,-4,-7,-1,1,2,-1,3,4,-5,1,-2,0,3,7,1,2,3,0,1,1,0,2,2,0,2,6,1,0,1,-9,-1,-8,9,4,5,-6,2,-2,0,3,-6,-3,-1,-1,1,3,0,-3,3,-1,-1,0,-6,0,4,4,1,0,0,0,1,3,0,0,0,0,3,1,1,0,0,11,1,10,10,3,7,-4,8,8,8,-2,-7,-1,4,5,0,-3,-4,-3,4,3,8,1,-3,0,4,2,3,1,0,0,2,1,0,0,0,0,2,1,3,1,0,20,9,11,20,7,13,-1,10,2,5,11,-7,-1,4,0,2,7,-3,0,6,2,3,4,-4,3,8,6,1,2,0,1,2,3,-1,2,0,2,6,3,2,0,0,-20,4,-24,13,10,3,-1,-9,-6,-1,-2,-1,2,-2,0,4,0,0,-3,-7,-6,-5,-2,-1,2,5,2,3,1,0,2,3,3,1,1,0,0,2,-1,2,0,0,-9,2,-11,-3,1,-4,2,0,-4,-3,1,-5,1,2,0,1,1,-3,1,-2,-4,-4,0,-2,2,0,-1,-3,-1,0,1,1,0,-1,0,0,1,-1,-1,-2,-1,0,4,2,2,2,-1,3,0,-1,-1,-1,12,-6,2,0,-1,-4,7,-2,-2,-1,0,3,5,-4,2,-1,0,2,-1,0,2,-1,-1,-1,0,0,0,0,1,3,-1,0,-7,-4,-3,0,2,-2,2,-4,5,2,-6,-7,0,-4,2,1,-1,-2,2,0,3,1,-5,-5,0,1,-1,1,-1,0,0,1,0,1,0,0,0,0,-1,0,-1,0,-13,-15,2,8,1,7,-3,0,-4,-6,-2,1,-3,0,-4,-5,-4,1,0,0,0,-1,2,0,0,0,2,2,2,2,0,0,0,0,0,1,0,0,2,2,2,1,11,9,2,3,2,1,7,-1,7,3,-1,-4,4,0,3,4,0,-2,3,-1,4,-1,-1,-2,0,0,-1,2,2,0,0,0,0,1,1,0,0,0,-1,1,1,0,20,14,6,-1,-2,1,-2,4,3,9,12,-6,0,0,0,6,9,-1,-2,4,3,3,3,-5,1,-1,2,1,-2,-2,0,0,0,0,-1,-1,1,-1,2,1,-1,-1,-14,2,-16,10,4,6,-3,0,4,-5,1,-10,-1,1,2,1,3,-4,-2,-1,2,-6,-2,-6,2,2,2,2,2,0,1,1,0,1,1,0,1,1,2,1,1,0,1,3,-2,8,2,6,0,2,-9,3,5,-2,2,1,-5,0,3,1,-2,1,-4,3,2,-3,1,0,1,4,2,0,1,0,0,0,1,0,0,0,1,4,1,0,-8,5,-13,5,3,2,0,-8,8,-5,-1,-2,1,-2,6,-1,2,-1,-1,-6,2,-4,-3,-1,0,0,3,1,0,1,0,0,3,0,0,0,0,0,0,1,0,1
39,39016,Camargo,22535,319,142,177,72,31,41,64,59,66,61,36,30,23,42,27,29,16,2,41,17,39,32,20,28,11,18,21,12,7,0,5,11,5,6,2,0,6,7,16,6,5,0,570,285,285,109,46,63,127,101,174,99,32,30,60,48,101,46,13,12,67,53,73,53,19,18,19,33,29,22,2,3,12,10,10,11,2,0,7,23,19,11,0,3,933,482,451,112,59,53,159,138,360,175,68,19,83,73,185,94,29,14,76,65,175,81,39,5,30,28,23,20,5,2,11,18,16,10,0,1,19,10,7,10,5,1,1036,500,536,96,36,60,210,128,333,210,92,48,107,58,158,105,39,23,103,70,175,105,53,25,18,28,23,18,3,4,6,9,9,9,1,1,12,19,14,9,2,3,1330,707,623,142,65,77,222,128,589,230,96,44,119,53,312,131,58,21,103,75,277,99,38,23,34,22,42,34,10,0,17,5,18,20,5,0,17,17,24,14,5,0,1377,752,625,266,155,111,232,198,489,260,131,39,118,106,273,154,70,11,114,92,216,106,61,28,48,53,74,64,20,6,18,29,44,49,12,2,30,24,30,15,8,4,568,290,278,246,123,123,91,83,206,102,56,30,39,45,99,47,42,16,52,38,107,55,14,14,49,74,66,41,8,7,22,46,31,18,3,3,27,28,35,23,5,4,305,143,162,280,155,125,67,52,16,115,17,39,29,31,5,62,10,8,38,21,11,53,7,31,49,57,86,67,18,1,26,28,45,47,9,0,23,29,41,20,9,1,121,36,85,222,119,103,12,45,-50,52,22,42,9,23,-30,18,0,19,3,22,-20,34,22,23,53,38,59,50,19,2,22,24,39,27,5,2,31,14,20,23,14,0,-41,-71,30,-23,-46,23,22,12,-114,13,10,9,-4,12,-67,-12,-4,1,26,0,-47,25,14,8,14,2,-17,-18,-4,0,3,-2,-14,-28,-8,3,11,4,-3,10,4,-3,-154,-158,4,-12,-24,12,-27,15,-52,-74,-18,1,-26,-15,-48,-48,-15,-3,-1,30,-4,-26,-3,4,18,11,-15,-14,-11,-3,7,2,-17,-12,-5,0,11,9,2,-2,-6,-3,-10,20,-30,-8,-1,-7,12,-2,-51,0,-4,27,34,-10,-18,-6,4,9,-22,8,-33,6,-8,18,12,14,-11,-26,-4,3,13,7,-3,-21,-1,3,-1,7,-8,-5,-3,0,-167,-116,-51,-91,-57,-34,-12,-20,-83,-46,-29,21,-6,-19,-46,-19,-29,3,-6,-1,-37,-27,0,18,-10,-7,-31,-30,-17,3,-6,-4,-20,-16,-15,4,-4,-3,-11,-14,-2,-1,-244,-140,-104,-60,-46,-14,-3,-49,-114,-71,-26,12,-2,-27,-68,-39,-19,8,-1,-22,-46,-32,-7,4,3,-4,-18,-38,-9,6,-3,-2,-11,-26,-11,7,6,-2,-7,-12,2,-1,-134,-60,-74,23,17,6,-7,-22,-72,-28,-13,14,0,-7,-27,-12,-10,2,-7,-15,-45,-16,-3,12,13,12,5,-3,-3,-3,8,8,3,-1,-1,-1,5,4,2,-2,-2,-2,-17,-24,7,11,-2,13,18,-11,-40,-12,-26,41,4,4,-32,-18,-5,14,14,-15,-8,6,-21,27,11,9,-12,-2,1,3,4,7,-8,-5,-2,1,7,2,-4,3,3,2,20,-2,22,39,28,11,22,-15,16,-22,-9,20,21,-9,11,-25,-11,7,1,-6,5,3,2,13,17,8,11,7,-6,-1,12,5,6,10,-8,0,5,3,5,-3,2,-1,-69,-35,-34,5,5,0,-19,-31,-48,22,-10,15,-13,-15,-10,9,-15,8,-6,-16,-38,13,5,7,9,7,-15,4,-3,2,9,1,-10,1,1,3,0,6,-5,3,-4,-1
39,39020,Castro-Urdiales,16795,1395,709,686,113,45,68,163,168,591,261,120,67,93,59,325,133,58,29,70,109,266,128,62,38,19,23,38,12,10,7,9,7,12,7,1,6,10,16,26,5,9,1,1418,733,685,169,73,96,170,160,585,276,140,69,108,53,285,174,73,33,62,107,300,102,67,36,32,41,57,31,4,2,22,9,25,15,0,1,10,32,32,16,4,1,1201,619,582,161,74,87,125,110,549,223,92,61,71,38,285,119,58,28,54,72,264,104,34,33,39,36,57,16,8,4,18,17,28,5,3,2,21,19,29,11,5,2,1594,819,775,186,81,105,165,196,753,296,90,55,98,76,381,182,45,18,67,120,372,114,45,37,47,43,64,24,4,2,23,19,25,11,3,0,24,24,39,13,1,2,1600,788,812,282,125,157,158,235,725,243,106,97,74,105,366,128,54,37,84,130,359,115,52,60,66,74,80,31,20,8,29,36,35,17,4,3,37,38,45,14,16,5,1054,520,534,288,133,155,75,219,482,130,84,38,29,88,277,64,46,8,46,131,205,66,38,30,67,79,87,39,15,0,32,30,43,18,10,0,35,49,44,21,5,0,991,543,448,378,188,190,74,185,428,140,71,62,61,101,239,80,21,18,13,84,189,60,50,44,78,83,126,66,16,6,42,42,69,27,7,0,36,41,57,39,9,6,995,570,425,581,311,270,88,184,420,152,65,63,57,98,256,88,38,21,31,86,164,64,27,42,117,146,178,100,28,4,59,78,93,58,20,0,58,68,85,42,8,4,643,337,306,285,146,139,40,132,287,81,47,41,14,75,163,28,28,17,26,57,124,53,19,24,50,72,104,36,17,2,25,39,61,14,4,1,25,33,43,22,13,1,339,135,204,100,24,76,43,71,133,19,28,23,7,17,67,19,-1,11,36,54,66,0,29,12,27,47,29,-9,-2,3,11,18,7,-9,-5,0,16,29,22,0,3,3,43,-25,68,-86,-72,-14,-15,41,68,-86,2,27,-5,6,43,-67,-9,3,-10,35,25,-19,11,24,-32,14,-7,-46,-10,-4,-14,-1,-15,-35,-3,-4,-18,15,8,-11,-7,0,-1,13,-14,103,40,63,-1,34,10,-67,-20,34,-10,4,39,-24,-22,18,9,30,-29,-43,2,16,32,26,-2,19,22,3,15,10,2,4,5,2,17,16,-4,15,17,1,-183,-106,-77,-55,-33,-22,-4,-45,-11,-84,-51,-1,3,-17,-11,-58,-29,4,-7,-28,0,-26,-22,-5,7,-7,-25,-24,-4,-5,0,-2,-17,-13,-2,1,7,-5,-8,-11,-2,-6,-215,-189,-26,-187,-143,-44,-14,-68,-42,-79,-39,6,-2,-44,-41,-78,-37,5,-12,-24,-1,-1,-2,1,-22,-13,-76,-43,-30,-5,-3,-17,-50,-50,-24,1,-19,4,-26,7,-6,-6,-257,-200,-57,-132,-84,-48,-14,-20,-73,-121,-73,28,-22,-19,-48,-86,-44,8,8,-1,-25,-35,-29,20,-3,2,-54,-62,-20,3,-4,-1,-27,-45,-8,-1,1,3,-27,-17,-12,4,82,12,70,81,33,48,29,0,82,-30,-13,7,10,-8,39,-12,-29,7,19,8,43,-18,16,0,23,15,21,4,6,11,11,5,6,9,-2,4,12,10,15,-5,8,7,-26,-38,12,82,6,76,40,-16,21,-73,-9,19,10,4,20,-65,-14,5,30,-20,1,-8,5,14,44,20,10,3,-6,7,15,13,-2,-9,-15,3,29,7,12,12,9,4,212,70,142,170,85,85,39,-10,147,1,8,19,20,-8,50,-5,16,-7,19,-2,97,6,-8,26,30,40,48,39,8,0,18,24,27,12,2,0,12,16,21,27,6,0
39,39022,Cillorigo de Liébana,1111,3,1,2,16,4,12,1,1,0,-1,-2,4,0,1,-2,0,-1,3,1,0,2,-1,-1,1,2,2,10,1,0,1,1,0,2,0,0,1,1,2,8,1,0,0,25,15,10,22,12,10,0,14,4,7,1,-2,3,8,1,4,-1,0,-3,6,3,3,2,-2,0,11,6,5,0,0,0,6,3,3,0,0,0,5,3,2,0,0,20,14,6,17,10,7,11,9,-3,-3,6,-2,7,4,-1,-1,3,0,4,5,-2,-2,3,-2,4,6,4,2,0,0,3,3,2,1,0,0,1,3,2,1,0,0,62,20,42,29,9,20,10,12,8,10,14,9,5,3,2,3,7,1,5,9,6,7,7,8,1,8,13,3,3,1,0,2,6,0,1,0,1,6,7,3,2,1,-10,-15,5,6,2,4,0,-7,-3,2,-4,4,-4,-3,-4,-1,-2,1,4,-4,1,3,-2,3,0,1,2,3,-1,1,0,1,0,2,-1,0,0,0,2,1,0,1,57,28,29,22,10,12,15,6,24,8,5,0,7,0,11,6,4,0,8,6,13,2,1,0,5,2,10,3,1,1,1,1,6,1,0,1,4,1,4,2,1,0,21,14,7,18,7,11,-2,7,-1,8,5,2,0,-1,2,5,5,3,-2,8,-3,3,0,-1,0,2,5,5,4,2,0,0,2,3,1,1,0,2,3,2,3,1,73,65,8,67,45,22,18,11,26,18,9,-9,15,12,24,10,8,-4,3,-1,2,8,1,-5,18,17,21,11,0,0,13,11,15,6,0,0,5,6,6,5,0,0,22,7,15,25,9,16,5,6,13,-3,7,-6,3,3,3,-5,5,-1,2,3,10,2,2,-5,5,10,11,0,-1,0,2,7,3,-2,-1,0,3,3,8,2,0,0,38,13,25,8,1,7,10,1,7,12,6,3,4,-2,0,5,4,3,6,3,7,7,2,0,2,0,1,4,1,0,1,-2,1,1,0,0,1,2,0,3,1,0,-2,-5,3,-5,-6,1,0,3,-8,6,-2,-2,1,1,-9,4,-2,-1,-1,2,1,2,0,-1,-2,4,-4,-4,1,-1,0,2,-5,-3,0,-1,-2,2,1,-1,1,0,2,12,-10,6,4,2,7,-8,9,2,-3,-7,6,-6,7,3,1,0,1,-2,2,-1,-4,-7,1,2,1,1,1,0,2,0,2,0,0,0,-1,2,-1,1,1,0,5,3,2,-2,-1,-1,0,7,-7,8,0,-1,-1,4,0,-1,3,-2,1,3,-7,9,-3,1,-1,1,-3,0,0,1,-1,-1,0,-1,1,1,0,2,-3,1,-1,0,14,-5,19,-2,-1,-1,13,-3,0,0,4,0,2,-4,-4,0,4,-2,11,1,4,0,0,2,2,1,-4,-1,-1,1,1,0,-1,-1,0,0,1,1,-3,0,-1,1,-14,-7,-7,2,-2,4,-9,0,1,-9,-1,2,-2,-2,1,-1,-6,2,-7,2,0,-8,5,0,1,1,1,-3,1,1,1,0,-2,-1,-1,1,0,1,3,-2,2,0,-8,-1,-7,-5,-5,0,-6,-3,-3,-3,4,3,-1,-2,-2,0,0,2,-5,-1,-1,-3,4,1,-1,1,1,-5,-1,0,0,-1,0,-4,0,0,-1,2,1,-1,-1,0,19,5,14,16,10,6,4,6,0,10,1,-1,2,3,-1,6,-3,0,2,3,1,4,4,-1,4,3,-2,7,2,2,3,2,-1,5,1,0,1,1,-1,2,1,2,25,-3,28,10,6,4,10,3,12,3,-1,-2,0,1,3,-2,-2,-2,10,2,9,5,1,0,2,3,5,0,2,-2,0,2,5,-1,1,-1,2,1,0,1,1,-1
39,39023,Colindres,6420,181,86,95,35,11,24,34,23,81,19,16,2,16,7,40,8,10,1,18,16,41,11,6,1,7,4,15,5,4,0,4,0,5,0,2,0,3,4,10,5,2,0,86,38,48,60,30,30,25,7,20,15,13,3,11,-2,10,8,6,3,14,9,10,7,7,0,14,7,22,11,3,2,6,4,12,7,1,0,8,3,10,4,2,2,9,6,3,43,25,18,-25,3,29,5,-6,-2,-13,-1,13,11,-5,-1,-12,4,16,-6,-1,-1,8,4,15,13,3,0,3,3,8,9,2,0,5,1,7,4,1,0,73,30,43,79,35,44,5,-1,40,-4,10,23,-7,-4,39,-4,0,5,12,3,1,0,10,18,22,21,22,9,4,1,8,7,15,4,1,0,14,14,7,5,3,1,56,15,41,42,18,24,8,13,21,0,5,5,5,2,3,0,-1,4,3,11,18,0,6,1,8,8,18,4,1,3,4,3,7,2,0,2,4,5,11,2,1,1,87,49,38,62,35,27,27,16,0,36,9,-1,19,4,-2,19,9,1,8,12,2,17,0,-2,14,13,20,10,4,1,12,7,9,6,1,0,2,6,11,4,3,1,94,37,57,80,46,34,35,26,24,-5,12,3,16,15,11,-3,-1,1,19,11,13,-2,13,2,27,13,25,9,5,0,13,10,15,7,0,0,14,3,10,2,5,0,158,72,86,99,49,50,41,13,68,33,-2,2,20,7,31,17,0,-4,21,6,37,16,-2,6,23,22,29,19,4,2,11,13,18,6,1,0,12,9,11,13,3,2,103,64,39,126,61,65,15,17,29,7,15,17,4,17,21,2,9,11,11,0,8,5,6,6,29,27,31,30,7,2,11,13,17,17,3,0,18,14,14,13,4,2,65,35,30,65,34,31,20,5,31,-7,6,3,8,3,11,4,4,1,12,2,20,-11,2,2,13,16,24,4,7,1,7,11,11,3,2,0,6,5,13,1,5,1,74,35,39,33,8,25,18,7,41,-6,6,13,16,1,19,-9,8,2,2,6,22,3,-2,11,10,11,11,-1,1,1,1,3,5,-2,1,0,9,8,6,1,0,1,48,17,31,-52,-28,-24,17,7,34,-18,12,-3,1,1,15,-7,9,-2,16,6,19,-11,3,-1,2,-2,-19,-29,-3,-1,2,1,-14,-18,1,0,0,-3,-5,-11,-4,-1,136,68,68,13,7,6,36,22,44,18,5,15,12,18,17,16,0,4,24,4,27,2,5,11,7,4,0,0,-2,4,2,7,-1,-1,-1,1,5,-3,1,1,-1,3,-61,-8,-53,-28,-11,-17,-8,-3,-15,-25,-10,-3,11,0,-6,-5,-5,-4,-19,-3,-9,-20,-5,1,3,-2,-22,-7,-3,3,5,-1,-8,-5,-2,0,-2,-1,-14,-2,-1,3,-17,-13,-4,4,6,-2,-13,-3,-9,11,6,-4,-4,-2,-4,-4,-2,5,-9,-1,-5,15,8,-9,-1,5,2,-4,0,1,2,3,3,-4,0,1,-3,2,-1,0,0,0,26,-5,31,12,7,5,8,1,11,16,-14,3,5,-3,-3,4,-9,1,3,4,14,12,-5,2,5,4,2,-2,0,3,3,1,4,-3,0,2,2,3,-2,1,0,1,-42,-32,-10,-28,-21,-7,-3,-16,-18,-7,8,-1,-1,-11,-5,-9,0,-4,-2,-5,-13,2,8,3,10,-4,-14,-16,-1,-3,6,-3,-9,-11,-2,-2,4,-1,-5,-5,1,-1,176,87,89,33,16,17,26,-1,51,55,28,10,-1,5,34,30,14,3,27,-6,17,25,14,7,7,5,9,8,1,2,0,4,11,3,-2,0,7,1,-2,5,3,2
39,39024,Comillas,2360,-11,-11,0,3,1,2,-4,-3,-2,-7,7,-1,-2,-2,-3,-4,2,-1,-2,-1,1,-3,5,0,0,0,2,0,1,0,0,0,1,0,0,0,0,0,1,0,1,0,55,27,28,13,5,8,6,2,10,10,9,19,-2,3,10,6,1,10,8,-1,0,4,8,9,1,1,2,6,1,2,0,1,1,2,0,1,1,0,1,4,1,1,19,0,19,8,4,4,5,-6,0,6,8,7,4,-4,-3,2,1,0,1,-2,3,4,7,7,0,2,4,3,0,-1,0,0,2,2,0,0,0,2,2,1,0,-1,77,25,52,13,6,7,7,7,1,7,21,32,-1,3,-3,5,9,11,8,4,4,2,12,21,2,3,1,0,5,2,2,1,0,0,1,2,0,2,1,0,4,0,76,50,26,16,7,9,5,7,9,17,9,29,4,6,6,10,7,17,1,1,3,7,2,12,0,2,6,4,4,0,0,2,2,2,1,0,0,0,4,2,3,0,47,26,21,15,9,6,-2,6,6,-2,18,19,-2,7,1,5,10,5,0,-1,5,-7,8,14,0,4,5,2,3,0,0,3,4,1,1,0,0,1,1,1,2,0,23,8,15,15,4,11,-1,2,16,3,-1,4,-2,2,10,-3,-1,2,1,0,6,6,0,2,2,5,6,0,1,1,0,3,2,-1,0,0,2,2,4,1,1,1,48,-7,55,30,13,17,0,16,6,0,10,17,-2,6,-10,-6,5,1,2,10,16,6,5,16,4,11,7,3,2,3,2,4,2,0,2,3,2,7,5,3,0,0,1,7,-6,30,19,11,14,3,-13,-1,-1,-1,10,3,-6,1,0,-1,4,0,-7,-2,-1,0,13,6,8,5,-1,-1,10,3,4,2,0,0,3,3,4,3,-1,-1,20,14,6,8,4,4,-1,1,7,0,0,15,0,3,11,-2,0,3,-1,-2,-4,2,0,12,0,4,3,2,-1,0,1,0,3,1,-1,0,-1,4,0,1,0,0,-4,4,-8,8,5,3,-1,0,2,-2,-3,0,2,1,0,1,-1,1,-3,-1,2,-3,-2,-1,3,-1,3,4,-1,0,2,-1,2,2,0,0,1,0,1,2,-1,0,17,12,5,8,1,7,3,1,-4,9,5,3,2,-4,-1,10,3,2,1,5,-3,-1,2,1,3,-1,0,1,2,3,3,-1,-3,1,0,1,0,0,3,0,2,2,-10,-4,-6,3,3,0,6,5,-7,-13,2,-4,2,4,0,-12,1,1,4,1,-7,-1,1,-5,-1,5,0,-4,3,-1,0,2,1,-3,2,0,-1,3,-1,-1,1,-1,-59,-33,-26,-9,-6,-3,-3,-9,-23,-16,-6,1,0,-4,-17,-9,-3,2,-3,-5,-6,-7,-3,-1,1,-1,-2,-4,-6,3,-1,1,-2,-4,-2,2,2,-2,0,0,-4,1,-23,-12,-11,-1,-3,2,3,-12,-7,-3,-3,-1,2,-7,-7,3,-2,-1,1,-5,0,-6,-1,0,1,-1,-1,-3,3,0,-1,0,1,-3,1,-1,2,-1,-2,0,2,1,6,-3,9,6,1,5,2,6,3,-5,-3,3,1,3,0,-3,-1,-3,1,3,3,-2,-2,6,1,2,1,-1,1,2,0,0,0,-1,2,0,1,2,1,0,-1,2,-4,1,-5,9,3,6,2,0,1,-6,-3,3,-1,0,5,-4,0,2,3,0,-4,-2,-3,1,5,1,0,1,-1,3,2,0,0,1,-1,1,3,1,0,0,0,2,-16,-7,-9,5,4,1,-11,2,-3,-4,2,-1,-2,1,2,-5,0,-2,-9,1,-5,1,2,1,-3,2,3,1,0,2,1,1,0,0,0,2,-4,1,3,1,0,0
39,39025,"Corrales de Buelna, Los",10657,98,81,17,48,43,5,22,33,43,5,-12,4,11,27,38,5,-5,3,11,6,5,0,-7,1,5,26,12,4,0,1,4,23,12,4,0,0,1,3,0,0,0,1,-6,-4,-2,53,34,19,-20,14,-3,2,4,-2,-15,12,-1,1,1,-1,-5,2,-2,1,3,-1,10,11,16,13,3,0,3,8,10,10,3,0,7,3,6,3,0,0,-46,-27,-19,22,18,4,-1,24,-35,-12,-7,-12,-2,6,-15,-4,-6,-7,1,18,-20,-8,-1,-5,1,9,7,2,3,0,1,6,7,2,2,0,0,3,0,0,1,0,-11,2,-13,55,26,29,-9,22,-11,-16,5,-2,-4,11,-8,1,1,-1,-5,11,-3,-17,4,-1,17,11,16,5,4,2,8,5,5,5,2,1,9,6,11,0,2,1,120,57,63,71,38,33,29,20,34,19,5,9,15,5,19,11,-1,6,14,15,15,8,6,3,14,11,29,13,2,1,5,7,16,10,0,0,9,4,13,3,2,1,111,62,49,81,45,36,27,29,41,7,-4,6,20,19,29,-4,-6,0,7,10,12,11,2,6,15,22,25,14,4,0,10,12,16,6,0,0,5,10,9,8,4,0,145,73,72,93,49,44,14,33,58,14,18,8,10,12,24,11,7,8,4,21,34,3,11,0,16,30,23,17,4,2,11,8,16,9,2,2,5,22,7,8,2,0,250,143,107,141,77,64,56,46,75,45,14,10,23,29,39,32,11,8,33,17,36,13,3,2,33,29,41,28,4,3,15,13,19,22,4,3,18,16,22,6,0,0,82,50,32,94,51,43,28,32,15,-6,8,5,20,14,15,-2,1,1,8,18,0,-4,7,4,25,25,20,13,6,3,13,12,13,8,3,1,12,13,7,5,3,2,-8,-13,5,33,22,11,5,5,-4,4,-3,-11,1,-1,5,-1,-4,-9,4,6,-9,5,1,-2,12,15,9,0,-3,0,8,8,10,0,-4,0,4,7,-1,0,1,0,-14,-40,26,10,-9,19,9,28,-17,-16,-9,-9,2,3,-10,-20,-6,-9,7,25,-7,4,-3,0,10,9,-3,-10,2,2,5,0,-4,-8,-2,0,5,9,1,-2,4,2,-95,-37,-58,14,-2,16,-7,-26,-39,-29,9,0,-2,-5,-25,-14,3,6,-5,-21,-14,-15,6,-6,5,5,-1,3,3,-1,2,-1,-3,-2,1,1,3,6,2,5,2,-2,-83,-50,-33,5,-1,6,-23,5,-40,-18,1,-7,-12,-1,-23,-12,1,-2,-11,6,-17,-6,0,-5,3,6,-5,-2,3,0,4,3,-5,-4,1,0,-1,3,0,2,2,0,-194,-114,-80,-126,-73,-53,-50,-5,-59,-46,-19,-14,-26,0,-28,-41,-11,-7,-24,-5,-31,-5,-8,-7,-24,-5,-50,-29,-16,-2,-12,-2,-24,-23,-12,0,-12,-3,-26,-6,-4,-2,-131,-71,-60,2,-4,6,-15,-16,-37,-45,-10,-15,-17,-13,-12,-21,-4,-8,2,-3,-25,-24,-6,-7,4,5,-1,-5,-1,0,1,-2,2,-3,-1,-1,3,7,-3,-2,0,1,-48,-18,-30,-13,-10,-3,1,-14,-12,-10,-9,-3,6,-1,-14,-7,0,0,-5,-13,2,-3,-9,-3,5,-6,-5,-5,-2,0,-1,-3,-2,-4,0,0,6,-3,-3,-1,-2,0,-9,-4,-5,-7,-3,-4,3,-7,-20,-8,7,14,-2,-1,-7,-2,3,6,5,-6,-13,-6,4,8,-1,2,0,-8,-1,0,-2,2,2,-4,-2,0,1,0,-2,-4,1,0,51,9,42,40,20,20,15,-7,11,9,13,9,8,-5,-2,3,6,-1,7,-2,13,6,7,10,10,10,10,2,2,6,6,5,4,3,-1,3,4,5,6,-1,3,3
39,39028,Entrambasaguas,2476,29,13,16,5,2,3,0,19,10,0,0,-3,-2,5,8,-1,1,0,2,14,2,1,-1,-3,1,0,1,2,0,1,0,0,0,1,0,1,1,0,1,1,0,0,16,11,5,9,2,7,5,-1,8,5,4,-5,1,1,5,2,3,-1,4,-2,3,3,1,-4,1,2,5,1,0,0,0,1,0,1,0,0,1,1,5,0,0,0,30,13,17,4,2,2,3,3,18,0,7,0,-2,3,8,3,2,0,5,0,10,-3,5,0,0,0,1,0,2,1,0,0,0,0,2,0,0,0,1,0,0,1,35,18,17,0,-1,1,5,5,13,4,4,2,2,2,10,1,0,2,3,3,3,3,4,0,-1,2,1,-3,1,0,0,0,0,-1,0,0,-1,2,1,-2,1,0,165,94,71,8,3,5,20,27,75,21,13,6,13,14,41,14,7,3,7,13,34,7,6,3,1,2,2,1,1,1,1,0,0,1,0,1,0,2,2,0,1,0,180,99,81,9,6,3,38,18,83,27,7,7,26,3,43,17,4,5,12,15,40,10,3,2,4,1,2,1,1,0,4,1,1,0,0,0,0,0,1,1,1,0,211,113,98,21,4,17,24,17,110,34,18,4,7,5,64,22,13,0,17,12,46,12,5,4,8,4,4,2,2,1,2,1,1,0,0,0,6,3,3,2,2,1,350,190,160,67,43,24,56,52,141,69,21,7,31,28,75,40,10,4,25,24,66,29,11,3,14,16,14,18,3,2,9,8,10,13,2,1,5,8,4,5,1,1,411,231,180,30,16,14,27,56,216,79,26,3,27,25,114,44,17,-1,0,31,102,35,9,4,2,7,13,6,2,0,1,3,8,3,2,-1,1,4,5,3,0,1,252,126,126,22,13,9,20,44,91,62,9,16,9,15,48,43,0,7,11,29,43,19,9,9,2,7,5,5,-1,3,2,2,3,4,0,1,0,5,2,1,-1,2,142,85,57,4,0,4,4,33,60,12,21,5,9,18,25,11,14,3,-5,15,35,1,7,2,-1,2,0,-1,2,1,0,1,0,-1,-1,1,-1,1,0,0,3,0,149,65,84,-4,-2,-2,19,24,70,36,4,-5,-2,8,36,23,1,-1,21,16,34,13,3,-4,3,0,-2,2,-2,-5,2,-1,-2,0,-1,0,1,1,0,2,-1,-5,87,20,67,12,4,8,14,2,51,21,8,-6,-2,4,17,1,0,-2,16,-2,34,20,8,-4,1,2,8,0,1,0,1,1,3,-2,1,0,0,1,5,2,0,0,95,49,46,-8,-4,-4,0,16,54,13,-1,7,6,3,22,14,-3,4,-6,13,32,-1,2,3,-3,-1,-1,-2,0,-1,-1,-2,0,0,-1,0,-2,1,-1,-2,1,-1,-30,-19,-11,-25,-19,-6,-11,-1,24,-31,-11,-1,-10,0,16,-17,-11,0,-1,-1,8,-14,0,-1,2,-2,-8,-11,-7,0,4,1,-7,-10,-8,0,-2,-3,-1,-1,1,0,-15,-19,4,-28,-22,-6,-6,-2,3,-14,-1,4,2,-4,-5,-11,-3,4,-8,2,8,-3,2,0,-5,1,-9,-8,-6,-1,-2,0,-6,-7,-7,0,-3,1,-3,-1,1,-1,55,13,42,8,0,8,7,12,13,14,0,9,3,4,8,1,-6,3,4,8,5,13,6,6,3,7,-1,-3,1,0,1,3,-3,-3,0,1,2,4,2,0,1,-1,84,45,39,12,8,4,31,-4,37,32,-2,-14,21,-3,13,26,-6,-6,10,-1,24,6,4,-8,4,-1,5,7,-1,-2,3,0,4,4,-1,-2,1,-1,1,3,0,0
39,39030,Guriezo,1717,48,28,20,4,1,3,11,10,15,6,7,-1,8,4,9,5,2,0,3,6,6,1,5,-1,0,0,1,0,3,0,0,0,0,0,1,0,0,0,1,0,2,0,52,28,24,16,9,7,12,5,12,16,10,-3,6,3,5,11,5,-2,6,2,7,5,5,-1,9,0,2,5,0,0,5,0,1,3,0,0,4,0,1,2,0,0,39,16,23,2,1,1,11,-2,14,8,5,-1,6,-1,4,4,2,-1,5,-1,10,4,3,0,1,0,1,0,0,0,1,0,0,0,0,0,0,0,1,0,0,0,124,67,57,12,6,6,21,5,57,23,13,3,14,5,26,16,6,0,7,0,31,7,7,3,1,0,5,4,2,0,1,0,2,2,1,0,0,0,3,2,1,0,22,15,7,6,5,1,0,-4,8,9,6,3,1,4,1,1,5,3,-1,-8,7,8,1,0,0,1,1,3,0,1,0,1,1,1,0,2,0,0,0,2,0,-1,120,74,46,14,9,5,12,11,51,25,11,4,12,5,28,16,6,2,0,6,23,9,5,2,2,2,6,1,2,1,1,1,5,0,1,1,1,1,1,1,1,0,50,33,17,13,5,8,-3,2,31,9,10,-2,0,3,19,5,7,1,-3,-1,12,4,3,-3,2,4,3,5,0,-1,1,3,0,2,0,-1,1,1,3,3,0,0,98,38,60,6,3,3,11,19,39,23,0,6,5,8,19,9,-3,1,6,11,20,14,3,5,1,3,3,-1,1,0,0,2,1,0,1,0,1,1,2,-1,0,0,48,35,13,13,8,5,14,4,22,3,10,-2,11,-2,14,8,2,4,3,6,8,-5,8,-6,3,5,4,2,0,-1,3,2,2,1,0,0,0,3,2,1,0,-1,76,46,30,17,11,6,18,7,40,5,9,-5,12,6,21,1,6,0,6,1,19,4,3,-5,9,0,3,0,4,0,7,1,2,-1,2,0,2,-1,1,1,2,0,47,24,23,8,2,6,3,4,13,21,5,1,5,1,4,16,-1,-1,-2,3,9,5,6,2,1,1,5,0,1,0,0,1,1,0,0,0,1,0,4,0,1,0,-10,-21,11,4,2,2,0,0,-3,-6,2,-1,1,-2,-12,-6,1,-3,-1,2,9,0,1,2,2,0,0,2,0,0,1,0,0,1,0,0,1,0,0,1,0,0,2,4,-2,1,0,1,6,1,8,-5,-4,-3,1,-2,6,-2,-2,1,5,3,2,-3,-2,-4,0,1,0,-2,2,0,0,1,0,-1,0,0,0,0,0,-1,2,0,-34,-8,-26,1,1,0,-12,-3,2,-14,-1,-6,-5,-3,6,-8,3,-1,-7,0,-4,-6,-4,-5,0,-1,0,0,0,2,1,-1,0,0,0,1,-1,0,0,0,0,1,-10,-13,3,-6,-2,-4,1,1,4,-14,5,-5,-5,-3,4,-8,1,-2,6,4,0,-6,4,-3,-2,0,1,-2,-2,-1,-1,1,2,-2,-1,-1,-1,-1,-1,0,-1,0,5,-4,9,2,2,0,6,6,7,-5,-2,-6,4,6,-2,-6,-3,-3,2,0,9,1,1,-3,1,2,1,0,-1,-1,1,2,0,0,0,-1,0,0,1,0,-1,0,-1,6,-7,-3,-3,0,0,3,-5,0,-3,0,0,-4,4,4,0,0,0,7,-9,-4,-3,0,-1,1,-1,-2,1,-1,-1,-1,-1,-2,2,0,0,2,0,0,-1,-1,-21,-7,-14,-8,-3,-5,-13,-6,11,-7,2,-4,-8,-5,4,-1,4,-1,-5,-1,7,-6,-2,-3,0,-4,0,-4,-1,1,0,-4,0,-1,1,1,0,0,0,-3,-2,0
39,39035,Laredo,13155,-75,-76,1,45,13,32,-5,-49,-69,4,13,32,-8,-28,-43,-5,-3,10,3,-21,-26,9,16,22,5,5,15,3,14,3,0,3,5,0,4,1,5,2,10,3,10,2,52,38,14,73,33,40,4,1,4,39,-4,9,8,5,6,17,-2,5,-4,-4,-2,22,-2,4,5,15,27,11,10,5,4,6,11,4,5,3,1,9,16,7,5,2,68,37,31,71,34,37,31,4,2,7,10,15,18,0,-3,7,11,7,13,4,5,0,-1,8,11,15,13,19,6,5,7,6,8,10,0,3,4,9,5,9,6,2,32,-6,38,86,40,46,6,34,-32,10,11,-1,-1,18,-25,0,0,2,7,16,-7,10,11,-3,11,16,28,20,5,6,5,7,14,10,3,1,6,9,14,10,2,5,33,50,-17,124,66,58,-4,3,-8,19,13,11,-2,6,8,10,10,17,-2,-3,-16,9,3,-6,17,23,44,21,14,3,10,9,23,11,7,4,7,14,21,10,7,-1,-43,-20,-23,136,69,67,3,2,-31,-3,-11,-5,5,10,-32,5,-6,-4,-2,-8,1,-8,-5,-1,28,28,43,26,8,3,15,13,19,15,5,2,13,15,24,11,3,1,-151,-92,-59,156,75,81,-11,2,-67,-47,-22,-1,-8,-4,-41,-22,-18,5,-3,6,-26,-25,-4,-6,34,52,38,22,8,1,17,25,18,12,1,1,17,27,20,10,7,0,-138,-79,-59,88,30,58,-10,-22,-85,-14,-14,6,-15,-12,-34,-11,-13,6,5,-10,-51,-3,-1,0,17,15,19,26,7,4,5,7,5,10,3,0,12,8,14,16,4,4,-20,-8,-12,89,50,39,25,9,-21,-9,-18,0,21,7,-16,-12,-7,3,4,2,-5,3,-11,-3,29,30,20,11,-2,1,19,21,6,4,0,0,10,9,14,7,-2,1,-177,-107,-70,18,4,14,-16,-22,-83,-41,-3,-6,-11,-11,-45,-23,-4,-7,-5,-11,-38,-18,1,1,7,-1,7,-1,4,2,2,1,-3,0,2,2,5,-2,10,-1,2,0,-105,-65,-40,16,2,14,-16,-14,-36,-14,-11,-15,-12,-15,-7,-21,0,-9,-4,1,-29,7,-11,-6,10,0,-1,5,3,-2,4,-4,1,1,0,0,6,4,-2,4,3,-2,-91,-48,-43,6,-7,13,14,-28,-52,-9,-13,4,7,-7,-31,-7,-9,2,7,-21,-21,-2,-4,2,12,1,1,-4,-4,0,3,-1,-2,-5,-2,0,9,2,3,1,-2,0,-87,-78,-9,-45,-13,-32,0,-23,-24,-34,-20,13,2,-16,-20,-28,-16,4,-2,-7,-4,-6,-4,9,3,-4,-14,-17,-7,-6,4,0,-7,-6,-1,-3,-1,-4,-7,-11,-6,-3,-54,-61,7,-16,-19,3,13,-8,-18,-17,-27,3,-2,-8,-20,-15,-18,4,15,0,2,-2,-9,-1,-1,-1,-2,-8,-5,1,-5,-4,0,-6,-6,2,4,3,-2,-2,1,-1,-54,-26,-28,1,-5,6,-4,-12,-6,-18,-21,1,2,-3,-5,-12,-4,-7,-6,-9,-1,-6,-17,8,2,3,-3,-8,2,6,0,1,0,-5,-2,1,2,2,-3,-3,4,5,-95,-52,-43,2,1,1,-6,-25,-35,2,-15,-11,-6,-14,-10,-3,-9,-7,0,-11,-25,5,-6,-4,3,3,1,-5,1,-1,0,2,4,-1,-2,-2,3,1,-3,-4,3,1,9,-8,17,3,-7,10,29,5,-23,1,-12,3,15,-2,-13,-4,-9,0,14,7,-10,5,-3,3,7,8,1,-10,-10,4,4,2,-2,-8,-5,2,3,6,3,-2,-5,2,-132,-56,-76,44,26,18,-22,-9,-65,-24,-5,-9,3,-9,-33,-5,-5,-8,-25,0,-32,-19,0,-1,6,5,13,3,13,4,6,4,7,2,5,2,0,1,6,1,8,2
39,39038,Limpias,1311,9,2,7,5,2,3,3,-1,12,2,-4,-2,-3,0,6,3,0,-3,6,-1,6,-1,-4,1,1,0,2,0,2,0,1,0,0,0,1,0,0,0,2,0,1,0,70,41,29,15,9,6,8,13,18,16,9,4,4,7,9,9,9,1,4,6,9,7,0,3,0,4,8,2,1,0,0,2,5,1,1,0,0,2,3,1,0,0,59,37,22,12,5,7,25,-1,15,15,1,3,17,6,12,-1,1,1,8,-7,3,16,0,2,2,2,5,1,1,1,1,1,2,0,0,1,1,1,3,1,1,0,49,20,29,0,0,0,23,5,6,10,1,4,9,2,-6,13,2,0,14,3,12,-3,-1,4,0,0,1,1,-1,-1,0,0,0,1,0,-1,0,0,1,0,-1,0,39,21,18,5,4,1,15,-3,24,1,-4,3,8,2,8,1,-1,0,7,-5,16,0,-3,3,2,1,0,1,0,1,2,1,0,0,0,1,0,0,0,1,0,0,-3,2,-5,4,3,1,-10,4,-2,-6,2,7,-5,1,0,-1,1,4,-5,3,-2,-5,1,3,2,0,0,1,1,0,0,1,0,1,1,0,2,-1,0,0,0,0,56,38,18,5,3,2,9,-2,23,13,5,2,4,-1,18,10,0,3,5,-1,5,3,5,-1,1,2,1,0,0,0,1,0,1,0,0,0,0,2,0,0,0,0,102,70,32,16,8,8,7,9,59,19,1,2,7,4,36,15,3,2,0,5,23,4,-2,0,4,1,7,3,1,0,2,1,3,1,1,0,2,0,4,2,0,0,74,45,29,6,2,4,15,3,33,12,10,-4,4,0,20,11,10,-3,11,3,13,1,0,-1,2,2,3,0,-1,0,0,1,2,0,-1,0,2,1,1,0,0,0,35,22,13,12,6,6,-9,10,25,4,5,-3,-5,8,9,8,4,-3,-4,2,16,-4,1,0,3,5,2,0,1,1,1,3,1,0,0,1,2,2,1,0,1,0,19,2,17,2,2,0,9,3,14,3,-12,-1,7,-2,0,6,-10,-1,2,5,14,-3,-2,0,4,0,-1,-2,-1,0,3,0,-1,0,0,0,1,0,0,-2,-1,0,61,34,27,1,0,1,4,11,-5,5,5,37,2,5,7,1,2,16,2,6,-12,4,3,21,-1,0,-2,1,2,1,-1,0,-2,1,1,1,0,0,0,0,1,0,-3,0,-3,-11,-9,-2,-18,3,-8,5,4,8,-7,1,-4,6,3,2,-11,2,-4,-1,1,6,-6,0,-4,-2,2,0,-4,-1,-3,-1,1,0,-2,1,-1,-1,1,0,-33,-9,-24,4,3,1,-21,-6,-6,-2,-1,4,-12,-3,1,7,-1,-1,-9,-3,-7,-9,0,5,0,1,1,1,1,0,0,1,1,1,0,0,0,0,0,0,1,0,-30,-14,-16,-7,-3,-4,-7,3,-4,-15,-9,2,-2,2,-3,-9,-4,2,-5,1,-1,-6,-5,0,-3,0,2,-3,-1,-2,-1,0,0,-2,1,-1,-2,0,2,-1,-2,-1,9,6,3,3,2,1,-2,-2,-3,-13,3,21,-3,0,-2,-6,1,12,1,-2,-1,-7,2,9,0,2,0,0,0,0,0,1,0,0,0,0,0,1,0,0,0,0,23,14,9,3,3,0,-3,1,0,3,3,16,2,2,-2,-1,1,10,-5,-1,2,4,2,6,1,-2,3,1,1,-1,1,0,1,1,0,0,0,-2,2,0,1,-1,38,25,13,1,2,-1,4,0,19,2,7,6,6,1,8,4,3,4,-2,-1,11,-2,4,2,0,1,1,0,-1,0,0,1,1,1,-1,0,0,0,0,-1,0,0
39,39040,Marina de Cudeyo,4597,69,42,27,14,4,10,8,12,20,16,3,9,3,13,8,10,1,6,5,-1,12,6,2,3,1,4,4,3,0,2,0,2,2,0,0,0,1,2,2,3,0,2,80,38,42,30,16,14,19,21,27,10,7,-4,11,9,9,6,2,0,8,12,18,4,5,-4,14,3,6,6,0,0,10,1,3,1,0,0,4,2,3,5,0,0,-11,5,-16,16,13,3,8,-9,-19,-1,6,3,9,6,-11,-2,3,-1,-1,-15,-8,1,3,4,5,2,1,3,4,1,4,2,3,2,2,0,1,0,-2,1,2,1,-5,-4,-1,9,0,9,11,-2,-24,13,7,-11,5,3,-18,4,8,-6,6,-5,-6,9,-1,-5,0,3,0,6,0,0,0,1,-1,0,0,0,0,2,1,6,0,0,-70,-27,-43,15,8,7,-14,-5,-31,-24,3,3,0,2,-14,-14,3,0,-14,-7,-17,-10,0,3,6,3,1,2,2,1,5,0,0,1,1,1,1,3,1,1,1,0,-9,2,-11,16,7,9,-2,12,-11,1,-2,-7,1,4,-4,5,-1,-3,-3,8,-7,-4,-1,-4,3,5,-1,5,2,2,2,1,0,2,1,1,1,4,-1,3,1,1,122,51,71,23,10,13,19,2,48,35,11,7,4,0,20,21,5,4,15,2,28,14,6,3,7,6,5,7,-1,-1,3,2,2,4,0,-1,4,4,3,3,-1,0,92,41,51,31,14,17,20,16,21,31,8,-6,6,6,12,13,8,-5,14,10,9,18,0,-1,8,7,4,8,2,1,3,2,1,7,1,0,5,5,3,1,1,1,6,-12,18,15,8,7,8,-15,-3,13,0,0,6,-12,-3,-1,-1,-3,2,-3,0,14,1,3,-1,3,4,7,2,0,0,2,3,2,1,0,-1,1,1,5,1,0,21,19,2,16,10,6,13,-5,6,9,-2,-3,14,-4,4,4,2,-3,-1,-1,2,5,-4,0,5,2,2,4,2,1,4,0,2,3,0,1,1,2,0,1,2,0,-32,-18,-14,7,-2,9,-3,-6,-7,-12,4,-2,0,-1,-11,-3,1,0,-3,-5,4,-9,3,-2,4,3,4,-5,1,0,2,1,1,-6,0,0,2,2,3,1,1,0,5,7,-2,0,-1,1,0,-6,14,4,-5,-4,3,-5,20,-5,-2,-5,-3,-1,-6,9,-3,1,2,-2,4,-2,-1,-1,1,-2,2,-1,0,-1,1,0,2,-1,-1,0,25,-4,29,9,6,3,13,0,3,11,-4,4,4,-1,-4,2,-7,4,9,1,7,9,3,0,7,0,-2,1,2,1,5,1,0,-1,1,0,2,-1,-2,2,1,1,-45,-15,-30,-5,-8,3,-11,-5,-28,-3,-4,7,-4,0,-12,-1,-3,4,-7,-5,-16,-2,-1,3,-1,0,-4,-4,2,2,-2,0,-2,-5,0,1,1,0,-2,1,2,1,-10,-5,-5,-2,-2,0,9,-5,-3,-11,7,-10,9,-4,-4,-10,7,-3,0,-1,1,-1,0,-7,0,0,-4,3,-1,0,0,-1,-1,0,0,0,0,1,-3,3,-1,0,8,-5,13,7,3,4,1,7,7,0,-2,-2,-4,1,5,-2,-2,-2,5,6,2,2,0,0,3,3,-2,4,-2,1,2,1,-1,2,-2,1,1,2,-1,2,0,0,8,-7,15,9,0,9,-4,-5,16,-1,2,-6,-5,-8,4,-1,0,2,1,3,12,0,2,-8,1,1,2,6,-1,0,0,1,0,1,-2,0,1,0,2,5,1,0,-4,1,-5,4,-1,5,-1,-1,-15,-3,11,8,-3,3,-6,-4,8,5,2,-4,-9,1,3,3,1,1,-1,0,2,1,1,-2,1,-1,0,0,0,3,-2,1,2,1
39,39042,Medio Cudeyo,6093,102,50,52,21,9,12,25,6,40,22,7,-2,17,-2,18,12,3,1,8,8,22,10,4,-3,1,6,9,5,0,0,0,1,4,4,0,0,1,5,5,1,0,0,93,43,50,30,17,13,24,21,14,13,12,4,8,11,11,5,5,1,16,10,3,8,7,3,3,9,9,3,4,0,2,6,4,3,1,0,1,3,5,0,3,0,108,46,62,49,30,19,25,-4,31,39,15,1,10,-4,21,15,4,0,15,0,10,24,11,1,12,8,20,6,3,-1,6,3,14,4,2,0,6,5,6,2,1,-1,191,105,86,39,17,22,42,23,63,29,18,14,32,16,28,6,10,13,10,7,35,23,8,1,12,4,9,9,4,1,5,2,5,3,1,1,7,2,4,6,3,0,197,110,87,83,40,43,59,32,54,42,11,-5,37,14,30,19,8,2,22,18,24,23,3,-7,26,18,18,15,3,2,16,3,12,7,2,0,10,15,6,8,1,2,273,143,130,71,34,37,61,35,84,84,3,3,34,17,29,52,8,2,27,18,55,32,-5,1,8,12,30,22,-1,0,3,3,13,15,0,0,5,9,17,7,-1,0,113,63,50,77,37,40,10,31,55,4,7,1,0,15,38,3,6,-2,10,16,17,1,1,3,20,12,16,19,9,1,5,6,10,12,4,0,15,6,6,7,5,1,44,48,-4,66,33,33,-5,5,30,10,-2,3,3,1,21,16,4,0,-8,4,9,-6,-6,3,13,22,17,11,2,1,10,9,5,7,1,1,3,13,12,4,1,0,146,87,59,65,34,31,34,20,43,34,14,-5,9,12,36,19,7,-1,25,8,7,15,7,-4,14,16,29,8,1,-3,7,5,20,2,1,-1,7,11,9,6,0,-2,28,12,16,4,-4,8,21,35,-1,-11,-12,3,8,26,5,-18,-1,0,13,9,-6,7,-11,3,10,11,0,-9,-9,0,9,7,-1,-12,-7,0,1,4,1,3,-2,0,-14,-5,-9,22,9,13,-5,-17,1,-16,10,13,1,-10,8,-13,3,7,-6,-7,-7,-3,7,6,9,9,2,-5,4,1,7,4,-2,-3,2,0,2,5,4,-2,2,1,3,5,-2,-6,-10,4,-1,8,-37,0,16,17,8,6,-25,6,0,7,-9,2,-12,-6,16,10,-5,5,-10,-4,6,-1,-2,0,-6,-1,-1,0,-3,5,-4,-3,7,-1,7,-3,10,1,-10,11,16,6,-17,9,-9,1,12,-9,-5,5,-8,1,4,15,-12,4,-1,0,1,-2,1,-2,0,2,-1,-5,-1,-2,-2,1,2,3,2,0,2,1,27,25,2,-17,-7,-10,14,3,-5,14,4,-2,14,-7,2,16,3,-1,0,10,-7,-2,1,-1,1,0,-16,-1,-2,0,-2,4,-11,1,0,0,3,-4,-5,-2,-2,0,-51,-23,-28,-5,-4,-1,-19,-5,7,-36,4,0,-11,-3,4,-12,-1,0,-8,-2,3,-24,5,0,-1,-2,1,-1,-2,0,-1,-1,1,-1,-2,0,0,-1,0,0,0,0,8,6,2,24,9,15,6,11,-15,7,-2,0,10,5,-10,1,-2,2,-4,6,-5,6,0,-2,5,7,2,8,3,-1,3,4,-1,3,1,-1,2,3,3,5,2,0,-39,-32,-7,1,-5,6,5,-20,1,-17,-10,3,-1,-11,0,-11,-10,1,6,-9,1,-6,0,2,10,-3,-1,-5,-1,0,5,-1,1,-7,-3,-1,5,-2,-2,2,2,1,69,21,48,29,7,22,19,20,-3,36,-6,2,4,7,-5,14,0,1,15,13,2,22,-6,1,9,9,4,2,3,2,3,4,-1,-1,1,1,6,5,5,3,2,1
39,39046,Molledo,1955,-5,2,-7,9,7,2,-4,-1,-7,3,3,-1,-1,4,-5,2,2,-1,-3,-5,-2,1,1,0,0,4,2,1,1,1,0,4,2,1,0,0,0,0,0,0,1,1,-14,-3,-11,6,4,2,-4,-1,-2,-1,1,-6,0,1,-3,0,2,-2,-4,-2,1,-1,-1,-4,0,2,2,0,0,2,0,2,1,0,0,1,0,0,1,0,0,1,17,13,4,8,6,2,7,10,-4,6,-2,0,2,5,2,5,-1,0,5,5,-6,1,-1,0,1,3,1,0,0,3,1,2,1,0,0,2,0,1,0,0,0,1,27,11,16,2,2,0,5,5,0,10,3,4,4,0,-2,6,2,1,1,5,2,4,1,3,0,3,-1,-1,0,0,0,3,-1,0,0,0,0,0,0,-1,0,0,-18,-1,-17,7,5,2,-5,-1,-18,-1,6,1,-2,4,-7,1,4,-1,-3,-5,-11,-2,2,2,0,2,-1,6,0,0,0,1,0,4,0,0,0,1,-1,2,0,0,-28,-14,-14,7,5,2,-6,-5,-20,2,2,-3,0,-4,-15,3,1,-1,-6,-1,-5,-1,1,-2,3,1,0,0,2,0,2,0,0,0,2,0,1,1,0,0,0,0,0,5,-5,3,1,2,3,-2,-4,2,3,-2,0,2,-3,5,1,0,3,-4,-1,-3,2,-2,1,1,0,1,0,0,0,0,0,1,0,0,1,1,0,0,0,0,12,8,4,4,2,2,6,2,-5,1,10,-3,6,-3,0,-1,7,-1,0,5,-5,2,3,-2,2,0,1,0,1,0,1,0,1,0,0,0,1,0,0,0,1,0,-38,-24,-14,5,1,4,-8,-5,-10,-5,-8,-2,-2,-3,-9,-5,-5,0,-6,-2,-1,0,-3,-2,1,2,0,0,2,0,1,0,0,0,0,0,0,2,0,0,2,0,3,1,2,10,3,7,8,-5,-9,1,2,4,3,-3,-3,-1,1,4,5,-2,-6,2,1,0,3,2,1,1,3,0,1,1,0,0,1,0,2,1,1,1,2,0,-10,-5,-5,1,2,-1,-1,1,-7,0,0,-2,-2,1,-4,-1,1,0,1,0,-3,1,-1,-2,0,0,0,1,0,0,0,0,0,1,0,1,0,0,0,0,0,-1,-13,-11,-2,1,1,0,4,-5,-6,1,-3,-4,3,-4,-2,0,-6,-2,1,-1,-4,1,3,-2,4,-1,-1,0,0,-1,3,0,-1,0,0,-1,1,-1,0,0,0,0,31,10,21,4,2,2,7,0,7,3,0,13,3,2,2,0,-2,5,4,-2,5,3,2,8,0,1,1,2,0,0,0,0,1,1,0,0,0,1,0,1,0,0,8,5,3,4,3,1,-7,8,5,4,0,-1,-6,7,2,1,0,1,-1,1,3,3,0,-2,1,1,1,0,1,0,1,1,1,0,0,0,0,0,0,0,1,0,-9,2,-11,-4,-1,-3,-3,-4,-6,-3,8,0,-1,1,-4,-1,6,1,-2,-5,-2,-2,2,-1,-2,0,-1,0,-1,0,-1,0,0,0,0,0,-1,0,-1,0,-1,0,-1,1,-2,-10,-7,-3,-5,2,4,-1,-2,0,-3,1,6,-1,-1,-1,-2,1,-2,0,-1,1,-1,0,0,-7,-1,-1,-1,0,0,-6,0,0,0,0,0,-1,-1,-1,18,13,5,8,5,3,8,0,-6,2,9,4,7,-1,1,1,5,-1,1,1,-7,1,4,5,4,1,2,1,0,0,2,0,2,1,0,0,2,1,0,0,0,0,-11,-7,-4,5,1,4,3,1,-12,6,-2,-7,2,0,-5,-1,0,-3,1,1,-7,7,-2,-4,0,3,1,0,0,0,0,0,1,0,0,0,0,3,0,0,0,0
39,39052,Piélagos,11181,578,315,263,111,66,45,84,120,163,135,54,18,49,71,75,82,27,9,35,49,88,53,27,9,9,48,31,14,6,3,3,30,22,7,2,2,6,18,9,7,4,1,515,257,258,90,59,31,77,89,185,125,29,10,27,40,105,68,16,0,50,49,80,57,13,10,6,46,19,14,3,2,3,31,13,10,1,1,3,15,6,4,2,1,664,343,321,33,14,19,117,54,222,156,78,17,67,22,110,86,43,7,50,32,112,70,35,10,10,5,5,9,4,0,5,3,1,4,1,0,5,2,4,5,3,0,624,335,289,61,30,31,74,75,209,152,80,23,36,36,119,93,48,3,38,39,90,59,32,20,9,13,27,8,1,0,5,6,13,2,1,0,4,7,14,6,0,0,770,429,341,137,79,58,115,120,280,166,47,39,69,65,155,96,27,15,46,55,125,70,20,24,14,56,47,14,0,6,10,30,29,7,0,3,4,26,18,7,0,3,766,403,363,93,47,46,125,80,333,136,52,13,53,45,164,91,28,8,72,35,169,45,24,5,15,24,33,14,4,1,9,9,19,8,0,1,6,15,14,6,4,0,966,514,452,117,55,62,211,136,355,155,77,12,120,51,188,108,31,5,91,85,167,47,46,7,33,35,20,14,9,3,20,10,13,7,2,1,13,25,7,7,7,2,1063,581,482,168,100,68,153,95,483,200,87,24,105,48,238,128,47,5,48,47,245,72,40,19,19,43,37,44,22,0,14,21,23,34,7,0,5,22,14,10,15,0,919,457,462,114,62,52,119,107,418,162,80,23,45,40,218,100,45,8,74,67,200,62,35,15,23,36,24,19,7,2,3,21,17,15,3,1,20,15,7,4,4,1,1035,486,549,85,35,50,123,149,481,164,59,35,54,62,239,70,32,15,69,87,242,94,27,20,22,38,16,11,-3,-1,12,16,6,2,-1,-1,10,22,10,9,-2,0,820,467,353,83,47,36,88,109,391,160,39,11,59,46,221,101,26,4,29,63,170,59,13,7,18,24,19,17,4,0,14,11,9,9,3,0,4,13,10,8,1,0,725,342,383,47,13,34,71,61,322,110,48,100,36,14,175,50,25,33,35,47,147,60,23,67,6,10,22,1,3,4,4,4,9,-6,1,1,2,6,13,7,2,3,225,117,108,5,-18,23,19,48,72,57,-7,25,16,17,46,26,-1,10,3,31,26,31,-6,15,2,29,-11,-8,-9,0,0,10,-14,-9,-4,-1,2,19,3,1,-5,1,218,48,170,-85,-74,-11,71,-10,76,38,2,24,34,-22,23,0,0,8,37,12,53,38,2,16,-8,-2,-40,-22,-16,2,-8,-5,-29,-21,-11,0,0,3,-11,-1,-5,2,208,97,111,-27,-26,-1,-7,-9,107,21,-5,83,-9,-8,73,12,-9,23,2,-1,34,9,4,60,-3,4,-8,-15,-7,1,-4,-5,-1,-14,-3,0,1,9,-7,-1,-4,1,146,39,107,-19,-17,-2,-3,5,109,-19,26,14,13,4,38,-22,5,-1,-16,1,71,3,21,15,-6,1,-3,-19,5,3,-5,0,-3,-12,3,0,-1,1,0,-7,2,3,309,134,175,-5,-16,11,39,33,100,74,17,37,16,7,47,41,2,7,23,26,53,33,15,30,1,16,-4,-10,-2,-7,-2,1,-3,-7,-3,-3,3,15,-1,-3,1,-4,249,116,133,69,28,41,59,5,77,68,16,21,29,8,41,24,13,2,30,-3,36,44,3,19,27,16,6,17,3,-1,13,7,1,8,0,-2,14,9,5,9,3,1
39,39055,Potes,1564,12,9,3,24,12,12,0,8,-5,1,6,2,1,9,-4,-1,3,1,-1,-1,-1,2,3,1,0,9,6,5,4,0,0,8,2,1,1,0,0,1,4,4,3,0,6,2,4,53,23,30,6,7,-9,2,-2,2,3,1,-3,0,1,0,3,6,-6,2,-3,2,7,16,11,14,3,1,3,6,6,6,2,0,4,10,5,8,1,1,14,14,0,35,24,11,-2,3,8,3,4,-3,1,-3,11,3,2,0,-3,6,-3,0,2,-3,8,11,9,6,3,-2,5,4,7,6,2,0,3,7,2,0,1,-2,-2,7,-9,58,24,34,-3,-3,9,2,-7,-2,5,2,1,0,-2,-1,-8,-5,8,2,-5,-1,14,8,20,12,0,3,6,4,7,6,0,0,8,4,13,6,0,3,-12,5,-17,14,9,5,-6,4,-4,-11,1,5,1,6,1,-5,-1,4,-7,-2,-5,-6,2,1,1,2,8,1,1,1,1,1,5,1,0,1,0,1,3,0,1,0,-33,-17,-16,22,11,11,-11,-1,-8,-12,-7,7,-6,0,-7,-4,-3,3,-5,-1,-1,-8,-4,4,0,8,13,1,0,0,0,4,7,0,0,0,0,4,6,1,0,0,13,4,9,54,24,30,11,-4,-7,-7,10,11,7,0,-5,-4,1,4,4,-4,-2,-3,9,7,10,14,18,6,3,2,6,9,5,2,1,0,4,5,13,4,2,2,4,-8,12,50,27,23,-5,10,9,-7,-1,-2,-9,4,2,-6,2,-1,4,6,7,-1,-3,-1,5,19,14,9,1,2,0,11,9,5,1,1,5,8,5,4,0,1,21,13,8,21,10,11,-3,1,15,4,1,4,-3,4,9,1,2,0,0,-3,6,3,-1,4,4,5,9,1,1,1,3,1,5,0,0,1,1,4,4,1,1,0,-26,-4,-22,-1,2,-3,-11,4,-5,-3,-9,-3,-3,3,-1,0,-1,-2,-8,1,-4,-3,-8,-1,2,1,2,-1,-4,-1,1,1,2,-1,0,-1,1,0,0,0,-4,0,-13,-12,-1,-2,-7,5,-1,0,-1,-13,1,0,0,-5,1,-9,0,1,-1,5,-2,-4,1,-1,-2,2,-2,-1,1,0,-1,-2,-1,-3,0,0,-1,4,-1,2,1,0,2,-10,12,10,1,9,-1,10,-6,0,-6,7,-3,5,-4,-3,-2,-2,2,5,-2,3,-4,9,1,9,3,-1,0,-2,0,3,0,-1,0,-1,1,6,3,0,0,-1,-12,4,-16,-4,-5,1,-2,-10,1,-7,-4,9,0,-6,0,1,1,8,-2,-4,1,-8,-5,1,0,0,-2,-1,0,-1,0,-1,-2,-1,0,-1,0,1,0,0,0,0,-23,-5,-18,-13,-2,-11,-18,5,-11,-12,0,11,-6,-3,-2,-4,0,8,-12,8,-9,-8,0,3,-5,0,-3,-5,-2,1,-2,0,1,-1,-2,1,-3,0,-4,-4,0,0,-4,-3,-1,-2,-1,-1,-5,3,-10,1,-2,10,-2,3,-7,0,1,3,-3,0,-3,1,-3,7,3,1,-5,-2,0,1,2,0,-3,-1,1,0,1,1,-2,-1,-1,1,-34,-17,-17,-5,-5,0,3,-3,-12,-23,-2,2,2,-3,-5,-11,-1,0,1,0,-7,-12,-1,2,1,1,-1,-5,0,-1,0,-1,0,-3,0,-1,1,2,-1,-2,0,0,3,3,0,3,2,1,14,2,-21,1,-4,10,10,-1,-10,-1,-2,5,4,3,-11,2,-2,5,4,3,-7,-3,3,3,4,0,-4,-2,2,2,0,3,-3,-1,1,1,21,3,18,17,5,12,-9,1,-2,10,8,11,-6,0,-3,6,1,4,-3,1,1,4,7,7,1,5,2,4,3,2,1,2,0,1,1,0,0,3,2,3,2,2
39,39059,Reinosa,11518,-312,-159,-153,24,5,19,-48,-82,-101,-67,-21,7,-23,-36,-54,-33,-10,-3,-25,-46,-47,-34,-11,10,2,2,13,5,1,1,1,0,3,0,1,0,1,2,10,5,0,1,-171,-78,-93,26,18,8,-3,-30,-60,-34,-19,-22,-2,-10,-27,-18,-7,-13,-1,-20,-33,-16,-12,-9,4,6,11,4,1,0,2,5,8,2,1,0,2,1,3,2,0,0,-63,-65,2,2,1,1,-11,-6,-19,-23,-3,-1,-7,-14,-16,-22,-5,0,-4,8,-3,-1,2,-1,1,0,-2,1,1,1,1,0,-1,0,1,0,0,0,-1,1,0,1,-188,-98,-90,-2,0,-2,-21,-38,-82,-27,-17,2,-14,-15,-37,-17,-11,-5,-7,-23,-45,-10,-6,7,0,0,-4,2,0,0,0,0,-1,1,0,0,0,0,-3,1,0,0,-25,-16,-9,48,16,32,9,-3,-25,-3,-17,12,-4,-7,-13,8,-5,2,13,4,-12,-11,-12,10,9,10,21,3,3,2,4,2,8,0,2,0,5,8,13,3,1,2,-65,-22,-43,78,32,46,6,-10,-31,-6,-9,-9,12,5,-21,0,-7,-8,-6,-15,-10,-6,-2,-1,16,22,25,10,4,1,12,6,6,5,3,0,4,16,19,5,1,1,-76,-53,-23,76,38,38,18,-10,-55,-12,-21,5,13,-11,-34,-14,-4,-1,5,1,-21,2,-17,6,20,24,24,8,0,0,11,9,11,7,0,0,9,15,13,1,0,0,-4,17,-21,118,66,52,22,1,-20,-10,-5,9,18,2,-11,7,-5,6,4,-1,-9,-17,0,3,29,21,46,16,4,2,17,10,25,11,2,1,12,11,21,5,2,1,139,70,69,63,26,37,45,1,24,30,17,22,16,6,22,4,9,14,29,-5,2,26,8,8,12,10,26,12,3,0,5,5,11,5,0,0,7,5,15,7,3,0,16,-5,21,31,10,21,8,7,-54,11,1,46,15,-3,-30,3,-2,14,-7,10,-24,8,3,32,12,11,4,6,-1,-1,9,0,-1,5,-2,-1,3,11,5,1,1,0,-36,-23,-13,25,10,15,-3,-5,-31,-4,5,5,-2,-7,-28,0,7,9,-1,2,-3,-4,-2,-4,1,8,4,7,2,3,-1,3,3,2,0,3,2,5,1,5,2,0,-44,-14,-30,20,2,18,-24,1,-32,8,-10,16,-13,1,-4,7,-7,3,-11,0,-28,1,-3,13,9,16,1,-6,1,-1,3,4,-2,-2,0,-1,6,12,3,-4,1,0,-73,-28,-45,10,3,7,-4,-24,-27,-16,-2,3,-5,-8,-8,-8,8,-4,1,-16,-19,-8,-10,7,7,4,-2,2,-1,0,4,1,0,0,-2,0,3,3,-2,2,1,0,2,-2,4,14,3,11,8,9,0,-12,0,-4,1,5,1,-14,3,2,7,4,-1,2,-3,-6,-1,2,4,7,2,0,-1,1,2,0,1,0,0,1,2,7,1,0,-125,-83,-42,-27,-25,-2,-19,-17,-33,-38,-21,5,-16,-9,-20,-20,-13,-5,-3,-8,-13,-18,-8,10,1,-2,-6,-14,-3,-3,0,-2,-3,-14,-3,-3,1,0,-3,0,0,0,-91,-40,-51,-71,-38,-33,-19,-22,-36,-34,-1,25,-12,-11,-8,-16,5,3,-7,-11,-28,-18,-6,22,-3,-6,-18,-27,-13,-5,-3,-3,-8,-15,-9,-1,0,-3,-10,-12,-4,-4,-50,-38,-12,-14,-12,-2,6,-9,-19,-5,-9,-11,5,-10,-5,-11,-2,-12,1,1,-14,6,-7,1,5,1,-10,-7,-4,1,4,-4,-6,-5,-1,0,1,5,-4,-2,-3,1,-120,-67,-53,-5,-3,-2,-10,-12,-53,-30,-8,-7,-9,-7,-23,-22,-6,1,-1,-5,-30,-8,-2,-8,-1,-1,-2,3,-4,0,0,0,-2,0,-1,0,-1,-1,0,3,-3,0
39,39060,Reocín,6867,73,46,27,8,5,3,12,18,28,12,4,-4,4,14,14,7,6,-2,8,4,14,5,-2,-2,0,4,3,0,1,0,0,2,2,0,1,0,0,2,1,0,0,0,53,28,25,22,18,4,13,-2,14,21,0,4,6,-3,6,15,-1,3,7,1,8,6,1,1,2,5,8,4,3,0,2,5,7,3,1,0,0,0,1,1,2,0,83,29,54,7,5,2,14,2,40,19,12,-2,1,-1,18,6,7,1,13,3,22,13,5,-3,0,0,2,1,5,-1,0,1,1,1,3,-1,0,-1,1,0,2,0,82,28,54,20,7,13,18,3,36,15,6,-1,2,-7,22,7,1,0,16,10,14,8,5,-1,5,1,3,7,2,2,2,0,1,3,1,0,3,1,2,4,1,2,217,105,112,21,12,9,32,45,107,34,8,-10,15,19,49,17,7,-2,17,26,58,17,1,-8,1,6,10,3,0,1,0,3,7,2,0,0,1,3,3,1,0,1,208,97,111,21,10,11,50,23,100,23,7,1,28,6,42,19,2,-2,22,17,58,4,5,3,5,5,4,6,1,0,3,1,1,5,0,0,2,4,3,1,1,0,248,127,121,21,10,11,42,20,113,51,5,15,28,12,55,19,1,12,14,8,58,32,4,3,5,2,8,3,2,0,2,1,3,2,1,0,3,1,5,1,1,0,147,85,62,13,6,7,19,22,69,21,9,1,11,8,46,9,3,3,8,14,23,12,6,-2,1,5,2,5,0,0,1,3,-1,3,0,0,0,2,3,2,0,0,17,-2,19,28,16,12,-13,11,20,-10,0,11,-3,-1,5,-4,-1,3,-10,12,15,-6,1,8,1,6,9,4,7,1,2,2,7,2,3,0,-1,4,2,2,4,1,-35,-7,-28,2,4,-2,-13,8,-27,-4,1,3,1,4,-12,1,-2,2,-14,4,-15,-5,3,1,4,1,-3,-2,-2,4,1,1,1,-1,-1,3,3,0,-4,-1,-1,1,96,48,48,22,12,10,26,1,46,15,6,2,15,-6,18,16,2,1,11,7,28,-1,4,1,5,3,7,2,3,0,4,1,2,1,2,0,1,2,5,1,1,0,26,2,24,1,-1,2,8,1,-8,2,18,2,-3,1,-8,-6,12,0,11,0,0,8,6,2,2,3,-3,-5,3,0,1,2,-3,-4,2,0,1,1,0,-1,1,0,10,14,-4,14,4,10,-16,0,18,5,9,-2,-4,7,18,-10,5,-2,-12,-7,0,15,4,0,1,5,0,5,3,0,-1,4,-1,1,1,0,2,1,1,4,2,0,-21,-1,-20,3,6,-3,1,-20,6,4,1,-8,3,-7,8,-1,1,-2,-2,-13,-2,5,0,-6,0,3,-1,1,0,0,1,3,1,1,0,0,-1,0,-2,0,0,0,62,25,37,7,3,4,13,12,3,12,13,12,3,5,1,10,3,5,10,7,2,2,10,7,5,3,-2,1,-1,1,2,2,-1,0,0,0,3,1,-1,1,-1,1,-42,-27,-15,-3,-4,1,13,-18,8,-16,-13,-13,2,-17,9,-3,-12,-4,11,-1,-1,-13,-1,-9,0,-2,1,-2,-1,0,-2,-1,2,-2,-2,1,2,-1,-1,0,1,-1,16,17,-1,11,4,7,1,0,3,10,3,3,-1,-2,2,14,6,1,2,2,1,-4,-3,2,3,2,-4,6,2,1,0,0,-3,5,1,0,3,2,-1,1,1,1,65,8,57,14,5,9,36,-4,13,1,30,-12,16,-5,1,-8,11,-8,20,1,12,9,19,-4,5,4,1,1,2,1,2,4,1,-1,-1,0,3,0,0,2,3,1
39,39061,Ribamontán al Mar,3525,68,31,37,25,9,16,-7,22,29,17,14,-5,-3,12,13,7,7,-3,-4,10,16,10,7,-2,1,6,10,5,2,0,1,3,4,1,0,0,0,3,6,4,2,0,113,63,50,23,7,16,15,25,31,23,16,0,2,16,18,12,13,1,13,9,13,11,3,-1,5,7,8,1,2,0,1,2,2,0,2,0,4,5,6,1,0,0,35,17,18,38,17,21,6,12,9,3,-6,7,10,4,0,0,-4,6,-4,8,9,3,-2,1,8,7,15,4,2,2,4,1,7,3,1,1,4,6,8,1,1,1,74,59,15,29,18,11,11,19,16,16,12,0,9,17,14,11,8,0,2,2,2,5,4,0,3,10,11,1,2,2,3,5,5,2,1,2,0,5,6,-1,1,0,89,61,28,39,18,21,1,4,37,17,23,6,3,6,12,18,15,4,-2,-2,25,-1,8,2,4,15,8,6,5,1,3,8,2,1,4,0,1,7,6,5,1,1,71,43,28,52,22,30,6,23,16,2,15,6,-2,8,19,5,11,0,8,15,-3,-3,4,6,16,11,14,6,5,0,5,3,9,3,2,0,11,8,5,3,3,0,75,55,20,45,18,27,21,17,-13,32,22,-1,15,12,1,20,10,0,6,5,-14,12,12,-1,12,9,12,6,1,4,5,4,8,0,-1,1,7,5,4,6,2,3,115,73,42,60,32,28,3,13,36,18,28,13,0,11,22,15,17,6,3,2,14,3,11,7,8,11,24,8,6,1,4,6,14,4,3,0,4,5,10,4,3,1,82,44,38,48,19,29,31,28,11,8,-3,2,17,15,5,2,3,-2,14,13,6,6,-6,4,13,14,12,6,1,2,6,4,4,4,0,1,7,10,8,2,1,1,45,19,26,19,5,14,9,1,21,0,0,10,3,0,9,2,-4,6,6,1,12,-2,4,4,3,3,10,1,2,0,1,1,3,0,0,0,2,2,7,1,2,0,13,11,2,16,6,10,7,-2,-23,18,4,4,11,3,-20,11,1,2,-4,-5,-3,7,3,2,2,2,6,4,-2,2,2,1,3,1,-2,0,0,1,3,3,0,2,30,21,9,1,3,-2,9,23,3,-6,-12,7,9,9,4,-2,-7,6,0,14,-1,-4,-5,1,-2,8,-8,1,1,0,1,4,-4,1,0,0,-3,4,-4,0,1,0,25,25,0,16,1,15,-8,11,9,1,-9,21,-4,10,10,0,-4,13,-4,1,-1,1,-5,8,3,3,5,4,0,1,0,1,1,-1,-1,1,3,2,4,5,1,0,-34,5,-39,-20,-12,-8,-3,-1,0,-21,-5,-10,3,-2,5,-6,6,-6,-6,1,-5,-15,-11,-4,-4,-1,-1,-5,-6,-3,-4,0,2,-5,-2,-3,0,-1,-3,0,-4,0,-37,-4,-33,1,4,-3,-21,-7,-9,-8,-4,11,-5,0,3,-8,-4,8,-16,-7,-12,0,0,3,-4,4,-1,1,0,1,-1,1,1,1,1,1,-3,3,-2,0,-1,0,27,30,-3,6,4,2,-3,7,12,8,-3,2,-2,9,12,11,-3,1,-1,-2,0,-3,0,1,-2,-2,3,5,-1,1,-1,1,3,1,-2,1,-1,-3,0,4,1,0,2,-10,12,-12,-8,-4,-3,16,-1,-16,3,0,-1,8,-8,-5,-3,-2,-2,8,7,-11,6,2,-1,2,3,-17,-2,2,0,2,0,-8,-5,2,-1,0,3,-9,3,0,8,10,-2,9,6,3,-11,11,13,3,-6,-7,-7,9,9,-1,-2,-2,-4,2,4,4,-4,-5,1,0,9,0,-2,0,-1,1,7,-3,1,0,2,-1,2,3,-3,0
39,39080,San Vicente de la Barquera,4392,10,12,-2,16,9,7,-2,-4,0,7,8,-1,5,-3,1,-1,6,2,-7,-1,-1,8,2,-3,6,1,3,2,4,0,4,0,0,1,4,0,2,1,3,1,0,0,-29,-7,-22,9,6,3,-7,-8,-4,-3,2,-9,-2,-2,1,1,0,-5,-5,-6,-5,-4,2,-4,2,2,3,1,1,0,2,0,3,0,1,0,0,2,0,1,0,0,35,8,27,-2,-1,-1,10,-4,17,8,5,1,4,-3,0,1,6,2,6,-1,17,7,-1,-1,0,-2,-1,1,0,0,0,0,0,0,-1,0,0,-2,-1,1,1,0,11,6,5,27,14,13,0,-6,4,-3,11,5,4,-9,0,1,3,8,-4,3,4,-4,8,-3,8,5,6,6,2,0,3,1,5,4,1,0,5,4,1,2,1,0,-29,-11,-18,18,5,13,-4,-17,-2,-4,4,-4,-5,-8,-4,2,7,-3,1,-9,2,-6,-3,-1,1,4,8,3,2,0,0,1,1,2,1,0,1,3,7,1,1,0,4,-3,7,26,16,10,-7,1,4,-8,10,4,3,-9,3,-3,4,-1,-10,10,1,-5,6,5,3,7,10,4,-1,2,3,5,6,2,-1,0,0,2,4,2,0,2,90,17,73,31,9,22,8,5,16,6,19,37,-5,-3,4,8,6,6,13,8,12,-2,13,31,5,12,3,5,6,0,0,3,1,3,2,0,5,9,2,2,4,0,-8,-8,0,36,11,25,-2,14,-14,-8,-5,9,-6,5,-9,-7,0,9,4,9,-5,-1,-5,0,3,16,7,3,5,2,0,6,1,0,3,1,3,10,6,3,2,1,48,32,16,52,36,16,6,13,11,22,-6,3,8,8,10,9,-2,0,-2,5,1,13,-4,3,8,13,17,13,1,0,7,8,14,7,0,0,1,5,3,6,1,0,-35,-22,-13,14,8,6,1,5,-22,-20,-2,8,-2,10,-17,-10,-2,0,3,-5,-5,-10,0,8,0,9,7,-4,3,-1,0,5,5,-2,0,0,0,4,2,-2,3,-1,-50,-30,-20,12,3,9,-9,-4,-40,1,-2,8,-4,-2,-24,-5,-1,7,-5,-2,-16,6,-1,1,9,4,-4,-1,-1,5,3,4,-4,-2,-2,4,6,0,0,1,1,1,-11,2,-13,6,6,0,-2,3,-4,-8,3,-6,4,3,7,-11,-2,-1,-6,0,-11,3,5,-5,0,2,4,-2,0,1,1,2,3,-2,0,1,-1,0,1,0,0,0,-24,-20,-4,8,3,5,0,-10,-12,-4,0,2,-10,-8,-9,4,1,1,10,-2,-3,-8,-1,1,2,2,3,0,2,-1,0,1,3,-1,1,-1,2,1,0,1,1,0,-22,-13,-9,-9,-5,-4,-6,2,-20,1,1,1,0,6,-14,-1,-3,0,-6,-4,-6,2,4,1,-1,0,-8,-3,1,2,0,1,-8,-1,1,2,-1,-1,0,-2,0,0,-43,-24,-19,-1,-2,1,-10,-8,-7,-15,1,-3,-8,-5,-5,-6,0,0,-2,-3,-2,-9,1,-3,0,-1,2,-4,1,1,-1,-1,2,-3,0,1,1,0,0,-1,1,0,-27,-14,-13,-16,-8,-8,2,-8,-18,-4,5,-4,0,0,-7,-9,3,-1,2,-8,-11,5,2,-3,1,1,-4,-6,-5,-3,0,0,-2,-2,-2,-2,1,1,-2,-4,-3,-1,-5,-2,-3,-3,-1,-2,-8,7,-9,-4,10,-3,-3,3,-5,-2,5,-1,-5,4,-4,-2,5,-2,-1,2,1,-6,3,-2,0,1,2,-5,3,-2,-1,1,-1,-1,0,0,-10,-16,6,10,5,5,4,-8,3,2,-8,-6,0,-6,-3,-1,-2,-4,4,-2,6,3,-6,-2,0,2,1,5,-1,2,0,2,2,0,-1,2,0,0,-1,5,0,0
39,39073,Santa Cruz de Bezana,7617,278,141,137,3,1,2,49,42,84,54,27,18,35,24,35,26,12,7,14,18,49,28,15,11,0,2,0,1,0,0,0,1,0,0,0,0,0,1,0,1,0,0,425,206,219,7,3,4,71,55,149,86,44,13,43,18,73,43,22,3,28,37,76,43,22,10,1,1,0,2,3,0,1,0,0,0,2,0,0,1,0,2,1,0,410,192,218,-4,-2,-2,117,14,109,115,15,21,60,14,41,56,7,8,57,0,68,59,8,13,0,-2,0,-3,1,0,0,-1,0,-2,1,0,0,-1,0,-1,0,0,138,89,49,19,9,10,-11,11,54,40,21,24,0,5,37,21,10,16,-11,6,17,19,11,8,7,1,6,1,2,1,3,1,4,-1,1,1,4,0,2,2,1,0,134,91,43,75,44,31,24,1,19,48,31,7,20,15,9,30,15,0,4,-14,10,18,16,7,13,20,25,7,9,1,7,14,14,4,5,0,6,6,11,3,4,1,242,104,138,68,27,41,76,34,29,64,28,5,40,15,9,24,17,-3,36,19,20,40,11,8,19,15,15,10,6,1,7,6,7,3,3,0,12,9,8,7,3,1,126,62,64,42,17,25,11,5,29,44,22,9,6,-10,26,25,10,-1,5,15,3,19,12,10,9,8,13,10,3,-1,5,-2,8,4,2,0,4,10,5,6,1,-1,302,132,170,37,19,18,70,13,72,45,50,44,37,9,23,26,21,14,33,4,49,19,29,30,13,3,9,2,6,4,8,2,3,2,2,2,5,1,6,0,4,2,401,202,199,60,39,21,75,37,143,88,17,38,46,22,57,42,16,17,29,15,86,46,1,21,13,14,17,13,2,0,8,12,8,9,2,-1,5,2,9,4,0,1,278,126,152,44,19,25,46,9,127,78,0,12,22,0,54,43,3,3,24,9,73,35,-3,9,11,14,13,8,-2,0,8,6,4,1,0,0,3,8,9,7,-2,0,147,82,65,23,12,11,34,7,65,8,7,23,25,4,30,10,2,6,9,3,35,-2,5,17,8,8,7,1,1,-2,5,3,5,0,0,-1,3,5,2,1,1,-1,300,140,160,22,7,15,38,19,87,70,48,28,22,6,38,29,30,13,16,13,49,41,18,15,10,11,-1,3,-2,0,7,3,-2,0,-2,1,3,8,1,3,0,-1,177,88,89,7,0,7,20,6,82,25,11,22,7,12,40,10,7,7,13,-6,42,15,4,15,9,3,4,-6,-2,-1,5,2,-1,-6,0,0,4,1,5,0,-2,-1,89,34,55,-26,-29,3,0,-2,39,40,7,9,-1,-4,17,12,6,0,1,2,22,28,1,9,-4,5,-15,-9,-2,-1,-5,3,-15,-6,-4,-2,1,2,0,-3,2,1,23,8,15,-20,-14,-6,-7,-1,27,4,-1,8,-1,6,4,4,3,-4,-6,-7,23,0,-4,12,-3,0,-19,-3,2,3,-2,0,-12,0,0,0,-1,0,-7,-3,2,3,97,33,64,-17,-10,-7,40,-12,27,32,-2,15,12,1,10,10,-3,4,28,-13,17,22,1,11,3,-3,-11,-9,4,-1,1,2,-8,-6,1,0,2,-5,-3,-3,3,-1,130,67,63,27,23,4,36,1,8,58,25,-4,32,3,0,31,6,-6,4,-2,8,27,19,2,5,4,1,9,4,3,4,2,4,9,2,1,1,2,-3,0,2,2,111,73,38,1,4,-3,21,-4,19,33,21,22,12,1,22,24,10,6,9,-5,-3,9,11,16,0,4,-3,-5,-1,7,1,4,-1,-2,-1,3,-1,0,-2,-3,0,4
39,39074,Santa María de Cayón,6324,76,51,25,14,11,3,9,1,51,1,8,6,13,-1,24,4,6,5,-4,2,27,-3,2,1,2,0,8,3,1,0,2,0,7,1,1,0,0,0,1,2,0,0,65,31,34,25,13,12,3,6,23,13,16,3,-2,2,14,8,8,1,5,4,9,5,8,2,5,6,5,4,4,0,2,3,1,4,3,0,3,3,4,0,1,0,71,39,32,26,18,8,3,29,35,9,2,-5,3,7,22,5,3,-1,0,22,13,4,-1,-4,1,2,13,9,1,0,0,0,12,5,1,0,1,2,1,4,0,0,128,81,47,43,32,11,8,6,72,30,12,0,-2,-1,41,29,10,2,10,7,31,1,2,-2,6,4,14,18,1,0,3,2,10,16,1,0,3,2,4,2,0,0,356,196,160,84,61,23,70,62,157,54,8,0,39,31,86,33,5,0,31,31,71,21,3,0,12,9,25,34,3,0,7,4,18,30,2,0,5,5,7,4,1,0,247,119,128,89,53,36,29,36,100,49,24,2,4,8,59,34,11,0,25,28,41,15,13,2,9,11,29,33,4,2,4,6,14,26,2,1,5,5,15,7,2,1,188,117,71,115,64,51,6,29,75,50,14,10,2,17,38,40,10,10,4,12,37,10,4,0,18,14,34,39,8,1,9,5,15,28,6,1,9,9,19,11,2,0,493,330,163,205,159,46,62,81,182,115,41,11,30,58,124,87,24,6,32,23,58,28,17,5,11,48,44,82,19,1,4,32,36,69,18,0,7,16,8,13,1,1,361,200,161,131,83,48,66,45,144,70,27,4,28,17,81,49,18,2,38,28,63,21,9,2,25,20,37,34,12,0,13,15,23,22,8,0,12,5,14,12,4,0,245,153,92,38,24,14,33,52,97,32,18,13,27,19,58,26,15,8,6,33,39,6,3,5,2,15,14,7,1,-1,4,3,9,7,1,0,-2,12,5,0,0,-1,173,79,94,19,1,18,38,29,60,13,27,0,14,18,24,2,16,-2,24,11,36,11,11,2,7,12,2,-4,2,0,6,1,2,-7,-1,0,1,11,0,3,3,0,86,56,30,26,17,9,8,11,55,2,-8,14,1,2,44,6,-5,8,7,9,11,-4,-3,6,1,5,5,10,5,1,-1,3,1,11,3,0,2,2,4,-1,2,1,51,27,24,23,13,10,-12,-14,54,9,4,7,-8,-6,23,12,0,5,-4,-8,31,-3,4,2,-3,1,8,15,-1,3,-3,2,4,11,-3,2,0,-1,4,4,2,1,59,55,4,22,21,1,-12,14,32,24,4,1,8,3,12,30,7,-2,-20,11,20,-6,-3,3,0,1,7,10,2,1,2,1,5,10,1,1,-2,0,2,0,1,0,-35,-1,-34,-7,-2,-5,-29,-4,-22,-2,15,8,-19,3,-8,3,15,6,-10,-7,-14,-5,0,2,2,3,-7,-4,1,-2,1,1,-2,-3,2,-1,1,2,-5,-1,-1,-1,-82,-52,-30,-40,-20,-20,-12,-3,-24,-23,-16,-3,-6,-8,-16,-12,-8,-2,-6,5,-8,-11,-8,-1,1,-12,-12,-8,-9,-1,-1,-9,-7,-1,-2,0,2,-3,-5,-7,-7,-1,-210,-193,-17,-234,-189,-45,-8,-9,-45,-71,-100,22,-11,-9,-19,-72,-90,8,3,0,-26,1,-10,14,-6,1,-35,-84,-105,-5,-4,0,-20,-73,-89,-3,-2,1,-15,-11,-16,-2,40,49,-9,43,27,16,13,2,14,-27,11,28,17,3,19,-18,12,13,-4,-1,-5,-9,-1,15,9,6,10,7,8,2,4,4,4,4,9,1,5,2,6,3,-1,1
39,39075,Santander,184165,-1080,-689,-391,104,50,54,-97,-187,-421,-249,-86,-6,-61,-115,-231,-184,-68,-15,-36,-72,-190,-65,-18,9,20,5,23,16,18,22,8,4,12,7,8,11,12,1,11,9,10,11,-1615,-891,-724,66,40,26,-217,-258,-689,-271,-162,13,-119,-128,-400,-167,-89,25,-98,-130,-289,-104,-73,-12,6,12,15,8,13,12,3,7,10,3,9,8,3,5,5,5,4,4,-2502,-1257,-1245,-94,-29,-65,-278,-471,-1024,-449,-196,-41,-145,-201,-519,-238,-103,-33,-133,-270,-505,-211,-93,-8,17,-29,-95,2,4,6,13,-14,-31,-2,4,1,4,-15,-64,4,0,5,-1741,-1024,-717,153,93,60,-82,-196,-859,-325,-244,-17,-71,-101,-488,-201,-145,-7,-11,-95,-371,-124,-99,-10,33,33,16,28,32,6,14,22,18,19,11,4,19,11,-2,9,21,2,5,-167,172,1905,969,936,19,205,-311,68,-21,63,-14,98,-233,0,-38,33,33,107,-78,68,17,30,248,493,642,364,103,42,125,243,323,205,45,24,123,250,319,159,58,18,-532,-394,-138,2049,1021,1028,19,120,-528,-39,-95,33,-42,68,-302,-59,-66,31,61,52,-226,20,-29,2,344,545,616,389,109,40,165,257,337,200,47,12,179,288,279,189,62,28,107,-154,261,2305,1146,1159,227,277,-312,63,-105,-28,113,108,-231,-2,-96,-36,114,169,-81,65,-9,8,432,587,680,447,111,36,225,284,333,224,49,23,207,303,347,223,62,13,520,144,376,2318,1189,1129,275,438,-159,132,-107,-34,149,216,-138,47,-85,-28,126,222,-21,85,-22,-6,474,651,681,403,97,1,237,310,381,219,41,-3,237,341,300,184,56,4,614,208,406,2209,1086,1123,294,386,-205,152,12,6,126,167,-99,45,-24,-1,168,219,-106,107,36,7,495,525,674,394,89,24,276,227,338,194,37,6,219,298,336,200,52,18,-744,-516,-228,1017,389,628,47,97,-614,-134,-64,-20,43,4,-348,-127,-44,-9,4,93,-266,-7,-20,-11,142,298,318,182,62,11,62,123,101,72,23,6,80,175,217,110,39,5,-1169,-784,-385,331,53,278,154,-20,-779,-240,-237,-25,81,-4,-483,-177,-147,-38,73,-16,-296,-63,-90,13,162,140,60,-36,-8,1,98,56,-19,-62,-17,-9,64,84,79,26,9,10,-848,-674,-174,406,107,299,92,33,-651,-168,-25,-113,53,-18,-458,-162,-41,-42,39,51,-193,-6,16,-71,151,156,61,8,17,4,84,56,1,-42,-3,2,67,100,60,50,20,2,-480,-283,-197,-3,-46,43,39,16,-431,-58,18,-51,-4,-16,-220,-52,35,-14,43,32,-211,-6,-17,-37,71,84,-96,-66,-4,2,30,34,-60,-46,-5,-1,41,50,-36,-20,1,3,-612,-388,-224,-184,-176,-8,20,22,-473,-104,-52,-1,-13,14,-238,-89,-55,8,33,8,-235,-15,3,-9,61,47,-127,-123,-40,-7,33,21,-84,-112,-33,-5,28,26,-43,-11,-7,-2,-533,-438,-95,-156,-86,-70,163,9,-368,-191,-121,-38,82,-47,-240,-143,-95,6,81,56,-128,-48,-26,-44,34,25,-130,-95,-18,18,27,-6,-65,-43,-15,13,7,31,-65,-52,-3,5,-58,-140,82,75,-26,101,109,113,-330,-33,58,16,49,18,-205,-10,20,-4,60,95,-125,-23,38,20,73,107,-100,-32,2,15,32,36,-69,-27,-3,2,41,71,-31,-5,5,13,442,289,153,426,150,276,113,239,-110,48,54,110,49,129,-58,59,51,75,64,110,-52,-11,3,35,78,227,55,-24,34,53,45,111,3,-29,-3,22,33,116,52,5,37,31,1091,422,669,911,419,492,331,294,154,35,142,121,192,125,25,-51,37,90,139,169,129,86,105,31,205,225,248,87,87,43,110,124,125,11,22,16,95,101,123,76,65,27
39,39079,Santoña,11657,8,7,1,3,1,2,-6,-2,-26,20,23,4,2,-4,-18,13,16,0,-8,2,-8,7,7,4,0,0,1,1,0,1,0,0,0,0,0,1,0,0,1,1,0,0,-39,-23,-16,15,3,12,1,-10,-39,-5,6,7,-3,-3,-24,-3,6,4,4,-7,-15,-2,0,3,6,2,2,3,0,1,1,0,0,2,0,0,5,2,2,1,0,1,87,52,35,58,36,22,20,28,22,4,9,-3,18,17,8,1,4,-1,2,11,14,3,5,-2,15,16,8,14,2,2,10,9,4,9,2,1,5,7,4,5,0,1,-30,-9,-21,62,33,29,-1,-28,0,-12,-4,12,2,-12,11,-10,-3,2,-3,-16,-11,-2,-1,10,10,11,22,11,5,0,4,4,17,6,2,0,6,7,5,5,3,0,56,28,28,79,41,38,22,21,-4,5,0,12,9,9,-4,14,-3,5,13,12,0,-9,3,7,20,23,24,10,3,-1,8,16,9,7,1,0,12,7,15,3,2,-1,-22,10,-32,102,62,40,-11,16,-12,-17,0,2,-11,5,5,5,3,5,0,11,-17,-22,-3,-3,20,24,26,21,8,2,14,14,17,13,4,0,6,10,9,8,4,2,74,77,-3,148,85,63,21,12,16,14,9,3,9,21,19,9,11,7,12,-9,-3,5,-2,-4,29,34,48,26,10,0,11,21,32,16,4,0,18,13,16,10,6,0,57,58,-1,205,122,83,18,37,-5,-6,-1,16,11,21,15,-1,2,9,7,16,-20,-5,-3,7,33,69,57,31,9,4,17,36,36,23,6,2,16,33,21,8,3,2,18,29,-11,153,92,61,26,12,-31,8,-9,2,26,10,-23,10,-6,4,0,2,-8,-2,-3,-2,36,32,46,31,3,1,26,17,25,20,1,1,10,15,21,11,2,0,14,32,-18,86,55,31,-23,1,-9,9,24,14,-14,6,2,10,15,13,-9,-5,-11,-1,9,1,12,18,32,14,6,4,7,10,20,9,5,4,5,8,12,5,1,0,-66,-30,-36,52,26,26,-9,-6,-43,-28,10,8,2,-1,-16,-21,0,4,-11,-5,-27,-7,10,4,11,15,13,9,2,1,5,5,11,3,1,0,6,10,2,6,1,1,-14,19,-33,30,14,16,4,2,-16,-9,0,2,13,5,-4,2,-9,8,-9,-3,-12,-11,9,-6,12,8,9,-2,0,3,2,3,8,1,-1,1,10,5,1,-3,1,2,-29,-42,13,37,12,25,16,-6,-21,-12,2,-4,-1,4,-25,-7,-6,0,17,-10,4,-5,8,-4,18,8,0,8,5,-2,7,7,-4,2,1,-1,11,1,4,6,4,-1,1,-2,3,20,17,3,3,-17,6,-4,8,11,0,-2,2,-12,8,6,3,-15,4,8,0,5,6,5,6,1,2,0,4,5,5,-1,3,1,2,0,1,2,-1,-1,-55,-20,-35,10,2,8,-25,6,-11,-20,-21,18,-7,4,1,-12,-18,12,-18,2,-12,-8,-3,6,-4,3,11,0,0,0,-3,1,7,-1,-1,-1,-1,2,4,1,1,1,30,6,24,7,-3,10,19,-2,-15,17,5,4,1,2,-12,5,7,0,18,-4,-3,12,-2,4,6,2,-2,-3,1,3,0,2,-2,-4,1,0,6,0,0,1,0,3,-16,-3,-13,13,6,7,26,-23,-7,-15,7,-8,17,-14,1,-18,5,3,9,-9,-8,3,2,-11,7,2,6,-5,2,0,3,2,7,-5,-2,0,4,0,-1,0,4,0,-68,-81,13,-95,-84,-11,3,-4,-36,-41,-5,9,5,-6,-24,-40,-15,-2,-2,2,-12,-1,10,11,8,0,-40,-43,-12,-11,7,-1,-25,-41,-16,-8,1,1,-15,-2,4,-3
39,39087,Torrelavega,57070,37,-18,55,356,198,158,20,44,-14,-36,-9,30,-10,19,-22,-9,-7,9,30,25,8,-27,-2,21,48,122,112,57,11,5,18,76,59,36,7,2,30,46,53,21,4,3,170,109,61,442,237,205,101,25,62,-28,-3,0,44,26,52,0,-14,0,57,-1,10,-28,11,0,82,112,155,70,14,3,41,59,86,44,5,1,41,53,69,26,9,2,306,176,130,486,261,225,123,-5,27,66,-30,126,91,16,-4,55,-20,40,32,-21,31,11,-10,86,123,101,126,95,25,13,71,55,59,56,15,4,52,46,67,39,10,9,107,142,-35,495,297,198,48,54,49,30,-34,-50,47,44,49,37,-14,-26,1,10,0,-7,-20,-24,83,131,156,86,25,6,45,77,99,52,16,3,38,54,57,34,9,3,-290,-176,-114,633,346,287,-9,-37,-207,-49,-13,25,-2,-19,-122,-22,-16,7,-7,-18,-85,-27,3,18,98,154,203,132,29,11,50,89,113,71,13,7,48,65,90,61,16,4,16,-8,24,601,337,264,38,44,-116,32,-18,32,-14,40,-55,23,-17,10,52,4,-61,9,-1,22,87,161,216,94,28,10,33,102,120,60,13,5,54,59,96,34,15,5,-239,-180,-59,524,269,255,52,-32,-127,-49,-86,5,22,-28,-95,-24,-55,-1,30,-4,-32,-25,-31,6,104,118,172,94,20,9,60,52,89,58,6,1,44,66,83,36,14,8,482,292,190,698,417,281,133,156,23,78,35,47,85,104,19,46,10,23,48,52,4,32,25,24,128,226,198,96,32,14,73,140,123,57,15,7,55,86,75,39,17,7,193,130,63,629,356,273,109,45,-1,50,-14,-1,58,50,4,28,-11,-1,51,-5,-5,22,-3,0,121,154,208,112,26,1,77,92,111,57,15,0,44,62,97,55,11,1,-49,-77,28,346,158,188,24,39,-56,-48,-10,7,10,3,-40,-39,-1,-3,14,36,-16,-9,-9,10,62,114,107,45,10,3,32,56,53,12,3,1,30,58,54,33,7,2,-203,-180,-23,133,57,76,-9,-7,-142,-72,-19,35,-23,-18,-93,-56,-15,16,14,11,-49,-16,-4,19,37,71,2,11,-1,3,6,42,8,-6,-2,2,31,29,-6,17,1,1,-52,-103,51,233,107,126,56,43,-178,-28,1,50,14,22,-114,-32,-7,15,42,21,-64,4,8,35,47,80,49,23,19,7,17,47,23,9,3,4,30,33,26,14,16,3,-266,-118,-148,54,37,17,-40,-39,-141,-31,-37,24,-34,-1,-55,-12,-21,9,-6,-38,-86,-19,-16,15,6,42,28,-20,-8,5,4,31,31,-25,-2,-2,2,11,-3,5,-6,7,-149,-115,-34,47,18,29,29,-19,-85,-51,-47,18,18,3,-87,-30,-26,4,11,-22,2,-21,-21,14,24,44,-4,-21,-2,2,16,35,-15,-15,-8,1,8,9,11,-6,6,1,-394,-234,-160,-129,-122,-7,-8,-44,-144,-120,-64,-13,8,-27,-66,-81,-61,-13,-16,-17,-78,-39,-3,0,6,-10,-42,-41,-46,-1,8,-20,-37,-31,-43,-3,-2,10,-5,-10,-3,2,-332,-230,-102,-121,-98,-23,-30,-18,-142,-114,-15,-14,-28,-14,-78,-77,-9,-20,-2,-4,-64,-37,-6,6,-2,17,-59,-64,-14,-3,-4,14,-46,-49,-13,-3,2,3,-13,-15,-1,0,-415,-281,-134,-234,-149,-85,-8,-50,-238,-149,-12,37,11,-25,-137,-118,-16,3,-19,-25,-101,-31,4,34,-9,12,-89,-100,-45,-5,1,3,-44,-71,-34,-5,-10,9,-45,-29,-11,0,134,31,103,176,71,105,66,33,-37,36,4,26,16,26,-38,8,-10,24,50,7,1,28,14,2,68,61,33,8,-4,10,34,35,14,-9,-9,6,34,26,19,17,5,4
39,39095,Val de San Vicente,2556,47,23,24,11,5,6,3,10,19,6,8,1,0,10,6,5,2,0,3,0,13,1,6,1,1,2,5,1,2,0,0,1,2,1,1,0,1,1,3,0,1,0,20,13,7,5,1,4,0,-10,8,6,15,1,-2,-2,3,4,8,2,2,-8,5,2,7,-1,0,0,5,0,0,0,0,0,1,0,0,0,0,0,4,0,0,0,27,7,20,7,4,3,-1,6,14,5,-2,3,-4,7,-1,4,-2,2,3,-1,15,1,0,1,2,2,2,0,0,0,2,0,1,1,0,0,0,2,1,-1,0,0,1,2,-1,24,9,15,-22,10,13,-7,9,-2,-15,5,10,0,5,-3,-7,5,3,-7,4,1,8,4,11,1,0,0,3,1,5,0,0,0,5,3,6,1,0,0,29,24,5,21,11,10,8,16,5,-3,2,1,8,7,6,0,-2,4,0,9,-1,-3,4,-3,4,9,6,1,0,0,3,4,3,0,0,0,1,5,3,1,0,0,40,32,8,17,11,6,-10,16,6,0,12,15,-7,7,3,9,10,9,-3,9,3,-9,2,6,1,4,7,2,1,2,1,3,4,2,1,0,0,1,3,0,0,2,52,27,25,23,11,12,9,13,11,9,3,5,4,1,10,2,4,5,5,12,1,7,-1,0,4,2,10,4,0,3,1,1,6,2,0,1,3,1,4,2,0,2,37,33,4,33,24,9,2,3,-1,20,9,3,-1,8,4,16,5,1,3,-5,-5,4,4,2,4,7,11,7,2,2,2,6,8,6,1,1,2,1,3,1,1,1,34,20,14,24,19,5,2,8,5,10,10,-1,2,5,11,-3,6,0,0,3,-6,13,4,-1,2,5,9,6,1,1,1,5,9,3,1,0,1,0,0,3,0,1,57,33,24,21,11,10,2,29,19,1,6,-2,1,11,12,2,6,0,1,18,7,-1,0,-2,3,8,8,-1,3,0,1,5,6,-2,1,0,2,3,2,1,2,0,37,9,28,12,6,6,5,-5,10,13,12,2,1,-4,0,5,6,2,4,-1,10,8,6,0,1,2,3,2,2,2,1,1,1,1,1,1,0,1,2,1,1,1,2,28,-26,4,4,0,-15,7,1,-7,6,8,-3,5,14,0,6,5,-12,2,-13,-7,0,3,0,2,-1,0,1,2,0,1,0,1,1,1,0,1,-1,-1,0,1,-8,6,-14,-3,1,-4,-13,7,3,1,-3,-3,-10,7,8,4,-5,2,-3,0,-5,-3,2,-5,-1,1,0,-2,-1,0,0,1,1,0,-1,0,-1,0,-1,-2,0,0,-19,-4,-15,-30,-22,-8,-5,1,-4,-5,-2,-4,-4,2,1,-4,0,1,-1,-1,-5,-1,-2,-5,-4,-1,-13,-6,-5,-1,-2,0,-11,-5,-4,0,-2,-1,-2,-1,-1,-1,-25,1,-26,3,0,3,-9,-1,-10,0,0,-2,-1,-2,0,3,0,3,-8,1,-10,-3,0,-5,0,2,-1,2,0,0,0,0,-1,1,0,0,0,2,0,1,0,0,-23,-6,-17,7,3,4,-22,3,-6,-4,5,6,-8,2,-1,-3,1,4,-14,1,-5,-1,4,2,0,1,0,1,1,4,0,0,-1,1,0,3,0,1,1,0,1,1,38,35,3,1,1,0,12,-4,5,13,11,-1,11,-1,4,9,11,-1,1,-3,1,4,0,0,1,-1,-2,1,1,1,0,-1,0,1,1,0,1,0,-2,0,0,1,-13,-14,1,13,4,9,2,-6,-2,-4,3,-5,-3,-3,-4,-7,0,3,5,-3,2,3,3,-8,4,0,3,2,3,1,2,0,1,0,1,0,2,0,2,2,2,1
39,39099,Villaescusa,3113,54,29,25,6,3,3,6,14,7,26,3,-1,4,8,1,16,3,-2,2,6,6,10,0,1,0,3,1,2,0,0,0,1,1,1,0,0,0,2,0,1,0,0,54,24,30,15,4,11,14,5,19,12,0,3,7,4,0,10,1,2,7,1,19,2,-1,1,3,2,6,4,0,0,1,1,1,1,0,0,2,1,5,3,0,0,10,6,4,5,3,2,8,-8,0,5,4,1,4,-2,0,-1,4,1,4,-6,0,6,0,0,2,1,1,0,1,0,2,1,0,0,0,0,0,0,1,0,1,0,44,35,9,22,21,1,-12,15,29,0,8,4,3,11,17,-1,5,0,-15,4,12,1,3,4,10,6,1,6,-1,0,10,6,1,4,0,0,0,0,0,2,-1,0,35,31,4,17,11,6,4,10,3,19,4,-4,5,6,10,14,-2,-1,-1,4,-7,5,6,-3,8,7,1,1,0,0,7,4,1,0,-1,0,1,3,0,1,1,0,37,35,2,8,5,3,7,3,12,8,0,5,13,-2,14,5,2,4,-6,5,-2,3,-2,1,4,3,0,1,-1,0,4,2,0,0,-1,0,0,1,0,1,0,0,-6,-5,-1,3,-4,7,0,-11,-6,15,8,-14,-4,-5,-2,7,3,-5,4,-6,-4,8,5,-9,-1,-2,3,2,1,0,-1,-5,1,1,0,0,0,3,2,1,1,0,63,37,26,20,9,11,28,8,-2,14,12,2,15,1,3,8,8,1,13,7,-5,6,4,1,8,1,5,4,1,1,4,-1,3,3,0,0,4,2,2,1,1,1,53,33,20,12,7,5,21,4,6,16,2,4,12,2,5,9,3,2,9,2,1,7,-1,2,0,5,0,4,1,2,0,2,1,3,1,0,0,3,-1,1,0,2,20,7,13,5,1,4,10,-1,7,3,4,-5,4,1,1,0,1,-1,6,-2,6,3,3,-4,1,3,0,-1,1,1,1,1,-1,-2,1,1,0,2,1,1,0,0,82,51,31,1,-1,2,30,1,29,28,-2,-2,23,0,17,11,-1,0,7,1,12,17,-1,-2,1,0,0,2,-1,-1,1,0,-1,0,0,-1,0,0,1,2,-1,0,81,30,51,-6,-4,-2,31,8,13,23,9,-2,10,5,6,8,3,-2,21,3,7,15,6,0,0,-1,-2,-3,0,0,-1,-1,0,-3,1,0,1,0,-2,0,-1,0,44,25,19,0,1,-1,15,5,10,8,11,-7,11,3,6,2,6,-3,4,2,4,6,5,-4,1,-1,-2,2,0,0,1,0,-1,1,0,0,0,-1,-1,1,0,0,23,19,4,-14,-4,-10,-8,-4,10,15,3,1,4,3,5,6,0,0,-12,-7,5,9,3,1,-2,-1,-4,-5,-2,0,1,0,-1,-3,-1,0,-3,-1,-3,-2,-1,0,46,22,24,-6,-4,-2,19,0,10,10,7,2,10,0,5,3,3,1,9,0,5,7,4,1,-2,-1,-1,-1,-1,0,-2,0,0,-1,-1,0,0,-1,-1,0,0,0,60,30,30,1,0,1,27,8,6,18,5,-2,10,4,5,13,0,-1,17,4,1,5,5,-1,0,0,1,-1,1,0,0,0,1,-2,1,0,0,0,0,1,0,0,10,-1,11,1,-3,4,13,-3,16,-12,3,-7,6,-3,3,-5,-1,-2,7,0,13,-7,4,-5,1,-1,3,-1,-1,0,-1,-1,1,-2,0,0,2,0,2,1,-1,0,31,6,25,-8,-4,-4,-5,0,6,13,10,7,-8,-1,-2,9,1,7,3,1,8,4,9,0,-3,0,0,-5,0,0,-1,0,0,-2,-1,0,-2,0,0,-3,1,0
40,40024,Ayllón,1192,-9,-4,-5,10,4,6,2,-2,-3,0,-2,-5,1,0,-2,-1,1,-3,1,-2,-1,1,-3,-2,4,1,3,1,1,0,3,0,0,0,1,0,1,1,3,1,0,0,41,16,25,16,10,6,5,7,9,2,1,17,2,2,5,-1,0,8,3,5,4,3,1,9,8,3,4,1,0,0,6,3,1,0,0,0,2,0,3,1,0,0,29,15,14,15,6,9,3,13,1,3,6,3,-2,2,7,2,3,3,5,11,-6,1,3,0,1,10,4,0,0,0,0,4,2,0,0,0,1,6,2,0,0,0,1,12,-11,22,15,7,0,-5,4,3,1,-3,1,4,2,3,2,0,-1,-9,2,0,-1,-3,1,7,9,4,1,0,0,6,6,2,1,0,1,1,3,2,0,0,35,12,23,28,13,15,14,7,11,0,2,-1,2,6,3,0,1,-1,12,1,8,0,1,0,10,8,6,3,1,0,2,6,4,1,0,0,8,2,2,2,1,0,15,12,3,50,33,17,-1,19,-1,0,1,-6,1,8,-1,4,1,-3,-2,11,0,-4,0,-3,6,21,10,9,1,0,4,13,8,6,0,0,2,8,2,3,1,0,-5,4,-9,50,28,22,2,5,-3,3,-2,-10,0,0,4,2,-1,-1,2,5,-7,1,-1,-9,5,14,20,10,1,0,1,7,12,7,1,0,4,7,8,3,0,0,63,53,10,93,62,31,15,20,9,11,8,-1,17,14,5,10,6,0,-2,6,4,1,2,-1,26,24,24,11,8,0,18,17,14,7,6,0,8,7,10,4,2,0,9,7,2,24,17,7,4,-2,10,-2,1,-1,2,-3,8,-1,0,1,2,1,2,-1,1,-2,2,10,8,3,1,0,1,6,6,3,1,0,1,4,2,0,0,0,-41,-22,-19,-33,-22,-11,-4,-6,-12,-10,-4,-5,-3,-1,-9,-6,0,-3,-1,-5,-3,-4,-4,-2,0,-4,-14,-10,-5,0,0,-2,-11,-6,-3,0,0,-2,-3,-4,-2,0,-1,11,-12,9,6,3,0,5,-8,5,2,-3,6,3,1,4,1,-2,-6,2,-9,1,1,-1,5,1,1,1,1,0,5,0,2,-2,1,0,0,1,-1,3,0,0,18,11,7,2,1,1,6,13,-4,3,-1,0,5,8,-3,1,1,-2,1,5,-1,2,-2,2,0,3,-3,0,1,0,1,2,-1,-2,1,0,-1,1,-2,2,0,0,-28,-21,-7,-13,-9,-4,-4,-10,-2,-8,5,-8,-2,-7,-2,-7,2,-4,-2,-3,0,-1,3,-4,-4,0,-3,-7,1,0,-2,0,-3,-3,-1,0,-2,0,0,-4,2,0,-6,-7,1,-12,-8,-4,5,-4,-6,0,-2,0,-1,-4,-3,-1,-1,3,6,0,-3,1,-1,-3,-3,-3,-3,-3,-1,0,-2,-2,-3,-1,0,0,-1,-1,0,-2,-1,0,-72,-46,-26,-35,-26,-9,-13,-3,-22,-14,-13,-6,-10,-2,-13,-9,-11,-1,-3,-1,-9,-5,-2,-5,-8,3,-15,-10,-5,-1,-6,2,-10,-8,-4,0,-2,1,-5,-2,-1,-1,-8,-4,-4,-14,-11,-3,1,-5,-4,-2,1,-1,3,-4,-3,-1,-1,0,-2,-1,-1,-1,2,-1,-7,4,-7,-3,0,-1,-2,1,-5,-3,-1,-1,-5,3,-2,0,1,0,-26,-10,-16,-13,-10,-3,-7,-3,-7,-5,-4,1,-1,0,-3,-3,-4,1,-6,-3,-4,-2,0,0,-6,2,-5,-2,-3,1,-3,1,-3,-2,-3,0,-3,1,-2,0,0,1,-4,-2,-2,-3,-1,-2,-1,-2,-3,4,3,-4,-6,2,-2,5,1,-1,5,-4,-1,-1,2,-3,2,-2,-3,0,1,-1,0,0,-2,0,1,0,2,-2,-1,0,0,-1
40,40032,Boceguillas,549,4,6,-2,22,14,8,-4,6,1,6,-2,-2,-2,2,3,5,-2,0,-2,4,-2,1,0,-2,2,7,9,4,0,0,1,3,7,3,0,0,1,4,2,1,0,0,42,26,16,41,23,18,11,19,13,0,-1,0,6,11,10,0,-1,0,5,8,3,0,0,0,6,19,11,4,0,1,3,11,8,1,0,0,3,8,3,3,0,1,12,3,9,22,8,14,2,9,12,-7,0,-4,2,1,3,-4,0,0,0,8,9,-3,0,-4,2,11,7,2,0,0,1,4,2,1,0,0,1,7,5,1,0,0,6,4,2,5,4,1,-6,-2,4,-1,8,1,-4,-1,6,-2,4,1,-2,-1,-2,1,4,0,0,0,2,3,0,0,0,0,1,3,0,0,0,0,1,0,0,0,15,9,6,20,14,6,2,8,5,-4,1,1,-1,4,5,-2,1,0,3,4,0,-2,0,1,1,9,8,3,0,0,0,6,6,2,0,0,1,3,2,1,0,0,26,11,15,46,27,19,3,5,10,2,4,2,4,1,5,-1,0,1,-1,4,5,3,4,1,9,9,17,8,2,0,4,9,9,3,1,0,5,0,8,5,1,0,16,12,4,32,17,15,6,17,-3,-2,-1,0,3,10,-1,4,-3,0,3,7,-2,-6,2,0,6,18,7,0,1,0,1,10,6,-1,1,0,5,8,1,1,0,0,27,18,9,64,41,23,8,16,-2,8,-1,-3,5,9,-2,6,3,-3,3,7,0,2,-4,0,11,21,16,9,5,0,7,11,10,8,4,0,4,10,6,1,1,0,-15,-12,-3,14,12,2,-2,-6,-4,-3,0,-1,-5,-4,-1,-1,-1,0,3,-2,-3,-2,1,-1,2,6,4,1,1,0,1,5,4,1,1,0,1,1,0,0,0,0,15,15,0,16,9,7,5,3,6,4,3,-4,5,0,9,0,5,-2,0,3,-3,4,-2,-2,4,3,4,4,1,0,2,1,4,1,1,0,2,2,0,3,0,0,22,7,15,16,7,9,2,9,-2,6,3,1,0,6,-8,4,4,0,2,3,6,2,-1,1,1,6,3,3,2,0,1,2,0,2,1,0,0,4,3,1,1,0,27,7,20,11,4,7,8,8,6,2,2,0,5,-1,4,-2,1,0,3,9,2,4,1,0,0,6,2,1,1,0,0,1,2,1,0,0,0,5,0,0,1,0,12,13,-1,-1,0,-1,-3,3,10,1,1,-2,-1,5,7,3,-1,-1,-2,-2,3,-2,2,-1,-3,0,1,0,0,0,-3,1,3,-1,0,0,0,-1,-2,1,0,0,26,15,11,13,6,7,18,6,-1,2,4,-4,10,3,-1,2,3,-3,8,3,0,0,1,-1,8,4,0,1,0,0,4,2,0,0,0,0,4,2,0,1,0,0,-13,-3,-10,7,3,4,-6,2,2,-5,-3,-3,-1,2,4,-5,-2,0,-5,0,-2,0,-1,-3,2,3,1,1,0,0,0,1,1,1,0,0,2,2,0,0,0,0,-11,-6,-5,10,5,5,2,-6,-2,-3,-1,-1,0,-1,-3,0,-2,0,2,-5,1,-3,1,-1,1,1,1,5,2,0,0,0,0,5,0,0,1,1,1,0,2,0,-28,-11,-17,4,5,-1,-10,-2,-11,-6,3,-3,-6,1,-4,-2,2,-3,-4,-3,-7,-4,1,0,1,0,2,-1,1,0,1,1,2,0,1,0,0,-1,0,-1,0,0,13,7,6,12,6,6,-5,4,12,-5,8,-1,0,1,6,-4,4,0,-5,3,6,-1,4,-1,0,2,6,0,4,0,0,1,3,0,2,0,0,1,3,0,2,0
40,40065,Chañe,729,-6,-1,-5,2,1,1,-1,-4,2,-1,-1,0,0,-1,1,0,-1,0,-1,-3,1,-1,0,0,0,1,1,0,0,0,0,1,0,0,0,0,0,0,1,0,0,0,1,-3,4,8,1,7,3,5,-5,-1,-1,0,0,1,-2,-2,0,0,3,4,-3,1,-1,0,3,3,1,1,0,0,0,0,1,0,0,0,3,3,0,1,0,0,-6,-3,-3,18,11,7,-2,1,4,-3,-1,-5,-2,1,3,-2,-1,-2,0,0,1,-1,0,-3,2,5,8,3,0,0,1,4,5,1,0,0,1,1,3,2,0,0,2,-1,3,6,2,4,-1,2,0,2,-2,1,-2,-2,1,2,-1,1,1,4,-1,0,-1,0,1,3,2,0,0,0,0,0,2,0,0,0,1,3,0,0,0,0,10,3,7,14,6,8,1,2,-1,4,1,3,1,2,-2,1,0,1,0,0,1,3,1,2,3,3,1,7,0,0,2,2,1,1,0,0,1,1,0,6,0,0,66,32,34,56,28,28,10,3,24,29,1,0,3,3,9,15,2,1,7,0,15,14,-1,-1,5,3,25,22,0,1,1,3,11,12,0,1,4,0,14,10,0,0,7,0,7,42,24,18,-3,12,1,-6,4,-1,-2,5,-1,-3,1,0,-1,7,2,-3,3,-1,3,13,14,10,2,0,0,7,9,7,1,0,3,6,5,3,1,0,98,36,62,121,45,76,11,22,28,34,5,0,6,7,6,14,2,1,5,15,22,20,3,-1,13,29,39,34,4,2,6,10,13,15,0,1,7,19,26,19,4,1,-13,-1,-12,8,3,5,6,-2,-3,-11,-1,-2,2,0,3,-5,0,-1,4,-2,-6,-6,-1,-1,4,0,3,0,1,0,2,-1,2,0,0,0,2,1,1,0,1,0,47,-2,49,52,4,48,3,-1,10,30,5,0,1,-2,-1,0,0,0,2,1,11,30,5,0,3,1,14,31,2,1,1,0,2,1,0,0,2,1,12,30,2,1,33,16,17,52,20,32,0,10,6,16,-1,2,0,8,6,1,0,1,0,2,0,15,-1,1,0,12,17,22,1,0,0,8,8,3,1,0,0,4,9,19,0,0,62,14,48,76,21,55,0,17,19,24,2,2,-2,8,4,2,2,1,2,9,15,22,0,1,5,19,24,26,2,0,0,8,8,4,1,0,5,11,16,22,1,0,-16,-7,-9,6,2,4,3,3,-7,-12,1,-4,1,2,-3,-6,1,-2,2,1,-4,-6,0,-2,4,4,-1,-2,1,0,1,1,-1,0,1,0,3,3,0,-2,0,0,16,10,6,19,8,11,4,4,7,-1,2,1,1,0,6,2,2,0,3,4,1,-3,0,1,2,7,4,4,1,0,0,2,3,2,1,0,2,5,1,2,0,0,-37,-12,-25,-28,-8,-20,4,8,-22,-19,-5,-4,1,10,-11,-7,-3,-3,3,-2,-11,-12,-2,-1,3,5,-21,-11,-2,-3,1,7,-9,-5,-1,-2,2,-2,-12,-6,-1,-1,18,-2,20,24,5,19,-4,5,1,15,3,-2,0,2,-4,0,1,-1,-4,3,5,15,2,-1,-2,11,4,10,1,0,0,6,-2,1,0,0,-2,5,6,9,1,0,-20,7,-27,-17,12,-29,4,13,-11,-19,-6,-1,1,7,0,-1,0,0,3,6,-11,-18,-6,-1,3,12,-4,-24,-4,0,1,5,4,1,1,0,2,7,-8,-25,-5,0,-20,-9,-11,-17,-8,-9,3,0,-10,-14,-2,1,2,1,-7,-6,0,0,1,-1,-3,-8,-2,1,4,1,-10,-12,-2,0,2,1,-7,-5,0,0,2,0,-3,-7,-2,0
40,40063,Cuéllar,9059,110,57,53,77,35,42,37,11,46,14,3,0,21,5,24,7,-1,2,16,6,22,7,4,-2,17,7,29,20,2,2,7,2,15,9,1,1,10,5,14,11,1,1,129,78,51,149,88,61,11,47,31,34,11,-10,3,27,27,16,7,-5,8,20,4,18,4,-5,17,39,50,35,7,0,9,25,35,15,4,0,8,14,15,20,3,0,96,49,47,131,72,59,23,28,18,22,6,-2,2,10,15,15,5,0,21,18,3,7,1,-2,31,35,34,24,2,4,13,19,21,14,3,1,18,16,13,10,-1,3,41,20,21,73,40,33,33,9,-1,2,7,-8,13,2,1,3,5,-5,20,7,-2,-1,2,-3,20,17,19,13,3,0,11,7,12,9,2,-1,9,10,7,4,1,1,27,40,-13,125,77,48,-4,29,18,-3,-3,-6,7,17,20,2,-3,-2,-11,12,-2,-5,0,-4,26,31,36,27,2,2,16,22,20,16,1,1,10,9,16,11,1,1,72,37,35,83,37,46,17,33,2,19,5,-2,10,17,-2,7,5,0,7,16,4,12,0,-2,15,27,22,14,6,-1,8,16,4,6,3,-1,7,11,18,8,3,0,47,22,25,91,45,46,30,8,-8,19,-2,0,11,1,-2,13,-1,1,19,7,-6,6,-1,-1,25,15,30,20,2,-2,11,5,19,11,0,-1,14,10,11,9,2,-1,302,179,123,333,177,156,45,90,71,77,21,-3,22,52,46,49,8,2,23,38,25,28,13,-5,49,100,97,64,17,4,24,57,53,34,7,1,25,43,44,30,10,3,42,25,17,71,42,29,20,-7,7,22,-1,-2,2,3,9,13,-1,-2,18,-10,-2,9,0,0,15,13,16,22,0,1,6,9,12,14,-1,0,9,4,4,8,1,1,-106,-71,-35,-66,-53,-13,-5,-14,-55,-9,-15,-7,-1,-3,-42,-9,-10,-5,-4,-11,-13,0,-5,-2,-12,0,-31,-15,-6,-1,-7,2,-27,-17,-4,0,-5,-2,-4,2,-2,-1,26,0,26,18,-8,26,27,1,-6,21,5,-16,16,0,-10,3,0,-6,11,1,4,18,5,-10,16,13,-1,-2,-4,-3,4,3,-4,-6,-3,-1,12,10,3,4,-1,-2,10,-6,16,12,3,9,12,6,14,-34,9,0,12,-4,-1,-22,4,3,0,10,15,-12,5,-3,9,10,4,-12,2,1,12,3,0,-9,-2,1,-3,7,4,-3,4,0,-28,-11,-17,-59,-34,-25,1,12,-25,-11,-17,6,-2,10,-14,-4,-7,0,3,2,-11,-7,-10,6,-7,-6,-21,-17,-9,0,-5,0,-9,-13,-6,-1,-2,-6,-12,-4,-3,1,-84,-46,-38,-31,-19,-12,-22,-4,-24,-29,-7,-2,-10,-5,-12,-19,-6,3,-12,1,-12,-10,-1,-5,1,-5,-12,-13,0,-2,-1,-1,-9,-9,2,-1,2,-4,-3,-4,-2,-1,-38,-41,3,-39,-28,-11,4,-11,-26,-10,-3,10,-4,-4,-25,-9,0,3,8,-7,-1,-1,-3,7,-4,-3,-3,-20,-8,-2,-3,-3,-10,-11,-2,0,-1,0,7,-9,-6,-2,49,37,12,5,11,-6,0,24,6,12,5,-1,0,16,6,10,7,-3,0,8,0,2,-2,2,2,2,-3,9,-3,-2,1,4,0,9,-1,-1,1,-2,-3,0,-2,-1,45,22,23,22,7,15,23,-2,11,16,0,-2,15,1,5,-1,0,3,8,-3,6,17,0,-5,3,2,0,12,0,5,3,1,-2,3,0,2,0,1,2,9,0,3,103,64,39,44,22,22,19,22,13,34,10,5,13,10,9,18,10,5,6,12,4,16,0,0,7,12,13,11,0,0,4,10,7,4,-2,0,3,2,6,7,2,0
40,40073,Escalona del Prado,593,5,2,3,18,6,12,0,4,3,-1,-1,-1,0,1,1,0,0,0,0,3,2,-1,-1,-1,4,6,5,2,0,0,1,2,2,1,0,0,3,4,3,1,0,0,2,4,-2,10,6,4,3,-1,4,-3,0,-1,2,1,3,-2,0,0,1,-2,1,-1,0,-1,3,2,4,1,0,0,2,1,3,0,0,0,1,1,1,1,0,0,14,12,2,13,7,6,6,-4,7,6,1,-2,6,-2,4,4,0,0,0,-2,3,2,1,-2,0,2,7,4,0,0,0,2,3,2,0,0,0,0,4,2,0,0,10,0,10,13,8,5,3,-1,5,3,0,0,0,-3,3,1,0,-1,3,2,2,2,0,1,3,2,4,4,0,0,2,1,2,3,0,0,1,1,2,1,0,0,23,20,3,29,15,14,5,15,4,-3,2,-1,3,15,4,-2,0,0,2,0,0,-1,2,-1,7,12,6,1,2,0,4,9,2,0,0,0,3,3,4,1,2,0,-10,-8,-2,16,8,8,-5,-1,-8,-2,3,4,-5,1,-4,-2,2,1,0,-2,-4,0,1,3,2,5,4,5,0,0,2,2,3,1,0,0,0,3,1,4,0,0,-4,-3,-1,16,9,7,1,1,-1,-3,-1,-1,0,0,-2,-1,0,-1,1,1,1,-2,-1,0,6,4,4,1,0,0,3,1,2,2,0,0,3,3,2,-1,0,0,35,13,22,30,12,18,8,9,10,11,1,-4,3,-2,6,6,1,-1,5,11,4,5,0,-3,6,6,7,9,2,0,1,0,5,4,2,0,5,6,2,5,0,0,-3,-4,1,2,2,0,0,0,-3,0,0,0,0,-3,-1,0,0,0,0,3,-2,0,0,0,1,0,1,0,0,0,0,0,2,0,0,0,1,0,-1,0,0,0,-6,-2,-4,-9,-4,-5,-1,3,-8,-4,2,1,-1,3,-4,-3,2,0,0,0,-4,-1,0,1,1,3,-8,-5,-1,0,0,1,-5,-1,0,0,1,2,-3,-4,-1,0,3,-3,6,3,2,1,1,5,2,-6,0,-1,1,2,-1,-4,0,-1,0,3,3,-2,0,0,-1,0,2,1,0,1,0,1,1,0,0,0,-1,-1,1,1,0,1,-1,0,-1,8,4,4,-3,5,1,-3,0,0,-1,1,0,-2,2,0,-2,4,1,-1,-2,0,1,3,2,2,0,0,1,1,1,1,0,0,0,2,1,1,0,0,-14,-2,-12,-7,-4,-3,-5,-1,-2,-6,1,-1,0,1,0,-4,1,0,-5,-2,-2,-2,0,-1,-4,1,-1,-3,0,0,0,0,-1,-3,0,0,-4,1,0,0,0,0,7,4,3,4,2,2,4,0,1,-1,2,0,1,0,0,-1,2,1,3,0,1,0,0,-1,1,-1,1,1,1,0,-1,0,0,1,1,0,2,-1,1,0,0,0,-8,-4,-4,-4,-3,-1,-3,-1,-1,-1,0,-2,-2,-1,1,0,0,-2,-1,0,-2,-1,0,0,0,-3,0,0,-1,0,0,-3,0,0,0,0,0,0,0,0,-1,0,-23,-12,-11,0,1,-1,-4,-3,-10,-2,-2,0,-3,-2,-6,1,-1,0,-1,-1,-4,-3,-1,0,0,0,0,0,0,0,0,0,0,1,0,0,0,0,0,-1,0,0,-15,-7,-8,-5,-4,-1,-2,-3,-3,-3,-1,-2,-1,-1,0,-2,-2,-1,-1,-2,-3,-1,1,-1,-1,-3,-1,-1,0,1,-1,-1,0,-1,-1,0,0,-2,-1,0,1,1,-7,-6,-1,-2,-3,1,3,-1,-2,-4,-2,-1,3,-1,-4,-2,-1,-1,0,0,2,-2,-1,0,0,1,-1,-1,0,-1,0,0,-1,-1,0,-1,0,1,0,0,0,0
40,40076,"Espinar, El",6087,41,33,8,33,19,14,-2,-2,4,31,13,-9,2,-3,6,17,10,-2,-4,1,-2,14,3,-7,7,3,14,4,3,1,5,2,7,2,2,0,2,1,7,2,1,1,214,117,97,118,62,56,25,28,76,47,31,5,16,15,43,26,16,2,9,13,33,21,15,3,22,24,35,32,3,1,11,11,17,21,1,1,11,13,18,11,2,0,304,170,134,156,81,75,53,72,71,67,29,9,29,39,52,29,12,6,24,33,19,38,17,3,39,45,38,24,6,2,25,20,24,8,0,2,14,25,14,16,6,0,332,176,156,127,64,63,55,66,98,58,39,12,27,36,58,24,19,7,28,30,40,34,20,5,23,36,40,15,10,1,12,20,21,6,3,0,11,16,19,9,7,1,486,286,200,157,100,57,70,96,179,105,26,5,46,60,91,73,13,2,24,36,88,32,13,3,13,67,49,19,4,1,10,46,30,10,2,1,3,21,19,9,2,0,462,244,218,131,64,67,78,70,177,77,42,16,45,35,84,48,26,6,33,35,93,29,16,10,24,45,35,19,6,0,9,25,16,10,3,0,15,20,19,9,3,0,447,231,216,234,124,110,37,74,207,94,25,7,9,31,116,62,11,-3,28,43,91,32,14,10,28,72,78,41,13,1,11,39,45,22,6,0,17,33,33,19,7,1,495,292,203,332,191,141,76,91,194,83,50,-3,39,51,118,63,27,-2,37,40,76,20,23,-1,45,94,98,62,27,4,25,54,63,36,12,1,20,40,35,26,15,3,279,143,136,140,61,79,39,54,98,61,24,1,23,19,57,33,9,0,16,35,41,28,15,1,23,39,40,24,13,1,9,15,23,11,3,0,14,24,17,13,10,1,150,73,77,38,18,20,39,20,38,19,32,-3,10,4,27,3,23,1,29,16,11,16,9,-4,11,12,2,11,0,0,5,12,-2,2,0,0,6,0,4,9,0,0,1,-10,11,-49,-44,-5,13,15,-2,-10,-21,6,-2,17,-5,-7,-8,-4,15,-2,3,-3,-13,10,10,5,-24,-28,-12,-2,5,4,-20,-24,-9,-1,5,1,-4,-4,-3,-1,-32,-32,0,71,25,46,-17,-9,-15,-9,-9,27,-3,-9,-5,-11,-9,8,-14,0,-10,2,0,19,10,21,17,17,2,4,3,7,7,7,-1,2,7,14,10,10,3,2,-55,-29,-26,25,7,18,-12,7,-35,-22,-2,8,-2,5,-9,-29,4,2,-10,2,-26,7,-6,6,9,10,0,1,3,1,6,0,2,-3,2,0,3,10,-2,4,1,1,-110,-43,-67,-16,-15,-1,-11,-19,-13,-28,-30,-6,-6,-7,-1,-13,-9,-3,-5,-12,-12,-15,-21,-3,3,1,-3,-4,-6,-6,-3,-4,0,-5,-1,-2,6,5,-3,1,-5,-4,-43,-24,-19,32,15,17,-4,-8,-31,-9,-7,13,-11,-2,-16,2,-7,7,7,-6,-15,-11,0,6,10,5,7,8,2,0,1,5,4,6,-1,0,9,0,3,2,3,0,-172,-84,-88,15,12,3,-45,-20,-34,-54,-27,14,-16,-5,-7,-34,-18,-1,-29,-15,-27,-20,-9,15,-1,1,7,6,2,1,0,1,5,5,2,0,-1,0,2,1,0,1,-28,-48,20,22,1,21,-3,-6,-5,-25,3,9,-1,-11,-8,-24,-5,2,-2,5,3,-1,8,7,-1,1,7,3,8,3,1,-1,0,-2,1,2,-2,2,7,5,7,1,-29,-44,15,-8,-17,9,-6,-7,-7,-33,1,18,-8,0,-14,-29,6,-2,2,-7,7,-4,-5,20,-5,7,-1,-14,6,-2,-3,1,-3,-11,1,-2,-2,6,2,-3,5,0
40,40134,Mozoncillo,1030,24,11,13,42,21,21,4,4,5,11,0,1,2,2,3,6,-1,0,2,2,2,5,1,1,12,7,9,14,0,0,6,4,3,8,0,0,6,3,6,6,0,0,27,17,10,37,21,16,10,9,8,4,-2,-2,5,6,5,2,-1,0,5,3,3,2,-1,-2,9,13,8,6,1,0,5,7,5,4,0,0,4,6,3,2,1,0,-3,-3,0,10,5,5,-1,4,-2,-7,3,-1,0,3,-4,-4,2,0,-1,1,2,-3,1,-1,1,6,3,0,0,0,0,4,2,-1,0,0,1,2,1,1,0,0,-3,-2,-1,15,7,8,-5,3,-5,1,1,0,-3,1,1,-2,0,0,-2,2,-6,3,1,0,4,4,2,4,1,0,2,2,1,1,1,0,2,2,1,3,0,0,2,0,2,11,4,7,-7,4,5,-4,4,-1,-3,-2,5,-4,2,1,-4,6,0,0,2,-2,4,4,2,1,0,0,1,1,2,0,0,0,3,3,0,1,0,0,4,3,1,19,5,14,-2,2,-2,6,1,-1,2,2,1,-1,1,-1,-4,0,-3,7,0,0,5,3,2,8,0,0,2,1,1,1,0,0,3,2,1,7,0,0,7,8,-1,12,4,8,-1,9,-6,0,5,1,-1,8,-2,2,1,1,0,1,-4,-2,4,0,7,2,-1,3,1,0,2,3,-2,1,0,0,5,-1,1,2,1,0,28,18,10,59,33,26,-1,17,6,8,1,-3,-1,7,8,5,1,-1,0,10,-2,3,0,-2,3,19,21,14,1,0,2,11,14,6,0,0,1,8,7,8,1,0,18,17,1,28,18,10,9,-4,7,2,4,-1,4,2,5,1,4,0,5,-6,2,1,0,-1,5,7,10,3,1,1,1,3,7,3,2,1,4,4,3,0,-1,0,17,10,7,12,6,6,6,7,2,3,-2,0,-1,6,2,4,-1,0,7,1,0,-1,-1,0,3,5,4,0,0,0,1,3,2,0,0,0,2,2,2,0,0,0,13,11,2,19,8,11,-6,5,-1,14,-1,2,-2,5,1,8,-1,1,-4,0,-2,6,0,1,1,3,6,8,0,0,1,1,3,3,0,0,0,2,3,5,0,0,-23,-9,-14,-1,-2,1,-6,-5,-9,-1,-2,1,-1,-2,-4,0,-2,1,-5,-3,-5,-1,0,0,-2,1,-3,3,0,0,-1,0,-3,2,0,0,-1,1,0,1,0,0,-2,3,-5,4,3,1,1,6,-1,0,-7,-1,0,3,3,1,-4,0,1,3,-4,-1,-3,-1,2,1,2,-2,0,0,1,0,3,-1,0,0,1,1,-1,-1,0,0,-49,-29,-20,-34,-21,-13,-8,-8,-21,-6,-1,-4,-6,-2,-12,-7,1,-2,-2,-6,-9,1,-2,-2,-4,-2,-14,-8,-4,-2,-1,0,-9,-8,-2,-1,-3,-2,-5,0,-2,-1,-2,1,-3,-5,-2,-3,-2,-1,-1,2,-1,1,1,0,-1,2,-2,1,-3,-1,0,0,1,0,-2,-3,-1,1,0,0,0,-1,-1,0,0,0,-2,-2,0,1,0,0,-3,-1,-2,4,3,1,0,-8,2,4,0,-1,-1,-4,0,4,2,-2,1,-4,2,0,-2,1,1,-1,2,1,1,0,1,-1,1,1,1,0,0,0,1,0,0,0,0,1,-1,4,2,2,0,2,3,-2,-2,1,1,3,2,-1,-2,0,-1,-1,1,-1,0,1,-1,4,0,1,0,0,0,4,-1,0,-1,0,-1,0,1,1,1,0,-1,1,-2,10,8,2,3,3,-7,-3,-1,4,2,1,-5,0,1,2,1,2,-2,-3,-2,2,3,3,4,-1,0,1,2,1,4,1,0,0,1,2,0,-2,0,1
40,40138,Nava de la Asunción,2662,22,10,12,8,2,6,5,2,-3,4,1,12,1,0,0,1,1,6,4,2,-3,3,0,6,1,1,2,0,2,2,0,0,1,0,1,0,1,1,1,0,1,2,10,3,7,3,2,1,-6,3,1,2,3,7,-3,2,2,1,2,-1,-3,1,-1,1,1,8,0,2,0,0,0,1,0,2,0,0,0,0,0,0,0,0,0,1,17,8,9,23,10,13,13,-5,-8,0,3,13,11,-6,-4,-1,3,7,2,1,-4,1,0,6,7,7,3,2,2,0,2,2,3,2,1,0,5,5,0,0,1,0,33,7,26,24,12,12,2,2,9,9,3,6,-1,-2,1,4,1,3,3,4,8,5,2,3,2,5,9,5,2,0,0,3,5,4,0,0,2,2,4,1,2,0,64,45,19,65,44,21,8,11,23,17,1,5,1,12,18,11,1,3,7,-1,5,6,0,2,9,17,20,17,1,0,5,12,14,12,1,0,4,5,6,5,0,0,88,55,33,62,35,27,16,20,36,10,5,2,11,11,19,9,3,2,5,9,17,1,2,0,2,21,24,12,3,0,0,14,14,6,1,0,2,7,10,6,2,0,19,4,15,32,19,13,8,1,-7,9,5,3,7,1,-8,2,1,2,1,0,1,7,4,1,3,10,8,9,1,1,2,5,4,7,0,1,1,5,4,2,1,0,156,98,58,109,68,41,33,26,59,27,6,4,18,20,39,15,3,2,15,6,20,12,3,2,21,34,31,16,5,2,12,21,21,10,4,0,9,13,10,6,1,2,26,13,13,29,16,13,6,3,-9,16,4,7,9,3,-8,6,2,1,-3,0,-1,10,2,6,8,10,6,4,1,0,6,7,2,1,0,0,2,3,4,3,1,0,17,-2,19,23,5,18,-4,-4,5,3,5,12,-3,-7,2,0,1,5,-1,3,3,3,4,7,1,4,7,5,3,3,0,-1,4,1,0,1,1,5,3,4,3,2,5,-4,9,18,7,11,-2,7,-8,4,0,1,-2,0,-8,2,1,1,0,7,0,2,-1,0,1,6,4,4,2,1,1,1,1,2,1,1,0,5,3,2,1,0,26,18,8,22,17,5,12,2,-2,0,1,13,9,2,3,-3,0,7,3,0,-5,3,1,6,9,4,5,2,1,1,8,3,4,1,1,0,1,1,1,1,0,1,43,6,37,7,3,4,8,-5,-17,5,-3,56,5,-1,-14,1,-2,18,3,-4,-3,4,-1,38,2,4,2,1,-1,-1,1,3,0,0,0,-1,1,1,2,1,-1,0,-23,-15,-8,1,3,-2,-8,-3,-9,-12,8,2,-1,-4,-3,-7,2,-1,-7,1,-6,-5,6,3,2,1,1,-2,1,-2,2,1,1,-1,1,-1,0,0,0,-1,0,-1,19,11,8,16,7,9,7,7,0,4,-5,6,3,5,-1,3,-2,3,4,2,1,1,-3,3,2,6,-1,4,2,3,1,4,-1,1,1,1,1,2,0,3,1,2,22,11,11,18,9,9,4,3,4,1,9,1,0,-1,7,0,4,1,4,4,-3,1,5,0,3,5,6,0,2,2,0,3,4,0,1,1,3,2,2,0,1,1,27,14,13,0,1,-1,4,3,4,1,-2,16,2,7,0,2,-2,5,2,-4,4,-1,0,11,-4,2,0,3,0,-1,-3,3,-1,2,0,0,-1,-1,1,1,0,-1,23,10,13,23,11,12,2,6,7,4,0,6,3,2,0,3,0,3,-1,4,7,1,0,3,7,8,6,1,-1,2,3,3,4,1,-1,1,4,5,2,0,0,1
40,40141,Navalmanzano,1146,7,6,1,4,3,1,0,4,-1,-2,6,0,0,2,3,-2,3,0,0,2,-4,0,3,0,0,1,3,0,0,0,0,0,3,0,0,0,0,1,0,0,0,0,-19,-10,-9,6,2,4,-5,-3,-6,-2,-2,0,-3,-1,-5,-1,0,0,-2,-2,-1,-1,-2,0,1,2,3,0,0,0,0,1,1,0,0,0,1,1,2,0,0,0,5,3,2,20,11,9,-3,8,-6,8,-2,-1,-1,5,-4,4,-2,1,-2,3,-2,4,0,-2,4,7,3,4,1,0,3,4,2,2,0,0,1,3,1,2,1,0,23,19,4,22,17,5,7,4,5,4,2,2,6,3,5,4,1,0,1,1,0,0,1,2,5,4,8,4,1,0,4,3,6,3,1,0,1,1,2,1,0,0,20,1,19,18,8,10,10,1,3,6,1,0,3,0,-2,0,1,0,7,1,5,6,0,0,3,5,3,7,0,0,2,3,0,3,0,0,1,2,3,4,0,0,-19,-9,-10,11,9,2,-4,-3,-9,-3,0,0,0,-1,-7,-1,0,0,-4,-2,-2,-2,0,0,0,4,5,2,0,0,0,4,3,2,0,0,0,0,2,0,0,0,-18,-5,-13,3,2,1,-5,-1,-9,-6,3,0,-2,2,-2,-6,2,1,-3,-3,-7,0,1,-1,-1,1,1,1,1,0,0,1,1,0,0,0,-1,0,0,1,1,0,46,18,28,40,17,23,12,6,13,11,4,0,4,2,4,6,2,0,8,4,9,5,2,0,5,4,16,11,4,0,2,2,5,6,2,0,3,2,11,5,2,0,-1,4,-5,9,4,5,-5,2,0,2,-1,1,-2,2,1,3,0,0,-3,0,-1,-1,-1,1,1,2,5,1,0,0,0,1,2,1,0,0,1,1,3,0,0,0,7,5,2,16,8,8,6,-3,2,1,1,0,4,-1,2,0,0,0,2,-2,0,1,1,0,5,2,4,4,1,0,3,0,2,3,0,0,2,2,2,1,1,0,13,4,9,19,7,12,0,3,5,4,0,1,-1,1,2,0,1,1,1,2,3,4,-1,0,4,7,3,5,0,0,3,2,0,2,0,0,1,5,3,3,0,0,2,-1,3,2,1,1,7,1,-4,3,-5,1,4,0,-3,2,-5,1,3,1,-1,1,0,0,0,0,-1,3,0,0,0,0,0,1,0,0,0,0,-1,2,0,0,-14,-4,-10,8,7,1,-5,0,-5,-6,1,1,1,0,-2,-5,1,0,-6,0,-3,-1,0,1,3,2,1,0,1,0,2,1,2,0,1,0,1,1,-1,0,0,0,4,5,-1,9,5,4,-5,-4,3,8,0,2,-4,-3,5,5,0,2,-1,-1,-2,3,0,0,-1,2,3,5,0,0,-1,0,3,3,0,0,0,2,0,2,0,0,-8,-4,-4,10,4,6,-3,-1,-3,0,0,-2,-1,-2,0,-2,1,-1,-2,1,-3,2,-1,-1,0,5,2,2,1,0,0,2,1,1,0,0,0,3,1,1,1,0,-5,-5,0,6,1,5,-3,-5,-2,2,3,0,-2,-1,-3,0,1,0,-1,-4,1,2,2,0,2,3,-1,2,0,0,1,1,-1,0,0,0,1,2,0,2,0,0,0,1,-1,8,4,4,3,0,-1,-1,1,-2,0,1,0,0,2,-2,3,-1,-1,-1,-1,0,1,2,5,1,-1,0,0,1,2,1,0,0,1,1,3,0,-1,0,-11,-7,-4,7,1,6,-4,-3,2,-3,-3,0,-4,-4,2,-1,0,0,0,1,0,-2,-3,0,2,1,2,2,0,0,1,-1,1,0,0,0,1,2,1,2,0,0
40,40170,Riaza,1686,85,50,35,104,65,39,0,19,23,19,12,12,-2,14,13,15,7,5,2,5,10,4,5,7,9,25,34,31,5,0,5,16,21,19,4,0,4,9,13,12,1,0,189,112,77,198,120,78,31,48,64,28,5,9,12,25,47,19,3,3,19,23,17,9,2,6,36,46,70,33,10,0,17,26,46,23,6,0,19,20,24,10,4,0,79,45,34,111,67,44,17,22,21,10,6,3,14,12,9,7,3,0,3,10,12,3,3,3,23,34,27,23,4,0,15,22,14,13,3,0,8,12,13,10,1,0,65,32,33,95,44,51,27,23,15,-3,-3,4,11,12,8,1,-4,2,16,11,7,-4,1,2,29,29,18,13,3,1,14,13,10,4,1,0,15,16,8,9,2,1,112,66,46,85,50,35,14,38,20,29,8,1,11,18,16,11,5,1,3,20,4,18,3,0,10,35,18,16,4,0,6,18,14,8,2,0,4,17,4,8,2,0,92,59,33,88,58,30,16,21,30,28,3,-5,11,12,22,13,5,-3,5,9,8,15,-2,-2,20,17,32,15,2,2,13,11,24,7,2,1,7,6,8,8,0,1,135,87,48,108,69,39,13,18,50,41,13,-1,12,13,29,26,10,-4,1,5,21,15,3,3,18,31,36,19,3,0,13,18,22,13,2,0,5,13,14,6,1,0,150,75,75,208,114,94,32,48,30,19,15,5,19,29,14,4,6,3,13,19,16,15,9,2,43,65,54,31,13,0,25,39,28,12,9,0,18,26,26,19,4,0,10,-8,18,57,32,25,14,1,3,5,-16,3,5,-4,-1,2,-8,-1,9,5,4,3,-8,4,13,12,19,10,3,0,9,6,9,6,2,0,4,6,10,4,1,0,29,6,23,18,2,16,8,21,-6,1,1,3,4,7,-7,-4,2,3,4,14,1,5,-1,0,7,10,4,-2,-1,-1,1,2,2,-2,-1,-1,6,8,2,0,0,0,15,19,-4,5,1,4,1,6,2,1,1,4,1,7,6,3,1,1,0,-1,-4,-2,0,3,1,5,-1,1,0,-1,0,2,0,-1,0,0,1,3,-1,2,0,-1,-43,-25,-18,9,5,4,-6,-10,-21,-11,0,7,-7,-2,-17,-5,1,5,1,-8,-4,-6,-1,2,0,5,3,-1,1,1,-1,1,4,0,1,0,1,4,-1,-1,0,1,-18,-16,-2,5,2,3,9,-6,-19,2,1,-5,4,-7,-10,1,0,-4,5,1,-9,1,1,-1,4,2,-3,2,0,0,2,-2,0,2,0,0,2,4,-3,0,0,0,-15,-10,-5,7,2,5,-5,-1,-2,-5,-6,1,-3,2,-5,-6,-3,1,-2,-3,3,1,-3,0,2,3,-2,3,0,0,1,1,-3,2,0,0,1,2,1,1,0,0,-31,-20,-11,16,8,8,-12,-1,-3,-13,-6,2,-8,-3,-2,-6,-2,0,-4,2,-1,-7,-4,2,6,3,2,4,1,0,4,1,0,3,0,0,2,2,2,1,1,0,-3,-17,14,15,8,7,-4,7,-19,3,0,9,-10,6,-15,1,-2,3,6,1,-4,2,2,6,3,5,2,3,0,1,2,3,1,0,0,1,1,2,1,3,0,0,-26,-14,-12,13,7,6,2,-14,6,-14,-8,3,6,-7,5,-12,-3,-3,-4,-7,1,-2,-5,6,6,1,7,-2,1,0,3,0,3,0,1,0,3,1,4,-2,0,0,-17,-10,-7,20,10,10,-4,-2,-27,11,0,5,-5,0,-9,7,-1,-2,1,-2,-18,4,1,7,8,3,-1,9,1,0,4,2,-1,5,0,0,4,1,0,4,1,0
40,40179,Sanchonuño,742,16,11,5,5,4,1,3,1,4,1,5,2,2,1,3,1,3,1,1,0,1,0,2,1,0,0,4,0,1,0,0,0,3,0,1,0,0,0,1,0,0,0,39,23,16,24,12,12,3,10,9,7,5,5,1,4,6,6,2,4,2,6,3,1,3,1,3,8,7,6,0,0,1,3,4,4,0,0,2,5,3,2,0,0,15,6,9,10,6,4,4,6,3,1,0,1,2,1,1,2,0,0,2,5,2,-1,0,1,0,4,3,3,0,0,0,2,2,2,0,0,0,2,1,1,0,0,24,13,11,23,11,12,6,6,2,7,0,3,6,4,1,2,0,0,0,2,1,5,0,3,5,7,7,4,0,0,4,4,3,0,0,0,1,3,4,4,0,0,32,14,18,26,10,16,3,10,8,8,2,0,0,5,5,3,1,0,3,5,3,5,1,0,4,7,11,4,0,0,1,3,5,1,0,0,3,4,6,3,0,0,18,9,9,26,11,15,2,1,10,2,3,0,2,-2,5,1,2,1,0,3,5,1,1,-1,7,4,14,1,0,0,3,1,7,0,0,0,4,3,7,1,0,0,14,6,8,28,16,12,4,4,5,2,-2,1,1,2,2,1,0,0,3,2,3,1,-2,1,6,7,10,4,1,0,3,4,6,2,1,0,3,3,4,2,0,0,59,33,26,46,27,19,10,13,17,14,5,1,1,8,11,10,3,0,9,5,6,4,2,1,4,12,18,11,1,0,1,7,11,8,0,0,3,5,7,3,1,0,28,15,13,17,12,5,6,3,5,9,5,0,4,1,0,7,3,0,2,2,5,2,2,0,1,2,5,6,3,0,1,1,3,5,2,0,0,1,2,1,1,0,3,1,2,2,0,2,2,4,-1,3,-1,-4,0,4,1,-1,-1,-2,2,0,-2,4,0,-2,0,5,-1,-1,-1,0,0,3,0,-2,-1,0,0,2,-1,1,0,0,8,4,4,16,7,9,2,7,1,0,1,-3,1,3,2,-1,1,-2,1,4,-1,1,0,-1,2,7,5,1,1,0,0,4,2,1,0,0,2,3,3,0,1,0,40,20,20,17,5,12,6,5,5,8,6,9,4,4,3,3,2,3,2,1,2,5,4,6,4,8,1,1,1,2,1,3,1,0,0,0,3,5,0,1,1,2,9,6,3,-12,-7,-5,-1,-1,7,0,0,3,1,-4,6,3,0,-1,-2,3,1,-3,0,4,-2,-2,-3,-3,-1,-1,-1,-1,-2,-2,-1,0,-1,-1,-1,-1,0,-1,-36,-21,-15,-13,-11,-2,-1,-4,-16,-11,-2,-1,-1,0,-11,-6,-2,-1,0,-4,-5,-5,0,0,-1,-1,-10,1,-2,0,-1,0,-9,0,-1,0,0,-1,-1,1,-1,0,4,2,2,0,-1,1,-4,1,-5,8,2,2,-2,-1,-1,5,1,0,-2,2,-4,3,1,2,-1,0,0,2,-1,0,0,-1,0,1,-1,0,-1,1,0,1,0,0,-1,5,-6,7,4,3,-1,-2,2,6,-3,-3,1,-1,6,4,-4,-1,-2,-1,-4,2,1,-2,1,1,4,1,0,0,1,0,3,0,0,0,0,1,1,1,0,0,-10,-5,-5,1,2,-1,-1,-3,-1,-2,-1,0,-4,-1,0,1,0,0,3,-2,-1,-3,-1,0,1,-1,3,-3,1,0,1,-1,2,0,0,0,0,0,1,-3,1,0,0,1,-1,-13,-5,-8,8,2,-1,-7,-3,-1,3,0,2,-4,-2,1,5,2,-3,-3,-1,-2,-3,3,-4,-4,-4,-2,-2,1,0,-3,-1,0,-1,2,-4,-1,-3,-2
40,40194,Segovia,54175,-320,-170,-150,6,2,4,-13,-105,-122,-74,-4,6,10,-42,-88,-38,-4,-1,-23,-63,-34,-36,0,7,0,2,1,0,1,2,0,0,1,0,0,1,0,2,0,0,1,1,-310,-188,-122,10,6,4,-13,-112,-128,-39,-14,-5,-15,-55,-75,-27,-17,-4,2,-57,-53,-12,3,-1,2,1,3,1,2,1,2,1,1,1,1,0,0,0,2,0,1,1,-565,-315,-250,-14,-3,-11,-41,-157,-263,-64,-65,21,-28,-81,-152,-26,-31,0,-13,-76,-111,-38,-34,21,3,-5,-9,-1,-1,-1,2,-1,-4,0,0,0,1,-4,-5,-1,-1,-1,-649,-302,-347,56,30,26,-36,-122,-333,-62,-60,-28,4,-44,-168,-35,-39,-12,-40,-78,-165,-27,-21,-16,6,19,10,15,2,2,3,9,6,10,0,1,3,10,4,5,2,1,183,64,119,829,454,375,99,78,-9,10,-14,14,38,44,-5,-15,-15,12,61,34,-4,25,1,2,148,199,251,168,48,5,79,104,147,95,22,2,69,95,104,73,26,3,197,137,60,1045,616,429,87,108,-133,103,3,15,44,57,-37,66,-10,11,43,51,-96,37,13,4,169,282,314,221,40,17,88,148,205,146,18,8,81,134,109,75,22,9,462,303,159,1514,931,583,105,243,-31,149,-12,1,78,146,27,70,-15,0,27,97,-58,79,3,1,192,466,457,318,65,7,94,278,310,207,35,3,98,188,147,111,30,4,637,392,245,1704,977,727,188,300,-35,148,0,23,110,179,-6,89,3,10,78,121,-29,59,-3,13,261,476,522,335,77,13,140,275,311,198,40,6,121,201,211,137,37,7,-326,-218,-108,540,278,262,34,-11,-213,-50,-28,-40,24,10,-151,-57,-27,-11,10,-21,-62,7,-1,-29,116,140,146,113,21,0,69,76,72,52,8,-1,47,64,74,61,13,1,-813,-579,-234,-246,-262,16,51,-76,-461,-222,-73,-45,14,-57,-302,-175,-49,-17,37,-19,-159,-47,-24,-28,120,-28,-199,-105,-39,-5,48,-38,-150,-103,-25,-2,72,10,-49,-2,-14,-3,-475,-236,-239,-191,-135,-56,-46,5,-207,-122,-93,-18,-11,19,-108,-85,-46,-3,-35,-14,-99,-37,-47,-15,-23,8,-72,-66,-43,0,-10,1,-49,-53,-27,2,-13,7,-23,-13,-16,-2,-247,-159,-88,94,3,91,33,43,-171,-58,-37,-34,21,27,-85,-49,-33,-15,12,16,-86,-9,-4,-19,40,57,5,-10,7,-7,15,19,-8,-18,-3,-3,25,38,13,8,10,-4,-403,-295,-108,-132,-129,-3,35,-82,-210,-75,-44,-23,19,-67,-149,-70,-33,1,16,-15,-61,-5,-11,-24,8,-3,-78,-51,-10,1,8,-14,-55,-60,-12,2,0,11,-23,9,2,-1,-833,-551,-282,-494,-318,-176,-58,-81,-406,-192,-103,1,-35,-48,-282,-119,-65,-6,-23,-33,-124,-73,-38,7,-66,-32,-209,-136,-53,-1,-32,-13,-142,-97,-34,-2,-34,-19,-67,-39,-19,1,-400,-265,-135,-274,-185,-89,-12,-48,-229,-120,-42,44,8,-43,-153,-64,-39,23,-20,-5,-76,-56,-3,21,-4,10,-137,-97,-40,-5,-2,-4,-84,-59,-35,-1,-2,14,-53,-38,-5,-4,-178,-130,-48,56,12,44,-12,26,-168,-37,-9,6,8,18,-119,-44,-18,17,-20,8,-49,7,9,-11,0,54,-11,7,-3,1,5,25,-15,-7,-5,3,-5,29,4,14,2,-2,-194,-178,-16,99,8,91,29,-15,-215,-26,-19,43,22,-22,-139,-23,-24,5,7,7,-76,-3,5,38,58,36,-4,11,-8,1,37,12,-28,-1,-11,-2,21,24,24,12,3,3,61,-77,138,192,28,164,109,67,-98,14,-30,2,64,34,-87,-51,-29,-1,45,33,-11,65,-1,3,57,87,58,-12,-1,-6,29,30,7,-28,-12,-2,28,57,51,16,11,-4
40,40208,Turégano,1113,10,11,-1,30,19,11,1,3,7,2,2,-4,1,3,7,3,1,-3,0,0,0,-1,1,-1,6,7,11,5,1,0,3,5,7,4,0,0,3,2,4,1,1,0,43,28,15,60,36,24,12,14,10,7,2,-1,8,10,8,3,1,-1,4,4,2,4,1,0,17,15,19,6,3,0,11,10,9,4,2,0,6,5,10,2,1,0,-35,-16,-19,26,13,13,-8,-6,-14,-5,3,-5,-7,-2,-6,-2,2,-1,-1,-4,-8,-3,1,-4,7,7,4,6,2,0,3,3,3,3,1,0,4,4,1,3,1,0,49,24,25,44,19,25,9,10,8,13,7,1,1,2,4,12,5,-1,8,8,4,1,2,2,13,11,9,10,0,1,4,4,4,7,0,0,9,7,5,3,0,1,41,26,15,57,30,27,10,7,12,9,2,0,4,6,8,5,3,-1,6,1,4,4,-1,1,11,12,19,10,2,1,4,7,11,5,2,0,7,5,8,5,0,1,32,12,20,40,15,25,11,-3,5,10,5,3,5,-1,0,4,3,1,6,-2,5,6,2,2,9,6,8,8,5,3,4,2,1,4,3,1,5,4,7,4,2,2,40,23,17,66,28,38,15,10,11,4,2,-2,9,6,4,2,1,0,6,4,7,2,1,-2,16,13,20,12,4,1,8,5,6,7,2,0,8,8,14,5,2,1,-1,-2,1,61,30,31,4,3,5,-8,-3,-2,1,5,2,-6,-3,-1,3,-2,3,-2,0,-1,15,13,20,12,0,1,5,8,12,5,0,0,10,5,8,7,0,1,-11,-19,8,16,7,9,-1,-2,-8,0,0,1,-3,-2,-7,-5,-1,0,2,0,-1,5,1,1,3,3,4,6,0,0,1,1,2,3,0,0,2,2,2,3,0,0,0,1,-1,16,6,10,-1,4,-2,-1,0,-2,0,3,-1,-2,0,0,-1,1,-1,1,0,-2,5,3,4,2,1,0,2,1,2,1,0,0,3,2,2,1,1,0,5,0,5,10,1,9,-1,-4,7,5,-1,-2,-2,-3,5,3,-1,-2,1,-1,2,2,0,0,2,5,1,1,0,1,1,1,-1,0,0,0,1,4,2,1,0,1,-27,-15,-12,8,2,6,-7,2,-7,-8,-3,-4,-4,-3,-5,-3,1,-1,-3,5,-2,-5,-4,-3,2,5,2,-3,2,0,1,0,0,-1,2,0,1,5,2,-2,0,0,-25,-18,-7,-26,-18,-8,-1,6,-14,-8,-2,-5,1,-1,-5,-7,-3,-2,-2,7,-9,-1,1,-3,-2,2,-13,-4,-3,-5,-2,0,-6,-3,-4,-2,0,2,-7,-1,1,-3,-11,-6,-5,-2,2,-4,-4,-3,2,-5,2,-3,-2,-3,-1,0,1,-1,-2,0,3,-5,1,-2,-2,0,1,0,0,-1,0,-1,3,0,0,0,-2,1,-2,0,0,-1,-12,2,-14,2,3,-1,-4,-1,-9,3,-2,0,-2,6,-1,-1,-1,0,-2,-7,-8,4,-1,0,0,-2,1,1,1,0,0,1,1,0,0,0,0,-3,0,1,1,0,-14,-9,-5,-7,-2,-5,7,-4,-4,5,-13,-7,5,-3,-2,-1,-7,-3,2,-1,-2,6,-6,-4,4,-1,1,-4,-7,0,2,2,0,-4,-3,1,2,-3,1,0,-4,-1,-8,-8,0,13,3,10,4,-5,-3,-10,2,3,-3,-1,-4,-2,0,2,7,-4,1,-8,2,1,5,2,2,2,1,1,2,1,-1,1,0,0,3,1,3,1,1,1,-10,1,-11,18,8,10,-1,0,0,2,-8,0,3,2,3,0,-3,-1,-4,-2,-3,2,-5,1,4,3,7,3,1,0,2,2,2,2,0,0,2,1,5,1,1,0
40,40225,Villacastín,1537,-12,0,-12,5,3,2,-4,-1,-5,-5,4,0,-1,4,-3,-1,2,0,-3,-5,-2,-4,2,0,0,2,2,1,0,0,0,2,0,1,0,0,0,0,2,0,0,0,25,17,8,21,11,10,8,1,12,3,2,-1,4,2,8,2,2,-1,4,-1,4,1,0,0,2,6,10,2,1,0,0,3,7,0,1,0,2,3,3,2,0,0,-4,0,-4,18,11,7,-7,3,-13,9,6,-3,0,3,-7,4,2,-2,-7,0,-6,5,4,-1,2,2,7,5,1,1,1,2,4,4,0,0,1,0,3,1,1,1,59,29,30,34,17,17,9,9,17,14,3,3,3,2,8,10,2,1,6,7,9,4,1,2,4,4,16,9,0,1,3,1,7,6,0,0,1,3,9,3,0,1,14,6,8,29,19,10,1,13,0,5,-3,-1,0,7,0,1,-1,0,1,6,0,4,-2,-1,4,9,8,7,0,0,3,5,6,4,0,0,1,4,2,3,0,0,41,30,11,41,29,12,20,7,7,11,-2,-2,12,4,7,7,0,0,8,3,0,4,-2,-2,12,9,12,7,1,0,8,6,9,5,1,0,4,3,3,2,0,0,-13,-19,6,34,15,19,-3,3,-3,-10,-1,-1,-1,-1,-8,-10,-1,1,-2,4,5,0,0,-2,6,9,13,2,3,0,3,4,5,0,2,0,3,5,8,2,1,0,-4,5,-9,56,34,22,-8,1,7,-10,4,3,1,-2,8,-7,3,2,-9,3,-1,-3,1,1,12,10,22,7,4,0,11,3,15,2,3,0,1,7,7,5,1,0,-30,-17,-13,5,9,-4,1,0,-16,-12,-3,-3,0,2,-9,-10,0,-2,1,-2,-7,-2,-3,-1,1,6,-1,-2,0,0,2,6,0,0,0,0,-1,0,-1,-2,0,0,-13,-12,-1,11,-1,12,-3,-6,-3,-2,1,-3,0,-6,-6,-1,1,-1,-3,0,3,-1,0,-2,2,3,6,-2,0,0,0,-1,2,-2,0,0,2,4,4,0,0,0,-12,-6,-6,-2,-4,2,-6,-1,-7,0,3,-1,0,-2,-2,-2,1,0,-6,1,-5,2,2,-1,0,3,-3,-3,0,1,-2,2,-1,-3,-1,1,2,1,-2,0,1,0,-7,-9,2,4,-2,6,2,0,-7,5,-5,-7,0,-2,-3,-1,-1,-3,2,2,-4,6,-4,-4,1,4,2,-4,-1,0,2,-1,1,-4,0,0,-1,5,1,0,-1,0,-58,-31,-27,-19,-11,-8,-11,-10,-13,-20,2,-5,-7,-5,-5,-13,0,-1,-4,-5,-8,-7,2,-4,-1,-3,-10,-6,0,1,0,-2,-5,-3,-1,0,-1,-1,-5,-3,1,1,-22,-1,-21,-12,-4,-8,-8,1,-3,-3,-7,0,1,2,-4,2,-4,3,-9,-1,1,-5,-3,-3,-3,0,-5,-2,-2,0,-1,0,-2,0,-1,0,-2,0,-3,-2,-1,0,-21,-12,-9,-15,-7,-8,5,-6,-1,-12,2,-8,-1,1,-2,-9,2,-3,6,-7,1,-3,0,-5,-3,-3,0,-6,-2,-1,-1,-1,-1,-4,0,0,-2,-2,1,-2,-2,-1,-7,-8,1,-6,-5,-1,-1,2,-4,-4,-1,1,-2,0,-4,-3,1,0,1,2,0,-1,-2,1,-1,2,-1,-2,-4,1,0,1,-2,-1,-2,0,-1,1,1,-1,-2,1,-22,-14,-8,-11,-8,-3,3,-9,-2,-6,-2,-4,1,-6,-3,0,-4,-1,2,-3,1,-6,2,-3,0,-2,-4,-1,-3,-1,0,-1,-3,0,-4,0,0,-1,-1,-1,1,-1,2,9,-7,22,10,12,-8,5,-10,10,-2,7,-3,0,0,7,2,3,-5,5,-10,3,-4,4,3,8,3,4,2,2,1,3,2,2,2,0,2,5,1,2,0,2
41,41001,Aguadulce,1953,7,5,2,4,2,2,-1,-2,0,2,9,0,-1,-1,3,-1,5,0,0,-1,-3,3,4,0,1,0,0,1,0,2,1,0,0,0,0,1,0,0,0,1,0,1,5,5,0,3,2,1,0,0,2,-1,3,1,0,-1,3,-1,2,2,0,1,-1,0,1,-1,0,0,1,1,1,0,0,0,1,0,1,0,0,0,0,1,0,0,2,6,-4,6,4,2,-2,-2,5,-3,2,1,-1,-1,6,0,1,0,-1,-1,-1,-3,1,1,0,2,4,0,0,0,0,1,3,0,0,0,0,1,1,0,0,0,19,5,14,3,1,2,3,3,4,-2,4,5,0,1,1,0,1,2,3,2,3,-2,3,3,0,1,1,0,0,0,0,1,0,0,0,0,0,0,1,0,0,0,10,5,5,8,5,3,3,0,-3,2,11,-3,1,-2,0,1,6,-1,2,2,-3,1,5,-2,2,2,4,0,0,0,2,0,3,0,0,0,0,2,1,0,0,0,20,14,6,19,10,9,-2,-5,2,7,14,4,1,0,3,3,5,2,-3,-5,-1,4,9,2,0,1,1,6,8,3,0,1,0,4,3,2,0,0,1,2,5,1,36,15,21,42,22,20,4,4,-1,17,12,-1,3,2,-4,6,7,0,1,2,3,11,5,-1,10,2,2,11,14,2,6,1,1,4,8,1,4,1,1,7,6,1,54,31,23,34,16,18,20,10,6,6,10,1,12,6,2,4,4,3,8,4,4,2,6,-2,9,6,6,3,9,1,5,3,2,2,3,1,4,3,4,1,6,0,14,1,13,18,8,10,7,10,-11,1,9,-1,0,5,-5,-4,4,1,7,5,-6,5,5,-2,1,2,-1,4,10,2,1,1,-2,1,5,2,0,1,1,3,5,0,56,25,31,25,10,15,14,2,15,6,12,6,6,-1,4,2,8,5,8,3,11,4,4,1,10,2,4,2,6,1,3,0,1,1,4,1,7,2,3,1,2,0,-20,-16,-4,10,5,5,-9,2,-2,-9,2,-2,-5,1,-3,-10,2,0,-4,1,1,1,0,-2,0,1,3,1,6,-1,0,1,1,0,3,0,0,0,2,1,3,-1,-4,-3,-1,8,2,6,2,-3,-3,0,-2,3,0,3,-4,0,-2,1,2,-6,1,0,0,2,1,2,3,0,1,1,0,1,1,0,0,0,1,1,2,0,1,1,9,2,7,12,3,9,5,3,4,-5,3,-1,3,1,2,-5,0,0,2,2,2,0,3,-1,5,1,3,2,2,-1,2,0,0,0,1,0,3,1,3,2,1,-1,12,9,3,8,4,4,8,2,4,-2,-2,0,3,1,3,-1,2,0,5,1,1,-1,-4,0,2,1,2,1,1,1,0,0,1,1,1,1,2,1,1,0,0,0,-49,-30,-19,-33,-13,-20,-2,-8,3,-16,-5,-20,-2,-6,0,-6,-2,-12,0,-2,3,-10,-3,-8,-5,-3,2,-7,-6,-14,-2,0,2,-3,-3,-7,-3,-3,0,-4,-3,-7,-19,-5,-14,1,1,0,-3,3,-6,-5,-5,-3,-1,1,-2,-3,-2,2,-2,2,-4,-2,-3,-5,0,3,-2,-2,0,2,1,2,-1,-2,0,1,-1,1,-1,0,0,1,-13,-7,-6,10,3,7,-6,0,-6,-6,3,2,-5,0,-5,0,2,1,-1,0,-1,-6,1,1,1,4,1,1,2,1,1,1,0,0,1,0,0,3,1,1,1,1,-14,-7,-7,10,4,6,-2,-4,-6,-6,1,5,0,-5,-3,-1,1,2,-2,1,-3,-5,0,3,2,0,1,3,3,1,1,0,0,2,1,0,1,0,1,1,2,1
41,41004,Alcalá de Guadaíra,56743,8,29,-21,16,6,10,14,-37,36,-16,7,6,10,-11,24,-5,7,6,4,-26,12,-11,0,0,1,2,2,2,8,1,0,0,2,1,3,0,1,2,0,1,5,1,116,82,34,7,5,2,-5,32,35,11,9,29,-11,12,35,18,9,17,6,20,0,-7,0,12,4,0,1,0,0,2,3,0,1,0,0,1,1,0,0,0,0,1,451,232,219,-2,-3,1,84,68,129,111,25,25,45,43,64,52,15,7,39,25,65,59,10,18,8,-11,-4,1,4,-1,5,-6,-3,-1,0,1,3,-5,-1,2,4,-2,829,437,392,27,11,16,160,122,371,120,24,26,89,58,183,82,8,13,71,64,188,38,16,13,2,4,6,10,1,4,2,0,1,6,1,1,0,4,5,4,0,3,1545,746,799,173,78,95,259,278,699,212,45,41,107,121,375,118,9,11,152,157,324,94,36,30,39,40,45,24,20,4,19,18,19,11,9,2,20,22,26,13,11,2,1297,680,617,208,97,111,125,265,688,134,50,19,91,102,388,67,26,-1,34,163,300,67,24,20,43,54,52,41,11,6,29,17,29,18,3,1,14,37,23,23,8,5,771,365,406,200,89,111,77,105,411,121,46,18,35,35,208,63,27,0,42,70,203,58,19,18,48,41,59,35,14,1,22,19,29,13,6,0,26,22,30,22,8,1,1146,538,608,286,146,140,214,157,466,185,9,110,124,80,211,92,0,27,90,77,255,93,9,83,75,62,76,54,14,3,39,32,33,30,9,2,36,30,43,24,5,1,1067,541,526,230,112,118,222,145,336,210,19,97,139,50,158,133,4,30,83,95,178,77,15,67,58,46,59,45,9,11,34,21,29,21,2,5,24,25,30,24,7,6,716,323,393,106,33,73,155,75,261,156,12,52,72,24,115,90,3,9,83,51,146,66,9,43,31,42,22,18,-6,-5,15,10,6,2,0,-2,16,32,16,16,-6,-3,474,222,252,105,55,50,60,48,168,100,45,40,32,-6,106,60,20,12,28,54,62,40,25,28,14,33,26,24,8,-1,8,17,16,10,5,-1,6,16,10,14,3,0,238,146,92,-38,-25,-13,27,-8,125,20,17,45,36,-7,93,-5,17,9,-9,-1,32,25,0,36,-17,4,-2,-19,-7,-2,-4,-2,-2,-16,0,-4,-13,6,0,-3,-7,2,84,14,70,71,28,43,0,-8,52,17,-14,45,-8,-24,22,11,-10,21,8,16,30,6,-4,24,22,13,20,11,4,1,10,5,9,4,0,1,12,8,11,7,4,0,60,7,53,-103,-59,-44,61,29,-18,-28,-12,20,31,13,-18,-22,-8,11,30,16,0,-6,-4,9,-26,-6,-29,-34,-9,-2,-17,-7,-10,-19,-6,0,-9,1,-19,-15,-3,-2,138,82,56,50,28,22,-17,42,30,43,31,17,-7,19,34,12,17,12,-10,23,-4,31,14,5,5,12,26,-2,6,0,2,7,18,-4,2,2,3,5,8,2,4,-2,-20,-59,39,-20,-25,5,42,-40,0,-33,-35,51,1,-19,-24,-25,-10,15,41,-21,24,-8,-25,36,5,-4,-11,-12,-2,2,3,-4,-13,-12,-1,2,2,0,2,0,-1,0,-126,-27,-99,-27,-7,-20,-67,5,-29,-77,-3,50,-4,1,-1,-44,-6,22,-63,4,-28,-33,3,28,-4,9,-12,-13,-6,-4,7,4,-8,-7,-4,-2,-11,5,-4,-6,-2,-2,-46,-81,35,8,-10,18,-20,-34,59,-84,-38,64,-1,-22,18,-46,-42,10,-19,-12,41,-38,4,54,21,13,11,-33,-12,6,7,8,9,-28,-9,2,14,5,2,-5,-3,4
41,41005,Alcalá del Río,9265,-114,-76,-38,6,5,1,-11,-36,-25,-32,-7,0,-9,-17,-28,-16,-5,2,-2,-19,3,-16,-2,-2,1,2,3,0,0,0,1,2,2,0,0,0,0,0,1,0,0,0,-104,-54,-50,5,4,1,-22,-25,-35,-21,-2,0,-14,-8,-20,-11,-2,0,-8,-17,-15,-10,0,0,0,2,2,0,0,0,0,1,2,0,0,0,0,1,0,0,0,0,-39,-13,-26,8,6,2,-10,-11,-18,8,0,-6,1,-6,-14,9,1,-1,-11,-5,-4,-1,-1,-5,3,2,3,1,0,-1,1,2,2,1,0,0,2,0,1,0,0,-1,83,40,43,24,13,11,20,16,27,9,2,3,18,0,10,8,0,1,2,16,17,1,2,2,6,7,6,3,1,1,4,3,3,2,1,0,2,4,3,1,0,1,62,20,42,23,8,15,43,-18,17,12,8,4,17,-7,2,3,3,3,26,-11,15,9,5,1,2,8,5,7,1,0,1,3,1,2,1,0,1,5,4,5,0,0,145,83,62,42,25,17,37,14,49,32,0,12,7,18,28,19,0,11,30,-4,21,13,0,1,13,7,12,9,0,0,5,7,6,7,0,0,8,0,6,2,0,0,438,207,231,67,27,40,80,81,178,55,23,7,39,30,93,26,8,0,41,51,85,29,15,7,19,19,12,12,5,0,9,9,5,2,2,0,10,10,7,10,3,0,407,215,192,120,72,48,69,68,132,72,21,27,34,38,83,37,9,7,35,30,49,35,12,20,21,37,32,25,2,1,9,23,22,14,2,1,12,14,10,11,0,0,292,143,149,41,25,16,29,41,135,40,21,16,8,23,67,19,15,10,21,18,68,21,6,6,-1,13,21,8,0,0,0,8,11,6,0,0,-1,5,10,2,0,0,106,41,65,5,-1,6,-5,-4,55,34,8,15,-4,-7,14,21,10,4,-1,3,41,13,-2,11,2,0,1,3,0,-1,1,1,-2,0,0,-1,1,-1,3,3,0,0,197,82,115,-6,-6,0,19,15,111,14,25,5,-4,4,55,9,11,3,23,11,56,5,14,2,3,5,-5,-8,-2,0,-1,2,-3,-4,-1,0,4,3,-2,-4,-1,0,123,89,34,26,9,17,-8,10,61,34,19,-1,7,9,46,12,12,-4,-15,1,15,22,7,3,9,4,6,5,2,-1,6,2,0,0,1,-1,3,2,6,5,1,0,64,10,54,-16,-14,-2,19,25,6,3,-3,0,11,-3,-8,5,-7,-1,8,28,14,-2,4,1,0,-3,-12,-4,0,3,-1,-3,-11,0,-1,2,1,0,-1,-4,1,1,9,-18,27,-46,-28,-18,11,-8,18,-19,1,-2,-3,2,10,-21,-2,-2,14,-10,8,2,3,0,-5,-4,-17,-15,-4,0,-2,-1,-11,-10,-3,0,-3,-3,-6,-5,-1,0,-7,-8,1,-13,-6,-7,-7,-3,4,5,-11,3,-12,-1,6,5,-6,0,5,-2,-2,0,-5,3,-2,2,-12,0,-1,0,0,2,-5,-3,0,0,-2,0,-7,3,-1,0,2,-10,12,-40,-23,-17,10,-16,-2,7,6,-4,-2,-17,2,3,3,-2,12,1,-4,4,3,-2,-1,-8,-14,-10,-6,-1,-1,-3,-9,-6,-4,0,0,-5,-5,-4,-2,-1,70,44,26,-8,-3,-5,8,-8,46,17,2,-2,5,-3,19,16,6,-2,3,-5,27,1,-4,0,2,2,-4,-7,-2,1,2,2,-4,-2,-1,0,0,0,0,-5,-1,1,-48,-10,-38,2,-1,3,-44,-2,6,-22,12,0,-15,-7,7,-2,4,2,-29,5,-1,-20,8,-2,-5,9,-5,0,2,0,0,2,-4,0,0,0,-5,7,-1,0,2,0
41,41007,"Algaba, La",12785,29,15,14,11,5,6,10,1,-1,17,-3,8,3,3,0,10,-4,4,7,-2,-1,7,1,4,4,1,2,4,0,0,0,1,1,3,0,0,4,0,1,1,0,0,78,34,44,27,16,11,21,1,19,18,13,2,10,-3,9,7,6,2,11,4,10,11,7,0,3,5,13,5,0,0,0,2,9,4,0,0,3,3,4,1,0,0,153,70,83,58,27,31,59,20,47,15,3,7,30,10,25,7,-2,-1,29,10,22,8,5,8,17,11,16,11,2,1,7,8,8,5,-1,0,10,3,8,6,3,1,109,60,49,45,26,19,12,34,31,15,14,4,6,10,24,12,7,2,6,24,7,3,7,2,8,15,22,-2,1,0,5,5,14,1,1,0,3,10,8,-3,0,0,138,77,61,20,10,10,17,23,50,38,15,-7,17,7,22,23,6,0,0,16,28,15,9,-7,-1,5,9,5,1,1,-1,0,6,4,0,1,0,5,3,1,1,0,63,44,19,94,60,34,-2,19,27,8,12,0,4,14,16,0,9,-1,-6,5,11,8,3,1,13,34,26,19,2,0,8,20,19,12,1,0,5,14,7,7,1,0,217,111,106,71,36,35,19,47,88,9,13,43,19,18,62,-5,7,11,0,29,26,14,6,32,10,22,23,15,1,0,8,9,13,6,0,0,2,13,10,9,1,0,515,256,259,96,45,51,55,86,233,86,28,17,23,39,120,52,15,0,32,47,113,34,13,17,19,25,25,18,6,1,6,12,14,11,2,0,13,13,11,7,4,1,203,99,104,62,29,33,12,22,124,25,13,8,3,7,58,17,9,7,9,15,66,8,4,1,15,13,19,13,2,-1,6,6,10,6,0,0,9,7,9,7,2,-1,263,125,138,40,19,21,33,42,106,53,10,9,20,13,56,28,2,2,13,29,50,25,8,7,7,7,16,8,2,0,4,2,9,3,1,0,3,5,7,5,1,0,213,72,141,34,10,24,22,25,74,26,32,24,3,8,21,11,14,11,19,17,53,15,18,13,2,5,5,9,9,4,0,1,0,4,3,2,2,4,5,5,6,2,131,37,94,62,25,37,19,34,29,19,11,15,5,8,13,4,5,-2,14,26,16,15,6,17,7,13,20,9,11,2,4,5,11,2,3,0,3,8,9,7,8,2,147,44,103,62,30,32,40,5,65,8,8,13,17,5,15,0,4,1,23,0,50,8,4,12,17,4,20,10,9,1,11,1,8,6,3,1,6,3,12,4,6,0,62,14,48,28,11,17,25,0,13,17,1,-2,9,-1,0,5,2,-5,16,1,13,12,-1,3,5,9,6,5,0,0,-1,6,2,2,0,0,6,3,4,3,0,0,83,28,55,20,10,10,0,20,-7,27,16,22,-9,6,-7,19,10,6,9,14,0,8,6,16,1,9,6,0,0,0,1,4,2,0,0,0,0,5,4,0,0,0,-108,-63,-45,-64,-50,-14,-40,4,-52,-33,-5,15,-21,1,-29,-13,-7,6,-19,3,-23,-20,2,9,-8,-1,-18,-22,-15,-1,-9,1,-14,-19,-10,0,1,-2,-4,-3,-5,-1,13,-10,23,15,2,13,0,1,2,9,-5,0,-3,-3,-10,7,-3,-1,3,4,12,2,-2,1,6,3,3,2,1,0,2,1,-1,0,0,0,4,2,4,2,1,0,-25,-20,-5,8,4,4,-8,-10,-4,-16,-3,16,-12,0,3,-15,-4,8,4,-10,-7,-1,1,8,2,5,4,-4,0,0,-2,1,2,0,0,2,4,4,2,-4,0,-2
41,41010,Almensilla,2884,115,63,52,9,4,5,12,24,36,23,14,4,9,14,16,13,7,3,3,10,20,10,7,1,2,0,1,2,2,2,1,0,0,1,1,1,1,0,1,1,1,1,123,49,74,4,1,3,27,11,31,27,15,11,10,1,15,11,9,2,17,10,16,16,6,9,0,1,0,2,1,0,0,0,0,1,0,0,0,1,0,1,1,0,122,62,60,9,5,4,26,2,41,36,11,7,17,0,21,19,5,1,9,2,20,17,6,6,2,0,3,2,1,1,2,0,1,2,0,0,0,0,2,0,1,1,601,292,309,4,2,2,81,146,210,93,43,14,43,70,94,47,23,9,38,76,116,46,20,5,0,3,1,0,0,0,0,1,1,0,0,0,0,2,0,0,0,0,223,116,107,16,7,9,47,17,97,17,30,7,24,15,47,11,13,0,23,2,50,6,17,7,4,3,2,2,2,0,0,1,1,2,1,0,4,2,1,0,1,0,323,166,157,12,5,7,50,63,104,54,39,7,29,33,55,20,25,3,21,30,49,34,14,4,1,0,6,2,2,0,0,1,3,1,0,0,1,-1,3,1,2,0,162,94,68,20,7,13,9,40,76,26,2,0,6,23,47,17,-5,1,3,17,29,9,7,-1,1,2,5,5,1,4,1,0,3,2,0,1,0,2,2,3,1,3,250,128,122,25,13,12,36,68,87,34,13,9,20,29,49,15,11,1,16,39,38,19,2,8,5,4,8,5,3,0,2,3,4,2,2,0,3,1,4,3,1,0,116,73,43,4,5,-1,14,31,77,7,-12,-1,11,18,44,2,-6,2,3,13,33,5,-6,-3,2,-1,3,1,2,-3,2,-2,3,1,1,0,0,1,0,0,1,-3,65,32,33,13,6,7,8,7,22,20,1,6,6,4,9,12,-1,2,2,3,13,8,2,4,1,3,-1,6,1,3,1,2,-1,3,0,1,0,1,0,3,1,2,4,-8,12,-3,-4,1,-2,6,3,-24,5,13,-7,1,0,-10,0,6,5,5,3,-14,5,7,-2,-1,0,-1,0,0,-2,-1,-1,0,0,0,0,0,1,-1,0,0,-51,-27,-24,2,-1,3,-10,-7,-38,3,-6,13,-3,-6,-18,1,-3,4,-7,-1,-20,2,-3,9,-2,3,2,0,-2,1,-2,1,1,1,-2,0,0,2,1,-1,0,1,5,-1,6,-4,-3,-1,10,-2,18,-12,-3,-5,3,-7,8,-5,-2,1,7,5,10,-7,-1,-6,0,1,-4,-1,2,-2,-1,-1,0,-2,1,0,1,2,-4,1,1,-2,-31,-17,-14,-1,-1,0,-10,0,-26,4,-5,5,-5,2,-19,4,0,2,-5,-2,-7,0,-5,3,0,1,-1,0,-1,0,0,1,-1,-1,0,0,0,0,0,1,-1,0,-4,-16,12,-1,0,-1,-8,2,0,-5,-5,17,-3,-3,-4,-7,-3,6,-5,5,4,2,-2,11,0,-2,-4,0,2,3,0,-1,-2,1,1,1,0,-1,-2,-1,1,2,7,-6,13,9,2,7,3,-7,25,-15,6,0,-2,-5,16,-18,4,0,5,-2,9,3,2,0,2,0,1,1,2,2,1,0,-1,0,1,1,1,0,2,1,1,1,-14,-12,-2,8,3,5,11,14,-17,-9,-6,-7,5,3,-15,-4,-2,0,6,11,-2,-5,-4,-7,4,4,0,4,-1,-2,1,2,-1,1,0,0,3,2,1,3,-1,-2,56,25,31,7,4,3,16,6,29,8,-7,3,6,1,23,1,-6,0,10,5,6,7,-1,3,1,-1,4,4,-1,0,1,-1,2,2,0,0,0,0,2,2,-1,0
41,41012,Aznalcázar,3490,-6,-2,-4,4,2,2,-8,0,-3,1,4,0,-3,-2,0,0,2,1,-5,2,-3,1,2,-1,0,0,2,0,2,0,0,0,1,0,1,0,0,0,1,0,1,0,-26,-8,-18,10,6,4,-16,1,-10,-4,4,-1,-5,4,-7,0,-2,2,-11,-3,-3,-4,6,-3,0,2,1,4,3,0,0,1,1,3,1,0,0,1,0,1,2,0,23,11,12,17,6,11,6,1,0,10,8,-2,2,0,-1,5,5,0,4,1,1,5,3,-2,4,3,8,1,1,0,3,1,2,0,0,0,1,2,6,1,1,0,31,13,18,10,5,5,9,4,6,5,11,-2,3,2,-1,3,6,1,6,2,7,2,5,-3,0,1,3,5,1,0,0,1,1,2,1,0,0,0,2,3,0,0,51,28,23,21,10,11,11,11,14,5,5,4,8,4,9,3,2,1,3,7,5,2,3,3,2,5,8,4,2,0,1,3,3,1,2,0,1,2,5,3,0,0,83,48,35,40,19,21,10,10,32,9,8,13,6,2,23,9,5,2,4,8,9,0,3,11,11,8,12,8,1,0,4,5,4,5,1,0,7,3,8,3,0,0,70,41,29,34,17,17,8,12,34,16,1,-1,9,5,21,9,1,-3,-1,7,13,7,0,2,3,4,19,7,1,0,2,0,10,4,1,0,1,4,9,3,0,0,112,53,59,68,35,33,10,29,40,14,14,5,1,16,16,12,6,1,9,13,24,2,8,4,19,18,17,12,1,1,7,12,8,7,0,1,12,6,9,5,1,0,54,20,34,24,9,15,20,8,6,13,-1,4,10,5,0,6,-4,0,10,3,6,7,3,4,11,4,7,1,2,-1,4,3,2,1,0,-1,7,1,5,0,2,0,77,30,47,31,14,17,15,17,14,15,13,4,4,7,3,9,6,1,11,10,11,6,7,3,9,6,7,5,3,1,3,3,3,2,2,1,6,3,4,3,1,0,64,29,35,24,7,17,24,7,22,8,-4,7,11,-1,15,3,-2,2,13,8,7,5,-2,5,11,5,4,2,0,2,4,2,2,-1,0,0,7,3,2,3,0,2,57,21,36,25,10,15,11,-1,8,15,15,9,4,-1,-2,13,7,0,7,0,10,2,8,9,11,9,3,2,0,0,7,4,0,-1,0,0,4,5,3,3,0,0,-25,-16,-9,-17,-12,-5,-13,10,0,-6,-10,-5,-3,8,0,-13,-1,-5,-10,2,0,7,-9,0,-1,4,-5,-8,-5,-2,-1,1,-5,-6,0,-1,0,3,0,-2,-5,-1,79,36,43,27,11,16,16,7,15,16,10,12,5,7,5,10,0,5,11,0,10,6,10,7,8,6,-1,8,4,2,3,2,1,3,1,1,5,4,-2,5,3,1,128,58,70,26,12,14,38,38,25,12,12,1,19,21,12,2,3,2,19,17,13,10,9,-1,7,6,6,3,3,1,3,2,4,1,1,1,4,4,2,2,2,0,13,4,9,13,11,2,-11,11,-8,1,0,16,-2,7,-14,5,1,5,-9,4,6,-4,-1,11,5,7,3,-2,0,0,4,5,1,1,0,0,1,2,2,-3,0,0,34,-8,42,3,-5,8,7,13,-6,10,1,5,-10,6,-7,0,0,3,17,7,1,10,1,2,2,3,0,-3,0,0,-3,1,-2,-4,1,1,5,2,2,1,-1,-1,26,13,13,18,12,6,12,-7,14,-4,10,3,10,-2,5,-4,5,-1,2,-5,9,0,5,4,6,1,9,-1,1,1,4,2,5,0,1,0,2,-1,4,-1,0,1
41,41015,Benacazón,5033,-4,-3,-1,12,8,4,-2,-8,6,6,0,-5,-2,-2,0,5,-1,-3,0,-6,6,1,1,-2,7,1,1,3,0,0,4,1,0,3,0,0,3,0,1,0,0,0,129,64,65,9,5,4,28,18,47,27,4,4,9,13,23,15,3,0,19,5,24,12,1,4,2,3,4,0,0,0,0,2,3,0,0,0,2,1,1,0,0,0,252,133,119,11,4,7,53,39,92,33,19,10,27,17,49,19,10,7,26,22,43,14,9,3,4,2,4,1,0,0,2,0,1,1,0,0,2,2,3,0,0,0,97,62,35,12,9,3,10,-2,64,20,1,2,8,2,34,15,0,2,2,-4,30,5,1,0,5,2,2,2,0,1,5,2,1,0,0,1,0,0,1,2,0,0,117,55,62,15,4,11,18,15,46,26,10,1,11,6,22,12,3,0,7,9,24,14,7,1,4,3,4,4,0,0,2,2,-1,1,0,0,2,1,5,3,0,0,170,94,76,9,5,4,15,24,76,26,19,11,5,12,43,19,10,5,10,12,33,7,9,6,0,6,2,-1,1,1,0,2,2,-1,1,1,0,4,0,0,0,0,142,64,78,20,8,12,17,18,79,-1,19,6,6,8,41,-6,10,3,11,10,38,5,9,3,6,5,7,2,0,-1,2,2,3,1,0,0,4,3,4,1,0,-1,60,38,22,29,14,15,-1,7,41,8,1,0,2,4,22,4,5,-1,-3,3,19,4,-4,1,5,10,8,4,2,0,4,3,5,0,2,0,1,7,3,4,0,0,141,61,80,19,6,13,20,18,77,18,3,5,8,2,39,11,0,3,12,16,38,7,3,2,6,0,9,1,1,2,3,0,3,-1,0,1,3,0,6,2,1,1,133,48,85,19,8,11,16,27,66,19,4,5,5,4,29,11,-2,3,11,23,37,8,6,2,1,7,7,4,0,0,1,2,3,2,0,0,0,5,4,2,0,0,92,49,43,14,5,9,-4,11,52,17,7,5,-4,2,32,12,2,4,0,9,20,5,5,1,2,4,3,4,1,0,0,2,1,2,0,0,2,2,2,2,1,0,58,35,23,17,14,3,3,5,26,7,10,2,5,4,14,6,5,0,-2,1,12,1,5,2,1,2,10,4,1,-1,2,1,9,1,1,0,-1,1,1,3,0,-1,56,38,18,-6,-1,-5,17,5,18,2,9,1,18,1,10,5,4,-1,-1,4,8,-3,5,2,2,-3,-3,-4,1,0,3,-2,0,-2,0,0,-1,-1,-3,-2,1,0,15,-2,17,15,10,5,-14,2,14,2,2,5,-6,0,8,-4,0,0,-8,2,6,6,2,5,1,6,1,2,4,2,1,5,2,1,2,0,0,1,-1,1,2,2,-64,-47,-17,4,5,-1,-22,2,-22,-11,-6,-3,-18,-3,-10,-11,0,-2,-4,5,-12,0,-6,-1,-3,6,2,-4,4,-1,0,3,3,-3,3,-1,-3,3,-1,-1,1,0,-48,-19,-29,4,4,0,-15,-12,-4,-4,-9,-4,-4,-5,7,-2,-12,-3,-11,-7,-11,-2,3,-1,2,1,1,0,2,-3,1,1,1,1,1,-1,1,0,0,-1,1,-2,21,29,-8,6,3,3,15,3,1,-1,7,2,17,10,1,-1,6,1,-2,-7,0,0,1,1,5,2,1,-1,-1,0,3,1,0,-1,0,0,2,1,1,0,-1,0,-35,-11,-24,1,3,-2,-16,-5,21,-19,-9,-10,-5,-5,12,-10,-3,-3,-11,0,9,-9,-6,-7,3,0,-1,-1,1,-1,2,0,2,-1,0,0,1,0,-3,0,1,-1
41,41016,Bollullos de la Mitación,5012,109,57,52,7,5,2,32,12,36,22,-2,6,19,8,14,16,-3,1,13,4,22,6,1,5,2,1,2,2,0,0,1,1,1,2,0,0,1,0,1,0,0,0,140,75,65,3,2,1,33,2,63,26,11,6,25,-5,28,18,8,2,8,7,35,8,3,4,1,0,0,2,0,0,1,0,0,1,0,0,0,0,0,1,0,0,194,94,100,11,4,7,26,23,76,52,8,4,15,5,44,25,4,0,11,18,32,27,4,4,2,4,3,0,-1,2,0,1,3,0,-1,1,2,3,0,0,0,1,445,219,226,8,2,6,65,50,204,67,38,15,26,26,105,35,20,5,39,24,99,32,18,10,2,1,1,1,2,1,1,0,-1,1,1,0,1,1,2,0,1,1,494,223,271,37,15,22,69,61,223,73,36,22,28,28,103,36,19,6,41,33,120,37,17,16,6,6,12,5,5,1,2,2,6,2,2,0,4,4,6,3,3,1,383,196,187,28,14,14,50,46,171,80,26,8,30,17,89,45,13,2,20,29,82,35,13,6,5,11,11,1,0,0,3,4,7,0,0,0,2,7,4,1,0,0,525,284,241,31,13,18,82,48,223,91,63,14,49,27,117,46,35,7,33,21,106,45,28,7,5,8,12,4,0,2,1,4,6,1,0,1,4,4,6,3,0,1,481,261,220,85,48,37,73,67,196,86,37,19,40,34,105,47,22,11,33,33,91,39,15,8,14,23,23,18,3,2,7,11,13,14,2,1,7,12,10,4,1,1,357,185,172,41,25,16,62,53,134,85,19,6,27,22,79,42,11,2,35,31,55,43,8,4,11,5,18,7,1,-1,7,2,13,3,1,-1,4,3,5,4,0,0,169,64,105,-12,-10,-2,26,13,81,32,14,5,16,0,39,4,8,-1,10,13,42,28,6,6,5,-6,-6,-8,4,-1,4,-3,-6,-6,1,0,1,-3,0,-2,3,-1,201,86,115,-6,-3,-3,54,7,95,29,1,12,25,-1,34,17,4,5,29,8,61,12,-3,7,4,0,-4,-1,-6,0,4,-1,-2,-3,-2,0,0,1,-2,2,-4,0,158,71,87,34,20,14,28,23,36,19,34,18,17,8,20,9,12,5,11,15,16,10,22,13,7,6,12,7,1,0,5,3,7,6,1,-2,2,3,5,1,0,2,41,30,11,-7,-5,-2,-16,-7,31,18,8,7,-3,-6,20,10,3,8,-13,-1,11,8,5,-1,-7,1,0,-3,1,1,-6,-1,1,0,0,1,-1,2,-1,-3,1,0,42,11,31,-24,-17,-7,0,15,24,0,-4,2,-6,2,16,3,-3,-2,6,13,8,-3,-1,4,0,1,-14,-10,-2,1,-1,-1,-6,-6,-3,0,1,2,-8,-4,1,1,92,58,34,-12,-6,-6,14,-2,59,13,1,12,8,-1,40,11,-2,5,6,-1,19,2,3,7,-6,1,1,-5,-1,-2,0,0,1,-5,-1,-1,-6,1,0,0,0,-1,54,16,38,3,0,3,5,1,42,-19,13,8,-2,-6,21,-15,8,3,7,7,21,-4,5,5,-2,-3,7,-2,1,1,-4,-2,5,0,1,0,2,-1,2,-2,0,1,138,41,97,14,2,12,21,1,66,-11,-1,61,5,4,37,-12,-4,11,16,-3,29,1,3,50,6,-2,12,-5,3,-1,2,-1,2,-5,3,0,4,-1,10,0,0,-1,107,44,63,25,8,17,-11,16,35,-7,34,36,-7,9,2,4,21,10,-4,7,33,-11,13,26,8,6,0,1,11,-1,4,3,-6,1,7,-1,4,3,6,0,4,0
41,41017,Bormujos,8223,841,418,423,17,9,8,166,108,308,164,67,28,91,43,152,80,38,14,75,65,156,84,29,14,4,2,8,1,2,0,2,0,5,1,1,0,2,2,3,0,1,0,880,464,416,38,20,18,103,174,386,135,67,13,43,95,215,63,39,8,60,79,171,72,28,5,12,4,14,6,0,0,6,3,7,4,0,0,6,1,7,2,0,0,710,342,368,35,18,17,152,75,239,168,50,21,65,39,114,95,23,5,87,36,125,73,27,16,7,6,11,8,3,0,5,3,6,4,0,0,2,3,5,4,3,0,686,327,359,32,12,20,133,36,292,132,47,33,67,3,151,71,16,14,66,33,141,61,31,19,11,4,8,8,1,0,4,2,2,3,1,0,7,2,6,5,0,0,791,426,365,71,32,39,109,68,373,149,60,24,75,24,194,76,40,14,34,44,179,73,20,10,11,12,23,13,8,2,8,5,6,7,4,2,3,7,17,6,4,0,914,464,450,123,55,68,161,82,323,211,66,52,76,41,172,102,34,28,85,41,151,109,32,24,20,22,30,39,6,3,7,3,18,20,2,2,13,19,12,19,4,1,635,289,346,133,65,68,113,74,281,89,33,33,52,35,127,50,17,8,61,39,154,39,16,25,30,26,39,26,7,2,17,9,21,12,3,1,13,17,18,14,4,1,848,393,455,165,84,81,179,90,280,186,50,63,84,43,133,99,19,17,95,47,147,87,31,46,23,44,43,34,16,4,16,23,21,14,7,3,7,21,22,20,9,1,559,260,299,78,33,45,111,27,264,97,21,46,61,9,114,52,14,14,50,18,150,45,7,32,12,18,33,10,-1,2,3,10,11,6,2,0,9,8,22,4,-3,2,306,172,134,76,32,44,58,0,163,54,5,20,42,1,84,33,2,5,16,-1,79,21,3,15,18,15,22,14,4,2,11,5,10,5,0,0,7,10,12,9,4,2,314,134,180,30,8,22,85,24,123,44,10,16,36,-2,57,17,12,7,49,26,66,27,-2,9,16,7,22,-10,-5,-2,10,0,2,-2,-2,-2,6,7,20,-8,-3,0,451,234,217,82,27,55,85,63,181,75,23,12,45,28,99,41,12,7,40,35,82,34,11,5,22,29,17,10,5,-3,9,11,8,-1,1,-1,13,18,9,11,4,-2,183,109,74,38,20,18,20,13,38,60,8,37,15,6,26,35,7,13,5,7,12,25,1,24,13,17,6,-5,3,1,9,4,3,-4,4,1,4,13,3,-1,-1,0,116,19,97,-39,-25,-14,7,0,108,-23,0,13,-7,-3,38,-19,-5,6,14,3,70,-4,5,7,-4,4,-6,-33,-2,-1,-6,2,-3,-16,-3,-1,2,2,-3,-17,1,0,254,136,118,10,10,0,46,21,133,15,6,18,23,14,61,3,10,11,23,7,72,12,-4,7,8,-4,8,-5,-1,1,7,-1,3,-3,1,1,1,-3,5,-2,-2,0,95,36,59,22,6,16,-1,20,52,-2,-3,17,1,4,23,-2,-5,14,-2,16,29,0,2,3,5,4,0,6,3,2,2,1,2,-1,-1,1,3,3,-2,7,4,1,100,51,49,53,28,25,48,-33,67,24,-12,-6,18,-20,29,9,9,-2,30,-13,38,15,-21,-4,22,3,8,9,7,4,16,0,2,5,4,1,6,3,6,4,3,3,200,112,88,33,15,18,76,3,53,49,4,18,51,8,41,16,-7,4,25,-5,12,33,11,14,3,7,6,12,6,-1,3,3,2,5,3,-1,0,4,4,7,3,0
41,41018,Brenes,10597,35,18,17,22,14,8,11,-1,4,13,6,4,1,-3,9,8,4,2,10,2,-5,5,2,2,6,2,8,4,0,2,3,1,6,3,0,1,3,1,2,1,0,1,18,11,7,38,27,11,11,-8,11,6,-1,-1,5,-1,5,3,0,-1,6,-7,6,3,-1,0,3,9,12,12,2,0,3,6,8,9,1,0,0,3,4,3,1,0,121,66,55,33,27,6,42,10,41,20,-5,8,22,1,25,12,-2,5,20,9,16,8,-3,3,4,3,12,10,2,2,1,3,11,10,1,1,3,0,1,0,1,1,186,98,88,69,39,30,37,38,63,28,13,4,31,9,31,15,8,2,6,29,32,13,5,2,15,16,25,9,3,0,12,8,11,4,3,0,3,8,14,5,0,0,196,124,72,87,53,34,30,45,64,36,6,9,17,23,50,22,5,4,13,22,14,14,1,5,11,21,33,15,2,4,4,15,19,11,2,2,7,6,14,4,0,2,311,181,130,124,75,49,44,64,97,69,27,11,20,44,58,39,17,4,24,20,39,30,10,7,11,33,44,27,7,2,7,16,27,18,6,1,4,17,17,9,1,1,191,103,88,72,46,26,59,17,58,49,6,-1,24,12,27,31,6,1,35,5,31,18,0,-2,11,17,20,19,1,2,5,11,13,14,1,1,6,6,7,5,0,1,169,66,103,61,31,30,24,37,74,10,16,9,10,8,39,-2,4,7,14,29,35,12,12,2,14,16,22,3,6,0,8,10,17,-5,1,0,6,6,5,8,5,0,152,65,87,80,34,46,40,4,84,15,4,7,10,3,50,8,-3,2,30,1,34,7,7,5,27,14,25,10,4,1,12,5,11,6,1,0,15,9,14,4,3,1,45,5,40,22,-4,26,8,26,26,-7,2,-10,-1,2,12,-6,0,-1,9,24,14,-1,2,-9,14,9,-4,2,2,-1,5,6,-10,-4,-1,0,9,3,6,6,3,-1,66,27,39,36,16,20,11,1,20,27,13,-4,3,-6,7,15,9,-1,8,7,13,12,4,-3,3,10,1,17,2,2,-1,3,2,10,0,1,4,7,-1,7,2,1,59,23,36,80,40,40,4,10,42,2,0,-3,7,11,16,-7,-4,-2,-3,-1,26,9,4,-1,22,22,18,11,4,3,16,14,6,2,0,2,6,8,12,9,4,1,24,1,23,15,-6,21,-1,6,-8,17,7,0,0,6,-6,-1,5,-3,-1,0,-2,18,2,3,7,10,-3,2,-1,-3,2,5,-5,-6,0,-3,5,5,2,8,-1,0,-248,-120,-128,-121,-68,-53,-60,-23,-85,-52,-22,-1,-32,-10,-43,-19,-13,0,-28,-13,-42,-33,-9,-1,-28,-9,-36,-23,-21,-4,-14,-9,-16,-12,-14,-3,-14,0,-20,-11,-7,-1,-43,-21,-22,-11,-6,-5,-12,9,-45,-3,0,-1,-11,7,-23,-2,3,-1,-1,2,-22,-1,-3,0,-3,7,-18,3,-2,1,-6,8,-13,6,-1,0,3,-1,-5,-3,-1,1,-62,-36,-26,11,10,1,-30,-29,7,-10,-1,3,-14,-16,3,-2,-2,-2,-16,-13,4,-8,1,5,11,-11,4,0,3,3,7,-1,0,2,0,2,4,-10,4,-2,3,1,-72,-47,-25,-7,-3,-4,-21,2,-10,-35,-9,-2,-17,1,-5,-19,-4,-5,-4,1,-5,-16,-5,3,-4,7,5,-12,-2,-2,-5,4,9,-10,-1,-1,1,3,-4,-2,-1,-1,-52,-45,-7,8,-6,14,-9,1,-18,-29,6,-5,-4,-3,-15,-15,1,-9,-5,4,-3,-14,5,4,8,11,4,-13,-1,-3,3,4,0,-7,-3,-3,5,7,4,-6,2,0
41,41020,"Cabezas de San Juan, Las",15660,-125,-80,-45,5,2,3,-30,-34,-48,-17,-4,7,-21,-21,-26,-9,0,-1,-9,-13,-22,-8,-4,8,0,2,2,1,0,0,0,1,1,0,0,0,0,1,1,1,0,0,-11,8,-19,21,7,14,18,-16,-8,5,-6,-6,22,-14,2,3,-1,-7,-4,-2,-10,2,-5,1,5,4,9,2,1,0,2,0,4,1,0,0,3,4,5,1,1,0,-47,-12,-35,39,21,18,-15,5,-39,12,-1,-10,-1,1,-13,1,5,-7,-14,4,-26,11,-6,-3,8,8,10,9,3,0,7,3,4,4,2,0,1,5,6,5,1,0,3,-9,12,37,16,21,1,6,5,-4,1,-6,-6,-2,9,-4,1,-6,7,8,-4,0,0,0,8,15,7,5,2,0,5,3,4,2,2,0,3,12,3,3,0,0,-7,-10,3,21,10,11,-1,-4,4,-9,-3,2,-6,-6,2,1,2,-3,5,2,2,-10,-5,5,4,5,5,3,1,3,3,2,3,1,1,0,1,3,2,2,0,3,3,9,-6,21,6,15,10,-7,-9,7,2,-1,3,-4,4,-1,4,1,7,-3,-13,8,-2,-2,4,9,6,2,0,0,-1,5,2,0,0,0,5,4,4,2,0,0,-20,-9,-11,28,13,15,12,-15,-3,-6,-7,-2,10,-7,-9,-1,-3,0,2,-8,6,-5,-4,-2,8,7,5,5,2,0,7,2,1,3,0,0,1,5,4,2,2,0,-6,-4,-2,45,22,23,22,9,-10,-14,1,-18,18,3,-9,-7,2,-11,4,6,-1,-7,-1,-7,11,13,19,0,1,0,8,9,5,0,0,0,3,4,14,0,1,0,36,5,31,34,13,21,13,1,-7,32,2,-8,2,-18,0,22,0,-2,11,19,-7,10,2,-6,11,9,3,10,1,0,7,0,1,5,0,0,4,9,2,5,1,0,11,35,-24,28,17,11,10,-1,7,1,-2,-7,10,9,17,-1,-1,-3,0,-10,-10,2,-1,-4,7,6,7,6,-1,1,4,2,9,2,-1,1,3,4,-2,4,0,0,-25,-31,6,6,-2,8,11,-14,13,-16,-5,-14,-3,-11,5,-8,-4,-10,14,-3,8,-8,-1,-4,4,0,0,1,0,0,1,1,-3,-2,0,0,3,-1,3,3,0,0,-71,-54,-17,-2,-5,3,-12,-8,-24,-34,-1,1,-8,0,-23,-23,-2,-1,-4,-8,-1,-11,1,2,1,3,-1,-5,1,-1,1,2,-2,-5,1,-2,0,1,1,0,0,1,-26,-27,1,-21,-16,-5,0,-4,-35,-4,10,4,3,-7,-26,-5,2,4,-3,3,-9,1,8,0,-3,-2,-7,-7,-2,0,-2,-2,-6,-5,-1,0,-1,0,-1,-2,-1,0,-68,-47,-21,-2,-6,4,-27,-16,-8,-13,5,-9,-20,-16,0,-15,4,-1,-7,0,-8,2,1,-8,-3,3,-3,0,2,-1,-3,-1,-2,0,1,-1,0,4,-1,0,1,0,-27,-13,-14,1,3,-2,6,-15,-34,9,1,5,-2,-10,-16,8,-2,7,8,-5,-18,1,3,-2,3,1,-3,-1,0,1,2,2,-2,0,0,1,1,-1,-1,-1,0,0,-45,-24,-21,-4,-1,-3,-7,-6,-27,0,1,-2,-2,6,-16,-9,3,-4,-5,-12,-11,9,-2,2,3,-4,-7,2,3,0,2,-1,-5,1,2,0,1,-3,-2,1,1,0,-124,-91,-33,-2,-1,-1,-21,-30,-31,-40,-1,-7,-20,-20,-16,-30,-1,-5,-1,-10,-15,-10,0,-2,0,2,-4,-3,0,0,-1,2,0,-3,0,0,1,0,-4,0,0,0,-71,-39,-32,-20,-9,-11,-26,-10,-14,-28,0,11,-22,-11,-2,-13,3,8,-4,1,-12,-15,-3,3,-5,-3,-6,-5,0,-1,-4,-4,-3,2,1,-1,-1,1,-3,-7,-1,0
41,41021,Camas,25499,-125,-94,-31,67,20,47,-52,-7,-32,-27,-3,-2,-20,-22,-27,-19,-3,-2,-32,15,-5,-8,0,0,12,19,21,6,8,1,6,5,1,3,5,0,6,14,20,3,3,1,-125,-67,-58,55,26,29,-29,-32,-18,-37,10,-15,-15,-9,-14,-15,0,-11,-14,-23,-4,-22,10,-4,7,15,20,9,4,0,3,8,11,3,1,0,4,7,9,6,3,0,-292,-146,-146,53,18,35,-60,-12,-152,-19,-21,-28,-31,-16,-71,-16,-5,-8,-29,4,-81,-3,-16,-20,9,13,13,13,3,2,3,3,7,3,1,1,6,10,6,10,2,1,-82,-24,-58,72,30,42,-19,13,-12,-12,-13,-31,-5,16,-3,-14,1,-13,-14,-3,-9,2,-14,-18,11,21,21,15,4,0,6,9,7,5,3,0,5,12,14,10,1,0,221,98,123,91,39,52,27,55,141,7,-3,-4,-7,42,64,9,-5,-6,34,13,77,-2,2,2,10,23,37,16,2,1,6,13,13,5,0,1,4,10,24,11,2,0,-31,-50,19,164,68,96,-48,43,4,-17,-7,-4,-29,11,-17,1,-10,-2,-19,32,21,-18,3,-2,29,37,59,30,6,2,16,15,24,10,2,1,13,22,35,20,4,1,-43,-14,-29,155,73,82,25,15,-5,-24,-32,-13,-3,10,1,8,-17,-9,28,5,-6,-32,-15,-4,33,36,38,35,10,2,17,10,21,19,5,0,16,26,17,16,5,2,68,22,46,183,99,84,-1,25,53,-11,1,-6,-8,0,36,-10,1,-1,7,25,17,-1,0,-5,33,48,77,12,5,4,18,21,44,7,2,3,15,27,33,5,3,1,141,105,36,175,83,92,-9,15,85,41,16,-12,9,12,53,25,8,-5,-18,3,32,16,8,-7,26,35,78,22,10,2,12,13,40,8,6,2,14,22,38,14,4,0,111,74,37,102,37,65,42,55,-19,33,-4,3,28,29,-9,35,-10,5,14,26,-10,-2,6,-2,25,36,13,20,7,1,13,12,2,8,1,1,12,24,11,12,6,0,1,-30,31,60,23,37,-31,52,56,-42,-12,-21,-12,22,6,-19,-15,-10,-19,30,50,-23,3,-11,13,17,18,6,3,1,11,6,8,1,-3,0,2,11,10,5,6,1,1,-5,6,-66,-37,-29,11,22,30,-35,-12,-13,-10,12,17,-26,-3,4,21,10,13,-9,-9,-17,-1,11,-24,-42,-13,1,-1,4,-6,-27,-8,1,0,7,-18,-15,-5,0,8,-1,9,-40,-16,-24,3,13,-3,9,-3,-13,1,4,-9,10,6,-11,2,9,6,-1,-9,-2,-1,2,-20,-9,-11,-1,1,5,-10,-7,-4,-1,-2,-3,-10,-2,-7,0,113,98,15,21,12,9,0,31,62,24,3,-9,15,14,56,13,3,-3,-15,17,6,11,0,-6,9,8,1,2,4,-3,4,9,-2,1,1,-1,5,-1,3,1,3,-2,198,85,113,27,12,15,52,48,59,42,7,9,19,24,17,27,6,8,33,24,42,15,1,1,17,9,-1,3,-3,2,9,7,-2,-1,-2,1,8,2,1,4,-1,1,215,117,98,64,31,33,45,19,78,61,5,1,24,12,35,35,5,6,21,7,43,26,0,-5,18,20,8,8,3,2,10,9,2,4,1,2,8,11,6,4,2,0,26,-13,39,-20,-24,4,-5,25,1,-16,28,-1,-4,4,2,-22,3,2,-1,21,-1,6,25,-3,-6,10,-6,-13,-9,3,-6,1,-2,-12,-7,2,0,9,-4,-1,-2,1,127,79,48,55,17,38,-28,51,46,10,36,16,-15,21,24,0,40,12,-13,30,22,10,-4,4,-1,13,35,-4,6,6,1,7,19,-13,1,3,-2,6,16,9,5,3
41,41023,Cantillana,8959,-11,-37,26,5,4,1,5,-12,-8,-10,2,12,-5,-14,-14,-10,-1,7,10,2,6,0,3,5,2,1,1,1,0,0,2,1,0,1,0,0,0,0,1,0,0,0,-15,-10,-5,5,2,3,-2,-5,-14,-7,4,7,-2,-5,3,-11,2,2,0,0,-17,4,2,5,1,0,2,1,1,0,0,0,1,0,1,0,1,0,1,1,0,0,87,48,39,28,18,10,12,13,42,10,10,-1,4,2,24,10,7,0,8,11,18,0,3,-1,5,8,10,2,1,2,2,5,8,1,1,1,3,3,2,1,0,1,110,78,32,86,61,25,6,17,39,32,3,9,6,9,32,22,4,2,0,8,7,10,-1,7,8,23,34,19,2,0,5,14,28,13,1,0,3,9,6,6,1,0,115,74,41,47,29,18,25,25,24,20,5,15,20,18,10,13,2,10,5,7,14,7,3,5,13,13,10,10,0,0,8,8,7,5,0,0,5,5,3,5,0,0,320,192,128,258,152,106,40,100,97,58,17,7,21,74,58,23,9,5,19,26,39,35,8,2,22,88,91,51,3,2,14,53,53,27,3,1,8,35,38,24,0,1,193,112,81,103,61,42,36,45,67,33,12,3,19,27,38,24,7,0,17,18,29,9,5,3,19,33,30,17,5,-1,12,15,21,11,3,-1,7,18,9,6,2,0,489,257,232,325,182,143,101,124,127,101,28,3,49,58,65,62,15,4,52,66,62,39,13,-1,55,106,87,64,12,0,27,63,41,44,7,0,28,43,46,20,5,0,138,71,67,45,13,32,38,34,25,27,14,0,17,14,19,13,9,0,21,20,6,14,5,0,18,8,9,4,6,0,7,1,2,0,3,0,11,7,7,4,3,0,-24,-33,9,-20,-26,6,9,4,-22,-21,1,5,1,-3,-21,-14,1,3,8,7,-1,-7,0,2,11,2,-16,-14,-3,0,4,-2,-14,-11,-3,0,7,4,-2,-3,0,0,52,41,11,-6,-1,-5,13,1,14,15,0,5,9,-2,14,11,1,3,4,3,0,4,-1,2,8,-7,-3,-3,-2,1,2,-2,-2,1,-1,1,6,-5,-1,-4,-1,0,200,145,55,142,95,47,6,84,51,42,8,5,12,50,41,32,4,4,-6,34,10,10,4,1,12,57,39,25,4,2,8,37,26,20,2,0,4,20,13,5,2,2,-101,-73,-28,-10,-26,16,-10,1,-31,-53,-8,1,-9,-1,-19,-38,-4,-1,-1,2,-12,-15,-4,2,12,13,-4,-28,-3,0,3,4,-6,-22,-5,0,9,9,2,-6,2,0,13,-12,25,24,1,23,15,-6,-6,3,-2,11,1,0,-17,-1,-1,7,14,-6,11,4,-1,4,8,7,-8,11,6,0,0,3,-11,5,3,1,8,4,3,6,3,-1,-106,-68,-38,-24,-19,-5,-42,3,-39,-19,-8,-2,-23,-1,-17,-15,-11,-3,-19,4,-22,-4,3,1,-9,1,-19,3,-2,0,-10,3,-11,-1,-3,1,1,-2,-8,4,1,-1,-67,-36,-31,-58,-30,-28,1,-12,-40,-13,-4,0,3,-9,-20,-12,1,1,-2,-3,-20,-1,-5,-1,-4,-9,-17,-19,-6,-3,-2,-9,-5,-10,-2,-2,-2,0,-12,-9,-4,-1,-47,-16,-31,-27,-17,-10,-9,-7,-9,-14,-10,-3,8,-3,-15,-9,0,1,-17,-4,6,-5,-10,-4,4,-3,-11,-14,-3,-3,2,1,-10,-11,1,-1,2,-4,-1,-3,-4,-2,-39,-42,3,-58,-52,-6,-8,14,4,-42,-16,8,-3,5,-4,-35,-9,3,-5,9,8,-7,-7,5,-1,3,-16,-34,-9,-1,-1,-2,-13,-26,-9,-1,0,5,-3,-8,0,0
41,41024,Carmona,25403,40,7,33,64,34,30,-2,3,0,9,35,-7,-3,-4,1,0,19,-8,1,7,-1,9,16,1,21,4,14,11,8,5,13,2,5,5,4,4,8,2,9,6,4,1,172,64,108,61,32,29,43,13,30,36,34,12,12,-3,14,19,16,3,31,16,16,17,18,9,17,13,15,8,3,2,9,7,5,6,1,2,8,6,10,2,2,0,246,135,111,61,29,32,51,29,41,68,30,19,30,17,28,31,23,2,21,12,13,37,7,17,16,12,17,7,8,1,7,6,7,4,5,0,9,6,10,3,3,1,163,87,76,62,32,30,51,-4,31,53,29,4,19,1,11,33,20,2,32,-5,20,20,9,2,11,15,20,8,8,0,5,9,11,3,4,0,6,6,9,5,4,0,338,190,148,61,25,36,77,45,54,108,41,-6,42,15,33,62,30,-2,35,30,21,46,11,-4,10,17,17,9,8,-1,1,6,9,5,4,0,9,11,8,4,4,-1,205,140,65,88,40,48,53,30,26,66,28,0,37,21,14,46,20,3,16,9,12,20,8,-3,12,24,18,28,5,1,6,10,6,14,3,1,6,14,12,14,2,0,213,141,72,77,42,35,47,14,72,57,29,-9,27,13,41,31,23,2,20,1,31,26,6,-11,15,22,23,14,3,-1,10,13,12,6,2,-1,5,9,11,8,1,0,208,148,60,121,61,60,19,33,85,55,26,-9,16,21,56,39,19,-4,3,12,29,16,7,-5,17,28,45,17,12,1,9,12,23,10,6,1,8,16,22,7,6,0,286,147,139,155,78,77,87,15,47,64,29,46,39,15,12,36,25,20,48,0,35,28,4,26,42,33,40,22,14,3,22,17,16,15,6,1,20,16,24,7,8,2,208,123,85,61,27,34,16,23,42,67,31,22,2,2,29,57,16,14,14,21,13,10,15,8,17,9,14,14,5,1,11,-1,7,8,0,1,6,10,7,6,5,0,54,40,14,56,25,31,55,-15,-16,10,6,9,27,-5,-12,2,16,8,28,-10,-4,8,-10,1,13,17,11,10,3,0,6,9,4,4,1,0,7,8,7,6,2,0,91,47,44,43,20,23,67,-20,3,2,15,20,31,-13,-5,7,14,9,36,-7,8,-5,1,11,15,12,5,2,2,4,6,2,3,5,-1,3,9,10,2,-3,3,1,-39,-19,-20,-27,-28,1,-9,-7,-53,1,11,19,-6,-5,-26,2,4,14,-3,-2,-27,-1,7,5,4,2,-15,-8,-7,-4,3,-4,-13,-6,-6,-2,1,6,-2,-2,-1,-2,-67,-25,-42,-40,-29,-11,3,-26,-33,26,-8,-29,-4,-4,-31,22,0,-8,7,-22,-2,4,-8,-21,-6,-16,-11,-8,2,-2,-5,-9,-6,-10,1,0,-1,-7,-5,2,1,-2,-90,-36,-54,36,20,16,-15,-12,-24,-22,-13,3,-6,-12,-4,-10,-6,5,-9,0,-20,-12,-7,-2,15,10,10,-3,3,0,8,5,8,-4,4,0,7,5,2,1,-1,0,-26,-14,-12,-20,-8,-12,12,-5,-22,-6,-13,11,8,1,-3,-16,-4,1,4,-6,-19,10,-9,10,-4,2,-1,-15,-2,0,-4,0,8,-12,-1,1,0,2,-9,-3,-1,-1,-14,12,-26,-3,-14,11,-1,-30,-5,24,-5,-3,3,-5,-11,21,2,0,-4,-25,6,3,-7,-3,11,0,-4,-3,-4,-5,1,-3,-6,-4,-1,-3,10,3,2,1,-3,-2,117,35,82,30,8,22,70,11,1,30,-11,11,37,11,-7,2,-4,-3,33,0,8,28,-7,14,11,6,13,8,-5,-3,7,4,5,0,-6,-2,4,2,8,8,1,-1
41,41026,Casariche,5145,19,15,4,8,4,4,2,16,2,-1,0,-1,4,11,0,-1,0,0,-2,5,2,0,0,-1,3,2,1,2,0,0,1,1,1,1,0,0,2,1,0,1,0,0,17,2,15,8,4,4,7,0,10,-2,5,-2,0,0,2,-2,3,-1,7,0,8,0,2,-1,1,3,1,1,2,0,0,2,0,0,2,0,1,1,1,1,0,0,-4,-3,-1,15,7,8,1,6,-14,1,1,0,4,4,-10,-1,-1,0,-3,2,-4,2,2,0,3,6,0,1,3,0,1,3,0,0,2,0,2,3,0,1,1,0,38,18,20,18,10,8,14,2,-1,12,7,3,3,0,1,8,4,2,11,2,-2,4,3,1,3,-1,3,7,5,1,2,1,1,3,2,1,1,-2,2,4,3,0,27,11,16,40,18,22,10,4,-10,6,12,-2,1,3,-6,4,7,0,9,1,-4,2,5,-2,13,6,4,8,8,0,6,1,2,4,4,0,7,5,2,4,4,0,15,16,-1,30,18,12,4,-1,-7,7,6,4,8,1,-5,5,5,1,-4,-2,-2,2,1,3,4,10,4,4,6,1,3,5,3,2,4,0,1,5,1,2,2,1,26,20,6,26,12,14,-8,21,3,0,6,3,-2,11,3,-2,4,5,-6,10,0,2,2,-2,4,9,5,1,4,3,1,5,2,-1,3,2,3,4,3,2,1,1,89,45,44,61,38,23,19,9,30,5,16,6,6,5,20,1,7,1,13,4,10,4,9,5,16,13,15,9,5,1,8,11,9,5,2,1,8,2,6,4,3,0,34,26,8,57,33,24,0,11,12,13,1,-2,-2,1,19,9,1,-2,2,10,-7,4,0,0,13,11,21,9,3,0,6,4,16,5,2,0,7,7,5,4,1,0,-22,3,-25,8,9,-1,-4,-10,-5,3,-1,-2,-1,4,-3,4,1,0,-3,-14,-2,-1,-2,-2,1,4,3,0,-1,0,2,5,2,0,0,0,-1,-1,1,0,-1,0,35,12,23,5,0,5,19,13,3,3,-2,-3,7,4,3,1,-2,0,12,9,0,2,0,-3,5,0,-1,1,0,0,3,0,-1,-2,0,0,2,0,0,3,0,0,20,14,6,37,22,15,4,10,7,-3,0,2,2,3,5,0,1,3,2,7,2,-3,-1,-1,10,8,16,1,2,0,3,4,12,1,2,0,7,4,4,0,0,0,-29,-12,-17,4,0,4,-3,-7,-20,0,1,-3,-5,-4,-8,3,1,-1,2,-3,-12,-3,0,-2,7,-2,-1,0,-1,0,3,-2,-1,0,0,0,4,0,0,0,-1,0,-7,-11,4,7,1,6,-5,-2,-5,0,7,-2,-2,-6,-3,-3,2,0,-3,4,-2,3,5,-2,2,-1,0,0,3,1,1,0,-2,-1,1,1,1,-1,2,1,2,0,-26,-11,-15,-10,-4,-6,-6,-6,-14,0,5,-3,1,-7,-3,2,-1,-2,-7,1,-11,-2,6,-1,-5,0,-1,0,1,-5,-2,1,0,1,-2,-2,-3,-1,-1,-1,3,-3,7,11,-4,-2,0,-2,4,7,1,-8,3,-1,5,4,6,-6,3,-2,-1,3,-5,-2,0,1,-4,4,1,-3,0,0,1,2,-1,-2,0,0,-5,2,2,-1,0,0,-15,-10,-5,10,6,4,4,-1,-7,-5,-6,-1,1,-1,-6,-1,-5,2,3,0,-1,-4,-1,-3,2,4,3,0,1,0,1,4,0,0,1,0,1,0,3,0,0,0,-30,-24,-6,2,-3,5,-7,-3,-14,-11,3,-3,-3,-2,-7,-14,3,-3,-4,-1,-7,3,0,0,-1,4,-2,-1,2,0,0,1,-3,-2,1,0,-1,3,1,1,1,0
41,41027,Castilblanco de los Arroyos,4403,45,25,20,9,3,6,-2,5,9,12,10,11,-4,6,6,7,5,5,2,-1,3,5,5,6,2,1,1,1,1,3,0,1,1,0,0,1,2,0,0,1,1,2,52,22,30,6,3,3,10,4,4,15,13,6,9,-4,1,8,6,2,1,8,3,7,7,4,2,0,1,2,1,0,0,0,1,1,1,0,2,0,0,1,0,0,67,24,43,6,3,3,1,7,-4,12,23,26,1,3,-3,7,12,5,0,4,-1,5,11,21,2,4,0,-1,0,1,1,1,0,0,0,1,1,3,0,-1,0,0,34,27,7,7,6,1,0,2,5,9,11,4,2,-3,8,8,7,4,-2,5,-3,1,4,0,0,1,4,0,2,0,0,0,4,1,1,0,0,1,0,-1,1,0,108,62,46,17,9,8,26,6,13,47,5,11,7,9,10,29,3,5,19,-3,3,18,2,6,3,4,4,4,2,0,1,2,4,1,1,0,2,2,0,3,1,0,103,45,58,41,23,18,10,0,38,12,34,7,-1,3,15,4,21,2,11,-3,23,8,13,5,6,8,15,8,2,2,1,6,9,5,1,1,5,2,6,3,1,1,126,76,50,35,22,13,11,25,6,45,29,6,9,9,1,31,17,5,2,16,5,14,12,1,10,11,0,12,2,0,6,5,0,9,2,0,4,6,0,3,0,0,58,40,18,57,32,25,17,-3,31,9,8,-2,10,4,18,4,5,-1,7,-7,13,5,3,-1,16,10,18,11,1,1,7,6,11,7,0,1,9,4,7,4,1,0,129,64,65,27,16,11,18,18,28,26,26,10,13,10,14,12,10,4,5,8,14,14,16,6,4,6,7,8,1,0,3,6,3,4,-1,0,1,0,4,4,2,0,6,14,-8,9,7,2,16,0,-10,-6,3,0,11,7,-4,-5,4,1,5,-7,-6,-1,-1,-1,5,3,0,1,0,0,3,2,0,1,1,0,2,1,0,0,-1,0,59,30,29,20,10,10,-3,-5,27,6,19,12,-3,-8,15,11,8,5,0,3,12,-5,11,7,3,2,11,2,2,0,1,1,5,2,1,0,2,1,6,0,1,0,-64,-45,-19,7,1,6,-22,0,-14,-29,9,-8,-7,-2,-11,-24,6,-7,-15,2,-3,-5,3,-1,0,2,2,0,2,1,0,2,0,-2,1,0,0,0,2,2,1,1,-12,-3,-9,7,2,5,2,0,0,-15,-2,-1,0,0,-2,-6,2,1,2,0,2,-9,-4,-2,0,3,2,2,0,0,0,1,0,1,0,0,0,2,2,1,0,0,-3,5,-8,11,7,4,-2,5,-6,-2,5,-2,2,3,-3,0,7,-3,-4,2,-3,-2,-2,1,3,2,3,0,2,1,3,1,2,0,1,0,0,1,1,0,1,1,-29,-5,-24,1,1,0,-11,-18,-15,4,7,2,-8,-10,2,9,3,-2,-3,-8,-17,-5,4,4,0,2,-3,0,2,0,0,0,0,0,1,0,0,2,-3,0,1,0,-76,-29,-47,-9,-8,-1,-20,-7,-23,-22,-4,0,-7,-5,-8,-13,2,2,-13,-2,-15,-9,-6,-2,1,1,-4,-3,-2,-2,1,1,-4,-3,-2,-1,0,0,0,0,0,-1,-18,-10,-8,4,0,4,-13,4,-6,-5,1,4,-7,5,-1,-4,-2,1,-6,-1,-5,-1,3,3,3,0,-1,1,2,-1,0,0,-1,1,0,0,3,0,0,0,2,-1,0,2,-2,5,3,2,12,6,-15,-9,2,7,6,1,-4,-5,2,1,6,5,-11,-4,0,6,-1,1,3,1,0,1,0,0,2,1,0,0,-1,1,1,0,0,1
41,41029,Castilleja de la Cuesta,15981,74,59,15,33,16,17,14,-28,128,-54,-16,23,18,-20,78,-20,-10,10,-4,-8,50,-34,-6,13,8,7,10,8,0,0,5,1,5,5,0,0,3,6,5,3,0,0,-31,-36,5,37,19,18,-8,-24,24,-17,-16,8,-7,-20,9,-3,-16,-1,-1,-4,15,-14,0,9,4,10,9,11,2,1,2,4,7,4,1,1,2,6,2,7,1,0,150,54,96,83,33,50,10,-16,137,-4,3,19,2,-19,70,-9,0,10,8,3,67,5,3,9,15,10,27,25,3,2,9,4,9,8,1,1,6,6,18,17,2,1,-10,-28,18,46,21,25,-14,-4,22,-42,8,8,-11,1,-1,-30,8,0,-3,-5,23,-12,0,8,13,14,9,8,1,1,7,6,3,4,0,1,6,8,6,4,1,0,-80,-49,-31,68,29,39,-40,17,-65,-18,-2,19,-28,10,-24,-20,-5,11,-12,7,-41,2,3,8,16,10,26,8,2,4,7,4,11,3,1,1,9,6,15,5,1,3,37,3,34,96,39,57,-20,-22,50,6,9,10,-8,-18,23,-2,2,2,-12,-4,27,8,7,8,14,18,35,16,9,3,7,5,16,6,3,1,7,13,19,10,6,2,152,61,91,137,69,68,19,52,57,28,-18,-1,17,0,41,11,-13,-4,2,52,16,17,-5,3,27,31,39,31,6,3,13,11,29,12,4,0,14,20,10,19,2,3,-57,-4,-53,177,78,99,-33,22,-26,-33,-5,9,-14,21,1,-6,-12,4,-19,1,-27,-27,7,5,23,48,51,33,17,4,9,22,21,19,5,2,14,26,30,14,12,2,-35,-51,16,162,66,96,-2,7,-14,-34,4,4,-18,4,-9,-25,-3,2,16,3,-5,-9,7,2,49,24,42,34,6,2,24,12,14,12,1,1,25,12,28,22,5,1,-23,-52,29,-48,-17,-31,0,11,-32,23,-23,-5,2,-8,-28,-6,-15,-1,-2,19,-4,29,-8,-4,5,1,-22,-13,-13,-6,2,2,-10,-8,-3,0,3,-1,-12,-5,-10,-6,42,19,23,59,27,32,0,16,34,13,-28,6,-2,-2,16,22,-13,2,2,18,18,-9,-15,4,13,18,16,9,0,-1,9,5,4,6,3,-1,4,13,12,3,-3,0,32,-16,48,12,2,10,-22,-6,7,-19,-14,85,-4,2,-5,-18,-10,22,-18,-8,12,-1,-4,63,4,7,-3,4,-2,1,2,2,-3,0,0,0,2,5,0,4,-2,1,-29,-39,10,20,6,14,-23,9,-6,-18,-15,29,-20,1,-12,-21,0,9,-3,8,6,3,-15,20,2,7,-1,8,3,1,1,1,0,3,0,1,1,6,-1,5,3,0,-54,-36,-18,-52,-37,-15,32,9,-45,-35,-24,-6,26,-2,-22,-23,-19,-4,6,11,-23,-12,-5,-2,4,0,-15,-25,-15,-3,3,-3,-12,-17,-8,-2,1,3,-3,-8,-7,-1,-140,-83,-57,-66,-45,-21,-16,-15,-72,-25,-26,2,-8,-13,-43,-15,-11,3,-8,-2,-29,-10,-15,-1,2,-6,-39,-18,-8,1,0,-7,-21,-15,-5,2,2,1,-18,-3,-3,-1,72,39,33,13,3,10,24,-7,14,-9,7,27,21,2,-4,0,3,11,3,-9,18,-9,4,16,9,9,-1,-4,-3,1,10,2,-2,-4,-3,0,-1,7,1,0,0,1,-114,-62,-52,-35,-11,-24,9,-22,-51,-68,3,16,10,-10,-28,-31,-1,0,-1,-12,-23,-37,4,16,-1,-4,-10,-19,-5,2,1,-1,-2,-11,2,0,-2,-3,-8,-8,-7,2,-78,-41,-37,25,12,13,-15,-4,13,-52,-30,-2,-3,-8,5,-14,-23,-4,-12,4,8,-38,-7,2,8,1,7,5,5,-1,7,0,3,1,1,0,1,1,4,4,4,-1
41,41034,Coria del Río,23751,38,42,-4,31,20,11,11,-9,11,18,-3,9,22,-4,7,10,-3,10,-11,-5,4,8,0,-1,6,6,14,2,3,0,4,5,9,0,2,0,2,1,5,2,1,0,88,43,45,47,25,22,25,17,24,38,-9,-7,12,-3,19,22,-5,-1,13,20,5,16,-4,-6,10,11,13,10,2,1,5,6,7,5,2,0,5,5,6,5,0,1,150,60,90,57,31,26,45,23,11,24,27,20,25,8,-4,5,16,9,20,15,15,19,11,11,19,10,11,9,6,1,11,5,5,6,4,0,8,5,6,3,2,1,266,143,123,132,64,68,30,47,127,48,22,-15,16,30,60,30,7,-2,14,17,67,18,15,-13,17,32,46,22,13,1,10,19,20,11,3,0,7,13,26,11,10,1,533,261,272,203,101,102,75,134,182,89,35,20,47,62,93,37,13,10,28,72,89,52,22,10,31,56,66,37,7,6,16,31,33,13,3,5,15,25,33,24,4,1,664,339,325,313,155,158,123,155,221,136,23,5,66,65,100,84,17,4,57,90,121,52,6,1,55,88,98,60,11,1,31,37,49,31,7,0,24,51,49,29,4,1,448,218,230,236,119,117,88,65,163,95,26,12,50,23,80,48,11,7,38,42,83,47,15,5,51,67,70,35,11,2,30,26,37,20,5,1,21,41,33,15,6,1,667,362,305,271,146,125,103,167,262,86,26,15,51,86,146,58,17,1,52,81,116,28,9,14,33,89,96,40,10,3,17,40,57,26,5,1,16,49,39,14,5,2,484,253,231,172,82,90,34,111,219,65,40,18,30,43,126,31,19,7,4,68,93,34,21,11,29,51,60,20,4,7,13,24,31,9,1,4,16,27,29,11,3,3,423,222,201,86,36,50,61,48,206,80,24,1,27,14,120,40,18,-1,34,34,86,40,6,2,22,24,22,10,6,1,12,9,9,3,2,1,10,15,13,7,4,0,484,225,259,115,55,60,65,100,220,72,30,1,21,38,110,39,12,5,44,62,110,33,18,-4,19,20,40,22,13,0,7,10,17,13,7,1,12,10,23,9,6,-1,243,136,107,98,56,42,5,52,111,30,22,26,-9,35,74,13,13,8,14,17,37,17,9,18,19,30,26,17,4,1,9,19,18,6,1,2,10,11,8,11,3,-1,-341,-252,-89,-349,-224,-125,-74,2,-158,-115,-3,5,-36,-30,-96,-78,-8,-3,-38,32,-62,-37,5,8,-45,-31,-136,-115,-22,0,-21,-26,-86,-71,-19,-1,-24,-5,-50,-44,-3,1,-216,-127,-89,-107,-83,-24,-44,-35,-48,-36,-23,-16,-10,-24,-36,-29,-18,-7,-34,-11,-12,-7,-5,-9,-19,-9,-40,-19,-15,-2,-7,-9,-31,-17,-15,-2,-12,0,-9,-2,0,0,112,39,73,36,23,13,41,25,17,32,-12,14,8,0,30,12,-8,3,33,25,-13,20,-4,11,16,12,2,0,3,2,9,8,2,1,1,1,7,4,0,-1,2,1,-32,2,-34,61,32,29,-43,21,0,-53,22,21,-3,18,0,-31,14,11,-40,3,0,-22,8,10,15,17,6,5,14,4,5,13,5,-2,7,4,10,4,1,7,7,0,65,51,14,94,57,37,-42,28,24,-16,46,17,-29,11,19,9,27,9,-13,17,5,-25,19,8,20,24,29,3,9,8,12,16,17,1,5,5,8,8,12,2,4,3,-15,-14,-1,24,3,21,-17,36,37,-97,13,15,-9,10,34,-63,2,12,-8,26,3,-34,11,3,16,5,21,-11,-4,-5,9,-2,11,-12,-2,-3,7,7,10,1,-2,-2
41,41903,"Cuervo de Sevilla, El",7717,-46,-20,-26,4,3,1,-9,-21,-13,-8,1,5,-2,-16,0,-3,-1,4,-7,-5,-13,-5,2,1,1,2,1,0,0,0,1,1,1,0,0,0,0,1,0,0,0,0,32,14,18,4,1,3,11,1,4,19,6,-7,2,-1,5,8,3,-3,9,2,-1,11,3,-4,1,0,1,1,1,0,0,0,1,0,0,0,1,0,0,1,1,0,12,9,3,27,18,9,6,-21,25,0,1,-1,2,-8,14,1,1,-1,4,-13,11,-1,0,0,6,5,14,1,-1,0,5,3,9,1,0,0,1,2,5,0,-1,0,70,37,33,50,25,25,4,29,20,6,8,-1,-4,16,14,7,4,-2,8,13,6,-1,4,1,10,13,15,6,4,0,5,5,9,3,2,0,5,8,6,3,2,0,132,85,47,57,32,25,37,23,48,21,2,0,27,11,30,11,3,0,10,12,18,10,-1,0,18,14,21,3,1,0,10,8,12,1,1,0,8,6,9,2,0,0,147,80,67,61,29,32,46,38,25,28,4,1,26,19,13,16,4,1,20,19,12,12,0,0,16,17,14,8,5,0,12,7,7,1,2,0,4,10,7,7,3,0,82,53,29,55,27,28,27,5,15,10,10,15,12,4,18,8,4,9,15,1,-3,2,6,6,16,18,12,8,0,0,7,10,6,4,0,0,9,8,6,4,0,0,39,27,12,42,23,19,11,10,6,-1,2,7,11,8,4,-5,-1,6,0,2,2,4,3,1,13,10,13,2,1,2,5,6,9,0,0,2,8,4,4,2,1,0,22,17,5,30,12,18,7,11,0,4,0,2,0,9,-3,4,5,2,7,2,3,0,-5,0,10,3,10,3,4,0,4,0,3,1,4,0,6,3,7,2,0,0,41,22,19,28,12,16,21,-3,5,12,6,-1,14,-5,2,11,3,-1,7,2,3,1,3,0,17,2,7,3,-1,0,10,0,2,1,-1,0,7,2,5,2,0,0,-15,-3,-12,15,11,4,11,-14,-21,11,-4,3,8,-4,-12,11,-1,-2,3,-10,-9,0,-3,5,5,4,6,0,0,0,5,1,4,0,1,0,0,3,2,0,-1,0,-53,-36,-17,-42,-24,-18,-8,-18,-15,-8,2,-5,3,-15,-14,-5,0,-3,-11,-3,-1,-3,2,-2,-10,-6,-8,-13,-2,-3,-5,-4,-5,-6,-2,-2,-5,-2,-3,-7,0,-1,-36,-18,-18,-6,-6,0,-9,-17,-12,-8,9,-2,-11,-10,-1,-5,5,1,2,-7,-11,-3,4,-3,-4,-1,-3,1,-1,1,-4,-2,-1,1,-2,1,0,1,-2,0,1,0,-41,-23,-18,4,0,4,-12,-7,-17,-10,6,-3,-8,-8,-9,-4,5,-1,-4,1,-8,-6,1,-2,-2,6,0,-1,0,0,-1,1,0,-1,0,0,-1,5,0,0,0,0,-53,-18,-35,-18,-8,-10,-9,2,-26,-12,-9,-2,-7,14,-6,-13,-5,-2,-2,-12,-20,1,-4,0,-2,-2,-4,-4,-4,-2,-1,1,2,-5,-4,-1,-1,-3,-6,1,0,-1,-18,-14,-4,3,2,1,-1,4,-13,-16,6,0,-5,-4,-9,-4,3,3,4,8,-4,-12,3,-3,1,1,2,1,-3,1,1,0,2,1,-3,1,0,1,0,0,0,0,-15,-21,6,-19,-21,2,21,-27,-8,-14,7,5,14,-18,-8,-11,6,-2,7,-9,0,-3,1,7,1,-6,-3,-13,-1,2,0,-5,-5,-10,-1,0,1,-1,2,-3,0,2,-64,-31,-33,-36,-23,-13,-2,-14,-23,-22,-5,-1,6,-3,-17,-13,-2,-3,-8,-11,-6,-9,-3,2,-5,-2,-14,-11,-2,-2,-1,-2,-8,-8,-2,-2,-4,0,-6,-3,0,0
41,41038,Dos Hermanas,94591,2716,1270,1446,95,41,54,522,335,1077,286,169,289,231,140,573,141,76,85,291,195,504,145,93,204,18,27,22,17,7,4,9,11,10,6,3,2,9,16,12,11,4,2,1486,741,745,175,88,87,345,133,643,226,72,64,168,62,321,123,39,29,177,71,322,103,33,35,47,34,48,31,12,2,21,18,25,17,4,2,26,16,23,14,8,0,2037,973,1064,173,73,100,416,271,838,294,121,63,226,113,403,136,64,15,190,158,435,158,57,48,50,38,29,30,18,4,23,17,13,6,10,3,27,21,16,24,8,1,1770,908,862,237,115,122,281,238,718,217,108,190,133,104,414,123,57,63,148,134,304,94,51,127,60,45,76,39,11,4,26,20,41,20,5,2,34,25,35,19,6,2,1672,814,858,309,150,159,286,214,770,227,65,81,155,89,397,110,26,26,131,125,373,117,39,55,58,81,106,38,17,3,31,38,53,18,6,1,27,43,53,20,11,2,1689,795,894,376,169,207,295,246,705,263,95,59,113,97,389,108,38,22,182,149,316,155,57,37,61,93,121,55,30,10,26,37,67,25,9,3,35,56,54,30,21,7,1713,843,870,323,170,153,285,236,731,289,69,59,139,122,341,158,31,29,146,114,390,131,38,30,77,78,86,60,27,-3,40,35,54,31,11,1,37,43,32,29,16,-4,1688,828,860,469,203,266,297,315,621,309,76,41,171,132,325,148,32,7,126,183,296,161,44,34,92,120,128,73,39,7,38,58,59,26,18,1,54,62,69,47,21,6,1394,654,740,362,160,202,198,276,577,221,33,62,126,131,275,91,13,16,72,145,302,130,20,46,69,78,142,51,13,1,35,28,75,13,6,1,34,50,67,38,7,0,1060,437,623,212,66,146,194,90,359,156,50,181,116,26,142,56,15,60,78,64,217,100,35,121,59,46,66,27,11,-3,32,11,14,2,3,-1,27,35,52,25,8,-2,1279,597,682,147,52,95,285,101,559,179,32,63,160,18,289,68,11,21,125,83,270,111,21,42,35,24,46,24,8,6,24,0,17,10,-2,0,11,24,29,14,10,6,520,109,411,130,30,100,84,62,207,63,20,54,32,4,54,2,-6,7,52,58,153,61,26,47,30,40,26,6,9,9,14,24,-5,-12,-2,4,16,16,31,18,11,5,153,42,111,-12,-36,24,-22,20,12,19,-11,90,-8,-8,12,5,-4,20,-14,28,0,14,-7,70,12,9,-43,0,-3,6,5,-7,-32,-7,0,3,7,16,-11,7,-3,3,-8,-60,52,-25,-17,-8,67,-19,-71,6,-46,28,78,-21,-76,-24,-28,-1,-11,2,5,30,-18,29,2,12,-26,-26,8,2,4,4,-18,-14,5,1,-2,8,-8,-12,3,1,285,73,212,40,6,34,128,-12,131,-56,-49,74,67,-17,48,-46,-27,21,61,5,83,-10,-22,53,19,16,3,-17,10,5,9,7,-2,-18,4,3,10,9,5,1,6,2,279,94,185,34,-7,41,92,6,35,39,6,64,36,-19,-8,50,2,14,56,25,43,-11,4,50,9,26,-21,-3,7,7,1,14,-25,-7,3,2,8,12,4,4,4,5,332,115,217,157,54,103,102,54,83,27,-54,99,47,21,52,-14,-32,33,55,33,31,41,-22,66,26,49,17,34,18,11,17,25,-7,11,4,3,9,24,24,23,14,8,189,3,186,66,24,42,99,-8,1,16,-5,55,33,-12,-55,2,5,7,66,4,56,14,-10,48,50,35,-3,-34,13,1,33,12,-6,-17,3,-4,17,23,3,-17,10,5
41,41039,Écija,37565,15,12,3,64,35,29,13,-3,-5,8,-5,7,11,13,-11,-2,-3,4,2,-16,6,10,-2,3,7,25,23,4,3,2,2,13,15,2,2,1,5,12,8,2,1,1,96,37,59,109,48,61,36,5,35,17,6,-7,18,-2,14,5,-1,2,18,7,21,12,7,-9,18,23,41,22,3,1,8,9,21,7,1,1,10,14,20,15,2,0,90,62,28,112,65,47,33,28,12,26,-13,4,28,3,23,18,-11,-1,5,25,-11,8,-2,5,29,24,33,24,1,0,20,10,24,9,1,0,9,14,9,15,0,0,185,94,91,118,65,53,40,25,62,9,15,25,18,11,18,17,8,19,22,14,44,-8,7,6,18,32,35,21,8,2,12,13,19,16,3,2,6,19,16,5,5,0,242,124,118,221,121,100,63,28,58,60,23,9,31,21,19,33,8,10,32,7,39,27,15,-1,31,49,81,45,13,1,16,24,47,25,7,1,15,25,34,20,6,0,337,182,155,219,113,106,80,73,94,55,24,9,33,43,63,24,14,1,47,30,31,31,10,8,37,62,68,37,11,1,18,31,38,20,4,0,19,31,30,17,7,1,228,105,123,156,79,77,64,27,39,37,43,12,38,1,14,20,26,-1,26,26,25,17,17,13,34,36,35,33,14,1,17,18,13,18,10,1,17,18,22,15,4,0,354,176,178,284,157,127,60,74,55,85,42,38,27,42,33,35,22,17,33,32,22,50,20,21,47,79,78,53,22,5,27,42,51,24,11,2,20,37,27,29,11,3,96,52,44,113,59,54,40,12,20,9,14,-3,19,8,16,4,7,-4,21,4,4,5,7,1,21,29,37,16,6,0,13,16,19,9,1,0,8,13,18,7,5,0,-1,8,-9,91,43,48,-1,-26,-23,18,-1,29,-8,-5,-19,16,5,15,7,-21,-4,2,-6,14,17,25,19,15,5,8,10,13,6,5,4,4,7,12,13,10,1,4,-46,-51,5,45,20,25,16,-17,-30,8,-6,-19,10,-22,-47,12,8,-13,6,5,17,-4,-14,-6,11,11,13,5,3,1,5,6,6,1,2,0,6,5,7,4,1,1,-163,-39,-124,33,14,19,-25,-28,-47,-20,-16,-20,-1,-12,0,-13,-5,-6,-24,-16,-47,-7,-11,-14,19,6,8,-2,4,-2,10,1,2,2,0,-1,9,5,6,-4,4,-1,-61,-54,-7,55,17,38,8,-14,-9,-33,-2,-8,-2,-15,-4,-24,-6,-1,10,1,-5,-9,4,-7,10,25,8,3,5,0,5,9,0,-1,2,0,5,16,8,4,3,0,-196,-105,-91,7,-5,12,-16,-26,-67,-58,-29,-1,-6,-13,-37,-29,-20,0,-10,-13,-30,-29,-9,-1,-1,8,-6,2,1,3,1,2,-6,-1,-2,1,-2,6,0,3,3,2,-151,-70,-81,17,2,15,-3,-35,-51,-42,3,-15,-7,-15,-25,-19,8,-10,4,-20,-26,-23,-5,-5,2,9,0,5,0,-1,1,2,0,0,-1,-1,1,7,0,5,1,0,-217,-106,-111,-49,-19,-30,-13,-13,-111,-37,-22,-18,-13,-9,-42,-27,-8,-6,0,-4,-69,-10,-14,-12,4,1,-11,-19,-16,-8,1,-2,-1,-10,-4,-3,3,3,-10,-9,-12,-5,-207,-116,-91,20,7,13,-24,-36,-75,-62,-1,-10,-22,-18,-44,-31,-4,-1,-2,-18,-31,-31,3,-9,5,4,4,2,4,0,2,-1,1,4,0,0,3,5,3,-2,4,0,-177,-66,-111,28,11,17,-19,-47,-67,-22,-12,-8,-6,-23,-31,0,-6,2,-13,-24,-36,-22,-6,-10,2,6,10,-4,7,5,5,1,5,-5,2,1,-3,5,5,1,5,4
41,41040,Espartinas,4749,455,241,214,16,7,9,95,57,137,96,45,17,59,28,70,51,22,8,36,29,67,45,23,9,3,1,3,5,2,2,2,0,1,2,1,1,1,1,2,3,1,1,228,116,112,26,11,15,36,17,98,44,22,10,13,8,46,28,15,5,23,9,52,16,7,5,11,0,7,5,3,0,3,0,4,2,2,0,8,0,3,3,1,0,650,304,346,43,19,24,151,84,216,115,36,20,62,48,92,58,18,10,89,36,124,57,18,10,12,3,8,14,3,2,3,1,3,7,3,1,9,2,5,7,0,1,683,315,368,39,17,22,157,58,227,122,42,31,68,30,98,67,18,9,89,28,129,55,24,22,18,5,8,4,3,0,8,1,6,0,2,0,10,4,2,4,1,0,625,292,333,43,18,25,159,43,182,140,25,20,82,19,72,72,14,7,77,24,110,68,11,13,14,4,10,11,3,1,7,2,3,4,1,1,7,2,7,7,2,0,1130,563,567,75,35,40,269,73,384,241,45,55,144,29,187,130,23,22,125,44,197,111,22,33,19,9,12,24,7,3,9,3,5,10,4,3,10,6,7,14,3,0,1245,637,608,44,20,24,326,67,414,285,73,38,171,37,198,158,35,15,155,30,216,127,38,23,10,7,12,10,5,0,7,1,5,4,3,0,3,6,7,6,2,0,1144,589,555,88,39,49,273,67,430,264,35,44,154,27,220,136,21,16,119,40,210,128,14,28,22,11,32,16,6,0,14,2,9,9,4,0,8,9,23,7,2,0,655,301,354,96,42,54,134,54,178,139,35,95,71,21,86,69,21,23,63,33,92,70,14,72,14,15,32,23,6,0,7,4,16,9,4,0,7,11,16,14,2,0,380,185,195,88,35,53,95,23,82,99,27,36,56,5,29,61,13,8,39,18,53,38,14,28,25,13,14,23,8,2,13,1,3,14,1,1,12,12,11,9,7,1,305,184,121,-3,4,-7,85,0,148,20,18,22,50,3,71,26,19,6,35,-3,77,-6,-1,16,2,5,0,-8,-3,0,3,5,1,-6,0,0,-1,0,-1,-2,-3,0,392,178,214,70,40,30,57,27,144,85,40,38,12,13,61,53,20,15,45,14,83,32,20,23,19,11,17,12,10,0,12,3,11,8,5,0,7,8,6,4,5,0,195,63,132,54,26,28,39,-9,86,43,2,31,13,-11,32,28,-1,2,26,2,54,15,3,29,18,11,14,6,0,2,10,4,7,2,2,0,8,7,7,4,-2,2,164,70,94,3,6,-3,62,0,60,16,-8,26,30,3,30,-3,-3,9,32,-3,30,19,-5,17,-1,3,-3,3,-2,2,3,3,0,0,-1,0,-4,0,-3,3,-1,2,120,50,70,-2,-2,0,8,-7,67,-23,29,46,20,-9,34,-18,9,17,-12,2,33,-5,20,29,0,-4,-3,3,-1,2,3,-5,-1,1,-1,0,-3,1,-2,2,0,2,273,114,159,43,32,11,74,-9,99,54,-1,38,45,-1,38,17,-5,8,29,-8,61,37,4,30,18,7,13,2,-1,1,17,3,9,0,0,1,1,4,4,2,-1,0,172,99,73,-13,2,-15,25,24,84,7,-11,27,34,28,33,-7,-11,13,-9,-4,51,14,0,14,-4,14,7,-25,-5,-2,-2,16,5,-14,-3,-1,-2,-2,2,-11,-2,-1,223,114,109,121,72,49,47,15,87,34,-3,22,19,12,37,26,-1,7,28,3,50,8,-2,15,23,43,29,6,8,5,10,33,15,3,5,2,13,10,14,3,3,3
41,41041,Estepa,11654,41,16,25,24,7,17,10,8,16,-1,11,-4,0,3,5,-2,8,0,10,5,11,1,3,-4,8,5,5,4,1,0,2,2,0,3,0,0,6,3,5,1,1,0,104,54,50,46,22,24,14,18,38,13,16,3,7,10,20,8,7,2,7,8,18,5,9,1,9,15,12,9,1,0,5,6,6,4,1,0,4,9,6,5,0,0,57,38,19,16,9,7,16,0,32,1,4,2,19,3,9,0,4,3,-3,-3,23,1,0,-1,5,3,5,4,-1,0,2,3,2,2,0,0,3,0,3,2,-1,0,19,-5,24,30,12,18,-4,9,-9,13,11,-1,-5,3,-8,9,3,-4,1,6,-1,4,8,3,6,4,7,10,3,0,2,0,4,5,1,0,4,4,3,5,2,0,-1,8,-9,46,23,23,-13,-4,-5,-4,17,11,-3,0,5,-3,6,3,-10,-4,-10,-1,11,8,7,5,7,17,9,1,4,3,3,10,3,0,3,2,4,7,6,1,97,48,49,74,47,27,15,23,33,22,12,-9,6,13,16,17,5,-7,9,10,17,5,7,-2,10,17,20,13,12,2,5,12,14,9,7,0,5,5,6,4,5,2,83,46,37,28,10,18,20,17,20,12,15,4,13,9,4,8,10,4,7,8,16,4,5,0,1,4,7,6,9,1,-1,0,3,2,5,1,2,4,4,4,4,0,98,52,46,70,29,41,18,-4,33,21,11,17,10,-1,23,7,9,3,8,-3,10,14,2,14,12,9,23,16,10,0,5,0,11,8,5,0,7,9,12,8,5,0,72,26,46,42,18,24,31,25,-1,18,-7,5,15,8,-1,13,-8,-1,16,17,0,5,1,6,14,19,-6,14,2,-2,10,6,-5,8,-1,-1,4,13,-1,6,3,-1,7,7,0,41,16,25,1,9,-7,6,-2,-2,-6,3,6,3,-2,1,7,6,-13,3,0,-3,18,7,7,6,2,0,4,5,4,2,1,0,14,2,3,4,1,0,-71,-36,-35,27,9,18,-9,-16,-25,-14,-6,-3,-5,-5,-20,-4,-7,3,-4,-11,-5,-10,1,-6,6,8,6,6,0,1,3,1,2,2,0,1,3,7,4,4,0,0,-8,-20,12,16,8,8,-19,11,14,-8,-2,-4,-7,4,-2,-9,-1,-3,-12,7,16,1,-1,-1,3,7,6,1,-2,0,5,3,0,0,0,0,-2,4,6,1,-2,0,-47,-32,-15,-15,-9,-6,7,5,-31,-30,0,2,2,1,-26,-13,0,5,5,4,-5,-17,0,-3,2,-2,-9,-6,0,0,1,-4,-4,-2,0,0,1,2,-5,-4,0,0,11,-7,18,19,8,11,21,-13,0,2,-5,1,5,-13,-3,7,-5,-2,16,0,3,-5,0,3,11,5,-3,2,2,1,5,3,-5,1,2,1,6,2,2,1,0,0,33,19,14,31,17,14,24,5,-13,9,12,1,11,3,-8,4,5,4,13,2,-5,5,7,-3,9,5,4,3,6,6,6,2,1,3,3,2,3,3,3,0,3,4,-78,-16,-62,-3,-2,-1,-6,-24,-29,1,-7,-13,-4,-9,-9,10,-1,-3,-2,-15,-20,-9,-6,-10,5,-1,-8,-4,2,1,3,-1,-5,-2,1,1,2,0,-3,-2,1,0,-59,-27,-32,35,14,21,-9,-2,2,-21,-9,-21,-4,0,-2,-13,-3,-8,-5,-2,4,-8,-6,-13,13,5,13,3,1,-2,10,0,3,0,1,-2,3,5,10,3,0,0,-40,-16,-24,18,5,13,-2,0,-21,-5,0,-11,-5,5,-8,-7,0,0,3,-5,-13,2,0,-11,7,4,4,2,1,0,1,1,2,0,1,0,6,3,2,2,0,0
41,41044,Gelves,5644,201,105,96,22,8,14,14,33,75,52,13,12,11,20,32,30,4,6,3,13,43,22,9,6,3,5,8,4,2,0,0,2,3,2,1,0,3,3,5,2,1,0,219,120,99,19,11,8,32,15,100,52,19,2,18,20,51,23,8,1,14,-5,49,29,11,1,4,2,5,3,3,2,3,1,3,1,2,1,1,1,2,2,1,1,333,179,154,38,23,15,72,3,151,65,29,4,47,0,74,34,17,0,25,3,77,31,12,4,8,6,7,8,5,3,5,5,3,3,4,2,3,1,4,5,1,1,277,158,119,39,27,12,39,13,151,53,16,5,29,15,76,28,10,0,10,-2,75,25,6,5,11,9,13,3,1,0,9,5,9,3,1,0,2,4,4,0,0,0,267,127,140,30,17,13,41,10,119,51,36,9,29,1,57,18,19,3,12,9,62,33,17,6,8,5,9,5,1,1,8,3,4,1,0,1,0,2,5,4,1,0,250,103,147,45,20,25,43,34,109,58,4,13,15,11,57,22,-1,7,28,23,52,36,5,6,8,14,8,10,4,0,6,6,1,4,3,0,2,8,7,6,1,0,128,74,54,45,22,23,15,13,38,46,7,6,14,7,16,31,-2,4,1,6,22,15,9,2,9,12,13,6,4,0,6,7,4,3,1,0,3,5,9,3,3,0,192,84,108,73,38,35,36,32,50,53,12,9,21,5,21,23,13,4,15,27,29,30,-1,5,15,14,22,13,8,0,10,5,11,7,4,0,5,9,11,6,4,0,156,84,72,40,20,20,63,10,26,51,0,2,46,-2,8,23,5,2,17,12,18,28,-5,0,8,7,11,11,0,1,6,1,5,5,0,1,2,6,6,6,0,0,55,26,29,18,3,15,27,0,9,-6,15,8,14,1,-3,-3,11,5,13,-1,12,-3,4,3,-4,5,8,5,2,2,-2,0,1,2,1,1,-2,5,7,3,1,1,119,50,69,25,13,12,52,4,58,10,-21,10,15,0,32,0,-4,2,37,4,26,10,-17,8,5,1,13,4,1,1,1,1,6,4,1,0,4,0,7,0,0,1,73,29,44,55,29,26,36,1,-1,17,11,4,14,-1,1,4,7,0,22,2,-2,13,4,4,16,9,13,10,7,-1,9,4,6,4,5,0,7,5,7,6,2,-1,135,60,75,21,9,12,8,24,67,19,14,4,4,5,47,2,2,0,4,19,20,17,12,4,5,2,6,5,2,1,1,1,4,2,1,0,4,1,2,3,1,1,57,31,26,10,-1,11,-8,-5,47,19,-5,1,-5,1,15,13,1,1,-3,-6,32,6,-6,0,2,3,0,2,2,1,0,0,-1,-1,1,0,2,3,1,3,1,1,114,60,54,15,9,6,32,8,69,-5,-16,1,25,2,39,-7,-14,2,7,6,30,2,-2,-1,4,2,7,1,1,-1,3,3,3,-1,-1,1,1,-1,4,2,2,-2,69,14,55,22,4,18,18,8,33,-9,-1,6,12,-10,12,-1,-1,-4,6,18,21,-8,0,10,8,2,2,3,3,4,3,-1,0,1,0,1,5,3,2,2,3,3,69,73,-4,2,-2,4,-13,6,41,16,-2,15,11,6,25,16,-2,11,-24,0,16,0,0,4,2,-3,4,-2,-3,3,-1,-2,3,-2,-2,1,3,-1,1,0,-1,2,-16,-22,6,17,8,9,-16,-10,42,-17,-12,-4,-15,0,9,-9,-9,1,-1,-10,33,-8,-3,-5,2,2,8,4,2,-1,0,0,5,1,2,0,2,2,3,3,0,-1
41,41045,Gerena,5450,2,2,0,5,3,2,-2,-4,-3,5,3,1,1,-3,-4,5,2,0,-3,-1,1,0,1,1,0,1,2,1,1,0,0,0,1,1,1,0,0,1,1,0,0,0,69,36,33,16,7,9,9,13,21,13,10,1,5,7,12,6,5,0,4,6,9,7,5,1,3,3,3,2,3,2,2,1,1,1,1,1,1,2,2,1,2,1,107,59,48,21,13,8,31,10,31,10,19,6,17,8,20,0,10,3,14,2,11,10,9,3,6,3,6,5,1,0,5,2,4,2,0,0,1,1,2,3,1,0,17,13,4,11,6,5,0,13,-14,3,3,11,1,12,-4,0,0,4,-1,1,-10,3,3,7,3,4,1,3,0,0,2,3,0,1,0,0,1,1,1,2,0,0,54,30,24,15,13,2,21,3,6,12,6,1,11,5,0,7,3,-1,10,-2,6,5,3,2,3,4,7,1,0,-1,2,3,6,1,0,0,1,1,1,0,0,-1,90,44,46,18,11,7,18,19,22,16,13,1,8,7,14,6,10,-1,10,12,8,10,3,2,6,5,3,3,1,0,4,4,2,1,0,0,2,1,1,2,1,0,128,61,67,30,16,14,28,11,41,25,6,11,12,4,18,11,6,6,16,7,23,14,0,5,8,8,10,2,1,1,7,4,2,1,1,1,1,4,8,1,0,0,157,89,68,21,12,9,41,17,61,28,6,-2,26,10,31,17,2,0,15,7,30,11,4,-2,4,7,5,4,1,0,4,4,1,2,1,0,0,3,4,2,0,0,307,164,143,27,15,12,69,31,126,53,12,4,37,12,67,32,5,2,32,19,59,21,7,2,4,5,6,9,3,0,1,3,4,5,2,0,3,2,2,4,1,0,285,156,129,17,7,10,42,30,143,34,18,7,27,15,75,19,12,1,15,15,68,15,6,6,1,5,4,5,2,0,1,2,1,2,1,0,0,3,3,3,1,0,155,67,88,18,6,12,21,13,89,29,-1,-1,3,4,33,23,0,2,18,9,56,6,-1,-3,7,5,1,3,1,0,1,2,-1,2,1,0,6,3,2,1,0,0,139,64,75,-4,-2,-2,30,20,49,21,6,7,19,5,16,12,2,8,11,15,33,9,4,-1,1,2,-2,-3,-1,-1,2,0,-2,-1,-1,0,-1,2,0,-2,0,-1,8,8,0,-2,-4,2,-24,8,24,-10,1,2,-16,3,19,-4,-1,3,-8,5,5,-6,2,-1,1,3,-1,-4,-1,0,0,1,-1,-3,-1,0,1,2,0,-1,0,0,63,46,17,2,0,2,-1,-5,18,18,11,21,5,4,10,9,7,8,-6,-9,8,9,4,13,1,1,-2,1,1,0,1,0,-2,0,1,0,0,1,0,1,0,0,65,35,30,3,-1,4,22,5,22,20,1,-3,11,3,5,13,4,1,11,2,17,7,-3,-4,3,-2,1,0,-1,1,0,-2,0,1,0,0,3,0,1,-1,-1,1,12,-3,15,15,7,8,-17,3,1,4,16,5,-11,-2,5,-1,4,2,-6,5,-4,5,12,3,2,1,2,5,3,2,2,1,0,2,1,1,0,0,2,3,2,1,30,6,24,5,5,0,0,-7,19,6,3,8,-4,-1,10,2,-2,3,4,-6,9,4,5,5,0,1,3,1,0,0,1,3,2,0,-1,0,-1,-2,1,1,1,0,46,36,10,20,7,13,11,0,1,14,7,12,12,2,-2,12,3,8,-1,-2,3,2,4,4,6,2,7,0,4,0,4,1,1,-1,1,0,2,1,6,1,3,0
41,41047,Gines,9303,313,125,188,16,6,10,94,27,100,48,19,11,33,19,33,24,7,1,61,8,67,24,12,10,3,2,6,3,2,0,2,0,2,2,0,0,1,2,4,1,2,0,291,157,134,38,15,23,79,17,92,47,29,25,50,5,54,23,14,10,29,12,38,24,15,15,12,9,7,9,0,0,4,2,3,6,0,0,8,7,4,3,0,0,379,178,201,38,15,23,96,38,103,73,28,31,30,25,53,32,17,14,66,13,50,41,11,17,11,9,0,13,1,3,6,4,-1,4,1,0,5,5,1,9,0,3,333,177,156,21,14,7,60,28,140,55,9,23,31,20,73,34,3,8,29,8,67,21,6,15,3,3,6,5,1,2,5,2,5,1,0,0,-2,1,1,4,1,2,306,133,173,38,18,20,92,-1,115,68,7,22,42,1,46,33,5,8,50,-2,69,35,2,14,14,1,16,7,0,0,5,0,8,5,0,0,9,1,8,2,0,0,102,49,53,51,19,32,27,-5,35,28,-3,10,22,-6,21,8,2,-1,5,1,14,20,-5,11,7,10,16,13,1,4,3,4,5,5,1,1,4,6,11,8,0,3,156,49,107,41,15,26,23,-1,44,44,16,33,18,-9,17,14,7,7,5,8,27,30,9,26,4,12,13,7,0,3,4,2,6,2,0,0,0,10,7,5,0,3,53,18,35,65,33,32,37,5,-1,-5,-7,16,23,-6,0,-4,-2,0,14,11,-1,-1,-5,16,10,12,24,16,2,0,5,5,12,10,0,0,5,7,12,6,2,0,194,78,116,77,38,39,11,21,64,23,17,28,16,4,26,7,6,6,-5,17,38,16,11,22,2,20,22,23,6,3,1,9,13,10,4,0,1,11,9,13,2,3,124,30,94,29,12,17,27,-3,43,19,14,12,14,-3,-1,4,4,5,13,0,44,15,10,7,0,4,18,2,6,-2,-1,4,5,1,2,0,1,0,13,1,4,-2,5,-20,25,34,19,15,4,1,-9,-17,-3,9,-2,-7,-7,-8,-5,-1,6,8,-2,-9,2,10,3,8,10,6,7,-1,3,1,8,4,3,0,0,7,2,2,4,-1,123,58,65,11,0,11,37,-10,26,35,16,9,13,-6,14,20,8,2,24,-4,12,15,8,7,8,0,-3,4,1,0,1,1,-3,0,0,0,7,-1,0,4,1,0,-33,-34,1,-37,-25,-12,-10,-12,-24,-4,11,-1,-18,-20,-7,-4,10,1,8,8,-17,0,1,-2,-3,-5,-14,-11,-5,-2,-4,-4,-11,-7,0,0,1,-1,-3,-4,-5,-2,-55,-54,-1,12,7,5,10,-24,-35,21,-27,-4,6,-15,-25,1,-17,-5,4,-9,-10,20,-10,1,4,2,-4,9,1,0,4,1,-1,3,0,0,0,1,-3,6,1,0,11,-7,18,12,-5,17,26,-2,-9,-4,-6,6,14,-1,-11,4,-8,-3,12,-1,2,-8,2,9,4,4,-2,3,3,0,0,0,-5,0,0,0,4,4,3,3,3,0,-55,-69,14,-45,-26,-19,13,-21,-32,-6,-10,2,-2,-22,-17,-22,-5,0,15,1,-15,16,-5,2,-10,-2,-11,-17,-3,-2,-7,-4,-1,-10,-3,-1,-3,2,-10,-7,0,-1,37,26,11,8,5,3,13,8,14,3,-10,4,4,3,7,12,0,-3,9,5,7,-9,-10,7,4,3,3,-5,2,0,2,0,4,-2,1,0,2,3,-1,-3,1,0,91,46,45,2,-2,4,36,-15,42,17,5,4,19,-4,22,-3,8,4,17,-11,20,20,-3,0,-4,2,12,-4,-5,1,-3,-2,9,-4,-2,0,-1,4,3,0,-3,1
41,41049,Guillena,8286,34,31,3,25,16,9,10,10,-9,15,7,0,13,10,-7,10,4,1,-3,0,-2,5,3,-1,7,4,10,1,2,0,4,3,6,0,2,0,3,1,4,1,0,0,-32,-22,-10,11,7,4,-14,-12,-10,-4,3,3,-8,-8,-5,-4,0,2,-6,-4,-5,0,3,1,5,2,1,2,1,0,4,1,1,1,0,0,1,1,0,1,1,0,51,32,19,13,7,6,16,-6,15,14,5,6,11,-4,10,7,3,4,5,-2,5,7,2,2,5,1,4,0,3,0,2,1,2,0,2,0,3,0,2,0,1,0,121,56,65,21,11,10,27,16,31,29,13,8,12,9,13,15,5,1,15,7,18,14,8,7,3,9,7,3,-1,0,1,6,3,2,-1,0,2,3,4,1,0,0,210,95,115,19,5,14,37,46,90,12,23,4,22,23,35,4,12,1,15,23,55,8,11,3,4,7,3,3,0,2,0,2,1,1,0,1,4,5,2,2,0,1,259,114,145,16,8,8,46,28,107,59,15,3,17,6,53,28,8,2,29,22,54,31,7,1,3,4,4,2,3,0,2,2,1,2,1,0,1,2,3,0,2,0,581,287,294,26,14,12,115,76,199,108,57,11,54,31,97,55,39,4,61,45,102,53,18,7,4,6,4,6,5,1,2,3,2,4,3,0,2,3,2,2,2,1,518,261,257,60,35,25,74,94,221,81,43,5,33,46,114,43,23,2,41,48,107,38,20,3,9,12,17,17,5,0,3,7,12,11,2,0,6,5,5,6,3,0,377,176,201,57,26,31,71,48,168,55,20,4,37,19,74,29,12,-1,34,29,94,26,8,5,12,11,16,15,2,0,6,7,8,3,2,0,6,4,8,12,0,0,228,127,101,61,24,37,33,33,103,45,9,3,10,18,59,31,4,4,23,15,44,14,5,-1,11,16,22,7,1,3,5,6,10,2,0,1,6,10,12,5,1,2,245,141,104,24,7,17,53,27,79,52,27,12,39,26,31,24,18,5,14,1,48,28,9,7,8,2,7,2,2,2,3,2,-2,1,1,1,5,0,9,1,1,1,227,120,107,13,3,10,42,23,108,49,1,-2,23,6,57,35,-1,-2,19,17,51,14,2,0,6,7,6,-3,-6,0,2,0,7,-4,-4,0,4,7,-1,1,-2,0,106,61,45,26,13,13,12,34,10,22,17,4,5,16,9,14,10,4,7,18,1,8,7,0,19,5,0,1,-4,2,12,0,3,-1,-3,1,7,5,-3,2,-1,1,74,30,44,22,10,12,4,10,34,17,8,-2,6,-1,17,9,3,-1,-2,11,17,8,5,-1,1,4,7,7,1,-1,1,3,4,2,1,-1,0,1,3,5,0,0,59,38,21,23,7,16,4,9,25,0,19,3,9,5,11,1,13,0,-5,4,14,-1,6,3,3,6,10,1,1,2,2,3,1,0,0,1,1,3,9,1,1,1,24,29,-5,25,11,14,-2,22,1,-7,10,4,3,21,-4,5,9,-2,-5,1,5,-12,1,6,7,11,1,2,2,2,0,6,2,0,1,2,7,5,-1,2,1,0,-17,0,-17,11,5,6,-19,0,-5,-18,7,16,-16,-8,11,-3,5,9,-3,8,-16,-15,2,7,7,2,4,-2,-1,0,3,1,3,-1,-1,0,4,1,1,-1,0,0,-28,-21,-7,20,7,13,-25,2,1,-3,-9,5,-18,2,-3,-1,-5,6,-7,0,4,-2,-4,-1,7,7,4,10,-5,-4,4,4,1,1,-2,-1,3,3,3,9,-3,-3
41,41902,Isla Mayor,6076,-3,-6,3,4,2,2,0,-4,-4,3,3,-1,-3,-4,-3,1,2,0,3,0,-1,2,1,-1,0,1,1,2,0,0,0,0,0,2,0,0,0,1,1,0,0,0,-50,-19,-31,12,9,3,-7,-14,-6,-15,-10,1,-2,-8,1,-2,-8,0,-5,-6,-7,-13,-2,1,2,1,6,3,0,0,2,0,4,3,0,0,0,1,2,0,0,0,-67,-35,-32,10,4,6,-14,-23,-17,-5,-3,-3,-9,-9,-8,-6,-2,-2,-5,-14,-9,1,-1,-1,3,1,3,3,0,0,2,0,2,1,-1,0,1,1,1,2,1,0,-62,-22,-40,11,3,8,-22,-3,-23,-5,-8,-3,-9,0,-8,0,-3,-3,-13,-3,-15,-5,-5,0,1,2,5,2,0,0,0,1,0,1,0,0,1,1,5,1,0,0,-73,-24,-49,8,4,4,-23,-21,-10,-20,3,-2,-4,-13,-2,-8,2,2,-19,-8,-8,-12,1,-4,2,3,3,0,0,0,2,1,1,0,0,0,0,2,2,0,0,0,-75,-51,-24,4,1,3,-10,-8,-36,-19,1,-4,-7,-11,-15,-17,0,-1,-3,3,-21,-2,1,-3,1,2,0,1,0,0,1,1,0,-1,0,0,0,1,0,2,0,0,-49,-19,-30,14,7,7,-12,-9,-7,-13,-7,2,-4,0,-3,-4,-8,1,-8,-9,-4,-9,1,1,2,6,1,3,2,0,0,4,1,2,0,0,2,2,0,1,2,0,4,8,-4,26,9,17,0,-1,-7,1,9,0,1,-1,-4,3,5,1,-1,0,-3,-2,4,-1,7,8,6,3,2,0,2,4,2,1,0,0,5,4,4,2,2,0,13,16,-3,20,8,12,13,4,-1,5,-5,-4,12,8,0,-1,-3,-1,1,-4,-1,6,-2,-3,10,0,3,4,2,0,5,0,0,2,0,0,5,0,3,2,2,0,22,5,17,14,6,8,2,10,5,1,-2,4,4,0,3,-1,-2,0,-2,10,2,2,0,4,3,4,5,2,0,0,3,2,1,0,0,0,0,2,4,2,0,0,-27,-15,-12,10,5,5,2,3,-17,3,-7,-12,-1,-1,-12,7,-3,-5,3,4,-5,-4,-4,-7,2,4,2,4,-2,0,0,3,0,2,0,0,2,1,2,2,-2,0,16,17,-1,18,11,7,3,9,3,1,0,-3,4,6,3,2,2,-1,-1,3,0,-1,-2,-2,3,4,2,4,4,0,2,3,2,1,3,0,1,1,0,3,1,0,-28,-6,-22,7,4,3,-3,0,-20,3,-5,-4,-3,1,-8,4,0,0,0,-1,-12,-1,-5,-4,3,1,1,0,0,0,2,0,0,1,0,0,1,1,1,-1,0,0,-26,-17,-9,4,0,4,-16,5,-10,0,-2,-4,-8,1,-4,-3,-3,-1,-8,4,-6,3,1,-3,0,1,2,-1,2,0,0,1,-1,-1,1,0,0,0,3,0,1,0,11,0,11,7,3,4,6,9,-10,8,2,-5,-4,5,-4,6,1,-4,10,4,-6,2,1,-1,-2,4,3,2,0,0,-1,2,1,1,0,0,-1,2,2,1,0,0,-26,-27,1,-13,-7,-6,-5,8,-9,-13,0,-10,-7,0,-7,-10,0,-4,2,8,-2,-3,0,-6,-5,0,-4,-2,-2,0,-3,0,0,-2,-2,0,-2,0,-4,0,0,0,-35,-18,-17,-5,-3,-2,4,-10,-11,-5,-4,-8,2,-3,-8,-2,-3,-4,2,-7,-3,-3,-1,-4,-2,3,-2,-3,-1,0,0,1,-1,-2,-1,0,-2,2,-1,-1,0,0,-32,-15,-17,0,-2,2,-1,-1,-8,-16,-2,-6,4,1,-7,-10,-1,-3,-5,-2,-1,-6,-1,-3,1,0,0,1,-2,0,1,0,-1,-1,-1,0,0,0,1,2,-1,0
41,41053,Lebrija,24023,-52,-32,-20,13,7,6,-7,-16,-12,-20,-1,2,-8,0,-7,-18,-1,-1,1,-16,-5,-2,0,3,1,6,3,1,2,0,1,3,2,0,1,0,0,3,1,1,1,0,-9,16,-25,24,16,8,10,-14,-27,8,2,15,8,3,-10,9,2,9,2,-17,-17,-1,0,6,6,6,5,3,3,1,4,4,3,3,1,1,2,2,2,0,2,0,5,-5,10,9,-3,12,20,-29,17,-6,5,-4,1,-18,14,-3,0,-2,19,-11,3,-3,5,-2,5,-1,2,2,1,0,0,-3,0,0,0,0,5,2,2,2,1,0,44,23,21,16,4,12,21,-3,-2,19,11,-2,15,-5,-3,8,8,-1,6,2,1,11,3,-1,5,2,5,3,1,0,1,1,0,1,1,0,4,1,5,2,0,0,59,31,28,27,12,15,13,4,26,11,3,2,4,4,16,9,-3,2,9,0,10,2,6,0,3,6,13,3,1,1,1,4,7,0,0,0,2,2,6,3,1,1,135,65,70,49,27,22,37,9,45,19,12,10,21,-2,27,9,4,5,16,11,18,10,8,5,12,7,22,5,2,1,6,3,11,5,1,1,6,4,11,0,1,0,239,118,121,75,39,36,59,53,56,36,25,7,32,22,22,25,13,2,27,31,34,11,12,5,9,21,17,14,10,1,7,5,9,9,7,0,2,16,8,5,3,1,257,147,110,106,48,58,61,36,74,60,23,6,25,17,61,26,15,5,36,19,13,34,8,1,23,24,21,29,8,0,10,11,12,11,2,1,13,13,9,18,6,-1,196,83,113,91,35,56,60,19,59,13,18,18,31,11,22,2,2,8,29,8,37,11,16,10,30,16,16,9,13,5,10,6,7,3,4,3,20,10,9,6,9,2,137,85,52,48,25,23,33,13,27,48,-1,14,28,11,13,23,3,8,5,2,14,25,-4,6,14,11,9,6,3,4,8,6,4,4,0,3,6,5,5,2,3,1,138,54,84,17,-4,21,42,-8,19,29,28,26,20,-13,2,14,17,12,22,5,17,15,11,14,1,6,-2,5,6,0,-1,0,-6,1,2,0,2,6,4,4,4,0,91,64,27,9,9,0,25,2,26,17,10,8,18,3,21,6,9,3,7,-1,5,11,1,5,2,5,-1,-2,5,0,2,3,0,0,4,0,0,2,-1,-2,1,0,63,23,40,13,-2,15,27,15,-5,-1,8,12,13,13,-14,-2,2,6,14,2,9,1,6,6,14,-3,-6,3,0,3,5,0,-7,-2,0,2,9,-3,1,5,0,1,-72,-59,-13,-24,-14,-10,-7,-7,-16,-39,-11,7,-4,-3,-12,-31,-11,1,-3,-4,-4,-8,0,6,-3,-4,-3,-14,-3,2,-3,-2,0,-9,-1,1,0,-2,-3,-5,-2,1,-16,-7,-9,-8,-1,-7,-6,-8,2,-12,5,1,1,-7,8,-8,-3,0,-7,-1,-6,-4,8,1,1,-1,-3,-7,2,-1,1,2,1,-4,-2,0,0,-3,-4,-3,4,-1,-61,-43,-18,-34,-21,-13,-17,-26,-26,-18,5,19,-6,-16,-8,-27,-2,15,-11,-10,-18,9,7,4,-11,-5,-17,-2,-1,2,-3,-5,-9,-3,-3,2,-8,0,-8,1,2,0,-60,-46,-14,-28,-25,-3,19,-23,-22,-15,-23,4,10,-15,-22,-4,-15,2,9,-8,0,-11,-8,2,-3,-3,-4,-16,-1,-2,-4,-5,-3,-14,0,0,1,2,-1,-2,-1,-2,-42,-8,-34,6,9,-3,2,-6,-30,5,-4,-9,8,-7,-15,9,-2,-4,-6,1,-15,-4,-2,-5,1,-1,11,-1,-2,-1,0,2,6,0,1,0,1,-3,5,-1,-3,-1
41,41055,Lora del Río,18878,-180,-78,-102,8,4,4,-51,-58,-45,-27,-1,4,-20,-32,-18,-14,3,4,-31,-26,-27,-13,-4,0,4,1,0,2,0,1,4,0,0,0,0,0,0,1,0,2,0,1,-96,-51,-45,39,21,18,-15,-29,-32,-3,-10,-7,-13,-10,-15,-4,-5,-4,-2,-19,-17,1,-5,-3,9,13,12,4,0,0,5,7,7,2,0,0,4,6,5,2,0,0,-18,-2,-16,32,11,21,-13,-13,-19,-6,16,19,-3,-2,-2,-2,4,4,-10,-11,-17,-4,12,15,2,15,6,3,5,1,0,4,3,1,3,0,2,11,3,2,2,1,36,31,5,84,42,42,15,-2,4,5,9,0,14,-2,14,-3,7,1,1,0,-10,8,2,-1,16,19,28,13,6,2,9,5,16,8,3,1,7,14,12,5,3,1,74,30,44,77,36,41,11,11,19,4,24,5,3,2,14,4,7,0,8,9,5,0,17,5,10,22,29,5,8,2,3,9,16,3,3,1,7,13,13,2,5,1,210,134,76,138,82,56,59,43,35,49,18,6,33,25,27,31,11,7,26,18,8,18,7,-1,24,37,40,29,5,2,12,20,22,20,6,1,12,17,18,9,-1,1,94,32,62,71,32,39,17,27,22,17,9,4,3,7,14,2,9,-2,14,20,8,15,0,6,9,24,17,17,4,0,3,8,10,10,1,0,6,16,7,7,3,0,76,58,18,127,77,50,18,14,31,28,-13,-4,23,5,18,17,-4,-3,-5,9,13,11,-9,-1,20,35,40,31,-1,1,11,22,23,20,0,1,9,13,17,11,-1,0,-112,-63,-49,-17,-12,-5,5,-32,-52,-13,-7,-5,5,-15,-35,-12,-2,-1,0,-17,-17,-1,-5,-4,6,7,-11,-10,-9,0,3,3,-7,-8,-3,0,3,4,-4,-2,-6,0,-16,-20,4,28,8,20,8,11,-20,10,-11,-14,-5,-1,-13,13,-11,-2,13,12,-7,-3,0,-12,4,9,7,3,3,0,1,4,0,2,0,0,3,5,7,1,3,0,-47,-34,-13,45,18,27,9,19,-47,-13,1,-13,8,6,-32,-14,7,-8,1,13,-15,1,-6,-5,16,9,10,10,-1,0,6,4,5,2,0,0,10,5,5,8,-1,0,-60,-36,-24,40,12,28,-18,-8,-16,-6,-3,-7,-10,-3,-10,-2,-5,-5,-8,-5,-6,-4,2,-2,14,15,9,2,-1,1,8,4,3,-2,-1,0,6,11,6,4,0,1,-14,5,-19,67,44,23,-6,22,-20,-3,-3,-9,-10,11,-4,10,2,-7,4,11,-16,-13,-5,-2,6,23,14,16,7,0,2,14,9,13,5,0,4,9,5,3,2,0,-13,-13,0,19,12,7,18,4,-26,-1,-2,-8,5,1,-12,3,-6,-3,13,3,-14,-4,4,-5,7,6,0,7,-2,1,4,5,-2,6,-2,1,3,1,2,1,0,0,-72,-64,-8,-18,-18,0,-7,-5,-42,-15,-13,3,-4,-8,-35,-11,-12,4,-3,3,-7,-4,-1,-1,-6,10,-5,-15,-3,1,-4,6,-5,-13,-3,1,-2,4,0,-2,0,0,-106,-33,-73,3,1,2,-25,-23,-32,-15,-5,-7,-7,-7,-8,-9,1,-4,-18,-16,-24,-6,-6,-3,-2,-3,3,2,1,0,0,-1,2,-1,1,0,-2,-2,1,3,0,0,-123,-51,-72,-28,-14,-14,-22,-35,-41,-16,5,-14,-5,-12,-22,-11,3,-3,-17,-23,-19,-5,2,-11,0,-1,-10,-10,-5,-3,1,-1,-3,-9,-1,-1,-1,0,-7,-1,-4,-2,-62,-33,-29,-17,-8,-9,6,2,-45,-11,-6,-10,8,-6,-27,-6,1,-4,-2,8,-18,-5,-7,-6,-5,-2,-9,-1,-1,0,2,-2,-8,0,0,0,-7,0,-1,-1,-1,0
41,41056,"Luisiana, La",4339,8,5,3,6,3,3,8,-8,5,0,2,0,3,-4,1,2,1,1,5,-4,4,-2,1,-1,0,0,4,2,0,0,0,0,2,1,0,0,0,0,2,1,0,0,-3,-4,1,2,1,1,2,-5,1,-2,0,1,2,-5,-1,0,0,0,0,0,2,-2,0,1,0,0,2,0,0,0,0,0,1,0,0,0,0,0,1,0,0,0,33,16,17,9,4,5,11,4,4,8,9,-4,5,1,-3,5,5,2,6,3,7,3,4,-6,4,1,3,1,0,0,2,0,1,1,0,0,2,1,2,0,0,0,10,12,-2,13,7,6,-2,-2,6,6,-1,4,1,-3,6,6,0,2,-3,1,0,0,-1,2,3,0,6,4,0,0,3,0,3,1,0,0,0,0,3,3,0,0,59,30,29,24,12,12,12,7,7,23,5,4,10,2,2,10,3,2,2,5,5,13,2,2,5,2,8,7,2,0,3,1,3,4,1,0,2,1,5,3,1,0,22,5,17,8,3,5,3,10,1,-1,12,-3,2,5,-2,-4,5,-1,1,5,3,3,7,-2,0,3,3,1,1,0,0,2,1,0,0,0,0,1,2,1,1,0,45,22,23,18,12,6,17,-4,17,6,5,4,7,-2,6,4,3,4,10,-2,11,2,2,0,5,0,9,2,1,0,4,0,5,2,1,0,1,0,4,0,0,0,-1,0,-1,10,7,3,4,3,-16,-2,11,-1,2,4,-6,-3,4,-1,2,-1,-10,1,7,0,1,2,2,0,4,0,1,1,1,1,2,0,0,1,1,-1,2,0,14,7,7,15,5,10,4,10,-3,-2,0,4,6,3,0,-2,-1,1,-2,7,-3,0,1,3,7,5,-1,2,2,0,4,2,-1,0,0,0,3,3,0,2,2,0,3,3,0,10,5,5,12,-3,4,-3,-3,-5,7,-2,4,-2,-3,-2,5,-1,0,-1,0,-3,6,0,2,1,1,0,3,0,1,0,1,0,3,0,1,1,0,0,7,2,5,24,9,15,5,-5,5,5,4,-6,0,-4,4,5,2,-3,5,-1,1,0,2,-3,3,5,8,2,6,0,0,2,4,0,3,0,3,3,4,2,3,0,13,2,11,8,1,7,-4,6,-7,9,7,2,-4,-1,-3,6,5,-1,0,7,-4,3,2,3,0,2,0,6,0,0,0,0,0,1,0,0,0,2,0,5,0,0,19,6,13,1,-2,3,11,0,5,3,3,-5,2,1,3,1,0,-2,9,-1,2,2,3,-3,0,-1,0,2,0,0,0,-2,-1,1,0,0,0,1,1,1,0,0,-21,-21,0,9,1,8,-1,1,-9,-7,-4,1,-1,-2,-12,-2,-3,1,0,3,3,-5,-1,0,1,3,4,0,0,0,1,0,0,0,0,0,0,3,4,0,0,0,-7,-3,-4,7,2,5,-3,7,-9,-3,0,0,2,-1,-2,-1,0,-1,-5,8,-7,-2,0,1,-1,5,1,0,1,1,0,2,-2,0,1,1,-1,3,3,0,0,0,-41,-18,-23,-11,-6,-5,4,-8,-22,-9,-3,-6,-1,1,-15,-3,-1,-2,5,-9,-7,-6,-2,-4,-3,0,-3,-4,-1,0,-1,0,-2,-3,0,0,-2,0,-1,-1,-1,0,-47,-21,-26,-12,-9,-3,-16,-8,-11,-11,1,-3,-4,-2,-4,-8,-1,-2,-12,-6,-7,-3,2,-1,-2,1,-6,-2,-3,0,0,0,-4,-3,-2,0,-2,1,-2,1,-1,0,4,2,2,5,-1,6,-6,6,-4,4,3,0,-4,1,0,1,2,1,-2,5,-4,3,1,-1,1,2,0,2,0,0,0,0,-1,0,0,0,1,2,1,2,0,0
41,41058,Mairena del Alcor,16408,75,18,57,30,17,13,18,19,8,7,9,12,5,8,-6,3,2,6,13,11,14,4,7,6,5,8,9,3,4,1,2,5,6,2,1,1,3,3,3,1,3,0,94,42,52,32,18,14,16,10,22,29,18,0,14,3,5,17,6,-2,2,7,17,12,12,2,9,4,10,6,3,0,5,3,6,3,1,0,4,1,4,3,2,0,178,97,81,36,19,17,46,17,76,27,7,0,14,7,42,24,4,3,32,10,34,3,3,-3,5,8,9,10,4,0,3,4,4,6,2,0,2,4,5,4,2,0,297,158,139,33,19,14,86,30,100,51,23,-4,34,16,71,21,14,-3,52,14,29,30,9,-1,9,7,9,7,0,1,6,5,5,3,0,0,3,2,4,4,0,1,325,150,175,68,33,35,52,36,153,29,43,7,16,17,78,14,21,1,36,19,75,15,22,6,13,12,21,15,6,1,6,6,12,6,3,0,7,6,9,9,3,1,551,294,257,80,38,42,139,53,217,89,30,13,75,25,120,52,16,4,64,28,97,37,14,9,11,17,26,18,6,2,2,8,15,10,2,1,9,9,11,8,4,1,544,276,268,57,26,31,93,90,264,61,14,15,57,38,141,29,6,2,36,52,123,32,8,13,8,8,20,12,5,3,6,4,9,5,1,1,2,4,11,7,4,2,396,219,177,56,28,28,81,70,109,54,44,27,47,34,71,26,24,6,34,36,38,28,20,21,13,25,10,3,6,-2,10,11,3,1,4,-1,3,14,7,2,2,-1,406,185,221,51,25,26,52,56,183,92,4,15,23,17,89,53,0,4,29,39,94,39,4,11,10,11,19,9,2,-1,7,7,5,4,2,0,3,4,14,5,0,-1,431,214,217,43,18,25,93,63,186,74,-3,8,37,27,95,47,0,2,56,36,91,27,-3,6,12,14,8,6,4,-1,6,5,1,4,2,0,6,9,7,2,2,-1,335,176,159,-6,0,-6,62,54,140,44,10,21,42,35,64,25,7,5,20,19,76,19,3,16,7,7,-3,-16,-1,-1,6,5,-1,-10,0,0,1,2,-2,-6,-1,-1,277,150,127,39,11,28,47,50,129,44,11,-3,28,30,82,12,-4,1,19,20,47,32,15,-4,6,8,9,11,7,-2,5,3,6,-2,0,-1,1,5,3,13,7,-1,162,71,91,12,-2,14,28,60,29,28,12,3,1,31,18,12,6,6,27,29,11,16,6,-3,2,7,-5,5,2,1,0,3,-5,2,-3,1,2,4,0,3,5,0,-2,-2,0,-98,-54,-44,1,-20,49,-31,1,3,3,-10,29,-23,4,1,-2,-10,20,-8,-3,2,-14,-7,-28,-39,-6,-5,-9,-2,-19,-22,0,-2,-5,-5,-9,-17,-6,-3,179,79,100,17,8,9,49,8,51,41,15,8,24,0,23,27,8,-4,25,8,28,14,7,12,11,6,-3,-1,2,1,3,5,-3,-1,2,1,8,1,0,0,0,0,206,90,116,-21,-3,-18,45,29,96,1,11,11,22,10,43,-10,7,8,23,19,53,11,4,3,-14,2,-6,-8,3,2,-8,6,-2,-2,2,1,-6,-4,-4,-6,1,1,75,13,62,23,1,22,-1,17,22,22,11,3,-10,1,14,9,5,-5,9,16,8,13,6,8,8,3,5,1,5,-1,0,1,1,-1,1,-1,8,2,4,2,4,0,180,82,98,54,20,34,35,10,54,44,13,9,28,6,13,16,8,2,7,4,41,28,5,7,19,7,17,5,3,1,10,3,6,0,-1,1,9,4,11,5,4,0
41,41059,Mairena del Aljarafe,33005,833,446,387,11,3,8,171,57,386,91,66,43,79,44,222,48,37,11,92,13,164,43,29,32,1,3,3,1,1,0,1,0,1,0,1,0,0,3,2,1,0,0,335,207,128,29,14,15,114,-51,201,30,9,30,63,-31,116,39,5,10,51,-20,85,-9,4,20,9,5,7,6,0,2,5,2,3,3,0,1,4,3,4,3,0,1,251,160,91,17,23,-6,33,3,136,58,-16,28,14,25,76,30,-8,19,19,-22,60,28,-8,9,4,-5,8,8,0,2,3,4,11,6,-2,1,1,-9,-3,2,2,1,287,140,147,24,15,9,115,-35,129,40,-14,39,73,-12,47,23,-11,9,42,-23,82,17,-3,30,3,5,8,7,1,0,3,3,4,5,0,0,0,2,4,2,1,0,242,75,167,92,43,49,55,-22,111,35,-4,45,16,-15,12,41,-5,12,39,-7,99,-6,1,33,17,17,24,25,9,0,6,8,13,12,4,0,11,9,11,13,5,0,-27,-45,18,134,47,87,64,-41,-28,-13,-30,15,51,-31,-27,-24,-23,0,13,-10,-1,11,-7,15,26,28,37,23,13,6,10,11,15,4,6,1,16,17,22,19,7,5,-14,37,-51,148,76,72,40,-62,30,-20,-34,25,40,-23,38,-4,-14,2,0,-39,-8,-16,-20,23,25,35,38,35,13,3,19,17,18,15,5,3,6,18,20,20,8,0,65,-10,75,245,106,139,-19,-20,-41,31,14,82,-18,-14,-28,1,2,36,-1,-6,-13,30,12,46,48,48,69,66,11,3,21,22,27,32,4,1,27,26,42,34,7,2,544,288,256,192,85,107,142,44,224,58,22,34,70,21,117,44,9,17,72,23,107,14,13,17,37,38,68,44,2,1,16,13,35,19,0,1,21,25,33,25,2,0,379,153,226,33,-11,44,102,-49,249,45,-22,21,43,-24,91,39,-10,0,59,-25,158,6,-12,21,18,10,21,-5,-5,-7,4,2,-2,-8,-3,-4,14,8,23,3,-2,-3,345,135,210,47,8,39,13,17,226,19,7,33,35,0,72,4,-5,12,-22,17,154,15,12,21,12,15,21,-8,1,3,8,5,5,-6,-5,0,4,10,16,-2,6,3,367,115,252,119,41,78,91,13,172,98,-50,16,48,-11,33,52,-21,7,43,24,139,46,-29,9,32,32,19,21,7,7,19,10,-2,3,6,5,13,22,21,18,1,2,240,98,142,3,-4,7,57,-19,130,7,13,17,38,-14,35,12,3,2,19,-5,95,-5,10,15,-5,5,1,-10,9,0,-4,0,-4,-3,6,-1,-1,5,5,-7,3,1,267,111,156,-23,-19,-4,68,-34,131,54,16,12,20,-17,85,16,0,2,48,-17,46,38,16,10,4,-8,-18,-4,2,1,1,0,-16,-4,1,-1,3,-8,-2,0,1,2,393,206,187,-26,-21,-5,8,-6,245,107,-1,14,13,-10,118,78,0,-1,-5,4,127,29,-1,15,-3,1,-20,-8,2,0,-6,2,-18,-1,0,0,3,-1,-2,-7,2,0,292,128,164,-99,-79,-20,69,-5,143,53,13,16,56,3,44,19,0,6,13,-8,99,34,13,10,3,-20,-37,-41,-6,-1,4,-13,-29,-33,-8,0,-1,-7,-8,-8,2,-1,191,62,129,-112,-44,-68,62,-59,99,63,-8,17,27,-27,25,41,-4,1,35,-32,74,22,-4,16,-2,-5,-46,-45,-14,-2,10,-2,-14,-32,-6,-1,-12,-3,-32,-13,-8,-1,214,23,191,-44,-26,-18,45,-14,66,89,-32,41,-3,-5,2,37,-15,-1,48,-9,64,52,-17,42,-16,17,-6,-21,-13,-9,-8,8,-2,-15,-7,-4,-8,9,-4,-6,-6,-5
41,41060,Marchena,18132,50,33,17,33,17,16,14,0,9,1,4,19,5,3,13,1,3,6,9,-3,-4,0,1,13,10,6,9,5,2,0,4,3,6,2,1,0,6,3,3,3,1,0,86,46,40,33,18,15,18,23,15,5,13,8,12,14,11,1,5,1,6,9,4,4,8,7,5,11,10,6,0,0,1,7,8,2,0,0,4,4,2,4,0,0,78,46,32,23,16,7,32,14,9,19,5,-5,15,7,11,9,3,-2,17,7,-2,10,2,-3,3,10,5,4,1,0,3,7,3,2,1,0,0,3,2,2,0,0,130,57,73,45,13,32,30,17,25,40,14,3,17,7,10,16,5,3,13,10,15,24,9,0,9,12,15,6,3,0,3,1,4,4,1,0,6,11,11,2,2,0,141,87,54,61,31,30,21,28,25,26,17,21,9,11,25,22,10,7,12,17,0,4,7,14,11,17,21,5,7,0,7,6,10,4,4,0,4,11,11,1,3,0,312,156,156,125,62,63,80,37,78,35,54,26,39,17,41,17,32,8,41,20,37,18,22,18,27,24,36,20,15,2,12,11,16,13,7,2,15,13,20,7,8,0,249,129,120,112,56,56,56,32,59,44,45,17,23,15,31,31,17,13,33,17,28,13,28,4,24,27,30,12,16,3,11,9,18,6,9,3,13,18,12,6,7,0,143,86,57,137,70,67,24,36,33,20,15,12,14,19,22,13,8,8,10,17,11,7,7,4,24,39,36,23,9,5,16,19,19,9,3,3,8,20,17,14,6,2,93,43,50,83,39,44,29,16,35,13,2,-1,20,9,8,3,2,1,9,7,27,10,0,-2,19,18,23,18,4,1,11,8,6,12,2,0,8,10,17,6,2,1,12,7,5,38,11,27,10,8,-9,-16,12,3,4,0,1,-7,6,0,6,8,-10,-9,6,3,18,6,10,4,-1,1,6,-1,4,2,-1,1,12,7,6,2,0,0,-82,-58,-24,23,0,23,-12,-12,-36,-15,-3,3,-14,-7,-20,-7,-3,-3,2,-5,-16,-8,0,6,12,6,3,0,2,0,5,2,-2,-5,1,-1,7,4,5,5,1,1,-2,10,-12,23,12,11,-2,6,-17,7,3,2,8,10,-14,-1,5,2,-10,-4,-3,8,-2,0,-1,17,3,3,1,0,0,16,-2,-3,2,-1,-1,1,5,6,-1,1,-95,-53,-42,2,-4,6,-5,-24,-43,-10,-9,3,-5,-13,-12,-17,-4,3,0,-11,-31,7,-5,0,-2,7,-5,2,0,0,-3,4,-2,0,-2,-1,1,3,-3,2,2,1,-4,-3,-1,34,15,19,9,7,-10,-19,4,4,0,5,-1,-8,0,1,9,2,-9,-11,4,3,11,10,5,5,2,1,6,3,3,3,0,0,5,7,2,2,2,1,-45,-27,-18,4,-1,5,-10,-6,-27,-15,0,8,-2,-9,-7,-13,-3,6,-8,3,-20,-2,3,2,1,2,-5,1,2,2,1,-1,-3,1,0,0,0,3,-2,0,2,2,-71,-52,-19,-6,-7,1,5,-25,-35,-13,-4,2,-6,-11,-20,-6,-9,1,11,-14,-15,-7,5,1,1,2,-12,1,0,0,0,-2,-4,0,-1,0,1,4,-8,1,1,0,-187,-98,-89,-71,-42,-29,-22,-27,-56,-53,-20,-7,-12,-14,-29,-34,-11,2,-10,-13,-27,-19,-9,-9,-3,-7,-21,-24,-7,-10,-2,-6,-11,-15,-3,-6,-1,-1,-10,-9,-4,-4,-100,-60,-40,1,-3,4,-2,-21,-50,-21,-4,-1,2,-12,-26,-24,-1,1,-4,-9,-24,3,-3,-2,-1,3,-2,-4,2,3,-1,0,0,-3,-2,3,0,3,-2,-1,4,0
41,41065,Morón de la Frontera,28207,-223,-116,-107,26,13,13,-31,-80,-76,-21,-6,-10,-17,-39,-40,-14,-1,-5,-14,-41,-36,-7,-5,-5,5,4,10,3,3,0,2,2,6,1,1,0,3,2,4,2,2,0,-44,-22,-22,39,16,23,17,-57,-7,-15,13,4,9,-23,-7,-12,6,4,8,-34,0,-3,7,0,12,6,10,3,7,1,6,5,1,2,2,0,6,1,9,1,5,1,-102,-28,-74,31,18,13,-15,-19,-34,-26,7,-17,-1,3,-13,-17,5,-5,-14,-22,-21,-9,2,-12,8,8,10,2,2,1,4,7,4,3,0,0,4,1,6,-1,2,1,-8,16,-24,31,17,14,27,-23,-11,1,8,-8,22,-3,-12,6,5,-2,5,-20,1,-5,3,-6,8,7,10,1,5,-1,6,4,2,2,3,-1,2,3,8,-1,2,0,15,9,6,35,16,19,35,-12,2,14,-10,-10,15,-11,11,6,-2,-6,20,-1,-9,8,-8,-4,5,4,14,4,7,1,2,1,7,0,5,1,3,3,7,4,2,0,112,78,34,35,17,18,38,-26,25,39,25,15,35,-18,24,17,14,7,3,-8,1,22,11,8,0,9,16,5,4,1,0,4,9,2,2,0,0,5,7,3,2,1,-21,-18,-3,39,14,25,10,2,-21,-28,10,9,1,0,-22,-9,5,9,9,2,1,-19,5,0,11,7,9,3,4,5,4,1,4,1,2,2,7,6,5,2,2,3,45,22,23,49,26,23,39,-32,-1,-5,9,34,21,-17,0,-5,6,15,18,-15,-1,0,3,19,14,8,13,10,2,2,10,2,7,5,1,1,4,6,6,5,1,1,84,55,29,37,19,18,40,-14,28,25,7,-3,19,-11,25,21,-3,2,21,-3,3,4,10,-5,7,5,12,11,2,0,2,3,5,7,0,2,5,2,7,4,2,-2,-6,-2,-4,40,18,22,29,-23,0,-3,7,-21,15,-14,4,0,2,-10,14,-9,-4,-3,5,-11,6,7,8,10,6,0,3,1,5,7,2,0,3,6,3,3,4,0,-25,-14,-11,27,9,18,12,-3,-53,10,2,9,11,-6,-22,3,1,4,1,3,-31,7,1,5,6,5,5,3,4,3,2,1,3,0,2,1,4,4,2,3,2,2,-102,-31,-71,27,16,11,-33,4,-39,-14,-9,-11,-11,2,-18,4,0,-8,-22,2,-21,-18,-9,-3,7,8,3,5,1,2,4,3,0,5,2,1,3,5,3,0,-1,1,-36,-41,5,10,6,4,25,-28,-19,-24,0,7,3,-16,-14,-23,0,5,22,-12,-5,-1,0,2,12,1,-8,1,2,2,5,0,-2,0,0,3,7,1,-6,1,2,-1,-70,-21,-49,-3,-1,-2,-14,-21,-28,-6,1,-3,-7,-8,-16,-1,6,4,-7,-13,-12,-5,-5,-7,5,3,-5,-3,-3,-1,3,2,-1,-4,-2,0,2,1,-4,1,-1,-1,0,-19,19,28,14,14,-6,-8,-31,21,22,6,-21,-7,-11,8,10,4,15,-1,-20,13,12,2,9,7,2,4,3,2,3,4,0,3,2,1,6,3,2,1,1,1,-90,-25,-65,27,14,13,-25,-19,-43,-33,19,9,-10,-3,-11,-14,6,2,-15,-16,-32,-19,13,7,7,5,5,-2,7,3,4,2,5,-2,2,1,3,3,0,0,5,2,-124,-59,-65,9,6,3,-15,-38,-45,-14,-3,-15,-9,-27,-25,-5,7,-2,-6,-11,-20,-9,-10,-13,5,2,-4,-2,6,-1,6,-2,-1,-2,5,-2,-1,4,-3,0,1,1,-43,-44,1,41,17,24,6,-24,-15,-12,8,-4,-2,-11,-15,-18,0,4,8,-13,0,6,8,-8,5,10,10,6,8,1,1,7,2,1,6,0,4,3,8,5,2,1
41,41067,Olivares,7697,29,1,28,18,10,8,-1,11,0,18,0,1,-10,2,-5,12,0,1,9,9,5,6,0,0,6,3,6,3,0,0,2,2,3,3,0,0,4,1,3,0,0,0,117,51,66,18,8,10,31,19,36,21,4,2,16,3,17,10,2,1,15,16,19,11,2,1,5,7,2,2,2,0,2,3,1,1,1,0,3,4,1,1,1,0,195,112,83,24,15,9,42,26,81,25,17,0,32,16,45,13,7,-2,10,10,36,12,10,2,8,2,10,3,1,0,4,1,7,3,0,0,4,1,3,0,1,0,155,70,85,20,8,12,25,38,49,17,26,1,6,17,28,6,15,-2,19,21,21,11,11,3,5,5,6,3,0,1,3,1,2,1,0,1,2,4,4,2,0,0,79,52,27,23,13,10,-11,12,45,10,15,8,3,-5,37,2,10,4,-14,17,8,8,5,4,3,5,7,6,2,0,2,2,4,3,2,0,1,3,3,3,0,0,45,33,12,33,21,12,-2,8,20,19,-3,2,-1,11,13,10,-1,2,-1,-3,7,9,-2,0,3,14,9,8,0,-1,0,11,7,4,0,-1,3,3,2,4,0,0,120,53,67,31,15,16,26,2,66,11,8,9,11,-6,31,11,4,3,15,8,35,0,4,6,5,9,9,4,2,2,3,3,7,1,0,1,2,6,2,3,2,1,91,54,37,41,26,15,19,28,46,1,6,-4,9,14,36,-3,5,-4,10,14,10,4,1,0,2,9,19,9,2,0,1,4,16,4,1,0,1,5,3,5,1,0,177,77,100,24,12,12,32,37,72,32,3,6,5,18,36,20,0,3,27,19,36,12,3,3,3,6,11,6,0,-2,2,4,3,3,1,-1,1,2,8,3,-1,-1,55,18,37,18,7,11,19,-16,29,9,11,-3,3,-3,12,-4,6,-1,16,-13,17,13,5,-2,4,-2,13,3,-1,1,2,-1,3,4,-1,0,2,-1,10,-1,0,1,-41,-25,-16,11,2,9,-26,-1,-1,-13,1,0,-5,-2,0,-10,-2,-2,-21,1,-1,-3,3,2,8,4,6,-6,0,-1,4,1,2,-4,0,-1,4,3,4,-2,0,0,44,20,24,41,15,26,8,7,15,7,8,3,2,5,7,0,8,2,6,2,8,7,0,1,6,11,17,1,6,0,3,2,8,1,1,0,3,9,9,0,5,0,-64,-32,-32,21,13,8,-1,-17,-24,-23,-7,14,0,-7,-12,-15,-2,9,-1,-10,-12,-8,-5,5,4,5,6,5,0,2,2,3,3,3,1,1,2,2,3,2,-1,1,-10,3,-13,-25,-7,-18,4,-3,-14,-3,9,-2,2,-1,1,1,3,-3,2,-2,-15,-4,6,1,2,-3,-11,-10,-1,-1,3,-1,-1,-7,0,-1,-1,-2,-10,-3,-1,0,-107,-49,-58,-60,-39,-21,-26,-17,-28,-30,-6,1,-9,-5,-6,-26,-2,-2,-17,-12,-22,-4,-4,3,-6,-6,-17,-26,-3,-2,-3,-4,-9,-20,-3,0,-3,-2,-8,-6,0,-2,-93,-50,-43,14,5,9,-36,-14,-35,-14,-1,5,-18,-7,-20,-6,-5,3,-18,-7,-15,-8,4,2,1,8,0,2,1,0,3,2,0,0,-2,0,-2,6,0,2,3,0,21,8,13,2,-1,3,16,-3,27,-23,-1,-1,9,3,6,-11,0,0,7,-6,21,-12,-1,-1,7,2,-6,-5,-1,4,1,5,-5,-3,-1,2,6,-3,-1,-2,0,2,-38,-17,-21,-5,-2,-3,-17,-2,-35,9,5,7,-8,-5,-12,6,4,0,-9,3,-23,3,1,7,-5,6,-8,-3,3,1,-1,2,-3,-2,2,0,-4,4,-5,-1,1,1
41,41068,Osuna,17306,-91,-55,-36,24,10,14,-25,-33,-39,-7,0,12,-10,-19,-16,-9,-4,6,-15,-14,-23,2,4,6,5,1,10,5,2,0,5,0,2,2,1,0,0,1,8,3,1,0,-22,-8,-14,7,5,2,5,-12,-18,2,-1,4,2,-3,-8,4,-1,0,3,-9,-10,-2,0,4,3,2,1,1,0,0,3,1,0,1,0,0,0,1,1,0,0,0,-21,-18,-3,20,3,17,-5,-2,-18,-14,16,3,-6,-7,-10,-8,8,4,1,5,-8,-6,8,-1,6,9,2,2,0,1,1,3,-1,0,0,0,5,6,3,2,0,1,49,22,27,12,4,8,21,-15,13,7,2,21,14,-6,9,0,-2,6,7,-9,4,7,4,15,1,2,5,3,0,0,1,1,1,1,0,0,0,1,4,2,0,0,67,28,39,30,13,17,29,-6,17,4,4,17,13,-1,5,4,1,4,16,-5,12,0,3,13,4,9,8,2,6,1,3,2,2,2,3,1,1,7,6,0,3,0,9,2,7,39,16,23,7,-7,-19,15,4,7,1,-6,-5,9,5,1,6,-1,-14,6,-1,6,6,8,15,9,0,0,3,2,9,3,-1,0,3,6,6,6,1,0,115,41,74,42,14,28,53,10,7,34,15,-2,19,1,0,13,13,-3,34,9,7,21,2,1,9,7,7,13,3,3,3,2,2,4,2,1,6,5,5,9,1,2,12,23,-11,56,23,33,9,5,-22,-1,21,-3,2,10,-13,5,12,5,7,-5,-9,-6,9,-8,12,12,13,12,4,2,3,5,4,6,3,1,9,7,9,6,1,1,6,23,-17,40,16,24,0,-16,6,3,11,-2,1,-3,7,2,8,5,-1,-13,-1,1,3,-7,9,13,7,10,1,0,5,6,1,4,0,0,4,7,6,6,1,0,26,-2,28,15,2,13,12,0,2,-1,5,8,9,-1,-9,-7,4,2,3,1,11,6,1,6,3,6,2,1,0,3,2,4,-3,-2,-1,2,1,2,5,3,1,1,-29,-16,-13,10,5,5,8,-5,-13,-11,0,-11,5,-5,-4,-9,-6,0,3,0,-9,-2,6,-11,3,3,5,-5,3,1,2,-1,4,-2,1,1,1,4,1,-3,2,0,-7,-4,-3,18,9,9,-3,11,-20,-1,1,9,-5,4,-11,7,3,0,2,7,-9,-8,-2,9,1,5,5,4,3,0,-1,1,4,3,2,0,2,4,1,1,1,0,-127,-70,-57,-4,-1,-3,-34,-12,-61,-4,-10,-1,-8,-6,-39,-2,-9,-2,-26,-6,-22,-2,-1,1,-3,11,-6,-2,-4,0,0,5,-4,1,-3,0,-3,6,-2,-3,-1,0,-15,-14,-1,-14,-9,-5,27,-9,-18,-15,8,-6,3,-4,-2,-16,6,0,24,-5,-16,1,2,-6,6,3,-9,-7,-5,-3,0,2,-3,-3,-4,-1,6,1,-6,-4,-1,-2,-48,-1,-47,7,2,5,11,-7,-37,-1,-10,-4,15,-5,-16,3,6,-4,-4,-2,-21,-4,-16,0,2,6,-5,4,-1,1,0,3,-4,1,2,0,2,3,-1,3,-3,1,-48,7,-55,-9,-10,1,-5,-6,-39,0,5,3,4,5,-16,4,4,7,-9,-11,-23,-4,1,-4,-2,1,-9,0,0,-1,-3,0,-7,-1,0,0,1,1,-2,1,0,-1,-29,-23,-6,10,5,5,0,-8,-12,-6,2,-4,-4,2,-13,-5,-2,-4,4,-10,1,-1,4,0,0,3,5,2,-1,0,-1,5,1,0,1,-1,1,-2,4,2,-2,1,-113,-58,-55,7,2,5,-18,-22,-14,-32,-21,-2,-12,-6,-11,-13,-13,0,-6,-16,-3,-19,-8,-2,3,5,3,-2,-3,0,2,2,-1,0,-1,0,1,3,4,-2,-2,0
41,41069,"Palacios y Villafranca, Los",32452,10,7,3,11,4,7,-19,19,-9,-8,18,5,3,1,-5,-4,9,2,-22,18,-4,-4,9,3,0,3,2,1,3,2,0,1,1,0,2,0,0,2,1,1,1,2,46,41,5,10,7,3,-9,-5,14,15,12,19,-6,2,17,10,8,9,-3,-7,-3,5,4,10,1,1,4,2,1,1,0,1,3,1,1,1,1,0,1,1,0,0,-22,-10,-12,-13,-7,-6,-1,-29,12,0,7,-7,-8,-20,18,-5,5,0,7,-9,-6,5,2,-7,0,-8,-3,-1,-1,0,0,-4,-1,-1,-1,0,0,-4,-2,0,0,0,97,50,47,10,2,8,45,4,18,18,7,4,26,6,2,4,9,3,19,-2,16,14,-2,1,4,2,1,1,1,1,0,1,-1,1,1,0,4,1,2,0,0,1,58,36,22,47,23,24,30,2,24,7,8,-9,14,-2,25,-4,7,-2,16,4,-1,11,1,-7,13,11,10,8,4,0,8,6,3,3,3,0,5,5,7,5,1,0,250,109,141,64,31,33,63,57,55,46,19,11,34,15,23,24,9,4,29,42,32,22,10,7,17,13,18,8,6,2,8,6,12,4,1,0,9,7,6,4,5,2,236,123,113,70,29,41,58,31,83,39,5,11,25,17,44,27,3,5,33,14,39,12,2,6,17,10,27,9,4,3,11,4,8,4,0,2,6,6,19,5,4,1,249,118,131,70,36,34,74,53,53,26,19,19,45,29,18,9,10,6,29,24,35,17,9,13,14,37,16,3,2,-2,10,19,8,-1,1,-1,4,18,8,4,1,-1,105,53,52,64,28,36,4,7,58,1,15,20,4,-3,33,1,7,10,0,10,25,0,8,10,14,10,28,3,8,0,6,6,14,0,2,0,8,4,14,3,6,0,149,59,90,23,4,19,49,24,16,18,-5,42,28,14,7,6,-5,6,21,10,9,12,0,36,11,4,-2,10,-1,0,7,-2,-3,3,-1,0,4,6,1,7,0,0,3,-7,10,-10,-5,-5,-8,-18,-3,1,9,24,3,-10,6,-20,9,7,-11,-8,-9,21,0,17,0,-3,-8,0,2,-1,1,0,-4,-3,1,0,-1,-3,-4,3,1,-1,51,51,0,29,24,5,8,21,-6,12,1,14,3,18,6,15,-1,6,5,3,-12,-3,2,8,3,13,7,1,5,0,1,7,7,3,5,1,2,6,0,-2,0,-1,-29,-30,1,10,-4,14,-1,-13,-9,-23,5,13,0,-6,-8,-22,2,9,-1,-7,-1,-1,3,4,9,10,-2,-5,-5,2,4,4,-5,-6,-2,1,5,6,3,1,-3,1,-63,-33,-30,-20,-20,0,0,5,-56,-11,2,2,4,2,-29,-12,6,-1,-4,3,-27,1,-4,3,1,3,-14,-10,-2,1,0,1,-11,-8,-3,1,1,2,-3,-2,1,0,-116,-42,-74,-23,-6,-17,-21,-27,-43,-22,-1,2,-11,-9,-7,-11,-1,-3,-10,-18,-36,-11,0,5,-3,6,-12,-6,-4,-4,-2,5,-5,-1,-1,-2,-1,1,-7,-5,-3,-2,-81,-21,-60,-12,-11,-1,-42,-21,-25,-20,2,26,-14,-7,-11,-7,-1,16,-28,-14,-14,-13,3,10,-3,3,-11,-8,5,1,-2,1,-7,-6,2,1,-1,2,-4,-2,3,0,-184,-100,-84,-32,-23,-9,-70,-34,-52,-45,4,16,-33,-20,-20,-28,2,0,-37,-14,-32,-17,2,16,-2,-3,-15,-12,2,-2,-1,-2,-4,-14,0,-2,-1,-1,-11,2,2,0,-50,-43,-7,-7,-15,8,-17,-35,-30,-7,0,39,-19,-24,-16,-9,8,14,2,-11,-14,2,-8,25,-2,2,1,-8,-1,1,-4,0,-2,-6,-3,0,2,2,3,-2,2,1
41,41072,Pedrera,5011,-34,-14,-20,4,3,1,-4,-18,-6,-5,-1,-2,-5,-3,-4,-3,0,0,1,-15,-2,-2,-1,-2,0,1,1,0,2,0,0,1,1,0,1,0,0,0,0,0,1,0,-20,-20,0,4,3,1,3,-17,-8,0,1,1,1,-9,-10,-1,-1,0,2,-8,2,1,2,1,1,1,2,0,0,0,0,1,2,0,0,0,1,0,0,0,0,0,-13,-16,3,2,-1,3,6,-8,-19,4,4,1,-1,-9,-11,3,1,1,7,1,-8,1,3,0,0,3,-3,2,0,0,0,1,-3,1,0,0,0,2,0,1,0,0,15,13,2,6,3,3,4,-1,2,9,7,-5,4,1,2,5,4,-2,0,-2,0,4,3,-3,1,0,3,0,2,0,0,0,2,0,1,0,1,0,1,0,1,0,64,42,22,14,8,6,19,4,18,18,1,5,9,7,9,15,3,0,10,-3,9,3,-2,5,1,0,7,3,3,0,1,0,5,1,1,0,0,0,2,2,2,0,13,5,8,23,11,12,0,9,1,2,3,-2,-2,1,2,2,2,0,2,8,-1,0,1,-2,2,7,11,1,2,0,1,3,6,1,0,0,1,4,5,0,2,0,41,31,10,28,14,14,8,8,14,3,6,0,7,1,18,-2,3,2,1,7,-4,5,3,-2,7,5,13,2,1,0,2,3,7,1,1,0,5,2,6,1,0,0,54,35,19,60,30,30,35,10,4,1,5,-1,19,9,5,-1,3,-1,16,1,-1,2,2,0,25,18,9,6,2,0,10,14,3,3,0,0,15,4,6,3,2,0,47,23,24,52,20,32,6,22,-6,15,3,6,6,9,-5,8,3,2,0,13,-1,7,0,4,9,19,13,10,1,0,4,6,5,5,0,0,5,13,8,5,1,0,9,2,7,15,3,12,9,1,14,-9,-3,-3,1,4,6,-4,-2,-1,8,-3,8,-5,-1,-2,7,8,3,-3,0,0,1,2,3,-3,0,0,6,6,0,0,0,0,0,-1,1,29,17,12,5,9,-6,-4,-3,-3,0,6,-4,0,-2,-2,5,3,-2,-4,-1,-1,14,5,4,5,1,0,7,3,2,5,0,0,7,2,2,0,1,0,7,6,1,34,16,18,-3,7,-6,3,1,4,-4,6,1,1,-2,2,1,1,-7,2,3,2,6,12,6,7,0,0,1,6,3,3,0,0,5,6,3,4,0,0,8,-17,25,18,4,14,17,-10,8,-3,-2,-4,3,-6,-9,-4,0,-2,14,-4,17,1,-2,-2,7,1,4,5,0,-1,0,0,0,3,0,0,7,1,4,2,0,-1,-34,-10,-24,5,5,0,-1,-8,-13,0,-5,-8,2,-5,-3,1,-2,-4,-3,-3,-10,-1,-3,-4,3,3,-2,1,0,-1,3,2,-1,1,0,-1,0,1,-1,0,0,0,-9,-15,6,6,4,2,6,-6,-14,0,4,1,1,-9,-9,0,0,0,5,3,-5,0,4,1,2,3,0,-2,2,0,2,3,0,-2,0,0,0,0,0,0,2,0,-5,6,-11,20,10,10,0,2,-9,3,2,-7,3,5,-5,0,0,-3,-3,-3,-4,3,2,-4,6,7,3,4,0,-1,2,4,0,3,0,0,4,3,3,1,0,-1,35,9,26,27,14,13,17,8,2,1,4,0,7,4,-2,0,1,-1,10,4,4,1,3,1,9,10,6,0,0,0,5,5,3,0,0,0,4,5,3,0,0,0,-69,-21,-48,26,12,14,-9,-17,-30,-14,-1,1,1,-6,-9,-11,1,3,-10,-11,-21,-3,-2,-2,6,10,1,5,2,1,3,5,1,2,0,1,3,5,0,3,2,0
41,41075,Pilas,11221,40,32,8,23,15,8,3,12,10,15,0,2,4,9,10,11,-2,2,-1,3,0,4,2,0,2,8,3,10,0,0,1,5,3,6,0,0,1,3,0,4,0,0,28,13,15,14,7,7,8,2,3,11,7,-4,2,3,2,4,4,-3,6,-1,1,7,3,-1,0,5,4,4,1,0,0,4,2,1,0,0,0,1,2,3,1,0,92,50,42,24,14,10,30,27,22,3,9,2,17,18,7,3,5,0,13,9,15,0,4,2,4,8,7,2,2,0,2,5,3,2,1,0,2,3,4,0,1,0,43,23,20,34,18,16,3,15,1,7,18,0,-2,13,-1,2,10,1,5,2,2,5,8,-1,10,10,7,3,4,0,4,7,4,1,2,0,6,3,3,2,2,0,109,65,44,56,28,28,16,15,27,20,17,11,6,10,22,11,8,6,10,5,5,9,9,5,6,15,19,11,3,0,3,6,11,6,1,0,3,9,8,5,2,0,191,109,82,137,83,54,39,46,69,23,13,0,16,26,41,19,7,-1,23,20,28,4,6,1,27,44,40,24,0,0,15,25,26,16,0,0,12,19,14,8,0,0,263,139,124,168,88,80,60,41,100,39,20,-3,33,20,50,23,11,-1,27,21,50,16,9,-2,36,42,54,34,1,0,20,23,25,19,0,0,16,19,29,15,1,0,405,221,184,228,138,90,69,127,126,51,25,4,28,69,79,28,14,4,41,58,47,23,11,0,30,87,71,31,7,1,15,51,51,18,2,1,15,36,20,13,5,0,323,172,151,70,34,36,54,62,116,60,24,4,25,31,60,34,13,3,29,31,56,26,11,1,20,15,17,13,3,1,8,8,8,7,1,1,12,7,9,6,2,0,98,55,43,32,13,19,10,17,49,20,8,-6,0,13,26,10,7,-2,10,4,23,10,1,-4,6,9,11,4,2,0,2,3,7,0,1,0,4,6,4,4,1,0,86,42,44,35,19,16,18,1,21,35,8,3,16,0,7,10,7,3,2,1,14,25,1,0,1,6,12,12,3,0,3,2,6,5,2,0,-2,4,6,7,1,0,31,39,-8,47,27,20,5,17,14,-5,1,1,14,8,9,6,0,3,-9,9,5,-11,1,-2,9,16,9,6,7,0,6,8,4,4,5,0,3,8,5,2,2,0,163,72,91,80,45,35,15,39,61,22,26,-4,4,28,18,11,16,-5,11,11,43,11,10,1,6,24,28,15,6,0,4,14,13,10,3,0,2,10,15,5,3,0,-24,-24,0,35,16,19,-9,2,-13,-6,0,4,-3,-3,-5,-8,-4,2,-6,5,-8,2,4,2,8,8,5,8,4,1,5,3,1,5,1,1,3,5,4,3,3,0,51,52,-1,96,48,48,-16,9,40,3,-1,9,0,10,30,7,-1,2,-16,-1,10,-4,0,7,20,22,35,17,0,0,14,13,13,8,-1,0,6,9,22,9,1,0,-36,-21,-15,2,-6,8,8,1,-32,-25,-7,14,3,0,-20,-10,-3,6,5,1,-12,-15,-4,8,18,10,-9,-9,-10,-2,6,5,-9,-3,-4,-2,12,5,0,-6,-6,0,6,-6,12,41,22,19,-7,25,-4,0,-5,-3,-5,10,2,-9,-2,-2,-2,15,-6,9,-3,-1,8,17,11,9,-4,0,7,7,7,3,-2,0,1,10,4,6,-2,0,21,-6,27,74,29,45,12,-6,18,-3,-8,0,-2,2,10,-11,-9,0,14,-8,8,8,1,0,18,14,28,12,-1,-1,10,4,14,2,-1,-1,8,10,14,10,0,0
41,41077,"Puebla de Cazalla, La",10750,-51,-18,-33,9,5,4,-22,-24,-9,-14,14,4,-8,-14,-3,-4,8,3,-14,-10,-6,-10,6,1,1,0,3,0,4,1,0,0,2,0,2,1,1,0,1,0,2,0,-97,-62,-35,2,1,1,-3,-48,-27,-5,-8,-6,-5,-32,-19,-3,-2,-2,2,-16,-8,-2,-6,-4,0,1,0,0,1,0,0,0,0,0,1,0,0,1,0,0,0,0,2,6,-4,12,3,9,9,-15,9,-8,8,-4,8,-10,8,-2,5,-5,1,-5,1,-6,3,1,3,4,2,0,2,1,2,1,-1,0,1,0,1,3,3,0,1,1,52,15,37,5,2,3,40,6,-11,6,14,-1,21,0,-14,3,6,2,19,6,3,3,8,-3,2,2,-1,0,2,0,1,0,-1,1,1,0,1,2,0,-1,1,0,31,28,3,33,21,12,4,-22,19,15,5,2,2,-8,18,9,3,1,2,-14,1,6,2,1,6,4,13,5,4,0,2,2,9,5,3,0,4,2,4,0,1,0,179,94,85,42,27,15,57,23,63,17,6,12,23,16,32,16,0,6,34,7,31,1,6,6,7,15,14,2,1,3,4,11,8,2,0,2,3,4,6,0,1,1,33,25,8,30,17,13,11,-12,16,8,8,3,5,-1,12,2,5,2,6,-11,4,6,3,1,5,7,13,5,0,0,1,6,7,3,0,0,4,1,6,2,0,0,179,110,69,107,65,42,33,29,64,33,20,1,20,25,42,14,9,2,13,4,22,19,11,-1,18,33,34,13,7,1,10,23,19,8,4,0,8,10,15,5,3,1,41,27,14,49,30,19,6,-1,15,17,3,-4,4,3,3,12,3,1,2,-4,12,5,0,-5,12,7,14,11,5,0,9,5,6,6,4,1,3,2,8,5,1,-1,94,40,54,18,2,16,17,22,12,34,10,2,2,13,-2,20,6,4,15,9,14,14,4,-2,6,12,0,-2,2,0,2,3,-2,-1,-1,1,4,9,2,-1,3,-1,60,26,34,-16,-16,0,-1,3,3,-5,9,48,0,-3,11,-9,9,15,-1,6,-8,4,0,33,-4,1,-10,-2,-1,-1,-2,-4,-8,-1,-1,0,-2,5,-2,-1,0,-1,-4,2,-6,36,29,7,-14,-8,4,-4,8,12,-2,-1,2,1,1,1,-12,-7,2,-5,7,11,2,10,15,6,2,0,4,11,7,4,2,0,-2,-1,8,2,0,0,-92,-47,-45,-17,-10,-7,-27,-24,-27,-16,1,4,-11,-11,-12,-15,0,3,-16,-13,-15,-1,1,1,-2,-4,-4,-6,-1,0,0,-2,-3,-3,-2,0,-2,-2,-1,-3,1,0,-82,-42,-40,-41,-30,-11,-9,-10,-34,-9,-17,-3,-9,-5,-16,-6,-11,3,0,-5,-18,-3,-6,-6,-2,-9,-16,-9,-8,1,-3,-8,-11,-4,-6,1,1,-1,-5,-5,-2,0,-74,-22,-52,-31,-20,-11,-7,-27,-30,-7,-6,1,0,-10,-11,-2,-3,3,-7,-17,-19,-5,-3,-2,-4,-2,-15,-7,-2,-1,-1,-2,-12,-3,-2,0,-3,0,-3,-4,0,-1,-34,-10,-24,-2,2,-4,-11,-25,-2,1,-2,0,-12,-5,-4,7,-1,2,1,-20,2,-6,-1,-2,-1,-4,7,-2,-2,0,-1,1,4,-1,0,-1,0,-5,3,-1,-2,1,-75,-42,-33,-11,-7,-4,-15,-15,-43,-11,0,7,-11,-6,-19,-5,-1,-2,-4,-9,-24,-6,1,9,-2,-3,-4,-1,-1,0,-1,-1,-4,-1,0,0,-1,-2,0,0,-1,0,-54,-33,-21,-9,-12,3,-20,-10,-29,-5,-2,15,-10,-12,-15,1,-2,9,-10,2,-14,-6,0,6,-3,0,-7,-3,3,1,-4,0,-6,-3,0,1,1,0,-1,0,3,0
41,41079,"Puebla del Río, La",10660,-106,-67,-39,4,1,3,-30,-14,-37,-20,1,-2,-20,-12,-22,-10,0,-1,-10,-2,-15,-10,1,-1,0,1,0,1,2,0,0,0,0,0,1,0,0,1,0,1,1,0,-23,-12,-11,8,2,6,-3,-18,5,-12,7,-1,4,-10,-6,-7,5,0,-7,-8,11,-5,2,-1,2,0,3,0,3,0,0,0,1,0,1,0,2,0,2,0,2,0,74,57,17,28,15,13,33,10,22,5,7,-5,22,6,21,5,3,0,11,4,1,0,4,-5,13,4,3,5,1,1,7,2,1,3,1,1,6,2,2,2,0,0,132,71,61,14,6,8,44,14,33,22,17,1,16,8,23,6,14,2,28,6,10,16,3,-1,1,8,1,3,2,-1,1,3,2,0,1,-1,0,5,-1,3,1,0,255,143,112,87,40,47,47,48,94,45,7,5,33,27,45,27,2,4,14,21,49,18,5,1,12,27,27,18,1,1,8,12,10,9,0,0,4,15,17,9,1,1,175,90,85,70,38,32,30,34,81,15,7,4,0,21,57,9,3,0,30,13,24,6,4,4,11,17,25,10,4,3,6,7,15,5,4,1,5,10,10,5,0,2,215,97,118,80,30,50,36,13,94,34,24,8,13,14,33,20,10,3,23,-1,61,14,14,5,12,15,25,21,5,2,2,9,8,9,1,1,10,6,17,12,4,1,42,32,10,41,24,17,26,-20,20,8,9,4,18,-10,16,5,4,3,8,-10,4,3,5,1,20,4,13,3,1,0,9,4,8,3,0,0,11,0,5,0,1,0,103,47,56,16,13,3,25,15,23,26,9,3,6,4,7,21,10,1,19,11,16,5,-1,2,8,11,0,-1,-3,1,5,5,0,2,1,0,3,6,0,-3,-4,1,-6,-12,6,2,-1,3,0,-12,5,9,2,-10,-13,-1,-4,8,0,0,13,-11,9,1,2,-10,9,-2,-5,1,0,-1,5,-1,-5,0,0,0,4,-1,0,1,0,-1,-42,-6,-36,-2,-3,1,-16,6,-28,-21,6,7,1,-2,-2,-11,4,3,-17,8,-26,-10,2,4,1,11,-11,-2,2,-3,4,3,-3,-5,0,-2,-3,8,-8,3,2,-1,-47,-49,2,6,2,4,4,-9,-7,-26,-11,1,-1,-15,-7,-20,-2,-4,5,6,0,-6,-9,5,5,4,1,-4,0,0,4,1,0,-3,1,-1,1,3,1,-1,-1,1,-98,-41,-57,10,10,0,-21,-25,-3,-38,4,-9,-11,-8,1,-21,6,-7,-10,-17,-4,-17,-2,-2,1,3,3,-4,6,0,0,4,5,-2,3,0,1,-1,-2,-2,3,0,-71,-57,-14,-31,-25,-6,-18,9,-39,-28,-3,8,-6,0,-29,-14,-7,-1,-12,9,-10,-14,4,9,-5,-1,-6,-13,-5,-2,0,-2,-6,-8,-5,-4,-5,1,0,-5,0,2,-89,-52,-37,-7,-8,1,-19,-8,-38,-20,-5,0,-9,-11,-19,-11,-8,3,-10,3,-19,-9,3,-3,-2,3,-2,-2,-4,0,-1,-2,-3,0,-3,1,-1,5,1,-2,-1,-1,-108,-45,-63,-25,-19,-6,-13,-17,-67,-4,-7,-2,-4,-3,-35,5,-8,-1,-9,-14,-32,-9,1,-1,-2,2,-20,-3,-4,1,1,0,-13,-3,-4,0,-3,2,-7,0,0,1,-100,-51,-49,-19,-12,-7,-18,-8,-38,-33,1,-7,-9,-7,-16,-27,7,-2,-9,-1,-22,-6,-6,-5,-8,-1,-2,-8,1,-1,-5,-1,-2,-5,2,-1,-3,0,0,-3,-1,0,-21,-16,-5,35,13,22,-3,-8,-16,13,-14,3,-12,-5,-6,11,-4,-1,9,-3,-10,2,-10,4,10,5,10,4,3,2,0,2,6,1,3,1,10,3,4,3,0,1
41,41081,"Rinconada, La",27673,444,229,215,66,41,25,71,96,133,73,41,22,43,38,72,38,23,10,28,58,61,35,18,12,8,11,25,14,4,2,6,7,16,8,3,0,2,4,9,6,1,2,311,158,153,45,24,21,28,32,108,75,46,25,18,16,62,34,20,10,10,16,46,41,26,15,7,3,17,14,2,0,6,2,8,8,0,0,1,1,9,6,2,0,675,324,351,82,36,46,146,142,170,138,49,20,68,70,94,61,19,6,78,72,76,77,30,14,26,11,13,24,7,1,11,4,7,10,3,1,15,7,6,14,4,0,684,359,325,74,34,40,103,109,261,127,43,32,52,37,140,74,29,17,51,72,121,53,14,15,19,12,18,13,7,5,8,3,10,7,3,3,11,9,8,6,4,2,467,237,230,89,42,47,44,58,276,35,29,8,34,16,151,21,7,3,10,42,125,14,22,5,24,15,24,13,9,3,13,4,17,4,2,1,11,11,7,9,7,2,672,321,351,103,52,51,79,120,237,112,86,31,20,58,124,58,45,9,59,62,113,54,41,22,18,33,25,18,6,0,5,17,15,10,3,0,13,16,10,8,3,0,653,285,368,142,71,71,97,77,276,110,59,16,35,36,138,43,26,-2,62,41,138,67,33,18,33,26,54,14,12,1,16,14,32,6,3,-1,17,12,22,8,9,2,501,206,295,169,81,88,107,78,166,64,39,43,42,29,74,23,21,9,65,49,92,41,18,34,48,39,56,20,5,1,23,19,29,8,2,0,25,20,27,12,3,1,447,234,213,125,59,66,123,60,141,74,11,22,76,31,66,44,1,13,47,29,75,30,10,9,22,31,41,19,4,3,12,11,22,9,3,2,10,20,19,10,1,1,415,203,212,113,55,58,39,84,191,51,31,10,0,34,122,24,10,9,39,50,69,27,21,1,23,34,27,19,8,0,6,18,18,9,3,0,17,16,9,10,5,0,351,171,180,92,46,46,51,60,134,64,13,28,46,35,53,27,3,10,5,25,81,37,10,18,25,14,30,12,7,1,13,5,15,6,5,1,12,9,15,6,2,0,153,60,93,55,24,31,43,11,40,25,8,21,33,-1,15,1,0,7,10,12,25,24,8,14,3,30,10,7,4,1,2,12,4,4,1,1,1,18,6,3,3,0,55,28,27,16,6,10,31,4,0,-8,13,5,4,15,5,-8,4,3,27,-11,-5,0,9,2,4,10,1,1,-2,0,1,8,1,-2,-3,0,3,2,0,3,1,0,85,49,36,26,16,10,27,3,59,-25,3,7,30,-6,27,-4,-8,-2,-3,9,32,-21,11,9,7,10,7,1,0,-3,6,5,6,0,-1,-1,1,5,1,1,1,-2,32,-25,57,30,21,9,-11,-22,30,-14,-14,65,-7,-16,17,-24,-11,18,-4,-6,13,10,-3,47,6,6,8,7,3,0,4,4,7,3,3,0,2,2,1,4,0,0,-37,-38,1,20,1,19,8,-26,-6,-34,-19,43,-2,-7,-8,-24,1,7,10,-19,2,-10,-20,36,2,13,9,-9,5,-1,0,6,0,-8,3,-1,2,7,9,-1,2,0,-121,-85,-36,-101,-65,-36,-26,-33,-101,-22,2,59,-16,-14,-43,-32,-3,20,-10,-19,-58,10,5,39,-31,3,-27,-24,-17,-4,-20,1,-13,-18,-11,-3,-11,2,-14,-6,-6,-1,19,-32,51,57,19,38,22,-15,9,-52,6,51,16,-4,-10,-57,10,14,6,-11,19,5,-4,37,17,10,19,2,5,4,5,3,8,0,1,2,12,7,11,2,4,2
41,41085,Salteras,2986,145,65,80,11,3,8,35,23,39,36,10,2,17,6,23,14,6,1,18,17,16,22,4,1,5,0,2,4,0,0,1,0,2,0,0,0,4,0,0,4,0,0,138,69,69,13,6,7,29,26,41,30,10,2,15,10,23,14,6,2,14,16,18,16,4,0,4,2,1,6,0,0,2,0,1,3,0,0,2,2,0,3,0,0,174,84,90,12,3,9,32,24,52,43,5,10,17,8,25,23,2,4,15,16,27,20,3,6,2,4,2,3,1,0,1,1,0,1,0,0,1,3,2,2,1,0,96,53,43,7,2,5,20,9,28,16,11,3,13,2,20,7,7,1,7,7,8,9,4,2,0,1,3,0,1,1,0,1,0,0,1,0,0,0,3,0,0,1,390,190,200,22,11,11,84,50,122,83,26,21,39,24,66,40,14,6,45,26,56,43,12,15,-1,12,7,4,0,1,1,4,4,2,0,0,-2,8,3,2,0,1,212,97,115,31,13,18,38,21,73,46,19,13,16,11,31,20,10,6,22,10,42,26,9,7,6,6,11,7,2,-1,1,3,4,4,1,0,5,3,7,3,1,-1,229,96,133,48,17,31,34,36,61,48,24,18,9,16,26,28,12,3,25,20,35,20,12,15,9,8,15,10,5,1,2,4,3,6,2,0,7,4,12,4,3,1,134,63,71,66,37,29,10,22,35,47,12,8,3,7,13,27,8,5,7,15,22,20,4,3,16,16,11,19,4,0,10,8,4,12,2,1,6,8,7,7,2,-1,107,56,51,39,16,23,23,11,24,15,21,11,7,12,11,7,13,4,16,-1,13,8,8,7,10,12,11,5,1,0,2,5,6,3,0,0,8,7,5,2,1,0,140,46,94,1,-4,5,25,11,43,28,9,23,11,2,15,11,3,3,14,9,28,17,6,20,-2,1,3,1,-2,0,0,0,0,-2,-2,0,-2,1,3,3,0,0,113,45,68,18,8,10,31,2,28,36,4,7,8,1,14,17,0,1,23,1,14,19,4,6,5,2,6,3,2,0,2,0,4,1,1,0,3,2,2,2,1,0,56,20,36,17,9,8,-13,14,48,2,-2,4,-14,9,24,4,-3,-1,1,5,24,-2,1,5,2,8,3,4,0,0,1,3,1,4,0,0,1,5,2,0,0,0,50,25,25,3,3,0,14,5,9,3,6,13,10,4,5,0,0,6,4,1,4,3,6,7,1,1,3,-1,-1,0,2,1,2,-2,0,0,-1,0,1,1,-1,0,-7,-8,1,7,1,6,-2,1,-5,-10,4,3,0,-2,-13,5,-1,2,-2,3,8,-15,5,1,-1,1,3,2,1,1,-1,0,0,2,-1,1,0,1,3,0,2,0,48,17,31,13,7,6,0,9,6,16,7,8,2,7,0,3,1,3,-2,2,6,13,6,5,6,3,0,2,1,1,5,3,-2,1,0,0,1,0,2,1,1,1,-55,-24,-31,-57,-30,-27,-11,-6,-16,-18,-10,3,-6,1,-4,-15,-2,-1,-5,-7,-12,-3,-8,4,-3,-5,-17,-20,-11,-1,0,-1,-9,-13,-6,-1,-3,-4,-8,-7,-5,0,-12,-14,2,8,4,4,3,-1,-8,-4,-9,5,-2,2,-3,-6,-4,-1,5,-3,-5,2,-5,6,2,3,2,-1,1,1,1,1,3,0,-1,0,1,2,-1,-1,2,1,-28,-9,-19,5,3,2,-9,-10,-12,-3,-6,9,-5,3,-13,4,-6,7,-4,-13,1,-7,0,2,0,0,3,2,-3,3,0,1,0,1,-1,2,0,-1,3,1,-2,1
41,41086,San Juan de Aznalfarache,20563,-238,-139,-99,79,34,45,-39,-40,-73,-33,-33,-15,-18,-32,-44,-19,-14,-8,-21,-8,-29,-14,-19,-7,17,18,25,15,3,1,6,9,15,4,0,0,11,9,10,11,3,1,-45,-34,-11,122,57,65,3,23,-47,-6,-18,-2,0,7,-21,-4,-13,0,3,16,-26,-2,-5,-2,19,31,39,24,9,0,7,20,22,6,2,0,12,11,17,18,7,0,-91,-56,-35,132,66,66,-56,-3,-25,3,0,-10,-20,-19,-15,12,-2,-12,-36,16,-10,-9,2,2,30,32,39,22,9,0,16,13,23,13,1,0,14,19,16,9,8,0,-52,-26,-26,125,65,60,-20,-1,7,-8,-10,-15,-4,7,-11,2,-5,-11,-16,-8,18,-10,-5,-4,21,36,38,17,11,1,13,21,18,7,4,1,8,15,20,10,7,0,44,10,34,140,64,76,-4,18,99,-24,-16,-27,-8,6,50,-28,-7,-6,4,12,49,4,-9,-21,21,39,53,20,7,1,9,20,23,8,4,0,12,19,30,12,3,1,-163,-101,-62,142,62,80,-108,24,-15,-38,-15,-15,-56,13,-14,-30,-4,-5,-52,11,-1,-8,-11,-10,18,44,40,29,6,3,12,20,15,10,2,2,6,24,25,19,4,1,-60,-53,-7,180,78,102,-8,2,-37,13,-6,-11,-13,-2,-28,0,2,-8,5,4,-9,13,-8,-3,41,47,49,31,9,2,17,17,28,11,4,1,24,30,21,20,5,1,223,89,134,323,155,168,33,21,146,41,12,-28,15,4,73,13,7,-21,18,17,73,28,5,-7,56,79,112,56,18,0,27,34,65,21,7,0,29,45,47,35,11,0,466,227,239,358,175,183,38,120,168,89,58,-11,5,48,87,35,45,6,33,72,81,54,13,-17,62,85,124,58,26,1,36,42,58,22,15,2,26,43,66,36,11,-1,199,34,165,197,79,118,38,48,92,43,-6,-5,0,15,30,14,-20,4,38,33,62,29,14,-9,51,31,63,40,6,3,25,6,27,14,2,2,26,25,36,26,4,1,382,192,190,190,85,105,54,78,147,82,25,-12,21,32,96,35,9,-5,33,46,51,47,16,-7,30,54,65,31,8,2,24,14,31,13,2,1,6,40,34,18,6,1,284,121,163,188,89,99,22,40,89,47,36,52,-8,16,47,38,19,8,30,24,42,9,17,44,36,47,60,30,11,3,18,17,29,17,6,1,18,30,31,13,5,2,146,87,59,136,78,58,11,51,40,75,-25,-9,9,19,35,48,-22,-2,2,32,5,27,-3,-7,18,38,47,22,5,0,12,14,32,17,1,0,6,24,15,5,4,0,-80,-22,-58,61,32,29,-28,24,-33,-49,-12,14,-5,15,-33,-10,3,3,-23,9,0,-39,-15,11,20,13,18,0,5,3,11,8,7,0,4,1,9,5,11,0,1,2,-54,-37,-17,127,57,70,18,22,-34,-50,-3,0,9,17,-20,-24,-15,-1,9,5,-14,-26,12,1,35,44,24,7,13,3,19,24,12,-1,4,0,16,20,12,8,9,3,135,73,62,82,33,49,-6,56,17,35,30,3,6,24,15,12,18,1,-12,32,2,23,12,2,16,23,21,10,4,5,9,8,5,6,0,3,7,15,16,4,4,2,-67,-88,21,46,7,39,-14,28,-34,-21,-22,11,-31,-1,-2,-20,-25,1,17,29,-32,-1,3,10,27,10,7,5,0,-4,6,2,-1,2,-1,-2,21,8,8,3,1,-2,-203,-157,-46,50,13,37,-53,-40,-31,-78,-11,19,-38,-27,-34,-44,-14,7,-15,-13,3,-34,3,12,19,17,18,-6,-2,2,11,3,12,-12,-4,2,8,14,6,6,2,0
41,41087,Sanlúcar la Mayor,10796,103,43,60,35,15,20,53,-5,17,10,3,22,23,-4,6,6,2,9,30,-1,11,4,1,13,7,7,7,6,6,1,4,2,1,2,4,1,3,5,6,4,2,0,73,31,42,29,8,21,21,7,33,-4,3,8,13,6,13,-3,-2,2,8,1,20,-1,5,6,10,5,7,4,2,0,3,1,2,2,0,0,7,4,5,2,2,0,115,62,53,60,37,23,34,-18,50,30,4,17,20,-17,23,24,4,8,14,-1,27,6,0,9,15,10,14,14,4,2,9,5,9,9,3,1,6,5,5,5,1,1,176,74,102,61,23,38,78,5,67,16,-1,3,37,-13,36,12,-2,0,41,18,31,4,1,3,17,9,21,9,2,1,4,4,9,5,0,0,13,5,12,4,2,1,175,93,82,43,21,22,35,14,55,56,14,8,26,15,22,27,6,0,9,-1,33,29,8,8,8,0,18,14,2,1,5,0,10,5,1,0,3,0,8,9,1,1,159,82,77,102,58,44,51,17,47,35,10,-3,32,9,20,14,7,-1,19,8,27,21,3,-2,15,24,38,16,6,1,9,16,19,10,2,1,6,8,19,6,4,0,227,104,123,81,49,32,20,13,110,49,10,19,1,2,49,33,4,10,19,11,61,16,6,9,14,18,29,15,4,0,7,10,19,11,1,0,7,8,10,4,3,0,185,95,90,99,53,46,4,29,73,39,25,9,-1,15,43,25,12,2,5,14,30,14,13,7,22,22,30,13,11,-1,7,11,17,10,8,0,15,11,13,3,3,-1,160,88,72,67,31,36,20,25,77,5,24,11,9,26,28,4,16,5,11,-1,49,1,8,6,19,22,15,5,5,2,7,13,6,1,3,1,12,9,9,4,2,1,210,114,96,19,4,15,39,16,69,46,7,28,30,3,37,36,1,7,9,13,32,10,6,21,13,4,3,4,-5,-2,4,0,3,3,-5,-1,9,4,0,1,0,-1,64,24,40,-12,-19,7,-30,-19,9,12,17,75,-1,-17,-5,14,7,21,-29,-2,14,-2,10,54,-8,-1,-5,4,-5,1,-4,-3,-9,-3,-1,0,-4,2,4,7,-4,1,119,21,98,22,5,17,6,17,44,-10,8,52,-3,4,15,-7,3,10,9,13,29,-3,5,42,6,8,7,-2,0,1,1,2,2,-2,0,1,5,6,5,0,0,0,201,92,109,3,6,-3,43,4,64,30,18,34,16,-1,30,14,15,14,27,5,34,16,3,20,9,5,0,-1,-6,-4,11,3,0,-2,-3,-3,-2,2,0,1,-3,-1,-49,-52,3,18,13,5,-22,-10,-18,-12,3,12,-13,-8,-17,-11,-3,-1,-9,-2,-1,-1,6,13,5,-5,2,8,3,3,7,-3,3,4,0,1,-2,-2,-1,4,3,2,-45,-36,-9,-24,-27,3,-19,7,-34,-5,-14,13,-28,11,-15,0,-11,4,9,-4,-19,-5,-3,9,-8,8,-13,-8,-6,0,-7,4,-17,-2,-7,1,-1,4,4,-6,1,-1,45,31,14,-23,-5,-18,10,4,25,-29,5,32,19,-5,21,-21,3,14,-9,9,4,-8,2,18,4,3,-11,-7,-9,-2,3,-2,-2,0,-3,-1,1,5,-9,-7,-6,-1,39,5,34,29,11,18,17,-7,-16,13,25,6,4,-2,-19,7,18,-3,13,-5,3,6,7,9,13,3,4,-1,6,3,9,1,-4,2,1,1,4,2,8,-3,5,2,109,49,60,49,32,17,15,-4,39,20,19,21,11,-8,26,4,10,7,4,4,13,16,9,14,14,9,24,-4,4,2,12,5,13,4,-1,0,2,4,11,-8,5,2
41,41089,Santiponce,6905,60,29,31,11,7,4,19,1,21,12,2,0,7,-5,18,4,3,-2,12,6,3,8,-1,2,0,0,7,1,2,0,0,0,4,1,1,0,0,0,3,0,1,0,70,20,50,12,7,5,22,14,5,18,11,0,13,6,-6,4,5,-1,9,8,11,14,6,1,6,1,2,2,0,0,6,0,0,1,0,0,0,1,2,1,0,0,42,25,17,17,7,10,-4,12,21,-3,10,1,-1,12,10,0,5,-3,-3,0,11,-3,5,4,3,2,7,1,4,0,1,1,4,-1,2,0,2,1,3,2,2,0,108,68,40,17,9,8,12,13,50,13,10,8,10,13,31,4,5,3,2,0,19,9,5,5,3,5,2,4,3,0,1,4,1,2,1,0,2,1,1,2,2,0,58,30,28,35,18,17,1,10,47,6,-8,2,-3,6,26,5,-5,2,4,4,21,1,-3,0,5,13,12,1,1,1,2,7,9,-1,0,1,3,6,3,2,1,0,147,72,75,38,17,21,32,5,64,24,10,9,17,4,29,14,5,3,15,1,35,10,5,6,13,5,13,4,3,0,9,2,3,2,1,0,4,3,10,2,2,0,55,33,22,40,28,12,8,22,5,2,10,1,13,9,4,-3,9,-2,-5,13,1,5,1,3,10,11,8,9,1,0,8,7,6,6,1,0,2,4,2,3,0,0,104,49,55,26,15,11,34,-4,36,32,4,-2,15,-4,19,15,5,-3,19,0,17,17,-1,1,3,6,5,8,3,0,2,3,5,4,1,0,1,3,0,4,2,0,146,78,68,53,31,22,33,10,64,40,8,-6,15,3,44,15,0,2,18,7,20,25,8,-8,19,8,15,10,2,-1,15,3,8,5,0,0,4,5,7,5,2,-1,65,26,39,24,9,15,-1,7,43,7,0,4,7,1,16,0,-2,0,-8,6,27,7,2,4,3,4,12,3,1,1,2,-1,7,1,0,0,1,5,5,2,1,1,120,53,67,26,12,14,9,7,65,22,4,4,11,-2,34,5,2,0,-2,9,31,17,2,4,4,1,12,4,3,2,2,0,6,3,0,1,2,1,6,1,3,1,8,-15,23,11,4,7,16,-4,-3,11,-8,-5,7,-6,-10,0,-7,0,9,2,7,11,-1,-5,2,0,5,2,2,0,1,0,2,1,0,0,1,0,3,1,2,0,-39,-23,-16,17,5,12,-5,-2,-9,-10,-11,0,-2,-2,-8,-3,-5,-2,-3,0,-1,-7,-6,2,2,2,10,2,1,0,1,1,3,0,0,0,1,1,7,2,1,0,-2,6,-8,8,4,4,-3,1,14,-6,-12,3,0,1,13,-5,-5,2,-3,0,1,-1,-7,1,0,5,2,-1,1,0,0,2,2,-1,1,-1,0,3,0,0,0,1,46,14,32,-6,-6,0,12,13,1,13,2,5,5,5,1,3,-2,1,7,8,0,10,4,4,-1,5,0,-6,-3,-1,2,0,-2,-3,-2,-1,-3,5,2,-3,-1,0,-37,-11,-26,-27,-9,-18,0,-29,13,-13,-7,3,4,-10,5,-1,-7,2,-4,-19,8,-12,0,1,-1,-11,-4,-7,-3,-1,3,-3,-4,-3,-2,0,-4,-8,0,-4,-1,-1,-2,-25,23,14,3,11,8,-7,10,-25,-2,14,-4,2,-5,-18,0,0,12,-9,15,-7,-2,14,6,-1,1,6,1,1,3,0,0,1,-1,0,3,-1,1,5,2,1,-17,-5,-12,11,5,6,-8,1,-18,-2,-11,17,-3,1,-2,0,-9,4,-5,0,-16,-2,-2,13,2,6,2,2,0,-1,2,2,0,1,0,0,0,4,2,1,0,-1
41,41091,Sevilla,701927,-3308,-1920,-1388,2585,1324,1261,-564,-562,-1201,-281,-348,-251,-295,-292,-762,-227,-202,-87,-269,-270,-439,-54,-146,-164,346,635,897,459,167,60,173,323,475,232,76,30,173,312,422,227,91,30,-974,-805,-169,3145,1514,1631,-168,144,-535,-161,-150,-72,-128,38,-388,-193,-106,-13,-40,106,-147,32,-44,-59,502,747,1145,522,155,54,262,346,573,224,69,26,240,401,572,298,86,28,-2494,-1583,-911,3380,1561,1819,-414,22,-1020,-326,-354,-257,-224,-77,-650,-259,-231,-58,-190,99,-370,-67,-123,-199,651,790,1032,662,171,55,338,335,488,306,64,24,313,455,544,356,107,31,-3930,-2166,-1764,3472,1660,1812,-461,-31,-1785,-557,-434,-462,-304,-26,-994,-354,-248,-144,-157,-5,-791,-203,-186,-318,673,870,1050,579,200,70,346,392,549,250,84,28,327,478,501,329,116,42,-2729,-1878,-851,4471,2068,2403,-522,361,-1183,-438,-371,-403,-366,140,-759,-375,-294,-157,-156,221,-424,-63,-77,-246,567,1188,1565,779,273,60,279,559,758,317,110,24,288,629,807,462,163,36,-1888,-1391,-497,5021,2332,2689,-440,634,-1051,-194,-312,-420,-244,237,-762,-236,-233,-108,-196,397,-289,42,-79,-312,625,1323,1730,961,271,71,315,599,833,419,105,38,310,724,897,542,166,33,-1911,-1160,-751,5173,2444,2729,-283,907,-1007,-401,-470,-516,-200,365,-505,-308,-268,-158,-83,542,-502,-93,-202,-358,820,1470,1706,829,245,56,392,675,849,381,101,25,428,795,857,448,144,31,-160,-247,87,6333,3057,3276,-353,1294,-125,-87,-213,-507,-154,551,-122,-112,-156,-149,-199,743,-3,25,-57,-358,881,1799,2201,1107,274,46,486,808,1107,502,117,24,395,991,1094,605,157,22,-418,-194,-224,4154,2064,2090,-162,813,-166,-123,-293,-360,-84,471,-121,-154,-149,-100,-78,342,-45,31,-144,-260,606,1180,1496,698,119,22,335,630,753,274,44,11,271,550,743,424,75,11,-1537,-1161,-376,2319,893,1426,-455,636,-519,-362,-246,-421,-174,153,-392,-390,-110,-137,-281,483,-127,28,-136,-284,361,816,808,290,27,-14,221,311,318,27,2,-2,140,505,490,263,25,-12,-2673,-1513,-1160,828,107,721,-535,322,-845,-449,-454,-544,-276,86,-509,-270,-269,-195,-259,236,-336,-179,-185,-349,209,490,214,-73,-27,-20,103,140,-8,-96,-35,-15,106,350,222,23,8,-5,-720,-598,-122,1908,681,1227,-74,738,-429,-346,-120,-378,-63,200,-251,-219,-107,-108,-11,538,-178,-127,-13,-270,312,795,545,140,64,31,157,254,225,11,14,6,155,541,320,129,50,25,-1645,-1014,-631,777,168,609,36,410,-896,-522,-239,-352,70,78,-530,-279,-152,-154,-34,332,-366,-243,-87,-198,230,527,81,-88,-16,8,112,163,6,-112,-22,2,118,364,75,24,6,6,-1899,-1115,-784,-128,-135,7,-232,289,-1006,-499,-126,-183,-95,59,-593,-274,-83,-53,-137,230,-413,-225,-43,-130,82,303,-270,-210,-38,-14,84,126,-181,-144,-23,-7,-2,177,-89,-66,-15,-7,-2634,-1518,-1116,-186,-258,72,-115,180,-1365,-710,-165,-372,-7,16,-851,-489,-56,-107,-108,164,-514,-221,-109,-265,171,244,-341,-249,-69,21,83,77,-263,-160,-26,11,88,167,-78,-89,-43,10,-881,-666,-215,234,-79,313,-7,235,-322,-269,-46,-398,-39,52,-265,-224,-45,-82,32,183,-57,-45,-1,-316,106,285,-95,-135,20,10,52,93,-134,-127,-1,13,54,192,39,-8,21,-3,156,-255,411,1498,589,909,320,594,-174,-105,21,-439,181,176,-210,-197,-44,-145,139,418,36,92,65,-294,332,547,319,83,120,45,187,223,138,-33,33,10,145,324,181,116,87,35,922,369,553,2857,1264,1593,377,737,348,125,-114,-477,165,337,75,80,-88,-143,212,400,273,45,-26,-334,516,843,854,358,156,79,243,393,372,136,59,37,273,450,482,222,97,42
41,41093,Tomares,17414,212,95,117,76,43,33,12,1,149,-3,30,12,15,7,67,-8,14,0,-3,-6,82,5,16,12,20,14,20,10,12,0,13,7,10,5,8,0,7,7,10,5,4,0,133,69,64,42,21,21,27,11,58,8,13,13,24,9,24,5,4,1,3,2,34,3,9,12,14,7,10,3,6,0,7,3,4,2,4,0,7,4,6,1,2,0,170,113,57,43,23,20,58,-47,137,-15,0,27,43,-25,75,11,-7,8,15,-22,62,-26,7,19,14,2,13,10,4,-1,7,0,7,8,2,-1,7,2,6,2,2,0,206,113,93,29,17,12,61,-38,99,49,0,23,39,-14,45,34,-3,5,22,-24,54,15,3,18,5,4,7,8,4,0,2,4,3,5,2,0,3,0,4,3,2,0,442,206,236,81,30,51,83,7,199,82,15,39,34,0,97,43,7,12,49,7,102,39,8,27,12,18,30,11,7,2,7,6,7,8,0,1,5,12,23,3,7,1,370,154,216,82,28,54,64,27,208,56,-1,13,34,-6,102,30,-11,-2,30,33,106,26,10,15,12,18,29,11,8,3,8,4,9,4,3,0,4,14,20,7,5,3,457,227,230,50,16,34,123,21,154,118,-12,28,63,6,74,62,0,6,60,15,80,56,-12,22,-2,22,17,5,4,3,-2,10,5,1,2,-1,0,12,12,4,2,4,613,262,351,163,68,95,118,60,252,129,17,21,42,30,108,52,10,12,76,30,144,77,7,9,23,35,54,34,11,5,8,14,21,18,4,3,15,21,33,16,7,2,512,238,274,127,48,79,158,24,148,128,22,14,96,12,69,47,4,3,62,12,79,81,18,11,26,23,29,39,9,0,12,7,11,14,4,-1,14,16,18,25,5,1,369,191,178,35,12,23,65,17,120,92,15,36,34,3,81,36,9,18,31,14,39,56,6,18,5,9,17,-1,4,0,-1,0,11,-2,4,0,6,9,6,1,0,0,235,93,142,68,25,43,69,0,100,44,-9,15,38,-2,37,18,-8,1,31,2,63,26,-1,14,11,26,19,6,4,-1,4,11,7,2,0,0,7,15,12,4,4,-1,113,35,78,38,5,33,54,-15,29,49,-31,10,26,-6,10,16,-27,7,28,-9,19,33,-4,3,2,14,11,8,0,2,2,2,0,3,-3,1,0,12,11,5,3,1,291,131,160,58,18,40,106,-34,138,62,0,8,46,-6,51,37,3,-3,60,-28,87,25,-3,11,15,1,22,7,7,5,7,1,3,2,3,1,8,0,19,5,4,4,118,30,88,19,4,15,31,-18,66,14,6,3,9,-10,13,4,7,0,22,-8,53,10,-1,3,19,6,-7,-4,5,-2,7,1,-5,-1,3,-2,12,5,-2,-3,2,0,129,74,55,40,11,29,80,-29,11,29,-14,21,49,-21,-10,33,-3,12,31,-8,21,-4,-11,9,20,0,5,11,1,-1,8,-1,-1,5,-3,0,12,1,6,6,4,-1,-147,-67,-80,-88,-51,-37,21,-39,-48,3,-78,-19,6,-15,-29,8,-44,-10,15,-24,-19,-5,-34,-9,-4,-7,-34,-29,-14,-1,-1,-7,-19,-17,-7,-1,-3,0,-15,-12,-7,0,103,20,83,34,9,25,79,-23,5,67,-37,1,29,-12,-3,26,-18,-7,50,-11,8,41,-19,8,12,9,1,2,0,7,8,1,-3,-1,-1,2,4,8,4,3,1,5,89,34,55,62,31,31,87,-18,10,36,-37,-5,58,-14,-8,15,-10,-14,29,-4,18,21,-27,9,25,9,8,11,5,0,14,3,6,3,5,-1,11,6,2,8,0,1
41,41094,Umbrete,4830,41,16,25,10,4,6,3,6,19,6,2,4,2,-3,9,4,2,1,1,9,10,2,0,3,5,2,3,0,0,0,3,0,1,0,0,0,2,2,2,0,0,0,78,34,44,6,2,4,6,16,44,5,6,1,0,6,23,2,2,1,6,10,21,3,4,0,1,1,4,0,0,0,0,0,2,0,0,0,1,1,2,0,0,0,68,28,40,1,1,0,11,10,30,2,7,8,2,3,18,-3,4,4,9,7,12,5,3,4,1,0,0,0,0,0,1,-1,1,0,0,0,0,1,-1,0,0,0,169,100,69,22,12,10,26,21,85,25,5,4,17,19,44,12,5,0,9,2,41,13,0,4,8,2,9,2,0,1,5,1,5,1,0,0,3,1,4,1,0,1,371,189,182,15,6,9,80,44,175,48,19,4,48,16,88,25,11,2,32,28,87,23,8,2,4,2,6,2,0,1,2,1,3,0,0,0,2,1,3,2,0,1,511,233,278,24,13,11,70,83,242,67,29,12,27,29,118,36,16,5,43,54,124,31,13,7,0,7,7,7,1,2,0,3,2,6,1,1,0,4,5,1,0,1,296,159,137,10,8,2,46,40,143,39,22,3,29,22,79,15,15,0,17,18,64,24,7,3,0,3,3,3,1,0,0,3,1,3,1,0,0,0,2,0,0,0,450,224,226,34,17,17,62,65,220,62,34,-2,25,30,113,33,19,-1,37,35,107,29,15,-1,6,6,9,7,5,0,2,4,3,5,2,0,4,2,6,2,3,0,238,114,124,20,7,13,32,43,99,44,11,5,15,15,53,25,3,2,17,28,46,19,8,3,6,7,2,3,2,0,2,2,1,1,1,0,4,5,1,2,1,0,222,109,113,35,13,22,35,34,99,21,15,11,20,14,43,12,11,6,15,20,56,9,4,5,6,7,11,5,5,1,2,3,3,3,2,0,4,4,8,2,3,1,54,26,28,17,10,7,9,-4,14,13,8,8,0,-4,6,14,5,1,9,0,8,-1,3,7,3,5,7,1,0,0,2,1,6,-1,1,0,1,4,1,2,-1,0,146,62,84,35,19,16,24,26,62,16,8,6,12,0,34,4,5,1,12,26,28,12,3,5,8,5,11,9,0,1,5,-2,7,7,0,1,3,7,4,2,0,0,1,-5,6,-7,-5,-2,-12,0,6,-10,6,8,-8,9,-1,-7,-1,3,-4,-9,7,-3,7,5,0,-3,-3,-2,0,1,0,-2,-2,-3,2,0,0,-1,-1,1,-2,1,22,24,-2,2,-1,3,5,2,7,9,5,-5,15,3,3,3,4,-4,-10,-1,4,6,1,-1,0,5,-5,0,2,1,1,3,-6,1,1,0,-1,2,1,-1,1,1,-58,-38,-20,-1,0,-1,-17,4,-15,-18,-5,-3,-6,3,-19,-10,-5,1,-11,1,4,-8,0,-4,-4,-2,-1,2,5,-1,-3,-1,-1,1,4,0,-1,-1,0,1,1,-1,11,-7,18,6,0,6,-2,-8,5,-19,15,16,4,-8,-3,-16,9,8,-6,0,8,-3,6,8,4,-1,-1,-1,0,2,0,0,-2,0,0,0,4,-1,1,-1,0,2,46,10,36,38,13,25,-4,2,5,24,2,7,-3,0,-10,13,2,3,-1,2,15,11,0,4,6,2,3,20,3,3,0,3,1,7,0,2,6,-1,2,13,3,1,15,7,8,10,7,3,4,3,4,-1,2,1,1,3,6,-8,1,1,3,0,-2,7,1,0,4,2,0,2,2,1,5,2,-3,0,3,0,-1,0,3,2,-1,1
41,41095,Utrera,46052,-192,-98,-94,62,39,23,26,-94,-89,-5,-17,-25,-1,-34,-51,-4,-11,-5,27,-60,-38,-1,-6,-20,17,13,15,10,5,0,9,9,11,7,2,0,8,4,4,3,3,0,-71,-44,-27,42,30,12,22,-58,-4,-12,1,-26,2,-34,-5,-4,6,-12,20,-24,1,-8,-5,-14,10,9,11,5,1,4,7,6,9,4,1,2,3,3,2,1,0,2,136,81,55,55,35,20,51,-19,-5,33,31,31,40,-16,23,14,12,0,11,-3,-28,19,19,31,16,13,11,11,6,-2,13,4,8,6,4,0,3,9,3,5,2,-2,337,234,103,68,37,31,100,14,68,101,37,8,52,8,52,75,35,6,48,6,16,26,2,2,20,20,11,17,0,-1,8,11,6,11,0,0,12,9,5,6,0,-1,358,253,105,93,58,35,69,-10,145,56,54,41,60,20,93,37,28,13,9,-30,52,19,26,28,25,16,23,21,6,2,17,11,14,13,3,1,8,5,9,8,3,1,620,382,238,107,55,52,124,54,201,96,58,75,71,34,131,70,47,23,53,20,70,26,11,52,19,23,28,18,8,10,8,11,18,8,5,4,11,12,10,10,3,6,706,400,306,174,99,75,178,69,229,127,51,35,90,34,153,76,25,13,88,35,76,51,26,22,40,29,46,40,8,9,16,16,31,25,4,5,24,13,15,15,4,4,634,415,219,220,147,73,129,88,213,111,52,22,76,59,137,85,42,7,53,29,76,26,10,15,34,53,65,47,14,4,22,35,41,35,12,2,12,18,24,12,2,2,278,196,82,132,64,68,73,13,101,69,21,-7,54,13,68,41,15,0,19,0,33,28,6,-7,31,30,40,27,0,3,13,17,19,12,1,2,18,13,21,15,-1,1,328,187,141,142,77,65,88,21,125,83,8,-11,43,0,68,56,6,4,45,21,57,27,2,-15,28,23,43,32,11,2,16,9,20,21,5,3,12,14,23,11,6,-1,240,146,94,66,23,43,40,17,115,40,30,1,13,15,72,24,18,2,27,2,43,16,12,-1,19,14,16,9,3,5,9,5,5,3,0,1,10,9,11,6,3,4,219,104,115,90,44,46,54,16,89,46,-3,5,40,8,45,12,-3,-1,14,8,44,34,0,6,22,25,26,14,3,0,20,11,6,6,1,0,2,14,20,8,2,0,112,90,22,38,7,31,16,38,25,0,28,7,7,12,34,11,14,10,9,26,-9,-11,14,-3,21,4,9,-5,6,1,5,1,0,0,1,-1,16,3,9,-5,5,2,143,49,94,41,17,24,12,6,101,-12,28,2,5,0,33,-5,6,8,7,6,68,-7,22,-6,11,4,10,11,1,2,8,3,1,4,0,1,3,1,9,7,1,1,-46,-25,-21,-152,-101,-51,44,-40,-76,11,-6,-4,21,-10,-40,0,-1,-7,23,-30,-36,11,-5,3,-9,-21,-61,-56,-5,-1,-8,-9,-37,-41,-6,-1,-1,-12,-24,-15,1,0,45,24,21,19,13,6,2,-5,-3,18,16,19,12,-22,-5,27,2,6,-10,17,2,-9,14,13,-2,6,7,2,5,2,-2,-1,5,3,7,1,0,7,2,-1,-2,1,-115,-107,-8,-164,-108,-56,24,-20,-36,-61,-37,2,2,-15,-14,-54,-24,-2,22,-5,-22,-7,-13,4,-6,2,-41,-61,-43,-18,-3,-1,-17,-46,-28,-13,-3,3,-24,-15,-15,-5,57,-11,68,77,30,47,47,-57,-8,5,32,26,27,-31,-24,-16,15,11,20,-26,16,21,17,15,17,10,19,12,14,4,10,2,10,2,5,0,7,8,9,10,9,4
41,41096,Valencina de la Concepción,6410,65,45,20,13,4,9,1,-1,53,2,1,7,2,1,31,4,3,0,-1,-2,22,-2,-2,7,4,2,5,2,0,0,1,1,1,1,0,0,3,1,4,1,0,0,102,43,59,16,7,9,24,10,21,34,9,1,0,9,7,19,9,-3,24,1,14,15,0,4,4,3,4,4,1,0,3,1,0,2,1,0,1,2,4,2,0,0,153,97,56,16,7,9,29,10,35,64,6,5,17,6,19,47,3,4,12,4,16,17,3,1,4,3,6,3,0,0,1,2,2,2,0,0,3,1,4,1,0,0,69,38,31,15,3,12,10,2,32,14,8,3,16,0,11,5,5,-1,-6,2,21,9,3,4,1,5,3,1,4,1,0,0,1,1,1,0,1,5,2,0,3,1,65,34,31,21,8,13,3,2,29,18,5,9,3,2,9,11,9,2,0,0,20,7,-4,7,2,5,6,7,0,1,2,1,3,2,0,0,0,4,3,5,0,1,172,83,89,22,4,18,31,37,30,49,15,14,17,21,16,18,10,3,14,16,14,31,5,11,7,7,2,7,-1,0,2,1,-1,2,0,0,5,6,3,5,-1,0,86,50,36,34,18,16,42,-4,16,14,9,9,27,-1,2,12,3,6,15,-3,14,2,6,3,12,4,5,7,4,1,6,4,2,3,1,1,6,0,3,4,3,0,45,17,28,31,13,18,18,-10,18,2,24,-3,13,-12,9,0,7,1,5,2,9,2,17,-4,8,3,15,0,3,0,6,-1,7,-2,1,0,2,4,8,2,2,0,28,20,8,29,12,17,5,-13,-10,28,9,12,-7,-8,8,20,2,6,12,-5,-18,8,7,6,6,6,5,8,5,-1,2,4,-1,4,3,0,4,2,6,4,2,-1,33,8,25,15,9,6,27,-7,-10,16,-1,4,8,-6,0,7,-1,1,19,-1,-10,9,0,3,7,4,3,3,-2,0,2,2,3,3,-1,0,5,2,0,0,-1,0,-22,-15,-7,-17,-20,3,21,-19,-22,-12,-2,15,5,-2,-8,-14,2,3,16,-17,-14,2,-4,12,-3,1,-4,-12,0,1,-6,-2,-3,-10,0,1,3,3,-1,-2,0,0,9,1,8,-1,-4,3,13,-12,14,-14,-7,9,6,-9,4,-5,-4,6,7,-3,10,-9,-3,3,2,-2,6,-6,-2,-1,1,0,3,-5,-2,-1,1,-2,3,-1,0,0,-76,-50,-26,-4,-3,-1,-9,-12,-45,0,-7,2,-15,-2,-26,-3,-6,2,6,-10,-19,3,-1,0,3,-2,-1,-2,-1,-1,1,-1,0,0,-2,-1,2,-1,-1,-2,1,0,-39,-18,-21,-10,-1,-9,11,-16,-22,-24,7,0,9,-7,-13,-13,5,-4,2,-9,-9,-11,2,4,-1,2,-8,-3,-1,0,3,0,-3,-1,0,0,-4,2,-5,-2,-1,0,7,-9,16,9,5,4,-9,0,-4,9,0,8,-4,-1,-14,5,0,3,-5,1,10,4,0,5,-1,7,-1,2,0,0,0,4,-1,2,-1,0,-1,3,0,0,1,0,7,-18,25,-16,-8,-8,15,-4,-21,13,-9,13,7,-4,-24,4,-6,4,8,0,3,9,-3,9,-1,-1,-2,-3,-7,-1,-2,1,-3,-1,-2,-1,1,-2,1,-2,-5,0,-99,-54,-45,-9,-11,2,-3,-21,-32,-19,-12,-8,1,-11,-22,-13,-4,-3,-4,-10,-10,-6,-8,-5,-2,0,-12,0,4,1,2,-4,-11,0,1,1,-4,4,-1,0,3,0,-20,-20,0,-10,-9,-1,5,-11,-32,30,-17,7,7,-7,-23,13,-8,-1,-2,-4,-9,17,-9,8,-1,1,-1,1,-7,-3,2,2,-3,-2,-5,-3,-3,-1,2,3,-2,0
41,41101,Villaverde del Río,6598,-125,-66,-59,8,6,2,-44,-32,-23,-16,-5,-2,-24,-17,-12,-10,0,-1,-20,-15,-11,-6,-5,-1,3,0,1,3,0,1,2,0,1,2,0,1,1,0,0,1,0,0,-47,-27,-20,2,1,1,-8,-23,-16,-2,0,3,-3,-10,-13,-1,0,2,-5,-13,-3,-1,0,1,0,1,1,0,0,0,0,0,1,0,0,0,0,1,0,0,0,0,2,14,-12,14,8,6,1,-4,13,-6,2,-4,6,-6,12,1,2,-1,-5,2,1,-7,0,-3,3,1,5,2,3,0,2,0,3,2,1,0,1,1,2,0,2,0,54,32,22,13,8,5,21,12,3,12,4,-2,8,10,2,9,2,-1,13,2,1,3,2,-1,2,5,4,1,1,0,0,4,3,1,0,0,2,1,1,0,1,0,33,28,5,11,6,5,25,-4,16,-5,1,2,21,0,8,-3,1,2,4,-4,8,-2,0,0,3,1,2,2,3,0,2,0,0,2,2,0,1,1,2,0,1,0,42,34,8,42,26,16,23,9,16,-3,-5,0,19,4,13,-2,-2,1,4,5,3,-1,-3,-1,11,13,15,4,-1,0,6,9,11,1,-1,0,5,4,4,3,0,0,60,44,16,25,17,8,23,3,12,18,5,-3,18,-1,13,12,3,-2,5,4,-1,6,2,-1,7,7,8,3,0,0,5,5,5,2,0,0,2,2,3,1,0,0,206,108,98,45,25,20,48,31,73,39,15,2,27,16,32,26,8,1,21,15,41,13,7,1,10,3,11,15,5,1,5,2,6,9,2,1,5,1,5,6,3,0,114,62,52,21,10,11,20,19,44,18,13,3,8,9,29,9,6,3,12,10,15,9,7,0,3,9,4,5,0,0,0,4,3,3,0,0,3,5,1,2,0,0,62,29,33,9,1,8,31,-7,33,10,-3,-5,17,-5,12,7,0,-3,14,-2,21,3,-3,-2,2,2,5,0,0,0,1,-1,1,0,0,0,1,3,4,0,0,0,79,36,43,43,12,31,15,12,23,10,17,3,3,9,15,3,4,3,12,3,8,7,13,0,13,7,11,10,2,0,3,1,5,3,0,0,10,6,6,7,2,0,36,12,24,19,9,10,4,19,-7,14,0,6,4,2,-7,9,1,5,0,17,0,5,-1,1,3,6,6,3,1,0,1,3,2,2,1,0,2,3,4,1,0,0,45,23,22,13,2,11,16,3,17,-1,1,8,3,5,8,-2,2,6,13,-2,9,1,-1,2,7,6,-4,3,2,-1,4,1,-4,0,2,-1,3,5,0,3,0,0,40,19,21,-28,-19,-9,30,5,13,-2,-4,-4,13,1,9,-3,0,-2,17,4,4,1,-4,-2,6,-4,-10,-16,-2,-2,3,-1,-7,-12,-1,-1,3,-3,-3,-4,-1,-1,21,9,12,22,10,12,1,-14,3,14,13,7,-1,-2,2,4,4,4,2,-12,1,10,9,3,6,2,4,4,4,2,3,0,2,2,2,1,3,2,2,2,2,1,11,-7,18,-24,-12,-12,9,13,-17,5,-3,3,8,-1,-15,0,-1,1,1,14,-2,5,-2,2,-2,-1,-15,-7,-1,2,-2,-1,-6,-3,-1,1,0,0,-9,-4,0,1,-8,3,-11,13,11,2,2,1,-13,-7,9,3,1,0,-5,0,10,-1,1,1,-8,-7,-1,4,0,2,10,-1,1,0,1,1,7,0,1,0,-1,1,3,-1,0,0,-10,-25,15,21,9,12,10,0,-7,-16,5,-2,-3,-5,-14,-11,6,2,13,5,7,-5,-1,-4,3,10,1,5,2,0,1,3,0,3,2,0,2,7,1,2,0,0
41,41102,"Viso del Alcor, El",16036,68,32,36,16,10,6,16,13,25,-9,11,13,5,6,12,-7,6,10,11,7,13,-2,5,3,4,1,7,2,2,0,1,1,5,1,2,0,3,0,2,1,0,0,28,14,14,20,11,9,15,11,0,0,6,-3,8,5,-5,2,5,-1,7,6,5,-2,1,-2,6,4,5,3,1,0,2,3,3,2,0,0,4,1,2,1,1,0,126,76,50,27,21,6,30,21,44,9,13,12,26,15,16,10,5,6,4,6,28,-1,8,6,9,5,2,9,1,1,9,5,1,6,0,0,0,0,1,3,1,1,166,97,69,30,17,13,27,41,35,33,19,7,16,12,25,21,14,5,11,29,10,12,5,2,10,5,8,5,2,0,4,3,4,4,2,0,6,2,4,1,0,0,282,145,137,43,15,28,64,37,106,47,19,7,33,20,54,26,14,0,31,17,52,21,5,7,8,7,17,9,1,1,3,3,6,2,0,1,5,4,11,7,1,0,254,108,146,54,24,30,51,42,62,62,11,20,13,25,23,34,5,5,38,17,39,28,6,15,10,14,12,17,1,-1,6,5,2,10,1,0,4,9,10,7,0,-1,158,82,76,46,22,24,38,13,60,26,10,6,28,7,27,15,3,0,10,6,33,11,7,6,17,10,13,4,1,0,10,6,3,2,0,0,7,4,10,2,1,0,179,101,78,79,43,36,20,41,84,21,10,4,14,27,54,11,-1,0,6,14,30,10,11,4,18,27,24,9,0,0,13,12,14,4,-1,0,5,15,10,5,1,0,144,75,69,70,38,32,21,36,60,20,0,7,13,20,26,11,5,3,8,16,34,9,-5,4,17,20,19,12,0,1,10,11,6,9,2,0,7,9,13,3,-2,1,138,83,55,45,13,32,56,8,48,19,11,-12,34,3,34,7,4,-3,22,5,14,12,7,-9,26,4,12,0,0,1,13,-3,9,-6,-2,0,13,7,3,6,2,1,77,28,49,40,6,34,20,10,24,17,7,-5,5,8,6,4,4,-3,15,2,18,13,3,-2,12,5,13,4,4,0,5,0,-1,-1,2,0,7,5,14,5,2,0,49,10,39,25,16,9,21,14,3,4,0,2,8,-1,-14,12,2,1,13,15,17,-8,-2,1,15,12,0,-1,-1,-1,6,8,2,-1,0,0,9,4,-2,0,-1,-1,9,-29,38,-16,-20,4,21,-8,17,-23,-5,3,-3,-12,-2,-12,-2,-2,24,4,19,-11,-3,5,-1,4,-8,-15,-1,2,-4,0,-10,-9,0,1,3,4,2,-6,-1,1,-60,-14,-46,-17,-5,-12,-32,4,-9,-8,-14,-3,-11,4,0,-1,-8,-2,-21,0,-9,-7,-6,-1,-10,4,0,-10,-3,2,-4,2,1,-3,-2,1,-6,2,-1,-7,-1,1,-90,-47,-43,-32,-18,-14,-34,1,-15,-36,-4,3,-5,-4,-4,-29,-5,4,-29,5,-11,-7,1,-1,-8,-7,-6,-8,-2,-1,-3,-6,-1,-5,-2,-1,-5,-1,-5,-3,0,0,-46,-30,-16,-14,-12,-2,-10,-25,-28,4,4,4,-8,-14,-12,0,2,0,-2,-11,-16,4,2,4,-3,0,-10,-3,-1,0,-3,-1,-6,-5,1,0,0,1,-4,2,-2,0,4,13,-9,17,6,11,13,4,9,-7,-7,-4,11,1,16,-6,-7,-3,2,3,-7,-1,0,-1,5,4,-1,6,2,0,1,2,-5,6,1,0,4,2,4,0,1,0,-96,-56,-40,16,5,11,-16,-27,-33,-16,5,-8,-8,-14,-20,-9,1,-5,-8,-13,-13,-7,4,-3,14,1,0,-2,1,1,6,2,-2,0,-1,0,8,-1,2,-2,2,1
42,42004,Ágreda,3333,25,4,21,25,15,10,13,2,7,1,3,-2,6,-1,2,-3,1,-2,7,3,5,4,2,0,3,12,8,1,1,0,2,8,5,0,0,0,1,4,3,1,1,0,-23,-8,-15,11,7,4,-6,0,-14,-1,2,-3,-3,2,-5,-1,1,-1,-3,-2,-9,0,1,-2,2,4,3,2,0,0,1,3,2,1,0,0,1,1,1,1,0,0,21,12,9,23,13,10,1,0,9,3,-3,11,4,-5,6,2,-2,6,-3,5,3,1,-1,5,10,0,7,4,0,0,7,0,3,1,1,0,3,0,4,3,-1,0,34,24,10,12,3,9,5,13,5,-2,7,3,4,6,10,-2,5,1,1,7,-5,0,2,2,3,3,5,1,0,0,2,0,1,0,0,0,1,3,4,1,0,0,18,13,5,35,17,18,-3,-4,14,5,4,2,1,-2,7,4,1,1,-4,-2,7,1,3,1,7,8,15,1,4,0,6,4,7,-1,1,0,1,4,8,2,3,0,35,18,17,48,25,23,7,5,9,-1,2,17,3,9,7,1,-2,2,4,-4,2,-2,4,15,7,16,17,7,1,0,3,8,8,6,0,0,4,8,9,1,1,0,41,20,21,56,31,25,5,13,10,11,1,0,-2,5,9,5,1,0,7,8,1,6,0,0,10,12,19,8,5,1,4,4,11,6,4,1,6,8,8,2,1,0,29,21,8,64,27,37,11,0,14,9,-2,-6,-2,-2,17,4,1,1,13,2,-3,5,-3,-7,18,11,18,15,-1,0,4,5,8,7,1,0,14,6,10,8,-2,0,44,38,6,51,23,28,17,-7,17,21,0,-9,8,-5,17,12,4,-2,9,-2,0,9,-4,-7,19,9,16,5,0,2,11,0,9,3,0,0,8,9,7,2,0,2,19,13,6,39,17,22,9,1,6,4,2,-4,8,0,0,4,2,-1,1,1,6,0,0,-3,10,7,13,5,3,0,6,1,4,4,2,0,4,6,9,1,1,0,-48,-39,-9,23,6,17,2,0,-20,-20,0,-11,0,-3,-12,-17,1,-10,2,3,-8,-3,-1,-1,8,7,4,3,1,-1,5,1,2,-1,0,-1,3,6,2,4,1,0,7,5,2,14,6,8,9,-4,4,3,-1,-5,2,-3,2,2,2,-2,7,-1,2,1,-3,-3,3,3,6,2,0,0,1,1,2,2,0,0,2,2,4,0,0,0,2,2,0,15,7,8,14,-4,-3,0,-8,0,11,-3,0,-2,-6,0,3,-1,-3,2,-2,0,5,4,5,0,-1,1,5,0,2,0,-1,0,0,4,3,0,0,1,-31,-17,-14,-7,-5,-2,-7,-4,-6,-10,3,-7,-4,-2,-8,-4,2,-1,-3,-2,2,-6,1,-6,-5,1,-2,-1,0,0,-3,0,-2,0,0,0,-2,1,0,-1,0,0,-13,-8,-5,8,2,6,-6,-6,-2,-5,2,2,0,-1,-3,-2,-2,0,-6,-5,1,-3,4,2,0,3,3,2,0,0,-1,3,-1,2,-1,0,1,0,4,0,1,0,-56,-32,-24,-46,-24,-22,-7,-10,-10,-21,-10,1,-5,-6,-2,-15,-5,1,-2,-4,-8,-6,-5,0,-7,-7,-11,-16,-5,0,-3,-3,-5,-11,-2,0,-4,-4,-6,-5,-3,0,-23,-7,-16,2,2,0,1,-12,-10,-2,-4,0,1,-7,-3,-2,0,1,0,-5,-7,0,-4,-1,3,2,-2,3,-4,0,1,0,0,3,-2,0,2,2,-2,0,-2,0,8,3,5,15,8,7,-9,0,9,1,1,4,-8,3,2,2,1,1,-1,-3,7,-1,0,3,1,4,5,3,1,-1,0,2,2,2,0,0,1,2,3,1,1,-1
42,42020,Almazán,5871,27,12,15,60,25,35,21,16,12,-4,-10,-9,12,9,6,-6,-7,-3,9,7,6,2,-3,-6,9,21,12,13,3,2,4,11,4,4,1,1,5,10,8,9,2,1,-9,-11,2,61,28,33,2,8,-14,-17,8,3,-5,3,-9,-6,2,4,7,5,-5,-11,6,-1,20,19,12,7,1,1,8,7,8,5,0,0,12,12,4,2,1,1,53,44,9,58,35,23,16,5,22,5,-3,8,10,6,19,5,-4,6,6,-1,3,0,1,2,11,16,20,7,2,1,4,13,13,4,0,0,7,3,7,3,2,1,24,26,-2,22,13,9,16,6,-2,0,0,4,10,1,9,1,3,2,6,5,-11,-1,-3,2,4,9,6,2,1,0,2,4,4,2,1,0,2,5,2,0,0,0,11,4,7,31,16,15,13,0,-13,5,5,8,1,-3,1,5,2,4,12,3,-14,0,3,4,7,11,10,1,1,1,1,8,7,0,0,0,6,3,3,1,1,1,40,18,22,39,19,20,14,5,-1,14,9,-5,7,-2,1,1,8,-1,7,7,-2,13,1,-4,8,6,10,12,1,2,5,3,6,4,1,0,3,3,4,8,0,2,154,77,77,93,57,36,34,37,23,32,15,13,9,22,18,18,8,1,25,15,5,14,7,12,20,29,25,12,7,0,10,19,16,9,3,0,10,10,9,3,4,0,188,90,98,111,57,54,49,33,48,34,10,5,22,20,22,12,8,-1,27,13,26,22,2,6,27,31,27,16,8,0,12,17,15,7,5,0,15,14,12,9,3,0,27,42,-15,51,37,14,28,-9,15,5,-3,-9,15,6,16,8,-2,0,13,-15,-1,-3,-1,-9,16,5,22,8,1,-1,10,5,16,5,1,0,6,0,6,3,0,-1,-18,13,-31,14,4,10,-4,4,-3,1,-12,-1,-1,0,7,8,-6,8,-3,4,-10,-7,-6,-9,6,10,3,2,-6,-1,3,1,1,2,-3,0,3,9,2,0,-3,-1,38,9,29,26,13,13,17,19,3,-7,-2,7,6,13,3,-14,-1,3,11,6,0,7,-1,4,8,11,0,5,0,1,6,9,-2,0,0,0,2,2,2,5,0,1,-124,-73,-51,-26,-19,-7,-26,-18,-42,-18,-4,-13,-11,-7,-29,-11,-4,-8,-15,-11,-13,-7,0,-5,-4,-3,-13,-3,-4,1,-2,-4,-9,-2,-3,1,-2,1,-4,-1,-1,0,-25,-11,-14,-15,-13,-2,2,-24,-20,4,-6,15,0,-16,-3,-2,1,7,2,-8,-17,6,-7,8,3,-2,-12,-3,0,-2,0,-3,-4,-5,0,-2,3,1,-8,2,0,0,-51,-28,-23,-29,-15,-14,-8,-8,-11,-14,-14,3,-8,2,-7,-6,-10,0,0,-10,-4,-8,-4,3,-7,-2,-13,-5,-1,-1,-3,-1,-8,-2,0,-1,-4,-1,-5,-3,-1,0,3,-9,12,-7,-10,3,11,4,-15,-5,3,3,7,0,-12,-12,1,7,4,4,-3,7,2,-4,6,0,-5,-4,-6,0,4,-2,-5,-3,-6,1,2,2,0,-1,0,-1,-67,-32,-35,-18,-12,-6,-6,-4,-15,-27,-10,-3,-8,3,-8,-14,-3,-3,2,-7,-7,-13,-7,0,0,3,-8,-10,-2,-1,-1,3,-6,-8,0,0,1,0,-2,-2,-2,-1,-32,-10,-22,2,2,0,-18,-4,-13,3,5,-6,-8,-5,2,0,3,-1,-10,1,-15,3,2,-5,-5,3,0,4,-2,0,-1,0,1,3,-1,0,-4,3,-1,1,-1,0,6,9,-3,19,8,11,11,-3,9,-14,-7,11,4,6,9,-10,-6,7,7,-9,0,-4,-1,4,7,7,8,-2,-2,1,3,5,6,-5,-1,1,4,2,2,3,-1,0
42,42043,Burgo de Osma-Ciudad de Osma,5042,30,21,9,26,13,13,10,-3,19,-1,0,4,4,-3,15,-1,1,4,6,0,4,0,-1,0,6,10,5,2,2,0,2,5,3,1,1,0,4,5,2,1,1,0,55,24,31,15,8,7,9,14,10,8,5,3,0,7,3,3,2,4,9,7,7,5,3,-1,3,6,4,2,0,0,1,3,3,1,0,0,2,3,1,1,0,0,51,28,23,44,29,15,2,13,12,6,3,7,1,8,8,1,3,1,1,5,4,5,0,6,10,13,10,5,2,1,7,7,8,3,2,0,3,6,2,2,0,1,-4,0,-4,5,1,4,2,8,-1,-11,-2,-2,-1,1,3,-1,-1,-1,3,7,-4,-10,-1,-1,0,1,0,3,0,1,0,1,-1,1,0,0,0,0,1,2,0,1,48,32,16,19,13,6,11,6,11,-6,9,12,14,6,5,-3,2,6,-3,0,6,-3,7,6,2,6,7,2,2,0,1,5,4,2,1,0,1,1,3,0,1,0,2,9,-7,32,15,17,-5,12,-5,-15,0,14,-1,6,1,-6,0,9,-4,6,-6,-9,0,5,5,14,6,7,0,0,4,5,3,4,-1,0,1,9,3,3,1,0,50,16,34,41,20,21,10,17,13,-1,11,-2,4,5,1,-1,6,0,6,12,12,0,5,-2,11,8,13,8,1,0,5,3,6,6,0,0,6,5,7,2,1,0,113,63,50,94,52,42,30,16,26,34,1,4,18,11,12,17,0,4,12,5,14,17,1,0,15,29,25,24,0,0,9,15,15,13,0,0,6,14,10,11,0,0,104,56,48,77,39,38,22,27,25,6,8,6,10,12,16,5,5,2,12,15,9,1,3,4,17,20,28,8,1,1,10,11,14,1,1,1,7,9,14,7,0,0,48,30,18,34,14,20,0,-3,1,-2,18,33,-2,-2,6,6,6,16,2,-1,-5,-8,12,17,12,3,6,3,10,0,4,0,2,3,5,0,8,3,4,0,5,0,31,23,8,11,4,7,-6,19,-27,24,-4,23,-7,12,-15,19,2,12,1,7,-12,5,-6,11,-1,10,-2,1,0,1,0,4,-4,3,-1,1,-1,6,2,-2,1,0,10,-4,14,25,4,21,14,17,-14,-6,4,-7,4,8,-8,-8,0,-1,10,9,-6,2,4,-6,4,17,-1,3,0,-1,1,5,-3,0,-1,0,3,12,2,3,1,-1,-40,-11,-29,-8,-8,0,-13,5,-30,4,-4,-2,-10,2,-7,5,-3,3,-3,3,-23,-1,-1,-5,-5,2,-6,-1,2,0,-3,-1,-2,-3,1,0,-2,3,-4,2,1,0,30,14,16,2,0,2,8,-2,-1,5,5,14,4,-4,-2,4,5,6,4,2,1,1,0,8,4,1,-1,1,-2,-1,2,-2,0,2,-1,-1,2,3,-1,-1,-1,0,11,-5,16,12,8,4,9,-7,-4,3,-4,11,4,-1,-5,-5,-4,5,5,-6,1,8,0,6,1,6,-2,3,2,1,2,3,1,1,1,0,-1,3,-3,2,1,1,-5,-12,7,23,8,15,-2,7,-2,-6,-2,1,-7,6,-1,-4,-1,-5,5,1,-1,-2,-1,6,8,6,3,3,1,0,2,2,1,1,0,0,6,4,2,2,1,0,18,-6,24,2,-5,7,13,-14,-7,19,-4,11,5,-10,-12,12,-5,4,8,-4,5,7,1,7,8,-4,3,-5,-1,0,4,-3,-2,-6,0,1,4,-1,5,1,-1,-1,-8,9,-17,18,11,7,-10,11,-20,5,1,6,-9,6,-5,5,6,6,-1,5,-15,0,-5,0,-1,11,1,4,1,2,-1,7,1,3,0,1,0,4,0,1,1,1
42,42103,Langa de Duero,929,-16,-9,-7,7,4,3,-3,-3,-12,4,3,-3,-3,-1,-6,2,1,-1,0,-2,-6,2,2,-2,2,0,1,4,0,0,1,0,0,3,0,0,1,0,1,1,0,0,-22,-8,-14,7,4,3,-2,-4,-7,-1,-1,-6,0,-3,-4,1,-1,0,-2,-1,-3,-2,0,-6,3,1,3,0,0,0,1,1,2,0,0,0,2,0,1,0,0,0,4,12,-8,12,10,2,1,5,2,3,-1,-5,1,5,5,2,1,-1,0,0,-3,1,-2,-4,1,4,4,3,0,0,0,3,4,3,0,0,1,1,0,0,0,0,17,10,7,20,8,12,4,5,2,1,4,0,1,3,4,-1,1,2,3,2,-2,2,3,-2,5,7,5,3,0,0,1,3,3,1,0,0,4,4,2,2,0,0,-18,-14,-4,17,7,10,-1,-3,-7,-3,-3,-1,-1,-3,-5,-1,-2,-2,0,0,-2,-2,-1,1,6,6,2,1,1,1,3,3,0,1,0,0,3,3,2,0,1,1,23,16,7,15,7,8,1,13,10,2,1,-4,2,8,6,1,1,-1,-1,5,4,1,0,-3,3,5,2,3,2,0,1,3,0,2,1,0,2,2,2,1,1,0,-6,-4,-2,21,8,13,0,-9,-1,3,3,-1,2,-4,-5,3,0,0,-2,-5,4,0,3,-1,4,5,6,3,2,0,3,1,3,1,0,0,1,4,3,2,2,0,14,8,6,50,26,24,6,-2,8,4,1,-4,3,2,5,1,1,-3,3,-4,3,3,0,-1,12,8,16,10,3,0,8,4,7,5,2,0,4,4,9,5,1,0,-9,-4,-5,19,11,8,2,-4,-5,-2,6,-5,1,-2,-2,-2,6,-5,1,-2,-3,0,0,0,7,3,4,3,1,1,3,2,3,2,1,0,4,1,1,1,0,1,-22,-11,-11,5,5,0,-10,2,-10,-1,0,-3,-5,2,-3,-3,0,-1,-5,0,-7,2,0,-2,1,1,3,0,0,0,0,1,3,1,0,0,1,0,0,-1,0,0,6,3,3,3,0,3,1,5,9,-4,0,-6,1,2,5,-2,0,-3,0,3,4,-2,0,-3,-1,1,1,1,0,0,0,-1,0,1,0,0,-1,2,1,0,0,0,5,4,1,-3,-5,2,5,2,-3,1,2,-2,2,-1,-2,3,1,1,3,3,-1,-2,1,-3,2,0,-6,-1,1,1,0,0,-5,-1,1,0,2,0,-1,0,0,1,-18,-12,-6,3,1,2,1,-2,-2,-1,-2,-11,1,1,-2,-2,-1,-8,0,-3,0,1,-1,-3,1,1,3,-1,-1,0,1,1,1,-1,-1,0,0,0,2,0,0,0,-9,-5,-4,-4,-4,0,1,0,-3,1,-3,-5,0,0,-1,1,-3,-2,1,0,-2,0,0,-3,0,0,-2,0,-2,0,0,0,-2,0,-2,0,0,0,0,0,0,0,-7,-4,-3,12,8,4,-5,4,3,0,1,-9,-7,4,2,2,-1,-3,2,0,1,-2,2,-6,3,5,4,3,-1,-2,3,4,2,2,-1,-2,0,1,2,1,0,0,-3,4,-7,8,4,4,-4,1,-7,3,4,1,-1,2,-3,2,3,1,-3,-1,-4,1,1,0,1,3,3,0,1,0,0,1,2,0,1,0,1,2,1,0,0,0,23,15,8,21,12,9,2,-3,9,3,10,1,2,-1,6,1,5,2,0,-2,3,2,5,-1,4,1,11,2,2,0,3,0,7,1,1,0,1,1,4,1,1,0,-9,1,-10,3,3,0,0,-1,-3,6,-2,-9,0,0,0,5,0,-4,0,-1,-3,1,-2,-5,0,1,2,0,0,0,0,1,2,0,0,0,0,0,0,0,0,0
42,42173,Soria,34045,233,86,147,303,120,183,26,44,118,40,-12,23,5,19,32,32,-9,13,21,25,86,8,-3,10,45,87,103,48,10,4,21,33,46,16,2,1,24,54,57,32,8,3,354,195,159,442,218,224,105,80,141,56,-17,-11,65,27,95,25,-5,-13,40,53,46,31,-12,2,110,111,151,50,13,0,66,41,78,26,3,0,44,70,73,24,10,0,183,101,82,404,180,224,59,51,82,13,-17,-14,27,22,59,8,-15,-6,32,29,23,5,-2,-8,103,101,117,52,18,6,53,38,55,23,7,2,50,63,62,29,11,4,478,178,300,454,198,256,102,145,104,63,8,64,44,55,45,4,3,27,58,90,59,59,5,37,106,127,125,75,9,8,57,43,57,30,3,5,49,84,68,45,6,3,674,315,359,572,283,289,126,119,181,122,37,85,67,46,89,66,13,31,59,73,92,56,24,54,140,134,176,80,30,7,79,54,87,44,12,3,61,80,89,36,18,4,694,302,392,520,262,258,153,132,181,125,41,44,83,81,73,39,12,17,70,51,108,86,29,27,124,142,137,77,26,8,70,71,65,38,12,3,54,71,72,39,14,5,615,269,346,713,360,353,127,143,160,112,21,45,61,71,76,45,-2,18,66,72,84,67,23,27,161,169,198,132,39,9,82,86,100,67,19,4,79,83,98,65,20,5,903,459,444,855,452,403,181,215,225,148,38,81,109,121,106,64,6,46,72,94,119,84,32,35,163,242,234,163,35,7,86,122,127,95,15,1,77,120,107,68,20,6,464,260,204,486,279,207,99,115,101,93,4,45,51,94,61,34,-2,22,48,21,40,59,6,23,107,139,137,86,15,-6,53,88,83,48,5,-2,54,51,54,38,10,-4,123,-12,135,49,-5,54,95,44,-41,-39,-18,62,44,16,-57,-44,-11,23,51,28,16,5,-7,39,64,42,-29,-25,-10,-1,26,16,-24,-27,-3,0,38,26,-5,2,-7,-1,126,27,99,39,-6,45,47,17,7,49,-27,19,40,-16,31,-10,-24,0,7,33,-24,59,-3,19,23,28,-15,-1,-3,-1,24,-1,-12,-13,-7,1,-1,29,-3,12,4,-2,204,44,160,43,24,19,53,43,47,0,0,56,23,19,-11,-4,-2,18,30,24,58,4,2,38,21,39,-14,-8,1,-2,16,26,-7,-12,0,-1,5,13,-7,4,1,-1,-127,-66,-61,-86,-61,-25,4,-22,-114,-23,7,22,2,-11,-69,-10,1,19,2,-11,-45,-13,6,3,-5,-4,-42,-30,0,-3,-8,-8,-23,-22,1,-2,3,4,-19,-8,-1,-1,-181,-131,-50,-54,-36,-18,-4,-22,-72,-87,-19,17,-6,-16,-51,-61,-12,12,2,-6,-21,-26,-7,5,-9,14,-22,-32,-9,-1,-8,13,-16,-23,-4,-1,-1,1,-6,-9,-5,0,-242,-127,-115,-107,-63,-44,-36,-28,-110,-58,-38,8,-6,-10,-60,-43,-27,10,-30,-18,-50,-15,-11,-2,3,28,-76,-45,-20,-8,5,16,-41,-33,-14,-2,-2,12,-35,-12,-6,-6,-62,-54,-8,-47,-20,-27,3,-34,-89,-34,11,66,3,-20,-50,-21,-5,31,0,-14,-39,-13,16,35,7,5,-18,-28,-15,-6,9,8,-8,-16,-14,-2,-2,-3,-10,-12,-1,-4,-118,-119,1,-144,-76,-68,-1,-31,-65,-55,-35,52,13,-21,-39,-62,-33,19,-14,-10,-26,7,-2,33,-15,-6,-30,-64,-26,-11,-2,-3,-11,-45,-13,-5,-13,-3,-19,-19,-13,-6,460,225,235,293,147,146,132,59,57,84,23,83,73,40,29,24,3,43,59,19,28,60,20,40,80,68,79,38,11,6,36,41,40,22,-1,5,44,27,39,16,12,1
43,43004,Alcanar,7801,331,217,114,334,226,108,33,80,131,57,32,-5,19,50,90,41,19,-4,14,30,41,16,13,-1,16,94,137,59,22,5,13,58,93,44,14,3,3,36,44,15,8,2,218,127,91,225,122,103,34,47,74,51,13,-2,22,24,37,39,6,-2,12,23,37,12,7,0,31,57,78,42,16,1,17,23,43,29,9,1,14,34,35,13,7,0,235,137,98,225,126,99,29,51,77,47,30,-1,23,27,47,19,21,-1,6,24,30,28,9,0,37,58,81,34,14,1,23,28,51,15,9,0,14,30,30,19,5,1,91,53,38,37,12,25,16,20,31,18,11,-9,11,12,19,11,4,-8,5,8,12,7,7,-1,8,17,8,7,0,-3,3,6,2,4,-1,-2,5,11,6,3,1,-1,435,265,170,350,193,157,35,121,127,86,46,20,22,70,79,52,26,14,13,51,48,34,20,6,57,110,105,54,16,7,33,52,65,28,8,6,24,58,40,26,8,1,385,221,164,338,189,149,63,100,116,65,34,9,35,53,68,42,17,9,28,47,48,23,17,0,58,97,99,52,23,7,33,58,52,31,8,6,25,39,47,21,15,1,428,237,191,358,195,163,83,91,120,82,38,11,52,50,73,37,21,2,31,41,47,45,17,9,62,100,92,69,24,8,41,49,55,32,11,5,21,51,37,37,13,3,549,300,249,522,285,237,85,162,174,92,30,-1,40,89,104,52,7,4,45,73,70,40,23,-5,79,157,143,100,33,7,35,83,91,56,12,6,44,74,52,44,21,1,10,-7,17,97,27,70,-18,47,-12,-26,28,-3,-12,21,-8,-23,18,4,-6,26,-4,-3,10,-7,18,54,13,3,5,3,4,21,-3,0,1,5,14,33,16,3,4,-2,5,28,-23,96,43,53,21,-9,10,-18,13,-11,8,-3,22,-4,10,-4,13,-6,-12,-14,3,-7,14,25,35,11,11,1,6,8,22,5,4,-1,8,17,13,6,7,2,57,53,4,57,24,33,-14,33,-2,-3,13,31,-7,24,18,1,5,12,-7,9,-20,-4,8,19,5,34,5,5,5,3,2,15,5,-1,1,2,3,19,0,6,4,1,99,52,47,82,30,52,-7,29,38,14,0,21,-5,21,18,4,-3,14,-2,8,20,10,3,7,14,24,25,10,-1,8,7,12,6,2,-2,4,7,12,19,8,1,4,-256,-150,-106,-154,-99,-55,-48,-12,-105,-62,-20,-10,-24,1,-70,-41,-11,-6,-24,-13,-35,-21,-9,-4,-19,2,-74,-39,-19,-5,-8,0,-49,-26,-14,-2,-11,2,-25,-13,-5,-3,-457,-294,-163,-394,-258,-136,-32,-54,-169,-152,-56,8,-10,-35,-113,-105,-29,-1,-22,-19,-56,-47,-27,9,-36,-43,-141,-127,-33,-14,-16,-28,-97,-88,-21,-8,-20,-15,-44,-39,-12,-6,-298,-187,-111,-317,-176,-141,-21,-3,-70,-75,-57,-72,-17,-10,-51,-45,-21,-43,-4,7,-19,-30,-36,-29,-21,-7,-80,-81,-64,-66,-11,-6,-45,-53,-28,-34,-10,-1,-35,-28,-36,-32,-79,-46,-33,0,-7,7,-27,-4,-23,0,-15,-12,-21,-3,-8,4,-10,-10,-6,-1,-15,-4,-5,-2,-5,12,-8,-3,2,0,-4,3,-6,-2,1,0,-1,9,-2,-1,1,0,36,17,19,22,11,11,15,14,-26,14,15,2,2,15,-8,0,13,-5,13,-1,-18,14,2,7,12,11,-12,12,4,-5,6,10,-4,3,2,-6,6,1,-8,9,2,1,-34,-6,-28,-37,-18,-19,-9,-2,-8,-25,5,5,-9,2,-5,-11,7,9,0,-4,-3,-14,-2,-4,-12,11,-4,-29,-2,-4,-9,0,3,-14,3,-3,-3,11,-7,-15,-5,-1
43,43005,Alcover,3692,52,19,33,31,17,14,4,14,18,5,9,0,-4,7,11,0,3,2,8,7,7,5,6,-2,2,7,9,6,5,0,1,4,6,3,2,0,1,3,3,3,3,0,158,72,86,68,34,34,37,26,30,39,14,11,20,4,16,16,11,4,17,22,14,23,3,7,11,16,17,12,6,6,3,6,11,7,4,3,8,10,6,5,2,3,133,84,49,81,49,32,25,25,49,15,18,2,10,24,30,13,9,-2,15,1,19,2,9,4,12,24,28,9,6,1,5,18,16,5,3,1,7,6,12,4,3,0,128,66,62,62,29,33,25,23,45,10,15,9,16,10,27,5,6,1,9,13,18,5,9,8,19,8,20,6,8,1,12,3,8,2,3,1,7,5,12,4,5,0,77,55,22,25,17,8,8,11,28,7,11,10,7,6,22,7,6,7,1,5,6,0,5,3,4,5,12,5,0,-1,4,4,5,4,0,0,0,1,7,1,0,-1,119,72,47,60,35,25,21,22,30,16,19,9,15,4,19,15,10,8,6,18,11,1,9,1,8,14,23,6,7,2,6,6,13,6,3,1,2,8,10,0,4,1,195,100,95,106,50,56,36,30,70,33,19,0,17,14,38,15,11,1,19,16,32,18,8,-1,31,19,30,21,2,1,15,10,14,8,2,0,16,9,16,13,0,1,199,119,80,91,52,39,40,62,42,36,13,2,20,41,26,21,4,4,20,21,16,15,9,-2,8,37,27,15,2,1,3,21,18,9,1,0,5,16,9,6,1,1,123,87,36,24,20,4,22,32,37,3,12,16,15,23,27,4,7,9,7,9,10,-1,5,7,10,9,0,0,5,0,6,5,1,4,3,1,4,4,-1,-4,2,-1,39,36,3,12,5,7,-1,8,1,11,1,16,4,4,1,9,3,12,-5,4,0,2,-2,4,5,5,6,0,-3,-2,3,1,5,-2,-2,-1,2,4,1,2,-1,-1,-9,0,-9,-63,-40,-23,-8,-7,14,-15,0,2,-3,3,7,-12,-1,2,-5,-10,7,-3,1,0,-21,-12,-22,-8,-2,0,-7,-7,-17,-9,-1,0,-14,-5,-5,1,-1,0,-5,-4,-1,-26,-19,-7,-14,19,3,-19,-2,6,-7,5,5,-15,4,3,-7,14,-2,-4,-6,3,-7,2,0,-18,-4,1,-4,-1,-1,-11,-2,0,-3,3,1,-7,-2,1,-12,-8,-4,-13,-17,4,9,-5,-4,-12,-1,-3,10,-3,-7,-6,-2,-2,-1,-2,3,-6,1,-1,0,-1,-10,-4,0,1,0,-1,-9,-4,-3,0,0,0,-1,0,3,1,-18,-20,2,-28,-23,-5,-5,-5,-11,6,1,-3,-8,-11,-8,8,4,-5,3,6,-3,-2,-3,2,-6,5,-7,-10,-5,-5,-4,1,-8,-8,-2,-2,-2,4,1,-2,-3,-3,-32,-20,-12,-13,-9,-4,-5,-3,-10,-20,3,1,-3,1,-9,-8,-5,5,-2,-4,-1,-12,8,-4,0,4,-2,-12,3,-5,1,2,-3,-5,0,-3,-1,2,1,-7,3,-2,5,-5,10,22,5,17,-7,3,-2,7,2,2,-4,-1,0,3,-3,1,-3,4,-2,4,5,1,9,3,4,2,4,-1,5,1,2,-2,-1,0,4,2,2,4,5,-1,48,22,26,18,9,9,6,9,6,5,12,11,10,6,-2,2,5,4,-4,3,8,3,7,7,2,4,6,-1,1,3,4,1,2,0,-1,3,-2,3,4,-1,2,0,-26,-14,-12,19,12,7,-22,2,7,-16,-4,1,-12,2,1,-4,-4,-1,-10,0,6,-12,0,2,2,3,7,1,5,1,1,2,6,0,2,1,1,1,1,1,3,0
43,43012,Altafulla,2955,186,109,77,59,38,21,27,26,49,31,36,12,13,20,25,18,21,9,14,6,24,13,15,3,12,15,13,9,7,3,8,11,9,6,2,2,4,4,4,3,5,1,152,69,83,57,34,23,30,7,60,31,19,5,11,0,32,14,11,2,19,7,28,17,8,3,10,8,15,11,10,3,3,5,11,6,8,1,7,3,4,5,2,2,153,71,82,59,34,25,24,20,65,20,7,11,10,13,29,11,1,3,14,7,36,9,6,8,12,17,20,6,3,1,5,12,10,6,1,0,7,5,10,0,2,1,136,75,61,36,22,14,40,1,34,43,14,2,21,6,13,24,10,0,19,-5,21,19,4,2,9,4,14,6,2,0,8,3,6,3,2,0,1,1,8,3,0,0,144,62,82,41,12,29,26,8,27,37,19,22,8,3,11,10,14,10,18,5,16,27,5,12,11,4,14,4,3,0,3,-1,3,2,2,0,8,5,11,2,1,0,224,104,120,76,36,40,41,10,64,40,45,17,18,6,38,12,18,8,23,4,26,28,27,9,19,7,14,15,15,4,10,2,8,7,5,3,9,5,6,8,10,1,169,88,81,48,23,25,28,24,31,42,24,14,19,13,10,19,13,8,9,11,21,23,11,6,17,4,11,12,3,1,7,5,6,2,2,1,10,-1,5,10,1,0,101,58,43,54,32,22,3,23,30,6,24,12,5,14,14,7,19,0,-2,9,16,-1,5,12,6,15,12,17,2,0,5,9,6,11,1,-1,1,6,6,6,1,1,98,40,58,37,12,25,24,-4,42,13,13,-1,9,-5,17,0,7,3,15,1,25,13,6,-4,8,3,12,8,3,2,3,0,4,4,0,0,5,3,8,4,3,2,13,3,10,-8,-8,0,-17,-7,28,-4,13,-7,-2,-6,11,-1,1,-5,-15,-1,17,-3,12,-2,0,-3,2,-6,0,-3,1,-4,-2,-3,-1,0,-1,1,4,-3,1,-3,35,-2,37,-30,-13,-17,24,-1,6,8,-4,2,5,2,-7,-2,-3,3,19,-3,13,10,-1,-1,-1,-2,0,-15,-7,-6,-3,-1,2,-8,-3,0,2,-1,-2,-7,-4,-6,45,25,20,13,8,5,5,5,33,1,-1,-4,-3,4,13,9,-5,3,8,1,20,-8,4,-7,4,5,4,2,1,-4,2,3,2,2,-2,0,2,2,2,0,3,-4,69,42,27,-15,-17,2,2,-7,45,9,7,6,11,-4,29,7,-1,-1,-9,-3,16,2,8,7,-2,-10,5,-4,-2,-4,1,-5,1,-5,-3,-6,-3,-5,4,1,1,2,42,30,12,-24,-10,-14,16,1,15,-3,11,1,11,2,7,5,3,2,5,-1,8,-8,8,-1,-8,1,-6,-14,3,0,-4,-1,-2,-5,2,0,-4,2,-4,-9,1,0,35,17,18,-12,-8,-4,9,-1,-1,22,1,-5,4,-2,7,11,-2,-7,5,1,-8,11,3,2,-1,-2,0,-5,1,-5,-4,-2,2,-2,1,-3,3,0,-2,-3,0,-2,31,22,9,16,4,12,5,-1,4,9,7,5,-1,-4,7,5,5,8,6,3,-3,4,2,-3,4,5,3,0,3,1,1,2,-2,-1,3,1,3,3,5,1,0,0,50,10,40,4,8,-4,9,0,15,-2,14,11,2,-3,4,-4,4,6,7,3,11,2,10,5,0,1,1,-3,1,3,2,-1,3,1,-1,3,-2,2,-2,-4,2,0,13,1,12,22,8,14,14,-2,-4,15,6,-17,4,-4,-8,14,5,-11,10,2,4,1,1,-6,4,6,5,1,4,1,-2,4,1,3,2,0,6,2,4,-2,2,1
43,43013,"Ametlla de Mar, L'",4777,68,51,17,107,60,47,5,0,24,16,21,2,3,9,13,8,15,3,2,-9,11,8,6,-1,8,22,20,18,30,8,4,13,11,10,16,5,4,9,9,8,14,3,99,57,42,95,55,40,6,19,33,22,9,10,2,12,19,13,3,8,4,7,14,9,6,2,6,14,32,17,18,8,1,10,19,12,8,5,5,4,13,5,10,3,117,78,39,83,50,33,7,13,22,19,42,13,9,0,24,11,26,7,-2,13,-2,8,16,6,12,12,23,21,13,2,6,7,16,14,7,0,6,5,7,7,6,2,22,27,-5,15,7,8,-11,5,15,0,8,2,-4,5,10,11,6,-2,-7,0,5,-11,2,4,3,9,1,1,5,-4,1,6,-1,1,3,-3,2,3,2,0,2,-1,343,201,142,304,166,138,41,46,71,65,95,25,25,34,38,34,51,18,16,12,33,31,44,7,40,51,66,53,75,18,23,26,37,24,43,12,17,25,29,29,32,6,361,186,175,252,135,117,52,53,109,63,73,9,27,29,55,36,32,4,25,24,54,27,41,5,37,46,59,41,58,10,19,17,34,26,32,6,18,29,25,15,26,4,338,185,153,249,134,115,65,26,64,92,72,8,27,21,48,51,31,4,38,5,16,41,41,4,38,41,46,65,41,14,15,25,32,33,21,7,23,16,14,32,20,7,333,171,162,234,112,122,61,48,72,64,72,10,35,26,37,33,34,3,26,22,35,31,38,7,37,39,54,33,61,8,16,21,24,20,26,4,21,18,30,13,35,4,157,102,55,141,78,63,16,32,51,25,20,6,13,17,32,22,15,0,3,15,19,3,5,6,16,35,30,26,26,6,8,16,21,17,12,3,8,19,9,9,14,3,17,8,9,-19,-14,-5,30,1,-6,0,-5,-6,11,5,-7,-1,7,-7,19,-4,1,1,-12,1,14,2,-1,-15,-20,0,7,2,-8,-8,-7,0,7,0,7,-7,-13,0,39,13,26,88,39,49,-11,5,-14,-4,46,15,-9,6,-12,4,20,4,-2,-1,-2,-8,26,11,8,11,8,15,35,10,4,3,1,10,13,7,4,8,7,5,22,3,43,32,11,56,31,25,-7,11,30,-4,26,-18,5,2,13,-6,20,-4,-12,9,17,2,6,-14,0,13,15,13,12,2,3,3,7,8,8,1,-3,10,8,5,4,1,35,19,16,71,29,42,-4,2,2,12,20,-1,-9,8,6,2,6,5,5,-6,-4,10,14,-6,8,9,13,14,22,5,3,6,7,4,8,2,5,3,6,10,14,3,13,22,-9,40,30,10,4,8,-6,-6,20,-9,2,10,0,-4,13,0,2,-2,-6,-2,7,-9,5,0,0,3,20,10,3,0,3,1,12,10,2,0,-3,2,8,0,46,25,21,35,22,13,5,-1,10,13,16,5,1,6,9,3,2,4,4,-7,1,10,14,1,-1,6,8,7,4,10,-1,6,2,5,1,8,0,0,6,2,3,2,107,77,30,72,41,31,5,12,7,29,24,28,4,8,3,21,18,21,1,4,4,8,6,7,8,5,4,19,20,15,3,3,3,7,13,12,5,2,1,12,7,3,-383,-211,-172,-275,-154,-121,-29,-34,-55,-76,-70,-118,-17,-18,-26,-57,-32,-59,-12,-16,-29,-19,-38,-59,-11,-16,-31,-55,-61,-102,-7,-8,-13,-43,-30,-54,-4,-8,-18,-12,-31,-48,-199,-128,-71,-161,-99,-62,0,4,-43,-72,-40,-47,4,-6,-26,-46,-24,-29,-4,10,-17,-26,-16,-18,0,1,-28,-46,-45,-43,-4,1,-19,-27,-26,-24,4,0,-9,-19,-19,-19
43,43906,"Ampolla, L'",1756,118,65,53,36,22,14,17,5,12,37,34,12,14,0,7,17,19,7,3,5,5,20,15,5,2,2,3,7,19,3,1,1,3,2,12,3,1,1,0,5,7,0,45,24,21,16,7,9,3,6,0,13,24,-1,2,2,-1,6,14,1,1,4,1,7,10,-2,2,1,2,3,7,1,0,0,1,2,3,1,2,1,1,1,4,0,45,20,25,-3,-2,-1,0,13,14,17,0,1,3,9,7,3,1,-3,-3,4,7,14,-1,4,0,0,-1,0,-1,-1,0,0,-1,0,0,-1,0,0,0,0,-1,0,139,69,70,31,18,13,23,16,46,37,14,2,9,8,20,23,8,1,14,8,26,14,6,1,0,8,2,6,9,6,0,5,2,4,5,2,0,3,0,2,4,4,234,132,102,170,87,83,32,47,76,35,35,6,14,22,50,25,19,1,18,25,26,10,16,5,24,36,52,22,28,8,7,17,33,14,12,4,17,19,19,8,16,4,167,95,72,112,64,48,17,40,34,36,41,2,9,23,28,15,20,1,8,17,6,21,21,1,14,31,26,18,16,7,6,20,19,10,5,4,8,11,7,8,11,3,66,40,26,74,39,35,19,17,-7,19,15,3,11,14,-7,12,9,1,8,3,0,7,6,2,14,20,11,19,9,1,7,12,4,11,4,1,7,8,7,8,5,0,312,174,138,211,116,95,32,41,119,44,66,8,18,19,70,24,35,6,14,22,49,20,31,2,24,36,69,38,37,5,16,19,37,23,17,3,8,17,32,15,20,2,155,92,63,86,44,42,16,40,24,28,39,9,5,27,18,17,16,10,11,13,6,11,23,-1,14,21,24,15,8,4,8,10,14,9,2,1,6,11,10,6,6,3,86,25,61,23,3,20,17,6,5,19,28,11,3,-6,1,5,15,7,14,12,4,14,13,4,8,9,-6,1,10,1,4,1,-4,-3,5,0,4,8,-2,4,5,1,22,-1,23,46,21,25,-2,-7,2,2,19,8,-8,-1,-4,0,13,0,6,-6,6,2,6,8,8,5,11,8,8,5,4,1,4,6,4,2,4,4,7,2,4,3,-18,-16,-2,20,1,19,-6,13,-14,-7,-6,0,1,6,-12,-7,-2,-4,-7,7,-2,0,-4,4,4,9,-5,3,2,5,1,3,-6,-3,0,4,3,6,1,6,2,1,68,29,39,20,7,13,19,4,18,27,4,-5,10,0,14,10,0,-6,9,4,4,17,4,1,3,6,5,4,4,-2,1,3,2,0,2,-1,2,3,3,4,2,-1,50,32,18,17,7,10,1,-2,34,3,11,2,-2,-3,17,9,4,5,3,1,17,-6,7,-3,-1,7,4,4,2,0,-1,1,2,3,1,0,0,6,2,1,1,0,31,23,8,48,32,16,8,-3,8,7,3,8,10,-6,4,5,3,6,-2,3,4,2,0,2,6,6,14,9,5,6,7,4,8,7,2,2,-1,2,6,2,3,4,-74,-44,-30,-60,-37,-23,-11,-1,-29,-44,7,2,-13,-3,-14,-23,1,7,2,2,-15,-21,6,-5,0,-5,-27,-25,-6,2,-1,-4,-18,-17,-3,6,1,-1,-9,-8,-3,-4,-53,-18,-35,-47,-25,-22,-24,-12,-9,-7,-1,-2,-14,-3,0,2,-3,-1,-10,-9,-9,-9,2,-1,-14,-5,-13,-9,-3,-4,-9,0,-7,-4,-4,-1,-5,-5,-6,-5,1,-3,-75,-36,-39,-40,-23,-17,-20,1,-21,-18,-4,-9,-8,0,-5,-15,-1,-6,-12,1,-16,-3,-3,-3,0,2,-14,-20,5,-14,0,1,-5,-14,3,-9,0,1,-9,-6,2,-5
43,43014,Amposta,16162,390,204,186,295,164,131,48,95,131,83,3,26,21,48,75,46,2,8,27,47,56,37,1,18,38,83,116,46,7,4,18,43,72,24,5,2,20,40,44,22,2,2,542,314,228,390,233,157,89,135,172,109,16,19,51,72,106,64,11,10,38,63,66,45,5,9,65,111,125,67,15,5,37,60,83,39,12,2,28,51,42,28,3,3,242,167,75,260,146,114,46,66,78,26,19,11,20,41,64,23,16,6,26,25,14,3,3,5,44,70,95,36,13,0,15,42,55,25,8,1,29,28,40,11,5,-1,172,82,90,36,13,23,19,40,41,47,17,10,7,12,24,28,9,5,12,28,17,19,8,5,12,13,2,10,-1,-1,2,7,-3,7,-1,0,10,6,5,3,0,-1,434,261,173,298,173,125,71,108,129,74,44,0,38,64,74,43,31,5,33,44,55,31,13,-5,55,85,96,47,15,-3,29,54,51,27,9,0,26,31,45,20,6,-3,398,226,172,232,99,133,96,95,129,22,21,29,50,59,80,17,9,8,46,36,49,5,12,21,65,79,65,14,4,3,28,31,35,6,-2,1,37,48,30,8,6,2,578,311,267,282,137,145,109,162,184,58,20,37,72,69,94,36,15,23,37,93,90,22,5,14,62,114,45,32,17,9,33,57,13,20,10,3,29,57,32,12,7,6,804,471,333,588,319,269,164,215,214,152,24,29,74,124,141,100,13,15,90,91,73,52,11,14,113,188,150,97,26,13,49,108,86,58,12,7,64,80,64,39,14,6,547,274,273,351,179,172,102,165,159,93,23,-7,50,73,103,40,6,4,52,92,56,53,17,-11,59,135,92,43,18,4,31,69,58,16,2,4,28,66,34,27,16,0,111,42,69,88,23,65,16,36,19,22,25,-11,0,20,4,4,14,-6,16,16,15,18,11,-5,21,22,24,20,3,-3,15,6,0,5,2,-5,6,16,24,15,1,2,21,-6,27,-11,-25,14,1,30,-8,-9,-1,-7,15,13,-19,-7,-5,-12,-14,17,11,-2,4,5,15,8,-24,-4,1,-9,14,-3,-21,-11,-1,-4,1,11,-3,7,2,-5,-21,8,-29,40,19,21,4,2,-48,7,-1,11,13,-6,-29,6,5,14,-9,8,-19,1,-6,-3,0,33,11,-6,-3,4,4,16,9,-14,-1,3,-4,17,2,8,-2,1,74,36,38,-16,-17,1,37,27,-1,-11,-1,11,29,9,6,-13,-2,0,8,18,-7,2,1,11,-6,27,-24,-19,3,1,-6,12,-13,-8,-3,0,0,15,-11,-11,6,1,-295,-176,-119,-101,-61,-40,-69,-38,-93,-81,2,-19,-35,-20,-63,-55,4,-9,-34,-18,-30,-26,-2,-10,-45,-8,-27,-30,5,3,-24,-7,-20,-21,6,4,-21,-1,-7,-9,-1,-1,-101,-63,-38,-74,-50,-24,0,10,-8,-91,-9,-10,8,-2,7,-65,-2,-13,-8,12,-15,-26,-7,3,-14,14,-28,-37,-4,-4,-15,7,-15,-24,0,-3,1,7,-13,-13,-4,-1,-93,-43,-50,57,25,32,-23,-21,-8,-49,10,-3,-35,-9,13,-24,8,1,12,-12,-21,-25,2,-4,-5,13,28,1,13,5,-9,7,17,2,5,1,4,6,11,-1,8,4,112,37,75,91,42,49,42,12,23,29,8,-2,35,-10,5,10,-3,-4,7,22,18,19,11,2,14,17,37,9,10,3,11,6,18,4,0,1,3,11,19,5,10,2,189,110,79,116,77,39,58,28,12,38,23,29,21,19,3,25,24,14,37,9,9,13,-1,15,39,22,35,18,-3,2,23,18,23,6,3,-1,16,4,12,12,-6,3
43,43016,"Arboç, L'",3485,118,56,62,76,46,30,24,41,25,20,12,-2,12,22,15,6,5,-2,12,19,10,14,7,0,14,24,23,11,2,2,11,13,16,6,0,0,3,11,7,5,2,2,202,108,94,108,66,42,49,47,56,38,6,4,18,36,27,22,3,2,31,11,29,16,3,2,28,26,32,19,2,0,12,21,20,12,1,0,16,5,12,7,1,0,123,67,56,80,46,34,38,43,17,15,9,-1,23,22,7,12,5,-2,15,21,10,3,4,1,19,28,20,11,1,0,12,13,12,8,1,0,7,15,8,3,0,0,212,156,56,139,88,51,46,33,59,43,18,12,36,20,47,31,10,11,10,13,12,12,8,1,37,33,46,20,2,1,24,21,31,10,2,0,13,12,15,10,0,1,202,137,65,132,91,41,29,72,60,13,14,9,17,50,43,12,7,3,12,22,17,1,7,6,22,52,33,13,7,3,14,39,24,9,2,2,8,13,9,4,5,1,248,142,106,120,71,49,49,76,78,22,15,-1,22,50,45,16,2,2,27,26,33,6,13,-3,24,42,28,20,5,-1,9,29,17,14,2,-1,15,13,11,6,3,0,217,127,90,75,43,32,37,74,41,37,14,7,20,39,40,14,7,2,17,35,1,23,7,5,11,39,20,4,1,-2,5,20,14,1,2,-1,6,19,6,3,-1,-1,277,131,146,165,87,78,75,72,77,35,4,15,40,42,29,19,-1,5,35,30,48,16,5,10,35,56,47,20,3,2,17,28,28,10,0,2,18,28,19,10,3,0,-12,-17,5,34,12,22,-5,-5,-30,11,11,4,-10,-4,-18,6,3,4,5,-1,-12,5,8,0,13,3,6,8,3,0,10,-6,1,5,2,0,3,9,5,3,1,0,9,-16,25,-18,-26,8,-2,11,18,-11,-1,-11,-11,0,-4,-6,2,-1,9,11,22,-5,-3,-10,-7,1,-3,-12,-3,2,-11,-3,-6,-7,-1,1,4,4,3,-5,-2,1,49,20,29,79,35,44,0,10,10,10,8,5,4,-6,4,12,5,-4,-4,16,6,-2,3,9,20,13,22,16,3,4,14,1,9,10,0,1,6,12,13,6,3,3,-61,-31,-30,36,13,23,-30,17,-18,-12,-9,-7,-21,18,-3,-9,-11,-3,-9,-1,-15,-3,2,-4,0,22,9,2,0,3,1,12,3,-1,-3,1,-1,10,6,3,3,2,27,29,-2,21,18,3,22,-2,28,-1,-17,-3,17,5,22,-6,-8,-2,5,-7,6,5,-9,-1,9,5,11,3,-5,-4,5,5,9,0,-2,-1,4,0,2,3,-3,-3,-22,-10,-12,-5,-4,-1,-21,3,1,-17,8,7,-4,-4,5,-14,5,4,-17,7,-4,-3,3,3,-8,6,3,-7,1,0,-4,3,2,-5,0,0,-4,3,1,-2,1,0,1,-1,2,1,-3,4,17,-6,10,-6,-6,-8,8,-4,-2,-4,-3,1,9,-2,12,-2,-3,-9,3,8,4,-13,-2,0,3,3,0,-10,0,0,0,5,4,-3,-2,0,-36,-35,-1,4,-3,7,-2,2,-7,-34,0,6,-3,-2,-11,-26,6,3,1,4,4,-8,-6,3,-4,8,-1,-1,0,2,-3,3,-2,-1,0,0,-1,5,1,0,0,2,-26,-13,-13,-4,-3,-1,-26,10,-17,-1,-1,7,-17,8,-9,7,-4,0,-9,2,-8,-8,3,7,-10,10,-9,-1,5,-1,-9,4,-4,3,3,-1,-1,6,-5,-4,2,0,35,22,13,49,21,28,12,28,-16,15,-5,-6,9,8,-2,10,-7,-1,3,20,-14,5,2,-5,25,21,-6,3,1,3,16,7,-4,-3,1,2,9,14,-2,6,0,1
43,43020,Banyeres del Penedès,1647,52,43,9,37,27,10,8,14,26,-3,10,-2,8,16,20,-6,9,-2,0,-2,6,3,1,0,6,13,13,4,1,0,3,11,10,2,1,0,3,2,3,2,0,0,72,29,43,34,23,11,13,10,28,13,3,6,3,4,13,7,0,3,10,6,15,6,3,3,0,14,13,4,1,2,0,9,9,4,0,1,0,5,4,0,1,1,25,17,8,31,26,5,4,1,7,2,11,1,4,0,2,3,7,1,0,1,5,-1,4,0,0,10,15,4,2,0,0,10,11,4,1,0,0,0,4,0,1,0,154,70,84,10,5,5,40,18,47,34,3,10,22,9,16,20,0,2,18,9,31,14,3,8,1,1,5,3,0,0,0,0,2,3,0,0,1,1,3,0,0,0,227,99,128,22,10,12,63,28,79,36,19,2,28,1,40,23,9,-2,35,27,39,13,10,4,3,4,10,4,2,0,1,0,5,3,2,0,2,4,5,1,0,0,216,101,115,25,12,13,54,26,71,46,14,3,24,16,31,19,7,3,30,10,40,27,7,0,6,5,10,4,0,0,2,3,5,2,0,0,4,2,5,2,0,0,144,70,74,22,15,7,31,12,31,45,15,9,17,1,16,23,8,6,14,11,15,22,7,3,2,7,3,3,5,2,1,3,3,4,3,1,1,4,0,-1,2,1,123,59,64,34,16,18,30,3,14,41,21,8,13,0,5,22,12,3,17,3,9,19,9,5,3,11,6,7,5,1,1,4,4,3,2,1,2,7,2,4,3,0,81,58,23,27,13,14,19,9,28,12,2,9,12,8,16,12,4,5,7,1,12,0,-2,4,5,7,8,4,2,0,3,4,3,1,2,0,2,3,5,3,0,0,-18,-5,-13,-2,-3,1,-3,-3,1,-5,-5,-3,4,1,-8,-3,1,0,-7,-4,9,-2,-6,-3,-1,2,-2,-1,1,-2,0,0,-2,0,0,-1,-1,2,0,-1,1,-1,41,8,33,11,6,5,30,-9,12,18,-9,-4,3,-7,10,8,-3,-5,27,-2,2,10,-6,1,0,3,4,3,0,1,0,0,2,3,1,0,0,3,2,0,-1,1,0,-2,2,7,1,6,-4,-1,7,-4,-2,6,-1,1,6,-7,-2,3,-3,-2,1,3,0,3,-1,2,6,1,-1,0,-2,1,3,0,-1,0,1,1,3,1,0,0,17,-1,18,-15,-11,-4,2,-1,8,-4,2,11,1,-7,4,1,-4,5,1,6,4,-5,6,6,0,-1,-3,-9,1,-3,0,-2,-2,-6,0,-1,0,1,-1,-3,1,-2,-2,-4,2,2,-5,7,-7,9,14,-1,-10,-7,-3,5,10,-5,-5,-5,-4,4,4,4,-5,-2,2,3,1,-2,-1,-1,0,0,0,-2,-2,-1,2,3,1,0,1,0,32,6,26,8,0,8,-3,11,25,-13,8,2,4,4,7,-12,4,0,-7,7,18,-1,4,2,-1,2,3,2,1,0,-1,0,1,1,-1,0,0,2,2,1,2,0,-16,-8,-8,-2,-11,9,-8,1,-10,3,-3,3,-2,2,-10,3,2,-2,-6,-1,0,0,-5,5,-1,5,-3,0,-3,0,0,-1,-3,-4,-3,0,-1,6,0,4,0,0,27,8,19,13,10,3,11,-10,36,-4,0,-5,6,-5,15,1,-5,-3,5,-5,21,-5,5,-2,0,3,7,5,0,-2,2,0,5,5,-1,-1,-2,3,2,0,1,-1,17,15,2,10,10,0,15,-4,14,-3,3,-4,7,-1,6,1,6,-2,8,-3,8,-4,-3,-2,1,1,6,0,3,0,1,2,3,1,4,0,0,-1,3,-1,-1,0
43,43021,Barberà de la Conca,405,8,0,8,5,1,4,1,2,10,-1,-2,-2,0,-1,6,-2,-1,-2,1,3,4,1,-1,0,0,0,5,0,0,0,0,0,1,0,0,0,0,0,4,0,0,0,18,9,9,12,6,6,2,5,3,5,3,-2,1,4,1,1,2,-1,1,1,2,4,1,-1,1,5,4,2,0,0,0,4,2,0,0,0,1,1,2,2,0,0,17,13,4,7,4,3,3,5,7,4,1,-3,6,2,4,2,0,-1,-3,3,3,2,1,-2,0,5,2,0,0,0,0,2,2,0,0,0,0,3,0,0,0,0,12,11,1,5,5,0,5,-1,1,8,2,-3,3,0,1,7,2,-2,2,-1,0,1,0,-1,0,0,2,2,1,0,0,0,2,2,1,0,0,0,0,0,0,0,42,21,21,23,9,14,14,1,20,7,3,-3,5,0,11,4,1,0,9,1,9,3,2,-3,10,0,10,3,0,0,4,0,5,0,0,0,6,0,5,3,0,0,17,7,10,7,4,3,-2,10,-3,9,4,-1,0,4,-4,4,4,-1,-2,6,1,5,0,0,0,3,0,4,0,0,0,2,0,2,0,0,0,1,0,2,0,0,16,15,1,17,10,7,2,5,6,1,2,0,0,3,4,5,2,1,2,2,2,-4,0,-1,5,2,4,4,2,0,4,1,2,2,1,0,1,1,2,2,1,0,14,12,2,9,4,5,0,2,6,2,4,0,2,1,3,2,3,1,-2,1,3,0,1,-1,2,3,3,1,0,0,1,1,1,1,0,0,1,2,2,0,0,0,21,14,7,10,4,6,3,3,2,8,2,2,2,1,3,4,2,1,1,2,-1,4,0,1,3,2,2,2,1,0,1,0,2,0,1,0,2,2,0,2,0,0,4,-1,5,-3,-2,-1,1,-4,3,3,-1,2,-1,-1,2,1,-2,0,2,-3,1,2,1,2,1,-1,-1,0,-2,0,0,0,0,-1,-1,0,1,-1,-1,1,-1,0,5,1,4,3,1,2,5,-5,12,-7,1,-1,4,-6,4,-2,1,0,1,1,8,-5,0,-1,1,0,2,-3,1,2,1,0,1,-3,1,1,0,0,1,0,0,1,-9,-3,-6,-1,-1,0,-3,0,-4,1,0,-2,0,-2,-1,0,1,-1,-3,2,-3,1,-1,-1,1,0,-1,0,-1,0,1,-1,-1,0,0,0,0,1,0,0,-1,0,-1,-3,2,-4,-4,0,-7,1,-3,9,-2,1,-4,1,-5,7,-3,1,-3,0,2,2,1,0,-2,0,-1,0,-1,0,-1,0,-1,-1,-1,0,-1,0,0,1,0,0,-5,-3,-2,3,2,1,0,0,-3,-2,-2,2,1,-1,-2,-2,0,1,-1,1,-1,0,-2,1,0,1,1,0,1,0,0,0,1,0,1,0,0,1,0,0,0,0,-8,-12,4,-5,-2,-3,-2,2,1,-7,-1,0,-3,1,-3,-5,-2,1,1,1,4,-2,1,-1,-4,0,-1,-1,1,0,-2,0,0,-1,0,1,-2,0,-1,0,1,-1,-25,-11,-14,-11,-6,-5,-4,-3,-10,-4,-1,-3,-3,-1,-2,-4,0,-1,-1,-2,-8,0,-1,-2,-1,0,-3,-4,-1,-2,-1,0,-1,-3,0,-1,0,0,-2,-1,-1,-1,-6,-2,-4,-5,-3,-2,-1,2,0,-5,-1,-2,0,2,0,-3,0,-1,-1,0,0,-2,-1,-1,-2,0,-2,-1,0,0,-1,0,-1,-1,0,0,-1,0,-1,0,0,0,1,4,-3,6,4,2,1,-1,3,2,-6,1,3,1,2,2,-5,0,-2,-2,1,0,-1,1,1,1,3,1,0,0,0,1,2,1,0,0,1,0,1,0,0,0
43,43022,Batea,1970,45,33,12,45,31,14,2,22,17,7,-2,-2,4,17,6,6,-1,0,-2,5,11,1,-1,-2,2,23,15,5,0,0,2,19,8,2,0,0,0,4,7,3,0,0,40,23,17,36,19,17,3,18,4,9,4,2,2,9,3,5,3,1,1,9,1,4,1,1,3,16,8,6,2,1,2,9,5,3,0,0,1,7,3,3,2,1,38,21,17,41,23,18,7,14,13,15,0,-12,4,6,8,8,0,-6,3,8,5,7,0,-6,5,13,11,12,0,0,3,7,8,5,0,0,2,6,3,7,0,0,26,13,13,33,20,13,11,9,-4,7,0,3,4,8,-4,2,1,2,7,1,0,5,-1,1,10,9,9,5,2,-2,5,9,4,3,1,-2,5,0,5,2,1,0,36,22,14,44,26,18,4,16,-2,10,8,0,1,12,1,4,3,1,3,4,-3,6,5,-1,6,18,10,8,2,0,2,12,8,3,1,0,4,6,2,5,1,0,18,18,0,29,21,8,2,8,0,8,1,-2,0,7,1,10,0,0,2,1,-1,-2,1,-2,2,9,9,7,1,0,1,6,7,6,1,0,1,3,2,1,0,0,5,-1,6,32,15,17,0,7,1,-1,-1,-1,-1,4,0,0,-3,-1,1,3,1,-1,2,0,1,9,12,11,-1,0,-1,4,8,6,-2,0,2,5,4,5,1,0,59,38,21,73,49,24,0,24,11,18,2,3,4,14,12,8,-1,1,-4,10,-1,10,3,2,4,23,21,21,1,2,3,15,16,14,0,1,1,8,5,7,1,1,4,2,2,10,5,5,9,6,-10,2,-7,4,3,3,-6,1,-2,3,6,3,-4,1,-5,1,2,7,-1,1,-1,2,1,2,-1,2,0,1,1,5,0,-1,-1,1,12,9,3,11,7,4,0,9,0,-4,5,4,1,3,4,-1,3,0,-1,6,-4,-3,2,4,0,5,3,2,1,1,1,2,3,1,0,1,-1,3,0,1,1,0,-15,-5,-10,5,2,3,-5,-2,-7,3,-1,-2,-4,1,-5,5,-1,0,-1,-3,-2,-2,0,-2,2,2,0,2,-1,0,1,1,0,1,-1,0,1,1,0,1,0,0,4,4,0,7,4,3,-2,-2,10,-3,-1,2,0,-1,6,-2,0,0,-2,-1,4,-1,-1,2,2,-1,4,1,1,0,2,-1,3,-1,1,0,0,0,1,2,0,0,-12,-10,-2,-2,0,-2,-1,-1,-4,-1,-4,0,2,-4,-4,-1,-2,0,-3,3,0,0,-2,0,-1,1,-3,1,0,0,0,0,0,0,0,0,-1,1,-3,1,0,0,-91,-68,-23,-101,-68,-33,-8,0,-57,-27,-11,12,-6,-1,-40,-18,-6,3,-2,1,-17,-9,-5,9,-7,-1,-52,-29,-11,-1,-3,-2,-39,-19,-5,0,-4,1,-13,-10,-6,-1,-33,-20,-13,-45,-30,-15,-3,11,-20,-15,-10,1,-3,5,-6,-11,-9,1,0,6,-14,-4,-1,0,-3,6,-18,-17,-12,-1,-3,2,-8,-13,-8,0,0,4,-10,-4,-4,-1,36,22,14,30,16,14,15,12,-4,6,6,1,9,11,-1,1,3,-1,6,1,-3,5,3,2,10,11,5,3,2,-1,6,8,2,0,1,-1,4,3,3,3,1,0,9,7,2,26,14,12,-3,4,0,5,1,2,-2,5,-1,5,-2,2,-1,-1,1,0,3,0,4,9,3,8,2,0,2,6,1,5,0,0,2,3,2,3,2,0,-3,1,-4,10,5,5,0,1,2,-3,-2,-2,0,0,1,0,-1,0,0,1,1,-3,-1,-2,3,0,3,4,0,0,2,0,1,2,0,0,1,0,2,2,0,0
43,43026,Benissanet,1017,16,12,4,14,9,5,0,3,6,4,3,-1,0,3,3,4,1,0,0,0,3,0,2,-1,1,2,6,3,2,0,1,2,3,2,1,0,0,0,3,1,1,0,21,16,5,16,7,9,-1,2,9,9,1,1,-2,4,6,7,0,1,1,-2,3,2,1,0,3,2,5,4,1,0,1,2,2,2,0,0,2,0,3,2,1,0,43,34,9,33,27,6,1,18,9,10,2,3,0,17,9,5,0,3,1,1,0,5,2,0,2,12,12,6,1,0,1,10,11,5,0,0,1,2,1,1,1,0,17,6,11,13,10,3,0,8,3,0,5,1,0,4,1,0,2,-1,0,4,2,0,3,2,0,3,6,4,0,0,0,3,5,2,0,0,0,0,1,2,0,0,51,30,21,64,35,29,0,11,25,6,8,1,1,5,15,3,6,0,-1,6,10,3,2,1,1,18,26,12,6,1,1,10,14,6,4,0,0,8,12,6,2,1,67,41,26,43,20,23,6,15,21,11,7,6,2,9,9,10,6,4,4,6,12,1,1,2,2,13,16,6,5,1,0,9,3,4,3,1,2,4,13,2,2,0,48,37,11,44,23,21,11,15,14,6,2,-2,9,9,16,3,0,-1,2,6,-2,3,2,-1,10,12,7,12,1,1,6,7,5,5,0,0,4,5,2,7,1,1,20,16,4,35,24,11,5,4,0,4,6,-1,3,2,4,3,3,1,2,2,-4,1,3,-2,3,10,9,8,3,1,2,6,8,6,1,1,1,4,1,2,2,0,-3,-4,1,15,8,7,-6,13,-10,-1,1,0,-4,7,-7,1,0,-1,-2,6,-3,-2,1,1,2,14,-6,4,1,0,2,6,-5,5,0,0,0,8,-1,-1,1,0,26,20,6,23,17,6,4,1,16,-2,5,1,0,4,12,-1,4,1,4,-3,4,-1,1,0,1,1,13,3,3,1,0,2,10,1,3,1,1,-1,3,2,0,0,-2,8,-10,-6,-2,-4,3,1,-9,0,1,0,2,1,2,1,2,0,1,0,-11,-1,-1,0,4,5,-15,-1,0,0,2,2,-7,0,1,0,2,3,-8,-1,-1,0,37,31,6,31,21,10,4,11,13,-1,9,1,2,7,15,0,5,2,2,4,-2,-1,4,-1,4,10,11,1,4,1,3,7,8,0,2,1,1,3,3,1,2,0,1,-3,4,-7,-9,2,1,6,-4,5,2,-7,0,1,-2,3,1,-5,1,5,-2,2,1,-2,1,-2,-3,-1,-2,0,1,-3,-4,-1,-2,0,0,1,1,0,0,0,-18,-8,-10,4,0,4,-3,-3,-2,-3,-1,-7,-4,0,0,-1,-4,0,1,-3,-2,-2,3,-7,2,2,-2,1,1,0,1,2,-3,1,-1,0,1,0,1,0,2,0,4,9,-5,-9,-7,-2,-3,5,4,-6,-1,6,0,3,5,-1,-1,3,-3,2,-1,-5,0,3,0,3,-5,-2,-3,-2,0,0,-1,-1,-4,-1,0,3,-4,-1,1,-1,-21,-23,2,-6,-6,0,-1,1,-7,-7,-3,-4,1,-3,-11,-4,-4,-2,-2,4,4,-3,1,-2,1,2,-5,-3,-4,3,3,0,-5,-1,-5,2,-2,2,0,-2,1,1,-34,-13,-21,-6,-1,-5,-5,0,-15,-2,-4,-7,-2,2,-7,-5,1,-2,-3,-2,-8,3,-5,-5,-1,1,-4,0,-1,-1,1,1,-2,-2,1,0,-2,0,-2,2,-2,-1,-8,-7,-1,1,3,-2,-3,3,-1,-3,-3,-1,-3,3,4,-7,-3,-1,0,0,-5,4,0,0,-1,2,4,1,-2,-3,0,2,5,0,-2,-2,-1,0,-1,1,0,-1
43,43036,Cabra del Camp,560,44,18,26,4,1,3,16,3,4,7,10,3,6,0,-1,5,6,2,10,3,5,2,4,1,2,1,0,1,0,0,0,0,0,1,0,0,2,1,0,0,0,0,32,25,7,16,10,6,4,5,10,8,1,4,7,5,5,4,2,2,-3,0,5,4,-1,2,3,4,2,4,0,3,1,4,1,3,0,1,2,0,1,1,0,2,54,24,30,9,4,5,10,13,13,7,13,-2,8,4,2,1,9,-1,2,9,11,6,4,-1,3,1,3,1,0,0,2,0,1,0,0,0,1,1,2,1,0,0,57,28,29,11,6,5,7,-9,44,10,2,2,1,-5,23,8,-1,2,6,-4,21,2,3,0,2,1,3,4,0,0,0,0,3,3,0,0,2,1,0,1,0,0,62,34,28,10,6,4,8,12,16,14,14,-3,3,3,10,10,7,0,5,9,6,4,7,-3,1,1,5,2,1,0,1,0,3,1,1,0,0,1,2,1,0,0,78,44,34,11,10,1,4,15,28,12,11,7,0,7,20,6,5,5,4,8,8,6,6,2,-2,2,2,6,2,1,0,1,2,5,1,1,-2,1,0,1,1,0,67,27,40,19,11,8,14,22,7,2,18,3,7,13,1,1,5,0,7,9,6,1,13,3,5,7,0,2,3,2,3,5,1,0,1,1,2,2,-1,2,2,1,63,34,29,9,3,6,12,9,21,18,2,-1,6,5,13,9,2,-2,6,4,8,9,0,1,-1,5,3,-2,1,3,-2,3,1,-1,1,1,1,2,2,-1,0,2,40,25,15,15,11,4,12,-5,23,6,8,-4,8,-3,12,5,5,-2,4,-2,11,1,3,-2,7,4,1,3,1,-1,5,3,1,1,1,0,2,1,0,2,0,-1,26,14,12,-1,-2,1,8,3,14,-6,7,-1,6,1,8,-2,2,-1,2,2,6,-4,5,0,2,0,1,-4,0,0,0,-1,1,-2,0,0,2,1,0,-2,0,0,9,-1,10,0,2,-2,5,-4,2,3,0,2,5,-6,2,-4,1,0,0,2,0,7,-1,2,5,-2,1,-2,-3,1,5,-1,2,-3,-1,0,0,-1,-1,1,-2,1,0,-11,11,1,-1,2,-5,3,-2,1,3,-1,-4,0,-2,-2,-3,-1,-1,3,0,3,6,0,0,-1,1,1,1,-1,0,-1,0,1,-1,0,0,0,1,0,2,-1,-2,1,-3,6,2,4,-6,6,2,-6,1,-2,-4,5,3,-4,1,-3,-2,1,-1,-2,0,1,1,2,0,2,1,0,1,2,-1,0,0,0,0,0,1,2,1,0,-41,-24,-17,-4,0,-4,-13,-4,-13,-7,2,-2,-8,-6,-4,-5,2,1,-5,2,-9,-2,0,-3,1,-2,-1,-1,0,-1,0,0,0,0,0,0,1,-2,-1,-1,0,-1,-3,-2,-1,-6,-2,-4,-1,-4,-8,2,3,4,-3,-5,1,2,2,0,2,1,-9,0,1,4,-3,1,-1,-3,-2,2,-1,1,1,-2,-1,0,-2,0,-2,-1,-1,2,7,8,-1,-1,-1,0,2,4,9,-2,0,-6,2,0,9,-2,0,-1,0,4,0,0,0,-5,0,-1,0,0,0,0,0,-1,0,0,0,0,0,0,0,0,0,0,18,12,6,12,5,7,9,3,7,-5,-1,5,6,1,3,1,-1,2,3,2,4,-6,0,3,4,1,3,3,1,0,1,0,3,1,0,0,3,1,0,2,1,0,18,7,11,9,3,6,8,8,8,-3,3,-6,2,5,7,-5,2,-4,6,3,1,2,1,-2,4,0,1,2,0,2,1,0,0,1,0,1,3,0,1,1,0,1
43,43037,Calafell,11106,939,465,474,300,154,146,144,155,207,184,184,57,70,65,117,100,85,27,74,90,90,84,99,30,75,56,94,39,24,10,38,32,45,20,11,6,37,24,49,19,13,4,1199,631,568,410,209,201,178,197,297,236,199,86,95,93,175,114,107,41,83,104,122,122,92,45,75,98,147,58,20,9,38,51,72,33,9,4,37,47,75,25,11,5,1393,683,710,444,226,218,199,210,350,327,224,76,82,113,192,162,99,35,117,97,158,165,125,41,86,98,136,73,43,6,39,52,83,29,21,2,47,46,53,44,22,4,1501,804,697,457,236,221,225,228,385,315,258,82,131,127,214,147,148,30,94,101,171,168,110,52,93,116,113,71,48,13,44,57,69,38,20,5,49,59,44,33,28,8,1543,821,722,481,257,224,166,223,477,271,245,136,87,126,254,149,134,56,79,97,223,122,111,80,80,123,146,66,34,25,36,74,86,33,16,7,44,49,60,33,18,18,1577,826,751,523,268,255,292,247,524,307,147,45,157,136,269,180,57,16,135,111,255,127,90,29,95,131,177,64,41,13,43,77,85,37,18,8,52,54,92,27,23,5,1500,750,750,470,264,206,240,239,454,244,220,82,112,126,248,129,103,25,128,113,206,115,117,57,79,134,133,76,31,13,47,77,78,41,13,6,32,57,55,35,18,7,1009,531,478,602,339,263,134,217,291,156,165,47,45,125,192,73,80,22,89,92,99,83,85,25,74,168,192,89,55,20,30,98,120,55,27,9,44,70,72,34,28,11,302,148,154,14,-36,50,73,64,23,49,26,55,49,26,21,0,20,26,24,38,2,49,6,29,16,48,-11,-20,-12,-14,0,10,-20,-23,-7,-3,16,38,9,3,-5,-11,283,95,188,-21,-64,43,5,83,9,62,99,31,6,23,-24,32,42,28,-1,60,33,30,57,3,12,33,-15,-32,-14,-9,0,6,-35,-32,-2,-2,12,27,20,0,-12,-7,376,234,142,114,38,76,88,37,100,73,37,34,58,35,51,46,29,10,30,2,49,27,8,24,24,16,38,13,20,-2,11,3,16,2,7,-4,13,13,22,11,13,2,-381,-213,-168,-362,-230,-132,-75,-22,-120,-112,-42,-7,-19,-3,-75,-86,-26,-7,-56,-19,-45,-26,-16,0,-22,-46,-101,-102,-59,-33,-6,-22,-69,-80,-36,-17,-16,-24,-32,-22,-23,-16,-158,-166,8,-170,-107,-63,-36,-14,-62,-20,-43,12,-46,-11,-44,-34,-35,-5,10,-3,-18,14,-8,17,-25,-6,-54,-46,-25,-17,-11,-5,-34,-33,-14,-12,-14,-1,-20,-13,-11,-5,-263,-115,-148,5,5,0,-67,-22,-41,-90,-10,-33,0,-2,-21,-55,-25,-8,-67,-20,-20,-35,15,-25,-1,14,4,-25,14,-7,9,10,0,-17,3,-3,-10,4,4,-8,11,-4,-73,-27,-46,-85,-45,-40,-15,24,-90,-7,12,14,-20,25,-48,-4,18,7,5,-1,-42,-3,-6,7,-29,9,-31,-36,3,-1,-13,8,-14,-23,-3,0,-16,1,-17,-13,6,-1,100,32,68,56,23,33,5,40,-11,-17,67,18,8,30,-14,-5,20,-2,-3,10,3,-12,47,20,2,24,22,-10,20,-5,-2,25,3,-9,12,-4,4,-1,19,-1,8,-1,663,371,292,269,128,141,86,87,130,156,79,101,51,51,74,78,46,59,35,36,56,78,33,42,40,55,76,50,21,17,27,23,38,19,10,7,13,32,38,31,11,10,656,335,321,352,191,161,90,64,162,137,138,56,50,42,79,66,68,23,40,22,83,71,70,33,65,64,107,58,38,16,39,33,66,28,16,6,26,31,41,30,22,10
43,43903,Camarles,2914,9,12,-3,27,16,11,-3,4,10,5,3,-10,-1,6,3,8,1,-5,-2,-2,7,-3,2,-5,3,4,10,9,0,1,2,3,5,6,0,0,1,1,5,3,0,1,7,9,-2,16,5,11,2,1,5,-4,6,-3,0,-2,6,1,3,1,2,3,-1,-5,3,-4,5,5,5,1,0,0,1,1,2,1,0,0,4,4,3,0,0,0,-22,-14,-8,0,1,-1,7,-13,-14,-1,2,-3,2,-5,-8,-1,1,-3,5,-8,-6,0,1,0,-1,1,0,0,0,0,0,1,0,0,0,0,-1,0,0,0,0,0,13,11,2,25,14,11,10,0,-4,5,3,-1,7,2,-3,6,0,-1,3,-2,-1,-1,3,0,10,2,6,2,4,1,5,2,3,2,1,1,5,0,3,0,3,0,138,67,71,141,71,70,25,29,52,13,10,8,8,7,34,11,3,4,17,22,18,2,7,4,21,43,47,20,10,0,8,15,32,12,4,0,13,28,15,8,6,0,111,66,45,116,66,50,17,28,38,11,14,1,10,16,23,7,5,3,7,12,15,4,9,-2,19,35,36,15,10,0,10,18,24,8,5,0,9,17,12,7,5,0,121,65,56,154,73,81,25,41,33,9,8,4,12,15,24,4,7,2,13,26,9,5,1,2,33,53,39,18,8,2,14,21,22,11,3,1,19,32,17,7,5,1,166,89,77,155,81,74,26,46,20,44,17,8,14,23,12,24,10,4,12,23,8,20,7,4,25,45,40,31,8,2,11,20,25,18,5,1,14,25,15,13,3,1,-75,-47,-28,-78,-45,-33,17,-23,-29,-30,-6,-5,10,-10,-25,-21,0,-2,7,-13,-4,-9,-6,-3,16,-20,-31,-30,-11,-3,8,-6,-24,-18,-4,-2,8,-14,-7,-12,-7,-1,59,30,29,35,14,21,14,13,16,12,6,-3,11,2,7,6,5,-2,3,11,9,6,1,-1,12,9,11,3,0,-1,7,1,1,2,2,0,5,8,10,1,-2,-1,-20,-5,-15,-3,-2,-1,-3,-4,-18,1,7,0,1,0,-11,1,4,1,-4,-4,-7,0,3,-1,-5,3,-3,0,3,-1,0,0,0,-2,1,-1,-5,3,-3,2,2,0,2,3,-1,-1,4,-5,4,2,-6,1,0,-1,1,1,-2,-1,3,1,3,1,-4,2,-3,-2,0,0,-2,1,-1,1,2,0,0,2,0,0,-2,0,-2,-1,-1,1,17,10,7,15,7,8,4,2,-6,9,6,2,0,1,-3,6,6,0,4,1,-3,3,0,2,2,0,3,6,1,2,0,-1,3,3,0,2,2,1,0,3,1,0,-6,-4,-2,12,4,8,-9,3,-6,-1,0,6,-7,2,-2,3,-4,4,-2,1,-4,-4,4,2,1,4,-1,3,4,1,0,1,-1,2,1,1,1,3,0,1,3,0,-42,-23,-19,-57,-32,-25,0,-15,-19,-17,2,7,7,-10,-14,-7,0,0,-7,-5,-5,-10,2,7,-3,-7,-23,-18,-6,-1,1,-5,-12,-12,-4,-1,-4,-2,-11,-6,-2,0,40,26,14,32,14,18,8,6,5,2,13,3,6,4,-3,7,7,3,2,2,8,-5,6,0,5,3,7,5,8,2,1,0,3,4,4,1,4,3,4,1,4,1,-29,-18,-11,12,5,7,-5,6,-16,-7,1,-10,-3,4,-7,-7,-1,-5,-2,2,-9,0,2,-5,1,3,4,1,1,1,2,2,1,-1,0,0,-1,1,3,2,1,1,28,10,18,34,20,14,-2,9,10,7,8,-4,-1,9,2,1,3,-4,-1,0,8,6,5,0,4,10,5,10,6,-1,2,7,2,6,3,0,2,3,3,4,3,-1
43,43038,Cambrils,19087,488,232,256,30,16,14,78,81,101,87,93,48,44,48,58,35,40,10,34,33,43,52,53,38,3,6,7,4,8,1,2,4,5,1,3,0,1,2,2,3,5,1,520,258,262,28,17,11,82,47,191,87,54,55,36,24,93,48,32,24,46,23,98,39,22,31,14,0,4,2,4,2,11,0,2,1,1,1,3,0,2,1,3,1,1138,523,615,560,263,297,160,232,330,213,116,84,84,100,169,103,45,19,76,132,161,110,71,65,98,144,158,97,49,10,45,63,80,50,21,3,53,81,78,47,28,7,1140,583,557,631,332,299,183,155,366,185,143,91,102,77,187,100,68,41,81,78,179,85,75,50,112,128,164,119,81,24,65,65,87,68,31,14,47,63,77,51,50,10,1374,677,697,709,329,380,178,201,427,220,185,153,88,86,224,110,99,56,90,115,203,110,86,97,112,157,185,133,80,35,43,66,101,66,36,13,69,91,84,67,44,22,1407,680,727,718,368,350,184,191,470,219,177,154,88,91,232,107,91,68,96,100,238,112,86,86,108,161,213,106,88,34,49,76,124,53,46,17,59,85,89,53,42,17,1449,709,740,799,415,384,199,273,400,307,125,130,87,141,190,180,51,55,112,132,210,127,74,75,131,208,201,134,80,34,68,104,105,74,38,20,63,104,96,60,42,14,1613,868,745,1106,574,532,231,315,524,315,123,107,96,166,300,193,69,40,135,149,224,122,54,67,154,282,338,192,99,37,64,135,182,121,54,15,90,147,156,71,45,22,633,275,358,330,150,180,81,129,151,110,62,87,50,57,58,57,19,25,31,72,93,53,43,62,61,117,64,55,14,9,39,56,20,22,6,0,22,61,44,33,8,9,529,222,307,212,81,131,53,163,90,72,85,62,23,55,49,43,35,13,30,108,41,29,50,49,56,103,-1,25,22,-1,30,34,4,3,2,3,26,69,-5,22,20,-4,451,168,283,144,45,99,69,20,124,84,48,103,15,19,30,37,42,23,54,1,94,47,6,80,43,30,38,33,-11,8,23,1,3,15,-1,1,20,29,35,18,-10,7,393,171,222,222,125,97,33,80,86,-18,86,125,15,29,55,-10,27,49,18,51,31,-8,59,76,58,49,48,6,50,5,32,19,32,9,25,4,26,30,16,-3,25,1,147,29,118,-6,-22,16,-22,35,64,-11,25,53,-15,2,21,-22,6,31,-7,33,43,11,19,22,-7,20,-6,-18,-3,2,1,4,-4,-19,-9,3,-8,16,-2,1,6,-1,32,-39,71,-220,-133,-87,29,23,-68,-26,-4,77,-9,19,-32,-21,-23,34,38,4,-36,-5,19,43,-9,-15,-91,-75,-26,-8,-3,-9,-48,-52,-22,1,-6,-6,-43,-23,-4,-9,-339,-214,-125,-483,-270,-213,15,-12,-77,-162,-127,5,7,-7,-64,-87,-77,6,8,-5,-13,-75,-50,-1,-15,-26,-157,-152,-104,-37,-8,-10,-100,-84,-58,-14,-7,-16,-57,-68,-46,-23,329,112,217,280,116,164,57,3,96,33,34,95,40,-1,34,-2,10,24,17,4,62,35,24,71,45,39,72,58,36,26,16,17,37,28,8,10,29,22,35,30,28,16,-606,-330,-276,-720,-393,-327,-27,-74,-152,-227,-46,-94,5,-25,-78,-162,-23,-52,-32,-49,-74,-65,-23,-42,-19,-46,-154,-270,-107,-133,1,-19,-75,-180,-60,-65,-20,-27,-79,-90,-47,-68,638,279,359,398,158,240,148,58,158,131,56,69,75,21,69,54,11,36,73,37,89,77,45,33,110,50,120,58,32,14,45,20,52,22,-2,12,65,30,68,36,34,2
43,43043,"Catllar, El",2120,116,44,72,25,11,14,36,19,26,27,18,-12,16,10,8,9,10,-8,20,9,18,18,8,-4,4,7,6,4,3,0,2,3,3,1,2,0,2,4,3,3,1,0,108,53,55,16,7,9,18,8,26,32,14,10,4,2,18,16,9,4,14,6,8,16,5,6,3,5,0,4,2,2,0,2,0,2,2,1,3,3,0,2,0,1,183,93,90,43,21,22,57,19,52,45,7,-2,27,13,19,23,8,1,30,6,33,22,-1,-3,14,11,9,8,1,0,6,5,6,3,1,0,8,6,3,5,0,0,219,110,109,26,12,14,53,22,55,49,22,13,29,2,25,32,15,3,24,20,30,17,7,10,7,5,8,3,2,1,4,1,4,1,2,0,3,4,4,2,0,1,105,56,49,30,14,16,8,11,28,46,23,-9,5,11,8,26,12,-6,3,0,20,20,11,-3,2,7,12,5,4,0,1,3,6,3,1,0,1,4,6,2,3,0,300,182,118,37,17,20,55,28,111,53,33,14,43,21,54,27,21,11,12,7,57,26,12,3,5,4,17,4,6,1,2,2,8,1,3,1,3,2,9,3,3,0,231,112,119,34,17,17,48,3,72,52,31,8,24,-4,38,26,21,2,24,7,34,26,10,6,8,5,11,5,4,1,3,2,6,2,3,1,5,3,5,3,1,0,197,101,96,16,5,11,47,24,44,58,12,4,26,11,22,34,5,-1,21,13,22,24,7,5,4,7,4,0,0,0,0,3,3,-2,0,0,4,4,1,2,0,0,75,21,54,35,10,25,27,10,8,36,-8,-1,10,-2,1,16,-2,-4,17,12,7,20,-6,3,10,4,9,9,0,3,4,0,2,3,0,1,6,4,7,6,0,2,47,23,24,1,-4,5,17,3,-5,22,6,-9,1,5,0,9,3,-5,16,-2,-5,13,3,-4,5,1,-4,5,-4,-2,0,1,-1,0,-2,-2,5,0,-3,5,-2,0,11,17,-6,6,2,4,4,-6,-10,15,4,4,9,3,-6,8,4,-2,-5,-9,-4,7,0,6,0,2,-2,1,2,2,0,1,-1,0,1,0,0,1,-1,1,1,2,26,20,6,10,6,4,13,-8,9,1,0,-1,13,-8,5,2,4,-1,0,0,4,-1,-4,0,2,-1,7,1,1,0,1,-2,4,2,0,0,1,1,3,-1,1,0,1,8,-7,-13,-6,-7,19,-13,-9,7,-15,4,11,-5,2,-3,-3,1,8,-8,-11,10,-12,3,-3,2,-5,-5,-1,-1,-4,2,-1,-2,0,-1,1,0,-4,-3,-1,0,65,33,32,0,1,-1,13,11,5,1,21,9,11,7,-6,-1,15,5,2,4,11,2,6,4,-4,4,-2,-3,3,2,0,2,-3,-1,1,2,-4,2,1,-2,2,0,-13,0,-13,8,1,7,-8,-7,7,4,-7,-4,-3,-2,7,2,-6,0,-5,-5,0,2,-1,-4,2,3,-1,3,0,1,1,1,0,0,-1,0,1,2,-1,3,1,1,1,-4,5,4,0,4,0,-11,4,3,-3,-11,0,-4,5,2,-4,-11,0,-7,-1,1,1,0,4,1,2,-1,0,-3,3,0,2,-3,1,-3,1,1,0,2,-1,0,36,23,13,7,10,-3,1,-4,13,9,0,7,3,1,11,2,-1,3,-2,-5,2,7,1,4,-1,2,1,2,3,0,2,4,0,2,2,0,-3,-2,1,0,1,0,102,63,39,2,-2,4,22,7,38,29,8,-8,10,5,14,19,9,0,12,2,24,10,-1,-8,0,-2,0,0,1,1,-3,0,1,-1,-1,0,3,-2,-1,1,2,1
43,43050,Creixell,1664,-90,-54,-36,5,1,4,-18,-18,-12,-23,-9,-7,-10,-10,-8,-14,-6,-4,-8,-8,-4,-9,-3,-3,2,0,0,1,2,0,0,0,0,0,1,0,2,0,0,1,1,0,105,67,38,44,23,21,7,12,34,21,24,7,5,13,19,11,17,2,2,-1,15,10,7,5,10,8,15,9,2,0,5,5,6,6,1,0,5,3,9,3,1,0,164,92,72,39,17,22,17,21,31,29,43,22,8,10,20,23,20,11,9,11,11,6,23,11,7,12,10,3,5,2,1,7,6,2,1,0,6,5,4,1,4,2,102,76,26,31,20,11,16,20,29,28,8,1,15,20,23,9,7,2,1,0,6,19,1,-1,5,7,7,5,5,2,4,4,6,2,3,1,1,3,1,3,2,1,37,7,30,23,10,13,11,3,-6,10,24,-4,4,-1,-9,7,10,-4,7,4,3,3,14,0,8,6,2,3,4,1,3,4,0,2,1,0,5,2,2,1,3,1,287,138,149,50,19,31,67,37,69,57,36,19,34,10,36,34,15,10,33,27,33,23,21,9,17,11,10,9,1,1,8,3,2,4,1,1,9,8,8,5,0,0,222,118,104,51,27,24,34,30,63,35,51,10,18,16,35,19,30,0,16,14,28,16,21,10,11,16,10,7,4,2,6,9,6,3,2,1,5,7,4,4,2,1,201,99,102,65,32,33,37,23,58,32,13,32,21,11,34,8,12,9,16,12,24,24,1,23,14,16,19,7,5,2,7,8,9,4,2,1,7,8,10,3,3,1,48,23,25,43,19,24,8,7,10,6,11,7,-1,5,8,-2,10,4,9,2,2,8,1,3,12,13,3,9,5,1,7,3,-1,6,4,0,5,10,4,3,1,1,68,26,42,28,13,15,21,11,14,3,3,15,12,-2,7,-1,2,7,9,13,7,4,1,8,8,5,2,8,2,1,4,2,0,5,1,0,4,3,2,3,1,1,31,14,17,8,1,7,-6,0,26,-2,-13,18,-10,3,23,-1,-10,5,4,-3,3,-1,-3,13,-7,7,5,4,-4,0,-6,2,3,2,-3,0,-1,5,2,2,-1,0,11,1,10,15,2,13,-12,-4,20,0,-11,18,-9,-9,17,1,-8,7,-3,5,3,-1,-3,11,5,3,6,-1,0,2,0,0,2,0,-1,1,5,3,4,-1,1,1,67,28,39,15,7,8,19,2,10,8,14,11,1,-1,-2,17,6,4,18,3,12,-9,8,7,3,1,6,2,1,1,0,1,2,1,1,1,3,0,4,1,0,0,25,0,25,12,1,11,-27,7,4,-12,33,16,-8,1,-5,-14,21,4,-19,6,9,2,12,12,-2,2,4,2,4,2,-1,0,0,1,0,1,-1,2,4,1,4,1,28,6,22,10,5,5,-7,11,-9,11,-2,21,-3,7,-2,0,-8,10,-4,4,-7,11,6,11,0,1,1,4,3,0,0,-1,1,3,1,0,0,2,0,1,2,0,-80,-45,-35,-36,-17,-19,-42,-14,-25,-34,19,13,-18,-11,-12,-16,6,5,-24,-3,-13,-18,13,8,1,-6,-5,-11,-10,-6,1,-1,-4,-5,-6,-3,0,-5,-1,-6,-4,-3,4,3,1,-7,-3,-4,-12,-6,11,-2,5,9,-7,0,5,2,3,1,-5,-6,6,-4,2,8,-12,1,5,-1,-2,2,-3,0,2,-2,-2,2,-9,1,3,1,0,0,69,31,38,20,11,9,11,3,13,6,29,12,7,4,0,11,8,3,4,-1,13,-5,21,9,0,0,8,3,7,2,-1,0,3,3,4,2,1,0,5,0,3,0
43,43051,Cunit,5542,1353,703,650,125,67,58,214,164,270,292,250,162,112,68,150,158,142,75,102,96,120,134,108,87,35,17,33,15,19,4,17,9,19,9,10,3,18,8,14,6,9,1,321,175,146,9,6,3,20,42,58,84,80,36,8,27,34,46,46,13,12,15,24,38,34,23,2,1,4,1,1,0,0,1,4,0,1,0,2,0,0,1,0,0,373,209,164,7,6,1,54,30,83,65,92,46,23,23,53,37,44,28,31,7,30,28,48,18,1,1,-1,1,3,2,-1,1,0,2,1,3,2,0,-1,-1,2,-1,612,299,313,26,12,14,107,71,130,107,97,95,45,31,59,63,55,44,62,40,71,44,42,51,9,5,7,3,1,1,4,3,4,2,-1,0,5,2,3,1,2,1,944,492,452,171,102,69,169,112,286,165,142,68,94,52,164,81,82,17,75,60,122,84,60,51,41,32,42,26,23,6,31,19,22,12,12,5,10,13,20,14,11,1,1076,574,502,191,100,91,201,142,316,177,154,75,109,71,171,102,79,31,92,71,145,75,75,44,40,42,49,35,14,6,21,18,27,20,7,4,19,24,22,15,7,2,1095,548,547,285,151,134,207,182,268,231,109,95,114,96,132,125,42,38,93,86,136,106,67,57,75,72,60,43,26,5,45,38,34,19,14,0,30,34,26,24,12,5,623,332,291,165,92,73,90,94,202,74,101,54,35,60,105,42,57,26,55,34,97,32,44,28,38,43,60,1,9,14,23,26,33,0,2,8,15,17,27,1,7,6,497,238,259,191,91,100,96,90,123,34,69,76,53,35,77,7,33,28,43,55,46,27,36,48,37,66,54,23,8,0,22,29,29,5,4,1,15,37,25,18,4,-1,246,79,167,6,-26,32,59,-5,1,27,40,114,37,-4,-21,20,26,20,22,-1,22,7,14,94,7,17,-17,-7,2,1,-1,-2,-13,-9,1,-2,8,19,-4,2,1,3,130,71,59,-1,-7,6,-1,20,-13,12,27,86,6,6,19,2,9,28,-7,14,-32,10,18,58,-4,7,1,-2,-3,-1,-4,-2,7,-6,-3,1,0,9,-6,4,0,-2,95,36,59,51,20,31,4,-7,-5,2,45,43,17,-13,-23,11,16,24,-13,6,18,-9,29,19,21,9,6,14,2,-4,13,0,-6,13,0,-1,8,9,12,1,2,-3,-262,-140,-122,-59,-34,-25,-79,-45,-116,-16,-2,0,-39,-18,-62,-10,2,-12,-40,-27,-54,-6,-4,12,-13,-10,-29,-16,7,2,-1,-6,-23,-9,5,0,-12,-4,-6,-7,2,2,-289,-189,-100,-145,-85,-60,-79,-58,-75,-87,-12,22,-51,-29,-40,-56,-19,6,-28,-29,-35,-31,7,16,-23,-17,-26,-49,-17,-13,-16,-11,-9,-34,-10,-5,-7,-6,-17,-15,-7,-8,-28,-36,8,-7,-20,13,-4,-13,-14,-26,2,29,-5,-11,-15,-21,2,11,1,-2,1,-5,0,18,10,0,-5,-11,1,-3,-1,-1,-8,-10,-1,0,11,1,3,-1,2,-3,16,0,16,-65,-51,-14,12,-11,-30,12,22,1,11,-8,-15,10,4,-8,1,-3,-15,2,18,9,0,1,-26,-28,-6,-10,0,-6,-18,-20,-5,-5,0,7,-8,-8,-1,-5,331,118,213,123,60,63,38,38,56,62,63,66,7,34,1,40,21,12,31,4,55,22,42,54,22,25,36,27,8,2,12,14,15,14,3,0,10,11,21,13,5,2,418,184,234,101,49,52,37,29,69,90,117,62,14,14,34,40,66,10,23,15,35,50,51,52,7,15,41,13,14,8,3,7,20,8,5,4,4,8,21,5,9,4
43,43901,Deltebre,10169,87,77,10,70,42,28,21,22,27,11,4,2,12,26,27,10,2,1,9,-4,0,1,2,1,10,20,24,11,5,0,4,13,17,6,2,0,6,7,7,5,3,0,144,83,61,135,71,64,14,25,41,38,20,5,8,21,21,18,12,3,6,4,20,20,8,2,14,32,40,29,14,5,5,17,22,17,8,2,9,15,18,12,6,3,183,91,92,152,80,72,27,50,56,21,22,4,8,17,37,15,10,3,19,33,19,6,12,1,27,39,48,21,14,3,11,18,30,15,5,1,16,21,18,6,9,2,157,113,44,169,96,73,29,47,33,29,14,3,23,30,32,18,10,0,6,17,1,11,4,3,28,45,55,27,11,2,16,26,31,16,7,0,12,19,24,11,4,2,211,118,93,184,88,96,34,35,68,40,24,10,16,16,46,21,11,7,18,19,22,19,13,3,32,46,54,29,18,5,15,19,29,12,10,3,17,27,25,17,8,2,150,78,72,124,80,44,31,43,33,10,21,8,15,33,11,4,12,2,16,10,22,6,9,6,15,46,33,16,9,4,11,32,19,9,6,2,4,14,14,7,3,2,-23,-5,-18,-113,-71,-42,11,36,-73,13,-9,0,0,24,-47,18,-2,2,11,12,-26,-5,-7,-2,7,17,-96,-26,-12,-6,3,7,-65,-14,-3,-1,4,10,-31,-12,-9,-5,436,274,162,393,243,150,54,111,159,64,35,12,32,61,112,38,21,7,22,50,47,26,14,5,45,106,140,74,22,5,24,61,93,49,12,3,21,45,47,25,10,2,184,64,120,98,33,65,48,21,32,20,22,38,19,1,14,10,5,13,29,20,18,10,17,25,35,32,16,6,4,1,13,12,6,0,-1,0,22,20,10,6,5,1,144,52,92,131,58,73,34,44,19,10,23,13,19,24,-8,1,8,5,15,20,27,9,15,8,27,39,24,24,14,3,16,21,4,12,3,2,11,18,20,12,11,1,165,91,74,118,61,57,59,39,21,27,11,7,30,16,14,12,7,9,29,23,7,15,4,-2,31,25,30,18,6,5,13,16,18,6,5,2,18,9,12,12,1,3,81,28,53,51,14,37,22,18,6,4,11,19,4,10,-3,-1,10,7,18,8,9,5,1,12,17,13,8,3,3,5,5,6,-1,-3,4,1,12,7,9,6,-1,4,-131,-107,-24,-166,-114,-52,-6,-18,-68,-47,-16,18,3,-18,-52,-38,-10,5,-9,0,-16,-9,-6,13,-21,-19,-65,-46,-13,-2,-6,-11,-47,-40,-8,-2,-15,-8,-18,-6,-5,0,-196,-131,-65,-256,-161,-95,-37,-31,-72,-49,-22,16,-21,-9,-42,-43,-14,1,-16,-22,-30,-6,-8,15,-48,-26,-79,-70,-31,-3,-32,-13,-45,-50,-18,-3,-16,-13,-34,-20,-13,0,-1,14,-15,69,43,26,-31,3,3,7,5,8,-14,1,5,14,6,1,-17,2,-2,-7,-1,7,13,16,12,25,2,0,10,7,6,19,1,0,3,9,6,6,1,0,1,-4,5,37,21,16,-24,8,-12,17,4,4,-24,7,-1,9,1,4,0,1,-11,8,3,0,3,5,13,14,1,0,1,-1,8,10,1,1,2,6,5,4,0,-1,21,-5,26,33,16,17,10,15,7,-5,4,-10,-4,3,3,-6,4,-5,14,12,4,1,0,-5,7,9,4,6,6,1,3,6,4,3,1,-1,4,3,0,3,5,2,33,26,7,41,31,10,4,20,-6,-12,22,2,-4,20,-1,-6,16,3,8,0,-5,-6,6,-1,8,11,13,7,4,-2,2,14,7,5,4,-1,6,-3,6,2,0,-1
43,43054,"Espluga de Francolí, L'",3650,7,7,0,16,9,7,5,5,-2,-2,-4,6,4,6,-5,1,0,2,1,-1,3,-3,-4,4,7,3,4,1,1,0,3,3,2,1,0,0,4,0,2,0,1,0,34,19,15,32,15,17,4,0,9,1,3,15,6,2,7,-1,-2,6,-2,-2,2,2,5,9,8,9,9,5,0,1,4,6,3,2,0,0,4,3,6,3,0,1,49,35,14,28,12,16,1,15,18,4,6,3,-1,10,12,8,3,0,2,5,6,-4,3,3,7,8,7,5,0,0,2,4,2,3,0,0,5,4,5,2,0,0,34,23,11,25,14,11,-1,20,-5,4,2,13,4,11,2,1,1,3,-5,9,-7,3,1,10,5,9,6,3,2,0,4,5,3,1,1,0,1,4,3,2,1,0,142,62,80,66,30,36,6,28,35,34,16,22,1,15,15,17,7,8,5,13,20,17,9,14,10,22,14,16,3,1,3,11,4,11,1,0,7,11,10,5,2,1,73,21,52,43,18,25,-8,18,27,12,5,18,-4,5,9,3,2,6,-4,13,18,9,3,12,6,12,14,7,4,0,5,2,4,6,1,0,1,10,10,1,3,0,70,43,27,68,46,22,14,9,21,2,6,17,5,8,17,3,6,4,9,1,4,-1,0,13,10,24,22,10,3,-1,7,16,15,5,3,0,3,8,7,5,0,-1,61,30,31,52,29,23,19,23,2,15,-5,12,9,12,2,5,-2,5,10,11,0,10,-3,7,13,15,12,15,-4,0,9,8,5,9,-2,0,4,7,7,6,-2,0,69,40,29,52,21,31,14,9,13,14,4,12,7,0,12,16,2,1,7,9,1,-2,2,11,6,10,17,11,6,1,3,3,9,4,1,0,3,7,8,7,5,1,-1,-17,16,13,1,12,14,-1,-8,-9,-2,5,6,-3,-2,-12,-2,-3,8,2,-6,3,0,8,2,4,-1,4,3,1,0,1,-1,-1,1,1,2,3,0,5,2,0,-26,-21,-5,-20,-19,-1,2,-10,-23,-7,-9,22,-4,-8,-9,-5,-4,9,6,-2,-14,-2,-5,13,-1,5,-9,-12,-3,0,-1,-1,-5,-9,-3,0,0,6,-4,-3,0,0,-2,-9,7,13,2,11,-3,0,-3,-8,-3,15,-5,3,-3,-4,-4,4,2,-3,0,-4,1,11,3,3,6,0,-3,3,1,0,1,0,-2,1,2,3,5,0,-1,2,8,6,2,10,7,3,-1,5,0,4,0,-1,3,2,-2,2,1,0,-4,3,2,2,-1,-1,3,3,0,2,3,-2,2,3,-1,2,2,-1,1,0,1,0,1,-1,-7,-11,4,4,-1,5,-5,2,-15,-6,-1,20,-4,-2,-5,-4,-1,6,-1,4,-10,-2,0,14,1,0,2,4,-4,1,1,-1,1,0,-2,0,0,1,1,4,-2,1,19,0,19,6,-1,7,3,-5,10,-8,4,15,2,-8,1,-4,1,8,1,3,9,-4,3,7,1,0,2,1,2,0,1,-4,1,0,1,0,0,4,1,1,1,0,8,-3,11,3,0,3,2,-4,-10,7,-3,16,3,-3,-11,8,-1,2,-1,-1,1,-1,-2,14,0,1,-4,4,3,0,0,0,-3,4,1,-1,0,1,-1,0,2,1,-7,-11,4,-19,-11,-8,9,2,-2,-13,-9,4,4,4,-4,-10,-8,3,5,-2,2,-3,-1,1,1,1,-5,-11,-6,-1,1,1,-2,-7,-5,0,0,0,-3,-4,-1,-1,1,7,-6,21,8,13,-10,7,-9,5,2,8,-6,4,-2,7,1,6,-4,3,-7,-2,1,2,-2,8,6,4,2,2,-2,5,3,2,0,0,0,3,3,2,2,2
43,43064,Gandesa,2588,79,44,35,49,35,14,14,20,27,16,0,0,7,12,15,8,2,-1,7,8,12,8,-2,1,1,13,22,11,0,1,0,11,15,8,0,1,1,2,7,3,0,0,70,51,19,66,43,23,8,18,28,11,3,1,4,13,19,11,1,2,4,5,9,0,2,-1,7,21,25,11,2,0,3,14,18,7,1,0,4,7,7,4,1,0,131,78,53,110,69,41,26,23,51,21,7,1,13,11,33,14,5,0,13,12,18,7,2,1,18,27,36,23,5,0,11,14,24,16,4,-1,7,13,12,7,1,1,101,60,41,100,58,42,15,20,23,25,8,11,6,14,14,16,4,6,9,6,9,9,4,5,16,25,27,21,11,0,8,13,17,14,6,0,8,12,10,7,5,0,95,55,40,107,63,44,12,26,24,23,5,5,7,19,14,11,2,2,5,7,10,12,3,3,17,27,28,27,6,2,10,18,19,12,4,0,7,9,9,15,2,2,62,35,27,98,55,43,8,29,10,7,8,2,2,23,5,2,5,0,6,6,5,5,3,2,15,34,27,14,5,3,8,21,12,10,3,1,7,13,15,4,2,2,1,-5,6,73,38,35,12,2,-11,-12,4,6,12,0,-7,-13,0,2,0,2,-4,1,4,4,20,23,21,6,2,1,14,12,10,2,0,0,6,11,11,4,2,1,135,68,67,137,77,60,23,43,28,30,4,5,10,23,16,15,5,-2,13,20,12,15,-1,7,14,40,36,35,10,2,7,22,18,23,6,1,7,18,18,12,4,1,77,52,25,83,51,32,19,12,27,19,-1,0,11,9,23,11,-3,1,8,3,4,8,2,-1,19,16,26,16,5,0,10,11,21,8,1,0,9,5,5,8,4,0,-10,-11,1,23,5,18,8,-2,-3,-13,-1,2,6,-2,-4,-11,-1,2,2,0,1,-2,0,0,10,5,7,-2,3,0,10,-2,0,-5,2,0,0,7,7,3,1,0,7,15,-8,10,4,6,5,4,-5,2,-4,5,7,3,-5,6,0,4,-2,1,0,-4,-4,1,2,10,-6,2,1,1,2,5,-7,2,1,1,0,5,1,0,0,0,-59,-22,-37,-50,-30,-20,-13,0,-12,-14,-14,-6,-4,-3,3,-7,-8,-3,-9,3,-15,-7,-6,-3,-8,-1,-5,-19,-15,-2,-3,-4,-1,-13,-8,-1,-5,3,-4,-6,-7,-1,-5,-15,10,-16,-13,-3,2,0,-14,-9,-4,17,1,0,-10,-10,-5,8,1,0,-4,1,1,9,-1,4,-10,-8,-2,0,-1,2,-5,-7,-2,0,0,2,-5,-1,0,0,-24,-9,-15,-26,-13,-13,8,-5,-13,-6,-12,2,6,-6,-5,-1,-6,2,2,1,-8,-5,-6,0,-2,4,-9,-11,-9,-1,-1,1,-5,-5,-4,0,-1,3,-4,-6,-5,-1,-42,-31,-11,-47,-34,-13,-3,-8,-9,-11,-10,-3,-2,-9,-3,-9,-9,0,-1,1,-6,-2,-1,-3,-5,-4,-12,-18,-6,-3,-3,-7,-6,-13,-4,-1,-2,3,-6,-5,-2,-2,28,8,20,31,11,20,13,15,-3,0,1,2,6,5,-1,-4,1,0,7,10,-2,4,0,2,5,7,5,12,0,1,2,3,0,5,0,0,3,4,5,7,0,1,17,12,5,12,8,4,4,6,3,9,-4,-3,-1,5,4,3,1,-1,5,1,-1,6,-5,-2,1,6,-3,7,0,0,0,4,-3,4,2,0,1,2,0,3,-2,0,5,2,3,-29,-15,-14,3,5,-3,-9,-1,10,3,1,5,-9,2,0,0,4,-8,0,-3,10,-2,2,-7,-14,-8,0,-1,1,1,-11,-3,-2,-1,1,-8,-3,-5,2
43,43078,Masdenverge,924,53,35,18,63,39,24,3,15,21,14,0,0,1,8,16,8,1,1,2,7,5,6,-1,-1,4,18,27,14,0,0,1,11,19,8,0,0,3,7,8,6,0,0,-2,5,-7,36,25,11,-3,5,-4,0,1,0,-1,5,-1,1,1,0,-2,0,-3,-1,0,0,5,17,12,2,0,0,2,13,9,1,0,0,3,4,3,1,0,0,18,15,3,34,22,12,2,5,5,3,2,0,-1,5,5,5,0,0,3,0,0,-2,2,0,7,9,7,10,0,0,2,6,5,8,0,0,5,3,2,2,0,0,21,9,12,27,14,13,5,1,-5,11,7,2,1,2,-5,9,1,1,4,-1,0,2,6,1,7,6,8,6,0,0,1,3,6,4,0,0,6,3,2,2,0,0,21,14,7,5,3,2,1,-1,4,11,4,1,3,1,-1,7,2,1,-2,-2,5,4,2,0,0,3,0,2,0,0,0,1,0,2,0,0,0,2,0,0,0,0,11,11,0,24,12,12,-2,3,1,8,-1,1,-1,4,1,6,1,0,-1,-1,0,2,-2,1,8,5,3,6,1,0,4,3,1,3,1,0,4,2,2,3,0,0,68,31,37,22,11,11,16,11,3,22,12,3,5,6,0,10,8,1,11,5,3,12,4,2,5,2,7,6,2,0,2,1,4,3,1,0,3,1,3,3,1,0,17,15,2,8,7,1,1,10,-8,10,4,-1,-1,8,-5,8,2,2,2,2,-3,2,2,-3,0,6,-2,2,1,0,0,5,-1,1,1,0,0,1,-1,1,0,0,14,6,8,11,4,7,1,4,4,-3,2,5,-4,4,8,-4,-1,1,5,0,-4,1,3,4,2,5,2,2,0,0,1,2,1,0,0,0,1,3,1,2,0,0,13,7,6,12,8,4,1,3,-2,6,9,-3,1,2,-1,3,4,-1,0,1,-1,3,5,-2,1,2,1,4,4,0,1,2,0,2,3,0,0,0,1,2,1,0,-1,-7,6,4,2,2,3,1,-3,2,-1,-1,-2,-2,0,-1,0,1,5,3,-3,3,-1,-2,0,3,0,2,0,0,0,1,1,1,0,0,0,2,-1,1,0,0,-7,-6,-1,8,0,8,-9,10,-2,-2,-3,0,-1,1,-2,-4,0,0,-8,9,0,2,-3,0,0,6,2,-1,0,1,0,1,0,-2,0,1,0,5,2,1,0,0,13,16,-3,4,4,0,4,1,7,-6,9,1,6,4,7,-4,5,0,-2,-3,0,-2,4,1,1,3,-4,2,1,1,1,2,-1,1,0,1,0,1,-3,1,1,0,-29,-19,-10,-34,-20,-14,-2,1,-19,-2,-6,1,0,1,-12,0,-7,1,-2,0,-7,-2,1,0,-5,-3,-16,-4,-5,-1,-2,-1,-10,-2,-4,-1,-3,-2,-6,-2,-1,0,-8,-4,-4,5,5,0,3,-7,5,-4,2,-5,1,-4,3,-1,1,-2,2,-3,2,-3,1,-3,3,0,4,-2,2,-2,2,0,3,-1,2,-1,1,0,1,-1,0,-1,-7,-5,-2,-8,-4,-4,2,-4,-9,5,-3,1,1,-1,-6,4,-4,0,1,-3,-3,1,1,1,-1,-1,-3,-1,-2,-1,-1,-1,-2,-1,0,0,0,0,-1,0,-2,-1,-28,-12,-16,-4,-6,2,-7,-5,-11,2,-3,-4,1,0,-9,0,-2,-1,-8,-5,-2,2,-1,-3,0,0,-2,0,-2,0,0,0,-3,0,-3,0,0,0,1,0,1,0,7,1,6,5,2,3,1,3,4,5,-4,-3,1,1,1,2,-2,-2,0,2,3,3,-2,-1,2,1,1,2,0,-1,1,1,0,1,0,-1,1,0,1,1,0,0
43,43086,Montblanc,5920,79,43,36,33,18,15,3,13,49,12,4,-2,5,6,30,4,-1,-1,-2,7,19,8,5,-1,6,8,9,9,1,0,5,5,4,4,0,0,1,3,5,5,1,0,88,49,39,25,14,11,24,21,37,6,5,-5,17,7,20,2,4,-2,7,14,17,4,1,-3,4,9,10,1,0,1,4,4,4,1,0,1,0,5,6,0,0,0,137,58,79,85,45,40,13,47,24,21,22,6,-2,25,9,13,10,1,15,22,15,8,12,5,11,21,35,10,5,2,4,12,21,6,1,1,7,9,14,4,4,1,108,55,53,53,21,32,18,30,21,22,9,4,5,22,14,13,1,1,13,8,7,9,8,3,10,9,19,9,5,0,4,3,9,3,2,0,6,6,10,6,3,0,140,75,65,73,44,29,19,26,45,36,-1,9,15,13,24,21,-3,3,4,13,21,15,2,6,10,19,28,12,3,0,6,14,13,8,2,0,4,5,15,4,1,0,77,60,17,74,47,27,5,15,24,9,13,12,5,14,23,7,6,6,0,1,1,2,7,6,9,20,23,11,7,3,4,10,18,7,4,3,5,10,5,4,3,0,64,56,8,67,35,32,-6,24,44,12,4,-12,-4,16,33,6,6,-2,-2,8,11,6,-2,-10,3,24,25,12,1,2,2,10,16,5,1,1,1,14,9,7,0,1,294,187,107,102,60,42,52,56,77,63,10,35,28,37,66,39,3,12,24,19,11,24,7,23,18,33,29,12,7,2,7,22,22,5,4,-1,11,11,7,7,3,3,216,123,93,105,58,47,30,40,74,47,16,4,12,21,44,31,5,5,18,19,30,16,11,-1,16,35,29,20,3,-1,9,19,17,9,2,0,7,16,12,11,1,-1,57,32,25,39,4,35,20,16,-19,35,4,3,14,3,-17,24,2,9,6,13,-2,11,2,-6,13,21,1,5,0,-2,7,7,-6,-2,-1,-1,6,14,7,7,1,-1,24,36,-12,30,9,21,-5,11,11,2,7,-4,6,16,14,-4,5,-2,-11,-5,-3,6,2,-2,7,8,7,4,0,2,2,3,4,0,0,0,5,5,3,4,0,2,41,18,23,53,29,24,15,20,3,2,3,-4,6,16,-13,3,0,4,9,4,16,-1,3,-8,15,12,12,8,5,1,8,9,3,7,2,0,7,3,9,1,3,1,-3,-8,5,-34,-27,-7,13,11,-8,-20,4,-6,12,1,0,-15,2,-9,1,10,-8,-5,2,3,1,-4,-14,-12,-6,0,1,-4,-8,-12,-4,0,0,0,-6,0,-2,0,-23,-5,-18,8,1,7,2,2,-17,-13,8,-7,0,4,-12,-2,8,-3,2,-2,-5,-11,0,-4,7,3,2,-3,1,-3,4,0,-3,0,0,0,3,3,5,-3,1,-3,24,9,15,25,17,8,3,2,13,5,-6,7,-2,4,12,1,-4,-2,5,-2,1,4,-2,9,3,5,10,6,0,1,0,5,6,5,1,0,3,0,4,1,-1,1,56,22,34,45,23,22,0,23,35,-4,-16,14,-4,9,19,-5,-8,8,4,14,16,1,-8,6,9,11,13,8,1,2,5,6,8,1,0,2,4,5,5,7,1,0,43,16,27,35,16,19,1,3,25,2,5,7,-2,1,10,-3,6,3,3,2,15,5,-1,4,4,7,9,6,7,1,3,4,2,3,3,0,1,3,7,3,4,1,28,14,14,-7,-9,2,7,4,3,-2,7,6,0,5,4,-5,3,4,7,-1,-1,3,4,2,2,2,-3,-12,2,2,1,0,-3,-10,2,1,1,2,0,-2,0,1
43,43088,Montbrió del Camp,1438,59,41,18,34,25,9,11,11,21,9,2,3,11,9,12,5,2,1,0,2,9,4,0,2,9,9,9,6,0,0,5,8,7,5,0,0,4,1,2,1,0,0,30,11,19,29,16,13,6,9,12,-4,5,3,3,4,6,-5,2,1,3,5,6,1,3,2,9,8,6,4,2,0,4,5,3,3,1,0,5,3,3,1,1,0,9,-2,11,16,8,8,6,8,0,-4,-2,1,4,4,-3,-4,-3,0,2,4,3,0,1,1,5,5,5,1,0,0,3,3,2,0,0,0,2,2,3,1,0,0,37,9,28,24,10,14,2,2,16,4,6,6,-1,1,3,1,2,3,3,1,13,3,4,3,6,2,7,4,4,1,3,2,2,2,1,0,3,0,5,2,3,1,102,73,29,25,12,13,16,14,44,10,15,1,6,10,32,11,11,3,10,4,12,-1,4,-2,2,5,6,5,4,2,1,3,2,3,2,1,1,2,4,2,2,1,94,58,36,32,14,18,11,25,42,16,2,0,10,14,19,14,0,0,1,11,23,2,2,0,7,11,6,7,1,0,2,5,2,5,0,0,5,6,4,2,1,0,122,53,69,25,14,11,19,21,43,28,12,0,8,11,18,13,5,-1,11,10,25,15,7,1,5,5,9,4,3,-1,3,3,4,3,2,-1,2,2,5,1,1,0,130,62,68,44,30,14,1,38,61,14,12,3,-4,15,42,4,5,-1,5,23,19,10,7,4,0,14,16,11,0,3,1,6,14,8,0,1,-1,8,2,3,0,2,143,77,66,27,15,12,22,18,61,24,13,4,13,7,33,10,11,3,9,11,28,14,2,1,5,2,15,3,1,1,2,1,9,2,0,1,3,1,6,1,1,0,72,46,26,24,17,7,12,25,28,5,3,-1,11,10,15,7,2,2,1,15,13,-2,1,-3,8,5,7,4,-1,1,8,3,4,2,0,0,0,2,3,2,-1,1,142,69,73,8,-1,9,15,47,46,25,4,0,5,20,26,8,7,0,10,27,20,17,-3,0,6,3,1,2,-3,-1,1,3,-1,-2,-2,0,5,0,2,4,-1,-1,32,20,12,-2,-3,1,-2,16,2,6,4,3,3,8,2,4,0,1,-5,8,0,2,4,2,2,4,-7,-1,-1,0,1,2,-4,-1,-1,0,1,2,-3,0,0,0,105,66,39,8,4,4,3,21,48,9,17,8,3,13,30,0,10,9,0,8,18,9,7,-1,1,3,2,2,0,0,1,1,1,1,0,0,0,2,1,1,0,0,-15,-3,-12,-13,-9,-4,-9,-2,-6,5,4,-5,-3,0,-1,2,2,-2,-6,-2,-5,3,2,-3,0,-4,-5,-2,0,-2,0,-2,-3,-3,0,-1,0,-2,-2,1,0,-1,47,26,21,18,8,10,7,14,16,5,7,-3,9,5,1,7,5,-1,-2,9,15,-2,2,-2,3,2,9,2,2,-1,1,0,6,0,0,0,2,2,3,2,2,-1,65,30,35,4,3,1,13,13,37,14,-2,-8,7,7,15,11,-4,-4,6,6,22,3,2,-4,-2,3,-1,2,2,0,-1,2,-1,2,1,0,-1,1,0,0,1,0,6,10,-4,-17,-8,-9,-9,8,2,-6,0,9,-5,3,9,2,-2,2,-4,5,-7,-8,2,7,-2,3,-3,-12,-5,2,-1,2,1,-7,-3,0,-1,1,-4,-5,-2,2,-1,-2,1,9,6,3,-7,13,-11,14,2,-9,0,6,-8,5,1,-3,-7,7,-3,9,1,-6,3,4,3,2,2,-5,2,1,2,1,1,-1,1,3,1,1,1,-4
43,43092,Mont-roig del Camp,6412,57,44,13,13,8,5,3,9,5,22,12,2,4,11,7,3,13,4,-1,-2,-2,19,-1,-2,4,2,2,2,0,3,3,1,1,1,0,2,1,1,1,1,0,1,146,92,54,7,5,2,7,12,38,26,53,11,5,10,25,11,32,9,2,2,13,15,21,2,0,1,1,3,1,1,0,1,1,1,1,1,0,0,0,2,0,0,140,68,72,-12,-6,-6,0,11,42,36,40,2,-2,5,16,23,22,1,2,6,26,13,18,1,-1,0,-7,0,-1,-3,0,0,-5,0,0,-1,-1,0,-2,0,-1,-2,199,126,73,-5,-4,-1,29,13,75,39,22,20,21,9,37,37,11,12,8,4,38,2,11,8,0,-1,-3,1,-2,0,0,-1,-2,1,-2,0,0,0,-1,0,0,0,544,294,250,379,210,169,75,101,122,114,74,49,29,43,83,70,39,28,46,58,39,44,35,21,38,84,81,75,64,32,12,47,51,46,32,21,26,37,30,29,32,11,747,413,334,458,254,204,117,105,206,148,124,38,72,49,114,78,72,25,45,56,92,70,52,13,70,90,105,90,69,29,37,48,60,49,36,22,33,42,45,41,33,7,839,502,337,431,245,186,134,122,248,189,106,31,81,62,160,122,61,14,53,60,88,67,45,17,77,75,102,83,67,19,37,37,61,53,44,10,40,38,41,30,23,9,777,426,351,479,267,212,110,160,216,150,111,19,67,79,126,82,60,6,43,81,90,68,51,13,62,134,110,90,64,13,38,69,59,56,32,11,24,65,51,34,32,2,811,429,382,466,245,221,98,116,254,187,92,53,50,50,157,97,40,28,48,66,97,90,52,25,70,97,119,94,44,36,34,56,66,48,17,20,36,41,53,46,27,16,441,227,214,257,122,135,15,65,113,71,110,62,10,22,67,23,67,38,5,43,46,48,43,24,31,43,45,44,62,30,16,11,27,14,34,19,15,32,18,30,28,11,268,141,127,205,98,107,63,20,39,60,54,27,38,6,24,32,24,12,25,14,15,28,30,15,59,27,29,40,35,10,32,8,10,21,20,4,27,19,19,19,15,6,129,81,48,119,67,52,46,22,15,31,8,7,21,19,5,17,16,5,25,3,10,14,-8,2,51,25,-5,4,25,17,41,12,-9,-1,14,8,10,13,4,5,11,9,165,155,10,174,102,72,31,49,32,0,50,4,50,22,50,0,31,7,-19,27,-18,0,19,-3,38,36,37,13,35,10,28,16,23,6,17,10,10,20,14,7,18,0,-15,-17,2,90,32,58,-25,18,-39,5,34,-13,-11,-3,-6,-5,5,-3,-14,21,-33,10,29,-10,22,19,-6,17,21,10,11,1,-7,9,7,7,11,18,1,8,14,3,-133,-77,-56,12,2,10,-53,9,-37,-32,6,-18,-18,9,-25,-24,5,-20,-35,0,-12,-8,1,2,-2,2,3,1,14,-5,0,2,0,-3,8,-4,-2,0,3,4,6,-1,-325,-174,-151,-198,-83,-115,-72,-29,-107,-98,-3,-15,-37,-21,-45,-66,11,-15,-35,-8,-62,-32,-14,0,-28,-30,-71,-50,-15,-7,-13,-10,-26,-23,-6,-6,-15,-20,-45,-27,-9,-1,150,121,29,154,96,58,15,-3,53,47,28,2,10,12,41,15,27,11,5,-15,12,32,1,-9,34,15,35,26,33,7,17,13,19,15,20,11,17,2,16,11,13,-4,242,124,118,175,101,74,42,36,86,42,35,2,29,17,40,22,16,2,13,19,46,20,19,0,23,32,40,28,36,12,17,13,19,21,18,10,6,19,21,7,18,2
43,43093,Móra d'Ebre,4836,272,142,130,58,30,28,54,21,85,59,3,45,27,2,48,44,-3,23,27,19,37,15,6,22,15,5,18,12,2,3,4,2,12,9,1,1,11,3,6,3,1,2,44,19,25,32,20,12,13,9,18,-2,3,5,5,6,6,-2,0,5,8,3,12,0,3,0,7,5,9,9,2,0,5,4,4,6,1,0,2,1,5,3,1,0,31,16,15,51,23,28,8,6,10,4,1,1,4,1,9,1,0,1,4,5,1,3,1,0,7,14,14,12,3,0,2,9,6,4,2,0,5,5,8,8,1,0,65,42,23,33,16,17,-1,7,23,-1,13,23,-2,8,19,0,4,13,1,-1,4,-1,9,10,6,3,7,3,8,5,4,2,3,1,2,4,2,1,4,2,6,1,45,15,30,50,23,27,18,1,5,27,-5,-3,7,1,-6,13,1,-3,11,0,11,14,-6,0,16,3,12,13,3,2,7,0,6,7,2,1,9,3,6,6,1,1,112,55,57,82,43,39,36,7,40,16,-8,17,19,3,16,12,-3,5,17,4,24,4,-5,12,13,21,20,12,8,6,8,10,11,4,5,3,5,11,9,8,3,3,120,57,63,58,31,27,30,3,36,22,9,19,11,-4,23,16,3,8,19,7,13,6,6,11,16,8,16,10,5,1,9,5,10,5,0,1,7,3,6,5,5,0,264,138,126,117,55,62,73,54,69,51,16,-1,32,25,35,35,8,3,41,29,34,16,8,-4,39,25,30,18,5,-1,16,13,13,11,3,-1,23,12,17,7,2,0,209,108,101,133,63,70,67,36,30,57,11,7,22,19,25,33,9,1,45,17,5,24,2,6,32,33,26,22,13,4,13,14,13,13,7,2,19,19,13,9,6,2,86,45,41,26,3,23,20,19,6,11,20,5,13,3,1,10,13,2,7,16,5,1,7,3,12,4,-1,5,1,1,6,-3,-5,1,2,0,6,7,4,4,-1,1,-92,-46,-46,-53,-33,-20,-30,-4,-7,-25,-16,-8,-11,-2,1,-20,-9,-3,-19,-2,-8,-5,-7,-5,-19,-3,-2,-24,-6,-1,-9,-2,-2,-17,-2,-1,-10,-1,0,-7,-4,0,17,-5,22,-10,-13,3,5,-6,9,9,-2,5,4,-5,-5,-1,2,0,1,-1,14,10,-4,5,-6,1,-1,2,-4,-2,-4,-1,-5,1,-4,-1,-2,2,4,1,0,-1,-111,-64,-47,-86,-48,-38,-14,-30,-21,-35,-12,6,-4,-18,-11,-24,-8,5,-10,-12,-10,-11,-4,1,-18,-14,-10,-28,-10,-5,-7,-7,-11,-14,-6,-2,-11,-7,1,-14,-4,-3,-20,-6,-14,-52,-31,-21,-13,7,-1,-17,-2,3,-8,8,-2,-2,-2,-1,-5,-1,1,-15,0,4,-17,0,-12,-18,-3,-4,-8,0,-9,-10,-4,-2,-9,0,-3,-8,1,-2,-91,-52,-39,-83,-43,-40,-31,-22,2,-32,-5,-4,-16,-8,-5,-19,-3,-1,-15,-14,7,-13,-2,-3,-21,-17,-10,-20,-10,-4,-12,-8,-4,-13,-3,-2,-9,-9,-6,-7,-7,-2,112,74,38,95,47,48,34,10,29,42,6,-3,17,11,21,21,8,-1,17,-1,8,21,-2,-2,18,21,20,22,9,5,6,10,13,12,6,1,12,11,7,10,3,4,49,33,16,39,21,18,-11,19,-6,20,4,24,-2,6,-3,15,8,8,-9,13,-3,5,-4,16,4,14,5,7,10,-1,2,6,3,4,5,1,2,8,2,3,5,-2,57,26,31,44,27,17,20,-1,4,22,5,6,14,-7,2,11,4,2,6,6,2,11,1,4,3,0,12,14,10,5,3,-3,12,8,4,3,0,3,0,6,6,2
43,43095,"Morell, El",2338,6,3,3,3,2,1,-1,2,0,0,2,3,-2,8,-3,-2,1,1,1,-6,3,2,1,2,1,0,0,1,1,0,1,0,0,0,1,0,0,0,0,1,0,0,14,11,3,10,7,3,2,2,5,-2,2,6,3,1,5,-1,0,3,-1,1,0,-1,2,3,2,2,3,2,0,0,1,2,3,1,0,0,1,0,0,1,0,0,56,44,12,20,13,7,24,7,14,9,-1,2,18,4,12,8,0,2,6,3,2,1,-1,0,2,11,3,3,1,0,2,7,2,2,0,0,0,4,1,1,1,0,82,48,34,37,14,23,5,21,33,12,9,0,6,4,25,4,8,-1,-1,17,8,8,1,1,12,7,10,7,1,0,4,1,6,3,0,0,8,6,4,4,1,0,75,46,29,43,21,22,15,5,34,13,1,4,6,4,23,9,-1,2,9,1,11,4,2,2,15,9,10,6,0,3,9,5,5,1,0,1,6,4,5,5,0,2,99,66,33,39,21,18,25,28,20,19,3,2,10,20,22,9,2,3,15,8,-2,10,1,-1,10,12,11,5,1,0,5,5,9,2,0,0,5,7,2,3,1,0,147,70,77,22,4,18,8,33,60,21,12,6,8,8,31,16,5,0,0,25,29,5,7,6,-1,8,7,6,2,-1,-2,1,1,5,0,-1,1,7,6,1,2,0,197,105,92,46,22,24,17,26,123,8,14,4,12,10,64,6,9,1,5,16,59,2,5,3,2,12,13,7,10,2,0,5,7,6,4,0,2,7,6,1,6,2,180,86,94,29,16,13,44,43,73,18,5,-8,23,18,33,13,2,-5,21,25,40,5,3,-3,5,6,12,7,0,-2,2,3,6,5,0,0,3,3,6,2,0,-2,86,58,28,16,15,1,16,13,47,6,-3,1,14,9,29,4,0,-1,2,4,18,2,-3,2,6,11,-1,-1,0,1,8,7,0,-1,2,-1,-2,4,-1,0,-2,2,34,2,32,6,-1,7,-14,35,-6,7,9,1,-5,6,3,-6,3,1,-9,29,-9,13,6,0,2,4,-5,2,2,1,2,3,-6,-1,1,0,0,1,1,3,1,1,40,10,30,-5,-7,2,-4,16,22,-3,6,4,-9,11,8,-4,4,1,5,5,14,1,2,3,0,-1,-6,-1,1,2,1,0,-8,-2,1,1,-1,-1,2,1,0,1,-54,-15,-39,3,3,0,-14,4,-10,-19,-3,-5,-8,6,7,-14,1,-3,-6,-2,-17,-5,-4,-2,3,2,3,-3,-1,-1,1,2,3,-3,0,0,2,0,0,0,-1,-1,17,-8,25,8,4,4,11,-2,24,-7,-7,-2,6,3,0,-12,0,-4,5,-5,24,5,-7,2,1,5,0,1,1,0,0,3,0,1,0,0,1,2,0,0,1,0,-20,-14,-6,-22,-20,-2,-4,2,-2,-9,-6,-2,-1,-9,1,-3,-4,3,-3,11,-3,-6,-2,-5,-2,-5,-1,-14,-1,1,-1,-5,-4,-9,-2,1,-1,0,3,-5,1,0,-1,-9,8,8,5,3,0,5,-6,11,-7,-4,-8,-4,3,6,-4,-3,8,9,-9,5,-3,-1,0,2,3,3,0,0,-2,3,3,2,-1,0,2,-1,0,1,1,0,60,39,21,14,5,9,11,9,30,17,-4,-3,11,2,23,9,-3,-2,0,7,7,8,-1,-1,2,7,8,0,-1,-2,4,3,4,-2,-3,-1,-2,4,4,2,2,-1,12,-11,23,-3,-4,1,15,5,-7,4,-5,0,4,2,-11,-6,-1,1,11,3,4,10,-4,-1,-2,0,2,0,-3,0,-1,-3,1,-1,0,0,-1,3,1,1,-3,0
43,43100,"Pallaresos, Els",2400,10,18,-8,11,6,5,-5,13,-8,-10,11,8,4,6,4,-7,9,2,-9,7,-12,-3,2,6,4,1,4,2,0,0,1,1,2,2,0,0,3,0,2,0,0,0,42,22,20,9,5,4,2,0,21,12,6,-1,1,-2,12,9,1,0,1,2,9,3,5,-1,1,2,3,2,1,0,0,1,2,2,0,0,1,1,1,0,1,0,4,-6,10,6,5,1,-5,5,36,-28,-2,-4,-1,-1,15,-16,0,-2,-4,6,21,-12,-2,-2,4,3,-2,1,0,0,3,3,-1,0,0,0,1,0,-1,1,0,0,154,74,80,10,4,6,35,19,64,25,0,9,18,8,33,12,0,4,17,11,31,13,0,5,0,3,4,1,2,0,0,1,2,0,1,0,0,2,2,1,1,0,99,61,38,18,14,4,6,17,33,16,9,19,8,9,21,8,6,9,-2,8,12,8,3,10,2,5,5,2,3,1,2,4,3,2,2,1,0,1,2,0,1,0,134,66,68,8,3,5,26,13,54,15,10,9,10,7,27,10,4,4,16,6,27,5,6,5,1,6,0,1,0,0,0,2,0,1,0,0,1,4,0,0,0,0,151,59,92,9,6,3,44,-2,54,33,6,10,14,0,20,18,2,2,30,-2,34,15,4,8,1,4,3,0,-1,0,1,1,3,0,0,-1,0,3,0,0,-1,1,258,135,123,8,6,2,79,26,70,65,7,6,47,14,33,33,6,0,32,12,37,32,1,6,0,4,4,0,-1,1,0,3,3,0,-1,1,0,1,1,0,0,0,108,60,48,10,3,7,21,2,34,28,7,13,11,3,20,14,4,6,10,-1,14,14,3,7,1,3,1,4,1,0,1,1,1,0,0,0,0,2,0,4,1,0,103,58,45,-2,-3,1,28,14,25,13,14,5,18,6,15,6,10,1,10,8,10,7,4,4,1,0,-2,0,0,-1,1,-1,-2,0,-1,0,0,1,0,0,1,-1,88,25,63,-1,-4,3,14,-8,54,-2,17,6,0,-6,26,-6,7,1,14,-2,28,4,10,5,-1,-4,0,1,2,0,-1,-3,-1,0,1,0,0,-1,1,1,1,0,98,39,59,-4,0,-4,31,-7,39,19,-5,17,15,3,12,5,-3,3,16,-10,27,14,-2,14,-1,2,0,-1,-4,-1,-1,0,0,1,-1,0,0,2,0,-2,-3,-1,29,7,22,-1,1,-2,12,5,3,6,-3,7,3,4,0,-1,-1,3,9,1,3,7,-2,4,1,0,-1,0,-1,0,1,0,0,0,0,0,0,0,-1,0,-1,0,-2,14,-16,5,1,4,-1,-8,8,-10,-4,12,1,3,8,-5,2,3,-2,-11,0,-5,-6,9,1,0,2,1,1,0,0,0,0,1,0,0,1,0,2,0,1,0,66,6,60,0,-1,1,-1,-8,3,-1,0,73,4,-9,-3,-2,-1,18,-5,1,6,1,1,55,0,2,-2,-2,2,0,0,2,-1,-3,1,0,0,0,-1,1,1,0,60,22,38,-8,-5,-3,18,6,8,4,-4,26,12,-2,3,4,-2,6,6,8,5,0,-2,20,-2,0,-4,-3,-1,2,0,0,-2,-3,-2,2,-2,0,-2,0,1,0,49,29,20,1,-1,2,19,-13,16,5,-13,34,14,-5,3,7,-1,10,5,-8,13,-2,-12,24,0,1,0,-1,0,1,0,0,0,-1,0,0,0,1,0,0,0,1,109,44,65,20,4,16,35,-1,27,19,1,26,17,-1,17,6,1,4,18,0,10,13,0,22,4,7,5,2,3,-2,1,2,2,0,0,-1,3,5,3,2,3,-1
43,43108,"Pla de Santa Maria, El",1615,26,16,10,16,9,7,9,6,5,9,0,-2,7,4,1,5,1,-2,2,2,4,4,-1,0,7,1,4,2,2,0,3,1,2,1,2,0,4,0,2,1,0,0,29,11,18,11,4,7,12,2,3,5,4,3,8,-2,0,4,0,2,4,4,3,1,4,1,4,2,5,0,0,0,2,0,2,0,0,0,2,2,3,0,0,0,49,27,22,12,6,6,6,19,12,10,8,-10,4,11,5,7,4,-5,2,8,7,3,4,-5,3,4,4,0,1,0,0,3,2,0,1,0,3,1,2,0,0,0,93,44,49,6,5,1,15,15,9,25,13,16,6,8,2,15,8,4,9,7,7,10,5,12,1,1,3,1,0,0,1,1,2,1,0,0,0,0,1,0,0,0,86,63,23,29,24,5,15,17,26,12,16,-2,10,10,23,12,10,-3,5,7,3,0,6,1,1,3,20,4,1,0,0,4,16,4,0,0,1,-1,4,0,1,0,102,46,56,12,6,6,23,14,21,17,10,15,13,6,14,3,3,7,10,8,7,14,7,8,0,6,5,1,0,0,0,3,3,0,0,0,0,3,2,1,0,0,45,24,21,9,3,6,5,6,-1,20,11,3,0,5,-2,9,10,2,5,1,1,11,1,1,4,3,0,1,1,0,2,4,-4,0,1,0,2,-1,4,1,0,0,164,80,84,21,11,10,44,41,25,27,19,6,25,16,11,12,14,2,19,25,14,15,5,4,9,6,3,3,0,0,6,2,1,2,0,0,3,4,2,1,0,0,94,54,40,16,7,9,10,8,26,21,19,11,7,3,14,15,11,5,3,5,12,6,8,6,5,4,5,-1,1,0,2,2,2,0,0,0,3,2,3,-1,1,0,54,30,24,12,3,9,0,6,27,6,9,8,-5,-2,25,4,4,6,5,8,2,2,5,2,4,5,3,2,-1,-1,2,2,0,0,-1,0,2,3,3,2,0,-1,16,8,8,-3,-4,1,3,0,14,-6,10,-3,3,1,4,-5,7,-1,0,-1,10,-1,3,-2,-1,-1,0,-3,2,0,-2,0,0,-3,1,0,1,-1,0,0,1,0,-4,-2,-2,1,-2,3,6,-9,0,1,2,-5,4,-3,-2,1,0,-2,2,-6,2,0,2,-3,0,-2,-1,3,1,-1,1,-2,-1,1,0,-1,-1,0,0,2,1,0,-37,-20,-17,3,1,2,-14,3,-15,-4,-5,-1,-8,1,-5,1,-5,-3,-6,2,-10,-5,0,2,2,4,-4,1,0,0,1,2,-2,1,-1,0,1,2,-2,0,1,0,6,-14,20,3,0,3,5,0,3,2,-5,0,-1,-4,-5,-2,-4,1,6,4,8,4,-1,-1,-1,1,0,3,-1,1,-1,0,0,1,0,0,0,1,0,2,-1,1,-20,-11,-9,1,-3,4,-10,-18,5,-3,-8,15,-4,-6,3,-4,-7,8,-6,-12,2,1,-1,7,2,-1,2,0,-2,0,1,-1,0,0,-3,0,1,0,2,0,1,0,-36,-17,-19,-6,-4,-2,-16,-2,-11,-13,6,-1,-10,0,-7,-5,3,2,-6,-2,-4,-8,3,-3,-1,-1,-4,-2,3,-1,-1,-1,-3,-1,2,0,0,0,-1,-1,1,-1,-33,-23,-10,-7,-3,-4,-8,-4,-10,9,-12,-6,-1,-6,-8,1,-7,-2,-7,2,-2,8,-5,-4,-2,-2,1,-2,-1,-1,0,-2,1,-2,0,0,-2,0,0,0,-1,-1,43,33,10,10,4,6,23,9,15,5,-6,-4,14,3,18,2,-3,-2,9,6,-3,3,-3,-2,4,5,3,-2,0,0,2,2,1,-1,0,0,2,3,2,-1,0,0
43,43111,"Pobla de Montornès, La",1256,155,95,60,31,22,9,31,13,37,39,24,10,18,13,22,24,12,6,13,0,15,15,12,4,4,11,10,3,3,0,2,7,9,2,2,0,2,4,1,1,1,0,101,47,54,4,1,3,9,21,24,26,19,0,1,10,11,12,11,1,8,11,13,14,8,-1,0,1,0,0,2,1,0,0,0,0,1,0,0,1,0,0,1,1,81,44,37,0,0,0,21,-8,14,25,24,1,12,-1,1,13,13,4,9,-7,13,12,11,-3,0,-1,1,0,0,0,0,-1,1,0,0,0,0,0,0,0,0,0,174,89,85,-1,-1,0,35,20,51,32,18,14,21,6,25,23,6,7,14,14,26,9,12,7,0,-1,1,0,0,-1,0,-1,1,0,0,-1,0,0,0,0,0,0,223,117,106,33,18,15,42,21,62,68,23,7,22,11,34,34,16,-1,20,10,28,34,7,8,6,6,5,8,5,2,3,5,3,4,2,0,3,1,2,4,3,2,194,98,96,46,26,20,47,18,78,34,13,3,28,7,40,17,4,0,19,11,38,17,9,3,14,5,6,10,4,6,11,5,1,3,2,3,3,0,5,7,2,3,210,126,84,21,17,4,42,21,83,41,19,3,23,11,43,32,15,2,19,10,40,9,4,1,2,5,7,6,0,1,3,2,5,6,1,0,-1,3,2,0,-1,1,144,87,57,34,26,8,20,20,55,36,11,4,10,5,36,34,4,-1,10,15,19,2,7,5,4,3,10,14,3,0,2,1,8,14,2,-1,2,2,2,0,1,1,93,37,56,20,11,9,30,0,44,12,3,1,17,-4,19,-2,4,2,13,4,25,14,-1,-1,3,3,5,5,-1,3,2,1,5,1,0,2,1,2,0,4,-1,1,26,17,9,18,7,11,0,14,-8,5,13,4,1,5,-3,10,4,2,-1,9,-5,-5,9,2,4,3,2,4,2,3,1,0,1,3,1,2,3,3,1,1,1,1,3,8,-5,-1,1,-2,-5,2,-10,-1,16,0,-7,6,-4,0,10,2,2,-4,-6,-1,6,-2,2,0,0,-2,0,-1,1,1,0,-2,1,0,1,-1,0,0,-1,-1,-38,-30,-8,-15,-20,5,-13,-8,14,-27,6,-9,-3,-1,5,-28,2,-5,-10,-7,9,1,4,-4,1,-2,-2,-12,1,-1,0,-2,-3,-13,-1,-1,1,0,1,1,2,0,1,-11,12,1,-4,5,6,-9,12,-18,3,4,2,-3,1,-15,2,0,4,-6,11,-3,1,4,-2,0,0,-1,1,1,-1,0,0,-3,0,-1,-1,0,0,2,1,2,-26,-16,-10,12,5,7,-2,0,4,-13,-2,-12,-5,2,-1,-4,-3,-5,3,-2,5,-9,1,-7,4,1,4,0,3,0,0,0,2,2,1,0,4,1,2,-2,2,0,-7,12,-19,-16,-9,-7,-6,-1,-9,0,5,5,9,-3,4,-1,3,0,-15,2,-13,1,2,5,-5,1,-6,-3,-2,-1,-2,0,-2,-2,-2,-1,-3,1,-4,-1,0,0,-48,-38,-10,12,1,11,-24,-6,7,-11,-7,-9,-21,-6,7,-7,-6,-7,-3,0,0,-4,-1,-2,0,3,3,2,3,1,-2,0,2,1,1,-1,2,3,1,1,2,2,0,-3,3,9,4,5,1,12,-4,-7,6,-7,-1,1,-2,-5,4,-1,2,11,-2,-2,2,-6,2,1,0,1,1,4,1,1,-1,0,1,2,1,0,1,1,0,2,48,33,15,15,7,8,20,0,9,3,6,10,17,-2,1,7,3,9,3,2,8,-4,3,1,3,2,1,1,4,4,2,0,0,1,2,2,1,2,1,0,2,2
43,43123,Reus,88912,-442,-204,-238,46,29,17,-62,-81,-168,-64,-65,0,-21,-62,-57,-30,-35,-1,-41,-19,-111,-34,-30,1,8,2,14,9,6,5,4,2,9,5,3,4,4,0,5,4,3,1,65,32,33,45,22,23,32,56,14,-15,-28,0,20,19,7,6,-16,-10,12,37,7,-21,-12,10,11,5,8,6,6,5,7,2,4,3,1,4,4,3,4,3,5,1,172,195,-23,-25,-10,-15,8,26,98,52,-30,7,-19,22,125,70,-17,9,27,4,-27,-18,-13,-2,-5,-6,-21,-6,5,8,-5,-3,-9,-3,4,6,0,-3,-12,-3,1,2,665,387,278,292,163,129,119,204,174,49,64,56,71,93,159,15,35,9,48,111,15,34,29,47,57,72,74,52,29,4,32,29,50,33,13,4,25,43,24,19,16,0,2286,1336,950,2391,1299,1092,376,640,819,400,47,0,170,360,549,227,21,0,206,280,270,173,26,0,457,609,743,425,120,27,228,324,455,225,58,8,229,285,288,200,62,19,3265,1888,1377,2814,1488,1326,614,799,1035,543,157,83,285,452,671,363,65,34,329,347,364,180,92,49,633,693,850,443,128,45,273,370,511,254,54,15,360,323,339,189,74,30,2754,1423,1331,2560,1323,1237,565,713,832,386,77,150,268,332,491,236,30,45,297,381,341,150,47,105,525,696,745,401,130,31,272,317,426,218,62,12,253,379,319,183,68,19,3026,1614,1412,3181,1686,1495,565,991,846,432,104,73,254,558,491,248,21,36,311,433,355,184,83,37,648,946,895,471,153,41,329,504,516,240,63,19,319,442,379,231,90,22,-534,-458,-76,1087,493,594,96,-40,-303,-173,-106,14,59,-33,-265,-143,-72,3,37,-7,-38,-30,-34,11,354,284,302,110,18,3,191,124,134,29,0,4,163,160,168,81,18,-1,-755,-664,-91,542,148,394,51,-107,-360,-249,-92,1,15,-99,-312,-212,-67,5,36,-8,-48,-37,-25,-4,189,177,110,17,32,4,93,59,10,-26,0,4,96,118,100,43,32,0,-617,-628,11,-546,-447,-99,10,-40,-274,-214,-89,-34,7,-121,-261,-168,-70,-26,3,81,-13,-46,-19,-8,13,-2,-268,-190,-75,-51,19,-48,-206,-155,-51,-22,-6,46,-62,-35,-24,-29,117,8,109,263,35,228,106,55,-18,-99,27,52,75,10,13,-92,-5,16,31,45,-31,-7,32,36,133,128,9,-43,11,0,60,39,0,-67,-3,-6,73,89,9,24,14,6,-817,-612,-205,-631,-400,-231,-156,-59,-280,-265,-89,28,-121,-46,-210,-189,-44,6,-35,-13,-70,-76,-45,22,-117,4,-215,-218,-78,-17,-69,-3,-134,-153,-45,-1,-48,7,-81,-65,-33,-16,-1354,-847,-507,-966,-634,-332,-97,-211,-499,-405,-148,13,-60,-122,-298,-280,-87,4,-37,-89,-201,-125,-61,9,-100,-72,-330,-340,-118,-21,-51,-44,-209,-247,-77,-11,-49,-28,-121,-93,-41,-10,-1609,-981,-628,-1480,-875,-605,-308,-216,-506,-469,-140,-5,-178,-128,-299,-326,-70,-5,-130,-88,-207,-143,-70,0,-224,-141,-473,-444,-168,-51,-122,-82,-269,-301,-84,-29,-102,-59,-204,-143,-84,-22,531,234,297,157,53,104,93,65,90,61,65,105,50,49,45,-8,26,46,43,16,45,69,39,59,27,87,28,-33,23,4,23,41,13,-45,11,0,4,46,15,12,12,4,11,-99,110,-140,-139,-1,34,48,-6,-182,-17,101,20,24,-17,-161,-34,51,14,24,11,-21,17,50,14,56,-28,-148,-53,-7,-14,30,-9,-122,-33,-4,28,26,-19,-26,-20,-3,35,1,34,21,-22,43,63,-34,-9,-41,-46,51,37,-40,1,-26,-23,29,26,6,-10,-15,-23,22,55,79,-19,-70,-47,-3,31,29,-7,-52,-38,0,24,50,-12,-18,-9,-3
43,43127,Riudecanyes,664,37,24,13,21,17,4,7,8,14,3,6,0,5,6,8,2,3,0,2,2,6,1,3,0,6,9,4,2,0,0,4,8,3,2,0,0,2,1,1,0,0,0,28,9,19,14,5,9,10,4,7,3,4,-1,5,2,1,1,1,-1,5,2,6,2,3,0,6,1,3,1,2,0,3,0,1,0,1,0,3,1,2,1,1,0,0,1,-1,3,1,2,0,3,-5,-1,2,2,-2,3,0,-3,3,1,2,0,-5,2,-1,1,0,0,0,1,0,2,0,0,0,1,0,0,0,0,0,0,0,2,18,10,8,5,4,1,6,3,4,-2,6,1,7,2,3,-5,3,0,-1,1,1,3,3,1,2,2,0,1,0,0,2,2,0,0,0,0,0,0,0,1,0,0,71,36,35,15,10,5,13,2,29,11,13,0,7,-1,15,6,7,2,6,3,14,5,6,-2,1,3,7,3,0,1,0,2,5,2,0,1,1,1,2,1,0,0,43,15,28,10,2,8,0,11,23,3,7,-1,-4,4,10,0,5,0,4,7,13,3,2,-1,0,3,3,1,3,0,-2,1,2,0,1,0,2,2,1,1,2,0,82,49,33,8,9,-1,12,5,35,21,3,-3,6,7,17,12,0,0,6,-2,18,9,3,-3,-1,2,2,4,1,0,0,3,2,3,1,0,-1,-1,0,1,0,0,68,31,37,29,16,13,15,3,28,17,2,2,5,3,15,6,1,0,10,0,13,11,1,2,6,5,10,4,2,2,2,3,6,3,2,0,4,2,4,1,0,2,34,15,19,6,0,6,5,8,8,8,8,-1,3,4,2,6,2,-1,2,4,6,2,6,0,2,5,1,-1,0,-1,1,2,0,-2,0,-1,1,3,1,1,0,0,27,16,11,8,5,3,8,8,12,3,-4,-1,7,6,2,0,0,0,1,2,10,3,-4,-1,0,2,4,1,0,1,0,2,2,1,0,0,0,0,2,0,0,1,22,18,4,12,9,3,7,1,3,10,-3,5,7,1,1,7,-1,3,0,0,2,3,-2,2,5,1,4,2,0,0,3,0,3,2,0,1,2,1,1,0,0,-1,21,12,9,10,3,7,-2,6,8,0,10,-1,-1,0,6,1,7,-1,-1,6,2,-1,3,0,3,1,5,-2,2,1,0,-1,3,0,1,0,3,2,2,-2,1,1,-14,0,-14,9,7,2,-6,-4,3,-2,-1,-2,-1,-1,5,-1,0,0,-5,-3,-2,-1,-1,-2,0,2,3,2,2,0,0,2,2,2,1,0,0,0,1,0,1,0,2,1,1,6,4,2,5,0,7,-10,-2,3,3,0,4,-4,-3,1,2,0,3,-6,1,2,6,1,-1,-1,0,1,3,1,1,-1,0,0,3,0,-2,0,0,1,16,6,10,11,5,6,7,-1,-1,3,5,3,2,1,0,-2,3,2,5,-2,-1,5,2,1,2,2,1,1,3,2,1,1,1,0,1,1,1,1,0,1,2,1,-52,-23,-29,-11,-5,-6,-8,-4,-6,-15,-12,-8,-1,-3,-1,-7,-6,-5,-7,-1,-5,-8,-6,-3,1,0,-3,-2,-7,0,0,0,-1,-1,-4,1,1,0,-2,-1,-3,-1,-8,-3,-5,12,11,1,-4,10,-7,-1,-1,-4,-5,7,1,-2,-1,-2,1,3,-8,1,0,-2,-2,6,4,4,1,-1,-2,5,5,3,1,-1,0,1,-1,1,0,0,49,26,23,12,3,9,12,4,10,15,5,3,8,1,3,10,1,3,4,3,7,5,4,0,3,2,3,0,3,1,1,0,0,-1,2,1,2,2,3,1,1,0
43,43129,Riudoms,5153,81,61,20,66,45,21,11,25,21,14,11,-2,7,16,22,11,4,0,4,9,-1,3,7,-2,14,23,13,9,5,1,9,16,10,7,3,0,5,7,3,2,2,1,53,21,32,45,24,21,21,12,-7,19,3,2,8,5,-5,8,1,2,13,7,-2,11,2,0,6,14,14,8,2,0,2,7,9,5,0,0,4,7,5,3,2,0,126,71,55,109,66,43,33,11,49,16,10,6,22,4,25,9,8,3,11,7,24,7,2,3,25,26,43,12,1,2,12,15,28,9,1,1,13,11,15,3,0,1,89,50,39,92,49,43,23,10,13,32,0,12,9,8,8,17,1,8,14,2,5,15,-1,4,27,23,28,9,1,4,13,13,13,7,0,3,14,10,15,2,1,1,150,83,67,98,51,47,33,35,14,39,17,15,20,16,14,21,8,6,13,19,0,18,9,9,24,28,19,21,5,1,10,14,11,13,2,1,14,14,8,8,3,0,178,56,122,68,32,36,47,27,33,26,3,43,21,17,3,10,-2,6,26,10,30,16,5,37,15,25,21,6,1,0,7,12,10,3,0,0,8,13,11,3,1,0,200,99,101,77,46,31,66,33,20,53,0,23,34,19,14,22,1,5,32,14,6,31,-1,18,15,21,17,16,6,2,12,14,8,8,2,2,3,7,9,8,4,0,227,134,93,147,81,66,43,43,56,58,16,10,23,23,42,38,6,1,20,20,14,20,10,9,30,42,36,32,5,1,16,27,17,18,2,0,14,15,19,14,3,1,36,10,26,38,10,28,-5,19,6,17,-4,-2,-10,5,1,14,-4,-1,5,14,5,3,0,-1,10,7,10,12,-2,0,3,1,2,5,-2,0,7,6,8,7,0,0,47,32,15,-10,-13,3,2,22,-5,14,-1,15,4,18,-4,11,-3,4,-2,4,-1,3,2,11,2,6,-11,-7,3,-3,2,1,-8,-7,1,-2,0,5,-3,0,2,-1,-6,-5,-1,-29,-24,-5,16,-7,2,-14,0,-5,7,-3,1,-6,-2,-2,9,-4,1,-8,2,-3,-3,-1,-8,-12,-5,0,-2,-5,-3,-11,-3,0,-1,4,-5,-1,-2,0,32,16,16,28,18,10,8,-1,7,-9,11,14,9,0,0,-8,8,6,-1,-1,7,-1,3,8,6,7,3,6,3,3,6,7,2,0,2,1,0,0,1,6,1,2,-67,-43,-24,-51,-30,-21,-17,-13,-16,-19,-6,3,-5,-1,-17,-17,1,-4,-12,-12,1,-2,-7,7,-9,-3,-15,-15,-8,-1,-7,1,-13,-6,-5,0,-2,-4,-2,-9,-3,-1,61,26,35,-16,-10,-6,4,1,32,-5,-2,26,1,-4,21,-8,1,12,3,5,11,3,-3,14,-6,0,-4,-7,-1,0,-2,-2,-2,-4,-2,0,-4,2,-2,-3,1,0,82,42,40,13,8,5,17,19,8,23,-3,16,10,14,6,8,-3,6,7,5,2,15,0,10,-3,7,1,7,2,0,-2,6,2,3,-1,0,-1,1,-1,4,3,0,6,7,-1,25,10,15,0,10,-12,-9,8,10,-2,1,-4,4,4,5,2,9,-8,-13,4,5,5,11,5,5,-1,0,-1,4,5,5,-3,0,6,7,0,0,2,0,28,17,11,39,22,17,-14,12,-3,8,10,18,-8,7,10,-3,6,7,-6,5,-13,11,4,11,5,8,13,9,3,1,2,5,8,5,2,0,3,3,5,4,1,1,83,27,56,41,21,20,24,7,19,-2,3,32,9,1,6,0,2,9,15,6,13,-2,1,23,12,6,12,8,3,0,7,1,6,6,1,0,5,5,6,2,2,0
43,43131,Roda de Barà,3150,227,123,104,80,60,20,31,30,59,46,46,10,17,18,26,31,21,6,14,12,33,15,25,4,13,22,24,11,8,2,8,19,19,9,4,1,5,3,5,2,4,1,276,151,125,86,56,30,48,45,74,60,39,5,22,34,42,28,23,0,26,11,32,32,16,5,21,25,20,11,4,2,11,20,14,6,2,0,10,5,6,5,2,2,236,109,127,61,34,27,39,22,69,22,49,37,18,12,38,4,24,14,21,10,31,18,25,23,14,17,10,11,7,1,8,9,7,3,6,0,6,8,3,8,1,1,217,93,124,74,37,37,-1,30,43,51,66,29,-10,7,21,30,34,12,9,23,22,21,32,17,16,16,21,15,4,1,9,8,9,9,2,0,7,8,12,6,2,1,264,135,129,80,41,39,67,34,58,50,43,13,32,18,28,28,28,2,35,16,30,22,15,11,29,21,14,13,1,1,13,12,9,7,-1,1,16,9,5,6,2,0,255,136,119,89,51,38,51,31,57,41,24,40,28,21,26,28,11,18,23,10,31,13,13,22,20,15,17,22,5,7,8,11,7,18,3,4,12,4,10,4,2,3,389,214,175,109,60,49,67,59,124,64,51,14,32,27,70,47,30,4,35,32,54,17,21,10,24,33,18,15,11,8,15,15,11,11,5,3,9,18,7,4,6,5,422,217,205,120,59,61,75,63,129,78,49,22,49,25,64,35,37,6,26,38,65,43,12,16,26,36,23,17,12,5,14,13,14,7,7,3,12,23,9,10,5,2,194,86,108,84,41,43,62,9,28,44,26,22,40,3,10,23,4,8,22,6,18,21,22,14,30,16,14,15,6,2,18,10,4,7,1,1,12,6,10,8,5,1,68,30,38,34,17,17,-9,1,18,3,11,41,-5,1,19,-5,7,10,-4,0,-1,8,4,31,7,5,8,5,8,0,3,1,5,3,4,1,4,4,3,2,4,-1,108,41,67,39,13,26,14,6,27,33,13,14,12,-4,2,18,6,4,2,10,25,15,7,10,14,8,15,7,-6,-1,8,2,5,0,-4,0,6,6,10,7,-2,-1,21,16,5,9,-2,11,0,6,-10,8,-15,25,0,3,3,6,-9,9,0,3,-13,2,-6,16,6,5,-4,0,0,1,2,0,-1,-1,-1,-1,4,5,-3,1,1,2,99,13,86,-22,-12,-10,3,7,27,-11,20,46,-2,-9,11,-14,7,15,5,16,16,3,13,31,-6,-4,-6,-8,-4,5,-1,-6,-5,-4,-1,4,-5,2,-1,-4,-3,1,-23,-8,-15,5,-6,11,10,-14,-5,-7,4,-9,8,-8,6,-14,5,-4,2,-6,-11,7,-1,-5,1,1,3,-7,9,-3,-1,-3,2,-7,3,-1,2,4,1,0,6,-2,55,10,45,11,2,9,5,-3,3,2,10,29,0,-1,-7,7,5,7,5,-2,10,-5,5,22,-1,7,-1,-2,10,-3,-1,5,-5,-1,6,-2,0,2,4,-1,4,-1,78,41,37,33,25,8,-4,-3,3,-5,5,71,4,-4,5,-7,3,35,-8,1,-2,2,2,36,5,1,9,7,5,4,6,0,6,5,4,2,-1,1,3,2,1,2,11,-3,14,28,11,17,-35,2,9,-7,11,23,-17,3,1,-2,4,7,-18,-1,8,-5,7,16,1,5,-2,6,8,9,-1,4,-2,1,2,6,2,1,0,5,6,3,130,55,75,46,19,27,14,34,27,4,27,24,-1,25,8,5,6,14,15,9,19,-1,21,10,9,4,10,6,13,4,3,1,3,5,5,2,6,3,7,1,8,2
43,43133,Roquetes,6289,-12,-3,-9,60,37,23,4,-16,17,-15,8,-9,-4,1,10,-11,9,-5,8,-17,7,-4,-1,-4,17,9,18,13,1,1,8,7,13,8,0,1,9,2,5,5,1,0,133,97,36,93,70,23,15,33,47,24,8,6,14,24,33,19,4,2,1,9,14,5,4,4,14,24,36,14,4,0,8,20,30,10,1,0,6,4,6,4,3,0,197,103,94,113,62,51,45,47,60,42,5,-6,25,22,35,21,2,-3,20,25,25,21,3,-3,26,28,31,21,6,0,11,18,19,10,4,0,15,10,12,11,2,0,189,113,76,128,81,47,62,25,52,37,7,5,37,17,22,27,3,5,25,8,30,10,4,0,37,19,34,27,9,0,24,12,23,15,5,0,13,7,11,12,4,0,168,103,65,97,52,45,41,29,43,29,20,2,16,18,36,15,16,2,25,11,7,14,4,0,17,15,30,16,15,2,7,6,19,9,9,2,10,9,11,7,6,0,214,131,83,129,81,48,41,43,70,38,11,13,9,28,59,27,5,5,32,15,11,11,6,8,18,30,43,28,8,3,9,17,32,16,6,1,9,13,11,12,2,2,236,118,118,140,89,51,67,63,25,46,28,4,33,34,12,23,12,5,34,29,13,23,16,-1,28,33,32,24,16,5,17,22,22,16,8,3,11,11,10,8,8,2,292,178,114,193,115,78,40,64,94,55,15,17,20,40,61,38,9,5,20,24,33,17,6,12,27,64,51,27,16,3,12,42,31,16,9,1,15,22,20,11,7,2,203,128,75,142,79,63,46,44,59,42,18,-12,32,24,40,24,12,-4,14,20,19,18,6,-8,48,33,32,21,7,-1,30,22,13,11,3,0,18,11,19,10,4,-1,-21,-21,0,77,28,49,6,11,-11,0,-9,-17,1,12,-20,5,-9,-10,5,-1,9,-5,0,-7,28,28,10,9,-2,3,13,12,-4,7,-1,0,15,16,14,2,-1,3,-29,-51,22,-102,-70,-32,41,-13,6,-8,-32,-31,18,-23,5,-14,-18,-20,23,10,1,6,-14,-11,1,-4,-25,-22,-38,-18,5,-6,-19,-20,-20,-11,-4,2,-6,-2,-18,-7,22,-15,37,29,-7,36,5,0,9,-10,10,-6,4,0,-9,-18,6,-3,1,0,18,8,4,-3,13,13,4,-3,-1,0,4,5,-9,-8,-1,1,9,8,13,5,0,-1,-66,-49,-17,-20,-26,6,0,-8,-25,-28,2,-7,-6,-6,-11,-13,-5,-6,6,-2,-14,-15,7,-1,0,-2,-9,-12,3,-2,1,-6,-12,-9,1,-1,-1,4,3,-3,2,-1,-18,-50,32,-14,-23,9,-1,11,-21,-6,-7,-9,-16,0,-16,-10,-7,-9,15,11,-5,4,0,0,4,7,-7,-5,-14,1,-1,3,-7,-7,-11,0,5,4,0,2,-3,1,-66,-29,-37,-10,-9,-1,-15,-14,-8,-23,-15,-4,6,-4,-7,-13,-8,-6,-21,-10,-1,-10,-7,2,-5,0,-7,-7,7,1,1,-1,-4,-8,4,-1,-6,1,-3,1,3,2,-53,-5,-48,7,3,4,-1,-32,-4,10,-11,-21,9,-12,-3,10,-5,-7,-10,-20,-1,0,-6,-14,-1,-2,4,7,-2,0,1,0,0,4,-2,-1,-2,-2,4,3,0,1,-76,-43,-33,-5,2,-7,-32,24,-32,-29,6,-20,-15,12,-16,-27,6,-8,-17,12,-16,-2,0,-12,-10,9,-2,-10,4,1,0,3,3,-10,3,1,-10,6,-5,0,1,0,-119,-77,-42,-4,-14,10,-25,-17,-25,-29,-13,-15,-20,-10,-15,-28,-1,-7,-5,-7,-10,-1,-12,-8,5,0,-2,-8,1,-1,-1,-3,-3,-9,2,-2,6,3,1,1,-1,1
43,43905,Salou,12267,859,458,401,568,321,247,115,182,343,143,50,19,60,84,210,77,17,8,55,98,133,66,33,11,73,122,212,104,41,12,45,60,128,61,21,5,28,62,84,43,20,7,1125,596,529,660,363,297,153,225,399,200,85,55,67,136,231,100,34,22,86,89,168,100,51,33,106,167,223,108,35,13,56,86,135,58,16,7,50,81,88,50,19,6,1460,874,586,993,587,406,131,403,536,229,86,64,91,221,337,151,43,26,40,182,199,78,43,38,98,273,390,166,52,11,58,145,250,101,27,4,40,128,140,65,25,7,1431,748,683,971,541,430,191,297,502,263,123,33,90,134,285,154,62,15,101,163,217,109,61,18,140,239,334,162,76,12,79,125,200,92,35,6,61,114,134,70,41,6,1713,1033,680,1334,801,533,107,412,687,295,147,46,49,235,471,183,74,12,58,177,216,112,73,34,148,346,495,231,82,27,75,207,323,149,37,8,73,139,172,82,45,19,1802,1100,702,1552,940,612,142,498,638,307,134,75,89,276,449,172,71,37,53,222,189,135,63,38,160,423,559,281,84,31,90,227,378,177,44,15,70,196,181,104,40,16,2120,1286,834,1570,924,646,231,573,701,328,180,76,131,340,460,201,103,32,100,233,241,127,77,44,225,468,479,252,96,34,136,268,298,149,56,12,89,200,181,103,40,22,2077,1251,826,1547,903,644,248,601,691,353,124,53,154,359,434,209,64,26,94,242,257,144,60,27,200,511,517,205,82,21,116,290,332,104,41,14,84,221,185,101,41,7,707,415,292,702,389,313,92,234,220,111,13,18,52,101,176,70,2,2,40,133,44,41,11,16,129,213,244,105,-2,-4,72,103,150,61,-6,1,57,110,94,44,4,-5,259,106,153,10,-61,71,81,197,-96,-18,44,42,37,131,-68,-19,8,17,44,66,-28,1,36,25,70,124,-110,-67,-14,-3,38,66,-90,-59,-19,-1,32,58,-20,-8,5,-2,-907,-476,-431,-1044,-609,-435,-80,-6,-317,-292,-157,-48,-37,19,-183,-184,-70,-21,-43,-25,-134,-108,-87,-27,-47,-70,-375,-328,-155,-75,-21,-29,-235,-211,-85,-34,-26,-41,-140,-117,-70,-41,338,63,275,99,9,90,70,142,81,38,-12,9,28,58,-20,-1,-1,-6,42,84,101,39,-11,15,46,69,-18,14,-12,-9,27,34,-49,-4,-1,-3,19,35,31,18,-11,-6,37,-19,56,138,13,125,-2,86,17,-43,-17,5,14,27,7,-45,-9,-10,-16,59,10,2,-8,15,13,86,32,-21,17,6,13,36,3,-42,0,0,0,50,29,21,17,6,-203,-159,-44,-117,-128,11,-64,18,-82,-102,2,18,-39,3,-52,-72,-11,8,-25,15,-30,-30,13,10,-22,35,-74,-57,2,-8,-14,8,-61,-47,-10,-6,-8,27,-13,-10,12,-2,-178,-142,-36,-120,-103,-17,-5,83,-149,-115,2,3,-5,49,-99,-71,-1,-20,0,34,-50,-44,3,23,37,48,-95,-83,-23,-13,16,25,-59,-61,-22,-9,21,23,-36,-22,-1,-4,-69,-100,31,166,81,85,44,17,-31,-84,-26,6,14,20,-26,-74,-27,-8,30,-3,-5,-10,1,14,48,64,49,-10,5,3,32,44,18,-15,0,-1,16,20,31,5,5,4,-83,-81,-2,-121,-97,-24,-7,82,-38,-131,-25,24,15,44,-17,-112,-27,9,-22,38,-21,-19,2,15,-19,78,-38,-107,-27,-17,-10,54,-32,-77,-29,-8,-9,24,-6,-30,2,-9,370,144,226,345,158,187,88,128,95,29,22,6,23,61,42,-2,13,2,65,67,53,31,9,4,97,97,126,22,-10,3,46,51,65,0,-11,0,51,46,61,22,1,3
43,43136,Sant Carles de la Ràpita,11106,282,156,126,152,86,66,32,71,99,36,20,23,10,42,55,20,15,13,22,29,44,16,5,10,9,50,52,25,11,5,6,32,28,12,6,2,3,18,24,13,5,3,232,134,98,213,130,83,30,61,66,39,40,3,13,36,43,24,19,3,17,25,23,15,21,0,32,51,75,33,18,3,15,34,45,22,11,2,17,17,30,11,7,1,263,128,135,168,87,81,23,61,94,55,20,6,10,29,56,19,10,1,13,32,38,36,10,5,31,51,53,24,7,1,19,27,29,8,4,-1,12,24,24,16,3,2,288,141,147,137,70,67,31,65,64,49,39,38,8,36,42,26,18,11,23,29,22,23,21,27,17,38,42,27,9,3,9,17,22,14,5,3,8,21,20,13,4,0,542,270,272,312,158,154,75,127,151,96,51,31,36,53,82,56,19,17,39,74,69,40,32,14,48,98,92,51,13,5,24,37,54,30,6,4,24,61,38,21,7,1,486,252,234,363,202,161,73,152,121,51,54,28,44,83,59,30,17,15,29,69,62,21,37,13,61,116,93,48,32,9,35,65,53,29,13,3,26,51,40,19,19,6,755,393,362,423,212,211,120,133,202,179,83,22,58,65,107,102,47,4,62,68,95,77,36,18,73,118,122,69,26,8,32,49,67,47,10,4,41,69,55,22,16,4,996,566,430,651,370,281,144,232,259,197,85,70,70,133,165,113,48,29,74,99,94,84,37,41,112,188,172,127,38,6,56,111,106,68,22,3,56,77,66,59,16,3,250,76,174,154,72,82,15,35,29,17,46,104,3,8,23,-2,12,27,12,27,6,19,34,77,34,59,41,4,11,3,23,28,19,-4,4,0,11,31,22,8,7,3,66,-46,112,-112,-85,-27,33,-24,-15,-41,20,95,13,-21,-35,-32,5,27,20,-3,20,-9,15,68,4,-16,-45,-42,-12,-2,1,-15,-26,-33,-10,-2,3,-1,-19,-9,-2,0,-240,-147,-93,-267,-155,-112,-46,-35,-76,-73,-61,47,-22,-19,-34,-59,-28,12,-24,-16,-42,-14,-33,35,-41,-22,-77,-62,-60,-7,-24,-8,-45,-51,-26,-2,-17,-14,-32,-11,-34,-5,-58,-26,-32,7,-3,10,-22,-28,-29,0,5,18,-7,-16,-16,4,5,6,-15,-12,-13,-4,0,12,-14,0,6,12,1,1,-9,-4,-4,10,1,2,-5,4,10,2,0,-1,82,57,25,21,24,-3,15,25,-10,-18,21,48,16,17,3,-12,10,26,-1,8,-13,-6,11,22,11,19,5,-8,-4,-2,9,12,9,-3,-3,0,2,7,-4,-5,-1,-2,37,-14,51,-98,-72,-26,-20,8,-8,-10,33,34,-6,-8,-10,-14,14,12,-14,16,2,4,19,22,-29,-7,-28,-37,3,0,-19,-8,-16,-27,-3,1,-10,1,-12,-10,6,-1,-190,-122,-68,-172,-119,-53,-22,-34,-107,-69,13,29,-6,-20,-73,-47,6,20,-16,-14,-34,-22,7,9,-12,-14,-63,-58,-24,-2,-8,-15,-47,-34,-13,-3,-4,1,-16,-24,-11,1,39,10,29,49,23,26,-7,18,-7,-42,38,40,4,1,0,-31,18,19,-11,17,-7,-11,20,21,6,11,9,-2,19,5,5,4,5,-2,6,4,1,7,4,0,13,1,251,106,145,146,90,56,39,15,48,53,54,40,14,2,34,17,10,27,25,13,14,36,44,13,19,14,24,51,31,5,12,10,20,29,11,7,7,4,4,22,20,-2,-99,-77,-22,-188,-111,-77,2,2,-22,-81,-37,28,-6,3,-4,-48,-24,-3,8,-1,-18,-33,-13,31,1,6,-37,-92,-44,-24,-4,2,-15,-56,-21,-17,5,4,-22,-36,-23,-7
43,43902,Sant Jaume d'Enveja,3331,8,13,-5,14,8,6,-5,16,-5,3,-3,2,0,10,-3,5,-3,4,-5,6,-2,-2,0,-2,0,10,1,3,0,0,0,5,1,2,0,0,0,5,0,1,0,0,7,8,-1,15,8,7,1,-1,-3,5,5,-1,2,0,-2,6,3,-2,-1,-1,-1,-1,2,1,5,3,3,3,1,0,3,2,0,2,1,0,2,1,3,1,0,0,8,7,1,23,14,9,1,11,-1,9,-7,-6,-1,8,-3,9,-5,-2,2,3,2,0,-2,-4,4,6,8,5,0,0,3,2,6,3,0,0,1,4,2,2,0,0,10,-6,16,21,7,14,6,2,-2,-1,6,0,0,1,-8,-2,5,-2,6,1,6,1,1,2,8,4,5,3,0,1,2,3,2,0,0,0,6,1,3,3,0,1,63,30,33,38,21,17,12,12,11,18,5,6,8,8,6,5,1,3,4,4,5,13,4,3,7,15,4,9,3,0,5,8,1,5,2,0,2,7,3,4,1,0,12,15,-3,26,14,12,0,0,-5,13,6,-1,1,-2,3,9,4,0,-1,2,-8,4,2,-1,2,6,6,10,0,2,1,3,0,9,0,1,1,3,6,1,0,1,74,47,27,54,30,24,4,26,18,5,14,6,8,11,12,9,5,2,-4,15,6,-4,9,4,6,20,10,10,6,1,4,12,4,5,3,1,2,8,6,5,3,0,49,23,26,55,29,26,-1,26,11,2,6,5,-1,12,11,-1,0,3,0,14,0,3,6,2,8,21,13,5,6,2,5,9,9,3,2,1,3,12,4,2,4,1,37,19,18,6,-3,9,3,6,18,5,5,0,1,-1,8,2,6,2,2,7,10,3,-1,-2,-1,7,-2,2,-1,1,-1,2,-3,-1,0,0,0,5,1,3,-1,1,12,3,9,-2,-1,-1,5,-4,8,2,-2,1,2,-2,1,1,-1,0,3,-2,7,1,-1,1,-2,1,1,-1,-3,2,-1,1,1,-2,-1,1,-1,0,0,1,-2,1,-6,-3,-3,-10,-11,1,1,-2,-5,3,4,-7,2,0,1,-2,-1,-3,-1,-2,-6,5,5,-4,2,-1,-4,-5,0,-2,0,-2,-1,-4,-3,-1,2,1,-3,-1,3,-1,14,20,-6,1,0,1,6,6,2,-5,4,-3,4,7,1,3,3,0,2,-1,1,-8,1,-3,1,3,-2,-3,1,1,0,2,-1,-2,0,1,1,1,-1,-1,1,0,27,9,18,6,2,4,4,-2,6,14,9,-4,-3,-5,6,6,5,-1,7,3,0,8,4,-3,4,0,0,3,-1,0,2,0,0,1,-1,0,2,0,0,2,0,0,-5,-12,7,-19,-16,-3,0,-5,-3,-7,6,2,-3,-7,0,-7,3,1,3,2,-3,0,3,1,0,-6,-7,-6,-1,0,0,-4,-6,-5,-1,0,0,-2,-1,-1,0,0,8,11,-3,2,1,1,-5,5,9,4,1,-7,-3,2,8,4,1,-2,-2,3,1,0,0,-5,0,2,-2,3,-1,0,0,0,-1,2,0,0,0,2,-1,1,-1,0,-28,-33,5,-22,-17,-5,3,-5,-12,-10,6,-9,-1,-8,-5,-13,0,-7,4,3,-7,3,6,-2,-3,-1,-7,-7,0,-4,-4,-1,-4,-5,0,-3,1,0,-3,-2,0,-1,-2,4,-6,19,10,9,-18,-1,0,-8,22,0,-11,3,0,-4,14,1,-7,-4,0,-4,8,-1,4,4,5,0,4,0,2,3,1,0,3,0,2,1,4,0,1,0,16,0,16,15,5,10,1,-1,11,1,9,-6,-1,-1,-2,5,3,-3,2,0,13,-4,6,-3,4,3,6,4,-1,-1,3,0,0,4,-1,-1,1,3,6,0,0,0
43,43140,Santa Oliva,2064,74,32,42,18,7,11,28,13,14,7,5,4,11,3,5,7,2,2,17,10,9,0,3,2,3,5,5,2,2,0,0,2,1,2,1,0,3,3,4,0,1,0,84,47,37,26,19,7,10,-1,26,19,24,4,3,-2,15,15,12,3,7,1,11,4,12,1,0,5,12,7,1,1,0,3,9,5,1,1,0,2,3,2,0,0,135,73,62,34,18,16,42,22,27,22,16,8,21,13,15,8,10,6,21,9,12,14,6,2,8,9,9,3,3,2,4,4,7,1,2,0,4,5,2,2,1,2,181,115,66,24,20,4,32,31,64,29,10,10,24,20,41,22,4,3,8,11,23,7,6,7,1,12,3,7,1,0,2,9,3,6,0,0,-1,3,0,1,1,0,111,80,31,45,25,20,15,2,36,21,24,10,13,7,28,9,15,6,2,-5,8,12,9,4,8,10,15,7,4,1,6,6,6,4,3,0,2,4,9,3,1,1,211,114,97,64,45,19,45,28,65,39,15,14,24,8,36,26,8,9,21,20,29,13,7,5,12,18,20,8,2,3,9,13,14,6,1,1,3,5,6,2,1,2,105,63,42,27,18,9,19,6,52,16,23,-14,11,9,33,4,10,-6,8,-3,19,12,13,-8,4,8,11,2,1,1,1,5,8,3,1,0,3,3,3,-1,0,1,85,27,58,14,3,11,28,4,20,18,11,2,17,-1,3,4,5,-2,11,5,17,14,6,4,1,10,3,-2,0,2,0,5,-1,-2,0,1,1,5,4,0,0,1,76,47,29,24,16,8,18,2,16,20,7,13,5,1,13,14,5,7,13,1,3,6,2,6,9,5,5,7,-2,0,4,3,6,4,-1,0,5,2,-1,3,-1,0,78,57,21,4,-1,5,31,5,23,10,0,1,23,3,19,8,3,-3,8,2,4,2,-3,4,10,-2,4,-8,0,-1,7,-3,0,-4,0,-1,3,1,4,-4,0,0,47,29,18,28,16,12,8,5,33,-14,3,6,-1,-4,25,1,0,3,9,9,8,-15,3,3,4,11,8,3,1,0,4,4,7,1,0,0,0,7,1,2,1,0,5,3,2,23,13,10,12,-6,8,1,-2,-6,0,3,2,0,1,-3,12,-9,6,1,-3,-3,4,4,6,2,5,2,0,2,5,0,4,2,4,2,1,2,1,0,-6,-19,13,-15,-10,-5,1,-13,-1,-6,11,1,6,-9,-8,-7,-2,2,-5,-4,7,1,13,-1,-7,2,-3,-8,1,0,0,0,-3,-6,-1,0,-7,2,0,-2,2,0,-15,-8,-7,-2,1,-3,-13,5,-11,-11,5,7,-5,7,-9,-3,5,-3,-8,-2,-2,-8,0,10,-4,-1,-2,2,3,0,-1,1,-1,2,1,-1,-3,-2,-1,0,2,1,-49,-22,-27,-56,-32,-24,-17,-6,3,-18,-16,2,-18,-2,7,-10,-8,6,1,-4,-4,-8,-8,-4,-7,-4,-14,-19,-8,-3,-4,-5,-6,-11,-4,-1,-3,1,-8,-8,-4,-2,-69,-27,-42,3,0,3,-25,-11,-8,-17,-7,1,-6,-6,-6,-4,-5,1,-19,-5,-2,-13,-2,0,-4,3,2,-1,3,0,-3,1,2,-1,2,-1,-1,2,0,0,1,1,50,25,25,7,4,3,32,1,12,7,-3,-1,15,5,0,3,0,1,17,-4,12,4,-3,-2,3,0,0,2,1,1,4,0,-3,0,2,1,-1,0,3,2,-1,0,11,3,8,6,5,1,4,-9,20,-22,8,8,-6,-1,16,-13,3,3,10,-8,4,-9,5,5,1,2,4,-2,-1,2,1,0,2,1,-1,2,0,2,2,-3,0,0
43,43142,Sarral,1421,36,26,10,34,22,12,5,18,15,1,-1,-2,3,13,10,1,0,-1,2,5,5,0,-1,-1,6,13,13,2,0,0,4,10,8,0,0,0,2,3,5,2,0,0,2,-1,3,18,10,8,-1,2,-3,0,2,1,-2,2,-1,-1,0,1,1,0,-2,1,2,0,3,5,6,1,2,1,2,3,2,1,1,1,1,2,4,0,1,0,41,32,9,42,25,17,15,5,14,10,-1,-2,13,4,9,8,0,-3,2,1,5,2,-1,1,13,12,11,6,0,0,9,6,7,3,0,0,4,6,4,3,0,0,29,17,12,23,13,10,2,11,1,13,2,0,4,5,-2,10,1,-1,-2,6,3,3,1,1,1,7,5,8,1,0,1,3,3,6,0,0,0,4,2,2,1,0,10,6,4,13,7,6,3,5,3,1,1,-3,2,6,0,-3,1,0,1,-1,3,4,0,-3,2,5,4,1,1,0,0,3,3,0,1,0,2,2,1,1,0,0,77,38,39,35,15,20,16,10,23,18,10,-1,4,8,12,9,5,0,12,2,11,9,5,-1,10,4,11,7,2,0,3,4,5,2,1,0,7,0,6,5,1,0,65,29,36,31,15,16,14,21,20,6,-1,3,6,3,16,3,-2,2,8,18,4,3,1,1,8,14,8,0,1,0,7,5,3,0,0,0,1,9,5,0,1,0,33,9,24,25,9,16,12,8,12,0,2,-2,4,2,2,2,1,-2,8,6,10,-2,1,0,8,11,7,0,-1,0,4,5,0,1,-1,0,4,6,7,-1,0,0,27,12,15,23,6,17,18,-1,7,9,-5,-4,9,1,1,7,-6,-1,9,-2,6,2,1,-3,6,6,7,2,1,0,1,2,2,0,0,0,5,4,5,2,1,0,0,-1,1,-10,-9,-1,6,-4,7,-5,-2,-6,4,-4,3,-4,2,-3,2,0,4,-1,-4,-3,-1,-2,-1,-3,-3,0,0,-2,-3,-2,-2,0,-1,0,2,-1,-1,0,-25,-7,-18,9,3,6,-3,1,-12,-6,1,-7,7,-2,-7,-4,-1,-1,-10,3,-5,-2,2,-6,8,1,1,-3,1,0,5,-2,3,-4,0,0,3,3,-2,1,1,0,-37,-18,-19,-5,-3,-2,-12,-4,-12,-8,0,-2,-4,-3,-7,-3,0,-1,-8,-1,-5,-5,0,-1,-5,2,-2,-2,1,-1,-4,1,0,-1,1,-1,-1,1,-2,-1,0,0,-18,-8,-10,-17,-9,-8,4,-6,-9,-7,4,-1,2,-2,-4,-6,2,1,2,-4,-5,-1,2,-2,-2,-1,-6,-9,2,-1,-1,-1,-4,-4,1,0,-1,0,-2,-5,1,-1,-47,-15,-32,-14,-4,-10,-12,-3,-15,-13,4,-9,-6,0,-7,-2,4,-4,-6,-3,-8,-11,0,-5,-2,-4,-6,0,-1,-1,-1,-2,-2,2,-1,0,-1,-2,-4,-2,0,-1,-3,-13,10,10,2,8,3,-1,-2,3,-4,-2,-2,-4,-3,0,-3,-1,5,3,1,3,-1,-1,3,3,3,2,-1,0,0,0,1,1,0,0,3,3,2,1,-1,0,-8,-2,-6,-11,-6,-5,2,2,-1,-4,1,-7,1,2,-1,-1,1,-4,1,0,0,-3,0,-3,-1,0,-6,-2,-1,-1,-1,0,-4,-1,0,0,0,0,-2,-1,-1,-1,-20,-16,-4,5,2,3,-5,-1,-7,2,-5,-4,-3,0,-5,-3,-3,-2,-2,-1,-2,5,-2,-2,1,1,1,1,1,0,1,0,0,0,1,0,0,1,1,1,0,0,-13,-13,0,-9,-10,1,-1,8,-5,-7,-2,-6,-1,1,-3,-5,-1,-3,0,7,-2,-2,-1,-3,0,-2,0,-3,-3,-1,-1,-2,-1,-3,-3,0,1,0,1,0,0,-1
43,43144,"Secuita, La",1121,8,10,-2,3,1,2,8,-2,2,0,1,-2,6,-1,1,2,2,0,2,-1,1,-2,-1,-2,1,0,2,0,0,0,1,0,0,0,0,0,0,0,2,0,0,0,13,11,2,9,5,4,2,-1,18,-9,1,2,1,3,11,-5,0,1,1,-4,7,-4,1,1,1,2,6,0,0,0,0,1,4,0,0,0,1,1,2,0,0,0,-25,-15,-10,4,4,0,-8,-4,-8,-4,-2,1,-9,-3,0,-2,-2,1,1,-1,-8,-2,0,0,0,3,3,0,0,-2,0,2,3,0,0,-1,0,1,0,0,0,-1,17,6,11,10,8,2,7,-9,10,7,-1,3,2,-4,1,6,0,2,5,-5,9,1,-1,1,2,0,4,1,3,0,2,0,4,0,2,0,0,0,0,1,1,0,80,40,40,4,2,2,19,12,23,17,7,2,10,6,12,6,5,1,9,6,11,11,2,1,2,2,0,1,-1,0,1,2,0,0,-1,0,1,0,0,1,0,0,35,19,16,11,8,3,13,6,5,12,3,-2,12,0,2,5,3,1,1,6,3,7,0,-3,4,2,3,2,0,0,3,1,3,1,0,0,1,1,0,1,0,0,79,38,41,7,1,6,20,13,18,19,3,3,10,3,12,9,2,1,10,10,6,10,1,2,4,1,-1,2,0,1,2,0,-2,0,0,1,2,1,1,2,0,0,87,47,40,19,11,8,15,22,35,6,4,1,6,14,21,2,2,-1,9,8,14,4,2,2,1,9,5,4,0,0,1,6,2,2,0,0,0,3,3,2,0,0,39,19,20,12,7,5,8,7,8,5,6,1,5,5,-2,6,3,1,3,2,10,-1,3,0,3,3,5,-1,2,0,2,3,1,0,1,0,1,0,4,-1,1,0,18,6,12,-3,-4,1,-5,12,10,3,0,-3,-4,4,4,1,1,-1,-1,8,6,2,-1,-2,0,0,-2,0,-1,0,0,0,-2,-2,0,0,0,0,0,2,-1,0,23,19,4,7,3,4,1,6,14,6,-5,1,1,8,8,3,-1,0,0,-2,6,3,-4,1,2,3,3,-1,0,0,2,3,0,-2,0,0,0,0,3,1,0,0,22,12,10,7,4,3,13,9,2,6,0,-8,7,1,4,2,1,-3,6,8,-2,4,-1,-5,2,0,2,2,1,0,2,0,-1,2,1,0,0,0,3,0,0,0,17,14,3,-1,-1,0,10,-2,19,2,-7,-3,8,0,9,3,-2,-4,2,-2,10,-1,-5,1,3,-1,1,-2,-1,-1,3,-1,0,-1,-1,-1,0,0,1,-1,0,0,21,-6,27,-1,-1,0,-2,10,1,1,3,5,-3,3,-7,-4,1,3,1,7,8,5,2,2,-3,2,-5,1,1,2,-1,1,-2,0,0,1,-2,1,-3,1,1,1,-1,-4,3,-1,0,-1,-6,-3,8,7,-3,-5,-11,3,4,6,-4,-3,5,-6,4,1,1,-2,-1,-1,2,0,0,-2,-1,0,0,1,0,-1,0,-1,2,-1,0,-1,19,6,13,8,2,6,3,6,0,2,6,4,1,2,-1,-4,6,3,2,4,1,6,0,1,4,1,3,0,-1,1,0,0,2,-1,0,1,4,1,1,1,-1,0,-10,-3,-7,0,0,0,1,-3,-1,-4,-1,-1,2,-5,2,1,0,-2,-1,2,-3,-5,-1,1,0,1,-1,0,0,0,0,0,0,0,0,0,0,1,-1,0,0,0,21,4,17,8,4,4,6,1,13,-2,1,-3,-2,2,8,-6,1,-1,8,-1,5,4,0,-2,1,1,1,4,1,0,0,1,0,2,1,0,1,0,1,2,0,0
43,43044,"Sénia, La",5029,294,217,77,285,201,84,12,70,151,59,4,-4,4,54,111,48,1,-2,8,16,40,11,3,-2,23,63,136,56,6,0,11,41,104,40,5,0,12,22,32,16,1,0,260,163,97,279,185,94,29,62,114,49,11,-5,15,40,70,29,8,1,14,22,44,20,3,-6,24,69,112,62,11,0,13,46,76,43,6,0,11,23,36,19,5,0,191,80,111,246,137,109,32,71,56,30,3,0,12,28,30,13,-1,-4,20,43,26,17,4,4,50,82,77,32,5,0,30,41,47,16,3,0,20,41,30,16,2,0,-78,-39,-39,0,0,0,1,-32,-20,-31,-4,11,2,-2,-13,-25,-3,4,-1,-30,-7,-6,-1,7,0,-1,1,0,0,0,0,-1,1,0,0,0,0,0,0,0,0,0,194,125,69,226,129,97,8,90,63,35,-6,1,-3,52,56,21,-4,2,11,38,7,14,-2,-1,18,90,84,35,-2,0,5,50,51,25,-2,0,13,40,33,10,0,0,130,39,91,190,88,102,28,40,26,10,16,11,14,11,7,-3,7,2,14,29,19,13,9,9,34,63,50,25,14,2,17,28,26,9,6,1,17,35,24,16,8,1,20,-5,25,92,44,48,17,32,-9,-20,-7,-1,14,16,-15,-19,-3,-4,3,16,6,-1,-4,3,25,40,28,-5,1,-2,16,20,14,-10,3,-2,9,20,14,5,-2,0,88,42,46,87,38,49,26,48,5,2,-6,9,22,22,-6,-2,-4,7,4,26,11,4,-2,2,25,45,9,5,0,1,17,22,-1,-1,-1,1,8,23,10,6,1,0,-49,-39,-10,-67,-59,-8,9,1,-50,-15,-4,1,10,-5,-40,-8,-1,-3,-1,6,-10,-7,-3,4,10,-13,-47,-16,-5,3,11,-17,-33,-15,-6,0,-1,4,-14,-1,1,3,-146,-76,-70,-137,-83,-54,-14,-19,-80,-50,3,11,1,-11,-42,-34,4,3,-15,-8,-38,-16,-1,8,-5,-14,-78,-38,-2,-1,0,-11,-47,-31,4,1,-5,-3,-31,-7,-6,-2,-47,-38,-9,-15,-19,4,-5,5,-49,-15,-3,19,-10,2,-24,-13,-1,8,5,3,-25,-2,-2,11,7,12,-20,-12,-5,3,3,1,-12,-11,-1,2,4,11,-8,-1,-4,1,-86,-39,-47,-26,-16,-10,-23,-11,-32,-23,3,-2,-14,1,-14,-16,2,0,-9,-12,-18,-7,1,-2,-7,-1,-13,-6,2,-1,-8,4,-8,-8,5,-1,1,-5,-5,2,-3,0,-90,-59,-31,-80,-52,-28,-24,-13,-41,-16,2,1,-16,-4,-25,-13,-2,1,-8,-9,-16,-3,4,0,-10,-8,-28,-21,-9,-4,-6,-4,-17,-17,-7,-1,-4,-4,-11,-4,-2,-3,-62,-44,-18,-70,-42,-28,2,-27,-17,-24,5,0,-1,-17,-9,-19,4,-1,3,-10,-8,-5,1,1,-8,-10,-27,-17,-6,-2,-3,-10,-16,-9,-3,-1,-5,0,-11,-8,-3,-1,-47,-26,-21,-66,-39,-27,-18,-3,-27,-16,9,8,-5,0,-20,-8,3,4,-13,-3,-7,-8,6,4,-11,-3,-27,-18,-4,-1,-7,-3,-13,-12,-3,0,-4,0,-14,-6,-1,-1,-21,-15,-6,-63,-51,-12,3,-6,-18,4,-4,-3,-4,5,-5,-5,-4,-3,7,-11,-13,9,0,0,-15,-4,-18,-12,-12,-2,-14,-3,-12,-13,-7,-2,-1,-1,-6,1,-5,0,-10,-1,-9,-5,1,-6,-14,-2,-15,13,3,6,-11,-3,-11,13,9,3,-3,1,-4,0,-6,3,-7,1,-3,1,3,2,-5,0,-3,3,5,1,-2,1,0,-2,-2,1,0,11,-11,-4,0,-4,0,-4,-12,7,-7,12,5,0,4,-2,-5,7,-5,-4,-16,9,-2,5,-3,2,-1,-5,1,1,2,-1,4,-5,-1,0,-5,3,-5,0,2,1
43,43148,Tarragona,113016,2103,967,1136,60,28,32,47,365,818,421,166,292,20,146,375,239,84,109,27,219,443,182,82,183,9,10,15,15,7,4,4,4,6,9,4,1,5,6,9,6,3,3,258,119,139,56,24,32,60,80,84,34,-24,18,19,48,30,13,0,10,41,32,54,21,-24,8,22,5,11,7,7,3,10,2,3,4,3,2,12,3,8,3,4,1,434,164,270,8,2,6,66,18,149,120,13,59,16,-6,68,68,-11,24,50,24,81,52,24,35,13,-9,-19,3,10,5,4,-3,-9,0,4,4,9,-6,-10,3,6,1,134,41,93,36,17,19,-44,97,8,27,9,52,-44,24,55,0,-13,23,0,73,-47,27,22,29,13,2,-12,12,10,10,4,1,-2,3,5,5,9,1,-10,9,5,5,3476,1947,1529,3018,1674,1344,659,904,1125,565,124,31,339,471,694,341,57,27,320,433,431,224,67,4,590,730,956,496,148,56,295,379,597,284,73,25,295,351,359,212,75,31,3720,2072,1648,4452,2496,1956,590,984,1237,729,97,45,322,479,799,409,28,17,268,505,438,320,69,28,735,1041,1541,783,217,76,398,536,940,449,108,36,337,505,601,334,109,40,2788,1562,1226,4388,2397,1991,442,886,900,538,91,-63,235,388,565,325,65,-4,207,498,335,213,26,-59,692,1090,1491,775,226,42,359,520,897,467,106,17,333,570,594,308,120,25,2277,1343,934,3503,1948,1555,129,1026,867,260,7,-30,63,536,589,174,-1,-20,66,490,278,86,8,-10,496,1101,1175,520,141,25,255,568,716,303,71,11,241,533,459,217,70,14,2195,1078,1117,2721,1312,1409,435,712,808,237,17,-8,246,335,416,87,-12,20,189,377,392,150,29,-28,527,819,877,351,90,18,269,377,453,154,31,11,258,442,424,197,59,7,-429,-381,-48,747,314,433,51,123,-331,-150,-83,-22,24,47,-255,-110,-52,-24,27,76,-76,-40,-31,2,231,323,147,19,-3,11,142,159,24,-9,-14,3,89,164,123,28,11,8,-235,-300,65,589,163,426,14,297,-214,-195,-114,-21,-27,92,-115,-175,-77,8,41,205,-99,-20,-37,-29,171,335,101,-20,-22,3,56,126,46,-53,-27,7,115,209,55,33,5,-4,109,-51,160,894,415,479,-43,214,-50,-39,34,22,-31,79,-57,-27,-18,23,-12,135,7,-12,52,-1,115,339,264,79,53,22,68,135,144,36,11,12,47,204,120,43,42,10,-36,-116,80,650,294,356,-125,85,-44,-51,14,78,-99,47,-4,-57,-33,28,-26,38,-40,6,47,50,74,237,222,53,22,29,21,129,123,8,-2,9,53,108,99,45,24,20,23,-31,54,193,22,171,42,123,-17,-72,8,-44,68,66,-46,-80,-5,-32,-26,57,29,8,13,-12,58,165,32,-63,-10,-1,52,76,-34,-66,-12,0,6,89,66,3,2,-1,83,-85,168,523,224,299,19,144,56,-43,12,-75,-43,70,13,-71,-19,-19,62,74,43,28,31,-56,65,154,183,38,48,22,22,75,105,0,4,14,43,79,78,38,44,8,253,78,175,697,305,392,-30,297,71,-94,29,-2,-29,134,57,-84,-11,19,-1,163,14,-10,40,-21,27,318,282,9,34,10,18,116,164,-9,4,7,9,202,118,18,30,3,321,73,248,559,250,309,39,345,52,-108,-2,-3,3,179,10,-70,-50,3,36,166,42,-38,48,-6,48,372,138,-41,29,-2,10,198,76,-28,-13,-2,38,174,62,-13,42,0,1467,702,765,1502,695,807,170,570,439,181,102,-16,89,254,247,82,22,-6,81,316,192,99,80,-10,202,508,437,167,130,32,97,239,251,44,38,9,105,269,186,123,92,23
43,43150,Tivissa,1767,44,20,24,27,14,13,6,14,7,5,10,1,3,6,2,3,6,-1,3,8,5,2,4,2,6,3,8,6,4,0,3,1,5,3,2,0,3,2,3,3,2,0,8,7,1,15,9,6,4,1,-2,5,0,-2,5,-1,1,0,1,-1,-1,2,-3,5,-1,-1,5,1,3,5,0,0,3,1,1,3,0,0,2,0,2,2,0,0,24,19,5,31,12,19,5,-1,2,11,9,-2,3,1,3,9,4,-1,2,-2,-1,2,5,-1,7,3,4,9,8,0,2,3,0,4,3,0,5,0,4,5,5,0,23,19,4,30,18,12,3,-1,-1,12,6,3,0,2,3,7,4,2,3,-3,-4,5,2,1,2,5,4,11,5,3,0,4,3,7,2,2,2,1,1,4,3,1,20,8,12,38,21,17,0,9,9,-5,3,2,-2,4,9,-4,1,-1,2,5,0,-1,2,3,4,10,10,6,5,1,2,5,7,3,3,0,2,5,3,3,2,1,19,9,10,36,18,18,6,9,-4,3,5,-2,4,1,1,1,3,-1,2,8,-5,2,2,-1,6,9,8,5,8,0,3,4,3,3,5,0,3,5,5,2,3,0,39,20,19,35,18,17,0,8,8,14,7,0,-4,6,0,11,5,1,4,2,8,3,2,-1,1,9,12,8,4,0,0,5,4,6,3,0,1,4,8,2,1,0,65,46,19,55,40,15,15,18,19,5,5,3,9,8,17,3,2,6,6,10,2,2,3,-3,12,19,13,4,4,2,8,13,11,3,2,2,4,6,2,1,2,0,-17,-4,-13,23,15,8,-4,2,-7,-7,3,-4,1,6,-4,-5,1,-3,-5,-4,-3,-2,2,-1,2,11,3,3,2,2,1,9,2,1,1,1,1,2,1,2,1,1,-6,-4,-2,27,14,13,1,3,-5,-2,0,-3,2,2,-1,-4,0,-3,-1,1,-4,2,0,0,12,6,3,5,1,0,9,2,1,1,1,0,3,4,2,4,0,0,-11,-14,3,11,1,10,3,-5,1,1,0,-7,-5,-6,0,2,-4,0,8,1,1,-1,4,-7,7,2,4,2,-2,-2,3,1,-1,0,-1,-1,4,1,5,2,-1,-1,0,-7,7,12,3,9,1,-7,7,7,-5,-3,-1,-9,8,0,-4,-1,2,2,-1,7,-1,-2,5,0,-1,5,2,1,2,-2,0,3,0,0,3,2,-1,2,2,1,-1,-10,9,-6,-8,2,2,4,-11,-2,4,2,-1,2,-8,-3,0,1,3,2,-3,1,4,1,-3,2,-5,1,-3,1,-3,1,-4,-1,-2,1,0,1,-1,2,-1,0,21,3,18,7,1,6,14,11,-7,4,1,-1,7,4,-3,1,-3,-2,7,7,-4,3,4,1,1,3,1,-1,1,2,0,-1,1,0,0,1,1,4,0,-1,1,1,4,2,2,2,1,1,5,-2,-8,5,7,-4,0,-2,-6,3,6,1,5,0,-2,2,1,-5,2,0,-4,0,5,-2,1,-1,-4,2,4,-1,1,1,0,-2,1,-1,-22,-7,-15,15,10,5,-8,-6,-1,0,-7,1,-1,-4,1,3,-5,0,-7,-2,-2,-3,-2,1,2,4,1,2,2,4,1,3,1,3,0,2,1,1,0,-1,2,2,-19,-12,-7,1,0,1,0,5,-15,0,2,-10,1,3,-9,-3,2,-5,-1,2,-6,3,0,-5,0,6,-7,-2,4,-1,0,2,-2,-3,3,-1,0,4,-5,1,1,0,-30,-28,-2,-2,-7,5,-3,0,-12,-2,-5,-8,-1,3,-12,-5,-6,-6,-2,-3,0,3,1,-2,2,1,-1,-2,-2,0,0,1,-4,-4,0,0,2,0,3,2,-2,0
43,43153,Torredembarra,10090,475,240,235,210,114,96,83,68,102,93,78,45,54,37,47,45,37,17,29,31,55,48,41,28,44,34,63,43,17,5,27,15,36,23,9,3,17,19,27,20,8,2,441,232,209,230,128,102,74,71,123,53,67,52,34,36,85,17,41,17,40,35,38,36,26,35,47,54,72,38,17,2,18,26,46,24,13,1,29,28,26,14,4,1,530,287,243,309,171,138,96,92,163,93,45,29,51,47,88,61,28,7,45,45,75,32,17,22,63,80,92,47,16,6,32,40,55,33,7,2,31,40,37,14,9,4,264,145,119,121,75,46,10,27,48,76,45,48,1,26,27,48,19,19,9,1,21,28,26,29,22,32,35,21,7,0,9,20,26,13,3,1,13,12,9,8,4,-1,724,410,314,277,150,127,112,118,208,150,78,52,60,65,122,94,38,29,52,53,86,56,40,23,42,68,83,49,21,11,23,37,44,30,5,8,19,31,39,19,16,3,457,206,251,281,121,160,59,104,121,71,68,31,14,38,70,38,33,12,45,66,51,33,35,19,63,72,71,45,16,8,19,32,34,23,7,4,44,40,37,22,9,4,592,227,365,357,155,202,75,139,103,114,96,58,18,65,13,58,40,28,57,74,90,56,56,30,59,105,91,59,32,9,23,49,29,33,15,4,36,56,62,26,17,5,445,240,205,342,188,154,63,100,122,72,46,44,25,38,86,52,16,21,38,62,36,20,30,23,52,94,87,73,33,3,30,38,46,54,17,3,22,56,41,19,16,0,123,68,55,201,91,110,32,36,59,-3,-3,8,19,24,32,7,-7,2,13,12,27,-10,4,6,52,68,67,-3,9,4,33,29,31,-7,4,2,19,39,36,4,5,2,80,30,50,59,8,51,34,26,19,-4,7,1,20,20,9,-26,-1,9,14,6,10,22,8,-8,27,30,13,-15,3,-1,13,14,3,-20,-5,1,14,16,10,5,8,-2,51,-25,76,-8,-40,32,23,8,-27,28,1,16,13,2,-35,8,-13,3,10,6,8,20,14,13,39,6,-42,-13,-5,5,23,1,-36,-16,-14,2,16,5,-6,3,9,3,-152,-110,-42,-161,-107,-54,-51,13,-22,-25,-57,-10,-20,-10,-14,-25,-32,-6,-31,23,-8,0,-25,-4,-26,-4,-17,-46,-48,-22,-16,-7,-10,-36,-30,-8,-10,3,-7,-10,-18,-14,80,4,76,-152,-90,-62,55,4,-24,-19,39,27,32,7,-26,-30,25,-4,23,-3,2,11,14,31,-13,-3,-71,-47,-13,-5,-2,1,-45,-35,-8,-1,-11,-4,-26,-12,-5,-4,106,56,50,-67,-33,-34,18,-10,-3,61,-10,46,5,-20,17,36,-10,25,13,10,-20,25,0,21,-19,-23,-15,-19,4,7,-6,-17,-4,-10,-1,6,-13,-6,-11,-9,5,1,-49,-50,1,-82,-68,-14,5,-19,-46,-36,17,31,-4,-12,-32,-19,3,14,9,-7,-14,-17,14,17,1,-2,-49,-26,-8,3,-6,-7,-24,-19,-9,-2,7,5,-25,-7,1,5,62,29,33,-37,-5,-32,34,-1,35,6,15,-27,24,-3,16,2,8,-19,10,2,19,4,7,-8,-4,1,-11,-18,-3,-5,-1,2,0,-11,5,-2,-3,-1,-11,-7,-8,-3,263,119,144,120,48,72,10,62,44,42,60,46,-4,34,7,30,33,20,14,28,37,12,27,26,16,38,45,13,3,1,4,23,24,-3,-1,-1,12,15,21,16,4,2,313,180,133,139,86,53,22,24,72,52,85,57,-4,28,61,39,37,20,26,-4,11,13,48,37,22,27,58,7,22,2,11,18,42,1,12,2,11,9,16,6,10,0
43,43155,Tortosa,29669,772,469,303,380,246,134,110,155,245,138,43,79,57,92,166,96,19,37,53,63,79,42,24,42,63,91,141,62,17,6,35,66,99,34,9,3,28,25,42,28,8,3,668,433,235,650,432,218,86,162,263,107,29,18,26,120,196,68,12,10,60,42,67,39,17,8,93,193,231,104,18,7,38,139,173,66,12,2,55,54,58,38,6,5,943,584,359,830,517,313,200,203,305,186,13,32,115,138,202,107,4,15,85,65,103,79,9,17,168,206,278,140,22,10,95,126,194,85,12,2,73,80,84,55,10,8,1117,697,420,849,528,321,205,221,350,196,69,54,98,151,255,116,40,25,107,70,95,80,29,29,150,207,294,132,48,12,70,137,206,78,27,5,80,70,88,54,21,7,1539,1025,514,1148,776,372,207,371,552,269,80,40,104,255,399,204,41,9,103,116,153,65,39,31,179,305,394,184,65,13,90,208,305,130,33,5,89,97,89,54,32,8,1252,826,426,1225,859,366,210,345,381,204,65,29,108,227,292,127,44,16,102,118,89,77,21,13,209,361,410,180,47,12,113,271,322,116,28,3,96,90,88,64,19,9,1296,903,393,1267,810,457,179,293,444,271,75,20,114,234,306,196,33,11,65,59,138,75,42,9,213,326,407,218,67,21,119,223,280,136,33,9,94,103,127,82,34,12,1229,779,450,1692,1071,621,206,363,411,236,38,-34,115,202,307,134,18,-4,91,161,104,102,20,-30,262,447,619,283,59,9,144,259,450,172,35,4,118,188,169,111,24,5,-682,-570,-112,401,170,231,82,-86,-387,-188,-57,-44,58,-76,-358,-141,-44,-10,24,-10,-29,-47,-13,-34,185,89,61,40,15,4,115,35,-2,8,9,-1,70,54,63,32,6,5,-1372,-1029,-343,-916,-724,-192,-8,-176,-597,-396,-166,-20,11,-133,-471,-335,-93,-2,-19,-43,-126,-61,-73,-18,24,-67,-426,-306,-125,-19,25,-62,-348,-257,-78,-5,-1,-5,-78,-49,-47,-14,-92,-103,11,236,97,139,61,13,-79,-84,6,-10,29,14,-78,-74,-1,6,32,-1,-1,-10,7,-16,112,62,18,22,16,2,57,38,-8,1,4,4,55,24,26,21,12,-2,-44,-35,-9,158,54,104,1,15,-37,-56,11,22,6,-2,-17,-50,6,21,-5,17,-20,-6,5,1,49,41,34,2,20,8,27,11,9,-14,13,5,22,30,25,16,7,3,-732,-456,-276,-569,-373,-196,-95,-50,-253,-203,-97,-31,-38,-38,-174,-136,-60,-8,-57,-12,-79,-67,-37,-23,-78,-23,-169,-190,-88,-26,-40,-15,-117,-135,-53,-16,-38,-8,-52,-55,-35,-10,-60,-15,-45,83,47,36,-45,8,-16,-18,1,22,-11,5,-9,-18,8,16,-34,3,-7,0,-7,6,-2,26,14,13,23,3,2,15,3,13,10,0,-4,11,11,0,13,3,-116,-37,-79,-162,-82,-80,44,4,-97,-26,-32,5,18,5,-27,0,-25,-1,26,-1,-70,-26,-7,6,-2,-2,-59,-50,-33,-19,-4,9,-24,-31,-23,-10,2,-11,-35,-19,-10,-9,-25,-68,43,30,-4,34,-13,6,22,-29,-20,13,-28,-4,4,-30,-18,4,15,10,18,1,-2,9,1,34,11,-7,-6,-7,-9,21,14,-17,-7,-9,10,13,-3,10,1,2,-159,-120,-39,-82,-98,16,-24,-12,-86,-96,-5,65,-9,-13,-54,-72,-4,33,-15,1,-32,-24,-1,32,-6,21,-25,-78,4,0,-2,-1,-21,-65,-5,-4,-4,22,-4,-13,9,4,160,55,105,194,96,98,17,38,56,26,-5,25,8,16,17,6,-3,7,9,22,39,20,-2,18,21,67,80,19,2,1,8,34,49,8,-5,0,13,33,31,11,7,1
43,43160,Vallmoll,1107,69,32,37,20,7,13,14,14,21,8,13,-2,7,8,7,5,5,-1,7,6,14,3,8,-1,1,8,7,2,0,2,0,4,2,0,0,1,1,4,5,2,0,1,42,25,17,14,8,6,6,4,15,16,-1,2,5,-1,12,9,-1,1,1,5,3,7,0,1,3,0,5,6,0,0,1,0,4,3,0,0,2,0,1,3,0,0,37,16,21,9,1,8,6,9,4,6,2,9,2,0,3,5,2,4,4,9,1,1,0,5,0,4,3,2,0,0,0,1,0,0,0,0,0,3,3,2,0,0,48,23,25,15,7,8,2,13,19,0,10,3,3,5,9,1,2,2,-1,8,10,-1,8,1,1,9,5,0,0,0,1,4,2,0,0,0,0,5,3,0,0,0,40,24,16,3,2,1,6,7,13,18,1,-3,4,2,10,10,2,-2,2,5,3,8,-1,-1,0,0,3,0,0,0,0,0,2,0,0,0,0,0,1,0,0,0,60,39,21,10,7,3,10,6,21,18,6,-2,4,1,12,17,3,1,6,5,9,1,3,-3,-2,2,9,-1,1,1,0,2,4,0,1,0,-2,0,5,-1,0,1,42,18,24,20,10,10,11,6,14,9,3,0,2,1,6,4,4,2,9,5,8,5,-1,-2,8,5,3,5,0,-1,3,3,1,3,0,0,5,2,2,2,0,-1,54,25,29,21,11,10,11,0,23,7,7,1,5,-4,10,5,6,1,6,4,13,2,1,0,2,6,9,1,2,0,0,1,8,1,1,0,2,5,1,0,1,0,6,-2,8,-1,-2,1,-2,5,-3,1,8,-4,-1,3,-5,-1,2,-2,-1,2,2,2,6,-2,1,-1,1,-3,1,0,0,1,-1,-2,0,0,1,-2,2,-1,1,0,0,0,0,11,5,6,4,-2,-5,-6,8,3,-1,-4,-1,-2,7,2,5,2,-4,-4,1,1,5,2,2,-1,1,1,2,0,1,0,0,1,3,2,1,-1,1,0,14,12,2,4,1,3,10,-2,-1,11,-1,-4,7,2,3,2,-1,-2,3,-4,-4,9,0,-2,1,0,0,3,-1,1,0,0,1,0,-1,1,1,0,-1,3,0,0,26,12,14,1,4,-3,2,-4,16,6,4,-2,1,-3,11,1,4,-4,1,-1,5,5,0,2,0,-2,1,1,0,0,0,0,1,2,0,0,0,-2,0,-1,0,0,-6,-8,2,-9,-4,-5,-4,-3,6,5,-9,0,-4,1,-2,5,-6,-1,0,-4,8,0,-3,1,-2,2,-2,-3,-3,-1,-1,2,-1,-2,-1,-1,-1,0,-1,-1,-2,0,2,-5,7,0,0,0,7,2,7,-4,-5,-7,1,-1,2,-7,0,-1,6,3,5,3,-5,-6,2,0,-1,-3,2,0,1,0,0,-3,1,1,1,0,-1,0,1,-1,-13,-15,2,-5,-2,-3,-5,2,1,-9,-3,-2,-8,-2,0,-7,0,0,3,4,1,-2,-3,-2,-1,-1,-1,1,0,-3,0,-1,0,1,0,-2,-1,0,-1,0,0,-1,-5,-8,3,-3,0,-3,-1,-2,3,-8,1,0,2,-2,-1,-6,0,-2,-3,0,4,-2,1,2,-1,-1,-3,0,2,0,0,-1,-1,1,1,0,-1,0,-2,-1,1,0,51,35,16,0,0,0,12,9,18,12,4,-6,11,6,8,12,3,-7,1,3,10,0,1,1,-3,0,-1,3,0,0,-3,0,-1,3,0,0,0,0,0,0,0,0,21,10,11,8,7,1,10,2,15,-3,2,-3,6,0,6,-1,1,-2,4,2,9,-2,1,-1,4,2,6,-1,-3,0,4,1,4,0,-2,0,0,1,2,-1,-1,0
43,43161,Valls,20265,155,121,34,136,99,37,24,35,63,21,-5,12,20,27,55,19,-6,2,4,8,8,2,1,10,17,34,54,25,4,1,10,23,40,23,2,0,7,11,14,2,2,1,371,247,124,199,133,66,59,83,122,62,25,19,28,67,84,46,15,7,31,16,38,16,10,12,36,53,69,25,8,6,20,33,53,19,4,3,16,20,16,6,4,3,425,226,199,316,195,121,67,115,143,49,33,16,38,64,78,23,16,1,29,51,65,26,17,15,48,88,110,58,7,1,21,58,69,39,4,1,27,30,41,19,3,0,581,324,257,267,170,97,118,126,151,118,19,42,59,64,107,71,4,17,59,62,44,47,15,25,50,75,77,54,4,5,26,42,58,39,0,3,24,33,19,15,4,2,566,309,257,297,184,113,113,116,156,87,30,58,47,83,90,42,20,25,66,33,66,45,10,33,45,91,99,44,11,4,19,60,69,25,7,2,26,31,30,19,4,2,772,462,310,450,259,191,152,149,258,123,47,28,87,93,159,80,30,9,65,56,99,43,17,19,105,105,130,78,22,6,55,58,85,43,13,4,50,47,45,35,9,2,649,349,300,431,249,182,136,118,228,131,3,19,69,51,141,82,-5,-1,67,67,87,49,8,20,101,85,142,86,11,3,53,49,89,50,5,0,48,36,53,36,6,3,761,440,321,510,293,217,132,179,234,110,37,50,59,108,161,61,26,17,73,71,73,49,11,33,95,162,151,73,13,11,54,93,96,37,7,3,41,69,55,36,6,8,240,84,156,327,145,182,28,93,50,26,20,22,-6,60,1,8,3,15,34,33,49,18,17,7,46,112,100,45,12,8,22,57,42,22,-1,2,24,55,58,23,13,6,17,-19,36,202,55,147,21,51,-28,-22,-13,10,32,12,-36,-25,-6,7,-11,39,8,3,-7,3,46,90,32,19,3,5,17,28,5,-2,-1,4,29,62,27,21,4,1,-221,-141,-80,-68,-59,-9,-11,-28,-104,-72,-20,24,11,-29,-67,-34,-18,3,-22,1,-37,-38,-2,21,25,1,-55,-25,-6,-8,17,-9,-42,-18,-4,-4,8,10,-13,-7,-2,-4,67,16,51,77,12,65,71,0,-31,12,2,14,27,-8,-16,1,2,11,44,8,-15,11,0,3,33,22,10,1,8,0,12,4,-3,-3,1,-2,21,18,13,4,7,2,-70,-32,-38,-3,0,-3,-5,-25,-59,-27,30,15,5,-20,-8,-32,12,7,-10,-5,-51,5,18,8,2,-1,-6,-12,11,2,4,-2,7,-16,6,0,-2,1,-13,4,5,2,36,-12,48,-8,-22,14,31,13,-19,-31,-1,43,18,9,-31,-24,4,16,13,4,12,-7,-5,27,5,12,-11,-5,-13,1,-1,9,-14,-8,-8,0,6,3,3,3,-5,1,-165,-89,-76,16,2,14,-58,-14,-47,8,-26,-23,-17,-10,-44,4,-12,-9,-41,-4,-3,4,-14,-14,-11,16,11,3,-5,-2,-2,5,-1,0,-4,1,-9,11,12,3,-1,-3,-4,-7,3,52,19,33,-14,-1,-18,18,-8,17,0,-12,-25,14,-3,11,-14,11,7,4,-5,6,-16,17,28,3,6,8,-8,7,12,2,1,1,-8,10,16,1,5,7,-62,-54,-8,97,55,42,-21,-12,-21,-47,9,33,-22,-21,6,-34,-1,19,1,9,-27,-13,10,14,17,16,37,10,14,1,6,7,28,8,4,0,11,9,9,2,10,1,150,104,46,168,102,66,23,45,34,-5,16,35,16,28,31,-8,22,12,7,17,3,3,-6,23,23,44,55,22,12,8,12,21,40,16,6,5,11,23,15,6,6,3
43,43163,"Vendrell, El",21097,944,481,463,32,15,17,113,173,190,166,202,89,48,82,104,91,104,45,65,91,86,75,98,44,6,5,6,2,11,2,1,4,3,1,4,2,5,1,3,1,7,0,861,457,404,299,169,130,133,152,198,144,147,85,70,81,131,83,71,24,63,71,67,61,76,61,81,66,90,37,19,5,41,40,55,21,10,1,40,26,35,16,9,4,1361,708,653,484,259,225,197,271,397,200,169,113,98,135,229,95,88,50,99,136,168,105,81,63,88,132,158,78,18,9,39,71,94,44,6,5,49,61,64,34,12,4,1362,656,706,472,208,264,208,274,400,207,174,78,95,119,207,106,87,36,113,155,193,101,87,42,131,117,128,62,17,12,66,43,56,28,8,4,65,74,72,34,9,8,1848,970,878,532,314,218,310,268,500,336,300,103,144,150,288,178,149,46,166,118,212,158,151,57,99,130,163,73,47,11,53,75,106,43,24,6,46,55,57,30,23,5,1350,686,664,471,253,218,172,294,347,215,204,111,107,151,189,112,86,38,65,143,158,103,118,73,114,117,109,74,43,11,70,61,60,38,19,5,44,56,49,36,24,6,1361,746,615,481,244,237,181,293,404,206,187,59,115,139,253,111,85,35,66,154,151,95,102,24,100,136,131,62,42,5,61,64,69,28,20,0,39,72,62,34,22,5,1232,638,594,467,216,251,170,238,411,195,126,74,76,115,212,121,65,29,94,123,199,74,61,45,124,129,137,63,7,1,57,60,60,29,8,-1,67,69,77,34,-1,2,748,317,431,472,205,267,124,170,181,93,74,97,54,55,69,59,39,39,70,115,112,34,35,58,132,105,118,61,29,13,74,37,42,27,11,7,58,68,76,34,18,6,196,72,124,101,26,75,15,77,-3,49,32,13,10,13,-10,26,13,10,5,64,7,23,19,3,34,44,19,-7,-5,13,19,15,0,-6,-8,5,15,29,19,-1,3,8,169,43,126,87,27,60,37,74,36,-15,-2,33,44,32,5,-19,-23,10,-7,42,31,4,21,23,14,30,32,-1,6,1,8,8,15,-5,-5,3,6,22,17,4,11,-2,76,18,58,162,60,102,-42,43,5,-15,32,48,-29,28,17,-32,17,18,-13,15,-12,17,15,30,32,51,25,20,19,10,18,17,10,5,5,4,14,34,15,15,14,6,-13,-24,11,19,-5,24,-14,17,-32,-21,2,28,-25,11,-14,-7,-2,12,11,6,-18,-14,4,16,-3,11,5,-7,5,6,-7,4,4,-8,4,-3,4,7,1,1,1,9,-143,-114,-29,-147,-102,-45,-60,21,-70,-85,-16,59,-56,14,-37,-61,-17,33,-4,7,-33,-24,1,26,-22,-5,-55,-46,-23,4,-16,-5,-29,-33,-17,-2,-6,0,-26,-13,-6,6,-317,-201,-116,-178,-106,-72,-76,-25,-112,-87,-6,-15,-16,-18,-73,-63,-26,-10,-60,-7,-39,-24,20,-5,-30,3,-42,-66,-17,-28,-19,3,-28,-45,-13,-5,-11,0,-14,-21,-4,-23,-18,-15,-3,4,-18,22,-30,27,-52,-28,38,26,-25,26,-15,-34,21,10,-5,1,-37,6,17,16,19,26,5,-34,-13,-3,9,13,0,-33,-10,1,10,13,5,-1,-3,-4,132,20,112,129,43,86,-35,24,4,-3,94,56,-36,0,9,-12,31,30,1,24,-5,9,63,26,21,37,41,-14,26,11,9,12,19,-10,2,9,12,25,22,-4,24,2,507,272,235,95,42,53,113,48,113,85,78,60,60,32,62,38,26,48,53,16,51,47,52,12,57,25,33,-33,0,4,34,11,15,-24,-7,6,23,14,18,-9,7,-2
43,43170,Vila-rodona,1030,37,27,10,27,26,1,-1,10,11,11,3,3,1,7,9,8,1,1,-2,3,2,3,2,2,0,8,12,7,0,0,0,8,11,7,0,0,0,0,1,0,0,0,18,9,9,22,15,7,8,7,7,6,-3,-7,2,6,5,4,-2,-6,6,1,2,2,-1,-1,8,7,7,0,0,0,3,5,7,0,0,0,5,2,0,0,0,0,27,17,10,12,6,6,4,9,9,3,1,1,2,5,7,1,1,0,2,4,2,2,0,1,0,9,4,-1,0,0,0,4,3,-1,0,0,0,5,1,0,0,0,37,22,15,20,13,7,11,10,4,7,7,-2,8,6,0,4,5,-1,3,4,4,3,2,-1,2,7,7,4,0,0,1,3,5,4,0,0,1,4,2,0,0,0,57,34,23,43,31,12,16,14,10,15,4,-2,7,8,8,11,1,0,9,6,2,4,3,-2,10,11,15,6,1,0,5,8,12,5,1,0,5,3,3,1,0,0,15,0,15,30,19,11,10,-2,0,3,1,5,2,-1,-1,0,-2,2,8,-1,1,3,3,3,7,9,9,4,0,1,2,7,6,3,0,1,5,2,3,1,0,0,15,-14,29,14,6,8,12,3,11,-6,0,-8,6,-3,-3,-10,-2,-4,6,6,14,4,2,-4,7,1,2,2,0,0,4,0,0,1,0,0,3,1,2,1,0,0,31,20,11,33,16,17,12,4,12,8,-2,-3,3,7,8,4,0,-2,9,-3,4,4,-2,-1,9,8,8,8,0,0,4,6,2,4,0,0,5,2,6,4,0,0,35,4,31,16,6,10,10,9,6,9,2,0,5,1,-2,4,0,-3,5,8,8,5,2,3,5,4,5,2,0,0,1,2,2,1,0,0,4,2,3,1,0,0,-5,10,-15,11,0,11,-1,5,-3,-5,-1,0,3,5,6,-4,-1,-1,-4,0,-9,-1,0,1,6,1,1,0,0,2,2,-1,-2,0,0,0,4,2,3,0,0,2,-23,-19,-4,-33,-21,-12,0,-7,-15,-3,3,-1,3,-2,-18,-3,2,-1,-3,-5,3,0,1,0,-4,-8,-14,-8,-1,2,-1,-2,-13,-6,0,1,-3,-6,-1,-2,-1,1,-4,-4,0,3,2,1,6,-3,-7,0,2,1,1,0,-3,-2,2,0,5,-3,-4,2,0,1,1,2,1,-1,1,-1,0,1,1,-1,1,0,1,1,0,0,0,-1,-15,-12,-3,1,0,1,-5,1,0,-3,-6,-4,-3,0,-1,-3,-4,-2,-2,1,1,0,-2,-2,1,0,-2,1,0,1,1,0,-2,1,0,0,0,0,0,0,0,1,5,0,5,13,5,8,3,8,-4,-1,0,-2,0,3,-2,-1,1,-1,3,5,-2,0,-1,-1,3,5,4,1,0,0,1,2,2,0,0,0,2,3,2,1,0,0,6,5,1,-3,-2,-1,-5,3,6,-3,10,-7,-2,0,3,0,5,-2,-3,3,3,-3,5,-5,-2,1,0,-3,1,0,-1,1,0,-2,0,0,-1,0,0,-1,1,0,-17,2,-19,4,4,0,-15,3,-11,4,4,-2,-1,5,-2,0,2,-1,-14,-2,-9,4,2,-1,-2,4,0,-1,2,0,0,2,1,-1,2,0,-2,2,-1,0,0,0,8,5,3,11,0,11,5,3,7,0,-3,-5,-1,-1,3,5,0,-2,6,4,4,-5,-3,-3,5,3,2,1,-1,1,0,0,1,-1,-1,1,5,3,1,2,0,0,2,4,-2,13,5,8,1,-6,4,0,0,4,-1,-1,4,2,0,1,2,-5,0,-2,0,3,3,0,6,2,0,2,0,0,4,1,0,0,3,0,2,1,0,2
43,43171,Vila-seca,12756,143,98,45,86,52,34,22,29,33,8,29,14,24,18,22,4,15,7,-2,11,11,4,14,7,13,13,33,9,15,3,9,8,22,6,5,2,4,5,11,3,10,1,367,189,178,175,87,88,51,90,132,53,20,14,33,34,86,28,4,1,18,56,46,25,16,13,30,45,62,19,16,3,13,19,40,6,7,2,17,26,22,13,9,1,653,334,319,304,167,137,81,171,228,109,48,4,41,60,124,69,31,2,40,111,104,40,17,2,33,89,109,52,14,2,20,39,64,32,9,1,13,50,45,20,5,1,540,274,266,300,141,159,84,122,218,75,15,25,43,60,105,51,10,6,41,62,113,24,5,19,67,71,85,53,16,4,28,32,35,37,6,1,39,39,50,16,10,3,754,415,339,360,191,169,120,174,291,114,24,28,51,87,175,75,11,15,69,87,116,39,13,13,76,77,124,55,20,6,42,33,72,28,11,4,34,44,52,27,9,2,1256,730,526,386,207,179,184,275,471,211,69,40,98,144,294,136,43,15,86,131,177,75,26,25,73,97,118,61,25,9,30,55,71,34,11,5,43,42,47,27,14,4,1372,651,721,595,288,307,171,352,483,200,108,47,74,148,263,91,54,16,97,204,220,109,54,31,75,173,179,97,40,25,38,73,103,49,14,9,37,100,76,48,26,16,1241,659,582,624,341,283,158,346,441,185,50,53,85,161,256,120,17,20,73,185,185,65,33,33,100,201,181,87,34,14,60,101,101,55,15,5,40,100,80,32,19,9,686,374,312,420,221,199,102,182,253,98,41,6,55,87,145,54,30,1,47,95,108,44,11,5,97,130,125,58,14,-5,47,61,77,31,9,-2,50,69,48,27,5,-3,301,192,109,171,89,82,42,119,113,8,10,-6,32,67,62,22,9,-6,10,52,51,-14,1,0,36,57,39,5,23,0,20,33,14,8,9,-2,16,24,25,-3,14,2,156,53,103,145,57,88,-30,113,66,-22,5,14,-9,47,30,-21,-3,4,-21,66,36,-1,8,10,26,46,25,27,9,7,19,17,4,10,1,1,7,29,21,17,8,6,61,1,60,-6,-31,25,22,52,3,-6,-19,9,13,10,-13,-9,-10,7,9,42,16,3,-9,2,22,27,-30,-24,-4,0,11,14,-29,-23,-5,-1,11,13,-1,-1,1,1,89,88,1,65,26,39,-32,64,66,-33,24,-2,-8,43,56,-17,12,-1,-24,21,10,-16,12,-1,17,35,14,-2,0,-1,10,12,6,-3,-2,2,7,23,8,1,2,-3,134,10,124,-9,-35,26,42,17,59,-13,22,5,8,-1,11,-28,11,10,34,18,48,15,11,-5,22,11,-37,-8,-3,5,4,-1,-25,-15,-4,5,18,12,-12,7,1,0,26,-30,56,101,40,61,-6,-3,51,-22,15,-9,-12,-9,13,-12,1,-10,6,6,38,-10,14,1,25,30,29,19,-4,-1,15,13,4,11,-2,-2,10,17,25,8,-2,1,-367,-254,-113,-231,-142,-89,-74,46,-142,-98,-81,-13,-39,12,-89,-73,-60,-2,-35,34,-53,-25,-21,-11,-23,-1,-91,-47,-47,-24,-17,-7,-41,-39,-31,-9,-6,6,-50,-8,-16,-15,-22,19,-41,61,40,21,-24,17,-21,-26,30,3,-1,12,2,-18,15,2,-23,5,-23,-8,15,1,-1,26,18,-1,18,-1,1,13,13,2,8,1,-2,13,5,-3,10,-2,109,29,80,199,81,118,-14,39,80,-30,21,9,-19,7,36,-3,4,1,5,32,44,-27,17,8,24,45,64,27,24,11,15,15,33,12,1,4,9,30,31,15,23,7
43,43178,Vinyols i els Arcs,1154,55,32,23,34,26,8,-1,9,24,14,8,0,1,7,12,8,5,-1,-2,2,12,6,3,1,4,7,19,3,1,0,2,6,15,2,1,0,2,1,4,1,0,0,52,33,19,40,25,15,1,16,14,23,0,-2,-1,11,9,15,2,-3,2,5,5,8,-2,1,4,14,17,3,1,1,2,8,11,3,1,0,2,6,6,0,0,1,21,6,15,48,27,21,10,7,3,1,-2,4,5,-2,4,-1,1,0,5,9,-1,2,-3,4,8,19,10,7,1,3,4,9,8,5,0,1,4,10,2,2,1,2,73,47,26,33,16,17,8,6,42,2,4,7,5,2,24,4,4,6,3,4,18,-2,0,1,1,12,12,3,1,2,0,3,8,3,0,1,1,9,4,0,1,1,49,16,33,33,17,16,2,6,23,10,4,3,-4,2,8,9,1,1,6,4,15,1,3,2,1,7,16,6,3,0,0,3,8,4,2,0,1,4,8,2,1,0,58,22,36,46,21,25,5,18,15,5,9,3,2,4,11,0,4,2,3,14,4,5,5,1,10,8,8,10,9,1,4,2,4,7,4,0,6,6,4,3,5,1,43,16,27,35,11,24,5,13,17,-3,8,1,4,2,8,-1,3,-1,1,11,9,-2,5,2,9,7,13,2,3,1,2,1,5,2,1,0,7,6,8,0,2,1,147,84,63,61,33,28,18,27,55,28,7,11,18,16,28,10,-1,12,0,11,27,18,8,-1,6,14,22,14,4,1,5,7,11,9,1,0,1,7,11,5,3,1,88,48,40,34,17,17,9,17,24,16,14,6,2,11,12,10,9,4,7,6,12,6,5,2,7,9,11,5,2,0,2,3,8,3,1,0,5,6,3,2,1,0,59,23,36,20,8,12,13,4,26,4,4,7,7,2,8,1,1,6,6,2,18,3,3,1,6,6,8,-1,2,-2,5,3,3,-2,0,-1,1,3,5,1,2,-1,23,18,5,6,3,3,0,3,6,11,1,0,6,-1,-1,10,0,3,-6,4,7,1,1,-3,0,2,0,-1,4,1,0,0,0,-1,3,1,0,2,0,0,1,0,19,23,-4,13,4,9,5,3,6,2,3,-2,4,2,6,3,4,3,1,1,0,-1,-1,-5,3,3,0,5,1,1,2,0,-2,2,1,1,1,3,2,3,0,0,6,-2,8,4,2,2,2,7,-6,0,0,1,-1,4,-9,0,2,2,3,3,3,0,-2,-1,0,0,1,1,2,0,0,0,0,1,1,0,0,0,1,0,1,0,-90,-44,-46,-101,-58,-43,-9,-9,-33,-24,-19,4,-1,-1,-23,-7,-14,2,-8,-8,-10,-17,-5,2,-6,-7,-30,-33,-19,-6,-5,-3,-17,-16,-14,-3,-1,-4,-13,-17,-5,-3,47,25,22,10,3,7,-3,18,11,-2,11,12,0,9,6,-8,7,11,-3,9,5,6,4,1,-1,4,3,0,3,0,0,2,0,-3,3,0,-1,2,3,3,0,0,-6,3,-9,5,5,0,-16,-1,2,-2,2,9,-10,-2,6,0,2,8,-6,1,-4,-2,0,1,0,0,3,0,1,1,0,0,4,1,0,0,0,0,-1,-1,1,1,17,9,8,7,4,3,-2,5,5,3,4,3,-2,3,-2,5,1,4,0,2,7,-2,3,-1,1,3,0,1,1,1,0,3,-1,2,0,0,1,0,1,-1,1,1,49,34,15,15,11,4,15,12,10,9,3,-1,7,9,10,1,5,0,8,3,0,8,-2,-1,3,2,4,0,5,1,1,1,4,1,3,1,2,1,0,-1,2,0
44,44013,Alcañiz,12961,265,149,116,149,98,51,43,47,114,41,2,17,28,27,58,27,-2,10,15,20,56,14,4,7,12,35,72,24,4,2,7,21,48,18,3,1,5,14,24,6,1,1,284,166,118,206,123,83,44,61,115,41,12,10,25,37,70,18,8,7,19,24,45,23,4,3,37,42,85,32,7,3,22,29,52,18,1,1,15,13,33,14,6,2,588,351,237,408,235,173,118,178,173,85,8,16,64,107,102,62,2,9,54,71,71,23,6,7,58,139,133,59,12,2,24,82,78,44,4,0,34,57,55,15,8,2,387,228,159,273,157,116,46,95,105,66,30,38,26,53,77,39,13,17,20,42,28,27,17,21,38,79,84,49,14,4,21,45,55,28,3,1,17,34,29,21,11,3,310,143,167,222,95,127,73,73,66,59,17,8,34,35,28,37,6,-2,39,38,38,22,11,10,39,60,69,36,8,6,17,25,33,16,3,1,22,35,36,20,5,5,270,149,121,261,140,121,71,47,74,46,14,19,43,34,34,22,7,11,28,13,40,24,7,8,61,63,70,48,15,3,30,34,38,29,7,1,31,29,32,19,8,2,381,186,195,392,205,187,45,118,128,59,24,0,16,58,76,25,10,-1,29,60,52,34,14,1,60,112,116,65,31,5,31,58,68,26,18,3,29,54,48,39,13,2,498,309,189,560,360,200,71,104,176,83,42,20,35,59,124,62,21,12,36,45,52,21,21,8,83,125,217,101,27,2,42,75,151,73,17,0,41,50,66,28,10,2,114,84,30,137,100,37,18,53,30,35,-12,-2,14,28,11,32,1,1,4,25,19,3,-13,-3,21,48,52,21,-1,-4,17,28,35,20,2,-2,4,20,17,1,-3,-2,-107,-100,-7,-79,-78,-1,3,-8,-56,-31,-19,9,3,-10,-53,-34,-15,12,0,2,-3,3,-4,-3,13,0,-56,-24,-12,-3,6,-8,-46,-25,-7,2,7,8,-10,1,-5,-5,84,43,41,-29,-26,-3,38,32,35,6,-42,4,26,26,18,-12,-25,4,12,6,17,18,-17,0,8,23,-15,-18,-28,-1,8,17,-15,-20,-17,0,0,6,0,2,-11,-1,-5,-16,11,12,-11,23,6,4,5,-14,-21,10,1,6,-11,4,-20,2,5,-2,16,-18,-1,8,3,15,6,-11,-4,2,0,5,-5,-4,-7,-1,3,10,11,-7,3,3,-65,-64,-1,-25,-35,10,-25,-12,-29,-14,-9,23,-25,-7,-23,-12,-13,15,0,-5,-6,-2,4,8,-11,8,-13,-3,-10,3,-7,2,-11,-10,-10,1,-4,6,-2,7,0,2,-56,-56,0,-122,-93,-29,-14,1,-37,-43,3,33,2,-12,-37,-22,-1,12,-16,13,0,-21,4,21,-12,-5,-47,-43,-16,2,-5,-4,-39,-31,-13,-1,-7,-1,-8,-12,-3,3,-100,-54,-46,-52,-32,-20,-5,-24,-16,-16,-23,-20,-4,-9,-6,-24,-11,-4,-1,-15,-10,8,-12,-16,-1,-4,-14,-18,-8,-7,-3,1,-7,-16,-5,-2,2,-5,-7,-2,-3,-5,-145,-103,-42,-176,-128,-48,-5,-57,-86,-28,4,18,-8,-28,-51,-30,3,4,3,-29,-35,2,1,14,-15,-28,-74,-45,-13,-2,-12,-23,-53,-33,-6,-2,-3,-5,-21,-12,-7,0,-39,-27,-12,-72,-42,-30,-22,14,-32,-7,-26,16,-15,-8,-7,-7,-10,10,-7,22,-25,0,-16,6,-24,7,-25,-20,-14,-1,-14,1,-6,-15,-9,0,-10,6,-19,-5,-5,-1,-8,11,-19,26,8,18,20,1,-48,26,-21,6,11,-1,-21,18,-5,0,9,2,-27,8,-16,6,17,20,-8,-1,-6,3,8,7,-2,-1,-5,1,9,13,-6,0,-1,2
44,44014,Alcorisa,3185,38,18,20,26,14,12,2,19,5,9,2,3,-2,10,4,3,2,3,4,9,1,6,0,0,4,8,6,5,2,1,2,4,3,2,2,1,2,4,3,3,0,0,56,30,26,33,17,16,10,4,23,13,2,4,6,2,12,9,0,1,4,2,11,4,2,3,4,7,18,3,1,0,2,3,11,1,0,0,2,4,7,2,1,0,101,53,48,92,57,35,18,29,22,12,9,10,4,18,15,7,3,4,14,11,7,5,6,6,14,33,27,13,2,1,6,21,20,7,1,0,8,12,7,6,1,1,77,56,21,64,40,24,8,18,22,15,13,-6,4,14,14,16,8,-3,4,4,8,-1,5,-3,4,12,24,9,9,2,1,5,18,8,6,1,3,7,6,1,3,1,96,64,32,58,41,17,19,34,12,28,5,-6,7,26,5,25,2,-4,12,8,7,3,3,-2,7,29,5,13,1,3,4,22,0,14,0,1,3,7,5,-1,1,2,56,47,9,71,49,22,10,7,21,10,12,-5,4,7,21,7,7,0,6,0,0,3,5,-5,13,18,24,8,7,0,7,12,22,5,2,0,6,6,2,3,5,0,73,39,34,88,51,37,16,27,19,9,0,1,7,16,14,5,-4,-1,9,11,5,4,4,2,21,28,27,10,1,-1,10,15,21,4,1,-1,11,13,6,6,0,0,-2,-19,17,77,40,37,-1,-13,15,-4,7,-4,-3,-10,6,-5,-1,-4,2,-3,9,1,8,0,15,11,33,11,8,-1,9,5,19,5,2,0,6,6,14,6,6,-1,-6,-1,-5,25,10,15,7,11,-19,3,-2,-2,7,2,-13,4,-2,3,0,9,-6,-1,0,-5,7,8,6,4,2,0,5,2,0,2,1,1,2,6,6,2,1,-1,-43,-28,-15,2,-2,4,-2,-14,-13,-4,-11,0,0,-8,-15,1,-5,-2,-2,-6,2,-5,-6,2,10,-1,2,-3,-7,1,7,-2,-2,-2,-4,1,3,1,4,-1,-3,0,-6,4,-10,0,0,0,-3,-2,1,-3,-2,2,1,0,0,2,-1,1,-4,-2,1,-5,-1,1,6,2,-1,-3,-4,0,6,2,-4,-2,-2,0,0,0,3,-1,-2,0,-62,-33,-29,-13,-10,-3,-15,3,-32,-14,-4,4,-13,-2,-14,-3,-3,3,-2,5,-18,-11,-1,1,-4,2,-3,-4,-3,0,-5,0,-1,-2,-2,0,1,2,-2,-2,-1,0,-38,-25,-13,-10,-10,0,-7,-3,-16,-5,-9,1,-2,-3,-7,-8,-5,0,-5,0,-9,3,-4,1,0,-1,-3,-5,-1,0,1,-1,-5,-5,0,0,-1,0,2,0,-1,0,-37,-18,-19,-15,-9,-6,-1,-3,-5,-19,-6,-5,-4,-2,-1,-9,-4,0,3,-1,-4,-10,-2,-5,1,-1,-2,-8,-3,-2,1,-1,0,-6,-2,-1,0,0,-2,-2,-1,-1,-53,-35,-18,-28,-20,-8,-6,-6,-18,-19,-3,-1,-4,-2,-12,-18,0,-1,-2,-4,-6,-1,-3,0,-2,2,-6,-15,-4,-4,-3,2,-5,-13,-1,-1,1,0,-1,-2,-3,-3,-45,-28,-17,-32,-17,-15,-2,-19,-12,-8,-10,2,1,-6,-8,-4,-11,-1,-3,-13,-4,-4,1,3,-2,-4,-5,-7,-12,-2,1,0,-3,-5,-8,-2,-3,-4,-2,-2,-4,0,-6,-1,-5,1,1,0,2,-7,-4,-8,3,7,0,-4,4,-5,-1,5,2,-3,-8,-3,4,2,0,1,3,-3,-1,1,-2,0,5,-2,-1,1,2,1,-2,-1,0,0,-18,-16,-2,0,-3,3,4,3,-2,-15,-5,-4,4,0,-2,-14,-2,-2,0,3,0,-1,-3,-2,0,2,5,-6,0,-1,1,1,3,-6,-1,-1,-1,1,2,0,1,0
44,44025,Andorra,8072,-100,-40,-60,35,29,6,-16,-25,-7,-30,-8,-14,-11,-9,7,-13,-7,-8,-5,-16,-14,-17,-1,-6,2,5,20,7,1,0,0,4,18,6,1,0,2,1,2,1,0,0,-18,-1,-17,30,17,13,8,-5,4,-20,-6,-2,-2,4,0,-6,0,1,10,-9,4,-14,-6,-3,9,5,9,5,0,0,5,3,5,3,0,0,4,2,4,2,0,0,57,38,19,96,62,34,4,25,12,8,2,5,3,9,15,13,-4,1,1,16,-3,-5,6,4,13,24,33,22,2,1,3,16,27,15,0,1,10,8,6,7,2,0,25,19,6,74,44,30,19,0,18,-1,-6,-5,16,9,4,2,-8,-4,3,-9,14,-3,2,-1,23,12,26,10,3,0,13,8,15,8,0,0,10,4,11,2,3,0,52,26,26,98,55,43,10,12,9,-2,-7,23,3,9,5,-1,-3,11,7,3,4,-1,-4,12,17,32,21,16,5,3,12,17,13,6,3,1,5,15,8,10,2,2,49,38,11,81,53,28,26,12,27,-2,-17,-1,18,12,17,0,-10,-2,8,0,10,-2,-7,1,15,25,28,9,2,1,10,20,18,5,0,0,5,5,10,4,2,1,161,98,63,185,111,74,43,25,54,30,3,2,26,14,37,17,0,1,17,11,17,13,3,1,35,49,59,32,6,1,19,28,40,18,4,0,16,21,19,14,2,1,146,89,57,163,106,57,46,31,41,39,-21,7,20,29,28,22,-10,0,26,2,13,17,-11,7,20,52,52,33,4,2,9,35,41,20,1,0,11,17,11,13,3,2,86,63,23,113,82,31,16,20,26,19,-4,10,8,22,19,16,-6,5,8,-2,7,3,2,5,12,29,38,30,3,1,8,23,27,23,1,0,4,6,11,7,2,1,-25,-32,7,44,27,17,0,3,-15,0,-19,4,-3,-4,-14,-1,-14,3,3,7,-1,1,-5,1,3,9,17,10,0,3,1,4,12,7,0,1,2,5,5,3,0,2,-13,-10,-3,78,50,28,13,8,-12,-15,-5,-1,7,4,-6,-3,-8,-3,6,4,-6,-12,3,2,15,28,21,6,5,2,8,18,16,4,3,1,7,10,5,2,2,1,-22,7,-29,39,29,10,-3,5,-26,-3,-2,8,2,15,-10,0,-2,2,-5,-10,-16,-3,0,6,5,19,10,6,-1,0,2,17,9,3,-2,0,3,2,1,3,1,0,18,4,14,42,26,16,12,-18,2,16,8,-5,0,-1,-9,9,7,-1,12,-17,11,7,1,-4,12,6,8,16,-1,0,3,6,5,12,0,0,9,0,3,4,-1,0,-49,-29,-20,-20,-19,-1,9,-16,-16,-6,-15,-5,7,-3,-11,-8,-12,-4,2,-13,-5,2,-3,-1,4,1,-6,-14,-4,0,6,-1,-6,-14,-3,0,-2,2,0,0,-1,0,-91,-59,-32,-53,-36,-17,-24,-16,-29,-22,-3,3,-17,-6,-16,-11,-11,1,-7,-10,-13,-11,8,2,-6,-3,-18,-15,-8,-3,-4,1,-16,-9,-7,-1,-2,-4,-2,-6,-1,-2,-163,-91,-72,-86,-52,-34,3,-26,-55,-46,-36,-1,2,-14,-33,-24,-20,0,1,-12,-22,-22,-16,-1,0,-10,-25,-31,-19,-1,0,-6,-17,-18,-11,0,0,-4,-8,-13,-8,-1,-30,-17,-13,29,13,16,7,-1,-19,-8,-8,-3,2,-4,-8,-4,-5,0,5,3,-11,-4,-3,-3,4,4,7,10,3,1,2,1,3,5,1,1,2,3,4,5,2,0,-156,-78,-78,-49,-31,-18,-19,-19,-66,-36,-23,8,-7,-9,-33,-21,-15,8,-12,-10,-33,-15,-8,0,-4,4,-12,-19,-17,-1,-3,1,-2,-14,-12,-1,-1,3,-10,-5,-5,0
44,44050,Calamocha,4055,31,17,14,3,1,2,9,14,6,13,-5,-10,-2,13,5,7,-5,-3,11,1,1,6,0,-7,1,2,0,0,0,0,0,1,0,0,0,0,1,1,0,0,0,0,70,38,32,53,26,27,1,22,36,18,1,-9,-4,15,21,9,0,-4,5,7,15,9,1,-5,3,18,20,11,1,0,1,10,11,4,0,0,2,8,9,7,1,0,108,64,44,73,37,36,25,33,22,14,11,2,14,18,14,14,4,2,11,15,8,0,7,0,17,28,17,13,1,-3,7,12,11,8,0,-1,10,16,6,5,1,-2,63,31,32,82,42,40,0,32,36,14,-5,-14,2,14,21,-1,-3,-3,-2,18,15,15,-2,-11,16,23,29,13,1,0,11,13,13,5,0,0,5,10,16,8,1,0,121,93,28,135,88,47,31,48,23,25,4,-9,18,29,27,22,4,-8,13,19,-4,3,0,-1,22,44,35,26,4,4,13,28,26,18,1,2,9,16,9,8,3,2,142,88,54,165,100,65,33,43,43,23,8,-11,23,22,30,13,5,-6,10,21,13,10,3,-5,27,36,69,28,3,0,15,19,46,18,1,0,12,17,23,10,2,0,87,40,47,125,62,63,21,49,35,0,-4,-15,7,29,18,-7,-1,-6,14,20,17,7,-3,-9,21,38,42,16,7,-1,9,25,24,0,4,0,12,13,18,16,3,-1,179,126,53,207,139,68,35,28,61,49,14,-13,22,20,43,39,6,-5,13,8,18,10,8,-8,35,52,61,50,5,2,20,34,43,39,2,0,15,18,18,11,3,2,18,-7,25,36,12,24,36,10,-3,1,-5,-21,31,-2,-15,-6,-3,-12,5,12,12,7,-2,-9,23,18,0,0,-5,-1,23,3,-6,-6,-2,0,0,15,6,6,-3,-1,-108,-84,-24,-93,-73,-20,7,-16,-48,-27,-15,-11,-5,-13,-37,-22,-8,-2,12,-3,-11,-5,-7,-9,1,-24,-38,-21,-9,0,-4,-17,-28,-20,-4,0,5,-7,-10,-1,-5,0,-24,-19,-5,3,-9,12,-12,5,0,-11,-2,-8,-4,2,-1,-12,-6,-2,-8,3,1,1,4,-6,2,8,-5,-5,0,1,1,2,-5,-6,-2,0,1,6,0,1,2,1,-34,-29,-5,-17,-10,-7,1,3,-24,4,4,-18,3,2,-18,-7,3,-9,-2,1,-6,11,1,-9,1,-1,-6,-7,-2,0,3,1,-3,-9,0,0,-2,-2,-3,2,-2,0,-56,-39,-17,-40,-26,-14,-8,-4,-24,-11,-10,-3,-8,-3,-15,-6,-8,-2,0,-1,-9,-5,-2,-1,-4,1,-15,-13,-9,-1,-5,0,-7,-10,-4,0,1,1,-8,-3,-5,-1,-34,-20,-14,-39,-24,-15,-6,1,-16,1,-9,-8,-7,2,-15,3,-3,-1,1,-1,-1,-2,-6,-7,-11,-1,-16,-2,-9,0,-5,-1,-11,0,-7,0,-6,0,-5,-2,-2,0,-40,-31,-9,-16,-15,-1,-7,-5,-9,-5,-9,-7,-4,-7,-8,-5,-3,-4,-3,2,-1,0,-6,-3,-4,8,-10,-10,-1,1,-4,1,-6,-6,0,0,0,7,-4,-4,-1,1,-18,-19,1,-19,-14,-5,1,-3,-18,-3,5,0,-5,-7,-11,-3,7,-1,6,4,-7,0,-2,1,2,-1,-7,-7,-6,0,0,-2,-6,-4,-1,-1,2,1,-1,-3,-5,1,-5,-4,-1,24,18,6,8,-7,-4,3,2,-7,7,-3,-3,0,-2,-2,1,-4,-1,3,4,-5,6,6,2,7,2,1,3,4,3,7,1,0,3,2,-1,0,1,1,-11,5,-16,-18,-8,-10,1,4,-15,-8,0,3,3,2,-3,1,1,-2,-2,2,-12,-9,-1,5,3,-2,-12,-8,-1,2,2,-2,-6,-3,0,1,1,0,-6,-5,-1,1
44,44051,Calanda,3487,18,13,5,33,23,10,-3,9,5,8,-5,3,-4,7,4,5,-3,3,1,2,1,3,-2,0,3,10,12,6,1,1,1,8,8,4,1,1,2,2,4,2,0,0,48,36,12,47,35,12,1,9,24,-3,10,-3,1,8,19,-2,5,-1,0,1,5,-1,5,-2,5,10,20,5,0,0,3,8,15,4,0,0,2,2,5,1,0,0,95,61,34,125,78,47,18,20,24,15,-1,10,11,12,22,6,-1,3,7,8,2,9,0,7,15,29,43,26,0,3,8,14,32,16,0,1,7,15,11,10,0,2,42,16,26,66,39,27,8,14,3,-6,10,10,7,4,4,-8,2,4,1,10,-1,2,8,6,13,14,28,6,2,2,7,10,18,2,0,1,6,4,10,4,2,1,59,33,26,82,37,45,2,23,20,8,5,0,1,15,5,6,5,1,1,8,15,2,0,-1,15,23,29,13,0,1,6,12,11,7,0,1,9,11,18,6,0,0,78,41,37,89,49,40,12,9,33,16,2,4,8,5,15,8,4,1,4,4,18,8,-2,3,12,12,36,26,2,0,7,6,20,15,1,0,5,6,16,11,1,0,95,57,38,136,80,56,11,28,11,31,10,-1,1,22,15,9,5,2,10,6,-4,22,5,-3,19,31,43,34,5,1,8,21,29,18,2,1,11,10,14,16,3,0,128,65,63,134,88,46,21,16,22,28,5,31,9,8,14,14,3,13,12,8,8,14,2,18,13,38,44,30,5,1,7,26,31,17,3,1,6,12,13,13,2,0,96,36,60,94,44,50,32,19,13,19,8,2,20,14,-7,6,2,-2,12,5,20,13,6,4,21,25,24,14,7,0,14,12,9,4,3,0,7,13,15,10,4,0,133,59,74,85,38,47,28,19,41,26,14,5,16,4,17,11,8,2,12,15,24,15,6,3,11,20,32,18,4,-1,9,8,13,5,3,-1,2,12,19,13,1,0,29,7,22,56,17,39,3,16,1,12,-1,-2,6,6,-5,0,1,0,-3,10,6,12,-2,-2,6,16,14,19,2,-2,4,6,4,3,0,-1,2,10,10,16,2,-1,-66,-32,-34,-48,-19,-29,-10,-7,-13,-30,-13,6,-10,-6,1,-12,-6,1,0,-1,-14,-18,-7,5,1,-4,-12,-21,-14,2,-2,-4,-1,-7,-5,0,3,0,-11,-14,-9,2,10,1,9,-3,-7,4,7,4,0,0,-5,4,5,2,-4,-2,0,0,2,2,4,2,-5,4,1,8,-7,-4,-2,1,-1,3,-6,-2,-2,1,2,5,-1,-2,0,0,-12,-30,18,-20,-22,2,17,-7,-19,3,-8,2,2,-10,-19,2,-4,-1,15,3,0,1,-4,3,3,-3,-10,-5,-4,-1,0,-5,-9,-6,-1,-1,3,2,-1,1,-3,0,-13,1,-14,-7,-4,-3,-2,2,-11,-4,-3,3,-1,2,3,-4,-3,2,-1,0,-14,0,0,1,-4,4,-6,4,-4,-1,-2,2,-2,2,-3,-1,-2,2,-4,2,-1,0,-23,4,-27,3,6,-3,-1,12,-8,-14,-6,0,2,3,-5,-1,5,2,-3,9,-3,-13,-11,-2,2,12,2,-6,-8,1,3,2,3,-1,-1,0,-1,10,-1,-5,-7,1,-68,-27,-41,-9,3,-12,-16,-13,-18,-21,1,-3,-9,-7,-5,-1,-3,-2,-7,-6,-13,-20,4,-1,-2,0,-1,-4,-2,0,-1,1,3,1,-1,0,-1,-1,-4,-5,-1,0,5,9,-4,23,18,5,15,-3,-10,9,-6,1,7,1,-2,9,-7,1,8,-4,-8,0,1,0,12,4,6,5,-4,0,8,3,5,7,-5,0,4,1,1,-2,1,0
44,44076,Cella,2913,1,-2,3,6,1,5,2,-2,-4,2,4,-2,4,-2,-4,1,1,-2,-2,0,0,1,3,0,0,1,3,1,1,0,0,0,0,1,0,0,0,1,3,0,1,0,6,12,-6,11,8,3,10,3,1,3,-4,-9,6,6,0,4,-2,-2,4,-3,1,-1,-2,-7,3,3,4,1,0,0,2,3,2,1,0,0,1,0,2,0,0,0,-18,-6,-12,12,6,6,-3,-3,-10,-2,0,2,-4,-1,-3,-1,-1,3,1,-2,-7,-1,1,-1,3,4,1,2,1,1,1,3,-1,2,0,1,2,1,2,0,1,0,38,37,1,42,34,8,1,17,12,6,3,-2,4,14,9,5,4,0,-3,3,3,1,-1,-2,6,9,10,11,5,1,5,9,7,8,4,1,1,0,3,3,1,0,84,71,13,78,67,11,10,23,25,19,5,2,7,24,21,14,4,1,3,-1,4,5,1,1,5,26,25,14,5,3,3,24,23,13,2,2,2,2,2,1,3,1,47,26,21,38,23,15,1,21,12,8,4,-2,-2,12,12,4,3,-2,3,9,0,4,1,0,6,12,10,5,3,0,3,7,7,4,2,0,3,5,3,1,1,0,91,74,17,55,43,12,27,18,34,21,-1,-8,26,13,18,20,0,-4,1,5,16,1,-1,-4,11,17,12,18,-2,-1,9,11,9,15,0,-1,2,6,3,3,-2,0,126,105,21,106,89,17,17,34,60,6,5,-1,14,21,55,7,4,2,3,13,5,-1,1,-3,10,26,52,11,4,3,7,22,44,10,3,3,3,4,8,1,1,0,20,13,7,63,44,19,-9,22,-13,19,2,2,-10,18,0,9,-1,-1,1,4,-13,10,3,3,5,16,23,15,2,1,1,12,18,10,2,1,4,4,5,5,0,0,-141,-130,-11,-88,-84,-4,-13,-20,-52,-51,-2,-3,-7,-22,-49,-48,-3,-1,-6,2,-3,-3,1,-2,-1,-9,-33,-41,-4,0,0,-11,-32,-37,-4,0,-1,2,-1,-4,0,0,-22,-14,-8,0,-7,7,2,-4,-15,-6,0,0,0,1,-10,-6,0,1,2,-5,-5,0,0,-1,3,5,-3,-4,0,-1,0,2,-4,-4,0,-1,3,3,1,0,0,0,-12,-9,-3,10,4,6,2,-4,0,-6,2,-5,1,-6,0,-3,2,-3,1,2,0,-3,0,-2,3,2,3,0,0,2,1,1,1,0,0,1,2,1,2,0,0,1,14,4,10,-6,-4,-2,15,-2,-6,7,0,1,12,-1,-10,3,0,1,3,-1,4,4,0,0,1,-3,0,-6,0,2,1,-1,0,-5,0,1,0,-2,0,-1,0,1,-52,-26,-26,-9,-9,0,-11,-7,-11,-9,-10,-5,-5,-6,-5,-3,-7,-1,-6,-1,-6,-6,-3,-4,-1,2,-7,-2,-2,0,0,-1,-4,-3,-2,0,-1,3,-3,1,0,0,-18,-4,-14,0,2,-2,-2,-2,-4,-4,0,-7,3,-2,5,-5,-2,-4,-5,0,-9,1,2,-3,-2,-1,1,0,1,0,0,0,1,0,0,0,-2,-1,0,0,1,0,-63,-44,-19,-1,-3,2,-15,-2,-12,-13,-7,-14,-9,0,-8,-12,-7,-7,-6,-2,-4,-1,0,-7,0,0,-1,0,0,0,0,0,-2,0,-1,0,0,0,1,0,1,0,-38,-27,-11,-19,-14,-5,-2,-2,-18,-3,-3,-11,-3,-1,-13,-1,-3,-7,1,-1,-5,-2,0,-4,-2,1,-13,-5,-1,1,0,1,-11,-3,-1,0,-2,0,-2,-2,0,1,-15,-13,-2,6,1,5,3,-2,-4,1,-4,-8,-2,-4,-3,2,-1,-4,5,2,-1,-1,-3,-4,4,-2,0,4,0,0,1,-1,1,0,0,0,3,-1,-1,4,0,0
44,44099,Escucha,1121,8,15,-7,28,23,5,-1,9,11,-9,-1,-1,2,6,10,-2,-1,0,-3,3,1,-7,0,-1,6,5,13,4,0,0,4,4,12,3,0,0,2,1,1,1,0,0,-2,11,-13,14,12,2,-5,2,6,-1,0,-4,0,4,5,5,-2,-1,-5,-2,1,-6,2,-3,1,6,3,4,0,0,1,5,2,4,0,0,0,1,1,0,0,0,-23,-12,-11,19,15,4,-10,-6,-1,-7,-1,0,-4,-5,-2,-2,-1,1,-6,-1,1,-5,0,-1,1,3,10,3,0,1,1,1,9,2,0,1,0,2,1,1,0,0,-7,-8,1,9,4,5,8,-3,-6,-6,2,-2,5,-2,-4,-7,0,0,3,-1,-2,1,2,-2,6,1,2,0,0,0,4,1,0,-1,0,0,2,0,2,1,0,0,-10,-6,-4,16,12,4,2,-2,-10,4,-4,-1,2,0,-5,3,-3,-2,0,-2,-5,1,-1,1,4,3,3,5,1,0,3,3,2,3,1,0,1,0,1,2,0,0,4,12,-8,30,25,5,-3,3,10,-3,-1,-2,-1,5,13,-1,-2,-1,-2,-2,-3,-2,1,-1,3,5,17,4,0,0,2,5,15,3,0,0,1,0,2,1,0,0,-19,-15,-4,14,13,1,-3,-4,-2,-12,5,-2,-2,-2,0,-12,4,-2,-1,-2,-2,0,1,0,0,3,7,4,0,0,0,3,6,4,0,0,0,0,1,0,0,0,-41,-17,-24,13,9,4,-4,-5,-16,-4,-5,-7,2,-1,-7,-3,-4,-4,-6,-4,-9,-1,-1,-3,4,3,2,2,2,0,3,1,2,3,0,0,1,2,0,-1,2,0,-15,-2,-13,2,-1,3,-9,-3,9,-6,-2,-5,-5,-2,7,-2,1,-2,-4,-1,2,-4,-3,-3,-2,1,4,-2,1,0,-1,-1,2,-1,0,0,-1,2,2,-1,1,0,16,15,1,17,12,5,5,7,-1,0,5,0,5,3,6,-3,3,1,0,4,-7,3,2,-1,6,4,4,2,1,0,6,2,4,-1,1,0,0,2,0,3,0,0,9,-1,10,7,0,7,8,7,-2,5,-3,-5,6,0,-3,1,-3,-2,2,7,1,4,0,-3,4,4,-1,1,-1,0,2,1,-2,0,-1,0,2,3,1,1,0,0,-22,-15,-7,-4,-2,-2,10,-5,-11,-4,-7,-6,3,-4,-8,-1,-3,-2,7,-1,-3,-3,-4,-4,0,0,-3,-1,0,0,0,0,-2,0,0,0,0,0,-1,-1,0,0,9,2,7,10,2,8,8,4,2,2,-1,-6,3,2,3,-2,0,-4,5,2,-1,4,-1,-2,4,3,1,2,0,0,0,1,0,1,0,0,4,2,1,1,0,0,-15,-5,-10,3,0,3,0,-2,4,-10,-4,-4,3,1,-2,-3,-2,-2,-3,-3,6,-7,-2,-2,2,0,2,-1,0,0,2,-1,0,-1,0,0,0,1,2,0,0,0,-23,-16,-7,-3,-1,-2,-16,-5,-5,6,0,-4,-13,-3,-4,6,-2,-1,-3,-2,-1,0,2,-3,-3,0,-2,1,0,0,-2,0,-1,1,0,0,-1,0,-1,0,0,0,-6,-7,1,4,1,3,-1,1,0,-8,1,1,-3,-1,1,-4,0,0,2,2,-1,-4,1,1,1,2,-1,1,1,0,0,0,0,1,0,0,1,2,-1,0,1,0,-38,-25,-13,0,1,-1,-2,-3,-4,-17,-10,-2,-2,-1,-3,-9,-7,-2,0,-2,-1,-8,-3,0,0,1,-1,0,0,0,0,0,0,1,0,0,0,1,-1,-1,0,0,-24,-17,-7,-9,-5,-4,-3,0,-4,-7,-5,-5,-2,-1,-2,-4,-6,-2,-1,1,-2,-3,1,-3,-5,1,-1,-1,-3,0,-3,0,1,0,-3,0,-2,1,-2,-1,0,0
44,44145,Mas de las Matas,1483,7,6,1,6,4,2,-1,0,5,0,1,0,0,2,2,0,0,0,-1,-2,3,0,1,0,0,1,3,2,0,0,0,1,2,1,0,0,0,0,1,1,0,0,-3,5,-8,18,13,5,-8,5,-9,3,2,4,-3,4,0,1,2,1,-5,1,-9,2,0,3,0,9,4,5,0,0,0,7,4,2,0,0,0,2,0,3,0,0,24,14,10,27,17,10,3,10,0,-2,2,9,2,4,5,-3,2,3,1,6,-5,1,0,6,8,10,6,2,0,0,4,7,4,1,0,0,4,3,2,1,0,0,21,12,9,12,4,8,5,-4,6,1,6,6,2,-2,2,2,3,4,3,-2,4,-1,3,2,4,1,4,1,1,0,1,1,0,1,0,0,3,0,4,0,1,0,7,11,-4,27,19,8,4,-1,-6,0,1,11,4,0,3,1,2,3,0,-1,-9,-1,-1,8,6,6,10,5,0,0,4,4,8,3,0,0,2,2,2,2,0,0,26,13,13,37,25,12,2,4,5,13,1,2,2,2,5,7,-1,-1,0,2,0,6,2,3,2,11,15,8,0,1,1,8,11,5,0,0,1,3,4,3,0,1,27,11,16,23,12,11,-4,9,8,1,3,8,-2,8,-2,3,0,4,-2,1,10,-2,3,4,2,11,6,4,0,0,1,8,0,3,0,0,1,3,6,1,0,0,9,9,0,30,17,13,-4,5,-5,-2,13,0,-2,3,-3,-2,10,1,-2,2,-2,0,3,-1,4,10,8,5,3,0,2,4,4,4,3,0,2,6,4,1,0,0,-2,6,-8,12,10,2,2,2,-1,-6,-2,3,-2,4,1,-1,-1,4,4,-2,-2,-5,-1,-1,3,6,4,-2,0,0,2,4,4,-1,0,0,1,2,0,-1,0,0,-6,-10,4,11,1,10,-9,7,-8,-3,0,7,-4,3,-7,-2,-3,3,-5,4,-1,-1,3,4,2,4,1,2,0,2,1,2,-2,1,-1,0,1,2,3,1,1,2,-11,-3,-8,-8,-3,-5,-2,3,-12,1,4,-6,-1,3,-9,2,4,-4,-1,0,-3,-1,0,-2,-4,0,-3,-1,0,0,-1,1,-2,-1,0,0,-3,-1,-1,0,0,0,7,2,5,8,5,3,3,2,2,-3,0,2,2,1,2,-2,-1,0,1,1,0,-1,1,2,2,4,0,2,0,0,1,3,0,1,0,0,1,1,0,1,0,0,9,6,3,1,0,1,0,2,5,-2,2,1,0,0,6,-6,2,3,0,2,-1,4,0,-2,1,1,1,-1,-1,0,1,1,1,-3,0,0,0,0,0,2,-1,0,-13,-10,-3,-9,-9,0,0,0,-8,-2,0,-2,-2,-1,-5,-2,1,0,2,1,-3,0,-1,-2,-2,0,-5,0,-2,0,-2,0,-5,-1,-1,0,0,0,0,1,-1,0,0,3,-3,-6,-2,-4,2,-1,0,-1,-2,2,3,-1,3,0,-2,0,-1,0,-3,-1,0,2,0,-2,0,-4,0,0,0,-1,0,-1,0,0,0,-1,0,-3,0,0,-7,2,-9,3,0,3,0,1,-2,-4,-1,0,0,1,0,2,-1,0,0,0,-2,-6,0,0,0,3,-3,-1,2,2,0,1,-2,0,0,1,0,2,-1,-1,2,1,-15,-10,-5,-3,-3,0,-5,-2,-15,1,2,3,-2,-1,-12,0,3,2,-3,-1,-3,1,-1,1,0,1,-5,0,0,1,0,1,-4,0,0,0,0,0,-1,0,0,1,18,7,11,6,3,3,3,0,4,4,-1,7,0,-1,2,3,0,2,3,1,2,1,-1,5,3,2,1,0,0,0,0,2,1,0,0,0,3,0,0,0,0,0
44,44153,Monreal del Campo,2318,27,13,14,37,25,12,-2,14,7,9,4,-5,-3,7,6,5,1,-3,1,7,1,4,3,-2,3,14,14,6,0,0,1,9,10,5,0,0,2,5,4,1,0,0,26,12,14,39,24,15,6,9,0,9,-1,-3,8,5,-2,5,-1,-3,-2,4,2,4,0,0,10,10,12,4,0,0,7,5,10,2,0,0,3,5,2,2,0,0,44,24,20,56,32,24,14,10,20,2,-2,-2,8,6,14,-3,-1,-2,6,4,6,5,-1,0,9,14,20,11,1,0,3,6,16,5,1,0,6,8,4,6,0,0,3,0,3,29,17,12,-4,13,-3,-9,2,5,-3,10,-5,-5,3,1,-1,3,2,-4,-1,4,9,9,9,2,0,0,5,7,5,0,0,0,4,2,4,2,0,0,88,65,23,67,47,20,25,16,31,8,2,7,18,9,24,4,1,9,7,7,7,4,1,-2,14,22,22,8,1,0,10,13,19,5,0,0,4,9,3,3,1,0,89,46,43,73,38,35,19,2,23,22,4,17,8,1,18,13,0,6,11,1,5,9,4,11,18,12,24,12,6,0,8,6,14,7,3,0,10,6,10,5,3,0,134,70,64,81,37,44,25,31,35,25,-1,17,13,15,18,16,0,7,12,16,17,9,-1,10,18,18,19,23,3,0,6,9,8,12,2,0,12,9,11,11,1,0,148,52,96,115,65,50,14,36,28,19,2,46,3,16,12,5,0,15,11,20,16,14,2,31,20,39,28,18,6,2,10,23,18,12,2,0,10,16,10,6,4,2,29,17,12,41,23,18,-3,11,16,-3,-2,8,-3,3,18,-4,0,2,0,8,-2,1,-2,6,-2,12,18,12,1,0,-1,5,12,6,1,0,-1,7,6,6,0,0,23,10,13,17,9,8,11,1,7,-5,-5,7,6,-5,5,-2,-1,2,5,6,2,-3,-4,5,2,4,4,2,3,0,2,1,4,-1,2,-1,0,3,0,3,1,1,-8,0,-8,6,2,4,0,-4,-10,-1,-1,6,0,2,-6,-3,-2,8,0,-6,-4,2,1,-2,2,4,0,0,0,0,1,3,-1,-1,0,0,1,1,1,1,0,0,-80,-37,-43,-61,-37,-24,-16,0,-37,-10,-12,-4,-10,-2,-17,-7,-2,1,-6,2,-20,-3,-10,-5,-12,-2,-27,-11,-7,-2,-5,-2,-16,-11,-2,-1,-7,0,-11,0,-5,-1,-3,3,-6,8,1,7,-4,-1,-5,1,4,5,2,1,-5,0,3,3,-6,-2,0,1,1,2,3,5,0,-1,1,0,2,0,0,-1,0,0,1,5,0,0,1,0,-18,-13,-5,-6,-4,-2,-2,0,1,-7,-1,-9,-5,-3,-2,-1,1,-2,3,3,3,-6,-2,-7,-1,0,-3,0,-1,-1,0,-1,-3,0,0,0,-1,1,0,0,-1,-1,-26,-8,-18,-38,-29,-9,2,1,-13,-19,-5,5,6,-2,-8,-13,-2,7,-4,3,-5,-6,-3,-2,-4,4,-18,-16,-4,0,-1,0,-14,-13,-2,1,-3,4,-4,-3,-2,-1,-54,-26,-28,5,2,3,-16,-17,-12,-18,-2,11,-11,-6,-2,-10,-2,5,-5,-11,-10,-8,0,6,2,1,3,-1,0,0,1,0,0,1,0,0,1,1,3,-2,0,0,-27,-22,-5,-8,-6,-2,-16,3,-15,-3,0,3,-12,1,-7,-3,-3,1,-4,2,-8,0,3,2,-4,1,0,-7,2,0,-4,0,2,-4,0,0,0,1,-2,-3,2,0,-23,-16,-7,-9,-14,5,5,-2,-6,-18,-6,0,-1,0,-4,-7,-3,-3,6,-2,-2,-11,-3,3,3,1,-3,-8,-1,-1,0,0,-2,-9,-3,0,3,1,-1,1,2,-1
44,44216,Teruel,30047,95,40,55,103,48,55,11,25,43,1,-18,35,8,8,15,-7,-5,20,3,17,28,8,-13,15,5,25,37,26,7,2,4,12,16,9,4,2,1,13,21,17,3,0,725,355,370,428,202,226,98,148,316,102,18,42,44,64,158,53,5,30,54,84,158,49,13,12,58,99,149,94,21,2,22,48,77,44,8,1,36,51,72,50,13,1,475,235,240,446,236,210,85,95,187,70,-15,48,39,42,96,35,-2,20,46,53,91,35,-13,28,83,102,167,78,15,0,46,48,94,39,9,-1,37,54,73,39,6,1,264,90,174,267,123,144,64,64,70,49,-4,21,26,43,7,16,-7,4,38,21,63,33,3,17,58,66,59,60,13,7,23,31,31,29,6,2,35,35,28,31,7,5,565,293,272,398,209,189,101,124,200,101,8,32,53,83,101,49,-6,13,48,41,99,52,14,19,80,101,121,70,18,6,41,61,69,31,5,0,39,40,52,39,13,6,605,317,288,641,385,256,107,159,246,91,-23,18,59,78,135,64,-19,3,48,81,111,27,-4,15,99,185,218,112,21,3,60,108,137,67,8,3,39,77,81,45,13,0,702,384,318,848,467,381,151,142,230,125,21,21,79,82,118,77,11,10,72,60,112,48,10,11,160,197,282,168,27,9,79,100,164,104,9,7,81,97,118,64,18,2,816,464,352,1021,583,438,153,243,208,153,17,31,76,131,126,96,15,16,77,112,82,57,2,15,155,285,312,205,41,5,80,159,182,127,27,0,75,126,130,78,14,5,528,234,294,609,308,301,125,101,184,57,-4,66,61,51,75,24,-4,27,64,50,109,33,0,39,104,161,208,109,19,5,52,85,109,51,5,4,52,76,99,58,14,1,121,42,79,110,29,81,79,-7,-28,2,7,60,51,-7,-15,-12,-4,23,28,0,-13,14,11,37,57,40,7,0,-5,6,39,10,-3,-15,-6,1,18,30,10,15,1,5,179,24,155,197,76,121,91,1,12,-3,-8,87,36,-14,-18,-12,-1,35,55,15,30,9,-7,52,67,51,32,24,14,7,31,27,7,3,6,1,36,24,25,21,8,6,137,69,68,85,22,63,28,-9,4,-1,2,95,1,10,19,-9,3,39,27,-19,-15,8,-1,56,23,28,20,3,3,2,3,10,16,-5,0,-2,20,18,4,8,3,4,-282,-206,-76,-390,-248,-142,-20,-82,-126,-82,-38,60,-7,-68,-89,-51,-16,19,-13,-14,-37,-31,-22,41,-44,-37,-172,-94,-32,-12,-21,-35,-115,-59,-13,-6,-23,-2,-57,-35,-19,-6,-214,-189,-25,-293,-188,-105,31,-66,-107,-79,-61,64,21,-29,-85,-82,-41,26,10,-37,-22,3,-20,38,-24,-29,-97,-104,-34,-6,-5,-19,-62,-81,-20,-1,-19,-10,-35,-23,-14,-5,-44,-84,40,-59,-49,-10,-10,-13,-33,-46,-22,69,-8,-27,-38,-34,-11,30,-2,14,5,-12,-11,39,7,5,-31,-23,-16,-5,4,-4,-21,-21,-7,-2,3,9,-10,-2,-9,-3,101,31,70,-96,-49,-47,70,-41,4,-4,-36,104,25,-13,2,-14,-15,41,45,-28,2,10,-21,63,4,-9,-33,-34,-19,-6,3,-2,-20,-23,-8,0,1,-7,-13,-11,-11,-6,21,-31,52,-6,-10,4,45,20,-49,-45,-34,86,22,6,-30,-42,-21,39,23,14,-19,-3,-13,47,29,30,-11,-26,-25,-5,19,10,0,-23,-16,-1,10,20,-11,-3,-9,-4,308,86,222,93,42,51,81,10,48,46,-9,111,51,4,6,2,-31,44,30,6,42,44,22,67,52,39,9,-7,-3,-4,23,24,11,-12,-8,0,29,15,-2,5,5,-4
44,44246,Valderrobres,1880,49,34,15,20,17,3,5,14,24,6,2,-2,5,8,19,1,2,-1,0,6,5,5,0,-1,0,9,8,3,0,0,0,7,7,3,0,0,0,2,1,0,0,0,53,33,20,55,33,22,5,11,15,15,9,-2,2,9,9,8,6,-1,3,2,6,7,3,-1,8,14,14,17,2,0,5,9,9,8,2,0,3,5,5,9,0,0,85,67,18,101,59,42,6,7,57,12,2,1,5,6,42,11,1,2,1,1,15,1,1,-1,8,25,50,15,2,1,5,10,32,11,0,1,3,15,18,4,2,0,51,37,14,39,25,14,7,28,8,12,-4,1,5,17,9,8,-2,1,2,11,-1,4,-2,0,3,16,9,8,3,0,0,10,7,5,3,0,3,6,2,3,0,0,39,23,16,61,42,19,4,11,7,14,4,-1,3,10,-2,9,4,-1,1,1,9,5,0,0,8,18,14,19,2,0,6,12,8,14,2,0,2,6,6,5,0,0,101,67,34,58,31,27,4,24,38,-5,6,34,3,11,29,0,6,17,1,13,9,-5,0,17,6,18,28,3,2,1,1,8,20,1,0,1,5,10,8,2,2,0,57,32,25,61,38,23,8,16,18,-2,2,12,6,11,11,-1,0,3,2,5,7,-1,2,9,8,24,20,5,2,1,4,14,15,3,0,1,4,10,5,2,2,0,68,36,32,72,45,27,6,13,16,7,4,21,1,10,11,5,5,4,5,3,5,2,-1,17,11,19,27,12,2,1,4,13,18,9,1,0,7,6,9,3,1,1,57,21,36,50,26,24,7,5,30,7,-4,10,3,3,16,-1,-5,4,4,2,14,8,1,6,10,12,18,11,-2,0,4,6,12,5,-2,0,6,6,6,6,0,0,36,16,20,17,8,9,-6,1,15,10,0,13,2,-3,12,1,-2,5,-8,4,3,9,2,8,3,4,7,1,1,1,3,1,3,-1,1,1,0,3,4,2,0,0,36,22,14,21,10,11,-1,10,6,13,9,-2,-1,4,2,9,8,-1,0,6,4,4,1,-1,3,5,4,5,4,0,3,1,1,2,3,0,0,4,3,3,1,0,50,15,35,-3,-3,0,23,2,9,0,0,17,12,-7,5,0,-1,6,11,9,4,0,1,11,4,2,-3,-4,-2,0,2,-1,0,-3,-1,0,2,3,-3,-1,-1,0,-2,-5,3,-30,-18,-12,3,7,-5,-7,3,-6,3,3,-2,-9,1,-3,0,4,-3,2,2,-3,-4,2,-16,-8,-4,0,0,0,-9,-6,-3,0,-4,2,-7,-2,-1,0,35,15,20,-12,-13,1,6,9,-3,12,0,10,6,7,-5,3,1,4,0,2,2,9,-1,6,-3,3,-8,-2,-3,-1,-2,0,-6,-3,-1,-1,-1,3,-2,1,-2,0,8,2,6,4,-2,6,3,-3,-5,-9,9,14,0,-1,0,-6,5,4,3,-2,-5,-3,4,10,6,4,-1,-6,2,-1,3,0,-2,-3,1,-1,3,4,1,-3,1,0,-21,-14,-7,-2,-2,0,-5,1,-5,-8,-2,-3,-3,-1,0,-7,-4,0,-2,2,-5,-1,2,-3,5,4,-3,-6,-2,0,4,3,-1,-5,-3,0,1,1,-2,-1,1,0,43,17,26,7,1,6,3,-2,13,-2,5,25,5,-1,6,-5,2,10,-2,-1,7,3,3,15,1,5,6,-2,-3,0,0,0,3,-1,-1,0,1,5,3,-1,-2,0,55,27,28,16,3,13,17,5,12,10,-2,13,4,7,8,6,-4,7,13,-2,4,4,2,6,5,2,2,6,-1,0,2,1,-2,3,-1,0,3,1,4,3,0,0
45,45002,Alameda de la Sagra,2823,-5,5,-10,8,6,2,0,3,-3,-1,-3,0,2,4,2,0,-1,-1,-2,-1,-5,-1,-2,1,0,3,3,1,0,1,0,3,2,1,0,0,0,0,1,0,0,1,41,22,19,27,16,11,9,16,7,9,0,-1,7,7,2,6,-1,0,2,9,5,3,1,-1,9,8,6,4,0,0,5,4,5,2,0,0,4,4,1,2,0,0,24,12,12,9,5,4,7,7,2,2,3,3,5,4,-2,0,3,1,2,3,4,2,0,2,2,2,2,1,2,0,2,1,2,0,0,0,0,1,0,1,2,0,80,47,33,35,18,17,12,28,29,3,1,4,5,15,18,4,1,2,7,13,11,-1,0,2,9,10,10,5,0,1,6,4,6,2,0,0,3,6,4,3,0,1,101,65,36,26,17,9,27,21,22,25,6,-2,14,18,12,15,6,-1,13,3,10,10,0,-1,4,7,8,7,0,0,2,4,8,3,0,0,2,3,0,4,0,0,40,24,16,24,13,11,4,11,11,10,2,1,4,8,2,5,1,2,0,3,9,5,1,-1,7,5,6,6,0,0,5,2,4,2,0,0,2,3,2,4,0,0,89,39,50,48,27,21,16,16,24,22,9,3,5,4,14,10,2,3,11,12,10,12,7,0,7,15,12,7,6,1,2,10,9,3,3,0,5,5,3,4,3,1,58,51,7,61,49,12,-5,32,35,0,-5,-3,-1,21,26,8,-4,-3,-4,11,9,-8,-1,0,6,24,19,10,1,1,5,18,14,11,1,0,1,6,5,-1,0,1,50,32,18,50,29,21,14,22,10,1,-1,-2,7,11,8,6,-2,-1,7,11,2,-5,1,-1,13,19,19,-1,1,-1,4,10,13,1,1,0,9,9,6,-2,0,-1,2,-10,12,-8,-11,3,-2,-1,2,-3,4,1,-5,-4,6,-7,1,0,3,3,-4,4,3,1,-2,-3,-5,-3,4,0,-2,-3,-3,-5,2,0,0,0,-2,2,2,0,56,21,35,14,1,13,14,4,17,18,5,-4,-1,1,9,9,3,-3,15,3,8,9,2,-1,7,-1,1,3,4,0,0,-2,-1,2,2,0,7,1,2,1,2,0,25,1,24,-3,-10,7,7,5,14,3,-6,2,10,0,-4,2,-7,0,-3,5,18,1,1,2,0,-1,-1,1,-3,0,0,-4,-4,1,-3,0,0,3,3,0,0,0,-12,-13,1,1,1,0,6,8,-13,-19,5,1,-1,7,-5,-17,2,1,7,1,-8,-2,3,0,-2,2,-1,-3,2,2,-1,2,0,-1,-1,1,-1,0,-1,-2,3,1,-23,-4,-19,-8,-5,-3,-3,1,-18,4,-6,1,-2,-1,-3,2,0,0,-1,2,-15,2,-6,1,-1,1,-1,-2,-3,-2,0,-1,0,-3,0,-1,-1,2,-1,1,-3,-1,-24,-10,-14,-4,-3,-1,-8,3,-12,-3,-5,0,-2,0,-2,-1,-6,-1,-6,3,-10,-2,1,1,1,-2,0,-1,-3,0,1,-2,1,0,-3,0,0,0,-1,-1,0,0,76,40,36,17,6,11,36,9,16,10,8,-4,11,8,12,4,6,-1,25,1,4,6,2,-3,8,3,2,2,-1,0,3,1,1,0,0,0,5,2,1,2,-1,0,-40,-20,-20,3,2,1,-29,3,6,-7,-10,-2,-10,0,3,-6,-4,-2,-19,3,3,-1,-6,0,-2,3,0,1,0,-1,2,1,1,-1,-1,-1,-4,2,-1,2,1,0,54,30,24,21,12,9,4,6,13,10,14,2,1,2,7,8,7,1,3,4,6,2,7,1,0,3,12,0,2,3,-2,2,6,2,1,2,2,1,6,-2,1,1
45,45021,Borox,2193,34,31,3,39,22,17,8,12,13,3,0,-1,12,6,12,2,0,-1,-4,6,1,1,0,0,13,13,7,5,0,0,8,6,6,1,0,0,5,7,1,4,0,0,50,32,18,27,17,10,3,12,14,16,6,-2,4,8,9,8,3,0,-1,4,5,8,3,-2,4,7,7,5,2,0,3,4,4,4,1,0,1,3,3,1,1,0,90,45,45,47,23,24,17,22,26,23,6,-4,7,11,12,14,3,-2,10,11,14,9,3,-2,12,13,13,8,1,0,7,6,6,4,0,0,5,7,7,4,1,0,88,43,45,42,17,25,20,13,34,12,3,2,8,8,16,8,1,0,12,5,18,4,2,2,12,11,13,3,2,0,4,5,5,2,1,0,8,6,8,1,1,0,24,24,0,41,24,17,-18,21,5,6,9,3,-11,13,11,4,6,1,-7,8,-6,2,3,2,2,15,15,7,1,1,1,7,10,5,1,0,1,8,5,2,0,1,94,51,43,39,25,14,13,20,34,14,7,-1,3,5,28,6,6,0,10,15,6,8,1,-1,3,11,15,6,4,0,2,7,10,3,3,0,1,4,5,3,1,0,134,72,62,44,24,20,12,33,55,17,12,2,3,20,33,7,7,1,9,13,22,10,5,1,4,17,7,9,6,0,1,10,5,5,3,0,3,7,2,4,3,0,201,106,95,65,36,29,27,34,88,35,11,5,9,15,50,25,5,2,18,19,38,10,6,3,13,21,17,10,3,1,3,11,15,6,1,0,10,10,2,4,2,1,128,71,57,33,19,14,14,46,28,19,19,1,11,20,14,14,10,1,3,26,14,5,9,0,10,14,1,7,3,-1,6,7,-1,5,2,0,4,7,2,2,1,-1,121,45,76,15,1,14,28,19,43,23,6,-1,13,3,16,14,0,-2,15,16,27,9,6,1,6,8,2,-2,1,0,4,2,-4,-1,0,0,2,6,6,-1,1,0,96,70,26,13,7,6,0,24,38,19,6,5,5,14,31,8,6,3,-5,10,7,11,0,2,-1,6,2,3,2,0,0,2,2,0,2,0,-1,4,0,3,0,0,96,61,35,17,6,11,15,25,33,23,-3,-2,13,13,18,15,-3,1,2,12,15,8,0,-3,0,9,8,2,-3,0,-1,1,5,1,-1,0,1,8,3,1,-2,0,-13,-8,-5,-9,-1,-8,-3,4,9,-15,-3,-4,0,5,-3,-5,0,-4,-3,-1,12,-10,-3,0,-3,0,-5,-2,0,0,0,0,-1,0,0,0,-3,0,-4,-2,0,0,31,18,13,14,12,2,-3,17,3,18,4,-8,2,4,4,8,2,-3,-5,13,-1,10,2,-5,3,6,1,4,1,-1,3,2,3,3,2,-1,0,4,-2,1,-1,0,48,14,34,22,9,13,17,5,24,-3,6,-1,1,0,12,-5,5,1,16,5,12,2,1,-2,8,3,5,3,2,0,3,0,2,1,2,0,5,3,3,2,0,0,41,17,24,22,12,10,2,5,6,4,17,4,-2,10,-9,2,11,3,4,-5,15,2,6,1,5,9,0,4,2,1,3,5,-2,4,1,1,2,4,2,0,1,0,42,38,4,27,15,12,-13,15,-2,33,3,7,-12,9,3,31,2,7,-1,6,-5,2,1,0,1,6,6,8,4,1,0,3,5,6,0,1,1,3,1,2,4,0,101,50,51,52,25,27,23,5,34,17,16,5,11,1,22,7,7,0,12,4,12,10,9,5,9,4,16,10,10,3,5,2,8,5,4,1,4,2,8,5,6,2
45,45023,Burguillos de Toledo,909,69,37,32,6,3,3,11,11,8,27,9,1,3,6,3,19,5,0,8,5,5,8,4,1,2,2,0,2,0,0,1,1,0,1,0,0,1,1,0,1,0,0,40,22,18,6,3,3,-2,7,10,6,16,2,0,3,5,2,9,2,-2,4,5,4,7,0,0,3,1,1,1,0,0,2,0,0,1,0,0,1,1,1,0,0,156,65,91,29,9,20,20,35,48,34,13,4,2,17,26,11,7,2,18,18,22,23,6,2,2,8,11,5,3,0,0,4,4,1,0,0,2,4,7,4,3,0,202,103,99,20,8,12,34,29,86,27,15,5,15,13,48,11,8,4,19,16,38,16,7,1,3,7,4,3,1,1,1,3,1,1,0,1,2,4,3,2,1,0,154,88,66,10,7,3,28,25,70,11,15,1,15,9,45,9,10,-1,13,16,25,2,5,2,1,2,5,2,0,0,1,0,4,2,0,0,0,2,1,0,0,0,247,117,130,16,7,9,39,52,86,44,20,3,18,24,45,18,9,2,21,28,41,26,11,1,4,5,5,2,0,0,2,3,1,1,0,0,2,2,4,1,0,0,171,85,86,15,4,11,21,45,78,16,5,2,7,20,41,11,1,3,14,25,37,5,4,-1,6,3,2,1,3,0,4,1,0,-2,1,0,2,2,2,3,2,0,139,67,72,39,18,21,20,20,47,22,22,5,10,8,28,12,7,1,10,12,19,10,15,4,8,14,12,1,2,0,4,8,6,0,0,0,4,6,6,1,2,0,49,30,19,-7,0,-7,4,-1,25,20,-1,3,7,-2,14,10,1,2,-3,1,11,10,-2,1,1,-8,1,-1,0,0,2,-3,-1,2,0,0,-1,-5,2,-3,0,0,100,51,49,-4,-7,3,18,13,34,21,6,2,3,9,14,14,5,0,15,4,20,7,1,2,3,-2,-10,2,1,0,2,-2,-10,1,0,0,1,0,0,1,1,0,55,24,31,-14,-9,-5,-8,-1,39,15,-3,2,-1,-1,18,2,2,1,-7,0,21,13,-5,1,-5,1,-4,-4,-2,0,-3,0,-1,-4,-1,0,-2,1,-3,0,-1,0,39,28,11,16,7,9,8,-1,5,13,5,5,8,-2,3,12,4,0,0,1,2,1,1,5,4,3,4,2,1,2,3,1,1,1,0,1,1,2,3,1,1,1,62,15,47,3,3,0,6,10,21,16,2,2,-2,4,6,5,0,1,8,6,15,11,2,1,0,0,1,2,0,0,0,1,0,2,0,0,0,-1,1,0,0,0,34,23,11,-15,-8,-7,1,0,26,14,-4,1,-2,2,22,5,0,0,3,-2,4,9,-4,1,-3,-2,-5,-3,-2,0,-2,-2,-1,-3,0,0,-1,0,-4,0,-2,0,1,-11,12,-25,-11,-14,12,-11,11,-4,-5,-5,1,-10,2,1,-1,-5,11,-1,9,-5,-4,0,-6,-7,-8,1,-4,-1,-1,-4,-5,1,-2,0,-5,-3,-3,0,-2,-1,32,30,2,8,4,4,12,-2,24,4,-1,-5,12,-2,18,3,-2,0,0,0,6,1,1,-5,4,-1,3,2,0,0,3,0,0,1,0,0,1,-1,3,1,0,0,52,29,23,-1,1,-2,17,3,16,2,5,6,10,1,6,3,5,3,7,2,10,-1,0,3,-1,0,2,0,-1,-1,0,1,0,0,0,0,-1,-1,2,0,-1,-1,-2,2,-4,5,5,0,8,-9,15,-9,-6,0,2,0,4,0,-4,0,6,-9,11,-9,-2,0,0,4,1,2,-2,0,0,3,1,1,0,0,0,1,0,1,-2,0
45,45028,Calera y Chozas,3767,-7,-2,-5,15,7,8,-15,6,3,-8,8,0,-3,2,1,-3,2,0,-12,4,2,-5,6,0,2,4,6,3,0,0,0,1,4,2,0,0,2,3,2,1,0,0,77,43,34,26,15,11,7,22,35,5,6,2,4,12,17,7,4,-1,3,10,18,-2,2,3,5,9,6,5,1,0,2,5,3,4,1,0,3,4,3,1,0,0,52,24,28,44,26,18,1,3,30,8,15,-6,-1,3,13,4,7,-3,2,0,17,4,8,-3,12,7,16,9,0,0,9,2,10,5,0,0,3,5,6,4,0,0,130,66,64,40,24,16,26,27,35,22,14,3,11,14,24,6,6,3,15,13,11,16,8,0,7,13,11,5,1,0,4,7,7,4,0,0,3,6,4,1,1,0,142,81,61,34,18,16,34,23,58,24,3,0,22,12,30,14,1,2,12,11,28,10,2,-2,7,6,11,11,-1,0,4,2,6,7,-1,0,3,4,5,4,0,0,70,40,30,29,20,9,4,20,22,2,20,-2,-4,10,16,3,14,-2,8,10,6,-1,6,0,1,6,13,5,4,0,1,5,8,3,3,0,0,1,5,2,1,0,144,88,56,33,20,13,31,26,36,18,11,21,21,12,23,8,9,14,10,14,13,10,2,7,4,10,13,5,1,0,3,4,9,3,1,0,1,6,4,2,0,0,153,88,65,53,30,23,20,40,38,24,24,4,16,21,21,14,13,0,4,19,17,10,11,4,7,24,12,5,3,1,5,13,7,2,1,1,2,11,5,3,2,0,86,45,41,12,5,7,15,11,20,16,5,20,7,5,17,7,-1,11,8,6,3,9,6,9,3,2,3,2,1,1,2,1,1,1,0,0,1,1,2,1,1,1,50,23,27,-2,-7,5,10,13,22,4,0,0,4,5,6,2,2,2,6,8,16,2,-2,-2,0,2,-8,4,0,0,-1,0,-5,0,-1,0,1,2,-3,4,1,0,99,43,56,-22,-19,-3,18,24,16,19,12,9,5,13,6,2,11,3,13,11,10,17,1,6,-5,-4,-3,-3,-8,0,-7,-4,-3,-4,-2,0,2,0,0,1,-6,0,63,23,40,1,-4,5,25,3,16,12,11,-1,9,3,5,5,3,0,16,0,11,7,8,-1,2,1,-2,0,0,0,0,1,-4,0,-1,0,2,0,2,0,1,0,-18,-8,-10,-3,-5,2,-2,3,-20,1,5,-4,-9,7,-7,-1,4,-3,7,-4,-13,2,1,-1,0,0,-1,-2,0,0,0,0,-2,-2,-1,0,0,0,1,0,1,0,15,-3,18,-7,-4,-3,15,12,-5,-1,-5,-5,4,3,-5,-3,-2,-2,11,9,0,2,-3,-3,1,0,-5,-2,-2,1,0,0,-2,-1,-2,1,1,0,-3,-1,0,0,-32,-9,-23,-29,-19,-10,-6,-9,-3,-15,2,1,0,-4,3,-9,3,-1,-6,-5,-6,-6,-1,2,-4,-2,-7,-10,-3,-3,-3,-2,-4,-6,-2,-2,-1,0,-3,-4,-1,-1,-38,-16,-22,-1,4,-5,-13,-9,-13,2,2,-4,-2,-5,-7,6,-3,-5,-11,-4,-6,-4,5,1,-2,0,0,1,0,0,-1,2,1,3,-1,0,-1,-2,-1,-2,1,0,10,7,3,-13,-8,-5,20,-7,-3,-7,7,-1,7,-4,-1,-1,4,3,13,-3,-2,-6,3,-4,2,1,-9,-6,-3,2,2,-1,-6,-3,-1,1,0,2,-3,-3,-2,1,34,8,26,-2,-1,-1,28,-4,17,-1,-7,0,12,-9,6,5,-7,3,16,5,11,-6,0,-3,4,1,0,-4,-3,0,1,2,1,-3,-2,0,3,-1,-1,-1,-1,0
45,45031,Camarena,2215,29,25,4,8,4,4,-7,3,11,6,7,12,1,4,7,4,5,7,-8,-1,4,2,2,5,0,3,3,2,0,0,0,2,1,1,0,0,0,1,2,1,0,0,89,41,48,17,12,5,18,-6,36,11,22,8,7,-4,16,6,11,5,11,-2,20,5,11,3,0,3,8,3,3,0,0,2,4,3,3,0,0,1,4,0,0,0,124,70,54,10,7,3,42,10,20,26,14,14,22,6,16,14,8,6,20,4,4,12,6,8,3,3,3,2,-1,0,3,3,1,1,-1,0,0,0,2,1,0,0,84,47,37,17,10,7,9,14,50,7,5,1,5,5,33,6,1,-1,4,9,17,1,4,2,1,2,9,4,0,1,1,2,5,2,0,0,0,0,4,2,0,1,82,52,30,26,15,11,3,17,20,26,16,0,3,6,17,15,10,1,0,11,3,11,6,-1,5,4,9,5,2,1,1,1,8,3,1,1,4,3,1,2,1,0,122,64,58,28,15,13,20,17,42,23,18,-2,8,13,18,14,12,-3,12,4,24,9,6,1,4,6,10,5,3,0,0,5,5,3,2,0,4,1,5,2,1,0,156,79,77,45,22,23,29,28,46,29,16,5,13,23,22,10,9,0,16,5,24,19,7,5,8,9,14,7,2,5,4,6,8,2,1,1,4,3,6,5,1,4,303,160,143,71,44,27,40,48,124,52,21,9,22,15,66,35,14,3,18,33,58,17,7,6,13,26,18,12,2,0,7,14,14,7,2,0,6,12,4,5,0,0,213,116,97,45,26,19,65,23,64,35,23,-1,32,11,35,21,15,0,33,12,29,14,8,-1,9,14,14,9,1,-2,2,9,10,4,1,0,7,5,4,5,0,-2,153,80,73,10,3,7,34,18,41,30,19,12,22,10,19,14,6,9,12,8,22,16,13,3,6,2,3,0,-1,0,6,0,-1,-1,-1,0,0,2,4,1,0,0,81,57,24,12,7,5,-5,21,34,11,14,5,-5,14,31,11,8,-2,0,7,3,0,6,7,6,6,-1,2,-1,0,4,3,-1,2,-1,0,2,3,0,0,0,0,56,38,18,17,10,7,-4,6,31,16,6,0,-5,2,27,14,4,-1,1,4,4,2,2,1,-1,4,6,5,1,0,-1,3,3,4,1,0,0,1,3,1,0,0,-11,-16,5,1,-7,8,33,-19,-13,-3,-6,-2,13,-14,-8,-4,-2,-1,20,-5,-5,1,-4,-1,6,-7,1,-3,3,1,2,-6,-3,1,-1,0,4,-1,4,-4,4,1,-38,-48,10,-26,-25,-1,-16,-3,-16,-12,6,5,-12,-6,-11,-17,1,1,-4,3,-5,5,5,4,0,-8,-8,-9,-4,2,0,-6,-7,-10,-4,1,0,-2,-1,1,0,1,-9,-2,-7,11,8,3,-3,-12,22,-24,6,-1,3,-7,5,-9,6,-3,-6,-5,17,-15,0,2,6,4,4,-1,-1,-1,6,2,0,0,0,0,0,2,4,-1,-1,-1,-40,-23,-17,-3,-10,7,-11,-2,-16,-10,0,-7,-7,-3,-7,-7,2,-5,-4,1,-9,-3,-2,-2,-4,6,-5,-1,0,-1,-5,1,-1,-4,-1,-1,1,5,-4,3,1,0,-6,-3,-3,-15,-9,-6,-7,-4,8,7,-5,-9,-1,0,5,-3,-5,-4,-6,-4,3,10,0,-5,-9,4,-5,-4,0,-2,-1,0,0,-5,-2,-2,-8,4,-5,1,2,0,22,28,-6,4,3,1,-4,12,6,7,-2,2,-5,6,8,14,-1,3,1,6,-2,-7,-1,-1,3,-1,1,-1,0,2,1,1,-3,0,2,2,2,-2,4,-1,-2,0
45,45034,Camuñas,1735,49,31,18,48,31,17,9,13,15,8,3,0,2,10,12,6,1,-1,7,3,3,2,2,1,8,13,19,7,0,0,3,9,12,6,0,0,5,4,7,1,0,0,29,12,17,28,16,12,3,7,3,12,-2,5,1,0,1,6,-1,4,2,7,2,6,-1,1,4,10,9,4,0,0,3,5,5,2,0,0,1,5,4,2,0,0,16,10,6,27,16,11,10,-4,0,7,3,1,10,-4,2,2,1,0,0,0,-2,5,2,1,8,4,7,7,1,0,7,1,5,3,0,0,1,3,2,4,1,0,40,13,27,29,13,16,5,22,6,4,4,-2,1,11,2,-1,1,-2,4,11,4,5,3,0,4,15,8,1,2,-1,1,7,4,0,1,0,3,8,4,1,1,-1,34,23,11,38,25,13,16,3,7,-1,4,5,12,3,3,1,2,2,4,0,4,-2,2,3,15,10,12,0,1,0,10,5,9,0,1,0,5,5,3,0,0,0,55,31,24,37,20,17,18,17,11,3,7,-3,11,6,6,2,5,0,7,11,5,1,2,-3,6,11,12,5,2,0,4,6,5,2,2,0,2,5,7,3,0,0,16,10,6,39,19,20,-4,4,15,6,-3,0,-2,-1,15,-1,1,1,-2,5,0,7,-4,-1,5,10,16,7,0,0,0,2,13,4,0,0,5,8,3,3,0,0,82,56,26,72,50,22,15,24,22,12,6,0,10,21,18,4,1,-1,5,3,4,8,5,1,12,29,19,13,0,-1,7,22,17,5,0,-1,5,7,2,8,0,0,31,23,8,28,17,11,0,7,8,2,10,1,3,2,8,2,4,2,-3,5,0,0,6,-1,2,12,9,2,1,0,1,6,7,1,0,0,1,6,2,1,1,0,-24,-27,3,-20,-19,-1,-3,-10,-21,-4,5,8,-3,-9,-18,-4,3,3,0,-1,-3,0,2,5,4,-3,-11,-10,-1,0,1,-4,-11,-5,-1,0,3,1,0,-5,0,0,1,-15,16,7,-7,14,2,0,-4,1,2,1,-6,0,-7,0,0,-1,8,0,3,1,2,2,4,5,-5,2,0,1,0,0,-5,-1,-1,0,4,5,0,3,1,1,-23,-16,-7,1,4,-3,-4,-7,-8,-5,1,-3,-1,1,-11,-4,-3,-1,-3,-8,3,-1,4,-2,-2,2,3,-4,1,0,-1,4,2,-1,-1,0,-1,-2,1,-3,2,0,-13,-5,-8,-10,-4,-6,1,2,-3,-7,0,-5,1,-2,4,-4,0,-3,0,4,-7,-3,0,-2,-2,2,-3,-7,0,0,-1,0,-1,-3,1,0,-1,2,-2,-4,-1,0,-13,-7,-6,-4,-4,0,-7,3,-6,-2,3,-3,-6,1,-1,0,1,-1,-1,2,-5,-2,2,-2,-4,1,2,0,-2,0,-4,1,2,-1,-1,0,0,0,0,1,-1,0,2,5,-3,1,2,-1,1,-2,3,-3,4,-1,0,1,5,-3,3,-1,1,-3,-2,0,1,0,0,-1,4,-3,1,0,0,0,4,-3,1,0,0,-1,0,0,0,0,-1,-4,3,-3,-1,-2,3,-2,-9,-3,9,2,3,0,-6,-3,3,-1,0,-2,-3,0,6,3,3,3,-6,-3,0,0,3,1,-2,-2,-1,0,0,2,-4,-1,1,0,-28,-12,-16,-2,-1,-1,1,-3,-7,-5,-8,-8,1,-3,-4,0,-4,-3,0,0,-3,-5,-4,-5,1,2,-4,-2,-1,1,2,-1,-3,0,0,0,-1,3,-1,-2,-1,1,-26,-12,-14,-1,1,-2,0,1,-13,-8,0,-5,-3,3,-11,-2,2,0,3,-2,-2,-6,-2,-5,1,1,-1,-3,2,0,-1,3,-2,0,1,0,2,-2,1,-3,1,0
45,45038,Carranque,1573,110,53,57,3,1,2,34,23,28,15,4,3,16,10,17,9,-1,2,18,13,11,6,5,1,0,1,2,0,0,0,0,0,1,0,0,0,0,1,1,0,0,0,80,38,42,14,6,8,12,3,40,19,3,0,8,-4,20,12,2,0,4,7,20,7,1,0,0,4,7,0,3,0,0,1,4,0,1,0,0,3,3,0,2,0,142,62,80,13,6,7,41,3,45,36,13,-3,17,4,19,18,3,-1,24,-1,26,18,10,-2,7,2,3,0,1,0,4,0,1,0,1,0,3,2,2,0,0,0,219,115,104,20,9,11,50,40,64,42,13,2,22,19,38,20,10,0,28,21,26,22,3,2,3,6,6,5,0,0,1,3,3,2,0,0,2,3,3,3,0,0,77,43,34,14,7,7,10,4,38,12,11,2,7,1,21,6,6,1,3,3,17,6,5,1,3,6,1,4,0,0,2,3,0,2,0,0,1,3,1,2,0,0,174,101,73,25,15,10,35,29,61,30,9,6,24,16,34,19,8,0,11,13,27,11,1,6,3,4,11,6,1,0,2,2,6,4,1,0,1,2,5,2,0,0,264,137,127,28,16,12,59,37,88,35,28,6,27,24,44,15,15,5,32,13,44,20,13,1,7,13,3,5,0,0,1,8,3,4,0,0,6,5,0,1,0,0,529,261,268,37,23,14,124,60,175,112,27,11,62,36,86,60,9,2,62,24,89,52,18,9,7,12,9,8,0,1,3,8,6,5,0,1,4,4,3,3,0,0,264,132,132,22,9,13,59,20,102,43,28,6,20,9,54,23,19,1,39,11,48,20,9,5,3,7,7,2,1,1,1,5,2,-1,1,0,2,2,5,3,0,1,141,71,70,-7,-7,0,44,-2,47,31,0,11,25,-6,27,15,2,4,19,4,20,16,-2,7,0,-1,-5,-2,0,0,2,-2,-5,-3,0,0,-2,1,0,1,0,0,184,89,95,28,16,12,30,25,60,35,21,10,19,9,28,16,12,2,11,16,32,19,9,8,4,10,5,5,2,1,5,5,2,2,1,0,-1,5,3,3,1,1,176,88,88,1,4,-3,41,20,66,15,7,12,18,12,32,10,2,5,23,8,34,5,5,7,0,4,3,-6,0,0,-1,5,2,-3,1,0,1,-1,1,-3,-1,0,29,3,26,-18,-13,-5,28,15,9,-16,4,-3,12,3,6,-7,-1,-7,16,12,3,-9,5,4,-1,0,-10,-8,0,1,-1,-1,-7,-4,0,0,0,1,-3,-4,0,1,86,49,37,-7,-6,-1,17,-3,39,23,5,2,10,-2,24,14,1,0,7,-1,15,9,4,2,-7,0,-2,0,2,0,-6,0,-1,-1,2,0,-1,0,-1,1,0,0,-77,-25,-52,2,-1,3,-19,-18,-21,-22,7,-8,-11,-4,-4,-13,7,-4,-8,-14,-17,-9,0,-4,-2,2,0,2,0,0,-1,0,1,-1,0,0,-1,2,-1,3,0,0,70,28,42,-3,0,-3,38,13,29,-25,16,-6,20,1,8,-10,9,-3,18,12,21,-15,7,-3,-2,0,3,-4,0,0,-1,0,1,-1,1,0,-1,0,2,-3,-1,0,42,36,6,2,-2,4,10,1,22,8,-4,5,6,9,19,3,-3,0,4,-8,3,5,-1,5,-3,4,-3,1,1,2,-4,1,-2,1,2,0,1,3,-1,0,-1,2,59,38,21,10,9,1,29,-12,24,21,-3,-2,15,-6,14,13,0,-2,14,-6,10,8,-3,0,3,2,3,1,1,-1,2,3,1,1,0,1,1,-1,2,0,1,-2
45,45041,Casarrubios del Monte,2765,277,171,106,56,34,22,55,35,95,58,22,9,39,25,52,34,13,4,16,10,43,24,9,5,10,12,23,9,0,1,4,7,16,5,0,1,6,5,7,4,0,0,148,80,68,48,28,20,23,24,25,44,19,10,16,13,18,21,10,2,7,11,7,23,9,8,9,20,7,8,2,2,6,11,5,4,1,1,3,9,2,4,1,1,297,156,141,52,21,31,60,39,78,66,42,5,28,22,44,30,26,0,32,17,34,36,16,5,14,10,9,10,8,1,5,5,3,3,5,0,9,5,6,7,3,1,186,94,92,52,28,24,40,26,54,39,21,-4,17,12,30,22,12,-3,23,14,24,17,9,-1,12,15,12,7,3,1,7,7,5,5,3,1,5,8,7,2,0,0,-221,-116,-105,5,4,1,-35,-40,-63,-36,-33,-17,-18,-20,-38,-21,-12,-9,-17,-20,-25,-15,-21,-8,3,0,2,0,0,0,3,0,1,0,0,0,0,0,1,0,0,0,17,18,-1,54,35,19,16,2,16,-11,6,-10,11,1,10,5,-1,-5,5,1,6,-16,7,-5,5,15,21,7,4,1,2,8,15,6,2,1,3,7,6,1,2,0,221,124,97,61,28,33,36,28,85,22,26,18,29,15,46,7,12,11,7,13,39,15,14,7,14,20,18,6,2,0,5,13,8,1,0,0,9,7,10,5,2,0,205,97,108,64,34,30,31,44,94,36,11,-19,10,18,56,17,8,-14,21,26,38,19,3,-5,7,14,25,10,6,1,5,4,14,7,2,1,2,10,11,3,4,0,321,160,161,82,44,38,51,24,191,49,13,-11,34,-1,112,19,1,-7,17,25,79,30,12,-4,18,16,30,13,3,1,12,5,20,4,1,1,6,11,10,9,2,0,103,37,66,50,24,26,17,29,26,25,12,-12,-1,4,7,14,14,-5,18,25,19,11,-2,-7,10,9,16,10,4,0,6,4,9,3,2,0,4,5,7,7,2,0,33,29,4,45,22,23,1,19,15,6,-8,-1,6,8,12,5,-3,-1,-5,11,3,1,-5,0,8,14,14,7,1,1,3,6,8,3,1,1,5,8,6,4,0,0,-7,8,-15,38,17,21,-22,6,8,20,-10,-12,-15,17,16,5,-8,-7,-7,-11,-8,15,-2,-5,6,9,11,7,0,2,4,6,5,2,0,0,2,3,6,5,0,2,-20,21,-41,32,17,15,-14,5,14,12,-3,-30,2,0,2,24,5,-12,-16,5,12,-12,-8,-18,6,9,13,2,2,0,4,4,6,2,1,0,2,5,7,0,1,0,-127,-61,-66,12,8,4,-15,-24,-30,-45,-2,-14,-7,-16,-9,-25,0,-7,-8,-8,-21,-20,-2,-7,1,2,9,2,-1,-1,0,2,4,0,3,-1,1,0,5,2,-4,0,-4,-24,20,31,13,18,17,12,-1,-34,6,-5,3,5,-15,-18,0,-1,14,7,14,-16,6,-4,4,6,7,6,6,2,2,1,5,2,1,2,2,5,2,4,5,0,-15,-10,-5,42,18,24,11,1,-12,-25,12,-7,5,-5,5,-25,8,1,6,6,-17,0,4,-8,7,11,12,6,1,4,3,4,7,1,0,3,4,7,5,5,1,1,10,15,-5,35,19,16,14,-4,-2,-16,22,0,12,3,4,-15,10,0,2,-7,-6,-1,12,0,15,4,8,7,0,1,8,1,5,5,0,0,7,3,3,2,0,1,129,65,64,77,40,37,38,8,37,44,10,-17,23,3,24,14,2,-6,15,5,13,30,8,-11,17,12,25,17,4,1,9,8,15,7,2,-1,8,4,10,10,2,2
45,45046,Cebolla,2789,63,51,12,76,68,8,-4,24,18,19,4,2,-6,20,16,20,1,1,2,4,2,-1,3,1,0,28,24,23,1,0,0,23,23,21,1,0,0,5,1,2,0,0,57,38,19,42,32,10,15,17,14,4,9,0,10,10,9,3,5,1,5,7,5,1,4,-1,5,16,15,5,1,0,4,11,11,5,1,0,1,5,4,0,0,0,123,59,64,113,61,52,25,39,26,18,12,3,13,20,13,8,4,1,12,19,13,10,8,2,13,47,34,18,1,0,5,27,19,10,0,0,8,20,15,8,1,0,89,44,45,77,42,35,22,26,34,3,6,-2,7,14,19,3,1,0,15,12,15,0,5,-2,13,28,26,8,2,0,7,15,16,4,0,0,6,13,10,4,2,0,109,58,51,79,45,34,7,39,21,17,13,8,8,14,10,14,8,2,-1,25,11,3,5,6,4,38,21,12,2,1,3,19,13,9,0,1,1,19,8,3,2,0,66,39,27,83,46,37,6,18,23,18,0,1,6,9,13,8,2,0,0,9,10,10,-2,1,9,25,33,15,1,0,5,10,22,8,1,0,4,15,11,7,0,0,97,52,45,105,56,49,11,18,46,12,9,-1,2,4,30,9,5,1,9,14,16,3,4,-2,11,27,46,19,1,0,4,11,28,11,1,0,7,16,18,8,0,0,188,109,79,173,108,65,25,60,52,36,11,0,15,34,27,24,7,0,10,26,25,12,4,0,20,60,54,36,3,0,6,37,36,26,3,0,14,23,18,10,0,0,23,8,15,32,17,15,13,6,14,-20,5,5,7,3,4,-11,2,4,6,3,10,-9,3,1,7,11,8,6,0,0,4,5,4,4,0,0,3,6,4,2,0,0,57,38,19,27,16,11,13,12,23,12,2,-7,8,6,15,7,3,-3,5,6,8,5,-1,-4,5,8,9,2,2,0,3,3,6,2,2,0,2,5,3,0,0,0,-4,-7,3,23,12,11,-6,0,10,-9,0,0,-4,-4,6,-5,2,-1,-2,4,4,-4,-2,1,4,5,10,3,0,0,3,1,7,1,0,0,1,4,3,2,0,0,32,13,19,32,15,17,10,7,3,9,2,1,1,4,1,3,3,1,9,3,2,6,-1,0,2,13,9,6,1,1,0,6,6,2,1,0,2,7,3,4,0,1,-46,-35,-11,-9,-9,0,-14,-1,-31,-5,1,3,-9,-1,-24,-3,1,2,-5,0,-7,-2,0,1,1,1,-9,-2,0,0,1,-1,-6,-3,0,0,0,2,-3,1,0,0,-64,-42,-22,-60,-38,-22,5,1,-37,-24,-7,-5,3,0,-21,-22,-1,-2,2,1,-16,-2,-6,-3,-3,-3,-31,-20,-1,-2,-1,-3,-17,-17,1,-1,-2,0,-14,-3,-2,-1,-60,-33,-27,-23,-14,-9,-7,1,-36,-12,-3,-4,-7,5,-26,-3,-1,-1,0,-4,-10,-9,-2,-3,0,5,-20,-5,-2,-2,-1,5,-12,-4,-1,-1,1,0,-8,-1,-1,-1,-35,-31,-4,-17,-14,-3,-4,-1,-17,-15,3,-1,0,-2,-13,-14,0,0,-4,1,-4,-1,3,-1,-7,0,-3,-7,1,-1,-4,0,-4,-6,0,0,-3,0,1,-1,1,-1,-45,-18,-27,-5,0,-5,-10,-6,-11,-14,-7,2,-2,-2,-7,-5,-5,3,-8,-4,-4,-9,-2,-1,-2,1,-4,1,-1,0,0,1,-1,0,-1,1,-2,0,-3,1,0,-1,-100,-59,-41,-50,-37,-13,-11,-9,-29,-33,-10,-9,-5,-4,-13,-26,-10,-2,-6,-5,-16,-7,0,-7,-2,-2,-14,-22,-7,-3,0,-1,-7,-23,-5,-1,-2,-1,-7,1,-2,-2
45,45047,Cedillo del Condado,1507,73,42,31,5,4,1,29,8,19,6,5,4,18,6,9,2,4,2,11,2,10,4,1,2,0,1,4,0,0,0,0,1,3,0,0,0,0,0,1,0,0,0,84,48,36,16,6,10,8,18,42,10,0,5,4,8,26,7,1,1,4,10,16,3,-1,4,5,3,7,1,0,0,0,3,2,1,0,0,5,0,5,0,0,0,105,46,59,21,9,12,15,21,18,28,15,5,-2,11,15,13,8,1,17,10,3,15,7,4,4,7,6,1,2,1,1,4,3,0,1,0,3,3,3,1,1,1,139,70,69,24,14,10,35,13,49,29,10,1,22,0,24,15,7,2,13,13,25,14,3,-1,10,2,7,3,1,0,6,0,4,2,1,0,4,2,3,1,0,0,129,69,60,32,21,11,19,23,44,18,16,8,7,17,23,7,10,4,12,6,21,11,6,4,8,9,14,2,0,0,4,6,9,2,0,0,4,3,5,0,0,0,105,62,43,17,10,7,21,23,35,20,5,1,12,13,25,8,4,1,9,10,10,12,1,0,1,5,7,4,0,0,1,2,6,1,0,0,0,3,1,3,0,0,103,58,45,22,12,10,34,7,42,9,11,2,18,5,25,6,5,2,16,2,17,3,6,0,4,6,6,2,4,0,2,4,3,1,2,0,2,2,3,1,2,0,134,74,60,59,33,26,22,34,42,25,-1,7,6,24,23,14,-2,4,16,10,19,11,1,3,21,15,13,10,1,-1,9,10,9,5,0,0,12,5,4,5,1,-1,273,146,127,49,25,24,51,49,103,39,18,9,25,21,59,23,11,1,26,28,44,16,7,8,4,20,15,7,3,0,0,10,10,3,2,0,4,10,5,4,1,0,225,125,100,23,10,13,23,48,102,26,16,7,-1,25,60,22,13,4,24,23,42,4,3,3,9,3,8,5,0,-2,2,1,6,2,0,-1,7,2,2,3,0,-1,92,69,23,16,9,7,-17,45,44,20,-1,3,-5,20,37,17,0,1,-12,25,7,3,-1,2,4,5,6,1,0,0,3,1,5,0,0,0,1,4,1,1,0,0,130,66,64,20,11,9,36,17,52,11,2,8,23,2,27,6,2,3,13,15,25,5,0,5,5,7,4,3,1,0,3,2,4,2,0,0,2,5,0,1,1,0,237,111,126,20,10,10,56,47,63,33,21,9,24,23,35,12,11,5,32,24,28,21,10,4,4,8,6,-2,2,1,1,2,5,-1,2,1,3,6,1,-1,0,0,73,41,32,20,3,17,18,11,-8,35,12,6,-2,13,-6,24,9,2,20,-2,-2,11,3,4,8,2,6,2,2,0,1,0,1,1,0,0,7,2,5,1,2,0,-70,-50,-20,14,4,10,-49,3,-13,-18,5,0,-27,4,-8,-18,1,-3,-22,-1,-5,0,4,3,1,4,0,4,4,1,2,3,-3,0,2,0,-1,1,3,4,2,1,43,3,40,-5,-6,1,7,-5,43,-1,-3,-1,-2,2,24,-13,-2,1,9,-7,19,12,-1,-2,-1,-1,2,0,-7,-1,-1,1,2,-2,-5,-1,0,-2,0,2,-2,0,35,19,16,28,11,17,11,-3,-3,5,21,5,5,6,0,-4,9,4,6,-9,-3,9,12,1,5,5,5,4,6,2,1,4,2,-1,4,0,4,1,3,5,2,2,-30,-8,-22,14,2,12,-20,2,-6,-5,8,-5,-6,-1,-7,4,7,-2,-14,3,1,-9,1,-3,4,3,3,3,-1,1,1,2,0,0,-1,0,3,1,3,3,0,1
45,45052,Cobisa,1393,184,96,88,8,3,5,22,29,83,37,8,4,11,16,46,19,6,-1,11,13,37,18,2,5,2,2,2,2,0,0,1,1,0,1,0,0,1,1,2,1,0,0,222,113,109,10,4,6,21,29,92,40,34,4,6,13,55,18,18,2,15,16,37,22,16,2,2,1,5,1,1,0,0,0,4,0,0,0,2,1,1,1,1,0,216,113,103,8,3,5,20,24,114,22,21,10,13,10,57,16,9,4,7,14,57,6,12,6,3,2,3,0,0,0,1,2,0,0,0,0,2,0,3,0,0,0,153,69,84,9,3,6,28,12,69,27,10,3,6,6,35,13,5,2,22,6,34,14,5,1,2,2,2,1,1,0,1,2,0,0,0,0,1,0,2,1,1,0,156,89,67,5,1,4,30,7,65,33,8,9,11,7,40,20,6,4,19,0,25,13,2,5,3,2,1,0,0,0,2,-1,2,-1,0,0,1,3,-1,1,0,0,217,105,112,6,1,5,47,17,77,37,23,8,31,12,33,19,8,1,16,5,44,18,15,7,-2,4,3,0,0,1,-1,2,0,0,0,0,-1,2,3,0,0,1,152,90,62,14,9,5,44,6,32,41,14,10,33,4,15,20,10,4,11,2,17,21,4,6,1,6,5,2,0,0,2,4,3,0,0,0,-1,2,2,2,0,0,138,70,68,8,2,6,37,0,79,9,6,8,18,-2,41,3,6,5,19,2,38,6,0,3,4,1,2,1,0,0,1,-1,2,0,0,0,3,2,0,1,0,0,68,39,29,9,6,3,12,0,20,21,5,7,7,4,12,11,3,2,5,-4,8,10,2,5,4,2,1,2,0,0,2,1,1,2,0,0,2,1,0,0,0,0,109,47,62,9,3,6,30,27,26,9,12,1,12,10,10,6,8,-2,18,17,16,3,4,3,1,1,0,6,0,1,0,-1,0,3,0,1,1,2,0,3,0,0,51,5,46,-1,0,-1,11,4,5,15,9,7,3,-3,5,-5,3,3,8,7,0,20,6,4,2,3,-3,-2,-1,0,3,0,-2,-1,0,0,-1,3,-1,-1,-1,0,35,11,24,9,3,6,12,3,13,5,0,2,10,-2,2,4,-3,0,2,5,11,1,3,2,1,3,2,2,1,0,1,1,1,0,0,0,0,2,1,2,1,0,8,4,4,-3,-1,-2,2,0,7,1,3,-6,7,1,2,-1,-1,-2,-5,-1,5,2,4,-4,-2,0,2,-2,-1,0,-1,0,1,-1,0,0,-1,0,1,-1,-1,0,-19,-20,1,-2,-1,-1,-11,-4,5,-12,1,0,-10,0,-3,-10,2,1,-1,-4,8,-2,-1,-1,0,0,-1,0,-1,0,0,0,-1,0,0,0,0,0,0,0,-1,0,14,-2,16,10,4,6,14,-2,-5,5,11,-8,5,-2,-5,-2,7,-4,9,0,0,7,4,-4,1,3,1,1,3,0,1,-1,0,1,3,0,0,4,1,0,0,0,7,-2,9,6,3,3,8,0,-4,3,-2,3,4,2,-3,0,-6,1,4,-2,-1,3,4,2,4,0,1,1,-1,1,2,0,1,1,-2,1,2,0,0,0,1,0,22,6,16,-7,-7,0,12,4,-7,14,-7,4,3,4,-6,5,-3,1,9,0,-1,9,-4,3,-1,3,-3,-5,-1,0,-2,1,-3,-3,0,0,1,2,0,-2,-1,0,46,42,4,5,1,4,26,-10,0,10,14,7,17,2,1,11,10,2,9,-12,-1,-1,4,5,3,0,0,1,1,0,1,0,-1,0,1,0,2,0,1,1,0,0
45,45053,Consuegra,10081,-47,-26,-21,11,8,3,-12,-9,-17,-5,0,-4,-8,-7,-9,-3,0,1,-4,-2,-8,-2,0,-5,2,4,5,0,0,0,1,3,4,0,0,0,1,1,1,0,0,0,79,55,24,68,44,24,14,11,34,7,8,5,3,15,21,4,5,7,11,-4,13,3,3,-2,14,24,21,8,1,0,7,19,13,4,1,0,7,5,8,4,0,0,79,50,29,100,63,37,20,8,40,14,7,-11,12,6,24,7,4,-4,8,2,16,7,3,-7,13,30,40,14,3,0,11,20,24,7,1,0,2,10,16,7,2,0,90,56,34,104,59,45,18,25,33,10,-2,5,21,10,15,9,-3,3,-3,15,18,1,1,2,25,33,34,10,2,0,17,17,18,7,0,0,8,16,16,3,2,0,117,93,24,136,98,38,28,40,51,12,-5,-9,19,27,40,15,-5,-2,9,13,11,-3,0,-7,19,45,52,20,-1,1,12,33,35,18,0,0,7,12,17,2,-1,1,82,49,33,124,59,65,15,20,19,22,1,2,6,9,14,11,5,2,9,11,5,11,-4,0,27,33,42,17,3,0,9,15,24,9,1,0,18,18,18,8,2,0,86,61,25,115,68,47,30,13,16,27,1,-5,19,10,14,22,-3,-2,11,3,2,5,4,-3,30,35,28,18,2,0,17,22,16,11,1,0,13,13,12,7,1,0,206,111,95,179,111,68,44,53,68,16,19,8,22,32,37,14,8,1,22,21,31,2,11,7,27,59,51,32,9,1,14,36,32,22,6,1,13,23,19,10,3,0,68,46,22,97,57,40,0,27,14,23,-2,6,-7,12,23,12,1,4,7,15,-9,11,-3,2,11,38,26,20,3,-1,3,24,18,11,2,-1,8,14,8,9,1,0,12,19,-7,48,23,25,15,1,-19,6,12,-6,9,12,-9,-1,9,-2,6,-11,-10,7,3,-4,15,20,5,6,1,0,6,13,3,1,0,0,9,7,2,5,1,0,49,43,6,81,52,29,-1,3,11,15,17,4,1,5,9,17,8,3,-2,-2,2,-2,9,1,3,30,26,14,8,0,2,15,20,9,6,0,1,15,6,5,2,0,-53,-43,-10,14,1,13,-8,1,-34,-6,2,-7,-3,-7,-23,-4,3,-7,-5,8,-11,-2,-1,0,11,-1,2,2,0,0,3,-4,-1,3,0,0,8,3,3,-1,0,0,-37,1,-38,20,18,2,-9,-2,8,-22,0,-13,-6,3,17,-5,-2,-7,-3,-5,-9,-17,2,-6,-2,9,8,5,1,0,-3,7,9,5,0,0,1,2,-1,0,1,0,-65,-42,-23,-7,-9,2,8,-15,-34,-12,-2,-6,-2,-15,-8,-13,-1,-2,10,0,-26,1,-1,-4,-2,2,1,-7,-1,0,-5,-2,3,-5,0,0,3,4,-2,-2,-1,0,-10,0,-10,24,21,3,-5,-5,12,-2,3,-15,0,-3,7,-2,4,-6,-5,-2,5,0,-1,-9,-5,10,11,6,2,0,-3,8,9,4,3,0,-2,2,2,2,-1,0,-41,-11,-30,9,5,4,8,-13,-6,-23,-7,2,7,-9,3,-12,0,-1,1,-4,-9,-11,-7,3,5,8,6,-8,-2,-1,3,4,5,-8,0,0,2,4,1,0,-2,-1,-110,-54,-56,-9,-4,-5,-29,-21,-35,-10,-8,-9,-13,-9,-18,-8,-6,-3,-16,-12,-17,-2,-2,-6,-9,5,-2,-1,-2,0,-6,2,1,-1,0,0,-3,3,-3,0,-2,0,15,15,0,44,24,20,13,2,-6,6,4,-2,8,5,-3,6,1,0,5,-3,-3,0,3,-2,16,13,1,9,5,0,11,9,-1,4,1,0,5,4,2,5,4,0
45,45066,Fuensalida,7661,4,12,-8,43,23,20,-40,12,20,-6,5,13,-10,3,12,-1,0,8,-30,9,8,-5,5,5,9,6,14,7,5,2,6,4,8,4,1,0,3,2,6,3,4,2,185,88,97,90,44,46,37,39,48,33,11,11,22,18,23,13,2,7,15,21,25,20,9,4,20,21,24,17,4,0,12,13,10,5,2,0,8,8,14,12,2,0,220,111,109,96,51,45,73,48,61,24,7,3,32,32,30,12,2,1,41,16,31,12,5,2,25,23,25,16,5,0,12,12,14,9,2,0,13,11,11,7,3,0,272,134,138,94,47,47,73,62,85,26,9,10,27,26,54,16,6,3,46,36,31,10,3,7,27,22,30,9,5,0,14,10,17,4,2,0,13,12,13,5,3,0,323,179,144,79,46,33,52,67,131,45,12,9,30,25,79,32,3,5,22,42,52,13,9,4,13,18,26,13,6,1,8,9,14,10,3,0,5,9,12,3,3,1,222,126,96,90,58,32,59,54,67,21,16,1,34,32,43,9,7,-3,25,22,24,12,9,4,19,33,27,6,4,0,13,19,21,4,1,0,6,14,6,2,3,0,557,295,262,178,98,80,131,119,157,94,24,6,60,59,85,61,15,2,71,60,72,33,9,4,22,56,47,35,12,3,11,28,27,23,7,1,11,28,20,12,5,2,614,339,275,228,147,81,113,152,188,102,37,17,55,86,114,56,20,6,58,66,74,46,17,11,37,88,60,36,5,2,24,50,42,27,4,0,13,38,18,9,1,2,263,145,118,139,82,57,28,57,68,76,12,19,22,33,33,52,-2,7,6,24,35,24,14,12,23,46,51,21,-1,-2,14,31,32,7,-4,1,9,15,19,14,3,-3,41,30,11,11,-5,16,38,-13,18,-9,2,7,40,-11,8,-14,4,2,-2,-2,10,5,-2,5,12,3,-9,0,2,2,10,-5,-10,-5,2,2,2,8,1,5,0,0,36,1,35,5,2,3,1,20,-8,-4,11,5,-6,1,-4,-4,3,4,7,19,-4,0,8,1,6,14,-6,-10,2,-4,6,5,-5,-9,4,-1,0,9,-1,-1,-2,-3,59,17,42,-2,-10,8,15,15,18,3,6,-4,5,4,3,1,5,0,10,11,15,2,1,-4,-3,2,-5,-1,3,0,-1,0,-9,-1,1,0,-2,2,4,0,2,0,-123,-88,-35,-75,-61,-14,-38,-10,-38,-31,-12,-4,-28,-8,-20,-28,-1,-4,-10,-2,-18,-3,-11,0,-12,0,-22,-29,-11,-3,-8,-4,-21,-22,-6,-1,-4,4,-1,-7,-5,-2,-189,-107,-82,-61,-50,-11,-52,-13,-44,-52,-20,-3,-30,-8,-18,-28,-15,-5,-22,-5,-26,-24,-5,2,-8,1,-26,-14,-14,-1,-5,-3,-22,-12,-9,0,-3,4,-4,-2,-5,-1,-132,-79,-53,-68,-49,-19,-40,-17,-18,-68,-3,2,-23,-10,-12,-37,-1,-1,-17,-7,-6,-31,-2,3,-18,-5,-15,-22,-11,2,-9,-4,-12,-16,-7,-2,-9,-1,-3,-6,-4,4,-67,-72,5,-57,-48,-9,-4,-18,7,-58,0,7,-22,-14,9,-38,-10,0,18,-4,-2,-20,10,7,-10,-8,-4,-33,-6,2,-13,-8,-5,-18,-5,0,3,0,1,-15,-1,2,17,1,16,-2,-15,13,20,-7,-18,19,4,-1,10,-12,-4,6,3,0,10,5,-14,13,1,-1,2,0,-3,-6,-1,4,-2,-3,-4,-8,-2,2,4,3,1,2,1,2,41,28,13,28,14,14,-9,25,1,5,11,8,4,19,-8,4,8,-1,-13,6,9,1,3,9,1,10,8,5,-2,5,5,4,6,-1,-3,1,-4,6,2,6,1,4
45,45067,Gálvez,3069,40,25,15,41,25,16,3,11,18,8,2,-3,1,8,13,3,1,-1,2,3,5,5,1,-2,7,11,16,5,2,0,3,6,13,2,1,0,4,5,3,3,1,0,25,16,9,52,26,26,4,6,18,-4,5,-4,3,2,9,-1,3,0,1,4,9,-3,2,-4,10,8,28,6,0,0,3,6,15,2,0,0,7,2,13,4,0,0,76,40,36,92,46,46,7,20,24,14,-1,8,6,9,14,4,2,4,1,11,10,10,-3,4,11,28,35,14,1,1,5,12,21,7,1,0,6,16,14,7,0,1,82,52,30,68,44,24,10,22,31,6,12,1,2,14,21,6,7,1,8,8,10,0,5,0,8,21,30,6,1,1,5,13,20,3,1,1,3,8,10,3,0,0,48,30,18,65,37,28,1,16,21,4,1,6,1,7,19,0,0,3,0,9,2,4,1,3,5,20,34,3,2,0,1,11,23,0,1,0,4,9,11,3,1,0,51,33,18,81,48,33,21,7,11,5,9,-5,10,9,8,4,4,-4,11,-2,3,1,5,-1,19,21,24,11,4,1,8,15,15,7,2,0,11,6,9,4,2,1,57,44,13,88,47,41,23,14,16,7,4,-7,13,10,12,7,4,-2,10,4,4,0,0,-5,20,17,34,13,3,1,8,10,21,5,2,1,12,7,13,8,1,0,99,72,27,101,74,27,0,29,51,5,7,5,5,20,33,10,4,0,-5,9,18,-5,3,5,12,29,37,19,5,-1,9,20,28,15,3,-1,3,9,9,4,2,0,29,15,14,37,22,15,19,4,6,3,-2,-5,13,3,0,-3,-1,-1,6,1,6,6,-1,-4,9,13,18,-4,-1,0,5,9,13,-6,-1,0,4,4,5,2,0,0,-44,-15,-29,-5,2,-7,-4,-3,-29,-3,-2,0,-1,0,-7,-3,-2,0,-3,-3,-22,0,0,0,1,1,-7,2,-1,-1,2,3,-2,0,0,-1,-1,-2,-5,2,-1,0,-5,-6,1,26,12,14,3,-7,-11,3,2,3,3,-5,-5,3,-4,1,0,-2,-6,0,6,2,5,6,8,7,0,0,2,2,4,5,-1,0,3,4,4,2,1,0,-70,-37,-33,-16,-12,-4,-9,-6,-41,-17,7,-4,5,-2,-25,-19,4,-1,-14,-4,-16,2,3,-3,-4,3,-6,-8,-1,0,-1,3,-5,-9,0,0,-3,0,-1,1,-1,0,-96,-59,-37,-29,-21,-8,-13,-17,-27,-27,-6,-4,-9,-9,-24,-13,-4,1,-4,-8,-3,-14,-2,-5,-2,-5,-5,-12,-3,-2,0,-4,-7,-8,-2,0,-2,-1,2,-4,-1,-2,-58,-29,-29,-37,-25,-12,-15,-7,-13,-17,-1,-6,-8,-3,-7,-9,-1,-1,-7,-4,-6,-8,0,-5,-3,-5,-8,-18,-2,-1,-2,-3,-6,-12,-2,0,-1,-2,-2,-6,0,-1,15,9,6,15,9,6,4,6,13,-1,1,-6,3,1,12,-5,-1,-1,1,5,1,4,2,-5,3,3,7,1,0,1,2,2,4,0,0,1,1,1,3,1,0,0,-42,-32,-10,4,-4,8,6,-9,-5,-21,-17,5,0,-8,-5,-14,-6,2,6,-1,0,-7,-11,3,5,3,3,-7,-1,1,1,2,0,-6,-1,0,4,1,3,-1,0,1,-49,-28,-21,-2,-3,1,-13,-9,-13,-10,-3,-1,-5,-2,-11,-7,-4,1,-8,-7,-2,-3,1,-2,1,3,-2,-5,1,0,1,2,-3,-4,1,0,0,1,1,-1,0,0,-50,-27,-23,-19,-14,-5,-7,-4,-23,-16,1,0,-2,0,-13,-14,1,1,-5,-4,-10,-2,0,-1,-2,3,-7,-10,-1,-2,-1,0,-3,-9,0,-1,-1,3,-4,-1,-1,-1
45,45070,Guadamur,1593,8,-1,9,6,3,3,1,5,-1,1,0,2,-2,2,-2,1,0,1,3,3,1,0,0,1,0,2,2,2,0,0,0,1,2,0,0,0,0,1,0,2,0,0,11,2,9,11,4,7,-5,4,8,-3,5,2,-2,1,3,-3,2,1,-3,3,5,0,3,1,4,1,6,0,0,0,2,1,1,0,0,0,2,0,5,0,0,0,43,26,17,21,13,8,7,4,13,11,3,2,3,4,10,6,1,1,4,0,3,5,2,1,6,4,6,2,2,1,2,4,4,1,1,1,4,0,2,1,1,0,18,7,11,11,4,7,-6,6,9,-1,4,4,-3,4,4,0,0,1,-3,2,5,-1,4,3,3,2,5,0,0,0,1,0,2,0,0,0,2,2,3,0,0,0,28,19,9,14,7,7,4,2,5,9,5,2,3,2,4,5,3,2,1,0,1,4,2,0,2,4,5,2,0,0,1,3,2,1,0,0,1,1,3,1,0,0,35,23,12,29,17,12,15,11,-1,12,2,-2,6,7,-2,10,2,0,9,4,1,2,0,-2,6,10,6,5,2,0,3,6,3,4,1,0,3,4,3,1,1,0,23,8,15,17,8,9,1,3,16,2,0,1,2,0,8,0,-2,0,-1,3,8,2,2,1,5,1,12,0,-1,0,2,1,7,-1,-1,0,3,0,5,1,0,0,37,15,22,24,16,8,19,7,2,4,3,0,9,3,0,0,1,1,10,4,2,4,2,-1,11,11,0,0,1,1,7,7,0,0,1,1,4,4,0,0,0,0,11,2,9,2,-1,3,6,-4,3,0,2,0,3,0,-5,1,3,-2,3,-4,8,-1,-1,2,0,1,0,1,0,0,-1,1,-1,0,0,0,1,0,1,1,0,0,22,14,8,2,1,1,-1,9,12,6,0,-4,1,4,9,5,-2,-4,-2,5,3,1,2,0,0,0,2,1,-2,0,1,0,0,0,-1,0,-1,0,2,1,-1,0,12,16,-4,6,4,2,11,-5,2,0,3,3,12,-2,2,2,2,1,-1,-3,0,-2,1,2,1,2,3,0,0,0,1,1,2,0,0,0,0,1,1,0,0,0,9,1,8,12,5,7,-7,0,8,4,-1,4,-3,0,3,-2,0,3,-4,0,5,6,-1,1,2,1,3,5,0,1,1,-1,1,4,0,0,1,2,2,1,0,1,23,6,17,-3,-4,1,9,-5,5,2,2,10,3,-3,0,1,1,4,6,-2,5,1,1,6,1,0,-1,-2,-1,0,0,-1,-1,-1,-1,0,1,1,0,-1,0,0,-8,-3,-5,-3,0,-3,1,-4,-13,7,-3,4,-1,-1,-3,1,-1,3,2,-3,-10,6,-2,1,2,1,-4,1,-1,-2,1,2,-2,0,-1,0,1,-1,-2,1,0,-2,12,-5,17,3,3,0,6,1,3,-1,2,1,1,-4,0,-2,0,0,5,5,3,1,2,1,0,1,1,-1,1,1,1,0,1,-1,1,1,-1,1,0,0,0,0,-17,-5,-12,8,6,2,-7,1,-7,-6,1,3,-4,2,-4,0,0,3,-3,-1,-3,-6,1,0,2,0,3,2,1,0,1,0,3,2,0,0,1,0,0,0,1,0,-9,0,-9,9,6,3,-2,-1,-7,-3,5,-2,0,1,-3,0,4,-3,-2,-2,-4,-3,1,1,3,1,3,1,1,0,2,1,1,1,1,0,1,0,2,0,0,0,-24,-17,-7,-6,-5,-1,-8,-4,-11,-3,0,0,-3,-3,-6,-3,-1,-2,-5,-1,-5,0,1,2,0,-2,-3,-3,1,0,0,-2,0,-4,1,0,0,0,-3,1,0,0
45,45071,"Guardia, La",2417,-2,3,-5,2,1,1,-4,-2,9,-9,2,2,-1,2,5,-3,1,-1,-3,-4,4,-6,1,3,0,0,2,0,0,0,0,0,1,0,0,0,0,0,1,0,0,0,8,5,3,10,6,4,-3,3,1,3,3,1,-3,-1,4,2,2,1,0,4,-3,1,1,0,1,3,6,0,0,0,0,1,5,0,0,0,1,2,1,0,0,0,-7,-1,-6,9,5,4,0,0,-1,3,1,-8,-3,5,2,-2,1,-2,3,-5,-3,5,0,-6,1,3,3,2,0,0,0,2,2,1,0,0,1,1,1,1,0,0,16,6,10,19,9,10,1,12,-8,5,7,-2,1,8,-6,-1,4,-1,0,4,-2,6,3,-1,3,9,5,2,0,0,1,5,2,1,0,0,2,4,3,1,0,0,47,26,21,35,17,18,4,9,16,5,10,1,2,2,12,1,6,2,2,7,4,4,4,-1,7,13,12,2,1,0,3,7,7,0,0,0,4,6,5,2,1,0,38,21,17,22,7,15,7,15,7,8,4,-3,2,10,6,0,2,1,5,5,1,8,2,-4,4,5,9,3,1,0,1,2,3,1,0,0,3,3,6,2,1,0,29,8,21,37,16,21,1,10,0,15,1,5,-1,0,5,5,-2,2,2,10,-5,10,3,3,8,10,11,6,2,0,2,3,10,1,0,0,6,7,1,5,2,0,85,51,34,50,33,17,13,18,34,8,6,6,5,10,19,10,4,4,8,8,15,-2,2,2,7,18,18,6,-1,0,5,10,11,6,0,0,2,8,7,0,-1,0,56,35,21,22,12,10,14,8,7,24,6,-3,11,5,1,16,5,-1,3,3,6,8,1,-2,1,8,7,7,-1,0,1,1,4,5,1,0,0,7,3,2,-2,0,-53,-29,-24,25,10,15,-6,-6,-13,-19,-10,3,-2,-5,-12,-6,-4,1,-4,-1,-1,-13,-6,2,6,7,8,3,1,0,4,3,2,1,0,0,2,4,6,2,1,0,-34,-17,-17,8,4,4,-1,-5,-12,-1,-3,-8,-1,-6,-5,2,-2,-3,0,1,-7,-3,-1,-5,1,4,3,0,0,0,1,1,1,1,0,0,0,3,2,-1,0,0,-56,-26,-30,3,-1,4,-8,-3,-25,-20,3,-3,-1,1,-14,-14,3,-1,-7,-4,-11,-6,0,-2,2,1,1,-2,0,1,0,0,-1,-1,1,0,2,1,2,-1,-1,1,-37,-8,-29,-1,0,-1,-12,-6,-9,-10,5,-4,-6,-2,0,-5,5,1,-6,-4,-9,-5,0,-5,1,2,-3,-2,1,0,1,2,-2,-1,0,0,0,0,-1,-1,1,0,-11,-10,-1,-5,-2,-3,-7,0,-2,-2,4,-4,0,-2,-6,0,1,-3,-7,2,4,-2,3,-1,-2,0,0,0,-2,-1,-1,0,0,0,-1,0,-1,0,0,0,-1,-1,-58,-40,-18,-47,-34,-13,-11,0,-24,-23,-4,4,-9,-1,-14,-14,-4,2,-2,1,-10,-9,0,2,-4,-3,-15,-18,-5,-2,-3,-3,-12,-11,-4,-1,-1,0,-3,-7,-1,-1,-49,-16,-33,-8,0,-8,-10,-7,-17,-1,-13,-1,-6,3,-11,2,-5,1,-4,-10,-6,-3,-8,-2,0,0,-2,-6,0,0,-1,4,-2,-2,1,0,1,-4,0,-4,-1,0,-23,-11,-12,3,1,2,-9,-3,-10,-4,2,-1,-7,-3,-1,-2,-1,1,-2,0,-9,-2,3,-2,-1,0,0,4,1,-1,-3,0,0,4,1,-1,2,0,0,0,0,0,16,6,10,3,-1,4,7,2,-1,-15,3,19,3,2,0,-11,5,7,4,0,-1,-4,-2,12,3,0,1,0,-1,0,2,0,1,-3,-1,0,1,0,0,3,0,0
45,45078,Huerta de Valdecarábanos,1685,26,12,14,12,8,4,-1,7,3,6,7,4,0,5,-1,4,2,2,-1,2,4,2,5,2,2,2,4,3,1,0,1,2,2,2,1,0,1,0,2,1,0,0,23,19,4,27,21,6,6,7,0,6,4,0,4,9,1,2,3,0,2,-2,-1,4,1,0,8,6,7,5,1,0,6,5,6,3,1,0,2,1,1,2,0,0,17,13,4,32,20,12,-3,10,1,3,4,2,-2,4,4,2,2,3,-1,6,-3,1,2,-1,4,11,7,7,2,1,2,7,5,4,1,1,2,4,2,3,1,0,13,3,10,15,9,6,-1,-1,12,0,1,2,-1,-3,7,0,0,0,0,2,5,0,1,2,0,2,11,1,1,0,0,0,8,1,0,0,0,2,3,0,1,0,51,33,18,31,18,13,7,10,19,15,2,-3,5,6,11,12,0,-1,2,4,8,3,2,-2,3,9,11,8,0,0,1,7,6,4,0,0,2,2,5,4,0,0,24,8,16,9,1,8,8,12,-1,2,3,-2,2,7,-5,3,2,-2,6,5,4,-1,1,0,3,3,1,0,1,0,1,1,-2,1,0,0,2,2,3,-1,1,0,65,29,36,14,7,7,10,16,27,7,4,2,4,4,15,3,1,3,6,12,12,4,3,-1,4,5,6,-3,2,0,1,1,5,-1,0,1,3,4,1,-2,2,-1,98,57,41,32,20,12,23,25,13,19,14,2,11,14,15,11,5,0,12,11,-2,8,9,2,8,8,12,3,1,0,4,5,8,2,1,0,4,3,4,1,0,0,18,16,2,18,8,10,3,-2,8,4,3,0,8,0,4,2,1,0,-5,-2,4,2,2,0,2,4,4,6,1,1,2,0,1,5,0,0,0,4,3,1,1,1,17,3,14,5,1,4,6,7,1,0,1,2,1,0,4,-4,0,2,5,7,-3,4,1,0,3,0,-3,1,1,2,1,0,-3,0,1,2,2,0,0,1,0,0,-11,-7,-4,4,4,0,-7,6,-12,1,5,-5,-5,3,-5,-1,3,-3,-2,3,-7,2,2,-2,-2,5,5,-5,0,1,2,3,3,-4,0,0,-4,2,2,-1,0,1,-35,-22,-13,-7,-5,-2,-8,-5,-14,-1,-9,1,-5,-3,-10,2,-6,0,-3,-2,-4,-3,-3,1,1,-3,-2,3,-5,-2,0,-2,0,2,-4,-1,1,-1,-2,1,-1,-1,-12,-3,-9,-7,-7,0,7,-2,-3,-10,-2,-2,5,-2,-1,-6,0,0,2,0,-2,-4,-2,-2,0,-1,-3,-2,-2,0,0,-1,-3,-2,-2,0,0,0,0,0,0,0,-57,-28,-29,-5,-2,-3,-23,-4,-18,-14,5,-2,-12,-3,-9,-6,3,0,-11,-1,-9,-8,2,-2,-2,-1,-1,0,1,-2,1,-1,-1,0,0,-1,-3,0,0,0,1,-1,-11,-8,-3,-6,-3,-3,2,-4,-10,2,0,-1,-1,2,-7,1,-3,0,3,-6,-3,1,3,-1,-2,-3,-2,2,-1,0,-2,-1,-1,2,-1,0,0,-2,-1,0,0,0,-30,-15,-15,-6,-4,-2,-5,-2,-8,-8,-6,-1,1,-2,-4,-5,-5,0,-6,0,-4,-3,-1,-1,0,-1,-3,0,-2,0,0,-1,-2,1,-2,0,0,0,-1,-1,0,0,-40,-21,-19,-22,-14,-8,-10,-1,-12,-12,-3,-2,-5,0,-7,-5,-3,-1,-5,-1,-5,-7,0,-1,-5,0,-8,-6,-3,0,-3,0,-5,-3,-3,0,-2,0,-3,-3,0,0,-12,-9,-3,-8,-6,-2,6,6,-10,-10,1,-5,2,2,-7,-10,3,0,4,4,-3,0,-2,-5,0,-1,-4,-2,-1,0,-1,-1,-1,-3,0,0,1,0,-3,1,-1,0
45,45081,Illescas,10106,541,274,267,68,34,34,123,73,182,103,29,21,57,28,102,56,15,7,66,45,80,47,14,14,16,17,19,12,3,1,7,10,8,8,1,0,9,7,11,4,2,1,605,329,276,162,92,70,123,62,259,97,43,16,56,37,133,67,25,6,67,25,126,30,18,10,38,24,66,28,5,0,23,11,36,19,2,0,15,13,30,9,3,0,744,409,335,181,101,80,161,110,245,129,53,32,97,74,123,67,18,18,64,36,122,62,35,14,35,36,57,35,11,5,21,25,32,19,2,2,14,11,25,16,9,3,557,295,262,151,73,78,98,108,210,108,14,4,46,56,117,61,7,3,52,52,93,47,7,1,25,37,52,27,6,3,15,14,26,16,2,0,10,23,26,11,4,3,928,464,464,178,90,88,209,136,324,153,56,38,105,60,166,92,24,15,104,76,158,61,32,23,31,58,45,28,13,1,19,27,23,15,4,1,12,31,22,13,9,0,906,460,446,170,86,84,157,150,339,175,44,10,86,63,190,79,20,6,71,87,149,96,24,4,29,45,51,29,7,5,14,21,34,12,3,2,15,24,17,17,4,3,1477,779,698,290,138,152,338,160,544,291,78,34,218,69,256,168,37,13,120,91,288,123,41,21,63,69,101,48,6,3,31,29,47,27,4,0,32,40,54,21,2,3,1641,827,814,336,166,170,321,261,576,300,112,42,169,119,289,159,61,17,152,142,287,141,51,25,88,79,91,67,6,0,49,32,43,38,1,1,39,47,48,29,5,-1,1848,1044,804,266,159,107,326,278,827,249,101,32,168,129,497,164,45,15,158,149,330,85,56,17,52,67,76,50,12,4,28,36,50,31,8,2,24,31,26,19,4,2,1002,528,474,60,11,49,147,225,420,120,39,34,89,117,214,62,25,14,58,108,206,58,14,20,-9,41,36,-13,2,-1,-2,10,11,-8,-1,-1,-7,31,25,-5,3,0,928,457,471,86,37,49,135,128,470,84,48,29,80,53,252,23,17,14,55,75,218,61,31,15,2,35,36,1,4,5,2,13,21,-4,0,2,0,22,15,5,4,3,668,371,297,-29,-21,-8,112,89,300,112,-4,8,69,48,169,75,-16,-3,43,41,131,37,12,11,3,21,-37,-16,-3,-4,5,9,-15,-13,-8,-2,-2,12,-22,-3,5,-2,529,290,239,39,17,22,132,111,164,74,19,7,67,60,72,63,8,6,65,51,92,11,11,1,5,19,8,3,5,-2,5,4,6,0,2,-1,0,15,2,3,3,-1,117,38,79,-167,-99,-68,102,12,31,-36,-18,14,84,-2,-10,-48,-7,19,18,14,41,12,-11,-5,-9,-13,-56,-66,-20,-4,-7,-8,-33,-42,-10,1,-2,-5,-23,-24,-10,-5,54,37,17,-82,-43,-39,52,-8,31,-44,-11,7,37,-5,9,-17,-2,2,15,-3,22,-27,-9,5,1,-2,-38,-37,-9,-1,1,3,-18,-26,-5,1,0,-5,-20,-11,-4,-2,482,261,221,44,6,38,142,4,180,80,0,39,75,-3,109,53,-4,6,67,7,71,27,4,33,9,5,9,8,6,4,3,3,0,-3,2,-2,6,2,9,11,4,6,556,278,278,152,74,78,174,63,142,99,24,29,88,39,90,37,1,4,86,24,52,62,23,25,30,26,42,32,7,13,17,20,21,12,0,2,13,6,21,20,7,11,408,199,209,-32,-6,-26,165,65,79,73,0,20,81,46,19,46,-6,5,84,19,60,27,6,15,-9,41,-6,-52,-10,1,-1,28,-6,-21,-7,0,-8,13,0,-31,-3,1
45,45082,Lagartera,1870,-5,-1,-4,12,7,5,-15,2,3,3,-1,3,-7,3,5,-2,-1,1,-8,-1,-2,5,0,2,1,2,7,2,0,0,0,1,5,1,0,0,1,1,2,1,0,0,-24,-11,-13,9,4,5,-19,0,-7,-5,1,5,-13,-1,-2,-1,2,3,-6,1,-5,-4,-1,2,1,3,1,3,0,0,0,1,0,2,0,0,1,2,1,1,0,0,-30,-7,-23,5,2,3,0,-7,-15,-9,0,1,3,-2,-8,-2,1,1,-3,-5,-7,-7,-1,0,3,1,1,0,1,-1,1,1,0,0,0,0,2,0,1,0,1,-1,-8,-3,-5,6,5,1,-6,5,-7,-2,-1,2,-3,5,-6,-1,-2,4,-3,0,-1,-1,1,-2,2,2,1,1,0,0,2,2,0,1,0,0,0,0,1,0,0,0,-21,-18,-3,8,4,4,-8,1,-6,-7,1,-1,-5,-4,-5,-4,2,-2,-3,5,-1,-3,-1,1,1,2,3,1,1,0,1,1,1,0,1,0,0,1,2,1,0,0,-38,-14,-24,5,3,2,-6,-6,-16,-6,0,-4,-1,-3,-5,-4,1,-2,-5,-3,-11,-2,-1,-2,1,1,0,1,2,0,1,0,0,1,1,0,0,1,0,0,1,0,-5,4,-9,13,8,5,2,-5,-1,-2,1,0,-1,-1,3,1,0,2,3,-4,-4,-3,1,-2,0,6,4,2,1,0,0,4,2,2,0,0,0,2,2,0,1,0,33,17,16,12,7,5,12,7,1,4,1,7,7,1,1,2,1,5,5,6,0,2,0,2,2,1,6,3,0,0,2,0,3,2,0,0,0,1,3,1,0,0,-5,-6,1,8,5,3,-3,2,-3,-5,0,4,-3,-1,-3,-1,-1,3,0,3,0,-4,1,1,0,2,3,3,0,0,0,1,1,3,0,0,0,1,2,0,0,0,15,10,5,3,2,1,2,0,8,-5,5,5,2,1,9,-4,2,0,0,-1,-1,-1,3,5,0,1,1,0,0,1,0,1,1,0,0,0,0,0,0,0,0,1,-25,-6,-19,5,1,4,-11,-6,-8,-4,0,3,-3,-2,-2,0,-1,2,-8,-4,-6,-4,1,1,0,3,2,0,0,0,0,1,0,0,0,0,0,2,2,0,0,0,-2,0,-2,6,1,5,4,0,-6,-3,0,3,3,0,-6,0,0,2,1,0,0,-3,0,1,2,3,-1,2,0,0,0,2,-1,0,0,0,2,1,0,2,0,0,12,10,2,6,3,3,-1,6,2,-1,-1,6,2,3,4,0,0,1,-3,3,-2,-1,-1,5,1,2,0,2,1,0,1,0,0,1,1,0,0,2,0,1,0,0,-10,-11,1,-4,-3,-1,-2,-6,-13,3,1,6,-6,-3,-9,3,0,4,4,-3,-4,0,1,2,-3,0,1,0,-1,-1,-3,0,1,0,0,-1,0,0,0,0,-1,0,17,13,4,13,7,6,4,4,5,-2,3,2,2,4,5,-1,0,3,2,0,0,-1,3,-1,2,5,5,0,0,0,1,3,3,0,0,0,1,2,2,0,0,0,-6,-12,6,4,3,1,1,-3,-4,-5,1,2,-2,-5,-3,-3,-1,2,3,2,-1,-2,2,0,1,2,2,-1,1,-1,1,1,1,-1,1,0,0,1,1,0,0,-1,-18,-2,-16,1,2,-1,-3,-4,-9,-3,3,-2,-1,2,-4,-1,3,-1,-2,-6,-5,-2,0,-1,-1,0,1,2,0,-1,-1,1,1,1,0,0,0,-1,0,1,0,-1,9,1,8,7,4,3,5,5,1,-6,0,3,3,0,2,-6,-1,3,2,5,-1,0,1,0,0,4,3,0,0,0,0,2,2,0,0,0,0,2,1,0,0,0
45,45087,Madridejos,10475,46,38,8,42,28,14,-1,10,23,10,3,-2,2,7,16,10,4,-3,-3,3,7,0,-1,1,3,12,15,8,2,1,1,8,11,7,1,0,2,4,4,1,1,1,42,11,31,62,37,25,-6,13,9,21,-1,4,-2,1,2,6,1,2,-4,12,7,15,-2,2,7,15,19,20,0,1,5,6,13,12,0,1,2,9,6,8,0,0,112,75,37,105,74,31,16,34,37,14,9,3,5,24,31,9,4,3,11,10,6,5,5,0,24,37,34,9,0,1,13,28,23,9,0,1,11,9,11,0,0,0,-5,8,-13,73,41,32,-10,7,-23,13,4,5,-5,3,-2,9,1,2,-5,4,-21,4,3,3,10,21,28,14,0,0,6,11,17,7,0,0,4,10,11,7,0,0,145,75,70,125,74,51,31,33,47,26,4,0,14,16,28,12,4,1,17,17,19,14,0,-1,20,38,48,17,2,0,11,19,32,10,2,0,9,19,16,7,0,0,23,12,11,81,46,35,15,3,10,-8,2,0,6,3,7,-6,-1,3,9,0,3,-2,3,-3,9,22,29,15,1,4,5,12,18,8,0,3,4,10,11,7,1,1,206,131,75,167,105,62,45,27,75,34,16,4,28,20,53,22,6,0,17,7,22,12,10,4,25,41,67,32,1,1,15,31,42,19,-2,0,10,10,25,13,3,1,206,141,65,294,178,116,30,76,47,49,10,-7,18,50,35,34,5,-3,12,26,12,15,5,-4,51,91,92,52,6,1,23,55,60,38,1,1,28,36,32,14,5,0,52,25,27,88,46,42,10,15,8,2,11,3,3,13,-1,0,7,1,7,2,9,2,4,2,9,27,19,22,10,-1,4,14,11,12,6,-1,5,13,8,10,4,0,-66,-41,-25,8,1,7,-6,-18,-33,-8,-2,0,-4,-9,-24,-3,-5,3,-2,-9,-9,-5,3,-3,1,3,7,-3,0,1,0,-2,2,2,-2,1,1,5,5,-5,2,0,-29,-19,-10,13,4,9,3,7,-32,-1,1,-4,-3,9,-21,-1,0,0,6,-2,-11,0,1,-4,3,10,-11,12,-2,0,0,7,-8,6,0,-1,3,3,-3,6,-2,1,-88,-35,-53,-17,-15,-2,-8,-14,-46,1,-14,-5,5,-5,-29,0,-5,-1,-13,-9,-17,1,-9,-4,-6,1,-5,1,-8,0,-2,-2,-9,0,-2,0,-4,3,4,1,-6,0,-119,-49,-70,-52,-33,-19,-15,-26,-37,-25,-11,-4,-8,-11,-18,-11,-1,0,-7,-15,-19,-14,-10,-4,-5,-1,-11,-29,-6,0,-1,-2,-7,-19,-3,-1,-4,1,-4,-10,-3,1,-118,-62,-56,-105,-65,-40,-9,-19,-59,-20,-18,5,0,-10,-32,-13,-11,1,-9,-9,-27,-7,-7,4,-22,-8,-45,-16,-14,0,-10,-7,-29,-11,-8,0,-12,-1,-16,-5,-6,0,-64,-34,-30,0,0,0,-8,-14,-25,-18,-6,7,-8,-8,-7,-15,1,3,0,-6,-18,-3,-7,4,3,1,2,-4,-1,-1,0,2,0,-2,0,0,3,-1,2,-2,-1,-1,-62,-15,-47,40,16,24,7,-28,0,-36,0,-2,6,-10,6,-16,-1,2,1,-18,-6,-20,1,-4,11,4,16,1,5,1,2,1,9,1,1,0,9,3,7,0,4,1,-102,-74,-28,-43,-38,-5,-7,-12,-58,-33,-5,13,-4,-9,-33,-27,-5,4,-3,-3,-25,-6,0,9,-8,1,-12,-24,-1,2,-5,-2,-10,-20,-3,2,-3,3,-2,-4,2,0,-59,-33,-26,-3,-4,1,-8,-13,-42,-8,-2,9,-6,-9,-20,0,-4,1,-2,-4,-22,-8,2,8,-3,4,-8,-2,1,2,-3,0,-3,-3,0,2,0,4,-5,1,1,0
45,45089,Malpica de Tajo,1875,19,8,11,13,7,6,3,5,10,2,1,-2,-1,1,8,-1,2,-1,4,4,2,3,-1,-1,2,3,4,4,0,0,0,2,4,1,0,0,2,1,0,3,0,0,30,11,19,8,4,4,0,5,7,6,11,1,0,2,1,3,5,0,0,3,6,3,6,1,0,4,4,0,0,0,0,2,2,0,0,0,0,2,2,0,0,0,56,31,25,17,9,8,10,13,15,8,5,3,7,11,7,4,1,0,3,2,8,4,4,3,2,7,4,2,2,0,1,5,2,1,0,0,1,2,2,1,2,0,4,4,0,24,17,7,-2,5,-6,10,3,-3,-3,8,-8,7,3,-2,1,-3,2,3,0,-1,1,7,7,7,2,0,1,5,4,5,2,0,0,2,3,2,0,0,41,23,18,42,24,18,-3,16,9,4,9,7,-5,10,12,-1,4,3,2,6,-3,5,5,4,6,14,17,3,2,0,2,9,12,0,1,0,4,5,5,3,1,0,25,9,16,57,33,24,2,16,8,-2,7,-4,-1,6,6,-3,4,-2,3,10,2,1,3,-2,4,27,20,5,1,0,2,12,16,3,0,0,2,15,4,2,1,0,87,46,41,82,38,44,17,6,22,19,16,8,10,6,5,11,8,6,7,0,17,8,8,2,14,19,30,14,4,0,6,10,10,10,2,0,8,9,20,4,2,0,35,23,12,42,24,18,2,4,8,3,8,6,-4,8,4,6,4,4,6,-4,4,-3,4,2,5,13,14,4,3,2,1,8,8,3,1,2,4,5,6,1,2,0,18,14,4,26,15,11,-10,5,5,3,10,7,-8,3,13,-1,4,3,-2,2,-8,4,6,4,4,7,10,5,0,0,2,4,6,3,0,0,2,3,4,2,0,0,-19,-7,-12,13,8,5,-17,5,-16,2,5,2,-10,8,-14,1,7,1,-7,-3,-2,1,-2,1,0,4,6,3,0,0,0,3,4,1,0,0,0,1,2,2,0,0,-31,-14,-17,10,6,4,-8,-1,-14,-7,0,0,0,-4,-8,-2,1,0,-8,3,-6,-5,-1,0,0,8,2,0,0,0,0,5,1,0,0,0,0,3,1,0,0,0,6,0,6,15,5,10,15,-2,-2,-1,2,-6,9,1,-2,-2,1,-7,6,-3,0,1,1,1,5,3,2,1,3,1,2,2,1,-1,1,0,3,1,1,2,2,1,-1,-4,3,8,5,3,5,7,-9,-1,1,-7,-1,4,-8,0,0,-1,6,3,-1,-1,1,-6,4,1,-1,3,0,0,2,0,-1,3,0,0,2,1,0,0,0,0,-48,-23,-25,9,5,4,-11,-4,-15,-14,2,-4,-8,-3,-4,-7,2,-2,-3,-1,-11,-7,0,-2,3,2,1,1,2,0,2,0,1,1,1,0,1,2,0,0,1,0,-28,-3,-25,4,0,4,-2,-3,-11,-2,5,-14,4,-2,-4,-1,6,-5,-6,-1,-7,-1,-1,-9,0,3,2,0,-1,0,0,1,1,-1,-1,0,0,2,1,1,0,0,-12,-8,-4,-20,-15,-5,3,0,-7,-15,-1,6,4,0,-5,-8,-2,3,-1,0,-2,-7,1,3,1,0,-3,-9,-6,-3,0,0,-2,-7,-4,-2,1,0,-1,-2,-2,-1,-62,-30,-32,-36,-22,-14,-5,-6,-16,-26,-3,-5,-1,1,-11,-12,-4,-2,-4,-7,-5,-14,1,-3,-6,1,-11,-13,-3,-4,-4,2,-5,-11,-2,-2,-2,-1,-6,-2,-1,-2,-25,-9,-16,11,8,3,-13,-3,-4,-13,5,3,-8,3,-1,-8,4,1,-5,-6,-3,-5,1,2,0,5,3,0,3,0,0,4,2,0,2,0,0,1,1,0,1,0
45,45098,Menasalbas,2955,46,23,23,31,18,13,9,10,11,7,3,5,4,6,7,3,1,1,5,4,4,4,2,4,11,8,6,4,0,2,8,5,5,0,0,0,3,3,1,4,0,2,-13,-9,-4,12,6,6,-6,-3,-10,0,2,4,-2,0,-9,0,0,2,-4,-3,-1,0,2,2,0,7,4,1,0,0,0,4,1,1,0,0,0,3,3,0,0,0,17,6,11,18,11,7,5,6,3,3,-2,0,3,2,-3,5,-1,-2,2,4,6,-2,-1,2,2,10,2,1,0,0,1,6,1,1,0,0,1,4,1,0,0,0,-13,4,-17,7,4,3,-7,-10,-3,-8,11,3,-2,-5,2,0,7,1,-5,-5,-5,-8,4,2,2,1,4,0,0,0,0,0,4,0,0,0,2,1,0,0,0,0,-19,-10,-9,25,16,9,-5,-7,-12,-3,8,-1,-5,-1,-7,-2,6,-1,0,-6,-5,-1,2,0,6,7,6,2,3,1,3,6,3,1,2,1,3,1,3,1,1,0,87,61,26,99,56,43,12,17,26,12,10,9,9,17,18,7,7,3,3,0,8,5,3,6,13,32,34,17,0,1,8,18,22,8,0,0,5,14,12,9,0,1,61,69,-8,131,97,34,-13,46,30,5,-4,-3,-10,40,35,11,-7,-1,-3,6,-5,-6,3,-2,8,51,51,16,1,0,3,39,41,13,-1,0,5,12,10,3,2,0,99,59,40,137,99,38,19,40,24,9,5,3,7,29,20,2,2,0,12,11,4,7,3,3,16,50,49,15,5,0,7,36,41,10,3,0,9,14,8,5,2,0,21,27,-6,83,71,12,-6,6,24,0,-5,3,-10,9,24,6,-4,2,4,-3,0,-6,-1,1,4,27,36,14,2,0,1,23,33,13,1,0,3,4,3,1,1,0,-44,-42,-2,8,-5,13,-2,-1,-30,-6,1,-5,-4,-4,-25,-9,-2,0,2,3,-5,3,3,-5,4,6,-4,0,0,0,2,4,-11,-2,0,0,2,2,7,2,0,0,-24,-25,1,10,-5,15,3,7,-16,-11,-6,-2,6,1,-18,-10,-4,0,-3,6,2,-1,-2,-2,6,5,1,-4,1,0,4,-1,-3,-6,0,0,2,6,4,2,1,0,-71,-31,-40,-20,-18,-2,-8,-5,-36,-14,-10,2,0,-2,-19,-10,-2,1,-8,-3,-17,-4,-8,1,2,4,-17,-5,-4,0,1,2,-14,-5,-2,0,1,2,-3,0,-2,0,-69,-56,-13,-53,-37,-16,-10,-14,-19,-18,-3,-6,-11,-10,-17,-14,0,-4,1,-4,-2,-4,-3,-2,-14,-10,-13,-10,-7,0,-8,-7,-11,-7,-4,0,-6,-3,-2,-3,-3,0,-82,-44,-38,-32,-17,-15,-17,-7,-35,-16,-1,-6,-3,-6,-21,-10,-2,-3,-14,-1,-14,-6,1,-3,-7,-3,-14,-4,-4,0,2,-4,-10,-2,-3,0,-9,1,-4,-2,-1,0,-77,-47,-30,-30,-22,-8,-16,-4,-45,-5,-5,-1,-6,-1,-29,-9,-2,0,-10,-3,-16,4,-3,-1,-5,0,-15,-7,-3,0,-2,0,-11,-8,-1,0,-3,0,-4,1,-2,0,-14,-1,-13,1,2,-1,-8,4,-16,3,3,1,-1,-3,-1,2,0,1,-7,7,-15,1,3,0,1,3,-6,1,1,0,0,-1,2,0,0,0,1,4,-8,1,1,0,-56,-27,-29,-26,-15,-11,-11,-5,-20,-8,-7,-4,-6,-3,-8,-4,-3,-2,-5,-2,-12,-4,-4,-2,-5,-3,-9,-6,-3,0,-4,-2,-4,-3,-2,0,-1,-1,-5,-3,-1,0,0,3,-3,-9,-4,-5,-1,0,0,1,-1,0,1,-1,2,0,1,1,-2,1,-2,1,-2,-1,-10,1,4,-4,0,0,-4,1,2,-2,0,0,-6,0,2,-2,0,0
45,45101,Miguel Esteban,4712,-6,-1,-5,4,3,1,-2,-2,-8,2,7,-3,1,-2,-7,2,6,-1,-3,0,-1,0,1,-2,0,0,1,1,2,0,0,0,1,1,1,0,0,0,0,0,1,0,78,46,32,98,60,38,12,25,20,22,-3,1,6,16,11,13,-2,2,6,9,9,9,-1,-1,17,19,36,25,0,0,9,15,19,17,0,0,8,4,17,8,0,0,33,18,15,77,37,40,15,-2,17,4,3,-2,8,-1,12,0,0,-2,7,-1,5,4,3,0,20,20,25,9,2,0,9,7,15,5,0,0,11,13,10,4,2,0,112,65,47,115,65,50,12,50,21,13,7,9,1,23,20,10,6,5,11,27,1,3,1,4,17,43,32,18,2,2,5,23,23,11,2,1,12,20,9,7,0,1,145,94,51,164,103,61,22,52,28,22,14,7,14,35,19,14,7,5,8,17,9,8,7,2,20,59,49,28,9,-1,11,36,33,18,5,0,9,23,16,10,4,-1,186,112,74,224,128,96,28,69,46,34,5,1,14,32,33,30,0,1,14,37,13,4,5,0,41,82,60,35,4,0,19,41,39,27,1,0,22,41,21,8,3,0,144,79,65,195,121,74,28,32,61,19,3,0,19,13,35,9,3,0,9,19,26,10,0,0,42,47,71,32,0,0,25,30,44,21,1,0,17,17,27,11,-1,0,388,241,147,368,229,139,56,148,96,51,25,6,32,84,81,33,8,2,24,64,15,18,17,4,60,141,102,51,10,0,32,87,74,31,3,0,28,54,28,20,7,0,-191,-121,-70,-160,-106,-54,-23,-37,-79,-44,-3,-4,-10,-20,-48,-36,-4,-2,-13,-17,-31,-8,1,-2,-25,-26,-66,-39,-6,1,-11,-15,-47,-29,-5,1,-14,-11,-19,-10,-1,0,-176,-121,-55,-139,-102,-37,-20,-34,-86,-32,0,-1,-7,-16,-66,-31,0,0,-13,-18,-20,-1,0,-1,-14,-28,-68,-27,-3,0,-5,-18,-53,-26,-1,0,-9,-10,-15,-1,-2,0,-78,-38,-40,-63,-43,-20,3,-22,-29,-20,-7,-2,7,-20,-7,-15,-3,1,-4,-2,-22,-5,-4,-3,-1,-18,-22,-17,-4,-1,1,-18,-11,-14,-1,0,-2,0,-11,-3,-3,-1,-27,-13,-14,-23,-7,-16,-13,7,-38,1,9,4,-2,0,-24,3,4,3,-11,7,-14,-2,5,1,-11,4,-26,1,5,2,2,3,-16,-1,2,1,-13,1,-10,2,3,1,-87,-55,-32,-117,-69,-48,-3,-1,-61,-16,-8,1,1,-2,-42,-4,-8,0,-4,1,-19,-12,0,1,-14,-9,-68,-16,-9,-2,-2,-2,-47,-9,-8,-1,-12,-7,-21,-7,-1,-1,-69,-54,-15,-24,-28,4,-21,-1,-26,-23,-7,9,-18,-2,-17,-16,-5,3,-3,1,-9,-7,-2,6,-3,-1,-4,-12,-4,-1,-9,-1,-2,-13,-4,0,6,0,-2,1,0,-1,-124,-62,-62,-76,-42,-34,-35,-8,-43,-25,-15,3,-16,-5,-20,-17,-6,3,-19,-3,-23,-8,-9,0,-17,-3,-32,-12,-12,0,-7,-3,-19,-8,-5,0,-10,0,-13,-4,-7,0,-12,-9,-3,-2,-1,-1,1,0,-6,-6,-6,4,8,-1,-9,-4,-8,5,-7,1,3,-2,2,-1,-1,3,5,-4,-4,-1,1,2,3,-3,-4,0,-2,1,2,-1,0,-1,-53,-17,-36,-42,-22,-20,-16,-10,-18,-15,3,1,-8,-2,-8,-5,5,0,-8,-8,-10,-10,-2,1,-7,-1,-10,-15,-9,-1,-2,-2,-6,-7,-4,-2,-5,1,-4,-8,-5,1,-9,-10,1,17,7,10,1,-11,-10,-4,0,18,0,-3,-11,-1,-3,9,1,-8,1,-3,3,9,3,4,6,5,-2,0,3,2,2,3,-3,0,0,2,4,2,1,0
45,45102,Mocejón,4146,6,-1,7,4,2,2,0,-3,12,1,-1,-1,2,-6,4,0,-2,3,-2,3,8,1,1,-4,0,1,3,0,0,0,0,0,2,0,0,0,0,1,1,0,0,0,39,12,27,34,22,12,5,9,9,4,7,4,0,4,7,-1,3,-1,5,5,2,5,4,5,7,12,11,2,2,0,5,11,5,1,0,0,2,1,6,1,2,0,39,35,4,44,32,12,12,14,-1,6,3,3,7,14,0,8,3,2,5,0,-1,-2,0,1,9,17,10,6,1,1,3,17,7,4,0,1,6,0,3,2,1,0,45,22,23,45,26,19,21,21,9,5,-5,-5,12,12,2,2,-2,-3,9,9,7,3,-3,-2,14,11,11,9,0,0,7,6,7,6,0,0,7,5,4,3,0,0,99,59,40,66,30,36,13,9,41,19,6,5,11,2,25,10,4,3,2,7,16,9,2,2,21,12,18,9,1,4,9,4,8,4,1,3,12,8,10,5,0,1,17,18,-1,47,45,2,-8,-5,13,14,-1,4,-8,1,8,16,1,-1,0,-6,5,-2,-2,5,-1,8,15,15,8,2,-1,9,17,13,6,1,0,-1,-2,2,2,1,124,59,65,79,44,35,39,39,34,9,6,-4,13,20,14,12,1,-2,26,19,20,-3,5,-2,15,32,18,8,3,2,6,20,8,7,1,1,9,12,10,1,2,1,105,64,41,72,38,34,20,11,40,20,9,-1,14,9,26,10,2,0,6,2,14,10,7,-1,12,18,28,11,3,0,5,12,17,3,1,0,7,6,11,8,2,0,25,22,3,73,51,22,-9,23,5,5,0,3,-7,17,9,0,1,1,-2,6,-4,5,-1,2,13,25,23,11,1,0,8,18,17,7,1,0,5,7,6,4,0,0,-43,-22,-21,18,5,13,-14,-4,-20,-3,-1,3,-1,4,-17,-2,-1,-1,-13,-8,-3,-1,0,4,2,9,7,1,-1,-2,0,3,4,0,-1,-2,2,6,3,1,0,0,-14,-18,4,-13,-14,1,-9,-5,-1,-5,3,4,-10,-1,-1,-7,0,1,1,-4,0,2,3,3,1,3,-6,-10,-2,1,1,3,-7,-9,-2,0,0,0,1,-1,0,1,88,51,37,20,12,8,26,25,9,17,9,0,15,8,9,11,5,1,11,17,0,6,4,-1,0,10,6,2,1,0,-1,6,5,1,1,0,1,4,1,1,0,0,-57,-50,-7,4,2,2,-8,-15,-19,-14,4,-7,-11,-10,-12,-14,0,-4,3,-5,-7,0,4,-3,0,3,-2,1,1,1,0,2,-2,1,0,1,0,1,0,0,1,0,-159,-90,-69,-106,-70,-36,-25,-30,-48,-32,-16,-3,-5,-16,-25,-25,-13,-2,-20,-14,-23,-7,-3,-1,-16,-15,-32,-21,-17,-5,-6,-10,-19,-18,-14,-3,-10,-5,-13,-3,-3,-2,-12,-9,-3,-31,-24,-7,8,22,-10,-22,-9,0,12,11,-13,-13,-4,0,-4,11,3,-9,-5,0,2,1,-12,-13,-6,-3,0,2,-12,-7,-5,-2,2,-1,0,-6,-1,-1,-37,-6,-31,19,16,3,-14,-17,1,5,-13,-1,-3,-5,2,7,-7,-1,-11,-12,-1,-2,-6,0,0,6,11,5,-4,0,2,5,8,2,-2,0,-2,1,3,3,-2,0,-5,-13,8,-6,-13,7,4,-5,-21,-2,10,5,-3,-7,-17,5,4,2,7,2,-4,-7,6,3,-3,0,-5,-1,1,0,0,-2,-9,-1,-2,1,-3,2,4,0,3,-1,-1,-7,6,0,-3,3,10,-6,-12,5,-3,2,6,-2,-11,1,-2,1,4,-4,-1,4,-1,1,3,-1,-2,-1,-3,2,2,-2,-4,1,0,0,1,1,2,-2,-3,2
45,45106,Mora,9352,142,83,59,89,46,43,26,39,51,10,9,6,13,23,38,4,2,2,13,16,13,6,7,4,12,25,33,12,3,1,4,12,23,6,1,0,8,13,10,6,2,1,33,9,24,71,41,30,14,14,-9,1,2,10,7,-1,-5,3,3,2,7,15,-4,-2,-1,8,16,29,18,7,1,0,9,15,13,3,1,0,7,14,5,4,0,0,153,84,69,126,69,57,33,44,51,6,9,6,16,25,23,7,7,4,17,19,28,-1,2,2,30,31,47,16,2,0,13,18,24,11,3,0,17,13,23,5,-1,0,90,49,41,75,40,35,22,18,12,22,10,4,10,6,7,15,6,6,12,12,5,7,4,-2,13,24,25,11,2,0,5,14,13,7,1,0,8,10,12,4,1,0,88,71,17,127,90,37,4,26,17,19,13,6,1,22,29,10,3,6,3,4,-12,9,10,0,8,41,48,23,6,1,3,31,39,13,3,1,5,10,9,10,3,0,200,116,84,117,74,43,35,47,60,26,21,10,16,36,31,18,11,3,19,11,29,8,10,7,18,31,35,28,2,2,11,19,25,17,1,1,7,12,10,11,1,1,283,171,112,261,166,95,45,69,124,31,12,2,29,44,68,25,8,-1,16,25,56,6,4,3,31,81,100,39,7,2,18,52,61,32,3,0,13,29,39,7,4,2,218,149,69,300,190,110,13,58,72,53,22,-1,14,32,55,35,12,0,-1,26,17,18,10,-1,40,80,104,63,11,1,19,47,77,40,6,0,21,33,27,23,5,1,115,77,38,160,108,52,16,22,20,27,17,5,12,17,18,14,6,5,4,5,2,13,11,0,18,36,56,35,11,3,14,24,42,21,5,2,4,12,14,14,6,1,33,-3,36,88,50,38,9,21,10,-19,12,0,-2,1,5,-4,2,-4,11,20,5,-15,10,4,12,25,37,11,2,2,4,15,22,9,0,1,8,10,15,2,2,1,1,-17,18,88,44,44,3,16,-19,6,2,-5,-2,7,-17,-3,3,-2,5,9,-2,9,-1,-3,20,26,21,12,9,0,11,12,13,4,4,0,9,14,8,8,5,0,-103,-57,-46,-4,-4,0,-10,-12,-41,-25,-12,-5,-1,-3,-33,-14,-10,2,-9,-9,-8,-11,-2,-7,1,10,-5,-4,-4,-3,2,4,-4,-2,-4,-1,-1,6,-1,-2,0,-2,-27,-1,-26,12,6,6,-4,-3,-8,-4,2,-10,8,-2,1,-3,-1,-4,-12,-1,-9,-1,3,-6,0,2,7,2,1,0,2,-1,4,1,0,0,-2,3,3,1,1,0,-51,-44,-7,12,2,10,-7,0,-19,-9,-7,-8,-4,-9,-6,-12,-5,-5,-3,9,-13,3,-2,-3,0,6,2,0,2,2,0,2,0,-1,0,1,0,4,2,1,2,1,-34,-14,-20,26,12,14,-12,6,-25,-4,-3,0,-5,9,-10,-3,-6,0,-7,-3,-15,-1,3,0,4,9,2,6,0,0,1,5,2,3,-2,0,3,4,0,3,2,0,-155,-84,-71,-11,-10,-1,-8,-24,-57,-28,-18,-17,-1,-13,-34,-21,-8,-5,-7,-11,-23,-7,-10,-12,4,5,-7,-4,-4,-5,2,2,-7,-4,-1,-2,2,3,0,0,-3,-3,-37,-30,-7,-10,-8,-2,18,-13,-11,-33,3,1,1,-10,-5,-20,0,4,17,-3,-6,-13,3,-3,6,-3,-7,-6,0,-1,1,-1,-4,-5,0,0,5,-2,-3,-1,0,-1,-83,-42,-41,-22,-20,-2,-25,-28,-24,-17,7,6,-10,-13,-13,-11,3,2,-15,-15,-11,-6,4,4,-7,2,1,-9,-8,-1,-4,-1,-1,-8,-6,0,-3,3,2,-1,-2,-1
45,45109,Navahermosa,3893,111,75,36,129,97,32,-8,43,49,11,8,6,-13,23,42,14,4,5,5,20,7,-3,4,1,3,48,54,21,0,1,3,31,46,17,0,0,0,17,8,4,0,1,67,51,16,93,69,24,7,32,12,5,7,3,-4,22,21,5,4,2,11,10,-9,0,3,1,11,35,35,10,1,0,4,27,27,9,1,0,7,8,8,1,0,0,65,40,25,93,70,23,15,14,10,-1,15,12,14,10,12,-8,7,7,1,4,-2,7,8,5,15,30,33,13,2,0,12,21,25,10,2,0,3,9,8,3,0,0,57,35,22,80,49,31,2,18,0,4,24,11,3,13,-4,2,15,6,-1,5,4,2,9,5,14,29,23,8,6,0,7,19,14,6,3,0,7,10,9,2,3,0,84,47,37,72,50,22,5,33,-1,13,12,16,-2,20,6,5,5,8,7,13,-7,8,7,8,9,29,27,5,2,0,4,18,23,4,1,0,5,11,4,1,1,0,51,7,44,58,31,27,11,2,13,12,7,6,5,-7,0,6,4,-1,6,9,13,6,3,7,9,12,21,11,4,1,5,6,13,6,1,0,4,6,8,5,3,1,5,18,-13,67,53,14,8,8,-10,-10,6,6,6,11,0,-8,4,6,2,-3,-10,-2,2,0,16,22,24,7,0,-2,7,19,21,5,1,0,9,3,3,2,-1,-2,88,56,32,102,72,30,13,26,31,5,11,1,5,23,18,3,9,-3,8,3,13,2,2,4,13,44,33,6,4,2,7,35,21,4,4,1,6,9,12,2,0,1,36,24,12,73,43,30,8,9,1,0,16,2,10,7,-6,2,5,5,-2,2,7,-2,11,-3,15,15,28,18,-3,1,9,7,18,11,-3,1,6,8,10,7,0,0,-42,-21,-21,0,-3,3,-12,-21,-12,-12,4,9,-6,-20,-7,-2,6,8,-6,-1,-5,-10,-2,1,2,2,1,-6,1,0,1,-5,-1,0,1,1,1,7,2,-6,0,-1,-75,-38,-37,-12,-7,-5,-13,-9,-17,-21,-11,-8,1,-1,-13,-14,-9,-4,-14,-8,-4,-7,-2,-4,-3,-1,-3,-3,-2,-1,0,-1,-3,-2,-2,0,-3,0,0,-1,0,-1,-50,-26,-24,-6,-7,1,-9,-23,-17,-8,3,4,-8,-11,-10,0,-1,4,-1,-12,-7,-8,4,0,5,0,-5,-3,-3,0,3,-1,-4,-3,-2,0,2,1,-1,0,-1,0,-36,-21,-15,0,-4,4,-11,9,-14,-16,-2,-3,-8,9,-8,-13,0,-2,-3,0,-6,-3,-2,-1,-2,7,1,-6,-2,2,0,2,-2,-4,-1,1,-2,5,3,-2,-1,1,-107,-63,-44,-53,-40,-13,-21,-15,-44,-20,-5,-1,-14,-7,-24,-18,-4,5,-7,-8,-20,-2,-1,-6,-8,-6,-21,-16,-2,-1,-6,-4,-17,-12,-1,-1,-2,-2,-4,-4,-1,0,-44,-22,-22,-20,-10,-10,-16,-3,-29,0,2,4,-8,-10,-12,3,2,3,-8,7,-17,-3,0,1,-2,-5,-10,-1,-2,0,-2,-5,-4,1,0,0,0,0,-6,-2,-2,0,-46,-29,-17,-17,-17,0,-2,-12,-15,-10,-13,2,1,-5,-6,-10,-10,-2,-3,-7,-9,0,-3,4,2,0,-5,-6,-5,-5,0,-1,-2,-9,-4,-2,2,1,-3,3,-1,-3,-45,-36,-9,-24,-18,-6,-14,-11,-13,-9,-8,8,-12,-4,-13,-7,-5,4,-2,-7,0,-2,-3,4,-9,0,-8,-8,0,0,-4,-2,-7,-5,-1,0,-5,2,-1,-3,1,0,-37,-3,-34,6,6,0,-7,-11,-22,2,-8,8,0,-4,-6,4,-4,5,-7,-7,-16,-2,-4,3,5,2,-3,-1,1,0,5,-1,0,-1,1,0,0,3,-3,0,0,0
45,45115,Noblejas,3016,-2,2,-4,10,7,3,-13,13,-3,3,-1,-2,-8,8,1,3,-2,0,-5,5,-4,0,1,-2,0,4,3,3,0,0,0,3,2,2,0,0,0,1,1,1,0,0,38,26,12,32,18,14,-3,22,3,1,13,2,-2,14,5,1,8,0,-1,8,-2,0,5,2,5,15,8,4,0,0,1,9,6,2,0,0,4,6,2,2,0,0,73,36,37,29,17,12,7,23,14,17,9,2,3,15,9,5,4,2,4,8,5,12,5,0,4,10,9,4,1,0,3,6,6,1,1,0,1,4,3,3,0,0,81,43,38,34,25,9,17,26,34,-3,8,-6,8,16,20,-4,4,-3,9,10,14,1,4,-3,2,15,12,5,0,0,1,14,8,2,0,0,1,1,4,3,0,0,52,26,26,29,16,13,13,5,18,14,-2,6,6,-3,11,12,-2,3,7,8,7,2,0,3,1,11,11,3,2,1,0,3,9,3,0,1,1,8,2,0,2,0,53,33,20,35,18,17,8,7,14,11,4,8,5,8,6,8,2,4,3,-1,8,3,2,4,3,8,13,7,2,1,3,4,6,4,0,1,0,4,7,3,2,0,89,70,19,74,46,28,27,26,25,9,11,-10,16,15,32,5,5,-4,11,11,-7,4,6,-6,13,27,23,12,0,-2,7,15,19,5,0,-1,6,12,4,7,0,-1,63,52,11,75,46,29,2,20,30,15,-3,-2,1,16,25,12,0,-2,1,4,5,3,-3,0,8,20,32,13,2,0,4,11,21,9,1,0,4,9,11,4,1,0,42,17,25,54,30,24,7,16,6,3,3,4,-3,14,-3,2,4,3,10,2,9,1,-1,1,4,26,17,3,1,1,0,21,8,0,-1,1,4,5,9,3,2,0,33,12,21,7,2,5,10,-1,23,2,-5,2,3,1,7,4,-3,-1,7,-2,16,-2,-2,3,1,5,2,1,-1,-1,1,2,0,1,-1,-1,0,3,2,0,0,0,32,2,30,-1,-6,5,12,6,2,2,5,3,6,-4,-8,2,4,1,6,10,10,0,1,2,0,-3,2,2,-1,-1,-2,-2,-2,1,0,-1,2,-1,4,1,-1,0,41,23,18,14,7,7,6,16,4,0,8,4,6,7,7,-3,4,1,0,9,-3,3,4,3,6,7,-1,0,1,1,5,1,1,-2,1,1,1,6,-2,2,0,0,-28,-16,-12,-9,-7,-2,-1,-6,-23,-2,-2,5,0,1,-16,-1,-2,1,-1,-7,-7,-1,0,4,-3,0,-8,2,0,0,0,1,-8,0,0,0,-3,-1,0,2,0,0,-21,-15,-6,-6,-4,-2,10,-6,-15,2,-13,1,2,-5,-6,0,-8,2,8,-1,-9,2,-5,-1,2,-3,-5,3,-3,0,2,-3,-2,2,-2,-1,0,0,-3,1,-1,1,-27,-15,-12,0,0,0,-7,-6,-8,-8,5,-3,-4,-7,-2,-6,6,-1,-3,1,-6,-2,-1,-2,-2,2,-1,-2,2,1,-2,0,-1,0,2,1,0,2,0,-2,0,0,-1,-7,6,15,10,5,4,-1,-4,0,-6,6,4,0,-8,-5,-3,3,0,-1,4,5,-3,3,7,2,-1,2,1,3,6,0,-1,2,1,1,1,2,0,0,0,2,-24,-11,-13,13,0,13,0,-4,-12,-11,1,1,0,-3,-1,-7,-2,1,0,-1,-11,-4,3,0,6,2,4,-3,5,-1,3,1,1,-5,1,-1,3,1,3,2,4,0,-6,-1,-5,11,6,5,-8,-9,9,-3,5,-3,-6,-1,3,-1,5,-3,-2,-8,6,-2,0,0,3,2,4,0,1,1,1,1,2,0,1,1,2,1,2,0,0,0
45,45119,Numancia de la Sagra,2402,218,101,117,10,4,6,57,31,42,49,20,13,22,11,22,29,11,4,35,20,20,20,9,9,1,2,4,1,1,1,1,1,1,1,0,0,0,1,3,0,1,1,168,103,65,14,8,6,49,31,46,33,4,3,35,19,24,20,2,2,14,12,22,13,2,1,3,3,7,0,0,0,2,1,4,0,0,0,1,2,3,0,0,0,220,116,104,24,12,12,43,19,87,23,22,17,28,17,35,14,11,10,15,2,52,9,11,7,9,3,5,2,4,1,6,3,1,0,2,0,3,0,4,2,2,1,160,101,59,18,7,11,30,41,48,24,8,1,26,21,30,14,3,2,4,20,18,10,5,-1,6,4,5,0,2,0,3,2,1,0,1,0,3,2,4,0,1,0,189,103,86,24,14,10,38,29,61,35,18,2,15,10,36,27,10,-1,23,19,25,8,8,3,1,3,9,7,3,0,0,1,5,6,1,0,1,2,4,1,2,0,24,-7,31,18,5,13,4,13,8,3,-7,-2,-4,5,-2,1,-3,-4,8,8,10,2,-4,2,6,5,3,4,0,0,1,2,1,1,0,0,5,3,2,3,0,0,257,132,125,77,37,40,46,52,78,45,16,15,13,27,49,23,7,9,33,25,29,22,9,6,21,18,21,13,1,1,10,11,8,6,0,1,11,7,13,7,1,0,188,82,106,92,48,44,71,28,57,13,9,3,35,13,25,6,6,-2,36,15,32,7,3,5,25,21,30,7,4,3,10,11,21,3,2,1,15,10,9,4,2,2,100,62,38,38,28,10,1,31,44,14,-1,6,3,9,38,8,-1,-1,-2,22,6,6,0,7,5,15,15,3,0,-2,3,8,18,1,0,-3,2,7,-3,2,0,1,68,48,20,12,5,7,11,23,10,9,13,3,12,10,10,5,9,0,-1,13,0,4,4,3,0,6,3,-1,3,0,2,-1,2,0,1,0,-2,7,1,-1,2,0,65,24,41,5,1,4,1,23,23,-3,7,1,-3,7,19,-2,2,-6,4,16,4,-1,5,7,-1,1,2,0,2,1,1,1,-2,2,-1,0,-2,0,4,-2,3,1,87,60,27,27,7,20,23,-2,41,13,0,6,19,4,28,2,4,1,4,-6,13,11,-4,5,10,-2,7,7,2,2,8,-1,-4,2,1,0,2,-1,11,5,1,2,13,7,6,16,7,9,17,-2,10,-5,-9,-2,16,-1,-3,0,-3,-4,1,-1,13,-5,-6,2,3,2,5,3,2,1,3,1,1,1,1,0,0,1,4,2,1,1,-181,-81,-100,6,1,5,-76,-14,-42,-38,-11,-8,-29,-5,-17,-22,-6,-6,-47,-9,-25,-16,-5,-2,3,3,-2,1,1,0,1,1,-1,0,0,0,2,2,-1,1,1,0,-40,-22,-18,16,7,9,-20,-3,-11,4,-16,1,-12,-5,-6,7,-10,3,-8,2,-5,-3,-6,-2,-1,4,3,7,2,1,0,0,0,5,1,1,-1,4,3,2,1,0,-40,-27,-13,14,7,7,-25,2,-2,-13,5,-6,-16,1,4,-12,0,-4,-9,1,-6,-1,5,-2,3,2,11,-3,1,0,2,0,5,-1,1,0,1,2,6,-2,0,0,15,11,4,11,14,-3,-4,9,5,10,-1,-2,0,7,-4,8,3,-1,-4,2,9,2,-4,-1,-1,12,4,-2,-3,1,0,12,3,0,-1,0,-1,0,1,-2,-2,1,53,20,33,-1,-7,6,14,17,10,3,8,-1,8,15,-1,-1,2,-3,6,2,11,4,6,2,-6,9,5,-7,-2,0,-7,5,0,-3,-2,0,1,4,5,-4,0,0
45,45121,Ocaña,6135,118,67,51,69,35,34,3,39,59,8,3,1,5,30,32,1,-2,-2,-2,9,27,7,5,3,7,21,28,11,1,0,5,13,14,3,0,0,2,8,14,8,1,0,199,127,72,125,74,51,43,48,88,14,4,1,24,30,57,16,0,-1,19,18,31,-2,4,2,27,42,38,12,6,0,13,27,25,7,2,0,14,15,13,5,4,0,108,74,34,122,66,56,13,63,24,2,3,1,15,34,26,1,0,-2,-2,29,-2,1,3,3,30,41,38,9,4,0,15,24,24,3,0,0,15,17,14,6,4,0,137,71,66,110,56,54,38,43,52,18,-11,-4,20,18,34,6,-9,2,18,25,18,12,-2,-6,24,41,31,8,4,2,11,18,20,5,1,1,13,23,11,3,3,1,-28,-20,-8,17,11,6,-19,19,-32,-5,2,9,-12,17,-29,-1,0,4,-7,2,-3,-4,2,5,2,6,7,1,1,0,2,5,4,0,0,0,0,1,3,1,1,0,289,138,151,154,87,67,44,71,94,49,14,12,13,34,52,24,9,5,31,37,42,25,5,7,27,41,54,29,1,0,15,18,34,19,0,0,12,23,20,10,1,0,544,300,244,189,117,72,88,134,204,77,26,11,37,75,120,44,18,4,51,59,84,33,8,7,21,78,49,30,7,3,6,52,34,18,5,1,15,26,15,12,2,2,987,527,460,374,214,160,161,211,377,160,48,13,78,105,220,80,31,4,83,106,157,80,17,9,70,124,109,54,10,3,38,63,70,35,6,0,32,61,39,19,4,3,583,326,257,219,122,97,80,127,223,123,17,7,34,66,135,76,8,1,46,61,88,47,9,6,49,44,82,39,4,0,25,23,49,21,3,0,24,21,33,18,1,0,485,237,248,173,83,90,89,98,136,96,37,17,35,48,62,55,21,8,54,50,74,41,16,9,31,64,46,20,8,3,18,22,26,8,7,1,13,42,20,12,1,2,612,313,299,155,80,75,101,108,188,127,49,18,67,47,100,63,23,8,34,61,88,64,26,10,25,49,47,23,7,1,16,24,30,5,3,1,9,25,17,18,4,0,353,216,137,169,82,87,39,50,134,54,68,7,21,35,68,42,40,6,18,15,66,12,28,1,33,49,39,31,12,0,19,22,16,16,7,0,14,27,23,15,5,0,23,31,-8,68,26,42,-7,33,-28,15,6,-4,0,12,-3,8,8,1,-7,21,-25,7,-2,-5,11,38,17,1,-1,1,8,16,4,1,-4,1,3,22,13,0,3,0,-244,-129,-115,-90,-54,-36,-77,-32,-71,-68,16,-19,-40,-11,-40,-38,10,-11,-37,-21,-31,-30,6,-8,-14,-1,-34,-37,-4,-1,-7,-3,-20,-21,-3,-1,-7,2,-14,-16,-1,0,-168,-100,-68,9,-3,12,-24,-15,-44,-76,-8,-5,-5,-11,-23,-64,-5,6,-19,-4,-21,-12,-3,-11,11,7,3,-13,-2,1,8,-2,2,-14,-2,2,3,9,1,1,0,-1,-134,-97,-37,-16,-23,7,-48,22,-79,-32,-8,13,-37,8,-33,-27,-11,9,-11,14,-46,-5,3,4,-7,16,-14,-11,-3,3,-7,5,-10,-9,-2,0,0,11,-4,-2,-1,3,236,104,132,127,59,68,52,33,33,43,44,29,31,7,13,20,24,7,21,26,20,23,20,22,26,29,36,17,13,5,11,16,16,10,5,0,15,13,20,7,8,5,253,129,124,47,8,39,61,26,42,48,26,42,33,14,12,20,15,27,28,12,30,28,11,15,21,23,-4,6,-4,3,9,5,-13,4,-2,3,12,18,9,2,-2,0
45,45122,Olías del Rey,4178,133,79,54,60,40,20,-1,23,73,17,7,7,0,20,39,11,3,1,-1,3,34,6,4,6,3,16,19,14,6,1,2,15,14,5,3,0,1,1,5,9,3,1,109,85,24,66,46,20,2,34,56,9,8,-1,17,19,39,6,3,0,-15,15,17,3,5,-1,5,25,21,13,1,1,5,17,16,8,0,0,0,8,5,5,1,1,144,93,51,86,55,31,7,25,89,3,15,-1,0,20,59,2,10,-3,7,5,30,1,5,2,19,24,28,9,4,0,8,20,18,4,3,0,11,4,10,5,1,0,130,69,61,27,17,10,4,25,82,0,14,2,3,12,40,4,6,0,1,13,42,-4,8,2,7,7,6,2,2,2,6,5,3,1,0,1,1,2,3,1,2,1,120,63,57,91,60,31,15,41,63,-5,2,-1,7,30,31,-3,-1,-1,8,11,32,-2,3,0,14,33,32,9,2,0,12,24,18,5,0,0,2,9,14,4,2,0,117,50,67,61,30,31,-7,22,44,22,11,18,-11,13,33,2,3,6,4,9,11,20,8,12,12,19,9,8,9,0,5,11,4,5,4,0,7,8,5,3,5,0,283,183,100,123,80,43,25,56,127,47,21,7,8,34,74,43,20,3,17,22,53,4,1,4,15,44,34,24,6,0,9,29,20,19,3,0,6,15,14,5,3,0,321,178,143,145,84,61,39,56,108,70,16,24,23,42,48,38,9,13,16,14,60,32,7,11,28,38,40,26,9,2,19,25,17,15,7,1,9,13,23,11,2,1,144,61,83,102,51,51,36,12,51,12,7,18,19,4,29,6,-2,3,17,8,22,6,9,15,15,22,39,20,2,2,8,11,25,6,0,0,7,11,14,14,2,2,202,78,124,71,40,31,43,23,68,30,11,16,25,3,22,11,5,7,18,20,46,19,6,9,9,20,19,16,5,2,5,11,14,9,1,0,4,9,5,7,4,2,50,41,9,47,31,16,-4,13,34,-3,3,4,1,14,16,-2,7,1,-5,-1,18,-1,-4,3,6,11,18,5,5,0,4,9,12,1,3,0,2,2,6,4,2,0,-47,-51,4,36,13,23,-18,-6,-5,-6,-9,1,-19,-7,-5,-11,-6,1,1,1,0,5,-3,0,4,11,15,3,2,1,3,1,9,-1,0,1,1,10,6,4,2,0,-37,-16,-21,-4,-9,5,-18,-3,5,-17,-7,-2,-12,6,-2,-6,-7,2,-6,-9,7,-11,0,-4,3,8,-2,-4,-6,-3,0,4,-3,-3,-5,-2,3,4,1,-1,-1,-1,-51,-16,-35,-37,-26,-11,-30,-8,-20,6,4,-7,1,-6,-14,6,0,-6,-31,-2,-6,0,4,-1,-4,-9,-11,-10,-1,-2,-1,-8,-9,-6,-1,-1,-3,-1,-2,-4,0,-1,43,-6,49,1,0,1,29,3,-14,0,11,15,3,-2,-7,-7,-1,7,26,5,-7,7,12,8,6,4,-5,-3,0,-1,5,2,-3,-4,0,0,1,2,-2,1,0,-1,30,-3,33,-78,-34,-44,21,7,18,-8,-16,0,4,4,7,-19,-4,-1,17,3,11,11,-12,1,-5,2,-21,-34,-14,-6,1,7,-11,-21,-7,-3,-6,-5,-10,-13,-7,-3,163,92,71,-35,-9,-26,32,45,13,29,17,22,20,34,-5,9,18,13,12,11,18,20,-1,9,-3,15,-17,-25,-3,-3,0,14,-8,-16,0,1,-3,1,-9,-9,-3,-4,107,83,24,41,15,26,18,22,9,34,2,15,17,23,-3,26,5,8,1,-1,12,8,-3,7,13,21,2,3,-1,2,5,13,-4,0,0,1,8,8,6,3,-1,1
45,45125,Oropesa,2736,-24,-16,-8,6,2,4,-10,-7,-8,-3,3,1,-5,-5,-4,-3,1,0,-5,-2,-4,0,2,1,2,1,2,1,0,0,1,0,1,0,0,0,1,1,1,1,0,0,31,20,11,10,8,2,-2,4,7,5,7,10,0,3,5,4,4,4,-2,1,2,1,3,6,0,2,3,5,0,0,0,2,2,4,0,0,0,0,1,1,0,0,68,13,55,8,5,3,2,4,31,18,11,3,-1,0,5,3,4,2,3,4,26,15,7,1,0,1,6,1,0,0,0,1,3,1,0,0,0,0,3,0,0,0,-10,-2,-8,6,0,6,-5,-6,-9,4,3,1,-1,-8,-4,5,3,2,-4,2,-5,-1,0,-1,1,4,0,0,0,1,0,0,-1,0,0,1,1,4,1,0,0,0,49,28,21,13,5,8,12,12,17,9,3,-4,6,9,7,6,0,0,6,3,10,3,3,-4,3,4,4,1,1,0,2,2,0,1,0,0,1,2,4,0,1,0,5,8,-3,12,4,8,8,0,-12,4,-2,8,4,-3,-2,4,2,4,4,3,-10,0,-4,4,5,0,6,1,0,0,3,-1,2,0,0,0,2,1,4,1,0,0,27,19,8,12,5,7,4,9,5,10,1,-2,4,3,0,7,6,-1,0,6,5,3,-5,-1,0,4,5,3,0,0,0,1,2,2,0,0,0,3,3,1,0,0,67,42,25,33,17,16,26,10,15,7,6,5,17,9,5,5,3,3,9,1,10,2,3,2,11,16,3,-1,3,1,5,10,1,0,1,0,6,6,2,-1,2,1,10,3,7,5,4,1,8,-7,-7,16,8,-6,5,-4,-9,6,6,-1,3,-3,2,10,2,-5,0,1,2,2,0,0,0,1,2,1,0,0,0,0,0,1,0,0,12,5,7,0,2,-2,-1,0,6,-11,15,4,0,-4,2,-2,8,1,-1,4,4,-9,7,3,0,2,1,-1,-2,0,1,1,0,0,0,0,-1,1,1,-1,-2,0,0,-2,2,14,5,9,9,-4,-7,5,7,-8,1,1,-4,4,3,-7,8,-5,-3,1,4,-1,5,1,4,4,0,0,2,0,2,1,0,0,3,1,2,3,0,0,-2,-1,-1,6,1,5,2,3,-4,1,-2,-1,1,0,-2,2,-3,2,1,3,-2,-1,1,-3,1,3,4,-1,-1,0,0,2,1,-1,-1,0,1,1,3,0,0,0,-31,-20,-11,-4,-4,0,1,-4,-9,-8,-6,-5,2,-6,-7,-4,-2,-3,-1,2,-2,-4,-4,-2,-2,1,0,-1,-2,0,-2,0,1,-2,-1,0,0,1,-1,1,-1,0,-2,0,-2,-8,-7,-1,-6,0,-3,4,1,4,-3,1,-1,1,-1,4,-3,-1,-2,3,2,0,1,-4,-1,-4,0,0,1,-3,-2,-2,-1,0,0,-1,1,-2,1,0,-20,-3,-17,-17,-4,-13,6,-3,-16,-1,-5,-1,6,1,-4,-5,0,0,0,-4,-12,4,-5,-1,-1,1,-12,-3,-1,-2,0,1,-4,-2,0,0,-1,0,-8,-1,-1,-2,-3,1,-4,14,8,6,-3,4,2,-6,0,-1,-2,3,-1,1,0,0,-1,1,3,-7,0,-1,3,2,7,1,0,0,3,1,3,1,0,0,0,1,4,0,0,0,3,1,2,5,1,4,3,-4,-9,0,13,-3,4,-5,-3,-5,9,0,-1,1,-6,5,4,-3,3,-1,0,1,0,1,2,-2,0,1,0,0,1,1,0,0,0,1,-53,-29,-24,-3,-4,1,-9,-13,-17,-13,3,-7,-8,-4,-7,-7,-2,-2,-1,-9,-10,-6,5,-5,1,2,-4,-3,0,0,-2,1,-1,-3,0,0,3,1,-3,0,0,0
45,45133,Polán,3310,35,28,7,22,17,5,-3,4,18,7,4,5,-1,7,12,2,4,4,-2,-3,6,5,0,1,3,7,9,3,0,0,3,5,8,1,0,0,0,2,1,2,0,0,65,36,29,49,34,15,1,29,24,5,4,1,0,11,16,6,1,0,1,18,8,-1,3,1,5,15,23,4,1,0,2,9,18,4,0,0,3,6,5,0,1,0,85,37,48,51,27,24,23,21,9,15,2,12,9,10,2,10,0,5,14,11,7,5,2,7,17,11,13,9,0,1,9,6,7,5,0,0,8,5,6,4,0,1,-2,-11,9,32,16,16,-3,4,-3,1,-4,3,-2,-3,-4,-3,-1,2,-1,7,1,4,-3,1,8,5,14,3,0,1,6,1,7,0,0,1,2,4,7,3,0,0,59,43,16,53,33,20,-1,18,24,10,5,-1,3,12,18,7,2,-2,-4,6,6,3,3,1,6,19,15,10,0,0,4,12,8,6,0,0,2,7,7,4,0,0,44,19,25,51,25,26,14,11,17,8,-1,-2,-3,11,12,3,-1,-2,17,0,5,5,0,0,9,17,15,9,1,0,2,10,9,4,0,0,7,7,6,5,1,0,115,73,42,61,36,25,18,32,15,30,13,7,14,19,12,18,7,3,4,13,3,12,6,4,9,21,20,9,1,1,6,12,11,6,0,1,3,9,9,3,1,0,82,60,22,60,46,14,15,16,32,17,5,0,9,15,22,13,4,-2,6,1,10,4,1,2,4,22,23,8,3,-1,2,18,18,6,2,-1,2,4,5,2,1,0,100,69,31,112,80,32,3,24,46,28,0,0,4,16,35,16,0,-1,-1,8,11,12,0,1,9,19,49,28,7,0,7,13,38,17,5,0,2,6,11,11,2,0,25,-13,38,47,19,28,15,1,2,-8,12,1,-1,-5,-7,-11,6,2,16,6,9,3,6,-1,7,17,20,-1,2,1,1,8,10,-2,0,1,6,9,10,1,2,0,-7,-24,17,36,14,22,9,3,-7,-19,2,2,4,-2,-18,-9,-2,2,5,5,11,-10,4,0,11,9,13,3,-1,1,8,1,4,2,-1,0,3,8,9,1,0,1,-3,9,-12,17,9,8,3,-10,-8,3,11,-1,7,-1,-6,5,3,1,-4,-9,-2,-2,8,-2,2,5,5,3,2,0,3,2,3,1,0,0,-1,3,2,2,2,0,-80,-54,-26,-34,-20,-14,-6,-2,-36,-18,-14,-5,-4,-8,-18,-19,-4,-3,-2,6,-18,1,-10,-2,-8,0,-12,-8,-6,0,-4,0,-6,-7,-3,0,-4,0,-6,-1,-3,0,-55,-44,-11,-37,-31,-6,-7,4,-20,-20,-17,3,-4,5,-19,-21,-7,0,-3,-1,-1,1,-10,3,-1,3,-15,-15,-9,0,0,1,-12,-15,-5,0,-1,2,-3,0,-4,0,-59,-16,-43,1,0,1,-3,-3,-14,-27,-9,-3,5,2,-12,-9,0,-2,-8,-5,-2,-18,-9,-1,-2,1,2,0,0,0,-2,1,1,0,0,0,0,0,1,0,0,0,-19,6,-25,20,16,4,-1,-2,-9,-7,7,-6,6,-4,5,-3,5,-2,-7,2,-14,-4,2,-4,2,4,8,5,1,0,1,2,7,5,1,0,1,2,1,0,0,0,-18,-19,1,5,1,4,8,-10,-7,-7,-10,5,3,-7,-3,-8,-7,2,5,-3,-4,1,-3,3,0,4,0,0,0,0,0,0,1,0,0,0,0,4,-1,0,0,0,-54,-37,-17,17,7,10,-10,4,-28,-22,4,0,-4,3,-16,-18,-1,1,-6,1,-12,-4,5,-1,8,3,0,2,3,1,5,2,-1,0,1,0,3,1,1,2,2,1
45,45136,"Puebla de Montalbán, La",7086,137,88,49,86,55,31,38,27,31,26,10,4,22,22,21,14,6,1,16,5,10,12,4,3,6,28,32,15,4,0,3,16,24,9,2,0,3,12,8,6,2,0,124,70,54,113,70,43,37,25,26,21,8,6,21,16,13,11,4,4,16,9,13,10,4,2,29,25,28,26,3,1,18,16,17,16,2,0,11,9,11,10,1,1,211,120,91,94,49,45,50,53,35,38,22,9,30,23,26,22,13,5,20,30,9,16,9,4,24,21,22,18,4,3,14,11,13,9,2,0,10,10,9,9,2,3,130,62,68,101,48,53,50,19,29,16,13,3,29,5,14,8,6,1,21,14,15,8,7,2,34,28,27,13,0,-1,16,12,16,4,0,0,18,16,11,9,0,-1,124,70,54,57,34,23,32,23,21,16,25,-1,14,13,21,6,13,-2,18,10,0,10,12,1,10,23,13,4,4,0,3,14,10,3,1,0,7,9,3,1,3,0,149,59,90,88,44,44,24,32,42,35,18,-1,7,13,18,21,7,-4,17,19,24,14,11,3,13,18,29,22,2,4,6,8,15,13,1,1,7,10,14,9,1,3,146,116,30,147,93,54,29,34,45,19,13,-1,13,25,50,14,13,1,16,9,-5,5,0,-2,35,32,52,21,3,0,19,21,42,8,2,0,16,11,10,13,1,0,165,132,33,196,130,66,15,56,70,31,-10,-3,7,51,57,21,-4,-3,8,5,13,10,-6,0,24,64,74,29,4,0,9,46,56,16,3,0,15,18,18,13,1,0,136,90,46,140,90,50,24,36,30,23,19,4,10,24,31,8,15,2,14,12,-1,15,4,2,16,51,39,24,5,3,10,31,32,12,4,0,6,20,7,12,1,3,2,-17,19,66,33,33,8,9,-14,16,-4,-12,0,6,-22,11,-6,-6,8,3,8,5,2,-6,9,15,26,12,5,-1,4,8,10,11,1,-1,5,7,16,1,4,0,-91,-79,-12,6,-9,15,-9,-22,-23,-35,3,-2,-13,-23,-12,-26,-3,-1,4,1,-11,-9,6,-1,2,7,-3,2,-3,-2,2,0,-8,0,-2,-1,0,7,5,2,-1,-1,-27,-24,-3,5,-14,19,8,-3,-28,0,-5,-2,0,4,-23,-2,-6,-1,8,-7,-5,2,1,-1,12,10,-6,-8,-2,-1,2,5,-12,-5,-3,-1,10,5,6,-3,1,0,-89,-41,-48,-38,-29,-9,-26,-4,-21,-29,-1,-9,-20,-2,-5,-17,4,-2,-6,-2,-16,-12,-5,-7,-11,-9,-1,-11,-6,-2,-6,-8,-4,-7,-3,-1,-5,-1,3,-4,-3,-1,-77,-51,-26,-6,-9,3,-16,-7,-22,-20,-12,-2,-8,-1,-25,-12,-4,-2,-8,-6,3,-8,-8,0,4,1,-3,-4,-3,-1,1,1,-5,-4,-2,0,3,0,2,0,-1,-1,-112,-49,-63,-19,-19,0,-28,-17,-28,-11,-16,-10,-5,-4,-25,-1,-9,-2,-23,-13,-3,-10,-7,-8,-2,1,-7,-9,-1,-1,-2,-1,-7,-8,0,-1,0,2,0,-1,-1,0,-57,-32,-25,6,-6,12,-3,-17,-16,-17,12,-16,-4,-6,-6,-15,6,-7,1,-11,-10,-2,6,-9,10,4,-3,-10,2,2,5,1,-7,-6,0,1,5,3,4,-4,2,1,-58,-27,-31,-13,-8,-5,-3,-20,-16,-15,0,-5,-3,-13,-4,-7,1,-2,0,-7,-12,-8,-1,-3,-1,-4,-1,-8,-4,2,-2,-1,5,-6,-5,0,1,-3,-6,-2,1,2,-101,-48,-53,-31,-9,-22,-29,-18,-27,-7,-8,-15,-16,-7,-13,4,-13,-5,-13,-11,-14,-11,5,-10,-10,-1,-8,-8,-4,-1,-1,-1,-2,-6,0,0,-9,0,-6,-2,-4,-1
45,45137,"Pueblanueva, La",2017,-4,-5,1,62,35,27,1,2,3,-6,1,-6,0,0,0,-5,1,-2,1,2,3,-1,0,-4,17,14,22,5,1,0,9,6,14,4,1,0,8,8,8,1,0,0,50,27,23,38,25,13,9,12,12,8,0,7,5,5,7,7,0,2,4,7,5,1,0,5,6,9,19,3,0,0,3,6,12,3,0,0,3,3,7,0,0,0,20,15,5,37,18,19,10,10,-4,4,7,-4,7,9,-1,2,4,-4,3,1,-3,2,3,0,12,11,12,1,1,0,5,7,6,0,0,0,7,4,6,1,1,0,11,19,-8,38,21,17,-18,12,8,6,5,0,-5,8,7,5,4,1,-13,4,1,1,1,-1,3,12,13,8,2,0,2,7,7,4,1,0,1,5,6,4,1,0,32,13,19,58,28,30,-8,19,10,0,10,0,-3,9,7,-1,4,-3,-5,10,3,1,6,3,8,26,12,6,6,0,5,12,7,2,2,0,3,14,5,4,4,0,68,38,30,74,41,33,6,26,25,5,4,0,1,10,15,6,4,1,5,16,10,-1,0,-1,10,28,24,9,3,0,4,16,14,5,2,0,6,12,10,4,1,0,95,45,50,50,26,24,26,16,27,15,14,-4,10,5,19,8,8,-5,16,11,8,7,6,1,8,14,18,6,3,1,2,7,12,4,1,0,6,7,6,2,2,1,72,53,19,108,73,35,-8,18,31,14,7,6,-4,15,20,12,3,3,-4,3,11,2,4,3,13,30,36,22,5,1,9,19,25,17,2,0,4,11,11,5,3,1,9,18,-9,14,12,2,-7,6,-6,7,6,2,0,7,0,2,4,3,-7,-1,-6,5,2,-1,0,4,5,3,1,1,0,3,5,3,0,1,0,1,0,0,1,0,11,2,9,13,7,6,5,6,5,0,-5,1,0,5,2,-1,-5,2,5,1,3,1,0,-1,1,8,5,-1,0,0,0,4,3,0,0,0,1,4,2,-1,0,0,17,7,10,9,5,4,13,5,-3,2,0,-6,4,4,-1,0,0,-2,9,1,-2,2,0,-4,3,4,-2,2,1,0,2,4,-3,1,1,0,1,0,1,1,0,0,-4,-8,4,16,5,11,4,-2,-11,-6,11,2,0,-2,-7,-4,5,1,4,0,-4,-2,6,1,6,3,4,1,2,0,3,1,0,1,0,0,3,2,4,0,2,0,8,5,3,2,2,0,4,-3,2,0,3,1,3,-2,3,-2,1,1,1,-1,-1,2,2,0,0,0,-1,0,3,0,0,0,-1,1,2,0,0,0,0,-1,1,0,-3,3,-6,9,7,2,-5,0,3,6,-2,-5,0,2,1,4,-2,-2,-5,-2,2,2,0,-3,3,1,2,3,0,0,3,1,1,2,0,0,0,0,1,1,0,0,5,9,-4,3,1,2,0,4,-6,3,0,2,5,4,-4,1,2,1,-5,0,-2,2,-2,1,0,2,0,1,0,0,0,1,0,0,0,0,0,1,0,1,0,0,-76,-49,-27,-53,-32,-21,-14,-9,-24,-13,-4,-11,-13,-4,-17,-9,-2,-4,-1,-5,-7,-4,-2,-7,-6,-3,-16,-16,-3,-9,-5,-1,-10,-11,-2,-3,-1,-2,-6,-5,-1,-6,11,11,0,2,2,0,14,-2,2,1,-4,-1,8,3,2,0,-1,-1,6,-5,0,1,-3,0,0,0,1,1,0,0,0,0,1,1,0,0,0,0,0,0,0,0,-24,-11,-13,11,3,8,-9,-2,-10,-6,2,1,0,-1,-8,-2,-1,1,-9,-1,-2,-4,3,0,2,0,2,5,1,1,1,-1,0,3,0,0,1,1,2,2,1,1
45,45144,"Real de San Vicente, El",1006,10,9,1,2,1,1,-1,4,0,-1,5,3,-1,3,2,1,2,2,0,1,-2,-2,3,1,0,0,1,1,0,0,0,0,0,1,0,0,0,0,1,0,0,0,1,12,-11,8,7,1,-2,2,4,-3,2,-2,-1,5,7,1,2,-2,-1,-3,-3,-4,0,0,0,3,4,1,0,0,0,3,4,0,0,0,0,0,0,1,0,0,35,11,24,22,16,6,6,13,6,4,4,2,4,3,3,1,1,-1,2,10,3,3,3,3,4,7,9,3,-1,0,2,5,7,3,-1,0,2,2,2,0,0,0,38,19,19,20,13,7,1,4,13,9,8,3,1,1,8,4,3,2,0,3,5,5,5,1,6,3,10,1,0,0,4,2,7,0,0,0,2,1,3,1,0,0,25,15,10,10,6,4,0,6,6,1,8,3,2,2,2,5,2,2,-2,4,4,-4,6,1,1,4,4,1,0,0,1,2,2,1,0,0,0,2,2,0,0,0,3,4,-1,12,7,5,3,-3,-5,3,7,-2,4,-2,-4,1,5,-1,-1,-1,-1,2,2,-1,2,2,4,4,0,0,2,1,2,2,0,0,0,1,2,2,0,0,55,32,23,41,21,20,2,8,5,20,16,6,3,3,4,9,8,6,-1,5,1,11,8,0,8,5,15,10,2,1,5,1,11,3,1,0,3,4,4,7,1,1,42,31,11,46,24,22,11,4,11,8,4,4,2,3,13,8,2,3,9,1,-2,0,2,1,10,11,19,6,0,-1,3,5,12,5,0,-1,7,6,7,1,0,0,-9,-3,-6,0,0,0,-7,-4,3,0,3,-3,-5,2,-2,-1,3,0,-2,-6,5,1,0,-3,-1,1,1,0,-1,0,0,1,0,0,-1,0,-1,0,1,0,0,0,14,21,-7,14,9,5,7,6,1,-4,0,4,2,5,4,1,5,4,5,1,-3,-5,-5,0,7,6,-1,1,1,0,2,5,0,1,1,0,5,1,-1,0,0,0,39,17,22,12,3,9,10,6,10,8,2,3,7,1,4,4,-1,2,3,5,6,4,3,1,2,2,3,4,0,1,1,0,0,1,0,1,1,2,3,3,0,0,-8,-8,0,8,3,5,-5,4,-10,-1,4,0,-2,0,-4,0,1,-2,-3,4,-6,-1,3,2,0,5,2,1,1,-1,2,1,1,0,0,-1,-2,4,1,1,1,0,-10,-10,0,2,0,2,-1,4,-5,-7,0,-3,-2,-1,-4,-4,0,-1,1,5,-1,-3,0,-2,0,1,1,-1,0,0,-1,0,1,-1,0,0,1,1,0,0,0,0,-43,-21,-22,-24,-14,-10,-13,-7,-10,-9,-1,-2,-6,-1,-6,-6,-1,1,-7,-6,-4,-3,0,-3,-3,-4,-11,-3,-2,-1,-2,-2,-6,-2,-2,0,-1,-2,-5,-1,0,-1,20,2,18,-9,-10,1,2,11,3,0,1,0,0,4,0,-2,0,0,2,7,3,2,1,0,0,2,-5,-8,1,-1,0,0,-4,-7,1,0,0,2,-1,-1,0,-1,-15,-10,-5,5,1,4,-3,2,-6,-2,0,-4,-1,2,-6,-2,-2,0,-2,0,0,0,2,-4,1,3,0,1,0,0,1,2,-1,0,-1,0,0,1,1,1,1,0,-24,-9,-15,-16,-9,-7,0,-4,-12,-4,-5,1,1,-2,-7,1,-3,1,-1,-2,-5,-5,-2,0,-3,-1,-5,-3,-4,0,-2,0,-3,-2,-2,0,-1,-1,-2,-1,-2,0,-9,1,-10,5,4,1,-2,0,3,-4,-2,-5,-1,4,4,-5,1,-3,-1,-4,-1,1,-3,-2,0,1,2,1,1,-1,0,1,2,0,1,-1,0,0,0,1,0,0
45,45145,Recas,2610,152,112,40,117,93,24,24,36,47,32,7,5,14,39,37,20,2,0,10,-3,10,12,5,5,9,42,43,21,1,0,4,37,34,17,0,0,5,5,9,4,1,0,160,121,39,174,134,40,16,48,69,22,5,-2,6,35,58,18,4,-1,10,13,11,4,1,-1,18,48,81,21,4,0,8,37,70,16,3,0,10,11,11,5,1,0,90,62,28,129,94,35,14,25,28,10,6,6,1,21,26,12,-1,3,13,4,2,-2,7,3,14,47,45,16,5,1,7,35,38,14,0,0,7,12,7,2,5,1,-13,-13,0,62,44,18,-11,2,0,-7,-1,5,-9,4,-3,-7,1,2,-2,-2,3,0,-2,3,3,24,25,9,1,0,2,17,20,4,1,0,1,7,5,5,0,0,25,17,8,75,61,14,-7,7,9,3,5,7,-2,5,3,4,2,4,-5,2,6,-1,3,3,8,19,35,13,0,0,7,14,30,10,0,0,1,5,5,3,0,0,91,24,67,69,52,17,24,30,3,15,2,11,13,16,-14,8,-2,2,11,14,17,7,4,9,6,26,27,7,1,2,4,22,20,6,0,0,2,4,7,1,1,2,174,122,52,134,104,30,19,59,50,34,3,7,12,38,42,21,5,2,7,21,8,13,-2,5,11,50,47,23,3,0,7,38,39,19,1,0,4,12,8,4,2,0,217,162,55,151,117,34,12,86,71,27,7,6,9,65,59,15,6,3,3,21,12,12,1,3,10,58,56,19,2,1,4,49,44,13,1,1,6,9,12,6,1,0,267,195,72,202,173,29,28,94,102,26,4,6,12,77,72,24,2,3,16,17,30,2,2,3,17,85,72,22,4,1,14,74,65,17,3,0,3,11,7,5,1,1,185,119,66,115,80,35,37,40,72,34,-5,4,28,25,46,22,-4,0,9,15,26,12,-1,4,19,34,46,14,1,0,13,23,33,9,1,0,6,11,13,5,0,0,136,82,54,74,51,23,20,32,54,13,12,3,7,15,40,10,7,2,13,17,14,3,5,1,7,22,29,11,3,1,3,14,23,9,2,0,4,8,6,2,1,1,102,59,43,54,27,27,19,12,43,9,8,10,13,-1,29,3,10,3,6,13,14,6,-2,7,8,14,21,8,1,2,6,6,12,3,0,0,2,8,9,5,1,2,24,-5,29,36,20,16,1,1,21,-2,5,-6,-2,-3,6,-2,-2,-4,3,4,15,0,7,-2,2,10,17,4,2,1,0,4,10,4,1,1,2,6,7,0,1,0,93,33,60,20,13,7,48,18,9,2,22,-5,17,5,2,0,14,-1,31,13,7,2,8,-4,6,5,7,2,0,0,2,3,5,3,0,0,4,2,2,-1,0,0,57,32,25,10,6,4,14,10,3,3,12,7,13,7,7,-2,1,1,1,3,-4,5,11,6,3,5,-1,0,1,1,2,4,1,-2,0,1,1,1,-2,2,1,0,-24,-13,-11,19,16,3,-9,16,-24,-10,-1,4,-1,10,-20,-10,4,4,-8,6,-4,0,-5,0,5,6,7,-2,1,2,6,3,8,-2,0,1,-1,3,-1,0,1,1,-123,-73,-50,20,1,19,-53,-3,-38,-30,-7,8,-23,0,-32,-19,-4,4,-30,-3,-6,-11,-3,4,6,9,1,1,2,0,3,6,-5,-3,0,0,3,3,6,4,2,0,2,-18,20,43,16,27,16,9,-5,-14,-2,4,5,6,-8,-18,-1,-1,11,3,3,4,-1,5,7,16,2,15,1,1,5,6,-1,5,0,0,2,10,3,10,1,1
45,45157,Santa Cruz del Retamar,1614,73,33,40,12,4,8,14,7,20,15,11,7,10,2,7,5,7,3,4,5,13,10,4,4,0,1,4,4,3,0,0,0,1,2,1,0,0,1,3,2,2,0,76,44,32,18,9,9,22,7,13,22,13,-1,10,7,4,16,7,0,12,0,9,6,6,-1,6,3,6,2,1,0,0,3,4,1,1,0,6,0,2,1,0,0,143,74,69,39,18,21,25,29,40,16,21,8,14,13,23,5,12,3,11,16,17,11,9,5,7,15,10,4,2,0,2,5,8,1,1,0,5,10,2,3,1,0,228,130,98,38,23,15,63,30,62,40,13,16,38,15,35,23,7,9,25,15,27,17,6,7,16,6,10,5,0,0,10,3,7,3,0,0,6,3,3,2,0,0,127,68,59,33,21,12,21,22,41,27,20,-7,10,13,22,19,10,-7,11,9,19,8,10,0,5,9,10,6,2,0,4,7,6,3,0,0,1,2,4,3,2,0,228,106,122,32,15,17,46,35,67,39,22,13,15,14,38,23,10,2,31,21,29,16,12,11,10,8,4,8,1,1,4,4,1,6,0,0,6,4,3,2,1,1,204,109,95,25,16,9,39,27,64,42,17,6,18,19,33,26,7,5,21,8,31,16,10,1,5,8,8,1,1,2,2,6,6,0,0,2,3,2,2,1,1,0,154,82,72,47,27,20,30,7,66,32,7,7,13,5,35,17,7,0,17,2,31,15,0,7,15,13,12,8,0,-1,9,11,3,4,0,0,6,2,9,4,0,-1,100,63,37,46,31,15,13,17,29,3,23,9,12,10,18,3,12,5,1,7,11,0,11,4,6,12,16,7,1,2,4,7,13,4,0,2,2,5,3,3,1,0,40,19,21,9,3,6,9,3,0,14,2,11,9,-4,-5,12,1,5,0,7,5,2,1,6,-2,5,1,1,1,2,-3,3,0,1,0,1,1,2,1,0,1,1,54,36,18,13,3,10,23,-1,13,14,3,4,17,-4,9,7,7,1,6,3,4,7,-4,3,4,-2,3,1,3,3,5,-4,-1,0,2,1,-1,2,4,1,1,2,27,20,7,12,2,10,8,13,-2,-2,9,4,-6,11,3,6,6,1,14,2,-5,-8,3,3,3,4,4,0,1,0,1,0,2,0,0,-1,2,4,2,0,1,1,-12,-13,1,10,2,8,-12,-8,-14,11,5,7,-7,-3,-4,-3,5,2,-5,-5,-10,14,0,5,0,5,3,1,1,0,-2,3,1,-1,1,0,2,2,2,2,0,0,-42,-33,-9,1,-1,2,-4,-7,-7,-21,1,-3,-6,-8,-12,-8,5,-4,2,1,5,-13,-4,1,3,5,1,-3,-3,-2,1,1,0,-1,-1,-1,2,4,1,-2,-2,-1,-41,-18,-23,1,0,1,-14,-13,0,-17,-3,8,-9,-4,2,-4,-3,1,-5,-9,-2,-13,0,7,-1,0,2,-1,0,0,-1,0,1,0,0,0,0,0,1,-1,0,0,-4,-7,3,-2,-1,-1,-8,4,1,-10,6,1,0,0,1,-10,1,0,-8,4,0,0,5,1,-2,1,0,-5,4,0,0,0,0,-3,2,0,-2,1,0,-2,2,0,34,22,12,12,3,9,-6,2,3,23,-18,26,4,2,8,7,-9,9,-10,0,-5,16,-9,17,3,3,3,0,1,1,1,2,1,-1,0,0,2,1,2,1,1,1,90,52,38,14,9,5,22,-7,25,12,19,19,11,-2,14,13,9,7,11,-5,11,-1,10,12,2,3,0,2,4,3,1,3,-1,1,3,2,1,0,1,1,1,1
45,45161,Seseña,3978,527,289,238,89,52,37,135,76,193,83,19,10,76,33,114,42,12,5,59,43,79,41,7,5,15,27,28,13,4,2,9,13,22,6,1,1,6,14,6,7,3,1,433,219,214,122,63,59,102,59,141,84,32,8,40,33,72,42,21,4,62,26,69,42,11,4,24,36,31,22,5,2,8,20,19,9,3,2,16,16,12,13,2,0,941,475,466,123,64,59,207,153,323,160,50,18,103,77,154,94,25,5,104,76,169,66,25,13,34,31,40,12,1,3,17,16,23,6,1,1,17,15,17,6,0,2,1027,551,476,159,86,73,214,144,360,199,62,19,126,71,182,120,37,5,88,73,178,79,25,14,26,54,40,30,6,0,11,30,22,19,2,0,15,24,18,11,4,0,1579,833,746,173,96,77,335,217,640,253,72,18,182,96,340,142,39,8,153,121,300,111,33,10,29,49,59,26,2,4,13,23,40,14,2,1,16,26,19,12,0,3,1462,805,657,196,100,96,319,202,538,255,83,21,171,103,302,147,49,11,148,99,236,108,34,10,31,46,76,28,10,3,18,19,39,20,4,0,13,27,37,8,6,3,1277,655,622,308,183,125,237,186,492,205,70,29,123,85,259,118,28,15,114,101,233,87,42,14,44,82,98,56,12,5,30,50,52,36,3,4,14,32,46,20,9,1,1547,823,724,345,194,151,280,230,583,254,101,32,132,112,327,154,55,11,148,118,256,100,46,21,49,78,106,65,22,5,25,49,59,29,13,5,24,29,47,36,9,0,2221,1191,1030,378,204,174,387,389,910,307,101,40,205,185,494,192,54,13,182,204,416,115,47,27,57,81,135,53,29,0,28,40,82,28,17,-2,29,41,53,25,12,2,1096,540,556,166,70,96,244,153,455,114,44,29,135,53,235,58,17,13,109,100,220,56,27,16,29,46,51,16,7,4,17,12,24,10,-1,2,12,34,27,6,8,2,809,383,426,63,23,40,135,105,340,145,24,20,58,34,172,90,19,2,77,71,168,55,5,18,-5,34,-7,14,6,2,-1,14,-2,1,4,1,-4,20,-5,13,2,1,369,203,166,49,0,49,87,31,182,42,6,-18,47,12,83,36,8,-13,40,19,99,6,-2,-5,10,5,-1,15,3,-1,0,-7,-5,3,0,-2,10,12,4,12,3,1,1142,602,540,20,-1,21,208,204,403,186,62,26,118,92,221,94,39,12,90,112,182,92,23,14,2,0,-6,8,-5,9,4,0,-10,-1,-5,4,-2,0,4,9,0,5,482,242,240,26,-7,33,83,96,167,38,50,19,37,56,110,-4,17,8,46,40,57,42,33,11,14,27,-19,-15,11,1,5,11,-16,-17,3,3,9,16,-3,2,8,-2,129,96,33,-132,-67,-65,94,12,66,-59,-14,0,59,4,54,-30,-2,-3,35,8,12,-29,-12,3,-6,1,-44,-62,-15,-9,4,1,-27,-35,-9,-2,-10,0,-17,-27,-6,-7,430,217,213,85,36,49,114,11,146,68,38,37,57,1,81,32,20,13,57,10,65,36,18,24,-1,18,40,6,15,6,-4,10,26,-2,6,-1,3,8,14,8,9,7,709,298,411,-43,-63,20,198,90,238,80,34,24,89,46,102,23,11,4,109,44,136,57,23,20,10,35,-6,-57,-15,-13,2,21,-9,-55,-16,-9,8,14,3,-2,1,-4,981,467,514,253,95,158,297,94,306,129,56,52,140,45,163,57,17,14,157,49,143,72,39,38,68,58,79,14,19,4,33,31,32,-8,2,-4,35,27,47,22,17,8
45,45165,Talavera de la Reina,73204,347,204,143,30,17,13,142,30,51,98,-13,37,84,22,17,71,-9,14,58,8,34,27,-4,23,5,4,4,3,9,4,3,2,2,2,5,2,2,2,2,1,4,2,-87,-42,-45,34,19,15,69,-59,-61,-36,17,-6,47,-35,-41,-12,5,1,22,-24,-20,-24,12,-7,12,6,6,4,5,1,7,2,4,2,3,1,5,4,2,2,2,0,199,98,101,12,8,4,182,4,-29,43,-4,-7,88,-3,-23,32,-5,4,94,7,-6,11,1,-11,8,-2,-9,7,0,8,4,4,-5,2,-1,4,4,-6,-4,5,1,4,-587,-295,-292,-19,-5,-14,62,-144,-268,-137,-69,-18,26,-61,-122,-83,-33,-16,36,-83,-146,-54,-36,-2,3,-4,-11,-5,2,-4,2,0,-5,-2,3,-3,1,-4,-6,-3,-1,-1,1332,716,616,1030,566,464,361,318,331,256,61,-4,176,151,192,147,29,9,185,167,139,109,32,-13,153,306,311,189,44,22,81,166,176,110,23,8,72,140,135,79,21,14,1440,731,709,1194,641,553,348,367,422,224,29,37,140,209,215,125,15,24,208,158,207,99,14,13,202,354,338,236,46,12,95,180,193,141,23,5,107,174,145,95,23,7,1543,922,621,1842,1048,794,284,438,487,274,26,20,145,244,329,181,16,-5,139,194,158,93,10,25,279,547,553,350,83,22,137,304,351,198,43,8,142,243,202,152,40,14,1818,1025,793,1960,1121,839,314,528,558,320,71,20,187,273,328,195,29,3,127,255,230,125,42,17,310,556,591,373,97,23,165,290,377,234,34,12,145,266,214,139,63,11,542,223,319,868,486,382,152,105,105,95,-1,57,87,26,37,41,5,17,65,79,68,54,-6,40,156,238,287,154,28,-2,87,129,165,86,15,1,69,109,122,68,13,-3,-169,-184,15,297,101,196,7,-25,-146,-93,-1,74,4,-15,-85,-82,-25,11,3,-10,-61,-11,24,63,87,84,78,16,17,5,41,34,20,-3,2,1,46,50,58,19,15,4,-269,-267,-2,387,166,221,27,-23,-106,-129,-67,38,-13,-41,-104,-85,-38,17,40,18,-2,-44,-29,21,71,134,82,68,17,11,32,66,35,21,5,4,39,68,47,47,12,7,99,13,86,477,230,247,1,63,-20,13,-18,46,-6,38,-27,-1,-14,18,7,25,7,14,-4,28,71,168,110,75,24,23,35,80,60,32,11,10,36,88,50,43,13,13,-309,-222,-87,161,42,119,-9,-136,-84,-94,2,3,1,-63,-89,-62,-8,-2,-10,-73,5,-32,10,5,46,61,29,14,6,2,23,23,-1,-2,-2,0,23,38,30,16,8,2,-1751,-967,-784,-1281,-737,-544,-269,-273,-471,-510,-192,-43,-99,-141,-272,-326,-114,-14,-170,-132,-199,-184,-78,-29,-202,-103,-356,-384,-182,-59,-92,-57,-206,-254,-108,-21,-110,-46,-150,-130,-74,-38,-1697,-986,-711,-946,-617,-329,-212,-215,-629,-482,-176,20,-139,-119,-339,-313,-93,13,-73,-96,-290,-169,-83,7,-54,-56,-396,-332,-108,-4,-22,-37,-253,-227,-76,-3,-32,-19,-143,-105,-32,-1,-422,-230,-192,21,-10,31,-46,-125,-177,-74,-32,23,-4,-64,-93,-45,-32,0,-42,-61,-84,-29,0,23,4,28,-11,-20,10,2,3,5,-9,-14,0,0,1,23,-2,-6,10,2,-956,-598,-358,-605,-387,-218,-157,-134,-376,-255,-87,45,-70,-78,-214,-204,-57,24,-87,-56,-162,-51,-30,21,-55,-26,-215,-216,-82,-17,-16,-31,-130,-149,-54,-9,-39,5,-85,-67,-28,-8,-222,-161,-61,4,-37,41,49,-89,-154,-86,-28,74,21,-27,-118,-63,-23,40,28,-62,-36,-23,-5,34,19,32,-30,-22,-24,22,4,23,-24,-32,-24,10,15,9,-6,10,0,12
45,45166,Tembleque,2101,40,22,18,24,12,12,5,13,10,7,3,1,4,6,5,6,1,0,1,7,5,1,2,1,3,7,8,3,0,1,2,4,4,2,0,0,1,3,4,1,0,1,27,15,12,18,11,7,3,2,0,7,7,9,0,-1,2,5,2,7,3,3,-2,2,5,2,2,5,6,4,1,0,2,3,4,2,0,0,0,2,2,2,1,0,31,7,24,14,8,6,1,7,6,6,7,5,1,2,-2,3,4,0,0,5,8,3,3,5,5,2,2,5,0,0,3,0,1,4,0,0,2,2,1,1,0,0,23,13,10,25,11,14,17,-1,5,1,0,1,14,-4,3,0,0,0,3,3,2,1,0,1,10,5,6,4,0,0,7,2,2,0,0,0,3,3,4,4,0,0,48,33,15,19,12,7,13,7,11,4,8,3,9,5,7,3,7,1,4,2,4,1,1,2,6,6,6,1,0,0,3,5,4,0,0,0,3,1,2,1,0,0,57,28,29,23,12,11,6,14,21,5,7,5,2,10,12,0,2,2,4,4,9,5,5,3,4,6,8,4,1,0,4,3,3,2,0,0,0,3,5,2,1,0,50,23,27,44,15,29,24,0,15,18,-3,-5,12,2,-3,13,0,-1,12,-2,18,5,-3,-4,14,7,13,8,1,1,7,2,4,1,1,0,7,5,9,7,0,1,57,36,21,40,30,10,12,4,20,9,4,7,8,2,17,9,0,0,4,2,3,0,4,7,5,11,15,8,0,0,4,8,12,6,0,0,1,3,3,2,0,0,49,28,21,48,24,24,11,7,11,7,6,5,-1,7,12,4,3,2,12,0,-1,3,3,3,10,13,13,8,3,0,1,9,9,4,0,0,9,4,4,4,3,0,46,28,18,32,19,13,7,2,10,20,-1,4,4,4,0,16,1,2,3,-2,10,4,-2,2,1,7,13,10,0,0,1,3,8,6,0,0,0,4,5,4,0,0,-8,-2,-6,16,12,4,-8,6,0,-6,-2,1,-4,4,2,-5,0,0,-4,2,-2,-1,-2,1,0,5,7,4,0,0,0,3,6,3,0,0,0,2,1,1,0,0,-12,-11,-1,26,12,14,1,0,4,-11,-3,-6,3,-5,3,-7,-4,-3,-2,5,1,-4,1,-3,2,9,5,5,3,2,1,4,3,2,0,2,1,5,2,3,3,0,-16,-6,-10,17,12,5,-4,4,-6,-5,1,-6,-3,5,-4,-3,3,-3,-1,-1,-2,-2,-2,-3,3,5,5,3,1,0,3,3,4,1,1,0,0,2,1,2,0,0,-39,-28,-11,9,4,5,-3,-2,-15,-12,-3,-6,1,-3,-12,-9,-2,-4,-4,1,-3,-3,-1,-2,2,3,0,2,2,0,2,1,0,1,0,0,0,2,0,1,2,0,-27,-12,-15,-3,-2,-1,-5,-7,-10,-4,4,-5,-1,-3,-4,-5,1,0,-4,-4,-6,1,3,-5,0,0,-1,-2,0,0,0,0,0,-2,0,0,0,0,-1,0,0,0,-42,-22,-20,2,2,0,-5,-3,-15,-8,-6,-6,-6,2,-6,-7,-2,-4,1,-5,-9,-1,-4,-2,4,-1,2,-3,-1,0,1,0,1,-1,0,0,3,-1,1,-2,-1,0,-23,-17,-6,5,2,3,-5,-10,-2,-6,3,-3,-2,-3,-5,-3,0,-4,-3,-7,3,-3,3,1,0,1,1,1,2,0,0,0,0,1,1,0,0,1,1,0,1,0,-14,-4,-10,8,-1,9,-9,-1,-4,-3,2,-1,-4,3,-3,0,0,-2,-5,-4,-1,-3,2,1,-1,4,-4,2,6,1,-1,1,-4,1,1,1,0,3,0,1,5,0
45,45167,"Toboso, El",2088,12,12,0,25,13,12,2,1,6,4,-2,1,2,2,4,4,0,0,0,-1,2,0,-2,1,4,5,13,3,0,0,1,4,7,1,0,0,3,1,6,2,0,0,47,42,5,55,39,16,-4,13,21,12,7,-2,1,13,16,8,5,-1,-5,0,5,4,2,-1,1,17,22,12,2,0,0,13,15,9,1,0,1,4,7,3,1,0,6,13,-7,36,20,16,-1,5,-4,3,4,-1,-3,6,2,6,0,1,2,-1,-6,-3,4,-2,5,9,13,4,4,0,3,5,6,4,1,0,2,4,7,0,3,0,12,-3,15,49,25,24,1,12,-5,5,5,-6,-2,4,-6,3,2,-4,3,8,1,2,3,-2,12,17,11,8,1,0,7,9,4,5,0,0,5,8,7,3,1,0,29,14,15,47,28,19,7,13,2,4,5,-3,3,9,-1,3,1,-2,4,4,3,1,4,-1,5,19,15,6,2,0,2,12,9,5,0,0,3,7,6,1,2,0,46,45,1,70,51,19,2,22,10,9,5,-2,2,16,18,6,3,0,0,6,-8,3,2,-2,0,33,23,10,4,0,0,22,19,7,3,0,0,11,4,3,1,0,28,19,9,46,27,19,-3,18,8,2,4,-1,0,6,8,3,2,1,-3,12,0,-1,2,-2,3,23,17,3,0,-1,2,12,11,2,0,0,1,11,6,1,0,-1,73,45,28,115,73,42,21,33,16,2,-2,2,8,23,11,0,2,1,13,10,5,2,-4,1,18,38,41,16,1,1,6,29,28,10,0,0,12,9,13,6,1,1,1,-11,12,21,6,15,10,-9,-10,4,6,0,3,-7,-8,-1,3,-1,7,-2,-2,5,3,1,2,4,6,6,3,0,1,1,2,1,1,0,1,3,4,5,2,0,13,16,-3,18,10,8,-3,11,3,-5,5,3,0,8,4,-3,2,5,-3,3,-1,-2,3,-2,2,9,3,3,1,0,1,6,2,1,0,0,1,3,1,2,1,0,0,7,-7,12,2,10,-1,0,0,5,1,-5,3,-3,1,7,1,-2,-4,3,-1,-2,0,-3,-1,6,7,1,-1,0,0,-1,4,0,-1,0,-1,7,3,1,0,0,-35,-22,-13,-9,-7,-2,1,-9,-26,1,-6,3,0,-4,-16,0,-4,1,1,-5,-10,1,-2,2,2,-1,-11,2,-2,0,1,-1,-8,1,-1,0,1,0,-3,1,-1,0,-35,-15,-20,14,8,6,-14,-11,-5,-9,2,2,-7,-11,-1,1,2,1,-7,0,-4,-10,0,1,0,4,5,4,0,1,0,1,2,4,0,1,0,3,3,0,0,0,6,-8,14,-5,-7,2,8,0,7,-10,5,-4,2,-1,-1,-8,2,-2,6,1,8,-2,3,-2,-1,0,0,-5,1,0,-1,-1,0,-5,0,0,0,1,0,0,1,0,-34,-7,-27,4,6,-2,-11,-5,-15,4,-2,-4,-2,-5,-3,3,2,-2,-9,0,-12,1,-4,-2,2,4,1,-2,-1,0,2,2,1,1,0,0,0,2,0,-3,-1,0,-17,-13,-4,1,-1,2,7,-8,-7,-6,-1,-1,3,-5,-5,-4,-1,-1,4,-3,-2,-2,0,0,1,0,-1,1,-1,1,0,0,-2,1,0,0,1,0,1,0,-1,1,-12,-6,-6,18,11,7,1,-5,0,-6,4,-4,1,-3,-1,-4,4,-3,0,-2,1,-2,0,-1,2,1,5,6,3,0,1,1,3,4,1,0,1,0,2,2,2,0,-103,-63,-40,-84,-49,-35,-20,0,-47,-28,-11,3,-8,1,-21,-26,-10,1,-12,-1,-26,-2,-1,2,-11,2,-37,-28,-11,0,-6,3,-17,-21,-9,0,-5,-1,-20,-7,-2,0
45,45168,Toledo,67617,651,278,373,396,172,224,322,17,191,80,-18,52,160,4,76,29,-16,22,162,13,115,51,-2,30,52,130,134,66,8,2,32,39,63,32,2,1,20,91,71,34,6,1,1257,544,713,637,301,336,335,171,447,267,-1,29,173,82,178,106,-10,8,162,89,269,161,9,21,124,144,195,134,29,5,65,64,100,54,13,1,59,80,95,80,16,4,555,215,340,313,149,164,241,43,214,124,-61,-2,111,29,61,52,-37,-1,130,14,153,72,-24,-1,73,80,88,57,12,2,36,44,38,27,4,0,37,36,50,30,8,2,451,183,268,184,88,96,226,30,117,127,-40,-1,124,26,19,53,-43,5,102,4,98,74,3,-6,33,41,44,47,16,2,16,25,16,23,7,0,17,16,28,24,9,2,1467,713,754,706,358,348,280,275,508,310,36,67,157,129,258,128,16,31,123,146,250,182,20,36,100,173,227,146,44,10,46,88,132,68,19,4,54,85,95,78,25,6,1659,824,835,798,398,400,296,372,611,252,80,59,144,156,297,152,61,27,152,216,314,100,19,32,183,232,217,92,45,17,93,113,121,44,19,5,90,119,96,48,26,12,1471,728,743,1289,669,620,272,364,581,263,30,-31,144,195,268,120,15,-11,128,169,313,143,15,-20,170,387,394,262,53,14,89,193,220,133,22,6,81,194,174,129,31,8,1475,766,709,1467,783,684,240,460,561,135,18,71,109,245,305,58,17,39,131,215,256,77,1,32,225,455,490,231,44,13,96,247,281,125,20,9,129,208,209,106,24,4,882,459,423,740,369,371,175,234,353,140,-22,20,103,126,150,68,-5,21,72,108,203,72,-17,-1,138,233,250,100,16,-4,73,120,120,49,1,2,65,113,130,51,15,-6,62,17,45,100,-36,136,71,-28,66,-3,-31,-7,75,-33,15,-15,-22,2,-4,5,51,12,-9,-9,67,54,-8,-4,-21,1,40,7,-42,-33,-14,0,27,47,34,29,-7,1,360,206,154,48,-86,134,79,197,266,-105,-56,4,34,138,156,-62,-34,-13,45,59,110,-43,-22,17,27,76,16,-58,-21,0,6,9,-29,-51,-24,-1,21,67,45,-7,3,1,507,241,266,106,-16,122,85,123,205,46,18,18,65,30,100,17,7,20,20,93,105,29,11,-2,26,104,-26,-15,-2,8,9,24,-20,-26,-9,4,17,80,-6,11,7,4,-494,-283,-211,-92,-59,-33,14,17,-247,-124,-97,-47,-2,21,-167,-65,-56,-11,16,-4,-80,-59,-41,-36,10,18,-38,-65,-16,-4,7,21,-42,-38,-10,1,3,-3,4,-27,-6,-5,-660,-319,-341,-382,-241,-141,-36,-6,-286,-256,-54,-27,3,16,-191,-106,-38,-4,-39,-22,-95,-150,-16,-23,-17,-15,-166,-133,-41,-10,-3,-24,-89,-89,-28,-7,-14,9,-77,-44,-13,-3,-511,-217,-294,-212,-140,-72,-73,-50,-138,-145,-102,-4,-28,-4,-67,-59,-61,-3,-45,-46,-71,-86,-41,-1,11,14,-107,-94,-43,-1,5,1,-69,-61,-18,-2,6,13,-38,-33,-25,1,-92,-93,1,193,77,116,42,67,-136,-28,-54,9,13,39,-59,-27,-34,-20,29,28,-77,-1,-20,29,25,143,-14,20,4,7,19,57,4,-3,-1,-1,6,86,-18,23,5,8,55,-47,102,250,74,176,93,70,-51,-17,-50,15,49,5,-67,-14,-17,-2,44,65,16,-3,-33,17,56,125,50,-9,6,11,32,27,18,-25,10,7,24,98,32,16,-4,4,485,165,320,675,268,407,114,236,74,-3,7,53,45,129,21,-34,-3,9,69,107,53,31,10,44,118,268,152,75,27,23,49,133,62,13,1,3,69,135,90,62,26,20
45,45180,Valmojado,2374,33,16,17,27,16,11,1,7,20,1,3,0,-2,2,13,2,1,0,3,5,7,-1,2,0,0,8,12,7,0,0,0,4,6,6,0,0,0,4,6,1,0,0,100,56,44,81,48,33,21,27,31,20,-3,2,10,14,19,13,-1,0,11,13,12,7,-2,2,16,15,31,18,0,0,7,7,19,14,0,0,9,8,12,4,0,0,126,59,67,87,44,43,51,13,36,25,8,-6,23,2,22,12,4,-4,28,11,14,13,4,-2,25,22,21,16,3,0,12,11,12,8,1,0,13,11,9,8,2,0,144,88,56,65,34,31,21,43,53,15,10,-1,15,20,35,7,7,1,6,23,18,8,3,-2,14,27,16,5,1,0,9,12,8,3,0,0,5,15,8,2,1,0,177,100,77,34,16,18,30,20,82,28,9,6,18,8,45,18,5,5,12,12,37,10,4,1,6,11,12,2,1,1,3,2,7,2,1,1,3,9,5,0,0,0,111,56,55,38,22,16,24,26,41,15,0,4,10,12,31,4,-4,3,14,14,10,11,4,1,8,11,13,3,1,0,6,5,8,2,0,0,2,6,5,1,1,0,183,108,75,65,31,34,23,60,70,14,16,2,10,30,49,10,10,-1,13,30,21,4,6,3,12,21,17,13,2,0,6,9,9,6,1,0,6,12,8,7,1,0,211,141,70,94,55,39,30,54,69,35,18,10,22,37,47,23,10,5,8,17,22,12,8,5,17,26,18,23,7,2,12,14,8,15,5,0,5,12,10,8,2,2,224,150,74,62,37,25,32,21,98,46,13,9,26,5,75,30,11,2,6,16,23,16,2,7,11,12,27,9,1,0,6,4,20,6,0,0,5,8,7,3,1,0,212,87,125,22,2,20,55,51,65,16,16,7,20,29,28,1,9,3,35,22,37,15,7,4,9,11,2,-2,2,0,3,1,0,-1,-1,0,6,10,2,-1,3,0,166,69,97,53,23,30,41,28,55,14,16,4,16,5,30,6,7,3,25,23,25,8,9,1,13,12,12,10,4,1,8,3,4,6,2,0,5,9,8,4,2,1,-51,-21,-30,-21,-16,-5,-20,-3,-33,-5,3,7,-13,0,-8,-3,3,-2,-7,-3,-25,-2,0,9,-4,0,-19,1,0,-1,-2,2,-15,-3,2,-1,-2,-2,-4,4,-2,0,107,52,55,15,6,9,29,23,0,18,6,27,22,9,-3,12,5,6,7,14,3,6,1,21,0,4,11,-2,0,1,0,4,4,-1,-1,0,0,0,7,-1,1,1,-65,-39,-26,29,9,20,-16,-15,-14,-17,-7,1,-6,-10,-10,-10,-4,-3,-10,-5,-4,-7,-3,4,14,7,3,2,1,2,5,2,-1,2,0,0,9,5,4,0,1,2,-60,-33,-27,6,4,2,-2,-9,-31,-10,-14,7,-11,-4,-8,-2,-10,2,9,-5,-23,-8,-4,5,3,0,4,-3,1,1,2,0,4,-2,0,0,1,0,0,-1,1,1,26,2,24,51,28,23,1,9,9,-1,0,6,0,5,2,-6,0,-1,1,4,7,5,0,7,11,13,11,14,2,0,5,7,7,9,0,0,6,6,4,5,2,0,6,-19,25,5,-8,13,7,-10,-10,0,8,8,-11,-9,0,2,-1,-1,18,-1,-10,-2,9,9,7,-7,-2,3,2,2,2,-6,-6,1,0,1,5,-1,4,2,2,1,106,62,44,25,8,17,37,10,27,11,6,14,22,9,13,13,5,2,15,1,14,-2,1,12,8,2,5,5,0,5,3,1,0,3,0,1,5,1,5,2,0,4
45,45181,Velada,2372,-2,-6,4,9,5,4,3,-4,-4,-1,6,-2,-3,-4,-3,-1,5,0,6,0,-1,0,1,-2,1,3,3,2,0,0,0,2,1,2,0,0,1,1,2,0,0,0,15,6,9,10,4,6,5,4,0,0,4,2,4,-2,-3,3,2,1,1,6,3,-3,2,1,3,3,3,0,1,0,1,2,1,0,0,0,2,1,2,0,1,0,10,5,5,1,2,-1,-3,8,-3,5,3,1,-3,7,-2,5,-1,0,0,1,-1,0,4,1,0,0,0,1,0,0,0,1,0,1,0,0,0,-1,0,0,0,0,9,3,6,9,4,5,4,1,-1,0,0,4,1,-1,2,-1,0,2,3,2,-3,1,0,2,3,1,2,1,0,2,2,0,1,0,0,1,1,1,1,1,0,1,67,37,30,15,9,6,17,16,15,10,5,1,10,7,9,6,2,1,7,9,6,4,3,0,4,4,2,3,1,0,3,2,1,2,0,0,1,2,1,1,1,0,-15,-7,-8,5,1,4,0,-4,-8,0,-4,2,4,-2,-5,-1,-4,1,-4,-2,-3,1,0,1,1,-1,3,2,0,0,1,-1,2,-1,0,0,0,0,1,3,0,0,86,57,29,8,5,3,13,10,28,13,17,3,14,8,14,8,12,1,-1,2,14,5,5,2,5,4,2,-3,0,0,4,3,0,-2,0,0,1,1,2,-1,0,0,31,8,23,16,9,7,-14,14,23,5,-1,4,-14,5,13,2,-1,3,0,9,10,3,0,1,3,5,6,1,1,0,1,3,4,0,1,0,2,2,2,1,0,0,23,21,2,4,2,2,5,6,8,-2,3,3,4,6,9,-1,2,1,1,0,-1,-1,1,2,5,1,0,-2,0,0,2,2,0,-2,0,0,3,-1,0,0,0,0,49,25,24,2,0,2,12,0,16,16,3,0,5,1,9,7,1,1,7,-1,7,9,2,-1,-1,0,4,-1,0,0,-1,0,3,-1,-1,0,0,0,1,0,1,0,27,14,13,5,0,5,7,-7,2,19,2,4,5,-2,-1,9,-1,4,2,-5,3,10,3,0,4,2,-1,0,0,0,2,0,-2,0,0,0,2,2,1,0,0,0,10,-2,12,6,4,2,3,3,-2,0,3,3,0,-4,1,-3,3,1,3,7,-3,3,0,2,1,2,2,0,-1,2,1,1,1,0,0,1,0,1,1,0,-1,1,34,20,14,4,1,3,3,6,19,-2,11,-2,1,2,11,0,8,-2,2,4,8,-2,3,0,0,3,0,2,0,-1,0,0,0,1,0,0,0,3,0,1,0,-1,-18,-10,-8,5,1,4,5,-5,-7,-11,-3,3,0,-1,-2,-6,-2,2,5,-4,-5,-5,-1,1,6,-2,-2,1,0,1,1,-1,-1,1,0,1,5,-1,-1,0,0,0,-4,-4,0,5,4,1,-2,-7,-7,1,8,3,0,-6,-6,2,3,3,-2,-1,-1,-1,5,0,2,0,0,2,1,0,2,0,0,1,1,0,0,0,0,1,0,0,1,-3,4,3,1,2,4,-2,-3,-7,2,5,0,-3,0,-4,0,3,4,1,-3,-3,2,2,0,0,1,0,0,2,0,0,1,0,0,0,0,0,0,0,0,2,-28,-6,-22,4,1,3,-8,2,-8,-3,-3,-8,-4,-1,-1,2,1,-3,-4,3,-7,-5,-4,-5,3,0,1,0,0,0,1,0,1,-1,0,0,2,0,0,1,0,0,15,6,9,1,-1,2,6,-5,12,-6,3,5,6,-4,5,-3,1,3,0,-1,7,-3,2,2,1,0,0,1,0,0,1,0,-1,1,-1,0,0,0,1,0,1,0
45,45186,"Villa de Don Fadrique, La",4164,62,50,12,53,42,11,6,27,8,16,2,2,3,15,13,13,3,2,3,12,-5,3,-1,0,5,12,19,14,2,0,3,10,15,12,2,0,2,2,4,2,0,0,32,27,5,41,27,14,10,12,0,7,4,-2,9,11,-1,6,2,-1,1,1,1,1,2,-1,3,13,12,9,4,0,2,11,7,5,2,0,1,2,5,4,2,0,12,3,9,27,15,12,-6,11,0,5,-2,2,-2,3,-4,5,0,1,-4,8,4,0,-2,1,0,10,9,7,1,0,0,4,4,6,1,0,0,6,5,1,0,0,33,27,6,42,25,17,15,-6,9,4,11,-1,16,-2,4,-2,8,2,-1,-4,5,6,3,-3,11,8,17,4,2,0,7,4,10,2,2,0,4,4,7,2,0,0,32,19,13,31,20,11,3,15,-3,3,16,-3,0,12,-3,-1,8,2,3,3,0,4,8,-5,4,12,5,9,1,0,2,9,3,6,0,0,2,3,2,3,1,0,58,20,38,28,15,13,20,8,16,-1,5,9,8,2,7,-4,1,6,12,6,9,3,4,3,4,6,15,2,0,1,2,3,9,0,0,1,2,3,6,2,0,0,47,23,24,38,23,15,9,1,14,14,14,-5,3,1,3,12,7,-4,6,0,11,2,7,-1,4,8,16,8,2,0,1,5,10,6,1,0,3,3,6,2,1,0,73,47,26,84,48,36,10,22,3,28,8,0,10,17,2,16,4,-2,0,5,1,12,4,2,13,26,23,18,3,0,6,16,11,15,1,-1,7,10,12,3,2,1,15,15,0,17,7,10,4,10,6,-1,-4,-3,2,7,7,-3,-1,2,2,3,-1,2,-3,-5,4,9,0,2,0,1,2,4,2,0,-1,0,2,5,-2,2,1,1,-3,-6,3,2,-3,5,-1,-1,3,-5,4,0,-3,-1,6,-8,2,-2,2,0,-3,3,2,2,5,1,-1,-5,1,1,2,1,0,-7,1,0,3,0,-1,2,0,1,-33,-7,-26,-1,4,-5,-6,-9,-7,-9,5,-6,-8,-3,8,-8,5,0,2,-6,-15,-1,0,-6,-4,-2,1,2,2,0,-1,-1,4,0,2,0,-3,-1,-3,2,0,0,3,-1,4,2,2,0,5,-7,-2,11,2,-6,6,-5,-5,5,1,-3,-1,-2,3,6,1,-3,-7,3,0,5,1,0,-2,0,0,3,1,0,-5,3,0,2,0,0,-48,-21,-27,-15,-9,-6,-9,1,-13,-10,-1,-15,-4,3,-9,-4,0,-6,-5,-2,-4,-6,-1,-9,-1,-1,-9,-1,-2,-1,0,1,-6,-2,-1,-1,-1,-2,-3,1,-1,0,-19,-17,-2,0,1,-1,4,-5,-5,1,-8,-5,-3,0,0,-2,-6,-6,7,-5,-5,3,-2,1,-1,1,-3,5,-2,0,-1,1,1,2,-2,0,0,0,-4,3,0,0,-24,-11,-13,6,6,0,0,-3,-11,-5,-7,1,0,-3,-7,1,-6,3,0,0,-4,-6,-1,-2,-2,0,4,3,0,0,-2,0,2,4,1,0,0,0,2,-1,-1,0,-41,-9,-32,-4,-1,-3,-8,-14,-9,-11,3,0,-5,0,-1,-5,1,2,-3,-14,-8,-6,2,-2,0,1,-2,-2,-1,0,0,1,-1,-1,0,0,0,0,-1,-1,-1,0,-26,-17,-9,4,0,4,-7,-3,-1,-7,1,-11,-5,1,-7,-4,2,-5,-2,-4,6,-3,-1,-6,1,1,3,-3,1,0,1,1,-1,-2,1,0,0,0,4,-1,0,0,-37,-21,-16,-2,-1,-1,-6,-2,-20,-2,-9,0,-4,-4,-9,-2,-4,0,-2,2,-11,0,-5,0,2,0,1,-3,-4,1,2,0,0,-3,-2,1,0,0,1,0,-2,0
45,45187,Villafranca de los Caballeros,5321,-3,-4,1,29,17,12,5,-1,-11,-2,4,3,1,-1,-3,-1,1,0,4,0,-8,-1,3,3,4,6,15,2,1,1,2,2,12,0,0,1,2,4,3,2,1,0,-12,-1,-11,33,21,12,5,1,-16,-1,2,-2,6,5,-12,0,2,-2,-1,-4,-4,-1,0,0,7,11,5,8,2,0,3,9,3,5,1,0,4,2,2,3,1,0,-23,-14,-9,29,13,16,-3,3,-15,0,-4,0,1,-2,-11,0,-3,1,-4,5,-4,0,-1,-1,5,11,11,2,0,0,4,5,5,-1,0,0,1,6,6,3,0,0,-11,3,-14,19,11,8,-6,7,-19,-7,7,7,-2,4,-3,0,5,1,-4,3,-16,-7,2,6,6,8,2,3,0,0,2,4,2,3,0,0,4,4,0,0,0,0,-10,-16,6,10,3,7,-1,-4,-9,3,7,-2,-6,-3,-4,2,1,-1,5,-1,-5,1,6,-1,2,2,4,1,1,0,0,1,2,0,0,0,2,1,2,1,1,0,18,24,-6,88,58,30,0,13,-2,9,2,-3,7,15,1,3,0,-2,-7,-2,-3,6,2,-1,15,29,23,21,0,-1,12,18,14,14,0,-1,3,11,9,7,0,0,134,87,47,95,57,38,32,24,32,14,19,15,19,14,31,8,9,7,13,10,1,6,10,8,14,31,33,13,3,1,7,19,22,6,3,0,7,12,11,7,0,1,117,82,35,137,86,51,24,31,40,16,-4,12,10,21,26,22,-1,6,14,10,14,-6,-3,6,27,45,36,28,0,0,14,26,23,21,1,0,13,19,13,7,-1,0,24,10,14,41,22,19,3,-1,13,-1,-6,14,6,-7,13,-2,-6,4,-3,6,0,1,0,10,5,10,18,7,0,0,1,3,13,4,0,0,4,7,5,3,0,0,-172,-100,-72,-114,-72,-42,-28,-33,-71,-44,4,-2,-17,-13,-38,-29,-1,-1,-11,-20,-33,-15,5,-1,-13,-18,-44,-37,-3,-1,-8,-9,-28,-27,-1,0,-5,-9,-16,-10,-2,-1,-25,-25,0,23,8,15,-10,1,-21,-5,3,7,-5,-3,-12,-6,0,1,-5,4,-9,1,3,6,7,13,0,3,0,0,3,3,1,2,-1,0,4,10,-1,1,1,0,-4,-11,7,8,4,4,10,8,-14,-8,6,-5,3,2,-16,-2,5,-3,7,6,2,-6,1,-2,0,9,-2,0,1,0,1,6,-3,-1,1,0,-1,3,1,1,0,0,-12,-11,-1,1,2,-1,6,2,-15,-2,2,-5,2,-1,-18,0,3,1,4,3,3,-2,-1,-6,-1,3,-2,0,1,0,1,2,-2,0,1,0,-2,1,0,0,0,0,-27,-16,-11,-6,-5,-1,0,-7,-19,-12,13,4,2,-9,-5,-10,5,3,-2,2,-14,-2,8,1,0,-1,-2,-3,0,0,0,-3,0,-2,0,0,0,2,-2,-1,0,0,1,-3,4,5,2,3,4,1,-16,0,7,7,1,4,-11,-3,7,0,3,-3,-5,3,0,7,2,4,-2,1,0,0,1,2,-2,1,0,0,1,2,0,0,0,0,-24,-23,-1,9,1,8,-7,-7,-20,-2,17,-4,-7,-6,-11,-4,8,-2,0,-1,-9,2,9,-2,3,2,2,-1,3,0,1,0,-1,0,1,0,2,2,3,-1,2,0,0,5,-5,8,6,2,-1,-2,-11,2,-2,12,-1,0,-5,6,-1,6,0,-2,-6,-4,-1,6,1,3,0,2,1,1,1,3,0,1,0,1,0,0,0,1,1,0,-27,-17,-10,5,0,5,-3,0,-31,5,-4,7,3,0,-25,6,-1,0,-6,0,-6,-1,-3,7,0,3,3,-1,1,-1,0,1,1,-1,0,-1,0,2,2,0,1,0
45,45188,Villaluenga de la Sagra,2639,-3,1,-4,5,2,3,2,-2,-1,4,-3,-2,2,-3,1,0,1,0,0,1,-2,4,-4,-2,0,0,4,1,0,0,0,0,2,0,0,0,0,0,2,1,0,0,25,9,16,14,5,9,2,9,-1,4,9,2,-2,4,0,2,4,1,4,5,-1,2,5,1,3,4,4,3,0,0,1,2,1,1,0,0,2,2,3,2,0,0,99,51,48,23,12,11,19,28,18,28,0,5,6,15,8,14,2,4,13,13,10,14,-2,1,5,8,4,5,1,0,2,4,3,2,1,0,3,4,1,3,0,0,136,73,63,25,14,11,33,20,51,6,10,9,22,10,31,1,3,6,11,10,20,5,7,3,5,9,10,0,0,1,3,5,6,0,0,0,2,4,4,0,0,1,81,46,35,35,14,21,12,27,32,8,-1,-2,5,15,17,8,2,-3,7,12,15,0,-3,1,4,11,12,5,1,2,0,7,6,1,0,0,4,4,6,4,1,2,156,81,75,38,17,21,34,27,57,18,14,0,16,14,32,9,5,0,18,13,25,9,9,0,7,13,11,4,3,0,1,5,7,2,2,0,6,8,4,2,1,0,258,144,114,46,17,29,54,48,85,63,13,-4,36,26,41,35,9,-2,18,22,44,28,4,-2,11,12,8,12,2,0,2,4,5,4,1,1,9,8,3,8,1,-1,275,156,119,75,52,23,65,65,54,64,13,7,28,38,37,37,7,2,37,27,17,27,6,5,14,25,20,11,5,0,11,13,16,10,2,0,3,12,4,1,3,0,108,64,44,47,27,20,13,22,35,25,11,1,10,12,24,12,7,-1,3,10,11,13,4,2,10,15,17,3,2,0,6,9,10,1,2,-1,4,6,7,2,0,1,50,15,35,7,-2,9,23,1,25,-9,9,-2,9,-3,9,-7,5,-1,14,4,16,-2,4,-1,-2,2,0,3,4,0,-1,-1,-4,1,3,0,-1,3,4,2,1,0,86,42,44,34,13,21,9,32,17,11,9,0,7,17,7,2,7,-2,2,15,10,9,2,2,7,10,7,2,5,1,2,2,5,1,2,1,5,8,2,1,3,0,30,20,10,20,7,13,0,4,4,10,6,4,-2,4,1,5,6,2,2,0,3,5,0,2,5,3,4,6,2,0,3,1,-1,2,2,0,2,2,5,4,0,0,-66,-42,-24,8,2,6,-3,-7,-45,-12,-2,2,-10,-5,-20,-9,0,1,7,-2,-25,-3,-2,1,4,2,2,-2,1,0,1,0,1,-1,1,0,3,2,1,-1,0,0,-87,-52,-35,-28,-19,-9,-12,-9,-25,-28,-6,-3,-2,-5,-22,-16,-6,1,-10,-4,-3,-12,0,-4,-1,-5,-9,-5,-6,-2,0,-2,-9,-3,-5,0,-1,-3,0,-2,-1,-2,-116,-63,-53,-40,-25,-15,-24,-14,-27,-41,-14,3,-14,-2,-19,-24,-10,3,-10,-12,-8,-17,-4,0,-4,-3,-9,-14,-11,1,-3,-1,-5,-11,-6,1,-1,-2,-4,-3,-5,0,-16,-7,-9,4,4,0,-8,0,-3,-7,2,-1,0,0,0,-10,5,-2,-8,0,-3,3,-3,1,1,2,1,3,-1,-2,3,1,1,1,0,-2,-2,1,0,2,-1,0,-37,-11,-26,-15,-10,-5,-2,0,-21,-13,-2,1,0,-1,-9,-3,1,1,-2,1,-12,-10,-3,0,3,2,-9,-11,0,0,1,1,-4,-8,0,0,2,1,-5,-3,0,0,-13,0,-13,-18,-6,-12,10,-5,-11,-3,-3,-3,10,5,-4,-4,-4,-4,0,-10,-7,1,1,1,-4,0,-8,-7,0,1,-1,1,-2,-2,-1,-1,-3,-1,-6,-5,1,2
45,45192,Villanueva de Alcardete,3304,174,142,32,214,165,49,12,77,61,24,1,-1,8,61,49,23,2,-1,4,16,12,1,-1,0,19,84,72,35,4,0,11,64,56,30,4,0,8,20,16,5,0,0,52,34,18,127,94,33,6,31,6,10,1,-3,4,23,5,3,-1,-1,2,8,1,7,2,-2,12,54,42,18,0,0,8,39,33,13,0,0,4,15,9,5,0,0,69,30,39,144,84,60,9,30,19,12,-1,0,3,17,6,6,-3,2,6,13,13,6,2,-2,14,60,48,19,2,0,7,35,31,10,1,0,7,25,17,9,1,0,40,32,8,110,76,34,12,12,4,11,-3,3,8,7,8,8,-2,3,4,5,-4,3,-1,0,18,35,40,16,1,0,11,25,30,10,0,0,7,10,10,6,1,0,142,90,52,185,119,66,12,62,34,22,13,-2,9,43,9,20,8,-1,3,19,25,2,5,-1,22,84,46,25,5,0,16,54,23,18,5,0,6,30,23,7,0,0,40,21,19,121,70,51,12,33,-15,12,4,-6,7,18,-15,9,2,-1,5,15,0,3,2,-5,18,62,17,22,0,1,9,34,9,16,0,1,9,28,8,6,0,0,46,25,21,62,30,32,12,-3,16,9,4,6,11,2,3,9,-3,2,1,-5,13,0,7,4,14,22,15,12,-1,0,6,12,8,7,-3,0,8,10,7,5,2,0,127,73,54,163,96,67,44,23,24,25,9,2,17,11,22,17,5,0,27,12,2,8,4,2,32,53,47,24,6,0,11,29,34,17,4,0,21,24,13,7,2,0,-13,-4,-9,13,6,7,-1,-6,-14,11,0,-2,3,-8,-8,6,0,3,-4,2,-6,5,0,-5,3,6,3,1,0,0,3,0,3,0,0,0,0,6,0,1,0,0,18,14,4,35,13,22,1,-7,10,2,7,0,2,-1,10,-3,4,0,-1,-6,0,5,3,0,4,10,8,6,3,0,1,3,4,2,2,0,3,7,4,4,1,0,16,13,3,28,16,12,9,21,-6,-2,-1,-4,5,11,-1,-2,2,-2,4,10,-5,0,-3,-2,3,19,3,-1,2,1,2,11,4,-3,0,1,1,8,-1,2,2,0,-43,-15,-28,25,16,9,0,-2,-15,-9,-4,-13,2,-3,-4,0,-2,-7,-2,1,-11,-9,-2,-6,6,14,2,2,0,0,3,9,1,2,1,0,3,5,1,0,-1,0,-48,-24,-24,-41,-24,-17,-8,-1,-28,-9,1,-3,-4,0,-14,-7,4,-3,-4,-1,-14,-2,-3,0,-12,-1,-19,-8,-1,0,-6,0,-12,-6,0,0,-6,-1,-7,-2,-1,0,-76,-60,-16,-76,-54,-22,-13,-19,-35,-21,-5,17,-10,-15,-19,-13,-2,0,-3,-4,-16,-8,-3,17,-11,-11,-33,-17,-5,0,-7,-10,-20,-13,-3,-1,-4,-1,-13,-4,-2,1,-116,-73,-43,-104,-65,-39,-11,-18,-50,-33,-17,12,-5,-11,-29,-21,-12,5,-6,-7,-21,-12,-5,7,-12,-14,-36,-31,-13,1,-4,-6,-23,-22,-10,0,-8,-8,-13,-9,-3,1,-27,-12,-15,-1,1,-2,-7,-8,-18,6,2,-3,2,-3,-8,2,-2,-4,-9,-5,-10,4,4,1,-3,2,-7,5,1,0,0,0,-3,3,0,0,-3,2,-4,2,1,0,-48,-31,-17,-31,-16,-15,-10,1,-19,-18,2,-4,-4,-3,-12,-11,1,-2,-6,4,-7,-7,1,-2,-11,-1,-9,-8,0,-2,-7,-1,-3,-4,-1,0,-4,0,-6,-4,1,-2,-47,-18,-29,-26,-13,-13,6,-13,-25,-9,-1,-5,4,-1,-17,1,0,-5,2,-12,-8,-10,-1,0,-1,-1,-11,-12,-1,0,0,-1,-6,-5,-1,0,-1,0,-5,-7,0,0
45,45196,Villaseca de la Sagra,1598,25,15,10,24,21,3,-7,8,4,1,-1,20,-1,7,4,1,-1,5,-6,1,0,0,0,15,0,9,6,9,0,0,0,7,6,8,0,0,0,2,0,1,0,0,4,0,4,9,4,5,-3,1,-1,3,0,3,-3,-1,-1,2,0,2,0,2,0,1,0,1,0,4,3,2,0,0,0,2,1,1,0,0,0,2,2,1,0,0,15,17,-2,36,24,12,-5,13,3,5,-3,2,-1,12,4,4,-3,1,-4,1,-1,1,0,1,8,11,11,6,0,0,5,7,8,4,0,0,3,4,3,2,0,0,42,19,23,15,8,7,6,9,11,6,4,5,2,2,5,4,2,3,4,7,6,2,2,2,1,7,6,1,0,0,0,4,3,1,0,0,1,3,3,0,0,0,29,14,15,11,6,5,11,5,7,5,1,-1,6,1,2,4,0,-1,5,4,5,1,1,0,1,0,4,6,0,0,0,0,1,5,0,0,1,0,3,1,0,0,-3,2,-5,7,3,4,-3,0,-1,0,3,-1,-4,2,1,-2,4,0,1,-2,-2,2,-1,-1,1,3,1,2,0,0,0,2,0,1,0,0,1,1,1,1,0,0,44,25,19,16,7,9,11,7,16,5,3,1,4,5,9,4,4,-1,7,2,7,1,-1,2,0,6,7,2,1,0,0,1,3,2,1,0,0,5,4,0,0,0,59,45,14,52,38,14,6,18,12,19,6,-4,5,13,12,15,2,-2,1,5,0,4,4,-2,7,15,20,9,1,0,3,12,15,7,1,0,4,3,5,2,0,0,12,12,0,27,16,11,7,3,-2,-3,6,0,6,3,-1,0,4,1,1,0,-1,-3,2,-1,8,7,5,5,2,0,5,4,2,3,2,0,3,3,3,2,0,0,19,9,10,16,12,4,7,-1,1,9,1,-2,4,-1,-5,7,3,-1,3,0,6,2,-2,-1,0,1,4,7,3,0,0,0,1,7,3,0,0,1,3,0,0,0,58,33,25,19,12,7,0,23,27,-2,4,2,-3,11,18,0,3,1,3,12,9,-2,1,1,1,11,3,2,1,0,1,7,1,2,0,0,0,4,2,0,1,0,20,14,6,1,1,0,-6,5,12,0,2,2,2,1,8,0,1,0,-8,4,4,0,1,2,1,0,1,-1,0,0,1,0,1,-1,0,0,0,0,0,0,0,0,53,18,35,13,7,6,25,2,17,8,0,-2,12,-2,3,4,0,-1,13,4,14,4,0,-1,5,2,5,1,0,0,3,0,3,1,0,0,2,2,2,0,0,0,11,5,6,9,3,6,5,3,-1,8,-4,1,0,4,-1,4,-3,2,5,-1,0,4,-1,-1,3,0,0,5,1,0,1,0,0,2,0,0,2,0,0,3,1,0,-28,-15,-13,-1,2,-3,-2,-9,-13,0,-4,0,-1,-4,-6,-3,-1,0,-1,-5,-7,3,-3,0,-3,-1,3,-2,2,0,-1,0,2,-1,2,0,-2,-1,1,-1,0,0,-4,-3,-1,-10,-8,-2,-9,9,-4,-12,7,5,-1,3,-6,-5,5,1,-8,6,2,-7,2,4,0,1,-3,-5,-3,0,0,-1,-3,-2,-2,0,0,2,0,-3,-1,0,-3,-1,-2,3,1,2,2,-2,1,-1,-4,-1,1,0,0,0,-4,0,1,-2,1,-1,0,-1,-1,2,0,1,0,0,-1,1,0,0,0,0,0,1,0,1,0,0,9,-2,11,-1,-3,2,1,-4,12,1,1,-2,-3,-2,5,2,-2,-2,4,-2,7,-1,3,0,1,0,0,-4,2,0,-1,0,0,-2,0,0,2,0,0,-2,2,0
45,45200,"Yébenes, Los",6313,74,52,22,44,25,19,6,32,8,21,6,1,1,17,15,13,6,0,5,15,-7,8,0,1,5,12,15,11,0,0,2,5,11,6,0,0,3,7,4,5,0,0,17,16,1,48,28,20,7,-2,5,3,14,-10,6,0,9,3,4,-6,1,-2,-4,0,10,-4,13,7,17,10,1,0,6,5,11,5,1,0,7,2,6,5,0,0,40,22,18,47,22,25,6,9,19,-6,2,9,6,6,14,-5,0,1,0,3,5,-1,2,8,10,13,17,6,1,0,5,5,9,3,0,0,5,8,8,3,1,0,53,43,10,53,35,18,6,21,-1,24,-1,2,5,14,5,17,1,0,1,7,-6,7,-2,2,8,17,13,14,0,0,3,13,9,9,0,0,5,4,4,5,0,0,119,71,48,102,63,39,17,36,55,2,4,4,7,25,33,3,-1,2,10,11,22,-1,5,2,14,36,36,14,2,0,8,21,24,10,0,0,6,15,12,4,2,0,65,46,19,82,51,31,11,32,4,12,8,-4,6,18,8,11,3,-1,5,14,-4,1,5,-3,10,22,35,11,3,0,4,12,25,8,2,0,6,10,10,3,1,0,5,-14,19,91,49,42,8,16,-22,12,0,-6,-3,9,-14,0,-2,-3,11,7,-8,12,2,-3,16,35,14,25,-1,1,8,16,14,10,-1,1,8,19,0,15,0,0,118,61,57,121,65,56,40,37,18,19,8,-3,19,14,13,17,2,-4,21,23,5,2,6,1,20,48,39,14,1,-1,11,21,25,9,0,-1,9,27,14,5,1,0,45,30,15,76,40,36,30,3,6,12,2,-8,14,4,8,5,2,-3,16,-1,-2,7,0,-5,18,18,29,9,1,1,10,10,14,6,-1,1,8,8,15,3,2,0,-24,1,-25,-3,-1,-2,-8,8,-17,-15,12,-2,-2,12,-7,-6,4,-1,-6,-4,-10,-9,8,-1,5,4,-6,-7,1,0,4,3,-3,-5,0,0,1,1,-3,-2,1,0,-23,-3,-20,16,7,9,-14,3,-30,13,5,2,-4,-7,-7,9,6,1,-10,10,-23,4,-1,1,1,10,1,6,-1,-1,1,4,0,2,1,-1,0,6,1,4,-2,0,-16,-13,-3,14,4,10,-1,-4,3,1,-9,-8,0,0,-1,-4,-10,0,-1,-4,4,5,1,-8,8,5,-1,4,-2,-1,4,0,-1,1,-1,0,4,5,0,3,-1,-1,-28,-17,-11,1,1,0,-7,-2,-13,-3,-3,0,0,-2,-7,-5,-4,1,-7,0,-6,2,1,-1,10,-1,-5,-2,0,-1,9,-2,-2,-2,-1,-1,1,1,-3,0,1,0,-145,-73,-72,-66,-38,-28,-35,-2,-59,-30,-15,-5,-18,-2,-24,-19,-7,-3,-17,0,-35,-11,-8,-2,-11,-5,-24,-19,-6,-1,-6,-2,-7,-16,-6,-1,-5,-3,-17,-3,0,0,-36,-19,-17,-26,-18,-8,-10,0,-18,-2,-3,-4,-10,-4,-5,0,-1,0,0,4,-13,-2,-2,-4,-11,-1,-5,-2,-7,0,-7,-3,-3,0,-5,0,-4,2,-2,-2,-2,0,-41,-19,-22,21,14,7,-13,-16,-7,-4,-7,7,-5,-6,2,-8,-3,2,-8,-10,-9,4,-4,5,2,7,1,6,3,1,2,4,2,2,3,0,0,3,-1,4,0,1,-56,-27,-29,5,-3,8,-2,-7,-23,-15,-6,-4,-3,5,-13,-10,-5,-2,1,-12,-10,-5,-1,-2,4,1,3,-2,-2,0,0,2,1,-4,-3,0,4,-1,2,2,1,0,-20,-9,-11,51,27,24,7,6,-14,-10,-13,1,0,-1,-3,-5,-5,2,7,7,-11,-5,-8,-1,18,12,14,4,0,2,8,8,7,3,-1,1,10,4,7,1,1,1
45,45203,Yuncler,1930,-51,-29,-22,4,3,1,-21,-4,-18,-6,1,-3,-11,-1,-10,-5,1,-3,-10,-3,-8,-1,0,0,0,3,0,1,0,0,0,2,0,1,0,0,0,1,0,0,0,0,86,47,39,32,15,17,14,9,26,17,16,3,10,4,14,7,9,2,4,5,12,10,7,1,4,8,10,5,3,0,2,4,4,2,1,0,2,4,6,3,2,0,135,66,69,36,17,19,29,39,34,15,7,4,16,19,17,5,3,3,13,20,17,10,4,1,4,14,13,2,2,0,3,7,5,1,1,0,1,7,8,1,1,0,79,48,31,24,13,11,22,10,22,16,4,6,10,5,15,15,1,2,12,5,7,1,3,4,10,4,8,1,1,0,8,2,2,1,0,0,2,2,6,0,1,0,99,46,53,29,15,14,15,32,31,15,9,-2,4,14,17,9,3,0,11,18,14,6,6,-2,3,7,6,7,3,3,2,3,2,5,1,2,1,4,4,2,2,1,90,55,35,16,8,8,21,27,16,19,7,-4,13,16,13,8,3,-2,8,11,3,11,4,-2,2,4,5,5,0,0,1,4,2,1,0,0,1,0,3,4,0,0,199,118,81,50,34,16,19,43,87,32,10,1,13,18,54,25,4,3,6,25,33,7,6,-2,3,15,16,12,3,1,2,9,12,10,0,1,1,6,4,2,3,0,229,132,97,66,36,30,30,43,92,52,9,-1,13,22,67,29,2,-2,17,21,25,23,7,1,9,18,25,12,1,1,2,10,16,7,0,1,7,8,9,5,1,0,124,37,87,17,6,11,31,27,59,-5,6,2,8,6,20,-6,7,0,23,21,39,1,-1,2,7,2,8,-1,2,-2,1,3,3,-2,2,-2,6,-1,5,1,0,0,54,44,10,32,19,13,3,23,25,-3,2,7,9,8,26,-1,3,2,-6,15,-1,-2,-1,5,2,5,16,7,1,0,2,3,8,6,0,0,0,2,8,1,1,0,158,68,90,18,3,15,45,31,46,21,11,2,17,15,27,6,6,-1,28,16,19,15,5,3,4,6,2,5,1,0,1,3,-1,0,0,0,3,3,3,5,1,0,133,73,60,18,5,13,15,15,57,29,20,-2,8,11,36,17,7,0,7,4,21,12,13,-2,4,5,6,4,-2,0,1,-1,4,1,0,0,3,6,2,3,-2,0,-86,-39,-47,4,1,3,-25,-11,-22,-24,-8,4,-5,-3,-12,-19,-6,5,-20,-8,-10,-5,-2,-1,1,-1,3,1,0,0,1,-1,1,0,0,0,0,0,2,1,0,0,-2,4,-6,7,3,4,-6,-11,-1,7,5,4,1,2,-8,6,4,0,-7,-13,7,1,1,4,1,2,2,0,0,2,1,0,2,0,0,0,0,2,0,0,0,2,-22,-15,-7,0,2,-2,12,-3,-20,-22,12,1,5,0,-13,-16,8,2,7,-3,-7,-6,4,-1,0,2,-3,-1,1,0,0,2,-2,1,0,0,0,0,-1,-2,1,0,28,17,11,16,9,7,16,6,9,-1,5,-5,11,5,5,-3,3,-2,5,1,4,2,2,-3,4,5,6,-2,3,0,0,2,6,-1,2,0,4,3,0,-1,1,0,21,17,4,0,2,-2,14,4,-6,9,1,-3,12,-2,2,5,3,-2,2,6,-8,4,-2,-1,2,-3,2,1,-3,0,2,-2,2,0,-1,1,0,-1,0,1,-2,-1,96,63,33,37,17,20,13,15,27,13,15,6,8,7,18,11,7,6,5,8,9,2,8,0,12,3,13,5,4,0,6,1,5,3,2,0,6,2,8,2,2,0
45,45205,Yuncos,3611,-104,-53,-51,20,14,6,-38,-16,-32,-10,-3,-2,-20,-9,-14,-5,-1,-2,-18,-7,-18,-5,-2,0,1,2,12,3,2,0,0,1,9,3,1,0,1,1,3,0,1,0,303,164,139,93,56,37,51,72,111,45,11,13,27,36,64,25,5,7,24,36,47,20,6,6,14,29,32,16,1,1,5,17,20,13,1,0,9,12,12,3,0,1,371,194,177,83,54,29,91,78,113,61,16,9,45,33,65,34,8,7,46,45,48,27,8,2,12,23,26,20,1,1,7,14,20,13,0,0,5,9,6,7,1,1,402,204,198,80,40,40,67,71,147,57,37,12,33,36,80,28,19,5,34,35,67,29,18,7,18,21,29,4,4,1,10,8,16,2,2,1,8,13,13,2,2,0,376,189,187,77,42,35,72,104,105,61,19,13,33,58,55,25,10,6,39,46,50,36,9,7,7,40,19,7,3,1,4,25,10,2,1,0,3,15,9,5,2,1,944,495,449,104,57,47,221,154,293,178,55,29,125,73,156,102,26,11,96,81,137,76,29,18,19,40,24,12,6,2,11,20,17,5,4,0,8,20,7,7,2,2,874,432,442,103,52,51,178,139,323,131,60,26,99,53,157,78,32,6,79,86,166,53,28,20,24,26,24,19,7,3,14,11,15,9,2,1,10,15,9,10,5,2,890,517,373,133,82,51,190,169,304,145,53,13,101,87,188,96,28,6,89,82,116,49,25,7,23,34,44,23,8,1,11,20,27,19,4,1,12,14,17,4,4,0,504,253,251,170,90,80,141,94,138,107,37,-8,73,51,71,52,23,-3,68,43,67,55,14,-5,43,45,54,26,2,0,25,22,30,15,-2,0,18,23,24,11,4,0,440,194,246,90,40,50,90,49,152,81,19,19,46,20,63,37,9,5,44,29,89,44,10,14,25,27,22,14,1,0,15,12,8,2,1,0,10,15,14,12,0,0,295,156,139,37,16,21,52,60,84,59,24,10,39,36,40,33,9,-1,13,24,44,26,15,11,4,12,7,4,6,4,0,6,7,0,2,1,4,6,0,4,4,3,462,275,187,108,51,57,101,76,150,67,37,14,50,38,101,43,22,7,51,38,49,24,15,7,13,27,32,15,11,4,8,13,18,4,3,1,5,14,14,11,8,3,161,70,91,41,18,23,26,32,93,-16,1,21,7,23,35,-12,8,8,19,9,58,-4,-7,13,15,11,22,-5,-2,-1,6,8,11,-2,-4,-1,9,3,11,-3,2,0,-128,-56,-72,-3,2,-5,-31,-49,-22,-39,-5,3,-12,-15,-17,-5,-15,-3,-19,-34,-5,-34,10,6,-7,-3,12,-4,-1,-1,-2,0,3,0,0,0,-5,-3,9,-4,-1,-1,-36,-17,-19,13,-4,17,-20,-26,28,-37,2,10,1,-15,6,-20,5,5,-21,-11,22,-17,-3,5,3,-1,0,2,7,2,1,-2,-3,-1,2,-1,2,1,3,3,5,3,-285,-183,-102,-243,-156,-87,-39,-36,-96,-97,-16,-3,-40,-12,-58,-65,-9,-1,1,-24,-38,-32,-7,-2,-33,-14,-54,-86,-48,-10,-22,-7,-38,-59,-25,-5,-11,-7,-16,-27,-23,-5,185,87,98,88,54,34,21,33,29,47,27,27,12,12,6,32,14,8,9,21,23,15,13,19,20,19,22,11,12,5,17,10,10,7,6,3,3,9,12,4,6,2,200,88,112,79,37,42,57,31,45,14,22,25,30,14,22,0,4,13,27,17,23,14,18,12,12,20,23,10,12,1,3,12,14,2,4,1,9,8,9,8,8,0
46,46002,Ador,1140,25,18,7,7,3,4,10,-3,8,6,3,-1,3,-3,9,5,3,-1,7,0,-1,1,0,0,1,0,0,4,2,0,0,0,0,1,2,0,1,0,0,3,0,0,9,4,5,8,3,5,4,-5,1,2,5,2,2,-2,-2,2,2,2,2,-3,3,0,3,0,1,0,2,1,3,1,0,0,1,0,1,1,1,0,1,1,2,0,65,32,33,30,13,17,5,12,14,6,18,9,4,5,7,4,8,4,1,7,7,2,10,5,4,1,6,3,12,3,1,1,2,1,6,2,3,0,4,2,6,1,67,37,30,34,16,18,4,11,2,23,22,5,4,6,0,12,11,4,0,5,2,11,11,1,0,2,2,12,16,2,0,0,1,6,8,1,0,2,1,6,8,1,41,26,15,42,24,18,-1,13,-2,8,17,4,1,7,0,3,10,4,-2,6,-2,5,7,0,4,3,4,11,13,6,3,2,1,5,7,5,1,1,3,6,6,1,26,19,7,32,16,16,3,-3,1,9,19,-3,2,-2,5,6,9,-1,1,-1,-4,3,10,-2,3,1,4,9,14,1,1,0,2,4,8,1,2,1,2,5,6,0,33,16,17,23,14,9,6,9,9,6,5,-1,1,2,9,2,3,-2,5,7,0,4,2,1,2,4,4,5,6,1,1,1,4,2,4,1,1,3,0,3,2,0,72,42,30,19,10,9,11,14,17,23,6,0,3,4,13,13,6,2,8,10,4,10,0,-2,2,2,1,7,5,2,1,0,1,4,2,2,1,2,0,3,3,0,-23,1,-24,10,7,3,0,-5,-9,-4,2,-4,2,0,-1,0,1,-1,-2,-5,-8,-4,1,-3,3,1,2,-2,5,1,1,1,2,0,2,1,2,0,0,-2,3,0,6,2,4,11,5,6,-2,-2,4,6,-1,1,-2,0,0,3,0,0,0,-2,4,3,-1,1,0,1,3,2,4,1,0,1,1,2,1,0,0,0,2,0,3,1,19,-1,20,-4,-2,-2,0,0,8,-1,9,2,-3,2,0,-1,0,1,3,-2,8,0,9,1,1,-2,-5,0,4,-2,1,-1,-4,1,3,-2,0,-1,-1,-1,1,0,-92,-50,-42,-82,-41,-41,-12,-4,-14,-15,-31,-17,-6,-3,-8,-8,-15,-10,-6,-1,-6,-7,-16,-7,-8,-1,-11,-16,-29,-17,-5,-1,-5,-7,-13,-10,-3,0,-6,-9,-16,-7,-43,-13,-30,5,4,1,-7,-3,-19,-5,-2,-7,1,-1,-7,-6,1,-1,-8,-2,-12,1,-3,-6,0,0,1,2,2,0,0,0,1,2,1,0,0,0,0,0,1,0,-6,-2,-4,-3,-2,-1,-9,6,-2,9,-3,-7,-7,5,-5,7,1,-3,-2,1,3,2,-4,-4,-1,0,1,0,-2,-1,-2,1,0,0,0,-1,1,-1,1,0,-2,0,13,12,1,3,3,0,-2,10,1,8,2,-4,3,6,-1,6,-2,1,-5,4,2,2,4,-5,-1,0,0,3,2,-1,0,0,-1,2,0,2,-1,0,1,1,2,-3,70,48,22,16,5,11,3,10,9,28,14,6,1,5,8,23,11,1,2,5,1,5,3,5,0,3,1,1,5,6,0,1,1,-1,2,2,0,2,0,2,3,4,18,18,0,15,10,5,-2,-2,12,3,5,2,-1,1,10,1,6,1,-1,-3,2,2,-1,1,0,1,1,4,9,0,0,1,1,1,7,0,0,0,0,3,2,0,-5,-6,1,-2,-2,0,-1,7,-1,-8,4,-4,0,2,1,-7,0,0,-1,5,-2,-1,4,-4,-3,1,2,-2,-1,1,-1,-1,2,-2,-2,2,-2,2,0,0,1,-1
46,46042,Aielo de Malferit,3961,90,51,39,81,50,31,9,23,47,8,2,1,7,10,24,9,2,-1,2,13,23,-1,0,2,7,27,38,9,0,0,4,16,22,8,0,0,3,11,16,1,0,0,130,94,36,129,90,39,19,52,46,8,6,-3,15,34,38,5,3,-2,4,18,8,3,3,-1,17,54,41,12,3,0,12,35,32,8,2,0,5,19,9,4,1,0,-26,-18,-8,0,1,-1,-2,-6,-28,8,3,1,-3,-2,-17,5,0,0,1,-4,-11,3,3,1,0,0,0,0,0,0,0,1,0,0,0,0,0,-1,0,0,0,0,-3,3,-6,17,9,8,6,-9,8,-2,-1,-3,8,-4,2,-1,-2,0,-2,-5,6,-1,1,-3,6,4,7,0,0,0,4,2,3,0,0,0,2,2,4,0,0,0,23,5,18,68,32,36,-3,15,23,-9,-2,0,-4,7,11,-7,-2,0,1,8,12,-2,0,0,5,26,31,5,0,0,2,12,17,1,0,0,3,14,14,4,0,0,87,46,41,71,35,36,6,24,45,15,-3,1,3,19,19,7,-2,1,3,5,26,8,-1,0,2,33,28,10,-3,1,0,18,12,7,-2,0,2,15,16,3,-1,1,61,37,24,65,28,37,2,19,15,21,4,-1,3,10,10,10,3,0,-1,9,5,11,1,-1,8,17,16,20,4,0,5,6,6,9,2,0,3,11,10,11,2,0,97,61,36,93,56,37,22,22,28,18,8,-3,14,10,18,15,6,-2,8,12,10,3,2,-1,12,31,21,22,6,1,6,17,13,16,3,1,6,14,8,6,3,0,26,16,10,-8,-3,-5,8,12,13,-15,8,2,4,9,10,-11,5,1,4,3,3,-4,3,1,-2,11,-3,-17,4,0,-1,6,-1,-10,4,0,-1,5,-2,-7,0,0,46,24,22,32,14,18,5,23,14,0,0,1,0,15,10,-1,-2,1,5,8,4,1,2,0,7,19,3,3,-1,0,3,11,0,-1,-1,1,4,8,3,4,0,-1,71,39,32,45,21,24,16,15,13,16,5,6,9,4,5,13,3,5,7,11,8,3,2,1,12,13,5,7,4,3,6,4,2,6,1,2,6,9,3,1,3,1,-69,-47,-22,-65,-42,-23,-4,-11,-27,-21,-6,-2,-5,-8,-15,-13,-7,0,1,-3,-12,-8,1,-2,-7,-13,-25,-19,-3,1,-2,-7,-18,-14,-3,1,-5,-6,-7,-5,0,0,-108,-59,-49,-91,-54,-37,-18,-13,-44,-21,-10,-3,-13,-5,-22,-14,-7,1,-5,-8,-22,-7,-3,-4,-9,-13,-42,-16,-11,-1,-7,-6,-25,-11,-6,0,-2,-7,-17,-5,-5,-1,16,8,8,9,4,5,2,4,4,4,0,-2,1,-3,3,1,4,0,1,7,1,3,-4,-2,1,2,5,7,-7,-1,1,-3,4,4,-2,-1,0,5,1,3,-5,0,34,19,15,11,4,7,0,20,16,-3,1,0,-4,9,13,-2,2,1,4,11,3,-1,-1,-1,-4,19,2,-10,5,-2,-4,8,1,-5,4,-1,0,11,1,-5,1,-1,15,5,10,21,10,11,-5,13,0,4,4,-3,1,10,-3,-2,0,-2,-6,3,3,6,4,-1,-3,14,0,9,-1,0,1,10,0,0,-2,0,-4,4,0,9,1,0,-7,3,-10,10,4,6,8,0,-6,-9,-1,-1,5,3,1,-4,-4,0,3,-3,-7,-5,3,-1,6,8,-4,-3,0,0,1,4,-1,-1,0,-1,5,4,-3,-2,0,1,-59,-26,-33,-29,-17,-12,3,-10,-19,-20,-12,-3,-1,1,-11,-12,-3,-1,4,-11,-8,-8,-9,-2,4,1,-10,-19,-5,0,0,2,-4,-12,-3,0,4,-1,-6,-7,-2,0
46,46005,Alaquàs,26179,587,316,271,103,60,43,93,171,226,45,23,21,46,81,130,36,9,11,47,90,96,9,14,10,21,24,36,15,4,0,9,15,22,12,2,0,12,9,14,3,2,0,598,356,242,188,110,78,80,167,213,76,25,32,49,89,145,44,17,11,31,78,68,32,8,21,36,42,58,38,9,3,22,20,36,21,7,2,14,22,22,17,2,1,327,242,85,196,111,85,15,162,110,49,-31,20,8,104,89,39,-15,13,7,58,21,10,-16,7,28,62,67,27,6,4,13,28,45,20,2,1,15,34,22,7,4,3,310,176,134,187,94,93,37,93,86,31,35,29,19,44,62,21,11,19,18,49,24,10,24,10,45,61,50,16,9,3,25,29,27,8,2,1,20,32,23,8,7,2,220,98,122,160,84,76,6,109,60,28,10,-3,-18,37,54,12,8,-3,24,72,6,16,2,0,23,55,54,17,6,4,13,27,31,8,2,2,10,28,23,9,4,2,177,42,135,194,96,98,52,62,-5,47,-14,33,15,27,-12,17,-13,7,37,35,7,30,-1,26,31,56,59,30,13,4,21,16,34,15,8,1,10,40,25,15,5,3,91,16,75,177,86,91,46,64,-8,-1,-20,7,23,36,-17,-3,-18,-4,23,28,9,2,-2,11,48,41,47,23,9,3,26,19,29,9,0,0,22,22,18,14,9,3,143,102,41,325,174,151,16,87,-25,22,1,32,19,61,-12,26,-8,15,-3,26,-13,-4,9,17,56,95,107,35,23,5,37,53,55,20,7,1,19,42,52,15,16,4,26,46,-20,204,109,95,11,61,-45,-10,-6,11,19,35,-14,-12,4,8,-8,26,-31,2,-10,3,43,56,50,45,7,-1,26,27,18,30,5,1,17,29,32,15,2,-2,-276,-200,-76,33,6,27,2,-66,-142,-62,-4,-11,-7,-43,-108,-40,3,-5,9,-23,-34,-22,-7,-6,15,16,1,-5,4,-2,12,0,2,-9,-1,0,3,16,-1,4,5,-2,-73,-51,-22,49,20,29,-7,32,-96,-36,13,15,-3,0,-36,-36,11,9,-4,32,-60,0,2,6,8,15,10,6,3,5,4,8,2,-1,5,1,4,7,8,7,-2,4,-25,5,-30,27,4,23,-8,8,35,-57,-20,11,-9,15,45,-33,-14,1,1,-7,-10,-24,-6,10,13,19,4,-14,0,5,5,13,1,-15,-1,1,8,6,3,1,1,4,83,-7,90,1,-16,17,36,9,9,-38,14,49,15,0,-8,-38,8,20,21,9,17,0,6,29,2,5,-5,-4,-5,5,-2,4,-10,-7,-4,3,4,1,5,3,-1,2,-178,-127,-51,-78,-48,-30,-34,-17,-83,-76,11,24,-12,-5,-60,-52,-1,6,-22,-12,-23,-24,12,18,-12,-14,-16,-25,-4,-7,-10,-5,-10,-15,-5,-3,-2,-9,-6,-10,1,-4,-174,-126,-48,-35,-33,-2,-72,-10,-66,-92,-6,63,-53,-17,-32,-51,-3,24,-19,7,-34,-41,-3,39,0,-6,-8,-15,-7,-2,-2,-5,-13,-11,-3,-1,2,-1,5,-4,-4,-1,-164,-78,-86,-2,0,-2,-46,-40,-30,-56,-16,23,-27,-5,-25,-16,-11,5,-19,-35,-5,-40,-5,18,5,4,-5,-20,5,2,5,3,-8,-4,1,0,0,1,3,-16,4,2,-104,-64,-40,-27,-25,-2,-32,-11,-37,-85,-5,68,-13,-1,-24,-60,-1,38,-19,-10,-13,-25,-4,30,-2,3,2,-25,-6,-2,-7,1,6,-23,-5,0,5,2,-4,-2,-1,-2,14,-4,18,65,17,48,-22,27,39,-40,-8,12,-13,18,23,-28,-14,7,-9,9,16,-12,6,5,10,29,7,6,8,4,8,14,0,-7,3,-2,2,15,7,13,5,6
46,46008,Albalat de la Ribera,3501,0,5,-5,12,7,5,-2,0,0,2,-1,0,0,3,0,2,0,0,-2,-3,0,0,-1,0,1,4,1,3,1,1,1,3,1,1,0,1,0,1,0,2,1,0,-24,-10,-14,15,10,5,-3,-9,-1,-6,-1,-3,-2,-2,-3,-1,1,-2,-1,-7,2,-5,-2,-1,1,1,7,5,1,0,0,1,4,4,1,0,1,0,3,1,0,0,-23,-7,-16,18,14,4,-2,-2,-9,-5,0,-5,-2,2,-5,0,0,-2,0,-4,-4,-5,0,-3,2,6,5,5,0,0,0,5,4,5,0,0,2,1,1,0,0,0,-1,19,-20,29,25,4,-9,4,4,4,1,-5,-2,10,11,3,0,-3,-7,-6,-7,1,1,-2,4,13,9,2,0,0,3,12,9,1,0,0,1,1,0,1,0,0,-24,-8,-16,21,12,9,-1,8,-15,-11,3,-4,-2,3,-6,-5,4,0,1,5,-9,-6,-1,-4,4,7,5,4,1,0,2,5,2,3,0,0,2,2,3,1,1,0,10,2,8,32,17,15,-3,4,4,2,-1,3,-1,3,-3,3,-1,0,-2,1,7,-1,0,3,3,10,11,5,1,2,0,8,4,3,1,1,3,2,7,2,0,1,-9,-5,-4,24,11,13,-1,-3,2,-2,2,-5,-3,-1,0,1,0,-2,2,-2,2,-3,2,-3,3,5,4,6,5,1,1,4,2,3,1,0,2,1,2,3,4,1,129,73,56,74,42,32,14,37,40,27,8,2,4,20,29,18,4,-2,10,17,11,9,4,4,10,23,26,10,3,1,5,14,14,8,1,0,5,9,12,2,2,1,-17,-11,-6,26,8,18,0,5,-10,1,-7,-4,0,3,-8,-1,-4,-1,0,2,-2,2,-3,-3,7,3,9,8,0,0,0,0,4,4,0,0,7,3,5,4,0,0,11,16,-5,10,5,5,7,3,-4,9,6,-9,5,-2,4,7,6,-4,2,5,-8,2,0,-5,4,-1,-7,10,3,1,4,-2,-6,5,3,1,0,1,-1,5,0,0,23,15,8,15,9,6,5,11,-2,10,-3,2,0,5,4,6,-3,3,5,6,-6,4,0,-1,-1,5,3,3,1,3,0,2,3,1,0,2,-1,3,0,2,1,1,-38,-30,-8,5,2,3,-5,-2,-12,-6,-5,-4,-3,-6,-3,-9,-4,-4,-2,4,-9,3,-1,0,1,1,4,0,-1,0,-1,1,3,-1,0,0,2,0,1,1,-1,0,0,-9,9,-8,-7,-1,8,-6,0,-3,1,-1,1,-1,-12,-3,3,2,7,-5,12,0,-2,-3,0,1,-5,-3,-1,0,1,2,-7,-3,0,0,-1,-1,2,0,-1,0,-53,-23,-30,-26,-16,-10,-12,-10,-22,-6,-2,1,-2,-7,-10,-2,-4,2,-10,-3,-12,-4,2,-1,-3,-7,-7,-6,-3,0,-3,-5,-3,-4,-1,0,0,-2,-4,-2,-2,0,1,13,-12,3,9,-6,-7,15,-2,1,-5,2,-2,9,5,0,3,1,-5,6,-7,1,-8,1,3,7,2,-4,-4,-1,3,8,3,-3,-1,-1,0,-1,-1,-1,-3,0,-10,-1,-9,-3,0,-3,8,-12,-1,-5,-1,0,3,-2,-4,0,0,1,5,-10,3,-5,-1,-1,-1,-2,-4,1,3,0,1,-1,-3,2,1,0,-2,-1,-1,-1,2,0,-67,-44,-23,-34,-29,-5,-15,-9,-13,-12,-10,-9,-9,-3,-12,-8,-9,-3,-6,-6,-1,-4,-1,-6,-9,-4,-7,-10,-6,0,-4,-5,-6,-7,-7,0,-5,1,-1,-3,1,0,-29,-23,-6,-1,-6,5,0,5,-17,-8,-12,3,-4,4,-11,-1,-10,-1,4,1,-6,-7,-2,4,-2,7,-1,-3,-3,1,-1,3,-3,-2,-3,0,-1,4,2,-1,0,1
46,46011,Alberic,9150,90,58,32,69,53,16,13,38,24,8,6,-1,5,28,15,5,3,1,8,10,9,3,3,-2,8,26,28,3,2,2,4,24,20,3,1,1,4,2,8,0,1,1,108,87,21,125,88,37,13,28,31,24,3,9,6,28,25,21,3,4,7,0,6,3,0,5,17,38,39,24,6,1,8,28,31,16,4,1,9,10,8,8,2,0,104,75,29,102,63,39,16,22,28,26,9,2,12,15,25,18,5,1,4,7,3,8,4,1,15,27,28,23,5,2,6,16,18,18,3,1,9,11,10,5,2,1,133,81,52,120,69,51,18,21,47,15,17,7,12,10,31,18,5,1,6,11,16,-3,12,6,17,23,30,24,18,5,8,11,19,19,8,2,9,12,11,5,10,3,161,100,61,168,97,71,2,48,41,28,32,13,2,27,33,13,21,5,0,21,8,15,11,8,24,48,40,27,21,7,16,28,23,17,11,1,8,20,17,10,10,6,248,131,117,162,90,72,30,83,42,58,33,1,7,57,25,28,19,-1,23,26,17,30,14,2,15,45,48,32,21,1,6,34,27,11,12,0,9,11,21,21,9,1,183,111,72,144,86,58,52,47,28,46,29,-14,40,14,20,30,15,-6,12,33,8,16,14,-8,37,36,27,28,12,4,25,22,16,16,4,3,12,14,11,12,8,1,504,291,213,251,151,100,84,151,147,91,24,7,41,78,101,52,16,2,43,73,46,39,8,5,40,88,59,42,16,2,23,55,40,21,10,1,17,33,19,21,6,1,196,156,40,183,102,81,25,57,59,39,10,4,25,42,50,28,5,3,0,15,9,11,5,1,43,33,57,28,16,3,18,18,35,20,7,1,25,15,22,8,9,2,170,62,108,141,73,68,48,46,27,34,20,-11,4,25,15,8,5,0,44,21,12,26,15,-11,36,38,41,14,8,0,17,24,21,3,4,0,19,14,20,11,4,0,85,44,41,79,62,17,10,26,31,17,0,5,2,22,21,4,-2,-1,8,4,10,13,2,6,3,28,28,13,2,2,7,17,23,10,1,3,-4,11,5,3,1,-1,-32,-23,-9,112,61,51,-24,4,-26,7,10,-6,-22,7,-13,5,0,-1,-2,-3,-13,2,10,-5,15,41,18,27,10,0,6,27,8,15,4,0,9,14,10,12,6,0,-369,-220,-149,-215,-166,-49,-62,-72,-127,-65,-23,-15,-29,-38,-97,-32,-18,-5,-33,-34,-30,-33,-5,-10,-15,-42,-87,-50,-16,-5,-7,-34,-75,-33,-15,-2,-8,-8,-12,-17,-1,-3,-11,4,-15,49,33,16,-17,-3,-3,2,4,2,0,-3,5,0,-3,-1,-17,0,-8,2,7,3,4,6,9,12,10,4,5,3,7,10,4,1,-1,3,2,2,6,3,-197,-117,-80,-145,-96,-49,-34,-20,-67,-59,-6,-5,-17,-3,-40,-49,-4,-1,-17,-17,-27,-10,-2,-4,-16,-9,-52,-49,-16,-3,-7,-7,-31,-38,-12,-1,-9,-2,-21,-11,-4,-2,-60,-37,-23,-94,-58,-36,7,1,-45,-27,-6,7,1,-1,-27,-11,-4,2,6,2,-18,-16,-2,5,-11,-2,-34,-43,-9,3,-7,0,-21,-25,-6,1,-4,-2,-13,-18,-3,2,-54,-56,2,62,30,32,-6,-14,4,-20,-8,-5,-16,-16,-8,-6,-7,-3,10,2,12,-14,-1,-2,15,14,18,14,1,0,6,5,11,9,-1,0,9,9,7,5,2,0,-56,-75,19,-25,-45,20,-6,4,7,-46,0,-15,0,-4,-1,-49,-13,-7,-6,8,8,3,13,-8,13,-1,-6,-27,5,-9,8,-4,-9,-32,-3,-5,5,3,3,5,8,-4
46,46013,Alboraya,15819,796,428,368,196,114,82,94,126,320,144,71,27,69,54,171,76,40,11,25,72,149,68,31,16,32,26,72,51,10,0,21,13,43,30,5,0,11,13,29,21,5,0,533,271,262,284,171,113,39,111,261,75,26,16,13,49,137,48,17,4,26,62,124,27,9,12,42,60,100,61,14,5,23,30,66,38,10,3,19,30,34,23,4,2,419,227,192,186,97,89,49,71,200,86,13,0,38,28,123,35,10,-5,11,43,77,51,3,5,31,24,71,44,9,7,15,13,40,21,4,4,16,11,31,23,5,3,203,79,124,56,26,30,0,52,109,-11,45,7,-3,14,66,-20,14,4,3,38,43,9,31,3,10,12,10,14,6,3,5,5,7,2,4,3,5,7,3,12,2,0,265,153,112,221,114,107,8,70,118,41,16,14,15,49,66,9,6,7,-7,21,52,32,10,7,22,61,76,42,16,2,10,38,39,17,8,1,12,23,37,25,8,1,607,347,260,336,200,136,35,126,214,133,77,15,19,50,145,82,40,8,16,76,69,51,37,7,45,52,136,74,22,1,23,24,89,48,8,3,22,28,47,26,14,-2,367,155,212,271,140,131,34,104,97,69,50,13,5,47,50,33,22,-1,29,57,47,36,28,14,46,66,80,46,23,7,20,25,48,32,11,2,26,41,32,14,12,5,379,222,157,275,126,149,47,107,117,50,39,13,34,57,56,40,18,8,13,50,61,10,21,5,48,61,79,60,18,8,22,28,38,27,9,1,26,33,41,33,9,7,75,-2,77,98,38,60,-26,58,43,-6,-5,10,-5,7,3,-4,-3,3,-21,51,40,-2,-2,7,5,50,33,2,7,-2,10,22,2,-1,5,0,-5,28,31,3,2,-2,-87,-64,-23,102,28,74,-27,4,7,-67,0,-14,-26,-9,15,-44,6,-12,-1,13,-8,-23,-6,-2,27,38,19,6,6,3,4,13,8,1,0,0,23,25,11,5,6,3,98,67,31,94,35,59,30,16,26,22,-3,6,30,16,18,4,-9,3,0,0,8,18,6,3,32,24,1,31,-4,5,14,12,-1,11,-7,2,18,12,2,20,3,3,316,73,243,14,-10,24,45,64,127,48,27,5,0,11,46,21,1,-3,45,53,81,27,26,8,1,24,-4,-3,-1,-3,-3,6,-5,-2,-4,-2,4,18,1,-1,3,-1,484,233,251,54,18,36,30,34,222,119,47,25,13,17,115,60,14,14,17,17,107,59,33,11,-2,18,12,10,13,-1,-3,9,8,-1,6,-3,1,9,4,11,7,2,207,51,156,54,23,31,23,31,89,37,10,10,0,0,38,12,0,0,23,31,51,25,10,10,14,13,-5,18,9,4,10,1,-2,7,6,1,4,12,-3,11,3,3,218,31,187,44,8,36,64,18,58,28,14,24,30,1,16,-33,-4,13,34,17,42,61,18,11,14,9,7,0,-1,10,8,1,-2,-6,2,3,6,8,9,6,-3,7,112,49,63,176,77,99,-6,22,50,23,25,-8,-1,21,12,3,12,-5,-5,1,38,20,13,-3,39,17,51,33,24,5,14,8,20,15,12,4,25,9,31,18,12,1,174,106,68,160,83,77,14,21,65,15,36,12,6,23,51,2,13,3,8,-2,14,13,23,9,21,25,33,23,36,16,10,13,11,21,17,7,11,12,22,2,19,9,134,13,121,202,99,103,36,7,53,40,-7,4,22,-1,-1,5,-11,-3,14,8,54,35,4,7,45,27,50,46,18,12,21,18,17,25,8,7,24,9,33,21,10,5
46,46014,Albuixech,3048,37,25,12,24,17,7,8,16,18,-1,-5,2,9,10,7,4,-3,-1,-1,6,11,-5,-2,3,0,11,8,5,0,0,0,8,5,4,0,0,0,3,3,1,0,0,74,42,32,41,26,15,2,20,21,22,7,3,-2,11,18,9,4,2,4,9,3,13,3,1,1,10,16,10,4,0,1,4,13,5,3,0,0,6,3,5,1,0,147,94,53,50,34,16,34,22,41,33,4,10,18,16,27,25,3,4,16,6,14,8,1,6,7,19,10,12,2,0,4,11,8,9,2,0,3,8,2,3,0,0,180,85,95,41,23,18,38,28,59,31,1,22,17,11,31,18,0,7,21,17,28,13,1,15,9,10,14,7,1,0,5,6,8,3,1,0,4,4,6,4,0,0,45,14,31,32,18,14,6,15,1,15,7,1,1,8,-5,7,2,0,5,7,6,8,5,1,7,9,8,6,1,1,5,4,5,3,1,0,2,5,3,3,0,1,63,30,33,46,20,26,15,13,18,7,3,5,10,7,10,1,-3,3,5,6,8,6,6,2,10,7,16,9,3,0,4,3,7,5,0,0,6,4,9,4,3,0,162,75,87,44,23,21,31,19,48,20,11,29,20,7,24,14,0,7,11,12,24,6,11,22,12,6,12,11,2,1,8,2,7,5,1,0,4,4,5,6,1,1,143,72,71,51,30,21,10,22,47,20,18,27,2,13,28,14,8,8,8,9,19,6,10,19,6,9,20,11,5,0,1,7,13,6,3,0,5,2,7,5,2,0,103,53,50,8,5,3,13,7,54,11,1,15,9,-1,31,9,0,4,4,8,23,2,1,11,1,4,5,1,-1,-2,0,3,3,1,0,-2,1,1,2,0,-1,0,75,34,41,-9,-6,-3,5,14,24,3,8,20,0,10,12,2,1,9,5,4,12,1,7,11,-5,0,-1,-4,1,-1,-4,1,-2,-2,0,0,-1,-1,1,-2,1,-1,36,15,21,0,1,-1,2,7,9,9,-2,10,4,3,2,2,2,1,-2,4,7,7,-4,9,-2,-2,7,-2,-2,1,1,-2,4,-1,-1,0,-3,0,3,-1,-1,1,-36,-32,-4,-69,-47,-22,-5,3,-21,-15,-9,8,-1,1,-16,-13,-5,2,-4,2,-5,-2,-4,6,-2,-1,-31,-25,-10,-1,-1,0,-22,-19,-5,-1,-1,-1,-9,-6,-5,0,-55,-29,-26,-22,-16,-6,-5,-7,-22,-3,-12,-4,-3,-7,-14,4,-8,-1,-2,0,-8,-7,-4,-3,-2,-2,-7,-7,-3,-1,-2,-3,-4,-4,-2,-1,0,1,-3,-3,-1,0,32,5,27,4,-2,6,6,1,5,0,-2,19,3,-1,2,-1,-3,3,3,2,3,1,1,16,-3,2,4,-2,2,0,-1,0,0,-1,-1,0,-2,2,4,-1,3,0,35,33,2,15,11,4,2,2,4,8,7,10,0,6,6,8,6,6,2,-4,-2,0,1,4,1,5,4,2,1,0,0,4,4,1,1,0,1,1,0,1,0,0,12,16,-4,-19,-6,-13,-7,7,-1,0,7,6,0,0,6,4,6,1,-7,7,-7,-4,1,5,-4,-5,-4,-4,0,-2,1,-2,-2,-4,1,0,-5,-3,-2,0,-1,-2,18,-4,22,-9,-5,-4,-14,3,-10,-9,10,36,-5,2,-3,-12,5,8,-9,1,-7,3,5,28,-5,0,-5,1,0,0,-4,0,-2,0,1,0,-1,0,-3,1,-1,0,92,34,58,31,14,17,14,3,9,14,9,40,9,2,-4,4,7,14,5,1,13,10,2,26,9,4,2,7,6,3,4,2,1,3,1,3,5,2,1,4,5,0
46,46020,"Alcúdia de Crespins, l'",4126,122,76,46,97,62,35,-5,23,53,25,13,13,-5,16,41,12,6,5,0,7,12,13,7,8,3,21,48,19,4,1,0,14,35,11,1,0,3,7,13,8,3,1,204,128,76,169,107,62,20,55,70,48,7,3,6,30,48,35,5,3,14,25,22,13,2,0,12,39,70,43,2,2,5,22,47,29,1,2,7,17,23,14,1,0,150,104,46,149,91,58,23,33,27,29,3,35,19,16,32,18,4,15,4,17,-5,11,-1,20,20,36,48,36,8,1,12,19,33,22,5,0,8,17,15,14,3,1,125,86,39,120,84,36,7,39,31,21,8,21,3,25,31,15,6,6,4,14,0,6,2,15,13,31,38,34,3,1,7,22,27,24,3,1,6,9,11,10,0,0,151,111,40,140,90,50,20,41,53,12,10,13,14,34,43,5,6,7,6,7,10,7,4,6,11,40,56,27,6,0,2,25,42,18,3,0,9,15,14,9,3,0,43,27,16,67,37,30,6,17,-1,19,-4,6,4,11,4,8,-1,2,2,6,-5,11,-3,4,5,18,30,13,0,1,3,7,21,7,-1,0,2,11,9,6,1,1,-57,-62,5,-116,-103,-13,8,18,-39,-50,-8,16,7,10,-30,-40,-9,2,1,8,-9,-10,1,14,6,2,-65,-52,-8,1,4,6,-54,-50,-9,0,2,-4,-11,-2,1,1,223,133,90,128,85,43,41,49,59,44,12,14,21,28,35,30,7,8,20,21,24,14,5,6,12,39,44,28,3,1,7,18,27,26,5,1,5,21,17,2,-2,0,66,23,43,-20,-19,-1,19,2,22,10,8,2,7,0,8,5,4,-1,12,2,14,5,4,3,5,-3,-12,-13,2,0,4,-5,-9,-8,-1,0,1,2,-3,-5,3,0,96,49,47,27,16,11,4,27,33,15,8,8,-1,15,25,3,3,4,5,12,8,12,5,4,2,22,4,-7,6,0,5,13,4,-9,4,0,-3,9,0,2,2,0,-36,-51,15,-68,-54,-14,8,0,-11,-27,-6,2,9,-6,-16,-28,-9,1,-1,6,5,1,3,1,-2,-12,-20,-25,-8,-2,-2,-10,-17,-18,-7,0,0,-2,-3,-7,-1,-2,17,-7,24,-4,-17,13,6,1,3,7,5,-2,8,-7,-8,-4,2,2,-2,8,11,11,3,-4,1,-3,-6,-2,6,0,-1,-8,-4,-8,3,1,2,5,-2,6,3,-1,19,3,16,-42,-27,-15,21,-1,-10,1,5,1,4,-4,-5,-1,8,0,17,3,-5,2,-3,1,0,-9,-18,-11,-4,0,-2,-7,-11,-7,-1,1,2,-2,-7,-4,-3,-1,-92,-54,-38,-82,-41,-41,-7,1,-24,-47,-14,-1,-10,2,-10,-28,-9,0,3,-1,-14,-19,-5,-1,-9,4,-25,-33,-18,-1,-2,1,-8,-18,-14,0,-7,3,-17,-15,-4,-1,43,32,11,34,23,11,-3,-1,25,18,7,-4,3,-3,18,13,1,-2,-6,2,7,5,6,-2,3,4,7,14,6,0,1,3,7,9,3,0,2,1,0,5,3,0,-64,-40,-24,-44,-26,-18,-25,-12,-11,-20,1,0,-10,-9,0,-25,3,-1,-15,-3,-11,5,-2,1,-9,-6,-16,-6,-7,0,-5,-2,-9,-6,-4,0,-4,-4,-7,0,-3,0,-39,-16,-23,-9,-12,3,-7,1,-17,0,-6,-8,-4,-3,-11,7,-3,-1,-3,4,-6,-7,-3,-7,0,2,-1,1,-12,1,0,1,-4,-1,-7,-1,0,1,3,2,-5,2,39,20,19,2,2,0,10,-5,0,12,6,19,6,3,2,3,2,5,4,-8,-2,9,4,14,0,0,0,0,1,1,-2,0,0,3,1,0,2,0,0,-3,0,1
46,46021,Aldaia,24297,166,94,72,61,34,27,39,16,62,25,11,8,6,18,35,19,8,9,33,-2,27,6,3,-1,8,18,18,11,5,1,3,10,13,5,3,0,5,8,5,6,2,1,127,67,60,156,92,64,37,43,15,16,24,-9,11,20,8,16,16,-4,26,23,7,0,8,-5,24,40,53,24,12,0,13,22,40,13,3,0,11,18,13,11,9,0,399,197,202,138,80,58,24,96,164,78,28,9,-12,42,102,54,9,2,36,54,62,24,19,7,25,28,47,28,8,0,12,11,34,20,2,0,13,17,13,8,6,0,526,276,250,122,63,59,59,189,205,18,15,25,39,89,119,6,11,5,20,100,86,12,4,20,31,37,37,3,9,4,18,18,17,2,6,2,13,19,20,1,3,2,407,201,206,116,50,66,32,125,218,13,2,16,1,52,130,2,5,7,31,73,88,11,-3,9,24,25,42,13,7,3,11,4,19,8,5,2,13,21,23,5,2,1,615,337,278,168,93,75,62,151,259,104,5,22,33,82,155,52,2,6,29,69,104,52,3,16,23,51,56,23,12,3,8,27,37,14,7,0,15,24,19,9,5,3,388,169,219,168,76,92,19,132,203,39,15,-19,-2,49,117,14,4,-8,21,83,86,25,11,-11,26,52,37,35,18,-1,8,29,18,17,6,-2,18,23,19,18,12,1,785,425,360,231,117,114,82,181,343,94,52,24,51,85,180,68,19,14,31,96,163,26,33,10,39,73,69,28,12,8,15,42,37,13,4,6,24,31,32,15,8,2,512,266,246,85,28,57,69,108,210,83,32,14,32,54,115,52,15,-1,37,54,95,31,17,15,16,18,36,7,6,2,5,5,10,4,3,1,11,13,26,3,3,1,251,154,97,-13,-6,-7,-11,92,118,10,11,22,5,44,78,8,4,10,-16,48,40,2,7,12,7,8,-17,-9,-5,1,3,5,-13,-3,1,0,4,3,-4,-6,-6,1,158,68,90,27,16,11,27,49,53,17,6,2,9,14,26,10,8,-5,18,35,27,7,-2,7,8,8,-8,4,15,-1,5,6,-2,-1,7,-1,3,2,-6,5,8,0,115,73,42,48,21,27,8,-1,38,35,30,-16,12,4,13,30,7,-1,-4,-5,25,5,23,-15,15,10,20,3,-3,-1,9,1,15,2,-6,-1,6,9,5,1,3,0,-6,-4,-2,-58,-40,-18,-4,0,-16,8,10,-10,-1,-8,8,-13,7,-2,-3,8,-24,21,3,-8,-10,9,-21,-31,-1,-4,-10,3,-13,-17,-1,-2,0,6,-8,-14,0,-2,-100,-74,-26,-53,-39,-14,-12,13,-55,-40,0,-16,-11,-2,-26,-33,-7,-3,-1,15,-29,-7,7,-13,-7,0,-24,-19,-1,-4,-6,0,-17,-16,-2,0,-1,0,-7,-3,1,-4,-45,-33,-12,-109,-73,-36,17,12,-15,-17,-23,-17,-4,4,11,-13,-14,-16,21,8,-26,-4,-9,-1,-25,-4,-30,-40,-12,-1,-11,2,-16,-36,-10,-3,-14,-6,-14,-4,-2,2,7,12,-5,-20,-15,-5,16,-4,17,-3,-4,-14,-3,-1,14,-1,0,-1,19,-3,3,-2,-4,-13,1,3,-13,-7,-7,-1,-6,0,-6,-3,-3,0,7,3,-7,-4,-4,-1,29,-8,37,50,18,32,32,0,34,-20,-22,-16,31,-5,8,-22,-22,-9,1,5,26,2,0,-7,13,13,6,2,13,-1,13,3,4,-9,3,2,0,10,2,11,10,-3,180,61,119,124,71,53,25,78,1,44,18,5,7,42,-11,18,-2,8,18,36,12,26,20,-3,17,44,22,29,7,3,10,29,12,14,1,3,7,15,10,15,6,0
46,46022,Alfafar,19205,16,30,-14,103,66,37,6,-3,31,-3,-16,5,7,3,27,8,-6,-5,-1,-6,4,-11,-10,10,15,26,36,20,3,2,9,16,25,14,1,1,6,10,11,6,2,1,-147,-56,-91,160,97,63,-26,15,-88,10,-38,-19,-23,16,-34,6,-14,-6,-3,-1,-54,4,-24,-13,14,42,66,27,8,3,5,29,43,13,5,2,9,13,23,14,3,1,71,29,42,153,83,70,13,30,22,16,-22,15,21,5,10,3,-14,4,-8,25,12,13,-8,11,43,34,43,25,9,-1,28,15,25,12,4,-1,15,19,18,13,5,0,249,130,119,196,104,92,52,71,102,31,-9,-4,21,47,50,27,-11,-4,31,24,52,4,2,0,43,43,67,27,11,3,28,26,34,13,2,1,15,17,33,14,9,2,278,114,164,122,51,71,81,76,99,-5,6,13,30,52,30,-5,1,0,51,24,69,0,5,13,20,42,34,12,7,7,9,23,10,6,1,2,11,19,24,6,6,5,520,263,257,264,136,128,85,134,164,115,8,1,46,63,81,65,3,2,39,71,83,50,5,-1,42,87,80,38,11,3,20,50,43,17,6,-1,22,37,37,21,5,4,311,134,177,308,151,157,83,100,84,60,-14,-5,53,37,29,25,-3,-5,30,63,55,35,-11,0,56,69,120,42,15,1,32,26,66,23,0,1,24,43,54,19,15,0,459,247,212,264,137,127,127,136,133,61,15,-15,53,75,84,46,4,-14,74,61,49,15,11,-1,45,100,73,41,5,-1,25,58,36,19,0,0,20,42,37,22,5,-1,150,75,75,234,120,114,38,95,35,7,4,-31,22,34,35,-2,-1,-10,16,61,0,9,5,-21,23,89,68,34,12,3,11,48,40,15,6,-1,12,41,28,19,6,4,-87,-67,-20,88,42,46,-41,9,17,-34,-14,-10,-20,4,11,-34,-11,-4,-21,5,6,0,-3,-6,6,37,35,5,3,1,9,12,21,0,-2,1,-3,25,14,5,5,0,-281,-169,-112,-145,-70,-75,-54,-8,-93,-72,-23,-17,-18,-12,-58,-52,-17,-5,-36,4,-35,-20,-6,-12,-32,-1,-47,-54,-11,-5,-13,2,-22,-33,-5,-2,-19,-3,-25,-21,-6,-3,58,7,51,56,21,35,29,10,24,40,-30,3,21,6,-16,24,-16,-6,8,4,40,16,-14,9,14,18,12,4,6,3,4,13,7,-2,0,-1,10,5,5,6,6,4,153,66,87,21,-1,22,57,50,56,11,-3,-20,6,29,34,3,-3,-7,51,21,22,8,0,-13,16,17,-17,0,6,-2,9,8,-18,-4,2,1,7,9,1,4,4,-3,197,102,95,-175,-99,-76,10,72,96,40,-6,-11,5,31,59,26,-6,-7,5,41,37,14,0,-4,-26,-19,-58,-50,-20,-5,-12,-9,-42,-26,-9,-2,-14,-10,-16,-24,-11,-3,-120,-89,-31,-25,-8,-17,25,6,-103,-42,-22,12,12,0,-60,-37,-13,5,13,6,-43,-5,-9,7,2,6,-8,-15,-10,-4,6,4,-8,-8,-2,-3,-4,2,0,-7,-8,-1,-313,-197,-116,-175,-105,-70,-47,-13,-115,-83,-40,-6,-33,2,-83,-46,-27,-3,-14,-15,-32,-37,-13,-3,-16,-9,-54,-69,-23,-5,-6,3,-39,-39,-20,-4,-10,-12,-15,-30,-3,-1,31,11,20,60,22,38,42,13,-20,-14,11,12,9,13,-22,3,8,7,33,0,2,-17,3,5,4,22,11,9,4,13,-1,13,1,5,0,4,5,9,10,4,4,9,40,36,4,144,80,64,-20,28,8,11,45,-26,-5,22,-5,7,23,-2,-15,6,13,4,22,-24,27,33,39,12,20,6,13,23,22,5,9,4,14,10,17,7,11,2
46,46025,Alfara del Patriarca,2726,-11,-4,-7,25,11,14,0,-3,-3,2,-5,1,-3,0,2,0,-3,3,3,-3,-5,2,-2,-2,5,4,9,7,0,0,2,1,3,5,0,0,3,3,6,2,0,0,0,10,-10,22,12,10,-1,-8,18,0,-1,-6,3,-6,14,4,0,-3,-4,-2,4,-4,-1,-3,2,0,18,1,1,0,1,0,10,0,1,0,1,0,8,1,0,0,18,7,11,35,20,15,-3,1,14,-1,8,0,-3,-3,12,0,3,-1,0,4,2,-1,5,1,8,1,13,11,2,0,5,1,8,5,1,0,3,0,5,6,1,0,45,20,25,33,15,18,1,20,11,10,4,-1,1,6,8,3,2,-1,0,14,3,7,2,0,7,14,5,6,1,0,4,4,3,3,1,0,3,10,2,3,0,0,65,32,33,24,11,13,9,23,14,18,3,-3,5,10,11,8,2,-4,4,13,3,10,1,1,9,3,7,4,1,0,5,1,3,1,1,0,4,2,4,3,0,0,51,22,29,19,9,10,1,20,24,3,4,0,-3,10,14,-3,4,0,4,10,10,6,0,0,0,6,11,0,2,0,1,3,7,-2,0,0,-1,3,4,2,2,0,102,44,58,32,14,18,4,27,58,5,11,-2,0,8,23,9,5,1,4,19,35,-4,6,-3,1,12,10,5,3,1,-1,5,5,3,1,1,2,7,5,2,2,0,120,72,48,32,19,13,19,40,35,16,7,0,11,23,15,12,5,4,8,17,20,4,2,-4,12,6,7,5,2,0,6,5,3,5,0,0,6,1,4,0,2,0,22,0,22,30,7,23,3,6,9,12,-12,2,2,-5,7,-1,-4,-1,1,11,2,13,-8,3,7,8,12,5,-2,0,4,1,4,-1,-1,0,3,7,8,6,-1,0,75,29,46,-2,-6,4,7,23,44,3,3,-7,7,11,18,-6,0,-1,0,12,26,9,3,-6,0,1,1,-3,-1,0,0,0,-2,-4,0,0,0,1,3,1,-1,0,76,38,38,23,13,10,9,37,22,14,-5,-2,0,18,19,4,-4,1,9,19,3,10,-1,-3,3,14,5,1,0,0,2,8,2,1,0,0,1,6,3,0,0,0,-21,-20,-1,-4,-8,4,-8,13,-14,-12,5,-5,-4,3,-10,-10,4,-2,-4,10,-4,-2,1,-3,-2,9,-6,-7,1,0,0,2,-4,-6,0,0,-2,7,-2,-1,1,0,0,-4,4,19,4,15,-1,29,0,-13,-10,-2,0,19,0,-12,-9,0,-1,10,0,-1,-1,-2,5,29,-9,-5,-1,0,1,14,-6,-4,-1,0,4,15,-3,-1,0,0,16,3,13,13,-3,16,5,20,2,-10,1,-2,3,0,1,1,0,-2,2,20,1,-11,1,0,0,22,-2,-6,-2,1,0,5,-2,-3,-3,0,0,17,0,-3,1,1,29,1,28,55,24,31,-7,50,7,-15,-1,-4,-5,26,-3,-11,-2,-2,-2,24,10,-4,1,-2,3,51,-2,2,1,0,2,23,-3,2,0,0,1,28,1,0,1,0,106,35,71,81,21,60,4,85,18,-5,9,-3,0,20,13,-1,5,0,4,65,5,-4,4,-3,0,84,-1,-2,1,-1,0,22,1,-2,0,0,0,62,-2,0,1,-1,13,5,8,28,13,15,2,19,-2,-6,1,-2,-2,14,0,-3,-3,-1,4,5,-2,-3,4,-1,2,27,3,-2,0,-2,0,9,4,-1,2,-1,2,18,-1,-1,-2,-1,8,-13,21,46,10,36,-1,49,-29,-3,3,-11,-5,11,-15,2,-1,-7,4,38,-14,-5,4,-4,3,42,-1,1,1,0,2,11,-3,0,0,0,1,31,2,1,1,0
46,46027,Alfarrasí,1205,44,28,16,26,17,9,13,2,16,8,0,3,8,2,10,5,0,2,5,0,6,3,0,1,8,3,9,4,2,0,5,2,6,2,2,0,3,1,3,2,0,0,20,14,6,21,11,10,3,1,9,7,1,-1,2,1,6,5,1,-1,1,0,3,2,0,0,4,4,9,4,0,0,0,2,7,2,0,0,4,2,2,2,0,0,16,8,8,12,3,9,3,5,4,2,3,-1,0,3,2,2,2,-1,3,2,2,0,1,0,2,5,4,1,0,0,0,1,2,0,0,0,2,4,2,1,0,0,12,4,8,10,5,5,5,-3,9,3,-1,-1,4,-3,3,2,-1,-1,1,0,6,1,0,0,0,2,6,2,0,0,0,0,3,2,0,0,0,2,3,0,0,0,4,8,-4,21,13,8,-1,8,4,-6,-2,0,1,7,3,-4,-1,0,-2,1,1,-2,-1,0,6,7,4,3,0,0,3,5,2,2,0,0,3,2,2,1,0,0,10,13,-3,13,9,4,4,-2,-3,9,3,-1,1,2,-1,7,4,0,3,-4,-2,2,-1,-1,2,4,3,4,0,0,0,3,2,4,0,0,2,1,1,0,0,0,-5,-10,5,12,6,6,-3,-1,-8,1,4,-1,-4,-2,-4,-4,2,0,1,1,-4,5,2,-1,0,3,6,3,0,0,0,1,4,1,0,0,0,2,2,2,0,0,9,6,3,18,9,9,6,-1,-1,6,0,0,3,0,1,4,-1,0,3,-1,-2,2,1,0,9,1,4,4,0,0,4,0,2,3,0,0,5,1,2,1,0,0,-18,-4,-14,-2,-4,2,-6,2,-8,-3,0,-3,1,-1,-3,0,-1,-1,-7,3,-5,-3,1,-2,2,1,-4,-1,0,0,0,0,-3,-1,0,0,2,1,-1,0,0,0,1,-3,4,4,1,3,2,3,-4,4,-3,0,2,0,-3,0,-1,0,0,3,-1,4,-2,0,1,2,-1,2,0,0,1,0,-1,1,0,0,0,2,0,1,0,0,-8,-4,-4,3,2,1,2,-2,-3,-4,0,-2,1,-3,4,-4,-1,-1,1,1,-7,0,1,-1,1,0,0,2,0,0,1,0,0,1,0,0,0,0,0,1,0,0,9,8,1,6,4,2,6,-4,9,1,-1,0,4,-2,6,2,-1,0,2,-2,3,-1,0,0,2,0,4,0,0,0,2,-1,3,0,0,0,0,1,1,0,0,0,-7,-5,-2,2,0,2,2,6,-9,-3,-4,1,2,4,-10,0,-2,0,0,2,1,-3,-2,1,5,1,-1,-2,-1,0,3,0,-1,-2,0,0,2,1,0,0,-1,0,-25,-13,-12,-11,-4,-7,-3,0,-4,-8,-9,-1,0,-3,-2,-3,-5,0,-3,3,-2,-5,-4,-1,-2,0,-4,-1,-4,0,-1,0,-1,0,-2,0,-1,0,-3,-1,-2,0,-5,-8,3,8,2,6,-2,-4,-4,1,1,1,-4,1,-7,-1,0,2,2,-5,3,2,1,-1,-2,2,5,1,2,0,-2,1,1,1,1,0,0,1,4,0,1,0,28,21,7,17,12,5,7,2,11,12,-3,-1,9,2,5,8,-2,-1,-2,0,6,4,-1,0,7,3,2,5,0,0,7,1,1,3,0,0,0,2,1,2,0,0,-14,-8,-6,-10,-6,-4,-3,-1,-4,-7,-2,1,-3,1,-2,-2,-2,0,0,-2,-2,-5,0,1,-1,0,-8,-1,-1,0,-2,0,-3,-1,0,0,1,0,-5,0,-1,0,2,1,1,-3,-3,0,1,-6,-1,0,6,0,-1,-1,1,1,1,0,2,-5,-2,-1,5,0,-3,-1,0,-1,1,0,-4,1,1,0,-1,0,1,-2,-1,-1,2,0
46,46029,Algemesí,25045,31,34,-3,84,39,45,3,16,20,-1,11,-19,2,10,26,-8,7,-1,1,6,-6,7,4,-18,5,24,34,11,6,2,3,4,22,6,2,1,2,20,12,5,4,1,149,85,64,112,63,49,24,30,55,28,11,-1,14,21,28,22,0,-2,10,9,27,6,11,1,22,30,36,19,3,2,10,19,22,10,1,1,12,11,14,9,2,1,276,146,130,155,84,71,48,89,72,48,3,11,15,43,53,29,5,0,33,46,19,19,-2,11,26,44,48,26,7,4,10,21,33,16,3,1,16,23,15,10,4,3,391,201,190,234,122,112,123,90,109,36,7,13,53,50,64,17,1,9,70,40,45,19,6,4,62,59,67,22,13,8,34,29,36,12,5,4,28,30,31,10,8,4,262,171,91,202,111,91,79,32,92,61,0,-4,54,19,60,39,3,-3,25,13,32,22,-3,-1,39,38,61,53,7,3,16,19,44,26,4,2,23,19,17,27,3,1,422,209,213,261,129,132,117,82,126,57,30,20,66,40,54,33,9,12,51,42,72,24,21,8,64,56,72,41,17,10,31,33,34,19,4,7,33,23,38,22,13,3,240,104,136,224,102,122,53,52,92,55,-2,-12,31,3,53,30,-7,-6,22,49,39,25,5,-6,58,55,71,32,12,-5,31,19,34,13,6,-2,27,36,37,19,6,-3,435,168,267,340,135,205,110,85,133,80,12,5,34,32,42,37,9,12,76,53,91,43,3,-7,102,62,95,50,19,5,44,21,31,25,7,3,58,41,64,25,12,2,320,198,122,225,99,126,99,35,116,62,2,-3,51,15,70,47,7,2,48,20,46,15,-5,-5,66,58,62,20,12,4,32,19,29,9,6,3,34,39,33,11,6,1,-196,-126,-70,-64,-67,3,-43,-4,-50,-68,-25,-6,-16,-12,-33,-44,-19,-4,-27,8,-17,-24,-6,-2,-2,21,-30,-49,-8,-1,4,1,-31,-36,-6,-2,-6,20,1,-13,-2,1,-140,-97,-43,-3,-18,15,-34,-2,-63,-41,15,-14,-33,3,-36,-28,6,-11,-1,-5,-27,-13,9,-3,8,17,-6,-18,-3,-3,-2,1,-6,-10,1,-2,10,16,0,-8,-4,-1,-45,-24,-21,-34,-34,0,-1,3,-53,8,-11,5,7,3,-27,-2,-13,6,-8,0,-26,10,2,-1,-4,6,-17,-12,-13,3,-2,3,-15,-13,-11,1,-2,3,-2,1,-2,2,-329,-161,-168,-133,-79,-54,-81,-37,-76,-77,-34,-20,-44,-22,-34,-40,-13,-7,-37,-15,-42,-37,-21,-13,-22,-3,-34,-42,-27,-5,-7,-2,-25,-30,-12,-3,-15,-1,-9,-12,-15,-2,-185,-62,-123,-122,-48,-74,-88,-5,-46,-35,2,-7,-40,1,-8,-14,6,-8,-48,-6,-38,-21,-4,1,-37,-5,-30,-37,-12,1,-19,-1,-3,-19,-5,0,-18,-4,-27,-18,-7,1,-174,-99,-75,-61,-37,-24,-19,-37,-17,-91,-8,6,-15,-11,-3,-63,-2,2,-4,-26,-14,-28,-6,4,-17,-3,-14,-27,-1,-1,-9,0,-8,-18,-2,0,-8,-3,-6,-9,1,-1,1,18,-17,32,19,13,6,11,-11,3,11,-19,13,2,2,2,6,-8,-7,9,-13,1,5,-11,19,16,-3,-7,6,-2,8,12,1,-8,4,0,11,4,-4,1,2,-2,-45,-4,-41,-10,-9,-1,-10,16,-53,9,-13,1,1,18,-24,9,-10,-2,-11,-2,-29,0,-3,3,-6,8,-9,-10,-1,3,-2,6,-13,-3,-1,2,-4,2,4,-7,0,1,-112,-52,-60,6,3,3,-20,-27,-17,-14,-12,-28,-16,-14,-4,7,-12,-14,-4,-13,-13,-21,0,-14,12,-6,-2,-5,3,-1,15,-7,-1,-8,1,0,-3,1,-1,3,2,-1
46,46032,Almàssera,5644,103,47,56,19,11,8,25,11,10,34,8,11,14,7,-6,22,3,4,11,4,16,12,5,7,3,4,5,6,0,1,2,3,1,5,0,0,1,1,4,1,0,1,175,91,84,9,6,3,37,28,62,30,9,7,18,12,36,15,4,4,19,16,26,15,5,3,0,0,6,2,1,0,0,0,4,1,1,0,0,0,2,1,0,0,203,110,93,21,12,9,32,37,81,34,13,7,9,23,46,22,7,3,23,14,35,12,6,4,6,5,3,2,3,2,3,2,2,1,2,2,3,3,1,1,1,0,220,129,91,22,10,12,19,47,102,26,16,6,6,35,64,10,8,4,13,12,38,16,8,2,5,1,10,2,5,-1,3,1,4,1,1,0,2,0,6,1,4,-1,166,88,78,35,22,13,27,32,68,21,7,9,14,22,39,8,-1,5,13,10,29,13,8,4,6,7,12,6,2,2,2,6,9,3,0,2,4,1,3,3,2,0,110,56,54,34,20,14,18,24,39,26,-5,2,14,8,18,14,1,-2,4,16,21,12,-6,4,8,11,4,8,1,1,4,6,4,5,1,0,4,5,0,3,0,1,99,46,53,78,38,40,24,18,47,19,0,-10,13,9,23,8,-1,-4,11,9,24,11,1,-6,17,19,25,10,3,2,10,7,13,6,1,1,7,12,12,4,2,1,8,17,-9,55,22,33,1,6,24,-18,-5,6,0,4,27,-14,0,2,1,2,-3,-4,-5,4,15,15,19,7,-1,0,4,4,11,3,0,0,11,11,8,4,-1,0,68,30,38,28,13,15,32,1,12,15,7,-3,17,-1,8,4,2,-2,15,2,4,11,5,-1,4,5,10,8,1,1,4,2,4,4,0,0,0,3,6,4,1,1,12,3,9,22,12,10,0,12,-11,9,4,-1,-10,10,-6,4,4,-1,10,2,-5,5,0,0,3,9,6,5,-1,-1,1,5,4,2,0,0,2,4,2,3,-1,-1,28,25,3,29,9,20,13,4,25,-5,-5,-3,15,1,18,4,-8,-5,-2,3,7,-9,3,2,6,5,9,6,2,1,2,3,1,3,0,0,4,2,8,3,2,1,45,26,19,4,-3,7,21,4,10,18,-4,-6,13,-1,0,12,0,1,8,5,10,6,-4,-7,4,-1,4,0,-1,-2,0,0,0,-2,0,-1,4,-1,4,2,-1,-1,-25,-17,-8,-10,-5,-5,-16,9,-14,-9,4,0,-5,5,-14,-8,5,1,-11,4,0,-1,-1,-1,-5,-1,-2,-2,0,0,-2,-1,-2,-1,0,1,-3,0,0,-1,0,-1,-16,-10,-6,-6,-1,-5,-8,3,-7,9,-5,-5,1,3,-6,1,-5,-3,-9,0,-1,8,0,-2,1,-2,-6,3,-3,1,-1,-2,0,3,-1,0,2,0,-6,0,-2,1,-28,-7,-21,-12,-5,-7,-16,-8,2,-19,13,1,-6,-4,-4,-10,14,4,-10,-4,6,-9,-1,-3,-4,3,-2,-6,-3,0,-1,0,1,-4,-1,0,-3,3,-3,-2,-2,0,50,9,41,17,7,10,16,-5,29,4,5,-3,6,-7,7,3,-1,-1,10,2,22,1,6,-2,5,0,7,3,-1,2,3,2,2,0,-2,1,2,-2,5,3,1,1,3,0,3,13,6,7,-7,11,-9,-1,6,2,1,7,-7,-8,0,7,-8,4,-2,7,6,-5,0,7,1,1,1,2,0,4,1,-1,1,1,0,3,0,2,0,1,-6,-4,-2,24,15,9,-4,5,12,-7,-6,3,-11,6,14,-3,-6,1,7,-1,-2,-4,0,2,6,5,12,-1,4,-1,5,1,6,2,2,0,1,4,6,-3,2,-1
46,46035,Almussafes,7122,-32,-22,-10,25,12,13,-1,14,-28,-6,-5,-4,-8,8,-14,-2,-3,-1,7,6,-14,-4,-2,-3,7,7,8,2,0,0,3,3,4,2,0,0,4,4,4,0,0,0,70,30,40,60,33,27,6,44,19,-2,0,3,9,12,13,-9,1,4,-3,32,6,7,-1,-1,8,18,25,5,3,1,6,7,14,3,2,1,2,11,11,2,1,0,101,51,50,60,34,26,30,38,17,7,-1,2,22,12,9,1,4,-1,8,26,8,6,-5,3,13,17,14,12,1,2,7,7,9,7,2,1,6,10,5,5,-1,1,28,5,23,49,24,25,6,5,-2,5,-14,10,1,6,-4,2,-9,3,5,-1,2,3,-5,7,12,8,15,12,1,1,5,4,9,5,1,0,7,4,6,7,0,1,107,60,47,47,23,24,43,29,9,25,-7,5,18,28,5,14,-6,0,25,1,4,11,-1,5,8,14,9,8,6,0,6,5,6,3,3,0,2,9,3,5,3,0,165,118,47,83,46,37,31,44,65,20,4,0,15,35,46,13,3,3,16,9,19,7,1,-3,13,25,27,13,2,1,4,15,16,6,2,1,9,10,11,7,0,0,149,86,63,88,46,42,49,30,29,24,5,8,29,4,33,8,4,4,20,26,-4,16,1,4,22,30,22,9,2,2,11,9,18,4,1,2,11,21,4,5,1,0,187,109,78,129,74,55,39,30,60,22,18,16,22,4,42,17,13,10,17,26,18,5,5,6,26,25,38,18,10,9,15,10,23,13,7,5,11,15,15,5,3,4,41,14,27,11,-4,15,41,2,-1,-7,4,1,12,12,-1,-16,1,1,29,-10,0,9,3,0,18,-1,-6,0,-2,1,6,3,-7,-6,-2,1,12,-4,1,6,0,0,62,37,25,3,1,2,-4,33,14,13,-9,11,0,15,10,10,-2,3,-4,18,4,3,-7,8,-1,11,-5,2,-3,-1,2,5,-5,1,-2,0,-3,6,0,1,-1,-1,40,11,29,-43,-21,-22,-18,6,28,3,-6,26,-2,-4,13,-1,-8,11,-16,10,15,4,2,15,-15,1,-11,-7,-11,0,-11,2,-6,-2,-5,1,-4,-1,-5,-5,-6,-1,100,29,71,9,0,9,23,9,24,0,14,29,7,2,5,2,8,6,16,7,19,-2,6,23,0,5,6,-6,1,2,1,1,1,-5,2,-1,-1,4,5,-1,-1,3,21,38,-17,-25,-17,-8,-27,25,17,-10,11,8,-3,14,17,-3,7,5,-24,11,0,-7,4,3,-13,3,-12,-2,-1,-1,-3,0,-10,-3,-2,0,-10,3,-2,1,1,-1,160,91,69,17,11,6,28,34,51,30,12,4,11,20,29,22,7,-1,17,14,22,8,5,5,0,13,1,1,2,-1,-1,9,-1,1,2,0,1,4,2,0,0,-1,9,-19,28,-11,-16,5,34,-3,-15,4,-22,10,18,-4,-15,1,-15,-3,16,1,0,3,-7,13,6,-3,-6,-5,-3,0,2,-7,-5,-3,-2,-1,4,4,-1,-2,-1,1,85,31,54,-16,-11,-5,26,20,21,9,-12,17,15,9,0,7,-11,8,11,11,21,2,-1,9,2,-3,-2,-9,-4,-1,-1,-3,-1,-4,-3,0,3,0,-1,-5,-1,-1,45,7,38,14,5,9,23,1,8,3,-1,10,6,3,-4,-2,2,1,17,-2,12,5,-3,9,14,1,-6,-5,3,6,6,3,-2,-7,2,2,8,-2,-4,2,1,4,4,-11,15,18,8,10,9,-13,-8,12,-2,4,6,-6,-4,0,-6,-1,3,-7,-4,12,4,5,3,6,4,3,1,1,3,2,3,2,-1,-1,0,4,1,1,2,2
46,46017,Alzira,40441,214,130,84,208,140,68,27,42,99,10,2,30,24,28,43,19,9,5,3,14,56,-9,-7,25,32,55,73,36,9,0,15,40,48,28,8,0,17,15,25,8,1,0,121,53,68,160,104,56,17,68,2,16,10,11,7,33,18,-5,0,0,10,35,-16,21,10,11,19,45,55,23,13,3,8,28,45,13,7,2,11,17,10,10,6,1,160,109,51,115,72,43,5,80,59,10,11,-10,5,49,53,-5,12,-5,0,31,6,15,-1,-5,19,22,27,20,22,4,10,17,19,12,12,2,9,5,8,8,10,2,210,65,145,227,112,115,50,63,67,21,-11,16,13,13,52,-2,-13,0,37,50,15,23,2,16,52,49,78,33,11,3,23,25,41,18,4,0,29,24,37,15,7,3,588,292,296,387,190,197,88,163,179,76,60,9,56,77,98,34,24,0,32,86,81,42,36,9,57,102,122,60,39,3,35,50,65,22,14,2,22,52,57,38,25,1,619,335,284,412,226,186,109,148,190,76,53,36,40,73,132,47,28,14,69,75,58,29,25,22,68,120,132,44,39,6,30,59,85,30,17,3,38,61,47,14,22,3,355,174,181,372,193,179,105,61,112,61,1,-1,43,19,70,24,-4,10,62,42,42,37,5,-11,71,85,120,59,25,7,36,44,64,25,16,6,35,41,56,34,9,1,476,225,251,408,212,196,114,138,89,83,44,10,54,79,42,25,17,8,60,59,47,58,27,2,93,117,104,59,21,11,47,68,56,26,8,5,46,49,48,33,13,6,482,262,220,331,142,189,137,126,107,79,9,22,73,68,51,50,13,1,64,58,56,29,-4,21,83,101,75,44,18,5,45,43,20,24,6,0,38,58,55,20,12,5,116,32,84,164,67,97,25,45,43,9,-13,0,15,8,27,-19,3,-4,10,37,16,28,-16,4,34,62,52,13,0,-4,14,22,20,3,6,-3,20,40,32,10,-6,-1,-116,-93,-23,-2,-19,17,4,-8,-58,-59,-21,13,2,-19,-52,-31,1,-1,2,11,-6,-28,-22,14,6,14,-8,-14,3,-8,-3,0,-11,-11,5,0,9,14,3,-3,-2,-8,127,66,61,103,38,65,49,16,-24,24,33,19,28,18,-18,9,15,10,21,-2,-6,15,18,9,12,45,23,-3,14,8,8,28,3,-11,6,3,4,17,20,8,8,5,-306,-162,-144,-251,-149,-102,-99,6,-129,-70,-26,11,-43,-6,-70,-33,-16,4,-56,12,-59,-37,-10,7,-34,17,-97,-93,-41,-9,-12,-6,-51,-56,-27,-2,-22,23,-46,-37,-14,-7,-248,-170,-78,-230,-155,-75,-58,-48,-42,-88,-9,-4,-38,-39,-27,-54,-9,-2,-20,-9,-15,-34,0,-2,-43,-2,-60,-97,-26,-9,-30,1,-46,-59,-20,-5,-13,-3,-14,-38,-6,-4,37,16,21,-32,3,-35,64,10,-46,-12,9,-2,24,7,-12,-7,6,-10,40,3,-34,-5,3,8,22,29,-36,-34,-9,-11,11,19,-1,-19,-2,-8,11,10,-35,-15,-7,-3,31,37,-6,74,25,49,-16,41,-40,37,1,7,-9,28,1,4,2,11,-7,13,-41,33,-1,-4,-1,25,11,17,3,8,-4,14,6,0,-3,3,3,11,5,17,6,5,-16,-13,-3,-12,-16,4,-43,14,-14,-7,20,1,-17,14,5,-17,1,-4,-26,0,-19,10,19,5,-28,21,5,-5,-4,-5,-16,18,4,-10,-13,-1,-12,3,1,5,9,-4,330,203,127,212,113,99,98,72,20,68,38,28,68,35,12,43,37,2,30,37,8,25,1,26,47,76,40,21,9,12,34,31,21,6,10,5,13,45,19,15,-1,7
46,46039,Anna,2553,90,49,41,94,54,40,8,24,37,19,1,1,3,9,20,14,2,1,5,15,17,5,-1,0,6,22,37,23,4,2,2,11,21,16,3,1,4,11,16,7,1,1,36,25,11,41,24,17,6,8,10,2,7,4,7,5,9,0,4,1,-1,3,1,2,3,3,6,10,15,3,5,2,5,6,9,1,2,1,1,4,6,2,3,1,34,29,5,54,36,18,-2,16,-3,15,6,1,2,13,0,6,6,1,-4,3,-3,9,0,0,11,15,11,12,3,2,7,11,6,7,4,1,4,4,5,5,-1,1,51,17,34,34,15,19,14,14,7,15,1,0,3,2,5,8,1,-2,11,12,2,7,0,2,7,4,15,7,1,0,2,-1,8,5,1,0,5,5,7,2,0,0,-17,-13,-4,1,-3,4,3,-10,-16,3,7,-3,-1,-6,-10,5,0,-1,4,-4,-6,-2,7,-2,6,-2,-4,2,0,-1,3,-1,-4,3,-3,-1,3,-1,0,-1,3,0,-16,-10,-6,17,6,11,-5,5,-23,11,-3,0,-3,1,-15,10,-4,1,-2,4,-8,1,1,-1,2,4,3,6,2,0,-1,3,1,3,0,0,3,1,2,3,2,0,28,24,4,50,33,17,4,-2,1,14,8,2,3,2,-2,9,8,3,1,-4,3,5,0,-1,7,13,10,14,5,1,3,9,7,10,3,1,4,4,3,4,2,0,30,27,3,33,20,13,-3,13,-3,11,5,6,0,13,1,6,3,3,-3,0,-4,5,2,3,4,9,4,13,2,1,2,6,2,7,2,1,2,3,2,6,0,0,41,11,30,24,10,14,6,-3,1,-1,4,35,2,-7,5,-6,2,15,4,4,-4,5,2,20,9,2,10,1,2,0,3,1,5,0,1,0,6,1,5,1,1,0,1,3,-2,1,0,1,0,-9,-7,4,0,10,2,-7,-2,6,-1,4,-2,-2,-5,-2,1,6,0,0,1,1,-1,0,0,0,0,1,-1,0,0,0,1,0,0,0,14,8,6,23,12,11,5,1,-2,-8,0,14,2,3,2,-2,-4,5,3,-2,-4,-6,4,9,4,6,7,2,2,1,1,5,6,0,-1,0,3,1,1,2,3,1,-1,-11,10,-14,-13,-1,-3,-6,-4,-7,-1,21,0,-5,-3,-13,1,9,-3,-1,-1,6,-2,12,0,1,-2,-6,-6,-1,-1,-1,-2,-7,-2,0,1,2,0,1,-4,-1,-76,-45,-31,-60,-36,-24,-10,-22,-26,-15,-11,8,-7,-11,-13,-9,-8,3,-3,-11,-13,-6,-3,5,-5,-12,-18,-13,-12,0,-2,-8,-13,-7,-6,0,-3,-4,-5,-6,-6,0,10,6,4,-5,-3,-2,-6,-8,5,4,0,13,-3,-4,0,3,2,6,-3,-4,5,1,-2,7,-1,-1,-1,-1,-3,2,-1,0,0,-2,-1,1,0,-1,-1,1,-2,1,41,23,18,8,6,2,10,0,-3,9,-1,27,7,2,-4,7,1,11,3,-2,1,2,-2,16,1,0,1,4,1,1,1,2,0,1,1,1,0,-2,1,3,0,0,14,4,10,7,4,3,-3,-1,-2,0,4,16,1,-1,-6,1,2,7,-4,0,4,-1,2,9,-1,1,3,4,0,0,-1,1,1,3,0,0,0,0,2,1,0,0,-14,-3,-11,-2,1,-3,-4,0,-8,-5,-2,5,-5,1,1,-4,0,4,1,-1,-9,-1,-2,1,1,1,2,-6,0,0,0,1,3,-3,-1,1,1,0,-1,-3,1,-1,36,8,28,-10,-5,-5,7,-4,-3,4,4,28,4,-5,-2,2,2,7,3,1,-1,2,2,21,0,0,-4,-5,0,-1,0,-1,-1,-4,1,0,0,1,-3,-1,-1,-1
46,46046,Barx,1221,31,3,28,25,12,13,-5,-2,1,3,17,17,-2,-7,1,-2,8,5,-3,5,0,5,9,12,2,2,0,4,16,1,1,1,0,1,9,0,1,1,0,3,7,1,-34,-11,-23,11,7,4,-2,-17,-1,-12,1,-2,-1,-8,-2,-4,3,1,-1,-9,1,-8,-2,-3,2,0,3,1,5,0,1,0,3,0,3,0,1,0,0,1,2,0,79,42,37,55,32,23,10,12,9,12,29,8,5,9,2,8,14,4,5,3,7,4,15,4,5,6,5,7,25,7,2,5,2,4,15,4,3,1,3,3,10,3,164,75,89,69,36,33,19,12,28,32,53,19,8,4,12,14,25,12,11,8,16,18,28,7,8,2,7,7,36,9,6,0,4,3,18,5,2,2,3,4,18,4,15,8,7,18,10,8,1,4,3,9,4,-4,3,-1,-1,9,3,-4,-2,5,4,0,1,0,2,5,0,8,11,-8,2,2,0,5,5,-4,0,3,0,3,6,-4,28,13,15,28,12,16,10,-4,1,8,11,2,5,-3,1,4,6,0,5,-1,0,4,5,2,5,1,3,6,10,3,2,1,1,3,4,1,3,0,2,3,6,2,36,18,18,48,26,22,7,2,-1,16,12,0,1,5,-1,7,5,2,6,-3,0,9,7,-2,6,3,8,12,14,5,3,1,5,5,8,4,3,2,3,7,6,1,70,44,26,38,21,17,3,10,14,15,24,3,3,6,6,12,17,-1,0,4,8,3,7,4,5,5,10,8,7,2,3,3,5,4,4,1,2,2,5,4,3,1,12,12,0,8,4,4,5,2,-3,14,1,-6,3,1,4,8,3,-6,2,1,-7,6,-2,0,2,4,0,4,-1,-1,2,2,0,2,0,-2,0,2,0,2,-1,1,-4,-4,0,-13,-8,-5,2,-5,5,-9,0,2,0,0,-3,-1,2,-2,2,-5,8,-8,-2,4,3,-1,-2,-3,-3,-7,1,-1,-1,-2,0,-5,2,0,-1,-1,-3,-2,-60,-17,-43,-65,-36,-29,-12,-4,-14,-5,-8,-17,-6,-1,0,1,-3,-8,-6,-3,-14,-6,-5,-9,-9,-7,-5,-12,-16,-16,-5,-5,-2,-5,-10,-9,-4,-2,-3,-7,-6,-7,0,7,-7,20,14,6,6,-1,-14,7,8,-7,4,2,-6,5,2,-1,2,-3,-8,2,6,-6,6,1,1,5,5,1,5,2,0,4,1,1,1,-1,1,1,4,0,1,-8,9,11,6,5,-4,4,0,-2,11,-8,-8,-2,-1,0,6,-3,4,6,1,-2,5,-5,0,1,1,2,8,-1,0,0,1,1,4,0,0,1,0,1,4,-1,-2,0,-2,13,6,7,3,2,-1,-4,5,-8,3,3,0,-4,3,-5,0,-1,-1,0,2,-3,0,0,1,4,3,5,0,0,1,2,1,2,0,0,0,2,2,3,-40,-13,-27,-62,-29,-33,-3,-16,-7,7,-9,-12,-3,-12,-3,8,0,-3,0,-4,-4,-1,-9,-9,-7,-12,-8,-9,-9,-17,-4,-7,-6,-3,-3,-6,-3,-5,-2,-6,-6,-11,17,5,12,19,8,11,0,6,2,0,7,2,2,3,0,-1,0,1,-2,3,2,1,7,1,1,1,0,0,11,6,0,1,0,0,3,4,1,0,0,0,8,2,-17,-1,-16,11,7,4,-9,-3,-7,-4,10,-1,-4,2,-7,-2,6,6,-5,-5,0,-2,4,-7,1,2,0,0,6,2,1,2,0,0,1,3,0,0,0,0,5,-1,26,10,16,20,12,8,2,-1,-1,8,8,11,-1,-2,-1,3,6,6,3,1,0,5,2,5,3,0,2,9,4,2,1,0,1,6,3,1,2,0,1,3,1,1
46,46048,Bellreguard,3754,41,29,12,23,11,12,7,7,10,11,4,0,5,7,2,10,3,1,2,0,8,1,1,-1,2,7,5,7,1,0,1,3,3,4,0,0,1,4,2,3,1,0,79,45,34,47,26,21,24,11,34,11,3,-5,7,9,19,9,1,0,17,2,15,2,2,-5,4,17,14,11,0,1,2,8,9,7,0,0,2,9,5,4,0,1,57,30,27,34,17,17,22,10,8,7,9,-2,10,6,0,9,7,-3,12,4,8,-2,2,1,8,6,10,7,3,0,2,5,4,5,1,0,6,1,6,2,2,0,129,69,60,65,38,27,30,27,29,23,13,2,19,16,18,8,8,-1,11,11,11,15,5,3,10,16,24,10,0,2,7,11,15,5,0,0,3,5,9,5,0,2,89,44,45,80,50,30,8,20,60,0,2,2,-1,10,38,-1,0,0,9,10,22,1,2,2,15,21,27,10,6,1,6,15,20,5,3,1,9,6,7,5,3,0,173,90,83,65,35,30,36,24,47,26,16,15,19,10,37,11,4,5,17,14,10,15,12,10,10,11,17,10,12,3,5,6,11,6,6,1,5,5,6,4,6,2,136,58,78,61,26,35,25,30,59,17,10,-5,9,17,26,6,4,-1,16,13,33,11,6,-4,12,16,18,8,3,1,6,9,7,2,0,1,6,7,11,6,3,0,172,94,78,54,29,25,38,22,41,42,19,3,19,11,21,24,13,0,19,11,20,18,6,3,-1,16,9,18,7,5,-2,7,5,12,6,1,1,9,4,6,1,4,78,51,27,46,21,25,16,29,-10,31,8,1,4,17,-2,21,7,2,12,12,-8,10,1,-1,8,12,7,9,4,4,4,2,2,7,3,2,4,10,5,2,1,2,79,44,35,-7,-11,4,23,5,26,4,8,5,11,2,17,3,7,2,12,3,9,1,1,3,-2,4,-9,-1,-2,0,-3,2,-9,-1,-1,0,1,2,0,0,-1,0,-70,-43,-27,-1,-7,6,-10,-11,-7,-30,-6,-6,-6,-4,-10,-18,-3,-1,-4,-7,3,-12,-3,-5,4,-7,4,-5,5,-3,2,-4,-2,-5,3,-1,2,-3,6,0,2,-2,-51,-29,-22,-39,-28,-11,-7,-8,-21,-12,2,-11,0,-6,-14,-5,-1,-5,-7,-2,-7,-7,3,-6,-7,0,-12,-12,-8,-4,-1,0,-12,-8,-6,-2,-6,0,0,-4,-2,-2,15,14,1,25,13,12,9,10,4,-2,0,-14,7,6,6,-1,-3,-6,2,4,-2,-1,3,-8,5,6,4,9,0,0,1,2,3,5,1,0,4,4,1,4,-1,0,-55,-16,-39,9,5,4,-18,-12,-21,0,-2,2,-5,-4,-16,5,3,3,-13,-8,-5,-5,-5,-1,4,4,0,4,-3,0,2,2,0,4,-3,0,2,2,0,0,0,0,-34,-20,-14,17,6,11,-24,-5,11,-16,1,-2,-17,-5,5,-8,4,1,-7,0,6,-8,-3,-3,1,0,9,4,2,1,-1,0,4,1,2,0,2,0,5,3,0,1,33,6,27,18,8,10,18,10,-12,4,-1,11,5,6,-16,8,0,3,13,4,4,-4,-1,8,4,9,-1,4,1,1,1,5,0,1,1,0,3,4,-1,3,0,1,4,-4,8,14,5,9,14,-1,1,5,-9,-9,9,-3,4,-4,-4,-6,5,2,-3,9,-5,-3,8,5,-1,-1,0,2,2,2,2,-3,1,1,6,3,-3,2,-1,1,45,34,11,26,14,12,5,-2,17,2,21,-2,-1,0,17,7,9,0,6,-2,0,-5,12,-2,4,4,12,2,4,0,1,2,10,0,1,0,3,2,2,2,3,0
46,46051,Benaguasil,9158,167,106,61,77,41,36,19,20,55,45,20,5,12,20,31,23,13,8,7,0,24,22,7,-3,9,17,18,22,8,2,3,11,9,13,3,2,6,6,9,9,5,0,62,52,10,129,77,52,3,15,35,17,-1,-7,1,16,26,12,1,-3,2,-1,9,5,-2,-4,19,39,32,27,12,0,7,27,20,15,8,0,12,12,12,12,4,0,119,68,51,119,54,65,15,31,34,9,11,16,5,13,29,12,4,5,10,18,5,-3,7,11,28,31,33,15,4,4,8,15,19,8,2,1,20,16,14,7,2,3,83,46,37,137,76,61,15,17,16,24,7,-1,-2,15,13,13,3,0,17,2,3,11,4,-1,29,41,30,22,10,3,14,24,19,13,4,1,15,17,11,9,6,2,221,150,71,222,140,82,28,65,68,40,22,-7,23,41,42,33,10,-3,5,24,26,7,12,-4,41,50,66,38,22,2,24,33,41,27,12,2,17,17,25,11,10,0,239,159,80,151,98,53,47,28,59,65,26,9,34,17,46,40,17,3,13,11,13,25,9,6,18,37,43,36,12,5,9,25,31,24,9,0,9,12,12,12,3,5,418,251,167,299,186,113,55,113,110,94,33,3,24,77,55,67,19,1,31,36,55,27,14,2,42,85,72,74,20,5,21,55,46,53,9,2,21,30,26,21,11,3,324,172,152,193,111,82,54,59,123,47,23,4,33,35,61,25,10,4,21,24,62,22,13,0,31,45,62,37,8,7,16,25,36,27,4,3,15,20,26,10,4,4,326,189,137,118,76,42,48,83,123,44,17,2,26,37,79,33,8,1,22,46,44,11,9,1,18,34,31,25,9,1,14,24,17,16,5,0,4,10,14,9,4,1,200,109,91,101,51,50,18,23,85,42,11,12,3,14,35,27,12,8,15,9,50,15,-1,4,16,25,29,16,3,7,6,10,15,9,3,4,10,15,14,7,0,3,-11,-30,19,-109,-84,-25,11,28,-5,-16,-34,-4,3,19,-12,-21,-18,-5,8,9,7,5,-16,1,1,-2,-48,-33,-25,-4,-1,-2,-37,-28,-15,-2,2,0,-11,-5,-10,-2,20,15,5,28,11,17,-9,12,13,7,7,-9,-9,2,15,3,5,-1,0,10,-2,4,2,-8,-1,12,6,4,4,1,-1,3,8,0,-1,0,0,9,-2,4,5,1,41,15,26,-29,-22,-7,-10,6,27,17,-4,-1,-16,1,18,15,-5,-2,6,5,9,2,1,1,-4,-14,4,-7,-7,-2,-3,-10,-2,-3,-3,-1,-1,-4,6,-4,-4,-1,-81,-70,-11,-61,-36,-25,-8,27,-68,-23,-3,-5,-7,12,-37,-30,1,-7,-1,15,-31,7,-4,2,-6,-2,-20,-21,-10,-3,-3,2,-14,-16,-5,-1,-3,-4,-6,-5,-5,-2,-360,-242,-118,-425,-280,-145,-26,-36,-99,-127,-48,-27,-2,-20,-67,-100,-36,-16,-24,-16,-32,-27,-12,-11,-38,-41,-111,-139,-69,-29,-16,-24,-73,-105,-48,-15,-22,-17,-38,-34,-21,-14,100,46,54,53,31,22,-2,26,9,32,29,6,-1,7,-1,24,11,9,-1,19,10,8,18,-3,8,12,11,8,8,6,6,5,6,5,5,4,2,7,5,3,3,2,30,12,18,50,23,27,-4,27,20,-7,-2,-9,2,6,7,-2,-1,-3,-6,21,13,-5,-1,-6,19,8,14,5,3,0,15,2,3,1,2,0,4,6,11,4,1,0,-62,-7,-55,14,-1,15,-17,-10,-15,-19,-3,4,-5,4,0,-12,4,6,-12,-14,-15,-7,-7,-2,1,9,6,-3,-5,2,-1,8,1,-6,-5,-1,2,1,5,3,0,3
46,46054,Benetússer,13659,38,32,6,12,5,7,18,12,-7,8,-5,13,7,2,9,8,0,6,11,10,-16,0,-5,7,2,2,1,1,4,2,1,1,0,1,2,0,1,1,1,0,2,2,43,38,5,7,3,4,12,-19,34,16,-6,7,13,-13,22,16,-3,3,-1,-6,12,0,-3,4,1,1,1,0,1,2,0,0,0,0,1,1,1,1,1,0,0,1,59,28,31,13,5,8,31,4,-22,30,7,8,14,6,-15,15,5,3,17,-2,-7,15,2,5,6,-1,2,2,3,1,2,-2,2,1,1,1,4,1,0,1,2,0,75,33,42,5,4,1,41,-3,31,20,-15,1,34,-2,1,9,-10,4,7,-1,30,11,-5,-3,1,1,1,0,2,0,1,1,0,0,2,0,0,0,1,0,0,0,41,48,-7,106,59,47,10,25,-4,23,-11,-1,5,6,23,21,-6,1,5,19,-27,2,-5,-2,12,26,47,15,3,2,6,13,30,9,1,0,6,13,17,6,2,2,-133,-44,-89,90,53,37,-3,-12,-54,-16,-26,-15,-6,1,-21,-3,-10,-4,3,-13,-33,-13,-16,-11,15,24,32,15,2,2,8,13,21,10,0,1,7,11,11,5,2,1,138,91,47,167,78,89,46,60,11,20,-3,-3,23,34,24,17,-4,-9,23,26,-13,3,1,6,28,46,49,30,8,3,12,20,28,15,2,1,16,26,21,15,6,2,-11,26,-37,166,111,55,10,-8,-27,22,-10,6,21,2,-7,12,-6,9,-11,-10,-20,10,-4,-3,27,45,57,26,8,0,23,27,37,19,4,0,4,18,20,7,4,0,283,138,145,160,97,63,60,59,149,51,-14,-27,17,36,82,29,-16,-16,43,23,67,22,2,-11,36,52,52,13,7,-3,21,33,34,4,3,-1,15,19,18,9,4,-2,95,76,19,65,30,35,6,35,54,6,17,-25,7,33,30,20,1,-15,-1,2,24,-14,16,-10,10,24,15,1,11,2,3,14,9,1,2,1,7,10,6,0,9,1,-105,-44,-61,11,11,0,33,-4,-50,-55,-31,-4,29,2,-39,-20,-15,-3,4,-6,-11,-35,-16,-1,4,29,5,-18,-7,-4,7,15,6,-13,-2,-2,-3,14,-1,-5,-5,-2,-233,-157,-76,-168,-109,-59,-14,-25,-135,-42,-2,-22,-12,-16,-98,-22,-1,-11,-2,-9,-37,-20,-1,-11,-16,-20,-80,-39,-15,0,-9,-8,-58,-25,-9,0,-7,-12,-22,-14,-6,0,-237,-133,-104,-231,-153,-78,-37,-27,-73,-71,-22,-3,-24,-7,-44,-57,-6,2,-13,-20,-29,-14,-16,-5,-13,-27,-80,-85,-24,-3,-9,-12,-60,-62,-9,-3,-4,-15,-20,-23,-15,0,-156,-94,-62,-105,-68,-37,1,-35,-66,-37,-14,-5,4,-16,-43,-34,-8,3,-3,-19,-23,-3,-6,-8,-21,-15,-42,-22,-6,0,-16,-11,-22,-15,-5,0,-5,-4,-20,-7,-1,0,-53,-14,-39,-16,-6,-10,-2,-1,7,-19,-21,-18,0,7,-3,-12,-2,-7,-2,-8,10,-7,-19,-11,4,-1,-21,1,-1,1,6,3,-13,-4,1,0,-2,-4,-8,5,-2,1,85,10,75,-21,-26,5,45,-1,-8,23,-1,22,17,-1,-17,5,-1,6,28,0,9,18,0,16,-3,3,-11,-4,-3,-4,-7,0,-10,-3,-4,-2,4,3,-1,-1,1,-2,30,14,16,26,-1,27,-7,-5,11,20,23,-16,2,-6,10,6,9,-9,-9,1,1,14,14,-7,4,1,10,5,9,-3,-2,2,4,-3,-1,-1,6,-1,6,8,10,-2,213,111,102,42,27,15,63,28,24,51,32,6,25,19,11,34,17,3,38,9,13,17,15,3,10,15,9,-2,7,3,6,9,11,-1,3,-1,4,6,-2,-1,4,4
46,46055,Beniarjó,1179,30,25,5,39,24,15,6,8,11,3,5,-2,4,7,7,3,3,1,2,1,4,0,2,-3,8,8,15,5,3,0,5,5,9,4,1,0,3,3,6,1,2,0,30,14,16,16,6,10,10,5,14,-1,2,0,6,2,5,1,1,-1,4,3,9,-2,1,1,3,2,8,1,2,0,0,2,2,1,1,0,3,0,6,0,1,0,47,15,32,23,14,9,15,8,-4,15,7,4,6,7,-7,3,3,2,9,1,3,12,4,2,6,6,2,2,4,2,4,4,1,1,2,1,2,2,1,1,2,1,124,63,61,25,13,12,23,22,33,29,15,2,11,14,12,18,7,1,12,8,21,11,8,1,9,2,7,6,1,0,5,1,3,3,1,0,4,1,4,3,0,0,44,27,17,16,9,7,1,5,22,7,8,-1,2,4,13,4,3,-1,-1,1,9,3,5,0,2,0,8,2,4,0,0,0,5,2,2,0,2,0,3,0,2,0,82,46,36,28,11,17,21,9,20,20,6,3,9,8,12,9,4,3,12,1,8,11,2,0,5,3,5,8,4,2,2,2,1,3,1,2,3,1,4,5,3,0,89,35,54,15,8,7,30,11,34,10,4,-1,10,2,14,8,3,0,20,9,20,2,1,-1,4,1,8,2,0,0,3,-1,4,2,0,0,1,2,4,0,0,0,93,42,51,19,9,10,34,7,25,18,8,1,20,5,1,10,5,2,14,2,24,8,3,-1,5,2,1,3,7,1,4,0,1,0,3,1,1,2,0,3,4,0,15,6,9,24,12,12,-5,1,12,-3,6,3,-1,2,5,-3,1,1,-4,-1,7,0,5,2,7,2,7,4,1,3,3,2,3,2,1,1,4,0,4,2,0,2,0,3,-3,3,3,0,-6,8,5,-3,-1,-3,-1,3,-1,3,1,-3,-5,5,6,-6,-2,0,4,-1,0,0,0,0,3,0,0,0,0,0,1,-1,0,0,0,0,-19,-17,-2,-25,-11,-14,-15,0,2,-1,-4,-1,-11,-3,2,-2,-3,0,-4,3,0,1,-1,-1,-6,-4,-5,-4,-6,0,-2,-3,-2,-1,-3,0,-4,-1,-3,-3,-3,0,37,25,12,4,2,2,8,8,9,9,-1,1,1,4,10,9,-3,2,7,4,-1,0,2,-1,3,2,-2,0,1,0,2,2,-1,0,0,-1,1,0,-1,0,1,1,-3,3,-6,0,-2,2,1,0,-4,8,-4,-4,3,-2,-2,5,-1,-1,-2,2,-2,3,-3,-3,1,1,-3,-1,1,1,0,0,-2,-1,0,1,1,1,-1,0,1,0,-27,-11,-16,-4,-2,-2,-7,2,-3,-14,-6,0,-5,1,3,-5,-6,1,-2,1,-6,-9,0,-1,-1,0,0,-4,1,0,-1,0,0,-2,1,0,0,0,0,-2,0,0,-60,-26,-34,-16,-7,-9,-22,-8,-14,-14,-2,-1,-11,-4,-8,0,-4,-1,-11,-4,-6,-14,2,0,-9,-2,-1,-3,-1,0,-5,0,-1,0,-1,0,-4,-2,0,-3,0,0,15,6,9,10,3,7,0,7,4,-4,4,4,-1,1,7,-5,1,3,1,6,-3,1,3,1,0,5,-1,1,2,3,0,0,-1,1,1,2,0,5,0,0,1,1,7,3,4,9,5,4,-10,-1,-4,2,10,8,-9,1,5,-2,3,4,-1,-2,-9,4,7,4,3,-1,0,2,2,3,3,0,0,0,1,1,0,-1,0,2,1,2,9,9,0,8,4,4,1,0,5,3,6,-6,2,4,2,2,4,-5,-1,-4,3,1,2,-1,0,1,1,2,3,1,0,0,1,2,1,0,0,1,0,0,2,1
46,46060,Benifaió,12054,-25,-13,-12,9,6,3,-10,7,-15,-11,2,4,-7,1,-5,-5,0,4,-3,6,-10,-6,2,0,1,3,0,0,2,3,1,2,0,0,0,3,0,1,0,0,2,0,134,85,49,142,92,50,7,38,65,12,5,4,0,31,44,6,3,0,7,7,21,6,2,4,16,36,65,15,6,3,5,27,46,8,3,2,11,9,19,7,3,1,12,54,-42,67,54,13,-8,23,2,-3,0,-3,5,19,23,3,-3,4,-13,4,-21,-6,3,-7,10,21,23,10,3,-2,6,16,22,7,2,-1,4,5,1,3,1,-1,-81,-72,-9,-14,-5,-9,0,-6,-44,-12,-6,-9,-10,-10,-37,-7,-5,-2,10,4,-7,-5,-1,-7,0,-1,-6,-2,-4,-1,0,-1,-2,0,-2,0,0,0,-4,-2,-2,-1,-46,-31,-15,48,30,18,-23,6,2,-24,2,-7,-8,-5,9,-21,-2,-3,-15,11,-7,-3,4,-4,2,10,23,5,5,2,2,8,17,1,2,0,0,2,6,4,3,2,26,-10,36,52,23,29,22,16,-38,25,-3,1,5,9,-20,0,-2,-2,17,7,-18,25,-1,3,11,18,4,14,2,3,7,9,0,4,1,2,4,9,4,10,1,1,-15,-23,8,74,34,40,4,-8,22,-17,-14,-4,-7,-2,8,-11,-9,-4,11,-6,14,-6,-5,0,17,24,15,7,7,3,4,16,9,1,3,1,13,8,6,6,4,2,-95,-50,-45,23,4,19,-19,4,-48,-19,-9,-8,-10,2,-25,-11,-8,1,-9,2,-23,-8,-1,-9,-1,15,5,5,-2,-1,-4,6,-1,4,-2,1,3,9,6,1,0,-2,-16,-18,2,7,-8,15,19,-10,-23,2,-5,1,13,-5,-17,-6,-2,0,6,-5,-6,8,-3,1,7,6,3,-9,-2,2,5,-1,-2,-9,-1,0,2,7,5,0,-1,2,-6,-2,-4,44,17,27,-15,7,-7,-7,17,1,9,2,-14,-4,7,0,-24,5,7,-3,10,1,10,12,10,5,2,4,6,5,6,0,-2,1,4,7,4,5,4,3,-111,-62,-49,-37,-31,-6,1,-5,-69,-20,-5,-15,-1,-5,-35,-11,-5,-4,2,0,-34,-9,0,-11,2,1,-24,-9,-1,-6,1,-2,-19,-5,-2,-4,1,3,-5,-4,1,-2,-104,-23,-81,24,7,17,-14,-14,-39,-7,-6,-13,-2,0,-2,-7,-7,0,-12,-14,-37,0,1,-13,9,4,9,3,0,0,5,0,3,-1,0,0,4,4,6,4,0,0,-10,-7,-3,7,3,4,-9,0,-13,-7,9,7,-2,-4,-11,-3,4,7,-7,4,-2,-4,5,0,3,-2,6,-1,0,1,2,-1,2,0,-1,1,1,-1,4,-1,1,0,-52,-9,-43,14,11,3,6,-21,-1,-11,-7,-19,0,-12,11,3,-5,-6,6,-9,-12,-14,-2,-13,-2,11,3,-2,4,0,1,1,7,-1,3,0,-3,10,-4,-1,1,0,-20,-9,-11,-8,-10,2,-7,6,7,-8,-11,-7,-6,0,10,-14,2,-1,-1,6,-3,6,-13,-6,-6,6,-5,-2,-4,3,-3,5,-4,-7,-2,1,-3,1,-1,5,-2,2,-19,-16,-3,-9,-8,-1,1,-13,-23,5,11,-1,-11,-5,-11,4,12,-4,12,-8,-12,1,-1,3,-1,-4,-2,-3,-1,-1,-4,-1,-4,-2,2,0,3,-3,2,-1,-3,-1,56,47,9,66,39,27,-4,9,13,32,10,-6,-1,10,17,13,3,2,-3,-1,-4,19,7,-8,10,11,18,17,6,2,5,5,14,8,5,1,5,6,4,9,1,1,-56,-42,-14,7,-7,14,-19,6,-9,-23,-1,-13,-14,-3,-5,-17,-1,-4,-5,9,-4,-6,0,-9,8,24,3,-24,-6,-2,3,14,-6,-14,-7,1,5,10,9,-10,1,-3
46,46059,Benifairó de la Valldigna,1643,19,7,12,8,2,6,11,-3,8,-1,4,0,5,-2,5,-2,1,0,6,-1,3,1,3,0,4,0,4,0,0,0,2,0,0,0,0,0,2,0,4,0,0,0,21,13,8,13,5,8,0,3,8,10,0,0,3,1,4,5,0,0,-3,2,4,5,0,0,2,3,6,2,0,0,1,0,3,1,0,0,1,3,3,1,0,0,31,24,7,11,10,1,14,2,10,6,1,-2,9,5,6,4,1,0,5,-3,4,2,0,-2,2,2,5,3,0,-1,2,2,5,1,0,0,0,0,0,2,0,-1,-1,-6,5,11,6,5,-2,-2,-4,-2,7,2,-2,-4,-2,-1,3,0,0,2,-2,-1,4,2,2,1,2,3,3,0,0,1,2,2,1,0,2,0,0,1,2,0,16,11,5,9,3,6,-2,6,-4,8,3,6,-1,5,-2,4,1,4,-1,1,-2,4,2,2,3,2,0,3,0,1,2,0,-1,1,0,1,1,2,1,2,0,0,-16,5,-21,14,8,6,-5,3,-7,-6,-1,0,0,5,-2,1,0,1,-5,-2,-5,-7,-1,-1,2,3,4,3,1,1,2,2,1,3,0,0,0,1,3,0,1,1,19,12,7,7,1,6,7,-5,11,2,2,1,5,-5,10,0,1,0,2,0,1,2,1,1,1,2,2,2,0,0,1,0,0,0,0,0,0,2,2,2,0,0,6,7,-1,19,7,12,0,4,2,1,2,-4,1,3,-2,3,2,0,-1,1,4,-2,0,-4,1,3,6,3,4,1,0,1,2,1,2,1,1,2,4,2,2,0,2,1,1,2,1,1,1,2,4,1,-4,-3,-1,1,5,-1,-3,0,2,1,-1,2,-1,-3,0,2,1,2,-3,0,0,0,1,1,-1,0,0,2,0,1,-2,0,7,-1,8,8,-1,9,1,8,-6,0,3,1,0,5,-7,0,2,-1,1,3,1,0,1,2,3,3,0,2,0,0,0,0,-1,0,0,0,3,3,1,2,0,0,-13,-7,-6,1,0,1,-2,0,-2,-7,-2,0,0,-1,0,-5,-1,0,-2,1,-2,-2,-1,0,0,3,0,0,-2,0,0,1,0,-1,0,0,0,2,0,1,-2,0,-6,-5,-1,7,4,3,-10,6,-11,3,5,1,-6,2,-7,4,1,1,-4,4,-4,-1,4,0,1,2,0,2,1,1,0,1,1,1,0,1,1,1,-1,1,1,0,13,14,-1,5,3,2,3,3,4,3,0,0,4,1,3,5,-1,2,-1,2,1,-2,1,-2,0,3,1,0,1,0,0,1,1,1,0,0,0,2,0,-1,1,0,-29,-11,-18,-6,-3,-3,-7,1,-8,-11,-3,-1,1,0,-6,-4,-2,0,-8,1,-2,-7,-1,-1,0,0,-1,-2,-2,-1,0,0,-1,0,-1,-1,0,0,0,-2,-1,0,14,5,9,-7,-2,-5,7,-4,5,1,3,2,1,0,2,-1,2,1,6,-4,3,2,1,1,0,0,0,-6,-1,0,0,1,0,-3,0,0,0,-1,0,-3,-1,0,-9,-2,-7,-1,-2,1,-2,-4,-3,0,0,-1,0,-1,-1,-1,0,0,-2,-3,-2,1,0,-1,0,1,-2,0,0,0,0,0,-1,-1,0,0,0,1,-1,1,0,0,5,8,-3,9,4,5,-1,-3,11,2,-1,-2,0,0,7,1,1,-1,-1,-3,4,1,-2,-1,2,-1,9,1,-4,1,1,-1,4,1,-1,0,1,0,5,0,-3,1,-4,0,-4,4,4,0,-2,-5,-1,1,2,1,-2,-2,1,1,1,1,0,-3,-2,0,1,0,0,0,-1,3,2,0,0,1,1,1,1,0,0,-1,-2,2,1,0
46,46067,Benisanó,1739,37,23,14,31,20,11,9,6,7,9,4,3,2,2,9,5,3,3,7,4,-2,4,1,0,7,3,14,5,2,0,2,1,11,4,2,0,5,2,3,1,0,0,33,16,17,30,15,15,5,2,9,8,2,7,6,-1,3,4,1,3,-1,3,6,4,1,4,10,5,7,8,0,0,7,2,2,4,0,0,3,3,5,4,0,0,18,6,12,6,-1,7,-2,3,0,-1,7,10,-4,4,2,-1,4,0,2,-1,-2,0,3,10,3,3,-1,1,0,0,0,0,-1,0,0,0,3,3,0,1,0,0,59,30,29,11,7,4,3,21,15,1,11,8,3,11,8,1,5,2,0,10,7,0,6,6,2,2,5,2,0,0,1,2,3,1,0,0,1,0,2,1,0,0,-3,-6,3,6,3,3,-2,-4,-6,-2,8,5,0,-3,-6,-2,3,3,-2,-1,0,0,5,2,1,0,2,0,3,0,1,0,1,0,1,0,0,0,1,0,2,0,44,25,19,13,7,6,13,1,8,9,4,4,9,-2,4,8,4,1,4,3,4,1,0,3,5,1,5,0,2,0,3,0,3,0,1,0,2,1,2,0,1,0,76,42,34,20,6,14,-4,22,39,-1,4,9,0,10,26,1,1,3,-4,12,13,-2,3,6,4,5,10,-3,0,2,0,3,5,-3,0,1,4,2,5,0,0,1,87,42,45,15,8,7,23,15,20,13,8,8,9,10,10,5,4,5,14,5,10,8,4,3,3,4,3,4,1,0,0,2,2,3,1,0,3,2,1,1,0,0,81,29,52,20,10,10,10,20,34,12,2,-1,4,5,17,1,2,-2,6,15,17,11,0,1,6,5,6,2,0,0,4,3,2,0,0,0,2,2,4,2,0,0,47,29,18,-2,-4,2,3,17,13,4,1,7,3,10,8,6,0,0,0,7,5,-2,1,7,0,3,-5,0,0,0,0,1,-5,0,0,0,0,2,0,0,0,0,1,2,-1,1,1,0,-11,-1,11,-8,9,-2,-4,1,4,-2,4,-2,-7,-2,7,-6,5,0,1,-1,-1,-1,2,0,1,-1,1,-1,1,0,0,0,-2,0,1,0,41,19,22,-3,-2,-1,14,11,-7,17,1,7,10,6,-4,3,2,2,4,5,-3,14,-1,5,0,0,-2,-1,-1,1,0,0,-1,-1,-1,1,0,0,-1,0,0,0,-20,-22,2,-10,-7,-3,0,-7,-3,-4,-5,-1,-8,-6,-2,-4,-1,-1,8,-1,-1,0,-4,0,-3,-3,1,-4,0,-1,-2,-2,0,-3,0,0,-1,-1,1,-1,0,-1,-7,-2,-5,-3,-2,-1,11,-8,-9,-4,-5,7,12,-3,-9,-1,-4,3,-1,-5,0,-3,-1,4,1,-1,-1,-2,0,0,1,0,-2,-1,0,0,0,-1,1,-1,0,0,-44,-15,-29,-7,-5,-2,-21,-1,-9,-8,-6,-2,-8,-3,-4,4,-5,-1,-13,2,-5,-12,-1,-1,-1,-2,-1,-2,-1,0,-1,-2,0,-1,-1,0,0,0,-1,-1,0,0,-6,-9,3,6,5,1,-3,-3,-6,4,4,-3,-7,-6,-2,4,2,0,4,3,-4,0,2,-3,2,2,-1,1,0,1,2,0,1,1,0,0,0,2,-2,0,0,1,26,16,10,17,3,14,9,-3,8,-1,8,3,8,-3,4,-1,5,2,1,0,4,0,3,1,8,1,4,0,3,1,3,0,0,-2,1,1,5,1,4,2,2,0,-11,-6,-5,11,8,3,-4,-1,-11,-2,-4,11,-3,2,-6,3,-6,3,-1,-3,-5,-5,2,8,2,0,1,6,0,2,0,1,1,5,-1,2,2,-1,0,1,1,0
46,46070,Bétera,12916,625,303,322,70,39,31,159,60,216,140,28,5,77,20,106,74,13,4,82,40,110,66,15,1,12,11,31,8,2,3,5,5,22,3,1,1,7,6,9,5,1,2,423,232,191,132,65,67,80,66,148,96,23,2,38,33,81,53,18,3,42,33,67,43,5,-1,36,27,33,23,4,4,16,15,15,10,4,2,20,12,18,13,0,2,895,452,443,139,63,76,197,93,322,189,63,19,106,34,166,97,34,9,91,59,156,92,29,10,32,29,37,28,13,0,14,12,17,15,5,0,18,17,20,13,8,0,671,330,341,130,62,68,127,90,243,144,33,20,66,41,118,71,14,9,61,49,125,73,19,11,33,29,34,22,7,3,12,15,22,8,3,2,21,14,12,14,4,1,661,315,346,143,65,78,148,50,255,120,64,20,71,16,122,63,34,5,77,34,133,57,30,15,37,25,41,17,20,3,17,10,22,6,8,2,20,15,19,11,12,1,603,343,260,159,84,75,113,91,204,128,32,22,65,49,117,78,15,8,48,42,87,50,17,14,39,31,46,25,13,2,19,16,23,14,8,1,20,15,23,11,5,1,606,278,328,182,82,100,145,62,236,123,24,14,69,18,113,70,4,7,76,44,123,53,20,7,50,30,48,34,11,6,22,15,20,17,6,1,28,15,28,17,5,5,618,300,318,135,63,72,145,41,224,109,57,30,72,24,97,58,32,12,73,17,127,51,25,18,30,21,40,23,18,2,11,8,19,16,7,2,19,13,21,7,11,0,345,154,191,116,51,65,80,39,87,77,17,43,45,15,31,50,8,8,35,24,56,27,9,35,45,19,19,23,7,0,24,3,9,10,3,1,21,16,10,13,4,-1,380,168,212,73,32,41,77,18,92,117,-10,79,33,-4,41,79,-11,25,44,22,51,38,1,54,24,11,23,11,1,2,13,1,8,8,2,-1,11,10,15,3,-1,3,241,129,112,63,32,31,94,-19,78,56,-1,30,54,-3,43,31,-2,8,40,-16,35,25,1,22,24,3,20,12,4,0,16,2,6,5,4,-1,8,1,14,7,0,1,367,223,144,84,35,49,81,24,107,83,10,50,52,16,67,48,16,17,29,8,40,35,-6,33,18,17,21,12,9,3,7,9,5,5,4,2,11,8,16,7,5,1,228,138,90,20,7,13,52,50,41,30,13,24,36,30,44,5,5,8,16,20,-3,25,8,16,3,11,-4,4,-1,2,1,5,1,-2,-1,0,2,6,-5,6,0,2,187,99,88,28,23,5,57,-13,55,53,13,21,41,-13,30,29,9,0,16,0,25,24,4,21,16,5,-1,9,0,-3,17,1,3,6,-3,-3,-1,4,-4,3,3,0,354,173,181,63,33,30,102,19,47,81,25,71,53,16,26,39,11,25,49,3,21,42,14,46,28,5,2,25,4,-3,16,5,1,9,0,1,12,0,1,16,4,-4,247,98,149,90,46,44,89,-11,45,52,5,63,50,-5,5,32,-5,19,39,-6,40,20,10,44,43,15,4,17,5,5,25,6,-7,15,2,4,18,9,11,2,3,1,366,157,209,117,44,73,89,0,77,96,-6,90,46,-6,51,46,-5,17,43,6,26,50,-1,73,50,17,15,24,2,6,22,8,6,3,0,2,28,9,9,21,2,4,451,210,241,118,41,77,147,-16,91,89,3,128,77,-13,63,40,-1,41,70,-3,28,49,4,87,65,10,9,14,18,1,35,-1,0,-4,11,0,30,11,9,18,7,1
46,46074,Bonrepòs i Mirambell,2299,-9,-6,-3,3,1,2,2,7,-6,-7,-5,-1,-2,3,-2,-3,-4,1,4,4,-4,-4,-1,-2,0,3,0,0,0,0,0,1,0,0,0,0,0,2,0,0,0,0,5,7,-2,15,4,11,6,2,-9,4,3,-3,5,2,-7,5,1,-1,1,0,-2,-1,2,-2,4,1,3,3,3,0,2,0,0,2,0,0,2,1,3,1,3,0,-55,-38,-17,-3,-2,-1,-8,-9,-20,-11,-3,-4,-5,-4,-16,-9,-2,-2,-3,-5,-4,-2,-1,-2,0,-1,-1,-1,0,0,0,-1,0,-1,0,0,0,0,-1,0,0,0,200,108,92,17,4,13,25,44,108,8,11,5,15,20,56,7,6,4,10,24,52,1,5,1,6,0,8,3,0,0,2,0,1,1,0,0,4,0,7,2,0,0,244,118,126,24,7,17,31,47,119,42,-1,6,11,16,70,19,0,3,20,31,49,23,-1,3,2,7,9,5,0,1,1,1,5,0,0,0,1,6,4,5,0,1,80,38,42,13,4,9,10,18,33,8,4,5,8,8,13,5,3,2,2,10,20,3,1,3,1,4,2,4,1,0,1,1,0,2,0,0,0,3,2,2,1,0,54,31,23,-5,1,-6,-9,4,61,-2,3,-2,-8,4,42,-5,1,-1,-1,0,19,3,2,-1,0,-1,2,-3,-1,-1,0,0,5,-3,0,0,0,-1,-3,0,-1,-1,43,18,25,22,8,14,4,11,15,4,4,3,0,7,5,4,1,2,4,4,10,0,3,1,5,1,7,5,3,0,0,1,2,3,2,0,5,0,5,2,1,0,161,90,71,12,8,4,28,43,46,27,9,10,9,20,41,18,2,3,19,23,5,9,7,7,-1,10,1,1,1,0,1,5,1,0,1,0,-2,5,0,1,0,0,47,11,36,-1,-2,1,6,10,25,-3,3,5,3,1,8,-6,-2,5,3,9,17,3,5,0,1,3,-1,-5,1,0,1,0,2,-4,-1,0,0,3,-3,-1,2,0,-28,-1,-27,10,6,4,-14,3,-13,5,-13,3,-3,1,4,0,-6,1,-11,2,-17,5,-7,2,5,4,0,2,0,-1,4,3,-2,1,0,0,1,1,2,1,0,-1,-10,-25,15,-12,-7,-5,-9,6,1,-5,-5,2,-10,1,-12,0,-1,-4,1,5,13,-5,-4,6,0,-2,-6,-3,0,-1,0,-2,-2,-2,0,-1,0,0,-4,-1,0,0,11,24,-13,-6,-7,1,5,3,3,-2,4,0,8,4,6,-1,5,2,-3,-1,-3,-1,-1,-2,1,-1,-1,-1,-2,-2,-1,-1,-1,-1,-1,-2,2,0,0,0,-1,0,-20,-9,-11,-13,-7,-6,-7,1,4,-1,-1,-11,-9,2,8,-4,-2,-2,2,-1,-4,3,1,-9,-7,0,-2,0,-1,-3,-5,0,-1,0,0,-1,-2,0,-1,0,-1,-2,20,6,14,-3,-1,-2,12,9,2,-3,1,-2,7,4,-4,1,-3,-1,5,5,6,-4,4,-1,2,1,-4,-4,2,0,2,1,-4,0,0,0,0,0,0,-4,2,0,37,6,31,5,3,2,9,18,2,16,-2,-5,4,5,-3,0,1,0,5,13,5,16,-3,-5,-3,1,5,3,-2,1,0,0,1,1,0,1,-3,1,4,2,-2,0,-8,-3,-5,0,-5,5,-12,3,10,-11,-2,0,-9,1,15,-7,-1,0,-3,2,-5,-4,-1,0,-1,4,1,-3,-1,0,-3,1,1,-3,-1,0,2,3,0,0,0,0,11,7,4,-1,2,-3,4,0,-2,7,4,-2,6,-1,-1,2,3,-2,-2,1,-1,5,1,0,-2,2,-4,0,1,1,1,1,-2,0,1,1,-3,1,-2,0,0,0
46,46077,Buñol,9358,-58,-21,-37,20,11,9,-17,-3,-33,-6,0,2,-6,3,-17,-2,0,2,-11,-6,-16,-4,0,0,3,2,9,3,2,0,2,1,4,3,1,0,1,1,5,0,1,0,52,29,23,46,24,22,11,13,-2,4,2,22,10,12,-8,3,2,9,1,1,6,1,0,13,10,9,17,7,3,0,6,5,7,4,2,0,4,4,10,3,1,0,39,31,8,51,27,24,8,-4,14,-3,2,22,3,4,15,-3,3,8,5,-8,-1,0,-1,14,8,9,19,9,5,1,3,7,10,5,2,0,5,2,9,4,3,1,83,50,33,52,25,27,14,10,11,15,10,24,12,-1,13,10,8,10,2,11,-2,5,2,14,12,11,18,8,3,0,5,5,8,5,2,0,7,6,10,3,1,0,143,52,91,84,37,47,41,23,14,14,16,29,16,9,5,4,3,13,25,14,9,10,13,16,22,15,22,14,9,1,9,9,7,9,3,0,13,6,15,5,6,1,162,87,75,93,61,32,6,54,34,19,23,23,0,32,24,11,11,5,6,22,10,8,12,18,16,36,23,12,5,1,8,29,14,7,3,0,8,7,9,5,2,1,209,95,114,133,81,52,58,24,68,31,15,8,22,20,28,17,6,2,36,4,40,14,9,6,26,42,32,18,15,0,16,31,20,6,8,0,10,11,12,12,7,0,242,146,96,162,104,58,40,11,66,53,16,48,29,2,51,32,8,21,11,9,15,21,8,27,33,40,45,31,10,2,24,24,29,20,5,2,9,16,16,11,5,0,95,55,40,68,35,33,34,0,30,26,-3,6,20,-5,22,13,3,3,14,5,8,13,-6,3,17,17,15,15,1,1,8,8,8,7,3,0,9,9,7,8,-2,1,3,-7,10,34,18,16,22,-7,-23,-14,5,24,20,-18,-14,-10,7,9,2,11,-9,-4,-2,15,18,15,1,-1,0,1,15,4,-1,-1,1,0,3,11,2,0,-1,1,-123,-71,-52,-84,-48,-36,-19,-10,-31,-64,-11,6,-6,-15,-22,-32,-6,7,-13,5,-9,-32,-5,-1,-13,1,-28,-29,-15,-1,-4,1,-17,-23,-6,1,-9,0,-11,-6,-9,-2,-29,-24,-5,17,13,4,-2,-9,-32,2,11,2,3,-8,-15,-9,4,2,-5,-1,-17,11,7,0,4,2,6,-4,5,4,7,1,4,-3,2,2,-3,1,2,-1,3,2,35,-11,46,-35,-34,-1,20,-3,19,-13,-3,12,11,-10,1,-12,-5,2,9,7,18,-1,2,10,3,3,-14,-16,-5,-7,0,-2,-9,-13,-6,-5,3,5,-5,-3,1,-2,-81,-48,-33,-40,-25,-15,-10,-22,-16,-36,-7,10,-2,-12,-2,-22,-6,-3,-8,-10,-14,-14,-1,13,-2,-2,-19,-12,-3,-2,0,2,-12,-11,-3,-1,-2,-4,-7,-1,0,-1,-85,-65,-20,-71,-37,-34,-4,-14,-48,-38,14,7,-6,-14,-30,-21,6,2,2,0,-18,-17,8,5,-9,-9,-25,-22,-5,-2,-3,-5,-13,-12,-4,0,-6,-4,-12,-10,-1,-2,-99,-41,-58,-9,-6,-3,-4,-15,-32,-23,-10,-12,2,-13,-13,-15,0,0,-6,-2,-19,-8,-10,-12,9,1,-5,-3,-7,-4,3,0,1,-4,-3,-3,6,1,-6,1,-4,-1,8,3,5,2,3,-1,0,2,4,5,-10,9,5,2,7,-2,-10,1,-5,0,-3,7,0,8,2,2,2,1,-8,2,4,2,2,-2,-4,1,-2,0,0,3,-4,1,4,-18,22,-8,-1,-7,14,3,-13,-18,-8,27,11,-4,-10,-12,-7,5,3,7,-3,-6,-1,22,4,4,-4,-9,-3,0,5,2,-4,-2,-2,0,-1,2,0,-7,-1,0
46,46078,Burjassot,34869,431,270,161,270,149,121,49,132,174,45,3,19,31,76,125,28,1,6,18,56,49,17,2,13,41,74,99,43,11,1,18,37,65,25,3,1,23,37,34,18,8,0,386,182,204,388,209,179,4,138,157,63,-12,22,-6,72,103,25,-12,0,10,66,54,38,0,22,53,101,139,70,14,5,28,50,79,42,6,2,25,51,60,28,8,3,689,319,370,440,231,209,118,171,234,99,7,39,53,72,119,55,1,10,65,99,115,44,6,29,89,115,153,61,17,4,47,62,82,30,8,1,42,53,71,31,9,3,56,64,-8,262,144,118,-4,112,-14,-14,-46,-2,7,68,6,5,-33,5,-11,44,-20,-19,-13,-7,47,60,86,43,15,8,24,37,48,27,3,2,23,23,38,16,12,6,280,119,161,397,205,192,28,87,99,53,-9,-4,4,34,66,17,-8,-6,24,53,33,36,-1,2,62,106,134,73,15,2,33,56,65,41,7,2,29,50,69,32,8,0,153,69,84,390,216,174,18,98,27,-13,-1,17,7,49,34,-35,1,5,11,49,-7,22,-2,12,66,89,133,69,22,6,39,50,76,35,8,3,27,39,57,34,14,3,-12,-4,-8,368,172,196,25,62,-48,-25,-24,-6,25,35,-12,-28,-14,-14,0,27,-36,3,-10,8,65,97,116,62,13,13,30,48,53,32,5,2,35,49,63,30,8,11,33,-25,58,471,217,254,-26,111,-57,32,-26,-3,-33,38,-19,19,-24,-7,7,73,-38,13,-2,4,69,126,152,96,18,5,36,58,74,43,5,-2,33,68,78,53,13,7,67,45,22,325,161,164,42,106,7,-38,-29,-4,30,47,14,-19,-16,-5,12,59,-7,-19,-13,1,62,131,99,35,5,-7,27,65,52,13,4,0,35,66,47,22,1,-7,-224,-192,-32,-43,-56,13,-22,11,-88,-74,-32,-15,-17,-28,-56,-63,-24,1,-5,39,-32,-11,-8,-16,4,28,-33,-40,-7,0,6,3,-32,-25,-7,-1,-2,25,-1,-15,0,1,-219,-189,-30,46,-5,51,26,8,-143,-55,-21,-22,10,-14,-102,-42,-12,-24,16,22,-41,-13,-9,2,24,49,-19,-11,3,-3,15,11,-15,-14,0,-1,9,38,-4,3,3,-2,45,-9,54,107,39,68,-1,58,-8,-13,-13,18,-14,22,-11,-3,-10,7,13,36,3,-10,-3,11,25,48,27,10,-2,-2,17,11,8,1,-2,3,8,37,19,9,0,-5,-6,-50,44,-7,-26,19,2,14,-4,-13,-17,2,19,11,-30,-29,-15,-14,-17,3,26,16,-2,16,-2,16,-13,-13,-6,4,2,13,-22,-15,-8,0,-4,3,9,2,2,4,-397,-229,-168,-193,-126,-67,-11,-17,-220,-83,-60,-11,5,-2,-106,-79,-40,-6,-16,-15,-114,-4,-20,-5,-18,-4,-71,-73,-24,-6,-11,-5,-38,-57,-14,-2,-7,1,-33,-16,-10,-4,-107,-67,-40,35,14,21,-26,10,2,-75,1,-16,-5,4,-8,-40,-2,-11,-21,6,10,-35,3,-5,11,15,-5,8,0,4,8,6,-3,6,-6,2,3,9,-2,2,6,2,-76,-69,-7,62,18,44,16,72,-44,-100,-9,-7,-6,38,-1,-73,-9,-20,22,34,-43,-27,0,13,29,35,8,-18,4,1,7,19,-1,-15,4,2,22,16,9,-3,0,-1,291,88,203,252,91,161,35,114,67,13,47,14,11,53,23,-22,16,3,24,61,44,35,31,11,43,86,69,26,19,5,23,35,20,0,8,1,20,51,49,26,11,4,220,73,147,314,117,197,34,115,52,35,2,-15,23,27,26,1,3,-4,11,88,26,34,-1,-11,56,91,87,50,19,6,26,22,41,12,12,0,30,69,46,38,7,6
46,46081,Canals,12937,264,181,83,252,174,78,16,75,114,53,0,8,3,55,84,41,-4,4,13,20,30,12,4,4,16,69,112,52,2,1,5,48,83,38,0,0,11,21,29,14,2,1,-164,-73,-91,26,20,6,-25,-53,-49,-27,-7,-3,-9,-22,-21,-16,-4,-1,-16,-31,-28,-11,-3,-2,0,9,8,8,1,0,0,6,8,5,1,0,0,3,0,3,0,0,205,107,98,257,137,120,32,52,60,38,20,1,10,27,38,24,5,0,22,25,22,14,15,1,48,67,74,45,17,4,22,35,41,28,7,2,26,32,33,17,10,2,178,85,93,179,95,84,51,24,50,36,10,2,25,21,18,16,5,-2,26,3,32,20,5,4,39,43,41,40,14,1,24,25,19,20,6,0,15,18,22,20,8,1,51,41,10,161,95,66,13,27,-9,24,5,-6,19,9,3,11,5,-5,-6,18,-12,13,0,-1,22,50,33,44,10,1,14,25,24,25,6,0,8,25,9,19,4,1,60,33,27,166,88,78,-5,11,43,13,5,-5,-7,1,32,9,2,-1,2,10,11,4,3,-4,27,42,51,35,9,2,7,22,32,22,4,1,20,20,19,13,5,1,146,62,84,198,95,103,30,44,6,34,20,12,16,19,0,13,13,1,14,25,6,21,7,11,36,58,47,38,15,4,16,27,24,19,8,1,20,31,23,19,7,3,164,114,50,288,174,114,8,84,30,25,9,9,5,58,26,20,3,3,3,26,4,5,6,6,24,102,88,55,17,0,14,62,55,37,6,-1,10,40,33,18,11,1,-132,-55,-77,67,35,32,-8,-22,-55,-28,-8,-10,-2,-8,-20,-12,-9,-3,-6,-14,-35,-16,1,-7,14,14,21,12,5,0,8,8,8,10,0,1,6,6,13,2,5,-1,116,37,79,141,79,62,47,33,26,-3,15,1,22,17,-9,-5,15,-1,25,16,35,2,0,2,24,45,35,26,8,2,12,27,15,17,7,0,12,18,20,9,1,2,17,25,-8,94,47,47,7,13,-9,7,5,-13,11,8,0,11,-1,-6,-4,5,-9,-4,6,-7,15,25,26,15,11,1,6,13,11,9,6,1,9,12,15,6,5,0,-29,-14,-15,110,60,50,-10,9,-32,5,1,-8,-6,4,-22,13,-1,-5,-4,5,-10,-8,2,-3,11,29,26,33,9,2,7,18,14,17,3,1,4,11,12,16,6,1,-89,-47,-42,28,14,14,-22,-22,-18,-23,0,-1,-20,0,-11,-14,-1,-2,-2,-22,-7,-9,1,1,2,7,10,5,4,0,-1,5,9,0,1,0,3,2,1,5,3,0,-25,-2,-23,35,23,12,-3,-4,-29,17,-4,-5,6,3,-15,7,-5,2,-9,-7,-14,10,1,-7,3,5,7,10,8,-1,1,2,4,8,6,1,2,3,3,2,2,-2,-29,-26,-3,7,1,6,10,8,-22,-6,-8,-3,-1,9,-13,-5,-7,-2,11,-1,-9,-1,-1,-1,7,11,-9,-1,2,-1,2,7,-8,-1,1,2,5,4,-1,0,1,-3,-71,-54,-17,-30,-27,-3,-1,9,-40,-19,1,-19,-1,17,-38,-14,-2,-13,0,-8,-2,-5,3,-6,1,9,-12,-24,-2,-2,-2,8,-9,-24,0,0,3,1,-3,0,-2,-2,-66,-45,-21,-52,-29,-23,-50,-5,13,-25,1,-6,-26,-7,10,-21,-6,1,-24,2,3,-4,7,-7,-54,3,2,-9,5,-3,-26,-1,5,-4,-1,-4,-28,4,-3,-5,6,1,-45,-29,-16,52,27,25,3,5,-19,-10,-12,-15,3,3,-23,-5,-4,-5,0,2,4,-5,-8,-10,19,14,5,10,3,-2,13,6,0,4,2,0,6,8,5,6,1,-2
46,46082,Canet d'En Berenguer,2216,107,67,40,14,9,5,5,14,18,24,29,16,1,16,11,16,16,4,4,-2,7,8,13,12,1,4,4,4,1,0,1,1,3,3,1,0,0,3,1,1,0,0,103,61,42,6,2,4,6,12,19,37,24,5,5,6,13,19,17,1,1,6,6,18,7,4,2,2,2,0,0,0,0,1,1,0,0,0,2,1,1,0,0,0,326,179,147,21,12,9,50,50,57,98,60,10,25,19,36,58,33,5,25,31,21,40,27,5,2,8,6,3,2,0,1,2,7,2,0,0,1,6,-1,1,2,0,165,96,69,22,12,10,19,32,31,52,16,8,18,19,22,28,6,1,1,13,9,24,10,7,2,4,8,5,3,0,0,3,5,3,1,0,2,1,3,2,2,0,335,176,159,45,22,23,36,25,91,107,62,10,23,11,39,55,41,2,13,14,52,52,21,8,5,11,14,10,4,1,3,5,5,5,3,1,2,6,9,5,1,0,303,162,141,32,18,14,38,40,79,84,50,9,13,21,45,45,30,7,25,19,34,39,20,2,4,7,9,7,6,-1,2,4,4,4,5,-1,2,3,5,3,1,0,388,208,180,75,33,42,86,20,141,92,31,15,48,10,75,49,15,8,38,10,66,43,16,7,14,13,25,11,8,4,5,5,12,7,3,1,9,8,13,4,5,3,296,170,126,55,33,22,43,32,72,91,36,13,23,13,47,49,27,4,20,19,25,42,9,9,-1,23,11,11,9,1,1,13,5,7,6,0,-2,10,6,4,3,1,130,63,67,35,16,19,50,2,73,37,-16,-16,19,-3,31,25,-2,-7,31,5,42,12,-14,-9,9,3,14,7,0,2,3,0,10,2,-1,2,6,3,4,5,1,0,8,-5,13,-45,-29,-16,-9,22,28,-11,-17,-5,-1,9,14,-4,-15,-7,-8,13,14,-7,-2,2,-7,0,-20,-13,-8,2,-1,-1,-12,-10,-6,1,-6,1,-8,-3,-2,1,240,136,104,-2,-2,0,39,46,109,27,5,8,26,22,59,16,8,4,13,24,50,11,-3,4,-2,6,-4,-3,-1,1,-2,5,-2,-3,-2,2,0,1,-2,0,1,-1,151,76,75,0,5,-5,7,7,84,14,0,40,5,16,39,6,5,5,2,-9,45,8,-5,35,-5,7,-11,1,5,3,0,4,-5,1,3,2,-5,3,-6,0,2,1,-48,-30,-18,-33,-17,-16,4,2,-9,-24,-23,2,-1,-1,-13,-10,-6,0,5,3,4,-14,-17,2,-1,-4,-19,-7,-3,1,1,-2,-14,-2,-2,2,-2,-2,-5,-5,-1,-1,293,145,148,-26,-13,-13,54,48,124,53,0,9,30,20,52,38,1,2,24,28,72,15,-1,7,-2,-1,-6,-6,-7,-4,2,-2,-2,-3,-6,-2,-4,1,-4,-3,-1,-2,131,45,86,-5,-18,13,53,9,24,21,4,16,22,-6,13,3,4,7,31,15,11,18,0,9,9,-5,-3,-4,-3,1,5,-6,-9,-6,0,-2,4,1,6,2,-3,3,81,38,43,-10,-17,7,38,-3,16,25,-9,11,21,3,-4,19,-8,3,17,-6,20,6,-1,8,-3,-4,0,-8,5,-2,-3,-3,-3,-9,2,-2,0,-1,3,1,3,0,-35,-21,-14,40,15,25,-1,6,1,1,-30,-13,-9,-2,12,-3,-9,-12,8,8,-11,4,-21,-1,9,7,14,8,1,0,2,1,6,5,0,0,7,6,8,3,1,0,133,65,68,30,17,13,32,-3,29,48,1,16,28,-1,12,30,-3,-6,4,-2,17,18,4,22,11,3,5,8,-1,3,9,2,3,3,-2,1,2,1,2,5,1,2
46,46083,Carcaixent,20487,114,92,22,161,114,47,3,30,35,32,19,-5,-6,17,52,20,10,-1,9,13,-17,12,9,-4,10,34,70,32,11,2,6,21,60,17,7,1,4,13,10,15,4,1,178,134,44,201,148,53,35,61,58,28,3,-7,14,53,50,22,6,-9,21,8,8,6,-3,2,19,67,81,24,8,1,11,48,63,21,5,0,8,19,18,3,3,1,165,145,20,174,103,71,37,32,38,43,4,8,22,38,35,33,2,10,15,-6,3,10,2,-2,22,50,59,30,11,1,9,32,36,17,7,1,13,18,23,13,4,0,225,112,113,258,150,108,64,83,34,20,9,15,42,53,10,3,2,2,22,30,24,17,7,13,39,90,71,33,14,9,21,55,45,17,7,4,18,35,26,16,7,5,339,176,163,215,109,106,84,86,88,53,15,3,34,42,39,47,10,-3,50,44,49,6,5,6,30,62,57,48,12,4,10,29,34,30,5,1,20,33,23,18,7,3,407,195,212,262,153,109,93,110,104,77,12,2,38,56,51,46,4,-7,55,54,53,31,8,9,42,82,78,43,17,0,19,50,51,24,10,-1,23,32,27,19,7,1,291,173,118,241,135,106,75,96,73,66,4,-14,46,61,40,37,-3,-7,29,35,33,29,7,-7,41,65,84,50,-1,0,21,44,47,26,-4,0,20,21,37,24,3,0,291,164,127,207,105,102,62,62,109,41,7,-1,34,36,77,7,-5,8,28,26,32,34,12,-9,40,69,56,28,9,2,25,31,35,8,1,2,15,38,21,20,8,0,2,-57,59,52,3,49,27,25,-40,-9,-6,0,-5,6,-37,-23,-1,-1,32,19,-3,14,-5,1,26,28,-1,-9,3,2,8,14,-14,-8,1,1,18,14,13,-1,2,1,106,61,45,104,41,63,33,33,38,10,15,-22,23,13,20,8,9,-14,10,20,18,2,6,-8,23,38,18,16,4,1,17,15,-3,6,2,0,6,23,21,10,2,1,-283,-137,-146,-200,-139,-61,-33,-39,-81,-69,-33,-36,-26,-6,-41,-48,-15,-8,-7,-33,-40,-21,-18,-28,-21,-10,-93,-49,-24,-11,-15,-1,-66,-43,-14,-6,-6,-9,-27,-6,-10,-5,115,40,75,36,6,30,53,28,14,15,7,-2,10,12,2,14,5,-1,43,16,12,1,2,-1,22,12,-3,-3,4,1,8,5,-10,-3,3,2,14,7,7,0,1,-1,-138,-59,-79,-106,-72,-34,-46,-16,-13,-44,-11,-8,-25,-15,8,-17,-11,-3,-21,-1,-21,-27,0,-5,-16,-10,-30,-38,-10,-5,-7,-10,-25,-25,-4,-3,-9,0,-5,-13,-6,-2,72,21,51,2,-9,11,52,4,-10,-5,26,-4,26,-3,-18,0,15,-2,26,7,8,-5,11,-2,11,3,-18,1,3,0,7,-5,-10,-6,3,0,4,8,-8,7,0,0,-21,5,-26,1,11,-10,-26,27,-29,-10,-4,15,-8,15,-12,6,-6,8,-18,12,-17,-16,2,7,-10,12,-1,-12,-4,6,-3,10,2,-6,-2,4,-7,2,-3,-6,-2,2,47,32,15,98,63,35,5,11,22,11,13,-17,-2,10,5,6,10,-4,7,1,17,5,3,-13,22,8,26,19,12,8,13,4,18,12,8,5,9,4,8,7,4,3,26,34,-8,34,26,8,-16,11,14,27,-12,-1,-3,12,17,13,-4,0,-13,-1,-3,14,-8,-1,-5,16,3,11,0,4,-3,17,3,6,1,1,-2,-1,0,5,-1,3,33,2,31,22,7,15,7,8,-15,17,13,-1,3,1,-18,9,7,-1,4,7,3,8,6,0,-1,24,4,2,-14,4,2,8,0,-2,-6,2,-3,16,4,4,-8,2
46,46084,Càrcer,2069,-25,-10,-15,3,2,1,-7,-4,-3,-9,0,-2,-4,-3,0,-3,0,0,-3,-1,-3,-6,0,-2,0,0,2,0,0,1,0,0,2,0,0,0,0,0,0,0,0,1,-17,-9,-8,2,1,1,-1,-6,-7,-1,0,-3,-2,-3,-2,-1,-1,-1,1,-3,-5,0,1,-2,0,1,1,0,0,0,0,0,1,0,0,0,0,1,0,0,0,0,11,8,3,9,5,4,4,-2,1,8,3,-4,4,-2,-4,8,1,0,0,0,5,0,2,-4,3,-1,3,2,2,0,2,-1,1,1,2,0,1,0,2,1,0,0,32,17,15,22,13,9,8,11,12,-1,3,-2,4,6,8,-2,0,0,4,5,4,1,3,-2,5,2,11,0,4,0,3,1,7,0,2,0,2,1,4,0,2,0,16,14,2,18,9,9,5,-2,9,4,2,-3,4,4,5,2,0,-2,1,-6,4,2,2,-1,6,4,3,3,2,0,3,3,1,1,1,0,3,1,2,2,1,0,7,-1,8,17,10,7,2,4,-4,9,-2,-1,-3,3,-5,4,1,-1,5,1,1,5,-3,0,3,5,3,3,3,0,2,4,1,1,2,0,1,1,2,2,1,0,82,45,37,27,18,9,37,19,12,13,2,-2,17,8,5,12,3,-1,20,11,7,1,-1,-1,7,7,4,4,5,0,5,4,4,3,2,0,2,3,0,1,3,0,33,27,6,40,24,16,7,10,12,-3,3,1,8,6,7,0,2,2,-1,4,5,-3,1,-1,5,7,14,10,1,1,3,4,7,7,1,1,2,3,7,3,0,0,-1,-4,3,3,1,2,-7,-6,11,0,3,0,-5,2,4,-3,-1,1,-2,-8,7,3,4,-1,0,0,1,2,0,0,0,0,0,1,0,0,0,0,1,1,0,0,-30,-15,-15,14,7,7,-5,-11,2,-11,-2,-1,-2,-4,-3,-6,1,0,-3,-7,5,-5,-3,-1,5,2,4,2,1,0,1,1,2,2,1,0,4,1,2,0,0,0,17,11,6,3,1,2,5,11,-5,-5,8,2,8,3,0,-5,4,0,-3,8,-5,0,4,2,0,1,2,0,0,0,0,0,1,0,0,0,0,1,1,0,0,0,5,4,1,3,-1,4,4,0,-2,5,-2,0,4,-1,-1,3,-2,1,0,1,-1,2,0,-1,1,2,0,0,0,0,0,0,0,0,-1,0,1,2,0,0,1,0,-1,6,-7,4,2,2,-8,-4,5,-3,3,3,-4,-4,6,3,5,-1,-4,0,-1,-6,-2,4,0,1,0,1,1,1,0,0,0,1,1,0,0,1,0,0,0,1,-65,-42,-23,-52,-32,-20,-5,-6,-23,-8,-15,-4,-1,-5,-20,-5,-7,-3,-4,-1,-3,-3,-8,-1,-10,-4,-20,-6,-10,-2,-4,-2,-13,-5,-6,-2,-6,-2,-7,-1,-4,0,20,9,11,-2,-1,-1,-2,11,-6,11,3,3,-2,7,-2,3,2,1,0,4,-4,8,1,2,0,1,-3,0,0,0,0,1,-2,0,0,0,0,0,-1,0,0,0,-16,-13,-3,-7,-5,-2,-11,-2,-3,-9,6,0,-10,-5,0,-3,3,0,-1,3,-3,-6,3,0,-7,1,-1,-2,2,0,-4,0,0,-2,1,0,-3,1,-1,0,1,0,-15,-9,-6,2,0,2,-5,-1,-2,-9,0,0,2,-2,-3,-5,0,-2,-7,1,1,-4,0,2,-2,2,3,0,-1,0,-1,1,1,0,-1,0,-1,1,2,0,0,0,-23,-9,-14,6,5,1,-5,1,-12,-4,-5,2,-4,2,0,-5,-2,0,-1,-1,-12,1,-3,2,2,1,0,3,0,0,0,1,2,2,0,0,2,0,-2,1,0,0
46,46085,Carlet,14041,-121,-52,-69,25,18,7,-10,-20,-45,-21,-16,-8,-3,-3,-18,-15,-6,-6,-7,-17,-27,-6,-10,-2,2,8,6,5,3,1,1,8,4,2,3,0,1,0,2,3,0,1,369,208,161,152,82,70,21,32,46,35,40,196,13,27,31,24,26,87,8,5,15,11,14,109,25,31,58,29,7,1,12,16,35,17,2,0,13,15,23,12,5,1,147,113,34,160,102,58,8,20,14,17,15,75,-1,19,31,19,14,33,9,1,-17,-2,1,42,27,35,60,33,3,1,14,21,41,23,1,1,13,14,19,10,2,0,243,162,81,179,110,69,38,54,42,38,8,64,33,31,37,27,8,27,5,23,5,11,0,37,34,58,50,29,5,2,24,30,38,13,3,1,10,28,12,16,2,1,226,98,128,168,83,85,36,46,66,-4,13,64,19,25,29,-22,8,36,17,21,37,18,5,28,18,57,62,26,1,0,12,29,33,7,0,0,6,28,29,19,1,0,263,171,92,178,105,73,46,28,88,27,21,48,22,27,65,24,15,16,24,1,23,3,6,32,31,39,70,31,5,0,16,24,45,19,0,0,15,15,25,12,5,0,388,240,148,251,131,120,78,103,96,53,19,35,38,63,65,36,13,22,40,40,31,17,6,13,49,69,77,39,12,5,25,36,38,26,4,2,24,33,39,13,8,3,151,88,63,138,77,61,21,35,63,11,8,17,12,17,39,-3,9,10,9,18,24,14,-1,7,24,39,44,25,8,-1,11,22,28,9,8,0,13,17,16,16,0,-1,199,123,76,110,59,51,35,49,52,25,8,25,29,11,31,23,8,18,6,38,21,2,0,7,25,32,31,18,5,-1,20,9,17,10,3,0,5,23,14,8,2,-1,136,69,67,80,27,53,30,12,4,3,30,63,16,-3,-3,0,19,41,14,15,7,3,11,22,28,16,21,12,0,3,16,1,4,7,-3,2,12,15,17,5,3,1,-50,-59,9,5,-22,27,-27,8,-58,-45,9,62,-19,11,-46,-32,2,26,-8,-3,-12,-13,7,36,1,12,-9,-2,-2,3,-4,0,-11,-2,-7,1,5,12,2,0,5,2,-189,-143,-46,-165,-113,-52,-7,-14,-114,-65,-6,16,1,-25,-81,-43,-4,8,-8,11,-33,-22,-2,8,-10,-12,-60,-60,-21,-2,0,-17,-42,-37,-16,0,-10,5,-18,-23,-5,-2,156,57,99,27,4,23,17,6,29,6,26,68,5,-4,11,-4,18,30,12,10,18,10,8,38,0,4,14,2,7,-1,-4,-2,10,-4,5,-1,4,6,4,6,2,0,100,60,40,-11,-7,-4,11,4,-7,5,33,51,2,0,5,0,21,32,9,4,-12,5,12,19,-5,7,-9,-2,-3,-2,-5,6,1,-6,-2,-1,0,1,-10,4,-1,-1,93,62,31,35,18,17,-7,4,14,23,19,41,-2,3,5,22,13,22,-5,1,9,1,6,19,11,8,5,10,0,1,2,4,5,7,-1,1,9,4,0,3,1,0,46,25,21,5,3,2,6,-10,7,-22,15,48,-3,2,8,-14,16,19,9,-12,-1,-8,-1,29,-5,3,14,-9,-3,1,-1,3,11,-10,-1,0,-4,0,3,1,-2,1,102,49,53,42,13,29,-1,20,11,19,29,23,1,-3,3,15,14,18,-2,23,8,4,15,5,12,15,6,2,4,4,9,4,1,-3,0,2,3,11,5,5,4,2,73,66,7,46,18,28,26,23,-1,23,5,5,11,10,13,30,2,4,15,13,-14,-7,3,1,10,7,10,11,2,5,2,-1,9,3,2,2,8,8,1,8,0,3
46,46089,Casinos,2397,2,1,1,6,4,2,1,2,-1,-6,5,1,2,2,-2,-6,3,2,-1,0,1,0,2,-1,1,3,2,0,0,0,0,2,2,0,0,0,1,1,0,0,0,0,6,1,5,6,3,3,0,4,3,4,-3,-1,-1,1,4,-1,0,-1,1,3,-1,5,-3,0,0,4,1,1,0,0,0,2,1,0,0,0,0,2,0,1,0,0,1,4,-3,6,1,5,2,0,-6,6,0,-2,1,2,-4,6,0,-2,1,-2,-2,0,0,0,3,1,0,1,0,0,1,0,-1,0,0,0,2,1,1,1,0,0,83,45,38,25,10,15,8,22,29,14,8,2,5,14,13,9,3,2,3,8,16,5,5,0,4,6,8,7,0,0,1,4,1,4,0,0,3,2,7,3,0,0,9,1,8,20,10,10,7,2,-1,0,6,-5,3,0,-2,1,3,-5,4,2,1,-1,3,0,2,4,7,2,4,0,1,1,4,1,2,0,1,3,3,1,2,0,76,41,35,37,17,20,21,27,6,16,6,0,11,16,3,8,3,0,10,11,3,8,3,0,14,8,9,5,1,0,6,4,5,1,1,0,8,4,4,4,0,0,69,27,42,43,23,20,27,10,10,11,12,-1,16,4,-3,8,5,-3,11,6,13,3,7,2,10,12,9,5,7,0,7,7,4,1,4,0,3,5,5,4,3,0,62,38,24,25,14,11,5,12,21,18,4,-1,3,1,16,11,5,0,2,11,5,7,-1,-1,3,7,5,5,5,0,1,2,4,3,4,0,2,5,1,2,1,0,23,8,15,11,7,4,6,4,4,3,4,0,1,5,0,2,-2,1,5,-1,4,1,6,-1,1,3,1,3,2,1,0,4,1,2,-1,1,1,-1,0,1,3,0,12,6,6,5,1,4,22,0,-2,-11,4,-1,12,-4,0,-6,4,0,10,4,-2,-5,0,-1,2,4,-2,0,1,0,1,1,-2,0,1,0,1,3,0,0,0,0,4,-7,11,1,1,0,-12,-1,13,3,-4,2,-13,0,5,1,-5,4,1,-1,8,2,1,-2,-5,4,1,0,0,0,-2,3,0,0,0,0,-3,1,1,0,0,0,14,21,-7,8,2,6,-10,-2,1,4,11,6,-3,-2,5,6,9,3,-7,0,-4,-2,2,3,1,-1,5,4,-1,0,1,-2,2,2,-1,0,0,1,3,2,0,0,-3,-7,4,-1,3,-4,-10,0,6,0,6,-4,-5,0,-4,3,4,-5,-5,0,10,-3,2,1,-4,-1,0,0,3,1,1,0,0,-1,2,1,-5,-1,0,1,1,0,-13,-2,-11,-43,-24,-19,17,-12,0,-9,-9,-3,17,-6,-4,-8,0,-1,0,-6,4,-1,-9,-2,-3,-5,-9,-7,-13,-6,-2,-3,-4,-6,-6,-3,-1,-2,-5,-1,-7,-3,-31,-14,-17,-28,-15,-13,-8,-2,-8,-21,7,-3,-6,1,-1,-12,3,-2,-2,-3,-7,-9,4,-1,-2,-4,-9,-13,2,-2,0,-2,-4,-7,0,-2,-2,-2,-5,-6,2,0,0,-3,3,21,12,9,-2,3,-5,-2,8,-3,-4,-1,0,-2,5,-1,2,4,-5,0,3,-2,4,2,4,7,1,3,1,2,3,4,0,2,3,0,1,3,1,1,-10,-5,-5,6,0,6,-11,-7,-1,2,1,7,-6,-2,-1,2,-1,2,-5,-5,0,0,2,5,0,1,1,2,1,1,0,0,-1,1,0,0,0,1,2,1,1,1,20,17,3,1,3,-2,4,8,6,-5,9,-2,4,3,7,-3,5,0,0,5,-1,-2,4,-2,-1,2,2,-2,1,-1,0,1,2,0,1,-1,-1,1,0,-2,0,0
46,46093,Catadau,2301,13,13,0,6,4,2,2,3,1,10,3,-4,3,4,2,3,3,-1,-1,-1,-1,7,0,-3,0,1,5,0,0,0,0,1,3,0,0,0,0,0,2,0,0,0,37,24,13,6,3,3,10,6,13,9,-1,0,5,3,9,7,0,0,5,3,4,2,-1,0,1,0,2,2,1,0,1,0,1,1,0,0,0,0,1,1,1,0,25,9,16,1,0,1,13,1,-5,10,5,2,6,1,-7,9,1,0,7,0,2,1,4,2,0,0,0,0,1,0,0,0,0,0,0,0,0,0,0,0,1,0,52,38,14,10,6,4,17,1,13,9,7,5,13,2,12,3,5,3,4,-1,1,6,2,2,2,2,1,1,4,0,2,1,1,1,1,0,0,1,0,0,3,0,4,-3,7,9,4,5,11,5,-17,7,0,-1,1,2,-12,7,-1,1,10,3,-5,0,1,-2,0,3,1,3,2,0,0,1,1,1,1,0,0,2,0,2,1,0,54,33,21,27,16,11,8,6,12,16,9,3,6,2,10,6,8,1,2,4,2,10,1,2,0,4,9,5,8,1,0,3,5,3,5,0,0,1,4,2,3,1,40,12,28,26,13,13,11,-2,12,2,11,7,7,-2,0,0,3,5,4,0,12,2,8,2,3,2,7,3,8,3,2,1,4,1,3,2,1,1,3,2,5,1,53,31,22,23,15,8,6,12,23,6,7,-2,2,9,14,4,3,-2,4,3,9,2,4,0,3,7,6,3,4,0,2,5,4,2,2,0,1,2,2,1,2,0,83,41,42,15,7,8,19,9,33,7,3,8,8,4,20,6,1,1,11,5,13,1,2,7,4,3,6,2,-1,0,4,0,3,1,0,-1,0,3,3,1,-1,1,-14,-13,-1,6,1,5,1,7,-3,-6,-4,-8,4,2,-6,-7,-2,-2,-3,5,3,1,-2,-6,1,2,2,-1,0,2,0,0,0,-1,0,2,1,2,2,0,0,0,42,22,20,-6,-8,2,17,5,-1,21,5,-5,9,1,4,6,6,-4,8,4,-5,15,-1,-1,-1,-1,-1,-2,0,-1,-2,-2,0,-2,-1,-1,1,1,-1,0,1,0,5,4,1,14,6,8,-3,2,2,-9,6,8,-5,4,-1,-3,3,6,2,-2,3,-6,3,2,3,2,2,1,4,2,2,1,-2,0,4,1,1,1,4,1,0,1,0,4,-4,-1,-2,1,0,3,-2,0,-1,1,4,1,1,0,0,-1,-4,2,-3,0,-1,2,0,0,-1,1,-1,0,0,0,-2,1,-1,0,0,0,1,0,0,0,-43,-24,-19,-2,-5,3,-9,-16,-12,-3,0,-3,1,-11,-9,-3,1,-3,-10,-5,-3,0,-1,0,0,2,-2,-2,0,-1,0,-1,-1,-2,0,-1,0,3,-1,0,0,0,15,7,8,16,8,8,-5,3,10,-6,8,3,-4,2,6,-4,2,5,-1,1,4,-2,6,-2,3,4,6,2,0,1,1,3,3,0,0,1,2,1,3,2,0,0,8,-1,9,-2,-3,1,11,-5,-2,7,-4,-1,1,-5,0,5,-3,0,10,0,-2,2,-1,-1,-1,-2,3,-1,0,-1,-2,-2,2,0,-1,0,1,0,1,-1,1,-1,22,24,-2,13,7,6,-3,-1,21,0,5,-1,5,-1,16,3,0,0,-8,0,5,-3,5,-1,0,3,3,4,3,0,0,1,2,3,1,0,0,2,1,1,2,0,57,27,30,17,6,11,17,4,4,13,8,10,14,6,-4,4,2,5,3,-2,8,9,6,5,8,4,-1,-2,8,0,6,2,-2,-4,3,1,2,2,1,2,5,-1
46,46094,Catarroja,20692,208,143,65,65,42,23,48,69,52,23,12,-3,20,37,46,28,6,3,28,32,6,-5,6,-6,11,14,19,14,3,3,8,8,14,9,1,2,3,6,5,5,2,1,499,248,251,127,74,53,50,147,201,57,24,18,10,61,146,16,10,4,40,86,55,41,14,14,21,34,45,25,1,0,12,18,30,14,0,0,9,16,15,11,1,0,860,485,375,152,77,75,99,202,396,97,36,19,51,102,240,64,19,5,48,100,156,33,17,14,35,34,49,23,8,2,14,22,27,11,3,0,21,12,22,12,5,2,559,281,278,158,72,86,79,140,295,17,19,8,35,69,156,8,9,5,44,71,139,9,10,3,35,32,56,19,13,1,15,15,26,9,5,0,20,17,30,10,8,1,870,463,407,198,93,105,56,175,460,94,57,20,37,74,265,55,24,5,19,101,195,39,33,15,40,46,70,24,14,2,17,22,37,9,5,2,23,24,33,15,9,0,991,543,448,205,98,107,111,213,476,86,68,10,60,104,296,33,33,4,51,109,180,53,35,6,37,55,58,24,19,2,18,25,30,12,7,1,19,30,28,12,12,1,760,343,417,252,117,135,58,199,381,71,20,15,13,88,208,29,2,1,45,111,173,42,18,14,42,69,84,30,16,7,22,37,35,13,7,2,20,32,49,17,9,5,780,327,453,261,122,139,120,148,253,125,48,82,48,56,132,62,10,16,72,92,121,63,38,66,59,75,62,44,17,3,24,36,36,18,8,1,35,39,26,26,9,2,300,181,119,213,119,94,25,72,147,60,17,-11,14,25,109,32,7,-2,11,47,38,28,10,-9,42,58,72,26,10,2,19,28,53,11,6,1,23,30,19,15,4,1,105,20,85,80,36,44,34,10,29,15,7,-5,21,10,-34,17,2,-5,13,0,63,-2,5,0,29,13,20,9,6,1,20,5,4,6,0,0,9,8,16,3,6,1,-10,-21,11,57,26,31,-4,41,-15,-46,-6,6,7,13,-12,-38,-2,-1,-11,28,-3,-8,-4,7,19,25,8,-2,-2,3,13,7,0,0,-1,2,6,18,8,-2,-1,1,-51,-46,-5,-124,-68,-56,4,-17,20,-44,-32,7,7,-16,12,-43,-20,4,-3,-1,8,-1,-12,3,-10,0,-41,-54,-18,-5,2,1,-22,-42,-9,-1,-12,-1,-19,-12,-9,-4,-128,-61,-67,-71,-44,-27,-58,28,-82,-31,-9,29,-17,14,-58,-7,-6,14,-41,14,-24,-24,-3,15,-11,2,-21,-22,-13,-6,-5,4,-20,-14,-10,0,-6,-2,-1,-8,-3,-6,-187,-120,-67,-49,-37,-12,-92,-4,-26,-67,-13,15,-61,-2,-20,-40,-9,10,-31,-2,-6,-27,-4,5,-6,5,-31,-13,-5,1,-4,3,-22,-9,-6,1,-2,2,-9,-4,1,0,98,64,34,82,42,40,17,11,6,32,0,29,3,17,22,21,-6,7,14,-6,-16,11,6,22,13,18,25,19,-1,3,4,10,15,13,-1,-1,9,8,10,6,0,4,-69,-88,19,-102,-76,-26,3,24,-29,-95,-8,29,-7,1,-7,-88,4,5,10,23,-22,-7,-12,24,-6,-3,-37,-52,-8,0,-11,-1,-20,-43,-5,2,5,-2,-17,-9,-3,-2,-55,-59,4,8,-3,11,-21,-4,0,-74,11,29,-5,-3,-12,-50,0,7,-16,-1,12,-24,11,22,7,5,3,-22,6,7,1,-2,3,-15,7,1,6,7,0,-7,-1,6,152,51,101,47,13,34,-9,65,33,-36,35,57,3,23,30,-39,16,15,-12,42,3,3,19,42,-3,19,11,1,12,4,-5,7,5,-3,6,0,2,12,6,4,6,4
46,46107,Chella,2528,7,10,-3,24,18,6,-5,-1,3,6,2,1,-3,2,0,7,2,2,-2,-3,3,-1,0,-1,3,3,12,5,1,0,2,3,8,4,1,0,1,0,4,1,0,0,61,31,30,33,20,13,8,20,16,8,5,1,6,10,9,3,1,0,2,10,7,5,4,1,0,15,10,7,1,0,0,10,6,3,1,0,0,5,4,4,0,0,71,40,31,72,41,31,16,16,9,20,9,0,10,6,7,11,3,2,6,10,2,9,6,-2,15,21,8,17,5,4,9,13,5,8,2,2,6,8,3,9,3,2,56,41,15,46,25,21,5,3,8,16,14,10,5,3,4,17,6,6,0,0,4,-1,8,4,8,5,8,14,9,2,4,3,3,10,4,1,4,2,5,4,5,1,55,33,22,61,36,25,-5,11,12,15,13,7,-2,5,9,10,5,4,-3,6,3,5,8,3,5,12,17,19,7,0,2,7,12,10,3,1,3,5,5,9,4,-1,55,39,16,42,23,19,5,5,24,-3,18,4,4,7,15,-2,9,4,1,-2,9,-1,9,0,6,7,9,11,8,0,4,4,5,5,4,0,2,3,4,6,4,0,109,59,50,59,31,28,20,19,31,33,6,1,10,7,23,16,4,0,10,12,8,17,2,1,7,10,12,19,7,4,4,6,6,12,2,1,3,4,6,7,5,3,99,56,43,99,64,35,7,26,16,27,17,4,3,16,5,15,15,1,4,10,11,12,2,3,11,26,31,23,7,1,5,21,21,12,5,0,6,5,10,11,2,1,-43,-26,-17,-32,-23,-9,8,6,-14,-20,-12,-11,6,1,-9,-16,-6,-2,2,5,-5,-4,-6,-9,9,1,-12,-13,-12,-6,7,1,-8,-12,-8,-3,2,0,-4,-1,-4,-3,11,1,10,18,8,10,3,14,-6,-2,5,-3,2,9,-4,-4,-1,-1,1,5,-2,2,6,-2,1,8,3,2,3,1,1,4,0,2,0,1,0,4,3,0,3,0,-5,-2,-3,6,1,5,-4,-1,1,3,-4,1,1,-5,2,2,-1,0,-5,4,-1,1,-3,1,0,1,0,1,2,2,0,0,0,0,0,1,0,1,0,1,2,1,-3,5,-8,13,7,6,-3,-4,-2,2,7,-2,-1,-1,1,2,5,-1,-2,-3,-3,0,2,-1,2,0,3,3,4,1,0,1,2,1,3,0,2,-1,1,2,1,1,-10,-11,1,12,8,4,1,-6,6,-10,-3,0,-2,-5,6,-8,-1,-1,3,-1,0,-2,-2,1,0,3,5,1,1,2,0,2,4,0,1,1,0,1,1,1,0,1,3,1,2,16,8,8,0,4,-3,7,-7,1,3,2,3,-4,-5,2,-3,2,-6,11,-2,-1,1,0,3,10,2,0,1,0,3,3,1,0,0,0,0,7,1,0,2,4,-2,13,7,6,0,2,-8,3,1,4,-1,1,-2,4,1,1,1,1,-6,-1,0,3,2,1,5,2,2,1,1,0,3,1,1,1,1,1,2,1,1,0,10,6,4,10,5,5,1,5,0,10,-1,-5,1,3,-2,9,-1,-4,0,2,2,1,0,-1,1,6,-1,6,-2,0,0,4,-1,4,-1,-1,1,2,0,2,-1,1,23,17,6,25,12,13,5,-2,-2,12,2,7,2,2,2,7,1,2,3,-4,-4,5,1,5,3,3,1,10,4,4,0,2,1,5,2,2,3,1,0,5,2,2,-5,5,-10,8,2,6,2,0,5,-5,3,-11,1,3,6,-1,1,-6,1,-3,-1,-4,2,-5,1,0,5,0,3,-1,0,0,3,-2,2,-1,1,0,2,2,1,0
46,46109,Cheste,6906,110,69,41,82,56,26,17,16,47,27,-1,3,1,13,33,19,1,0,16,3,14,8,-2,3,6,20,33,15,4,3,4,16,21,11,3,1,2,4,12,4,1,2,84,58,26,74,51,23,1,30,31,22,0,-2,1,21,20,16,-1,0,0,9,11,6,1,-2,4,26,24,15,3,1,2,17,19,9,3,1,2,9,5,6,0,0,69,34,35,11,5,6,7,25,18,2,15,2,0,12,16,4,5,-2,7,13,2,-2,10,4,1,5,3,0,2,0,1,4,1,0,0,-1,0,1,2,0,2,1,5,-5,10,2,1,1,2,3,-29,3,25,-4,-1,3,-21,0,11,-1,3,0,-8,3,14,-3,0,0,1,1,0,0,0,0,0,1,0,0,0,0,1,0,0,0,63,46,17,126,73,53,8,30,20,25,-10,-8,11,20,23,4,-7,-7,-3,10,-3,21,-3,-1,14,43,37,24,6,2,9,26,22,12,3,1,5,17,15,12,3,1,74,42,32,119,69,50,27,31,2,19,-7,-1,18,18,-1,10,-6,-1,9,13,3,9,-1,0,20,37,33,23,5,1,12,19,22,12,3,1,8,18,11,11,2,0,304,191,113,146,92,54,63,75,91,54,9,11,34,49,62,33,8,5,29,26,29,21,1,6,21,58,36,21,4,4,11,35,26,14,4,2,10,23,10,7,0,2,240,160,80,182,115,67,30,56,69,58,20,1,26,31,53,34,14,-4,4,25,16,24,6,5,19,48,54,47,11,0,15,29,38,25,6,0,4,19,16,22,5,0,176,100,76,114,68,46,34,40,67,18,15,5,14,30,35,14,8,1,20,10,32,4,7,4,27,32,34,16,4,0,16,20,19,13,1,-1,11,12,15,3,3,1,138,70,68,78,42,36,33,33,26,31,6,4,21,14,6,20,8,-1,12,19,20,11,-2,5,14,25,19,9,7,3,8,13,8,7,5,0,6,12,11,2,2,3,73,50,23,99,62,37,7,36,25,1,0,0,8,29,16,-6,1,-2,-1,7,9,7,-1,2,11,40,28,12,8,0,9,26,20,1,6,0,2,14,8,11,2,0,141,57,84,72,39,33,34,37,47,12,5,4,12,6,22,9,3,2,22,31,25,3,2,2,14,27,11,20,2,-3,7,16,4,13,0,-2,7,11,7,7,2,-1,-137,-78,-59,-68,-53,-15,-27,-15,-52,-34,-6,0,-14,-7,-32,-13,-12,2,-13,-8,-20,-21,6,-2,-4,-14,-28,-16,-8,1,-3,-10,-24,-9,-7,0,-1,-4,-4,-7,-1,1,-30,-27,-3,-70,-42,-28,16,0,-7,-28,-7,-5,8,-4,-12,-12,-4,-3,8,4,5,-16,-3,-2,-1,-11,-28,-20,-7,-3,2,-9,-17,-10,-6,-2,-3,-2,-11,-10,-1,-1,-78,-54,-24,-109,-78,-31,1,-5,-11,-54,-7,-4,-4,-4,-6,-36,-4,-1,5,-1,-5,-18,-3,-3,-8,-11,-25,-45,-20,0,-10,-7,-21,-26,-14,0,2,-4,-4,-19,-6,0,95,74,21,74,54,20,21,22,18,21,3,4,10,9,25,19,3,3,11,13,-7,2,0,1,12,22,15,14,6,1,6,12,13,15,4,1,6,10,2,-1,2,0,-77,-54,-23,-45,-40,-5,-6,10,-53,-22,-16,5,-10,10,-34,-13,-10,0,4,0,-19,-9,-6,5,6,10,-34,-9,-16,-1,0,3,-19,-13,-11,-1,6,7,-15,4,-5,0,35,30,5,85,54,31,9,14,15,2,1,-8,-2,10,18,4,2,-6,11,4,-3,-2,-1,-2,16,19,20,24,3,2,7,12,15,16,2,1,9,7,5,8,1,1
46,46111,Chiva,9327,426,199,227,115,58,57,63,63,76,96,40,82,38,34,30,52,24,19,25,29,46,44,16,63,19,23,37,27,8,1,9,11,19,17,2,0,10,12,18,10,6,1,360,204,156,163,90,73,32,57,107,70,34,56,17,38,62,44,23,18,15,19,45,26,11,38,36,39,63,19,5,0,22,22,33,9,3,0,14,17,30,10,2,0,444,248,196,146,80,66,101,40,156,60,37,42,66,17,85,41,21,14,35,23,71,19,16,28,39,31,42,19,13,1,25,14,18,13,10,0,14,17,24,6,3,1,601,325,276,213,108,105,107,83,181,149,55,30,55,50,107,71,30,14,52,33,74,78,25,16,53,36,49,50,19,5,24,21,30,25,4,3,29,15,19,25,15,2,418,249,169,111,60,51,89,40,137,93,24,23,44,29,77,64,18,13,45,11,60,29,6,10,22,22,34,19,10,2,13,9,21,13,2,1,9,13,13,6,8,1,611,358,253,160,86,74,139,68,165,151,40,43,73,41,104,93,30,17,66,27,61,58,10,26,26,42,49,27,13,2,15,19,31,14,7,0,11,23,18,13,6,2,525,301,224,125,72,53,94,37,214,96,40,40,55,25,124,60,24,16,39,12,90,36,16,24,21,23,36,23,18,4,13,14,22,12,8,3,8,9,14,11,10,1,562,272,290,157,79,78,124,63,183,140,19,23,70,27,79,81,1,8,54,36,104,59,18,15,27,58,30,29,13,-1,10,35,13,18,2,0,17,23,17,11,11,-1,614,323,291,176,96,80,162,96,147,131,26,39,90,47,73,83,17,5,72,49,74,48,9,34,55,46,35,27,9,2,32,26,12,20,3,1,23,20,23,7,6,1,145,67,78,31,13,18,16,-25,84,26,20,19,8,-14,38,15,12,7,8,-11,46,11,8,12,10,-3,8,1,10,1,8,-7,3,0,5,1,2,4,5,1,5,0,353,192,161,100,61,39,73,55,86,79,23,32,47,25,43,50,13,13,26,30,43,29,10,19,10,29,28,18,8,6,5,14,18,14,7,3,5,15,10,4,1,3,141,77,64,75,40,35,-6,8,23,62,29,27,-9,12,22,43,6,6,3,-4,1,19,23,21,3,8,24,20,12,4,-2,6,15,13,4,3,5,2,9,7,8,1,41,-7,48,-19,-22,3,-4,-15,-2,38,-13,42,-17,-27,5,30,-6,13,13,12,-7,8,-7,29,-15,2,-3,1,-3,-1,-7,-4,-5,-2,-3,-1,-8,6,2,3,0,0,14,9,5,32,15,17,-8,-8,19,-3,-8,25,4,-1,8,-8,1,7,-12,-7,11,5,-9,18,2,3,19,2,1,4,0,1,7,3,2,2,2,2,12,-1,-1,2,47,0,47,19,12,7,13,11,-18,5,-16,47,12,4,-13,1,-24,16,1,7,-5,4,8,31,5,1,-6,8,10,-1,1,2,-4,7,5,1,4,-1,-2,1,5,-2,49,9,40,54,33,21,-11,-17,6,25,5,36,-14,3,-1,7,3,7,3,-20,7,18,2,29,8,8,9,17,7,3,6,7,5,9,3,1,2,1,4,8,4,2,91,72,19,85,51,34,7,-10,44,25,28,1,17,-3,28,15,20,-5,-10,-7,16,10,8,6,18,13,27,12,13,1,13,10,20,0,7,1,5,3,7,12,6,0,194,82,112,139,63,76,47,10,47,60,-4,33,31,-7,17,39,-9,9,16,17,30,21,5,24,28,19,39,26,19,3,10,7,21,12,8,2,18,12,18,14,11,1
46,46098,Corbera,3078,-12,-10,-2,14,7,7,-2,0,-4,-1,0,-7,-5,-1,-2,0,0,-2,3,1,-2,-1,0,-5,1,2,3,2,5,1,0,0,2,1,3,1,1,2,1,1,2,0,0,5,-5,10,7,3,-3,8,-6,-3,4,0,-1,8,-3,-2,4,-1,-2,0,-3,-1,0,1,1,4,2,3,0,0,1,4,1,1,0,0,0,0,1,2,0,0,44,26,18,34,20,14,14,6,23,4,2,-7,8,5,11,3,2,-3,6,1,12,1,0,-4,11,5,12,3,3,0,7,3,5,2,3,0,4,2,7,1,0,0,24,15,9,5,2,3,10,9,-4,6,3,0,7,1,0,5,1,0,3,8,-4,1,2,0,3,3,0,1,0,-2,2,0,1,0,0,-1,1,3,-1,1,0,-1,28,11,17,33,14,19,1,14,1,8,4,0,2,3,0,3,2,1,-1,11,1,5,2,-1,-1,14,10,2,6,1,-1,4,6,1,2,1,0,10,4,1,4,0,72,45,27,31,18,13,17,7,28,16,4,3,7,3,18,15,2,1,10,4,10,1,2,2,7,9,11,4,0,0,6,6,5,2,-1,0,1,3,6,2,1,0,55,35,20,38,22,16,10,24,10,2,7,2,1,15,12,-1,5,2,9,9,-2,3,2,0,3,14,11,4,4,1,1,6,8,2,2,1,2,8,3,2,2,0,38,30,8,15,5,10,2,10,9,14,10,-5,6,9,5,5,6,-1,-4,1,4,9,4,-4,3,8,0,-1,5,0,1,4,-2,0,2,0,2,4,2,-1,3,0,23,24,-1,10,1,9,11,8,-15,15,7,-5,7,3,2,11,4,-4,4,5,-17,4,3,-1,1,8,-2,1,1,0,-1,3,-3,1,0,0,2,5,1,0,1,0,5,9,-4,6,5,1,9,-5,-1,10,-3,-3,8,-5,0,6,0,1,1,0,-1,4,-3,-4,5,0,-1,3,-2,1,4,0,-1,2,0,0,1,0,0,1,-2,1,7,-4,11,6,2,4,9,13,-14,-7,7,-2,5,8,-13,-8,4,0,4,5,-1,1,3,-2,5,3,-1,-1,0,0,4,3,-2,-3,0,0,1,0,1,2,0,0,-31,-4,-27,-10,-6,-4,-13,8,-22,-2,-3,5,-4,6,-4,-1,-2,0,-9,2,-18,-1,-1,5,1,0,-4,-5,-2,0,0,0,-2,-3,-1,0,1,0,-2,-2,-1,0,-20,-12,-8,-8,-5,-3,-12,6,-13,-4,-3,4,-9,3,-6,-4,-2,3,-3,3,-7,0,-1,1,-1,1,-5,-2,-1,0,-2,1,-3,-1,0,0,1,0,-2,-1,-1,0,-23,-9,-14,-1,-1,0,3,-7,5,-14,-7,-3,3,0,1,-6,-6,0,0,-7,4,-8,-1,-3,1,2,1,-3,-1,-2,0,1,1,-1,-1,-1,1,1,0,-2,0,-1,1,-1,2,8,2,6,9,-5,-2,6,-2,-5,8,-3,0,-3,0,-3,1,-2,-2,9,-2,-2,7,-1,0,1,0,1,6,-2,-1,-1,0,0,1,1,1,2,0,1,-9,-3,-6,-12,-7,-5,4,4,1,-4,-8,-7,-2,4,-1,1,-3,-3,6,0,2,-5,-5,-4,-5,1,-5,-2,-1,0,-5,2,-4,0,1,-1,0,-1,-1,-2,-2,1,-36,-27,-9,-1,-3,2,-7,-8,-8,1,-7,-6,-7,-7,-1,0,-7,-3,0,-1,-7,1,0,-3,2,3,-1,-2,-3,0,1,0,0,-1,-3,0,1,3,-1,-1,0,0,-26,-15,-11,-1,-1,0,-5,0,-14,-4,1,-2,-6,4,-7,-3,0,-1,1,-4,-7,-1,1,-1,-2,0,0,-1,1,1,-2,1,0,0,0,0,0,-1,0,-1,1,1
46,46105,Cullera,20459,484,293,191,431,253,178,93,63,125,121,55,28,56,36,78,73,32,13,37,27,47,48,23,15,80,76,144,73,37,19,51,37,80,47,20,16,29,39,64,26,17,3,-119,-70,-49,162,92,70,3,-44,-24,-35,-7,-13,-12,-19,-9,-20,-6,-4,15,-25,-15,-15,-1,-9,36,31,58,25,10,2,18,17,38,14,4,1,18,14,20,11,6,1,473,295,178,466,272,194,107,78,115,121,33,15,61,59,74,84,10,4,46,19,41,37,23,11,95,96,142,86,29,16,54,61,77,56,13,10,41,35,65,30,16,6,359,231,128,381,217,164,40,43,108,95,58,25,20,32,75,61,32,17,20,11,33,34,26,8,60,62,132,67,40,16,34,36,74,44,20,7,26,26,58,23,20,9,511,314,197,591,381,210,21,134,145,105,57,40,11,75,110,74,23,17,10,59,35,31,34,23,71,153,193,103,49,19,41,100,133,71,26,10,30,53,60,32,23,9,501,329,172,603,366,237,71,126,142,131,50,-17,37,100,114,66,35,-19,34,26,28,65,15,2,84,144,197,126,35,17,46,91,134,77,15,3,38,53,63,49,20,14,357,175,182,606,328,278,21,86,105,90,37,10,13,55,42,34,19,7,8,31,63,56,18,3,92,154,174,113,43,26,44,87,108,57,23,9,48,67,66,56,20,17,369,226,143,579,346,233,54,118,123,84,7,-13,29,70,82,56,0,-12,25,48,41,28,7,-1,82,152,188,128,22,7,49,92,118,75,10,2,33,60,70,53,12,5,162,116,46,290,178,112,72,66,35,9,36,-47,32,58,39,-9,25,-19,40,8,-4,18,11,-28,32,100,95,29,30,4,16,65,62,12,20,4,16,35,33,17,10,0,-285,-124,-161,2,6,-4,-35,-19,-86,-61,-37,-46,-14,4,-50,-21,-23,-22,-21,-23,-36,-40,-14,-24,13,36,-15,-29,2,-10,1,27,-9,-15,5,-6,12,9,-6,-14,-3,-4,-535,-305,-230,-329,-209,-120,-53,-19,-183,-112,-80,-88,-30,-9,-125,-63,-42,-38,-23,-10,-58,-49,-38,-50,-27,20,-140,-61,-52,-71,-15,8,-97,-39,-32,-35,-12,12,-43,-22,-20,-36,-347,-216,-131,17,-21,38,6,-48,-113,-109,-63,-20,6,-16,-87,-65,-44,-12,0,-32,-26,-44,-19,-8,30,25,-29,0,-7,-8,19,10,-23,-14,-12,-7,11,15,-6,14,5,-1,-302,-206,-96,-14,-22,8,-33,-36,-128,-82,-23,-3,-24,-27,-73,-66,-13,-6,-9,-9,-55,-16,-10,3,-2,5,-15,-14,4,6,-3,6,-11,-21,2,3,1,-1,-4,7,2,3,52,41,11,87,60,27,58,37,-24,5,-16,-14,41,31,-17,-5,-13,-1,17,6,-7,10,-3,-13,23,37,-6,17,8,3,22,30,-5,7,3,0,1,7,-1,10,5,3,-143,-102,-41,23,-9,32,-18,0,-84,-45,12,-17,-21,4,-56,-28,-3,-3,3,-4,-28,-17,15,-14,28,24,-45,-10,14,6,12,18,-37,-19,6,8,16,6,-8,9,8,-2,34,20,14,177,85,92,18,6,-1,10,6,-14,5,1,-1,15,0,-3,13,5,0,-5,6,-11,43,22,26,36,34,11,24,10,7,22,13,6,19,12,19,14,21,5,66,20,46,185,78,107,11,14,8,8,7,17,-1,5,13,-14,7,7,12,9,-5,22,0,10,44,46,38,42,9,4,23,19,15,16,6,-2,21,27,23,26,3,6,59,49,10,169,87,82,10,43,2,-12,0,16,-4,19,5,-1,12,17,14,24,-3,-11,-12,-1,27,61,43,7,7,19,7,35,20,11,-2,13,20,26,23,-4,9,6
46,46113,Daimús,1544,161,84,77,22,13,9,24,23,45,40,22,5,12,10,27,18,15,2,12,13,18,22,7,3,0,3,10,4,3,2,0,0,8,3,2,0,0,3,2,1,1,2,27,19,8,19,9,10,-2,1,12,10,6,0,1,0,6,7,4,1,-3,1,6,3,2,-1,5,1,6,5,1,1,3,0,2,2,1,1,2,1,4,3,0,0,113,66,47,24,14,10,14,12,28,25,26,8,7,6,16,18,13,6,7,6,12,7,13,2,1,0,4,4,14,1,1,0,3,1,6,3,0,0,1,3,8,-2,174,88,86,18,7,11,23,29,39,44,26,9,17,19,13,18,16,4,6,10,26,26,10,5,1,1,2,5,8,0,1,0,-1,3,4,0,0,1,3,2,4,0,127,64,63,34,14,20,26,22,26,27,10,12,10,11,14,18,7,1,16,11,12,9,3,11,6,6,6,2,6,8,1,4,2,1,4,2,5,2,4,1,2,6,134,76,58,42,20,22,29,23,11,51,16,6,22,13,3,32,4,3,7,10,8,19,12,3,4,5,9,19,4,1,1,2,3,13,1,0,3,3,6,6,3,1,171,83,88,39,23,16,27,32,40,19,30,17,16,16,16,11,10,10,11,16,24,8,20,7,3,16,9,4,6,0,1,9,7,2,2,1,2,7,2,2,4,-1,159,86,73,53,28,25,15,15,59,48,5,14,13,9,38,20,1,2,2,6,21,28,4,12,7,11,11,14,8,2,4,6,6,8,3,1,3,5,5,6,5,1,90,47,43,34,13,21,12,9,42,15,2,11,9,3,25,13,-1,0,3,6,17,2,3,11,7,9,11,3,5,-1,2,3,8,0,2,-2,5,6,3,3,3,1,106,53,53,34,12,22,17,-2,13,27,26,24,13,-5,5,14,14,12,4,3,8,13,12,12,2,2,4,7,10,9,1,1,-1,4,3,4,1,1,5,3,7,5,36,21,15,12,4,8,3,15,4,14,-6,-1,3,11,-2,9,-2,-1,0,4,6,5,-4,0,-2,4,2,2,3,3,-2,2,2,0,1,1,0,2,0,2,2,2,-36,-11,-25,24,12,12,-15,14,-15,-6,-23,8,-6,2,-5,3,-10,3,-9,12,-10,-9,-13,5,5,7,5,4,1,2,2,4,3,2,0,1,3,3,2,2,1,1,-34,-17,-17,4,5,-1,-18,7,-13,-8,-8,5,-17,10,-10,-1,0,0,-1,-3,-3,-7,-8,5,2,2,-2,3,-2,1,2,2,-1,2,0,0,0,0,-1,1,-2,1,56,20,36,4,2,2,-1,18,12,0,10,16,-4,7,8,1,4,4,3,11,4,-1,6,12,1,1,2,0,-1,1,1,0,0,0,0,1,0,1,2,0,-1,0,70,34,36,31,19,12,-9,6,7,-8,4,66,-4,4,13,-4,1,24,-5,2,-6,-4,3,42,2,5,9,2,7,6,1,4,6,1,3,4,1,1,3,1,4,2,50,37,13,9,6,3,19,14,-5,22,4,-6,10,8,-4,18,6,-2,9,6,-1,4,-2,-4,1,3,0,1,3,1,-1,4,0,2,1,0,2,-1,0,-1,2,1,7,-6,13,17,8,9,-17,7,13,0,-7,4,-3,1,-7,2,-5,3,-14,6,20,-2,-2,1,0,3,7,2,2,3,0,1,4,1,0,2,0,2,3,1,2,1,110,39,71,26,15,11,12,21,6,11,9,48,11,10,1,5,1,10,1,11,5,6,8,38,5,7,3,3,6,1,3,4,1,2,4,1,2,3,2,1,2,0
46,46116,"Eliana, l'",12652,440,207,233,7,2,5,142,34,78,104,45,30,81,7,35,55,20,6,61,27,43,49,25,24,1,0,1,2,2,1,0,0,0,1,1,0,1,0,1,1,1,1,312,153,159,144,78,66,95,15,92,87,1,14,51,2,43,43,-1,6,44,13,49,44,2,8,42,20,34,42,4,0,21,11,17,25,3,0,21,9,17,17,1,0,283,154,129,114,57,57,84,22,79,67,3,24,45,16,39,37,5,8,39,6,40,30,-2,16,33,17,29,25,6,3,17,8,16,14,1,1,16,9,13,11,5,2,402,193,209,122,62,60,154,-5,89,79,31,40,75,-5,30,50,11,20,79,0,59,29,20,20,37,13,30,21,13,7,23,7,11,11,6,4,14,6,19,10,7,3,394,163,231,125,58,67,164,4,27,131,10,42,77,-3,-8,61,8,20,87,7,35,70,2,22,31,14,41,26,6,6,9,5,19,17,6,1,22,9,22,9,0,5,399,196,203,150,74,76,138,28,104,92,-2,18,79,10,52,42,-9,10,59,18,52,50,7,8,40,26,52,17,9,4,24,14,21,9,3,2,16,12,31,8,6,2,365,160,205,132,57,75,164,-9,38,109,9,36,79,-3,0,62,2,6,85,-6,38,47,7,30,19,23,36,38,5,8,11,11,11,18,1,4,8,12,25,20,4,4,270,107,163,133,71,62,104,6,47,70,-7,44,40,1,13,34,-2,16,64,5,34,36,-5,28,33,21,43,23,10,3,17,10,28,11,3,2,16,11,15,12,7,1,140,63,77,132,55,77,63,22,13,35,-20,25,48,18,-10,8,-6,7,15,4,23,27,-14,18,20,32,38,28,9,4,10,11,12,17,4,1,10,21,26,11,5,3,-82,-30,-52,67,30,37,-12,-23,-51,9,5,-13,-7,-18,-9,5,2,-4,-5,-5,-42,4,3,-9,10,20,15,16,5,-1,6,9,8,5,2,0,4,11,7,11,3,-1,136,35,101,93,51,42,31,-20,37,33,6,39,9,-8,7,20,0,3,22,-12,30,13,6,36,19,18,27,19,7,2,9,9,21,8,3,1,10,9,6,11,4,1,259,130,129,75,40,35,77,9,21,59,15,70,47,6,2,34,15,21,30,3,19,25,0,49,21,6,19,16,7,4,9,3,8,12,5,2,12,3,11,4,2,2,175,74,101,37,19,18,73,-21,-13,43,18,73,41,-23,-3,24,12,20,32,2,-10,19,6,53,7,11,9,-1,6,3,8,5,4,-3,3,2,-1,6,5,2,3,1,153,65,88,36,34,2,73,-8,3,23,-21,80,55,-6,-1,3,-11,24,18,-2,4,20,-10,56,31,5,-6,-5,11,-2,30,-1,-4,-2,10,-1,1,6,-2,-3,1,-1,107,23,84,78,40,38,60,-41,14,20,-6,55,35,-11,-7,4,-9,8,25,-30,21,16,3,47,40,13,6,0,13,4,23,15,1,-6,4,1,17,-2,5,6,9,3,140,54,86,54,24,30,63,-29,-6,39,-5,76,35,-18,-5,19,-6,29,28,-11,-1,20,1,47,26,8,-2,16,4,1,21,0,-6,4,3,2,5,8,4,12,1,-1,337,115,222,127,68,59,106,0,20,104,-15,122,63,6,-8,42,-5,20,43,-6,28,62,-10,102,39,15,20,27,11,13,23,8,10,12,7,8,16,7,10,15,4,5,365,139,226,166,87,79,122,-36,33,95,7,130,53,-26,8,58,0,40,69,-10,25,37,7,90,48,17,41,32,20,6,27,10,21,16,10,2,21,7,20,16,10,4
46,46118,Enguera,4695,388,279,109,426,311,115,23,105,142,95,19,1,14,74,106,73,10,-2,9,31,36,22,9,3,27,116,165,98,16,1,17,83,123,76,8,1,10,33,42,22,8,0,400,284,116,461,327,134,36,122,148,85,7,3,19,92,105,63,6,0,17,30,43,22,1,3,39,122,183,99,16,1,24,91,128,73,11,0,15,31,55,26,5,1,76,50,26,241,152,89,35,26,-18,25,6,2,21,15,-10,14,8,2,14,11,-8,11,-2,0,37,59,68,61,15,1,22,37,43,40,10,0,15,22,25,21,5,1,59,23,36,128,79,49,17,21,-13,13,19,0,15,14,-18,3,7,0,2,7,5,10,12,0,17,34,32,23,19,2,15,23,21,11,7,1,2,11,11,12,12,1,77,24,53,97,51,46,14,15,0,11,8,30,3,5,-5,14,1,8,11,10,5,-3,7,22,12,27,31,15,7,5,4,13,19,11,2,2,8,14,12,4,5,3,26,3,23,72,36,36,15,6,-21,4,19,4,8,1,-15,-1,8,3,7,5,-6,5,11,1,14,14,16,17,10,1,6,8,8,10,4,0,8,6,8,7,6,1,120,66,54,135,79,56,23,34,6,36,22,0,16,25,-1,19,9,-2,7,9,7,17,13,2,26,30,36,35,8,0,15,21,16,23,4,0,11,9,20,12,4,0,174,113,61,200,124,76,6,59,27,59,15,7,5,41,16,36,8,6,1,18,11,23,7,1,10,61,42,68,17,1,5,42,25,41,9,1,5,19,17,27,8,0,36,-9,45,46,20,26,0,5,6,-6,12,16,-8,-1,-9,-3,6,5,8,6,15,-3,6,11,7,6,20,6,5,1,2,3,7,6,1,1,5,3,13,0,4,0,45,31,14,49,30,19,-2,15,10,15,4,3,-1,4,13,11,0,3,-1,11,-3,4,4,0,2,16,18,11,2,0,1,6,13,10,0,0,1,10,5,1,2,0,85,37,48,36,13,23,20,11,17,26,12,2,5,5,7,17,5,0,15,6,10,9,7,2,12,8,8,7,2,-1,5,3,0,4,1,0,7,5,8,3,1,-1,-17,-10,-7,11,5,6,-4,3,2,-15,-1,-2,-6,3,2,-12,2,2,2,0,0,-3,-3,-4,0,8,2,-1,2,0,-1,6,1,0,-1,0,1,2,1,-1,3,0,8,-4,12,17,10,7,3,2,12,-7,-4,2,2,0,3,-7,-5,2,1,2,9,0,1,0,0,4,7,5,0,1,0,2,3,4,0,1,0,2,4,1,0,0,-39,-26,-13,-15,-10,-5,5,4,-27,-5,-6,-10,3,0,-13,-4,-6,-5,2,4,-14,-1,0,-5,5,-2,-9,-4,-3,-3,4,0,-6,-2,-6,-1,1,-2,-3,-2,3,-2,-8,8,-16,13,8,5,-8,9,-10,3,7,-7,-4,6,4,1,6,-4,-4,3,-14,2,1,-3,1,5,3,2,3,0,1,2,2,1,2,0,0,3,1,1,1,0,-296,-191,-105,-234,-158,-76,-6,-18,-91,-97,-61,-20,-4,-8,-55,-73,-42,-10,-2,-10,-36,-24,-19,-10,-8,-4,-66,-85,-56,-16,-7,0,-42,-63,-35,-12,-1,-4,-24,-22,-21,-4,-55,-33,-22,-21,-16,-5,-6,-4,-23,-16,-1,-5,-5,-2,-14,-11,1,-3,-1,-2,-9,-5,-2,-2,-3,3,-13,-4,-1,-4,-1,0,-9,-5,-1,-1,-2,3,-4,1,0,-3,-12,-10,-2,20,5,15,-1,-14,0,-7,9,0,-4,-2,-5,-6,6,1,3,-12,5,-1,3,-1,-2,2,12,-2,2,6,-1,2,3,-3,1,2,-1,0,9,1,1,4
46,46122,Faura,2847,4,-6,10,11,6,5,2,3,-3,2,3,-4,-1,-2,-2,0,1,-2,3,5,-1,2,2,-2,0,1,4,3,3,0,0,0,4,1,1,0,0,1,0,2,2,0,-20,-10,-10,9,7,2,0,-6,1,1,-12,-4,0,-1,1,1,-9,-2,0,-5,0,0,-3,-2,1,2,5,0,1,0,1,2,4,0,0,0,0,0,1,0,1,0,-15,-7,-8,5,4,1,3,-6,-8,3,1,-7,2,-2,-8,4,1,-4,1,-4,0,-1,0,-3,0,0,2,2,2,-1,0,1,1,2,1,-1,0,-1,1,0,1,0,22,15,7,13,5,8,1,3,19,-1,-5,3,7,3,13,-1,-5,-2,-6,0,6,0,0,5,2,5,4,0,0,2,0,2,3,0,0,0,2,3,1,0,0,2,82,54,28,21,9,12,17,26,27,11,-1,-1,9,14,22,7,1,0,8,12,5,4,-2,-1,1,5,9,5,0,1,0,2,4,3,0,0,1,3,5,2,0,1,137,59,78,9,3,6,31,21,50,24,4,4,10,7,28,13,0,-1,21,14,22,11,4,5,1,1,3,1,1,1,0,1,0,1,0,1,1,0,3,0,1,0,92,53,39,18,4,14,7,14,45,14,8,1,7,3,24,9,5,3,0,11,21,5,3,-2,1,8,6,1,1,0,0,1,2,0,1,0,1,7,4,1,0,0,208,134,74,55,26,29,19,51,90,28,16,0,12,29,62,19,9,-1,7,22,28,9,7,1,10,15,13,11,6,0,4,9,6,3,4,0,6,6,7,8,2,0,96,44,52,19,7,12,16,25,22,18,9,4,0,12,13,13,4,3,16,13,9,5,5,1,4,5,6,0,0,2,2,2,4,0,-1,0,2,3,2,0,1,2,64,40,24,31,16,15,5,16,22,9,10,1,9,13,10,6,2,-1,-4,3,12,3,8,2,4,7,10,6,2,1,1,5,5,4,0,0,3,2,5,2,2,1,29,20,9,17,14,3,6,14,4,2,6,-3,2,7,7,-1,4,-2,4,7,-3,3,2,-1,0,13,2,2,-2,0,0,9,2,2,-1,0,0,4,0,0,-1,0,-66,-44,-22,9,2,7,-20,4,-17,-20,-8,-6,-13,2,-10,-15,-5,-3,-7,2,-7,-5,-3,-3,3,3,2,1,1,-2,2,1,1,-1,0,-1,1,2,1,2,1,-1,-10,-5,-5,2,1,1,-8,-5,6,-2,-2,3,3,-2,-1,-4,0,2,-11,-3,7,2,-2,1,4,-1,1,-1,0,-1,3,-1,-2,1,0,0,1,0,3,-2,0,-1,22,11,11,10,6,4,0,2,9,-9,5,11,0,1,9,-9,1,6,0,1,0,0,4,5,1,2,3,-1,2,1,1,1,2,-1,1,0,0,1,1,0,1,1,-20,-20,0,1,2,-1,-12,9,0,-15,-1,-3,-8,3,1,-11,0,-5,-4,6,-1,-4,-1,2,-1,0,-1,-1,0,2,1,0,-1,2,-1,0,-2,0,0,-3,1,2,9,8,1,-4,0,-4,-2,1,2,1,1,4,0,0,5,-3,2,2,-2,1,-3,4,-1,2,0,0,-2,-3,1,-1,2,0,-1,-3,1,0,-2,0,-1,0,0,-1,-13,-5,-8,-11,-9,-2,-5,-5,-13,-2,5,3,-1,-4,-4,-6,7,2,-4,-1,-9,4,-2,1,-3,-1,-8,0,1,0,-3,-2,-4,-1,1,0,0,1,-4,1,0,0,70,35,35,17,5,12,22,15,11,12,14,0,5,10,10,3,7,-1,17,5,1,9,7,1,1,4,2,6,3,0,0,0,1,1,2,0,1,4,1,5,1,0
46,46126,Foios,5304,71,38,33,31,25,6,13,11,42,6,-7,5,8,3,25,5,-5,1,5,8,17,1,-2,4,0,4,19,6,1,1,0,3,16,5,1,0,0,1,3,1,0,1,267,158,109,61,48,13,19,50,136,33,12,17,6,27,87,21,7,9,13,23,49,12,5,8,5,19,29,7,1,0,3,13,25,6,1,0,2,6,4,1,0,0,160,82,78,13,9,4,23,27,77,23,6,6,8,9,46,13,3,3,15,18,31,10,3,3,3,4,2,4,0,0,1,4,2,2,0,0,2,0,0,2,0,0,67,21,46,5,3,2,9,28,22,6,2,2,7,9,4,0,0,0,2,19,18,6,2,2,1,2,-1,3,0,0,1,1,0,1,0,0,0,1,-1,2,0,0,147,89,58,36,23,13,19,27,59,39,9,-5,4,20,38,22,5,0,15,7,21,17,4,-5,7,8,13,4,4,0,4,7,11,1,0,0,3,1,2,3,4,0,80,35,45,49,29,20,9,27,29,9,6,2,3,3,20,5,3,4,6,24,9,4,3,-2,5,16,16,9,3,0,3,7,12,5,2,0,2,9,4,4,1,0,80,44,36,50,17,33,7,41,-2,13,10,9,7,16,5,9,4,3,0,25,-7,4,6,6,8,16,12,8,1,2,4,7,1,3,0,1,4,9,11,5,1,1,85,27,58,28,5,23,16,24,18,8,10,6,9,14,-6,4,5,0,7,10,24,4,5,6,10,7,-1,6,1,5,4,3,-4,0,0,2,6,4,3,6,1,3,151,84,67,15,8,7,14,29,52,31,29,0,3,17,44,11,15,-1,11,12,8,20,14,1,-4,11,-4,4,5,2,-1,6,-1,1,2,1,-3,5,-3,3,3,1,104,27,77,4,-12,16,5,11,63,21,-2,4,2,-5,24,5,-3,4,3,16,39,16,1,0,2,4,-2,-1,-1,2,1,-3,-6,-3,-1,0,1,7,4,2,0,2,147,71,76,-4,-10,6,13,36,75,6,13,2,9,12,32,5,10,4,4,24,43,1,3,-2,3,3,6,-10,-3,-3,1,2,-2,-9,-1,-1,2,1,8,-1,-2,-2,47,42,5,-20,-15,-5,3,-11,49,14,-9,2,10,-7,33,9,-5,2,-7,-4,16,5,-4,0,-1,0,-5,-10,-2,-2,-1,-1,-4,-6,-2,-1,0,1,-1,-4,0,-1,46,-1,47,-15,-16,1,-11,25,21,0,9,2,-10,6,16,-10,-4,1,-1,19,5,10,13,1,-2,3,-7,-9,-1,1,-2,0,-4,-9,-1,0,0,3,-3,0,0,1,-2,6,-8,-23,-12,-11,4,1,13,-9,-9,-3,1,0,3,4,-5,2,3,1,10,-13,-4,-5,-3,-2,-7,-12,-2,1,-1,-3,-4,-6,-1,1,-2,1,-3,-6,-1,0,70,52,18,27,16,11,13,3,49,-4,9,3,12,0,36,1,4,2,1,3,13,-5,5,1,6,4,16,2,-2,0,4,1,10,1,-1,0,2,3,6,1,-1,0,-40,-6,-34,-12,-7,-5,-11,-11,-32,21,7,-8,0,-3,-18,18,3,-2,-11,-8,-14,3,4,-6,-5,3,-1,-8,-1,0,-3,1,1,-5,-2,1,-2,2,-2,-3,1,-1,12,9,3,9,-1,10,15,1,5,-12,-10,15,10,-5,-1,0,-5,11,5,6,6,-12,-5,4,-1,5,2,-1,2,2,-2,2,-1,0,-2,2,1,3,3,-1,4,0,103,60,43,46,26,20,19,25,31,26,4,-5,12,15,20,13,0,-1,7,10,11,13,4,-4,5,11,15,7,5,3,2,7,10,5,1,1,3,4,5,2,4,2
46,46127,"Font d'En Carròs, la",3180,7,9,-2,28,14,14,-1,8,-6,2,3,0,4,1,-1,0,4,0,-5,7,-5,2,-1,0,3,6,3,3,9,4,2,4,0,1,5,2,1,2,3,2,4,2,51,28,23,48,22,26,4,16,7,12,10,0,4,2,6,6,9,0,0,14,1,6,1,0,9,9,6,11,11,2,4,1,5,5,6,1,5,8,1,6,5,1,90,34,56,46,25,21,5,23,9,11,32,9,-3,11,0,5,16,5,8,12,9,6,16,4,3,11,1,3,25,2,3,6,1,1,13,1,0,5,0,2,12,1,128,62,66,104,51,53,22,17,22,22,39,5,9,9,13,6,22,2,13,8,9,16,17,3,13,7,17,26,33,7,7,2,10,9,18,4,6,5,7,17,15,3,150,83,67,72,42,30,11,19,33,35,39,10,8,10,23,18,15,6,3,9,10,17,24,4,5,10,14,18,19,5,2,6,10,11,9,3,3,4,4,7,10,2,167,99,68,58,38,20,47,32,37,33,18,-5,24,17,19,23,12,0,23,15,18,10,6,-5,10,10,10,5,17,5,8,8,7,2,9,4,2,2,3,3,8,1,183,101,82,86,46,40,29,16,56,39,27,10,10,4,40,26,13,6,19,12,16,13,14,4,10,9,24,21,16,5,5,4,14,11,8,4,5,5,10,10,8,1,216,121,95,94,51,43,0,67,77,41,19,12,-3,32,49,28,8,6,3,35,28,13,11,6,11,23,27,12,15,4,3,11,17,7,10,2,8,12,10,5,5,2,26,32,-6,18,5,13,4,12,29,-2,-8,-9,7,11,15,3,1,-6,-3,1,14,-5,-9,-3,9,6,3,4,1,-5,6,4,-5,4,0,-4,3,2,8,0,1,-1,17,1,16,55,33,22,-5,2,-8,24,2,2,-10,2,-4,12,1,0,5,0,-4,12,1,2,8,10,17,9,7,4,2,8,15,2,4,2,6,2,2,7,3,2,-6,11,-17,45,26,19,-10,7,-8,-1,11,-4,-4,8,-3,2,8,1,-6,-1,-5,-3,3,-5,5,8,7,11,11,3,1,6,2,8,6,3,4,2,5,3,5,0,-96,-60,-36,-4,-9,5,-15,0,-37,-31,-3,-7,-6,0,-21,-23,-5,-3,-9,0,-16,-8,2,-4,0,8,-8,-8,3,1,0,4,-7,-10,3,1,0,4,-1,2,0,0,-31,-18,-13,-6,-6,0,3,-1,-30,0,2,-4,4,-2,-16,-5,3,-3,-1,1,-14,5,-1,-1,-1,0,-10,1,2,1,0,0,-7,-2,1,1,-1,0,-3,3,1,0,2,-4,6,-2,-4,2,8,15,-5,-6,-3,-9,3,9,-2,-8,-3,-4,5,6,-3,2,0,-5,0,4,-4,-3,0,1,-2,2,-1,-3,0,0,2,2,-3,0,0,1,-98,-53,-45,-61,-39,-22,2,-8,-32,-22,-22,-16,5,-8,-23,-7,-11,-8,-3,0,-9,-15,-11,-8,2,-8,-17,-24,-7,-7,3,-8,-12,-13,-3,-6,-1,0,-5,-11,-4,-1,2,-2,4,29,7,22,-8,2,-1,-3,6,6,-6,3,1,-7,4,2,-2,-1,-2,4,2,4,0,1,3,3,12,9,-2,0,0,1,6,2,2,1,3,2,6,7,36,14,22,38,20,18,10,5,3,3,8,8,5,2,0,0,8,1,5,3,3,3,0,7,5,3,5,6,11,8,3,3,2,2,7,3,2,0,3,4,4,5,71,44,27,43,22,21,12,3,27,17,15,-3,7,-2,14,14,9,2,5,5,13,3,6,-5,6,4,9,6,15,3,5,-1,5,5,7,1,1,5,4,1,8,2
46,46129,Fuenterrobles,708,5,5,0,9,6,3,0,3,-1,-1,1,3,0,3,0,-2,1,3,0,0,-1,1,0,0,1,1,5,0,1,1,0,1,3,0,1,1,1,0,2,0,0,0,-1,-2,1,8,4,4,0,1,-4,1,4,-3,0,1,-3,1,1,-2,0,0,-1,0,3,-1,1,4,1,0,2,0,0,2,1,0,1,0,1,2,0,0,1,0,2,4,-2,6,3,3,1,6,-2,0,-4,1,1,7,0,-1,-2,-1,0,-1,-2,1,-2,2,0,4,2,0,0,0,0,2,1,0,0,0,0,2,1,0,0,0,30,13,17,19,13,6,4,8,12,4,0,2,1,4,7,0,0,1,3,4,5,4,0,1,2,8,7,2,0,0,1,5,6,1,0,0,1,3,1,1,0,0,11,5,6,9,6,3,-1,4,1,3,2,2,1,0,1,1,1,1,-2,4,0,2,1,1,1,2,5,1,0,0,1,1,4,0,0,0,0,1,1,1,0,0,-5,-3,-2,2,-2,4,-2,5,-10,0,2,0,1,2,-6,-1,1,0,-3,3,-4,1,1,0,0,3,-1,-1,1,0,0,0,-1,-1,0,0,0,3,0,0,1,0,-7,-5,-2,7,3,4,2,-4,-5,3,-1,-2,-1,-2,-1,2,-1,-2,3,-2,-4,1,0,0,2,1,3,1,0,0,0,1,1,1,0,0,2,0,2,0,0,0,18,10,8,16,11,5,4,4,9,3,-2,0,1,3,6,1,-1,0,3,1,3,2,-1,0,3,5,7,1,0,0,2,3,6,0,0,0,1,2,1,1,0,0,7,3,4,8,4,4,6,2,6,-6,3,-4,3,4,0,-4,2,-2,3,-2,6,-2,1,-2,3,2,3,0,0,0,2,2,0,0,0,0,1,0,3,0,0,0,1,5,-4,7,3,4,2,5,-7,7,-4,-3,4,3,-3,4,-1,-3,-2,2,-4,3,-3,0,4,0,2,1,0,0,2,0,0,1,0,0,2,0,2,0,0,0,15,15,0,20,14,6,3,9,-1,5,3,-3,4,7,3,3,2,-3,-1,2,-4,2,1,0,1,8,8,3,0,0,1,5,7,1,0,0,0,3,1,2,0,0,-25,-17,-8,-19,-13,-6,0,-3,-14,-3,1,-4,-1,-3,-7,-3,0,-1,1,0,-7,0,1,-3,0,-2,-12,-5,0,0,-1,-3,-6,-3,0,0,1,1,-6,-2,0,0,-9,-8,-1,-6,-5,-1,3,-7,-7,5,2,-5,3,-7,-5,2,1,-2,0,0,-2,3,1,-3,1,-5,-3,0,1,0,1,-4,-2,0,0,0,0,-1,-1,0,1,0,0,0,0,4,2,2,2,5,5,-8,0,-2,-1,5,2,-5,1,0,3,0,3,-3,-1,-2,0,3,1,0,0,0,0,2,0,0,0,0,0,1,1,0,0,0,2,4,-2,1,1,0,3,-2,-2,1,3,-1,2,0,-2,3,2,-1,1,-2,0,-2,1,0,1,0,1,-1,1,-1,1,1,-1,0,1,-1,0,-1,2,-1,0,0,-9,0,-9,-9,-3,-6,-3,3,-5,-7,0,2,1,2,-2,-4,2,1,-4,1,-3,-3,-2,1,-2,0,-2,-4,-2,1,0,0,-1,-2,0,0,-2,0,-1,-2,-2,1,22,16,6,5,3,2,6,1,2,12,2,0,4,0,3,10,0,0,2,1,-1,2,2,0,1,0,1,2,0,1,0,0,1,1,0,1,1,0,0,1,0,0,-18,-15,-3,3,0,3,-2,-4,-2,-6,-2,-2,-4,-4,1,-3,-3,-2,2,0,-3,-3,1,0,3,1,0,-1,0,0,0,0,0,0,0,0,3,1,0,-1,0,0
46,46131,Gandia,58676,1008,612,396,909,529,380,109,206,345,175,110,64,52,110,257,105,61,24,57,96,88,70,49,40,113,182,324,183,80,23,54,88,213,118,40,14,59,94,111,65,40,9,1943,1029,914,1619,908,711,357,452,568,341,147,58,179,231,331,182,77,25,178,221,237,159,70,33,298,388,505,281,101,35,158,207,305,160,58,14,140,181,200,121,43,21,1093,675,418,1436,800,636,181,309,375,165,73,-16,94,164,268,113,39,-13,87,145,107,52,34,-3,270,353,412,278,98,20,133,181,253,168,52,9,137,172,159,110,46,11,-607,-241,-366,819,447,372,-140,35,-191,-136,-68,-78,-102,60,-19,-75,-41,-43,-38,-25,-172,-61,-27,-35,121,224,240,157,56,14,47,117,159,88,25,8,74,107,81,69,31,6,1708,1080,628,1731,1024,707,210,527,517,264,127,47,118,336,363,153,62,45,92,191,154,111,65,2,238,519,526,287,103,39,124,323,337,169,42,21,114,196,189,118,61,18,2054,1237,817,1723,989,734,336,519,675,369,91,49,172,310,452,248,51,7,164,209,223,121,40,42,347,457,483,286,102,25,187,270,297,160,51,13,160,187,186,126,51,12,3342,1908,1434,3453,1880,1573,485,953,1048,566,210,71,295,483,674,322,103,22,190,470,374,244,107,49,511,944,1104,594,215,58,262,483,671,333,91,23,249,461,433,261,124,35,2529,1427,1102,2840,1623,1217,355,818,620,368,237,123,167,493,387,198,130,50,188,325,233,170,107,73,387,916,811,449,202,52,195,536,501,254,104,20,192,380,310,195,98,32,253,-11,264,660,285,375,171,131,-127,2,-35,102,85,60,-177,4,-43,45,86,71,50,-2,8,57,164,252,152,57,1,18,85,131,42,27,-13,5,79,121,110,30,14,13,-735,-483,-252,-265,-263,-2,-5,82,-349,-284,-100,-72,10,13,-178,-247,-61,-25,-15,69,-171,-37,-39,-47,31,152,-168,-138,-110,-39,33,57,-142,-126,-67,-24,-2,95,-26,-12,-43,-15,-1092,-671,-421,-686,-441,-245,-93,-76,-550,-278,-77,-20,-38,-47,-328,-228,-48,10,-55,-29,-222,-50,-29,-30,-45,44,-403,-212,-54,-23,-22,30,-250,-165,-33,-5,-23,14,-153,-47,-21,-18,258,180,78,554,341,213,109,89,-16,6,51,25,48,65,-4,27,25,20,61,24,-12,-21,26,5,29,225,164,86,39,1,21,145,95,63,19,-7,8,80,69,23,20,8,-705,-396,-309,-496,-304,-192,-24,-40,-303,-217,-15,-114,-15,-21,-179,-131,-28,-35,-9,-19,-124,-86,13,-79,-89,11,-163,-217,-18,-31,-44,-3,-96,-135,-19,-12,-45,14,-67,-82,1,-19,-992,-602,-390,-1057,-680,-377,-82,-72,-373,-319,-121,-45,-8,-33,-235,-230,-88,-22,-74,-39,-138,-89,-33,-23,-87,-56,-373,-351,-153,-56,-29,-35,-248,-255,-101,-25,-58,-21,-125,-96,-52,-31,-2142,-1263,-879,-1995,-1247,-748,-114,-85,-827,-642,-310,-160,-56,-34,-514,-428,-185,-50,-58,-51,-313,-214,-125,-110,-135,-31,-778,-653,-302,-101,-72,-6,-492,-467,-177,-35,-63,-25,-286,-186,-125,-66,-661,-408,-253,-371,-296,-75,2,-72,-368,-176,-51,-1,-7,-22,-210,-147,-38,1,9,-50,-158,-29,-13,-2,20,25,-221,-170,-44,12,5,20,-169,-136,-33,9,15,5,-52,-34,-11,3,-127,-177,50,41,-82,123,81,24,-132,-142,-3,34,54,-7,-104,-109,-20,5,27,31,-28,-33,17,29,60,111,-72,-85,-14,26,50,34,-80,-75,-17,2,10,77,8,-10,3,24,-282,-208,-74,-105,-126,21,82,45,-173,-186,11,-72,60,27,-107,-150,-29,-14,22,18,-66,-36,40,-58,65,101,-101,-139,-40,-10,51,56,-66,-125,-52,0,14,45,-35,-14,12,-10
46,46132,Genovés,2351,16,12,4,12,10,2,-6,6,15,-5,6,1,-2,2,10,-2,4,1,-4,4,5,-3,2,0,0,2,7,2,0,1,0,1,6,2,0,1,0,1,1,0,0,0,25,17,8,8,5,3,7,6,6,5,2,-1,3,5,4,4,1,0,4,1,2,1,1,-1,0,2,6,0,0,0,0,2,3,0,0,0,0,0,3,0,0,0,42,17,25,10,6,4,18,8,-2,14,1,1,7,-1,0,8,1,1,11,9,-2,6,0,0,2,2,2,4,0,0,1,1,2,2,0,0,1,1,0,2,0,0,40,23,17,27,18,9,1,11,9,4,11,4,2,8,7,0,5,2,-1,3,2,4,6,2,2,4,11,6,3,0,2,1,9,3,2,0,0,3,2,3,1,0,51,42,9,15,8,7,13,2,24,3,5,2,10,7,19,4,0,1,3,-5,5,-1,5,1,10,0,-1,2,2,2,8,0,-1,0,0,1,2,0,0,2,2,1,66,35,31,31,16,15,16,13,25,7,1,2,10,5,14,3,1,1,6,8,11,4,0,1,12,4,10,1,2,2,8,3,4,-1,1,1,4,1,6,2,1,1,31,5,26,17,7,10,6,6,3,5,5,2,0,1,-2,1,2,1,6,5,5,4,3,1,2,3,6,2,3,1,1,1,2,1,1,1,1,2,4,1,2,0,64,37,27,24,17,7,12,12,13,10,9,2,10,8,5,6,4,2,2,4,8,4,5,0,3,6,6,5,4,0,3,6,3,3,2,0,0,0,3,2,2,0,-21,-7,-14,9,3,6,-11,-5,-4,-5,6,-4,-4,-5,-4,-1,5,0,-7,0,0,-4,1,-4,1,3,3,2,0,0,1,1,0,1,0,0,0,2,3,1,0,0,-33,-18,-15,6,4,2,-5,-9,-12,0,-5,-2,-3,-2,-10,-1,-1,-1,-2,-7,-2,1,-4,-1,1,2,0,3,1,-1,1,0,1,1,1,0,0,2,-1,2,0,-1,-4,-2,-2,5,4,1,-3,4,-6,2,1,-2,-1,2,-5,4,-1,-1,-2,2,-1,-2,2,-1,0,2,0,0,3,0,1,1,0,1,1,0,-1,1,0,-1,2,0,24,14,10,13,6,7,-2,14,6,-4,10,0,-3,9,3,-3,8,0,1,5,3,-1,2,0,4,2,2,3,2,0,2,1,2,-1,2,0,2,1,0,4,0,0,-27,-12,-15,-5,-5,0,-9,-13,-1,2,1,-2,-7,-4,2,1,0,-1,-2,-9,-3,1,1,-1,-1,-1,1,0,-3,-1,-2,-1,0,0,-1,-1,1,0,1,0,-2,0,-12,-4,-8,-6,-5,-1,-4,-5,-11,1,4,1,-3,-3,-4,3,2,-1,-1,-2,-7,-2,2,2,-1,-2,-1,-4,2,0,-1,-2,-1,-2,1,0,0,0,0,-2,1,0,-4,-7,3,-1,0,-1,4,-4,-3,-1,2,0,1,-1,-4,-3,1,0,3,-3,1,2,1,0,2,2,-2,-2,-2,1,1,3,-2,-1,-1,0,1,-1,0,-1,-1,1,-26,-13,-13,-29,-14,-15,4,-4,-7,-3,-13,-2,2,-3,0,-1,-8,-2,2,-1,-7,-2,-5,0,-1,-4,-5,-8,-7,-4,0,-1,-2,-4,-5,-2,-1,-3,-3,-4,-2,-2,-3,-6,3,-3,-2,-1,2,-2,-4,-2,6,-3,2,-1,-2,-4,-1,0,0,-1,-2,2,7,-3,-1,1,-2,-2,2,-1,0,0,0,-2,0,0,-1,1,-2,0,2,-1,7,1,6,11,7,4,-3,0,2,2,-3,6,-1,0,-3,3,-3,3,-2,0,5,-1,0,3,2,2,2,4,1,-1,2,1,1,3,0,-1,0,1,1,1,1,0
46,46135,Godella,11058,27,12,15,7,2,5,54,-28,-11,25,-13,-8,25,-8,-9,15,-9,-4,29,-20,-2,10,-4,-4,1,3,1,2,0,0,0,0,1,1,0,0,1,3,0,1,0,0,237,124,113,96,50,46,104,10,18,88,10,4,64,1,-5,51,11,1,40,9,23,37,-1,3,22,21,25,19,6,3,10,10,17,9,3,1,12,11,8,10,3,2,89,69,20,83,48,35,94,-21,-6,14,-16,7,57,1,2,13,-12,1,37,-22,-8,1,-4,6,21,20,17,15,4,5,13,11,13,5,4,2,8,9,4,10,0,3,265,83,182,89,42,47,148,7,48,42,-12,22,61,1,-7,13,-7,13,87,6,55,29,-5,9,23,15,20,18,5,8,14,4,10,9,0,5,9,11,10,9,5,3,189,77,112,105,46,59,95,-3,73,20,-11,9,44,-2,23,8,-8,8,51,-1,50,12,-3,1,18,21,42,17,5,2,5,10,21,7,1,2,13,11,21,10,4,0,163,64,99,107,50,57,71,1,31,7,-4,48,38,-3,-1,5,-2,22,33,4,32,2,-2,26,16,29,32,23,6,0,9,12,13,13,3,0,7,17,19,10,3,0,252,94,158,137,61,76,107,13,42,42,-2,39,55,4,19,16,-9,4,52,9,23,26,7,35,30,30,40,30,5,2,17,7,21,11,3,2,13,23,19,19,2,0,-104,-78,-26,93,44,49,-10,-14,-47,-22,-16,0,-9,-4,-39,-17,-7,-3,-1,-10,-8,-5,-9,3,13,27,27,20,6,-1,7,15,14,8,1,-2,6,12,13,12,5,1,139,24,115,91,42,49,37,-11,70,36,-22,7,6,-2,4,17,-9,1,31,-9,66,19,-13,6,14,20,32,19,5,-2,6,4,21,7,2,-1,8,16,11,12,3,-1,-8,-18,10,5,-1,6,29,0,-41,29,-25,-14,31,-5,-45,14,-13,-6,-2,5,4,15,-12,-8,5,2,5,0,-5,-2,1,0,3,-3,-2,0,4,2,2,3,-3,-2,-79,-29,-50,-75,-44,-31,37,1,-58,-48,-2,-14,17,14,-42,-10,-6,-7,20,-13,-16,-38,4,-7,-5,1,-29,-33,-8,-4,-3,3,-24,-15,-6,-1,-2,-2,-5,-18,-2,-3,18,-5,23,18,5,13,-9,-12,10,3,20,5,-5,-14,0,6,11,-2,-4,2,10,-3,9,7,9,5,0,0,4,1,3,0,2,0,1,-1,6,5,-2,0,3,2,12,13,-1,-6,0,-6,25,-20,13,-16,-11,19,19,1,-1,-1,-11,6,6,-21,14,-15,0,13,9,1,-12,-4,0,0,5,4,-6,-5,2,0,4,-3,-6,1,-2,0,-61,-54,-7,-33,-21,-12,-8,-2,-17,-52,-21,37,-7,-8,-12,-31,-11,13,-1,6,-5,-21,-10,24,1,2,-7,-24,-8,2,1,-2,-3,-15,-4,2,0,4,-4,-9,-4,0,-32,-3,-29,-52,-17,-35,-1,-5,-40,-2,-24,40,8,-4,-22,6,-4,12,-9,-1,-18,-8,-20,28,-19,-4,-9,-12,-9,0,-3,-3,-3,-5,-4,0,-16,-1,-6,-7,-5,0,36,40,-4,29,12,17,46,-17,-25,20,-10,25,36,-2,-19,19,-4,9,10,-15,-6,1,-6,16,15,2,5,2,1,2,10,1,-3,2,0,2,5,1,8,0,1,0,89,28,61,64,28,36,55,-3,-10,41,-16,20,27,-4,-17,17,0,3,28,1,7,24,-16,17,13,24,7,5,9,6,9,8,2,3,5,1,4,16,5,2,4,5,118,64,54,121,51,70,55,-13,-7,43,1,36,30,-7,-6,26,3,13,25,-6,-1,17,-2,23,33,12,23,31,14,5,22,3,7,12,4,1,11,9,16,19,10,4
46,46136,Godelleta,2174,8,10,-2,15,11,4,-4,-3,6,1,8,1,4,-3,0,3,6,0,-8,0,6,-2,2,1,0,1,8,4,1,1,0,1,6,3,0,1,0,0,2,1,1,0,94,44,50,46,24,22,17,12,27,29,9,0,8,5,11,16,3,0,9,7,16,13,6,0,10,8,15,11,1,0,6,3,7,6,1,0,4,5,8,5,0,0,85,61,24,33,24,9,24,16,33,12,2,-1,14,16,26,4,3,-1,10,0,7,8,-1,0,4,8,14,4,3,0,3,5,13,2,1,0,1,3,1,2,2,0,69,42,27,13,8,5,14,4,29,16,7,-5,8,5,16,8,6,-2,6,-1,13,8,1,-3,4,3,4,1,0,0,3,2,2,1,0,0,1,1,2,0,0,0,111,65,46,40,23,17,21,6,47,18,15,2,13,3,23,14,8,2,8,3,24,4,7,0,9,6,7,4,9,5,6,4,3,1,5,4,3,2,4,3,4,1,122,65,57,21,12,9,14,4,37,40,20,4,1,5,19,25,13,1,13,-1,18,15,7,3,6,-2,3,9,4,1,3,-1,2,6,2,0,3,-1,1,3,2,1,121,66,55,20,9,11,23,12,40,38,13,-6,13,7,22,22,6,-3,10,5,18,16,7,-3,6,4,0,7,2,0,2,3,-1,3,2,0,4,1,1,4,0,0,169,99,70,18,13,5,29,20,60,42,8,2,12,6,38,27,9,2,17,14,22,15,-1,0,-1,10,2,3,2,1,0,5,2,4,1,0,-1,5,0,-1,1,1,37,26,11,-11,-7,-4,13,14,6,11,1,-4,11,6,7,8,-1,-3,2,8,-1,3,2,-1,-2,2,-6,5,-7,-3,-2,1,-4,4,-5,-1,0,1,-2,1,-2,-2,30,23,7,7,-4,11,-6,3,27,1,1,8,-1,10,15,0,-3,4,-5,-7,12,1,4,4,1,2,3,2,-3,2,0,0,-1,-1,-1,-1,1,2,4,3,-2,3,-31,4,-35,-13,-11,-2,-14,0,-18,-1,-2,2,5,2,-9,6,-1,-1,-19,-2,-9,-7,-1,3,-2,1,-7,-8,2,0,-1,-1,-5,-5,0,0,-1,2,-2,-3,2,0,4,-1,5,-14,-10,-4,-2,-19,16,2,3,0,0,-12,13,-2,-1,0,-2,-7,3,4,4,0,0,-2,-6,-3,-1,-3,0,-3,-4,-2,0,-2,0,1,-2,-1,-1,-1,64,44,20,-6,-5,-1,4,13,22,9,9,4,1,8,14,3,10,5,3,5,8,6,-1,-1,0,1,-4,-6,1,2,0,0,-3,-5,1,2,0,1,-1,-1,0,0,-46,-34,-12,-26,-14,-12,7,-9,-8,-23,-7,-7,-2,-2,-6,-11,-7,-6,9,-7,-2,-12,0,-1,-2,-2,-4,-7,-8,-3,-1,-1,-2,-3,-5,-2,-1,-1,-2,-4,-3,-1,-25,-10,-15,7,3,4,-29,1,12,-12,-9,7,-11,4,9,-8,-7,3,-18,-3,3,-4,-2,4,1,4,5,-4,0,-1,0,4,2,-3,0,0,1,0,3,-1,0,-1,15,-3,18,12,4,8,10,1,-7,-3,5,10,0,-5,-6,4,0,4,10,6,-1,-7,5,6,4,3,2,-1,1,3,2,0,2,-1,0,1,2,3,0,0,1,2,5,4,1,9,1,8,-9,-10,13,5,5,-1,-3,-11,10,2,3,1,-6,1,3,3,2,-2,0,1,4,1,-1,4,0,-1,1,0,-1,2,0,2,3,1,0,2,89,40,49,15,6,9,31,-1,2,17,20,17,17,1,1,3,14,4,14,-2,1,14,6,13,0,0,0,4,6,3,0,-1,2,1,3,1,0,1,-2,3,3,2
46,46139,Guadassuar,5331,15,12,3,26,17,9,4,3,5,-3,9,0,4,-2,4,1,6,1,0,5,1,-4,3,-1,5,5,11,1,3,1,2,2,9,0,3,1,3,3,2,1,0,0,89,62,27,60,39,21,15,16,36,18,3,1,12,10,25,13,3,-1,3,6,11,5,0,2,8,14,23,11,4,0,6,9,15,7,2,0,2,5,8,4,2,0,61,25,36,45,23,22,28,18,-3,14,1,2,11,12,-8,8,-1,3,17,6,5,6,2,-1,12,9,13,8,3,0,5,6,5,6,1,0,7,3,8,2,2,0,62,30,32,38,19,19,24,10,-1,17,9,2,7,5,-3,12,7,1,17,5,2,5,2,1,14,8,5,7,2,2,4,5,3,5,1,1,10,3,2,2,1,1,133,78,55,59,36,23,16,33,38,24,13,8,3,23,24,16,6,6,13,10,14,8,7,2,4,16,20,6,8,4,2,13,11,4,3,2,2,3,9,2,5,2,136,84,52,117,79,38,19,34,48,24,10,-1,10,22,33,13,4,-1,9,12,15,11,6,0,17,36,40,20,4,0,9,25,32,10,3,0,8,11,8,10,1,0,136,58,78,57,21,36,36,21,12,18,11,35,14,8,3,8,8,15,22,13,9,10,3,20,19,12,9,12,2,2,8,3,-1,8,0,2,11,9,10,4,2,0,226,115,111,148,88,60,27,72,55,33,10,26,15,39,38,15,1,5,12,33,17,18,9,21,14,53,49,23,8,1,7,30,35,12,3,1,7,23,14,11,5,0,37,4,33,11,-7,18,20,12,-8,4,1,6,8,5,-12,4,-1,-1,12,7,4,0,2,7,15,0,-6,-3,4,0,5,1,-9,-7,3,-1,10,-1,3,4,1,1,-57,-37,-20,-105,-66,-39,-1,-26,-28,-5,-6,8,2,-12,-24,-3,-2,2,-3,-14,-4,-2,-4,6,-15,-23,-38,-25,-8,3,-7,-15,-25,-16,-5,2,-8,-8,-13,-9,-3,1,53,40,13,18,10,8,23,-3,19,3,-6,13,13,7,7,8,-3,7,10,-10,12,-5,-3,6,7,1,10,1,-2,-1,5,0,3,0,0,1,2,1,7,1,-2,-2,33,2,31,9,-6,15,13,6,-5,3,-6,18,8,5,-10,0,-4,2,5,1,5,3,-2,16,3,11,-2,0,-2,-2,0,6,-6,-3,-2,-1,3,5,4,3,0,-1,-49,-51,2,-45,-29,-16,-14,-11,-14,-15,-12,20,-17,-6,-6,-17,-5,1,3,-5,-8,2,-7,19,-11,-1,-13,-14,-4,-1,-7,0,-8,-12,-1,-1,-4,-1,-5,-2,-3,0,-48,-30,-18,-28,-18,-10,-16,-9,-32,-6,-6,19,-8,-4,-14,-7,-8,10,-8,-5,-18,1,2,9,-6,-5,-10,2,-8,-1,-2,-4,-6,0,-6,0,-4,-1,-4,2,-2,-1,8,-6,14,-12,-8,-4,6,1,-16,-1,1,14,4,2,-11,-2,-3,5,2,-1,-5,1,4,9,-1,-4,-4,-6,3,-1,0,-1,-3,-4,1,-1,-1,-3,-1,-2,2,0,-26,-8,-18,16,14,2,-8,-3,-23,-8,8,6,-5,2,-10,-5,6,4,-3,-5,-13,-3,2,2,5,4,2,3,1,1,5,3,2,1,2,1,0,1,0,2,-1,0,36,31,5,26,21,5,5,3,1,6,10,10,5,5,4,6,7,3,0,-2,-3,0,3,7,2,11,6,3,0,1,2,10,4,3,-1,1,0,1,2,0,1,0,24,5,19,-8,-11,3,2,4,-2,0,-2,20,-3,4,-5,-3,2,10,5,0,3,3,-4,10,-2,3,-6,-1,-2,0,-2,1,-4,-3,-2,-1,0,2,-2,2,0,1
46,46147,Llíria,16300,376,226,150,163,105,58,70,72,97,89,55,-9,34,51,57,45,40,-3,36,21,40,44,15,-6,32,44,52,25,8,1,19,34,33,14,3,1,13,10,19,11,5,0,693,395,298,322,210,112,108,154,194,129,78,23,68,103,108,57,46,9,40,51,86,72,32,14,56,86,90,71,17,2,34,66,62,39,9,0,22,20,28,32,8,2,599,323,276,293,158,135,90,133,173,94,77,24,46,77,99,46,35,12,44,56,74,48,42,12,45,76,91,49,24,5,25,42,54,23,9,3,20,34,37,26,15,2,808,419,389,372,176,196,119,144,240,155,100,45,70,72,121,80,53,25,49,72,119,75,47,20,82,83,85,59,52,8,36,39,43,25,29,3,46,44,42,34,23,5,863,476,387,431,218,213,161,146,245,159,119,26,89,79,142,89,57,15,72,67,103,70,62,11,76,92,95,77,69,17,33,56,45,41,32,8,43,36,50,36,37,9,771,416,355,375,201,174,175,112,253,134,69,13,93,71,136,86,29,-2,82,41,117,48,40,15,98,78,93,59,39,2,51,43,56,34,17,0,47,35,37,25,22,2,779,403,376,345,177,168,152,118,270,121,69,38,90,56,128,64,41,19,62,62,142,57,28,19,80,79,87,52,34,11,49,35,35,29,21,7,31,44,52,23,13,4,770,433,337,333,178,155,158,114,219,162,73,38,85,67,125,91,46,17,73,47,94,71,27,21,62,87,82,57,37,4,26,47,43,35,22,3,36,40,39,22,15,1,225,136,89,212,119,93,0,49,114,18,35,17,-6,27,86,19,11,3,6,22,28,-1,24,14,42,60,53,29,19,5,27,35,30,12,10,3,15,25,23,17,9,2,316,161,155,80,43,37,49,18,105,43,58,42,6,17,66,21,31,16,43,1,39,22,27,26,7,15,23,16,16,0,1,11,12,11,7,-1,6,4,11,5,9,1,323,137,186,95,35,60,52,78,53,55,31,56,26,25,22,28,12,26,26,53,31,27,19,30,19,23,20,11,16,5,12,6,9,0,6,2,7,17,11,11,10,3,7,35,-28,4,4,0,-11,61,-16,-4,-33,12,2,33,9,-4,-4,2,-13,28,-25,0,-29,10,-8,51,-10,-13,-15,-4,0,29,-7,-11,-9,0,-8,22,-3,-2,-6,-4,75,46,29,86,56,30,-3,-5,15,-8,25,47,0,10,12,-10,8,25,-3,-15,3,2,17,22,12,26,30,6,8,4,8,19,18,7,1,3,4,7,12,-1,7,1,107,46,61,58,21,37,25,-1,32,-8,18,37,1,16,14,-11,1,20,24,-17,18,3,17,17,3,17,7,11,13,5,-1,9,2,0,9,0,4,8,5,11,4,5,65,17,48,134,74,60,11,-5,-17,1,20,64,15,-10,-14,6,8,21,-4,5,-3,-5,12,43,26,37,20,22,20,7,18,19,13,10,11,2,8,18,7,12,9,5,155,87,68,109,59,50,43,23,2,13,29,46,27,18,3,-1,26,17,16,5,-1,14,3,29,4,41,22,15,12,11,2,24,8,12,2,8,2,17,14,3,10,3,94,78,16,134,71,63,10,24,-15,4,30,42,22,14,-13,17,22,17,-12,10,-2,-13,8,25,16,30,21,24,26,12,4,20,10,14,13,7,12,10,11,10,13,5,323,159,164,207,123,84,67,25,37,75,62,57,39,6,12,51,37,13,28,19,25,24,25,44,32,34,43,36,51,9,18,20,27,25,25,6,14,14,16,11,26,3
46,46157,"Llosa de Ranes, la",3620,53,35,18,39,27,12,6,10,14,17,7,0,0,9,12,10,3,1,6,1,2,7,4,-1,1,12,14,10,2,0,1,9,12,4,1,0,0,3,2,6,1,0,50,31,19,38,25,13,6,24,11,6,1,3,5,8,13,5,0,1,1,16,-2,1,1,2,0,13,13,11,1,0,0,6,10,8,1,0,0,7,3,3,0,0,68,35,33,69,39,30,13,26,14,17,2,-5,4,16,9,7,0,-2,9,10,5,10,2,-3,5,26,20,17,1,0,2,17,10,10,0,0,3,9,10,7,1,0,14,7,7,36,20,16,4,11,-8,5,1,0,3,5,-3,5,-2,-1,1,6,-5,0,3,1,6,12,6,8,3,0,4,6,4,6,0,0,2,6,2,2,3,0,28,21,7,27,16,11,5,14,4,11,-2,-2,3,5,6,10,0,-2,2,9,-2,1,-2,0,3,12,8,3,0,1,2,6,6,2,0,0,1,6,2,1,0,1,-1,2,-3,28,15,13,1,0,-4,-5,2,2,3,3,-5,-1,1,0,-2,-3,1,-4,1,2,6,7,8,5,1,0,3,4,4,4,0,0,3,3,4,1,1,0,60,33,27,44,16,28,23,6,12,8,11,0,8,5,4,10,4,1,15,1,8,-2,7,-1,10,8,16,3,6,1,3,3,6,2,1,1,7,5,10,1,5,0,30,22,8,63,37,26,-8,18,5,10,3,0,3,5,5,6,2,0,-11,13,0,4,1,0,9,22,15,15,2,0,6,7,13,11,0,0,3,15,2,4,2,0,55,16,39,30,18,12,10,20,6,17,2,0,-4,14,-1,11,-3,0,14,6,7,6,5,0,4,11,6,8,-1,2,0,9,4,5,-1,1,4,2,2,3,0,1,35,10,25,5,-1,6,15,2,9,12,-2,-2,5,0,1,5,1,-2,10,2,8,7,-3,0,1,-3,6,3,-1,-1,0,-1,-1,1,1,-1,1,-2,7,2,-2,0,-38,-22,-16,7,3,4,-5,-3,-13,-5,-6,-5,-3,0,-10,-2,-4,-2,-2,-3,-3,-3,-2,-3,2,4,-1,3,0,-1,1,3,-1,2,-1,-1,1,1,0,1,1,0,26,9,17,30,18,12,18,3,-9,11,0,2,6,0,-3,7,1,-1,12,3,-6,4,-1,3,5,8,8,8,1,0,3,3,5,6,1,0,2,5,3,2,0,0,-63,-25,-38,-7,-1,-6,-13,-12,-19,-11,1,-7,-5,-5,-10,-4,2,-3,-8,-7,-9,-7,-1,-4,1,1,-4,-2,0,-3,0,1,0,-1,0,-1,1,0,-4,-1,0,-2,-58,-30,-28,1,2,-1,-2,-12,-20,-12,-6,-5,-5,-3,-11,-4,-4,-2,3,-9,-9,-8,-2,-3,0,0,0,0,0,0,0,0,0,1,0,0,0,0,0,-1,0,0,-13,-3,-10,1,1,0,-12,3,-4,2,6,-7,-7,5,0,-2,4,-3,-5,-2,-4,4,2,-4,-3,4,0,2,0,-2,-1,2,0,0,1,-1,-2,2,0,2,-1,-1,-262,-156,-106,-242,-149,-93,-17,-23,-65,-117,-31,-8,-6,-13,-34,-73,-27,-2,-11,-10,-31,-44,-4,-6,-12,-22,-66,-103,-34,-5,-6,-12,-37,-65,-28,-1,-6,-10,-29,-38,-6,-4,-13,-13,0,1,2,-1,3,1,-6,-11,1,-3,2,0,-5,-10,1,-1,1,1,-1,-1,0,-2,1,0,-2,2,-1,1,1,0,-1,2,-1,1,0,0,-1,0,0,0,3,-4,7,14,4,10,-1,5,-3,1,-2,4,-2,4,0,-2,-2,-1,1,1,-3,3,0,5,5,2,0,3,1,1,2,0,0,2,-1,1,3,2,0,1,2,0
46,46150,Llutxent,2394,14,4,10,11,4,7,2,-2,3,2,6,3,-1,-1,4,-3,3,2,3,-1,-1,5,3,1,3,1,2,3,2,0,2,0,1,0,1,0,1,1,1,3,1,0,23,24,-1,47,28,19,0,12,0,6,4,2,2,11,1,4,4,2,-2,1,-1,2,0,0,8,13,11,10,4,1,5,8,5,6,3,1,3,5,6,4,1,0,45,31,14,43,26,17,15,13,15,6,-1,-3,11,4,12,5,1,-1,4,9,3,1,-2,-2,13,11,14,5,0,0,6,6,10,4,0,0,7,5,4,1,0,0,26,19,7,26,21,5,-1,4,10,7,8,-4,2,6,5,2,6,-3,-3,-2,5,5,2,-1,1,6,9,3,5,1,1,5,7,3,4,0,0,1,2,0,1,1,24,17,7,42,29,13,-1,17,4,2,1,0,-1,11,0,5,3,-1,0,6,4,-3,-2,1,4,17,15,5,1,0,2,13,8,5,1,0,2,4,7,0,0,0,42,30,12,38,25,13,8,7,9,12,1,2,3,1,14,7,1,1,5,6,-5,5,0,1,2,14,11,9,2,0,1,7,7,8,2,0,1,7,4,1,0,0,8,4,4,33,20,13,2,9,-9,8,0,-1,2,4,-5,4,-1,0,0,5,-4,4,1,-1,6,14,2,10,1,0,3,10,0,7,0,0,3,4,2,3,1,0,23,20,3,35,21,14,-1,9,18,-5,0,0,-2,8,16,-2,0,0,1,1,2,-3,0,0,2,14,9,6,4,0,0,8,7,4,2,0,2,6,2,2,2,0,-15,-18,3,1,-7,8,-1,-5,-18,3,4,0,-3,-1,-15,0,0,0,2,-4,-3,3,4,0,-1,5,-1,0,-3,0,-1,2,-4,-2,-3,0,0,3,3,2,0,0,-1,10,-11,-18,-10,-8,3,-4,-4,-4,1,3,6,2,-2,-2,2,2,-3,-6,-2,-2,-1,1,-4,-1,-12,-2,-1,2,-1,-1,-6,-3,0,1,-3,0,-6,1,-1,1,-33,-26,-7,-34,-29,-5,4,-5,-19,-8,-3,-3,1,-4,-13,-6,-6,1,3,-1,-6,-2,3,-4,-1,-7,-12,-10,-3,-1,-1,-7,-10,-8,-3,0,0,0,-2,-2,0,-1,-31,-18,-13,-16,-9,-7,-1,-8,-13,-6,-6,0,-1,-5,-9,-3,-4,1,0,-3,-4,-3,-2,-1,0,-2,-8,-3,-4,0,-1,1,-5,-2,-3,0,1,-3,-3,-1,-1,0,-12,-2,-10,-12,-4,-8,0,2,-5,-2,0,-7,2,1,-4,1,0,-2,-2,1,-1,-3,0,-5,0,1,-7,-1,-2,-3,1,2,-5,0,-1,-1,-1,-1,-2,-1,-1,-2,-41,-16,-25,-6,-2,-4,-14,-5,-10,-5,-3,-4,-4,-5,-4,0,-1,-2,-10,0,-6,-5,-2,-2,0,0,-5,-2,1,-1,1,0,-3,-1,1,-1,-1,0,-2,-1,0,0,-28,-17,-11,-10,-6,-4,-7,-2,-13,-6,-2,2,-6,-2,-5,-2,-2,0,-1,0,-8,-4,0,2,-2,-1,0,-4,-3,0,-1,-2,2,-3,-2,0,-1,1,-2,-1,-1,0,-29,-18,-11,-3,-5,2,-15,1,-9,-6,0,0,-9,1,-6,-4,1,0,-6,0,-3,-2,-1,0,-2,3,-4,-2,0,2,-4,2,-2,-1,0,0,2,1,-2,-1,0,2,-19,-7,-12,2,1,1,-2,-5,-8,3,-4,-4,0,0,-3,2,-5,-2,-2,-5,-5,1,1,-2,-1,0,4,0,0,-1,0,1,2,0,-1,-1,-1,-1,2,0,1,0,10,6,4,19,6,13,0,-2,4,9,0,-3,-1,-2,6,1,2,-1,1,0,-2,8,-2,-2,5,2,3,6,1,2,2,-1,1,2,1,1,3,3,2,4,0,1
46,46160,Manuel,2460,16,11,5,14,9,5,-3,10,8,3,-1,-2,1,5,6,1,-1,-1,-4,5,2,2,0,-1,0,6,8,0,0,0,0,3,6,0,0,0,0,3,2,0,0,0,-8,-9,1,10,6,4,1,-4,-2,-1,-4,2,0,-2,-5,0,-3,2,1,-2,3,-1,-1,0,2,3,1,3,1,0,1,2,1,2,0,0,1,1,0,1,1,0,-10,4,-14,16,11,5,-9,6,-9,-1,3,0,-3,10,-4,1,2,-1,-6,-4,-5,-2,1,1,3,6,4,3,1,-1,2,5,2,2,1,-1,1,1,2,1,0,0,16,2,14,14,7,7,11,8,-6,5,3,-3,0,2,-2,1,4,-2,11,6,-4,4,-1,-1,3,4,4,3,0,0,0,2,2,3,0,0,3,2,2,0,0,0,32,14,18,33,17,16,11,13,7,3,1,-4,2,8,4,1,0,-2,9,5,3,2,1,-2,8,8,12,3,1,0,2,5,5,3,1,0,6,3,7,0,0,0,42,14,28,31,18,13,12,11,1,6,6,4,8,3,-8,4,3,3,4,8,9,2,3,1,12,10,4,2,2,0,9,2,2,2,2,0,3,8,2,0,0,0,43,10,33,23,7,16,10,5,7,16,4,-3,0,-2,2,8,0,-1,10,7,5,8,4,-2,2,10,3,1,5,2,2,2,-1,0,2,2,0,8,4,1,3,0,130,72,58,46,28,18,24,38,32,24,16,-5,11,26,15,9,9,1,13,12,17,15,7,-6,7,13,14,8,3,0,4,11,10,2,0,0,3,2,4,6,3,0,-8,-6,-2,-17,-17,0,-5,-3,2,1,3,-5,-4,-4,1,0,3,-2,-1,1,1,1,0,-3,-3,-4,-7,-3,-1,1,-3,-6,-5,-3,-1,1,0,2,-2,0,0,0,-37,-18,-19,-16,-10,-6,-8,2,-18,-13,2,0,0,-1,-5,-12,-1,2,-8,3,-13,-1,3,-2,2,1,-10,-4,-4,-1,1,0,-7,-1,-3,0,1,1,-3,-3,-1,-1,5,7,-2,6,5,1,6,-5,-4,6,0,1,2,2,-2,2,1,1,4,-7,-2,4,-1,0,3,-1,1,1,1,0,0,2,0,0,2,0,3,-3,1,1,-1,0,-46,-14,-32,-6,-2,-4,-9,-7,-12,0,-8,-10,-2,4,-5,-5,-1,-5,-7,-11,-7,5,-7,-5,-2,0,-2,8,-7,-3,-1,1,-2,6,-4,-2,-1,-1,0,2,-3,-1,8,6,2,-16,-5,-11,4,13,6,-8,-3,-3,1,5,-1,5,-2,-1,3,8,7,-13,-1,-2,2,-1,-2,-12,-3,0,1,0,-1,-4,-1,0,1,-1,-1,-8,-2,0,-20,-12,-8,-3,-1,-2,-3,3,-17,-2,-2,-1,0,-1,-3,-8,-1,-1,-3,4,-14,6,-1,0,-1,2,-6,2,0,0,0,0,-2,1,0,0,-1,2,-4,1,0,0,-27,-12,-15,8,7,1,-8,0,-10,-6,3,-4,3,2,-8,-4,0,-3,-11,-2,-2,-2,3,-1,-2,4,-2,6,2,0,2,2,-1,3,1,0,-4,2,-1,3,1,0,-37,-19,-18,-9,-4,-5,-17,-8,-9,-4,4,-4,-11,-6,-3,1,3,-3,-6,-2,-6,-5,1,-1,-3,0,-3,-5,2,0,-3,-1,1,-2,1,0,0,1,-4,-3,1,0,11,0,11,6,-1,7,8,6,2,-7,0,0,3,1,1,-4,-2,1,5,5,1,-3,2,-1,2,1,1,2,-1,1,0,0,-1,0,-1,1,2,1,2,2,0,0,3,5,-2,-3,-1,-2,1,5,1,0,-3,-1,3,-1,1,2,0,0,-2,6,0,-2,-3,-1,-1,2,-2,-2,0,0,-1,1,-1,0,0,0,0,1,-1,-2,0,0
46,46162,Massalavés,1470,38,26,12,39,26,13,9,5,17,8,0,-2,4,3,12,6,1,-1,5,2,5,2,-1,-1,7,3,17,10,2,0,2,3,12,8,1,0,5,0,5,2,1,0,101,66,35,108,67,41,2,33,39,30,-1,-1,-1,23,25,19,0,0,3,10,14,11,-1,-1,4,33,45,23,3,0,1,23,28,15,0,0,3,10,17,8,3,0,-1,-3,2,46,25,21,-6,0,7,-4,2,1,-5,2,2,-3,0,1,-1,-2,5,-1,2,0,5,13,21,5,2,0,3,6,12,4,0,0,2,7,9,1,2,0,-19,-7,-12,25,17,8,-8,7,-12,-5,3,-1,-6,4,-3,-4,2,1,-2,3,-9,-1,1,-2,2,7,10,6,0,0,1,4,7,5,0,0,1,3,3,1,0,0,46,21,25,33,18,15,8,14,5,9,5,2,9,7,-3,3,4,0,-1,7,8,6,1,2,0,7,10,11,5,0,0,4,4,6,4,0,0,3,6,5,1,0,27,15,12,57,35,22,-4,17,14,2,-3,1,-1,6,5,6,-2,1,-3,11,9,-4,-1,0,2,20,24,11,0,0,1,11,14,9,0,0,1,9,10,2,0,0,39,28,11,33,13,20,6,11,7,4,7,3,6,5,5,3,6,2,0,6,2,1,1,1,5,14,6,4,2,2,3,3,1,3,2,1,2,11,5,1,0,1,-10,6,-16,28,25,3,0,9,-8,-3,-2,-5,0,11,1,-1,-2,-2,0,-2,-9,-2,0,-3,2,13,10,3,0,0,1,12,9,3,0,0,1,1,1,0,0,0,27,21,6,14,6,8,-1,11,6,7,4,1,1,7,4,5,4,1,-2,4,2,2,0,0,2,4,4,3,1,0,0,2,2,2,0,0,2,2,2,1,1,0,-7,-24,17,6,-1,7,1,-1,-6,-1,1,0,-3,-1,-11,-4,-3,-1,4,0,5,3,4,1,4,1,-3,0,3,1,3,0,-4,-1,1,0,1,1,1,1,2,1,-29,-13,-16,-14,-12,-2,4,-4,-8,-17,0,-3,2,-2,-10,-5,1,1,2,-2,2,-12,-1,-4,0,3,-6,-9,-2,0,0,0,-4,-7,-1,0,0,3,-2,-2,-1,0,-7,-3,-4,-27,-17,-10,3,6,-11,2,-5,0,1,1,-6,4,-3,1,2,5,-5,-2,-2,-1,-3,-3,-11,-8,-2,0,-1,-3,-7,-5,-1,0,-2,0,-4,-3,-1,0,6,6,0,4,3,1,-4,6,-1,-1,3,2,-2,3,4,-1,2,-1,-2,3,-5,0,1,3,-1,3,0,-1,2,0,0,2,0,-1,1,0,-1,1,0,0,1,0,-16,-5,-11,-1,-4,3,-5,-3,6,-8,-2,-1,-1,-3,5,-3,-3,1,-4,0,1,-5,1,-2,0,0,0,-1,0,0,0,-2,0,-2,0,0,0,2,0,1,0,0,-16,-8,-8,2,2,0,-8,2,-6,-7,3,0,-6,3,-2,-6,3,0,-2,-1,-4,-1,0,0,1,2,1,-1,0,-1,0,1,3,-2,0,0,1,1,-2,1,0,-1,-14,-11,-3,-6,-5,-1,0,1,-5,-4,-7,0,1,-2,-4,1,-5,-2,-1,3,-1,-5,-2,2,4,3,-4,-4,-4,-1,5,1,-4,-1,-4,-2,-1,2,0,-3,0,1,25,12,13,8,5,3,6,5,-2,10,1,4,1,4,1,4,1,0,5,1,-3,6,0,4,0,3,-1,4,1,0,0,2,-1,2,1,0,0,1,0,2,0,0,-12,4,-16,-1,0,-1,-6,2,-9,9,-7,-3,0,1,-2,6,-1,-1,-6,1,-7,3,-6,-2,-1,1,-5,5,0,-1,-2,0,0,2,-1,1,1,1,-5,3,1,-2
46,46164,Massamagrell,12424,99,38,61,48,18,30,8,11,14,10,30,28,-3,-1,9,5,17,9,11,12,5,5,13,19,13,14,10,5,6,0,5,6,4,1,2,0,8,8,6,4,4,0,305,192,113,142,89,53,56,58,79,60,14,36,35,38,52,40,13,13,21,20,27,20,1,23,32,39,35,27,7,2,18,27,25,13,5,1,14,12,10,14,2,1,346,204,142,146,79,67,69,72,100,35,38,24,36,48,64,22,20,5,33,24,36,13,18,19,42,36,44,14,8,1,20,21,29,5,3,0,22,15,15,9,5,1,139,64,75,72,36,36,7,42,43,12,12,20,9,19,5,23,4,1,-2,23,38,-11,8,19,16,20,16,11,5,2,7,9,9,7,1,1,9,11,7,4,4,1,250,110,140,83,46,37,25,62,72,42,10,33,13,22,46,21,1,6,12,40,26,21,9,27,9,34,15,15,5,4,3,21,8,11,1,1,6,13,7,4,4,3,101,16,85,51,27,24,17,51,-9,-4,12,19,0,27,-19,-7,5,1,17,24,10,3,7,18,7,14,10,8,7,2,4,8,6,5,2,0,3,6,4,3,5,2,247,138,109,163,82,81,27,55,92,30,8,32,23,20,57,18,-2,16,4,35,35,12,10,16,27,49,48,26,10,1,19,20,23,14,4,1,8,29,25,12,6,0,201,86,115,112,57,55,2,42,98,8,3,45,-8,4,68,6,1,13,10,38,30,2,2,32,20,33,38,12,8,1,11,12,23,6,4,1,9,21,15,6,4,0,250,143,107,81,37,44,23,47,112,19,18,34,17,32,69,6,11,12,6,15,43,13,7,22,22,22,16,12,2,6,13,12,4,2,2,3,9,10,12,10,0,3,138,66,72,51,23,28,-13,42,85,22,6,-7,-8,18,48,10,-4,-2,-5,24,37,12,10,-5,10,17,4,11,7,2,4,9,1,6,2,1,6,8,3,5,5,1,61,25,36,23,2,21,3,-11,3,30,13,31,-14,-11,7,32,5,12,17,0,-4,-2,8,19,0,11,-5,13,3,2,-4,0,-7,9,3,2,4,11,2,4,0,0,-2,-1,-1,4,1,3,4,0,-35,-8,10,23,10,4,-27,-1,0,10,-6,-4,-8,-7,10,13,12,4,-18,2,6,-1,10,1,-9,-1,1,0,2,3,-9,3,5,-1,118,51,67,-26,-17,-9,44,0,64,-11,-1,17,16,9,32,-15,-3,9,28,-9,32,4,2,8,2,1,-11,-13,-5,0,-1,6,-10,-8,-4,0,3,-5,-1,-5,-1,0,-52,-31,-21,-56,-31,-25,1,-17,1,-41,8,2,2,-7,3,-23,-2,2,-1,-10,-2,-18,10,0,-8,-3,-13,-17,-7,-8,1,-3,-8,-12,-5,-4,-9,0,-5,-5,-2,-4,-43,-33,-10,-48,-32,-16,-41,27,-26,-18,12,4,-19,-1,8,-20,4,-2,-22,28,-34,2,8,6,-7,14,-25,-13,-14,-4,-5,4,-11,-12,-7,-2,-2,10,-14,-1,-7,-2,67,16,51,2,-4,6,22,5,-11,14,13,25,15,0,-6,3,1,6,7,5,-5,11,12,19,8,8,-9,-5,-1,1,3,4,-3,-8,0,0,5,4,-6,3,-1,1,78,49,29,47,23,24,15,1,-3,25,11,26,18,4,-12,10,14,13,-3,-3,9,15,-3,13,-4,11,15,11,8,6,-1,6,8,4,4,2,-3,5,7,7,4,4,276,142,134,83,34,49,54,27,62,64,31,35,30,15,33,33,18,9,24,12,29,31,13,26,14,20,16,22,6,3,6,10,6,9,2,1,8,10,10,13,4,2
46,46165,Massanassa,7633,-41,-24,-17,23,7,16,4,-2,-42,11,-6,-3,3,1,-27,4,-2,0,1,-3,-15,7,-4,-3,5,5,8,5,0,0,2,1,4,0,0,0,3,4,4,5,0,0,10,12,-2,47,31,16,6,8,3,-12,2,2,9,3,4,-8,1,2,-3,5,-1,-4,1,0,5,17,20,5,0,0,3,11,14,3,0,0,2,6,6,2,0,0,71,32,39,66,37,29,42,-1,14,14,-3,-2,18,4,4,7,-6,0,24,-5,10,7,3,-2,17,15,11,16,6,1,9,10,5,9,3,1,8,5,6,7,3,0,217,124,93,47,23,24,38,36,125,10,5,-4,16,22,78,4,3,-2,22,14,47,6,2,-2,11,10,16,5,4,0,6,5,7,2,3,0,5,5,9,3,1,0,203,115,88,17,9,8,31,24,121,18,-6,7,15,12,69,13,-2,3,16,12,52,5,-4,4,0,6,8,-1,2,1,-2,4,5,0,2,0,2,2,3,-1,0,1,201,129,72,45,32,13,29,24,117,9,15,5,10,21,78,11,7,-1,19,3,39,-2,8,6,10,10,12,8,2,3,6,8,10,8,-1,1,4,2,2,0,3,2,229,86,143,51,20,31,35,31,88,40,-8,43,19,9,37,15,-8,14,16,22,51,25,0,29,20,12,10,4,6,-1,12,5,0,0,3,0,8,7,10,4,3,-1,263,133,130,60,21,39,26,41,125,18,13,38,12,14,74,10,8,13,14,27,51,8,5,25,8,26,9,11,1,4,-1,12,4,5,-1,1,9,14,5,6,2,3,213,102,111,53,28,25,12,34,68,31,2,70,10,20,36,25,1,12,2,14,32,6,1,58,10,23,14,6,-2,2,8,9,7,6,-2,0,2,14,7,0,0,2,29,41,-12,-25,-8,-17,3,12,17,-27,4,14,13,7,17,-11,1,8,-10,5,0,-16,3,6,-5,7,-12,-8,-2,-4,0,4,-7,-4,0,-1,-5,3,-5,-4,-2,-3,106,38,68,41,19,22,-4,28,30,41,9,-4,-14,12,23,14,5,-5,10,16,7,27,4,1,5,8,12,9,4,0,1,3,9,3,2,0,4,5,3,6,2,0,-140,-76,-64,-12,-10,-2,-34,4,-56,-38,-18,3,-25,-1,-15,-30,-6,2,-9,5,-41,-8,-12,1,-2,2,-3,-6,-2,-1,-2,-1,-2,-4,-1,0,0,3,-1,-2,-1,-1,51,15,36,-31,-25,-6,16,5,5,9,-5,16,3,-3,5,7,-3,4,13,8,0,2,-2,12,5,-3,-7,-20,-3,-4,2,-4,-4,-17,1,-4,3,1,-3,-3,-4,0,11,0,11,-35,-17,-18,25,20,-38,3,-12,13,20,8,-22,-8,-2,3,5,12,-16,11,-10,10,-1,-1,-16,-13,-4,0,0,0,-8,-8,-1,0,-1,-1,-8,-5,-3,0,88,39,49,22,16,6,5,-6,29,28,11,26,1,-4,22,14,3,6,4,-2,7,14,8,20,-2,9,0,9,4,2,-1,4,2,8,2,1,-1,5,-2,1,2,1,46,34,12,-13,0,-13,11,9,10,-2,6,7,5,10,6,-1,9,1,6,-1,4,-1,-3,6,1,0,-8,1,-4,-3,-1,2,-2,2,-1,0,2,-2,-6,-1,-3,-3,56,11,45,-10,-6,-4,0,9,-10,-1,15,41,6,6,-11,-7,8,9,-6,3,1,6,7,32,3,-2,-10,-8,2,4,2,-1,-9,-2,2,2,1,-1,-1,-6,0,2,135,72,63,37,15,22,21,21,22,41,-10,34,9,4,19,21,-3,17,12,17,3,20,-7,17,11,3,8,10,3,1,0,0,7,6,0,1,11,3,1,4,3,0
46,46166,Meliana,9112,29,16,13,47,31,16,28,9,9,-4,-12,1,14,3,12,-3,-8,-1,14,6,-3,-1,-4,2,7,10,23,4,1,2,4,6,18,3,0,0,3,4,5,1,1,2,29,18,11,39,29,10,8,17,9,6,-8,-3,0,11,7,7,-4,-4,8,6,2,-1,-4,1,5,14,15,4,1,0,2,10,13,3,1,0,3,4,2,1,0,0,54,46,8,6,3,3,16,15,24,11,1,-8,12,9,18,13,-3,-2,4,6,6,-2,4,-6,4,0,4,-1,0,-1,2,0,2,-1,0,0,2,0,2,0,0,-1,2,-5,7,11,7,4,6,-4,11,1,-6,-4,2,-1,6,-3,-3,-3,4,-3,5,4,-3,-1,2,3,4,2,0,0,2,1,3,1,0,0,0,2,1,1,0,0,158,95,63,54,27,27,13,39,61,30,12,2,14,21,36,16,6,1,-1,18,25,14,6,1,5,26,12,10,0,1,4,9,8,5,0,1,1,17,4,5,0,0,62,30,32,39,25,14,16,12,36,2,-1,-3,9,5,21,-2,-2,1,7,7,15,4,1,-4,4,9,18,3,2,1,2,6,13,2,1,1,2,3,5,1,1,0,196,109,87,68,42,26,28,26,107,44,-4,-9,13,17,63,25,-8,-3,15,9,44,19,4,-6,11,24,17,14,0,0,6,15,15,8,-1,-2,5,9,2,6,1,2,305,138,167,91,39,52,45,73,149,22,17,-2,20,33,72,9,6,-1,25,40,77,13,11,-1,16,30,24,11,7,1,8,14,12,0,3,1,8,16,12,11,4,0,135,84,51,58,29,29,6,32,86,12,2,4,8,13,54,4,3,2,-2,19,32,8,-1,2,6,16,27,2,4,2,2,8,12,2,2,2,4,8,15,0,2,0,49,6,43,13,2,11,0,10,28,5,1,4,2,-17,23,-1,-5,2,-2,27,5,6,6,2,4,9,1,0,-2,1,1,2,2,-1,-2,0,3,7,-1,1,0,1,37,15,22,1,-2,3,19,13,23,-10,5,-12,8,16,15,-20,2,-6,11,-3,8,10,3,-6,0,8,1,-9,3,-2,2,4,1,-9,2,-2,-2,4,0,0,1,0,-8,-1,-7,6,3,3,-13,-14,45,-13,-5,-7,-3,-10,23,-7,-1,-5,-10,-4,22,-6,-4,-2,2,2,2,2,-3,1,4,1,-2,0,0,0,-2,1,4,2,-3,1,-76,-46,-30,-32,-24,-8,-9,-4,-50,-7,-2,-2,-5,-12,-24,-7,3,-1,-4,8,-26,0,-5,-1,-5,-7,-15,-4,-1,1,-3,-8,-9,-4,0,0,-2,1,-6,0,-1,1,-55,-45,-10,-25,-21,-4,-9,-6,-21,-6,-18,-4,-11,-8,-9,-7,-12,-3,2,2,-12,1,-6,-1,-3,3,-12,-7,-7,0,-4,0,-8,-7,-3,0,1,3,-4,0,-4,0,-45,-40,-5,13,2,11,-6,-6,-4,-6,-8,-15,-9,-3,-11,-6,-5,-9,3,-3,7,0,-3,-6,6,-3,7,5,-1,-1,3,-3,1,1,0,0,3,0,6,4,-1,-1,0,-18,18,-1,-8,7,-7,8,13,-17,-13,12,-11,8,-3,-14,-6,5,4,0,16,-3,-7,7,0,4,-1,-4,-1,1,1,3,-6,-5,-2,0,-1,1,5,1,1,1,46,0,46,47,24,23,26,-4,25,4,8,-9,8,-5,6,-9,3,-1,18,1,19,13,5,-8,12,12,16,-1,7,0,9,8,9,-6,4,-1,3,4,7,5,3,1,49,23,26,31,10,21,-4,22,19,9,11,-10,-6,12,5,7,5,-1,2,10,14,2,6,-9,6,12,3,5,0,4,3,8,-3,-1,0,2,3,4,6,6,0,2
46,46168,Miramar,1179,70,31,39,18,11,7,8,11,20,12,16,2,8,5,5,5,8,0,0,6,15,7,8,2,2,5,5,0,4,1,2,2,3,0,3,0,0,3,2,0,1,1,98,61,37,26,12,14,4,19,20,15,25,15,4,9,12,11,15,10,0,10,8,4,10,5,4,3,6,3,6,4,2,0,2,2,4,2,2,3,4,1,2,2,146,79,67,55,35,20,13,31,47,26,19,10,5,16,31,14,10,3,8,15,16,12,9,7,5,15,13,12,9,1,4,7,10,8,5,1,1,8,3,4,4,0,162,85,77,37,20,17,29,13,48,44,12,16,14,8,20,26,8,9,15,5,28,18,4,7,5,6,5,8,8,5,2,5,2,3,5,3,3,1,3,5,3,2,106,60,46,28,12,16,20,12,21,7,22,23,11,9,15,7,11,6,9,3,6,0,11,17,3,8,3,4,7,3,1,4,2,3,1,1,2,4,1,1,6,2,106,67,39,37,20,17,4,13,25,31,29,6,3,8,17,18,15,7,1,5,8,13,14,-1,6,7,10,3,9,2,1,5,4,1,7,2,5,2,6,2,2,0,119,55,64,24,10,14,14,11,36,42,12,3,7,3,19,19,7,-1,7,8,17,23,5,4,5,3,7,7,3,-1,2,2,5,2,0,-1,3,1,2,5,3,0,171,94,77,37,19,18,28,22,49,39,15,14,17,12,28,28,4,6,11,10,21,11,11,8,1,4,14,7,6,4,0,3,10,4,0,2,1,1,4,3,6,2,118,69,49,24,12,12,18,17,51,19,13,-3,8,14,33,11,5,-4,10,3,18,8,8,1,6,0,5,2,10,1,3,0,4,1,4,0,3,0,1,1,6,1,85,43,42,5,4,1,9,16,40,-4,9,11,-1,15,15,0,4,7,10,1,25,-4,5,4,-3,1,5,-7,5,2,-2,2,2,-7,5,2,-1,-1,3,0,0,0,101,63,38,26,13,13,-6,11,35,10,29,20,1,10,25,3,15,8,-7,1,10,7,14,12,5,5,0,3,8,4,3,3,0,1,5,1,2,2,0,2,3,3,23,7,16,1,-3,4,-2,17,10,4,-3,-4,0,9,5,2,-2,-6,-2,8,5,2,-1,2,0,2,0,-4,1,2,0,1,0,-3,-1,0,0,1,0,-1,2,2,32,27,5,4,2,2,-1,10,9,24,2,-11,3,9,5,11,5,-6,-4,1,4,13,-3,-5,2,-1,-1,4,0,0,1,0,-1,2,0,0,1,-1,0,2,0,0,41,15,26,-3,-1,-2,5,-2,19,-4,16,6,0,-2,9,-6,8,5,5,0,10,2,8,1,-2,-1,0,-5,4,1,0,0,0,-2,0,1,-2,-1,0,-3,4,0,53,33,20,11,8,3,14,9,14,10,-1,6,7,6,3,9,4,3,7,3,11,1,-5,3,3,2,2,2,0,2,3,0,2,1,0,2,0,2,0,1,0,0,-2,-17,15,3,2,1,-5,-2,-1,-5,3,11,-9,-4,-3,-4,-5,10,4,2,2,-1,8,1,-2,-3,2,-2,2,6,-2,-1,3,-1,0,3,0,-2,-1,-1,2,3,13,7,6,5,4,1,-1,0,3,5,5,1,4,1,3,2,-5,2,-5,-1,0,3,10,-1,0,1,4,1,1,-2,0,1,2,1,-1,1,0,0,2,0,2,-3,-54,-43,-11,-72,-44,-28,-12,2,-17,-24,-13,10,-14,3,-9,-17,-4,-2,2,-1,-8,-7,-9,12,-1,0,-16,-17,-20,-18,-1,0,-12,-14,-7,-10,0,0,-4,-3,-13,-8
46,46169,Mislata,40528,216,127,89,374,212,162,6,95,116,7,-27,20,9,38,68,10,-14,15,-3,57,48,-3,-13,5,52,100,136,71,9,2,29,56,73,44,5,1,23,44,63,27,4,1,562,267,295,561,302,259,84,173,249,48,-16,23,52,73,135,16,-21,10,32,100,114,32,5,13,95,125,192,127,17,2,49,68,107,72,6,0,46,57,85,55,11,2,250,122,128,462,230,232,52,99,99,-7,-27,44,29,51,57,-10,-17,17,23,48,42,3,-10,27,96,106,139,90,20,8,53,42,75,42,13,3,43,64,64,48,7,5,650,326,324,504,276,228,108,207,244,51,2,28,39,111,149,22,-14,16,69,96,95,29,16,12,99,121,148,87,29,14,48,69,93,47,11,7,51,52,55,40,18,7,-51,4,-55,389,226,163,-8,47,-21,-62,-12,14,-1,36,31,-41,-17,3,-7,11,-52,-21,5,11,46,97,155,59,23,5,21,59,96,35,9,4,25,38,59,24,14,1,528,350,178,597,354,243,73,148,243,83,-12,-8,37,108,166,75,-18,-13,36,40,77,8,6,5,104,149,206,95,29,11,50,91,136,63,9,4,54,58,70,32,20,7,173,86,87,627,329,298,100,70,65,-2,-18,-42,43,37,43,-29,-5,-5,57,33,22,27,-13,-37,129,166,181,104,35,6,64,88,106,51,17,1,65,78,75,53,18,5,116,54,62,625,312,313,75,86,5,-18,-27,-2,46,63,-16,-22,-19,-1,29,23,21,4,-8,-1,146,165,164,111,27,2,76,79,77,60,13,1,70,86,87,51,14,1,66,21,45,434,254,180,64,134,-45,-19,-20,-35,32,67,-16,-40,-14,5,32,67,-29,21,-6,-40,99,157,129,43,11,-5,56,94,88,22,-3,-1,43,63,41,21,14,-4,196,102,94,390,220,170,41,126,55,-15,2,-4,19,65,55,-18,-13,-3,22,61,0,3,15,-1,78,152,95,46,11,7,43,99,57,18,0,2,35,53,38,28,11,5,-368,-204,-164,5,-4,9,38,-3,-187,-99,-78,-40,16,18,-122,-61,-41,-14,22,-21,-65,-38,-37,-26,27,55,-14,-30,-30,-5,11,43,-15,-25,-16,-2,16,12,1,-5,-14,-3,77,15,62,242,134,108,65,20,-8,-14,-2,10,38,28,-9,-36,-11,2,27,-8,1,22,9,8,41,73,98,9,15,3,28,52,56,-3,3,-3,13,21,42,12,12,6,-13,-63,50,17,-7,24,43,-13,-14,-67,17,13,33,-12,-38,-54,-17,19,10,-1,24,-13,34,-6,23,17,-14,-27,12,1,14,10,-24,-13,2,1,9,7,10,-14,10,0,-149,-57,-92,-84,-38,-46,-1,-1,-84,-59,-7,-12,9,1,-50,-17,-2,-2,-10,-2,-34,-42,-5,-10,6,16,-46,-51,-12,2,9,12,-21,-38,-3,3,-3,4,-25,-13,-9,-1,-61,-85,24,12,16,-4,27,2,-39,-34,-5,-19,2,-11,-46,-18,-2,-9,25,13,7,-16,-3,-10,30,21,-22,-24,7,-3,18,13,-10,-16,12,-1,12,8,-12,-8,-5,-2,-127,-147,20,-71,-77,6,54,7,-77,-85,-31,-4,51,-25,-77,-84,-17,-1,3,32,0,-1,-14,-3,12,20,-42,-45,-16,-6,16,-1,-47,-38,-9,-3,-4,21,5,-7,-7,-3,69,55,14,299,155,144,36,60,-45,-11,21,4,-3,52,-2,-6,-3,11,39,8,-43,-5,24,-7,64,75,60,51,33,8,35,39,31,29,12,3,29,36,29,22,21,5,368,186,182,397,174,223,160,62,43,82,21,-10,102,19,31,15,10,1,58,43,12,67,11,-11,107,83,98,51,31,20,64,34,52,1,9,9,43,49,46,50,22,11
46,46170,Mogente/Moixent,4251,23,23,0,56,34,22,-4,12,10,5,-3,4,0,10,9,2,0,2,-4,2,1,3,-3,2,4,21,22,9,0,0,0,13,18,3,0,0,4,8,4,6,0,0,33,25,8,61,32,29,8,16,1,14,0,-5,2,10,7,8,1,-2,6,6,-6,6,-1,-3,11,19,17,11,3,0,5,8,10,7,2,0,6,11,7,4,1,0,59,25,34,94,45,49,9,13,19,10,7,1,3,3,10,6,3,0,6,10,9,4,4,1,16,23,32,17,6,0,5,13,17,8,2,0,11,10,15,9,4,0,19,18,1,44,26,18,-7,-2,13,16,0,-1,-1,-1,13,10,0,-3,-6,-1,0,6,0,2,4,10,21,8,1,0,3,6,14,3,0,0,1,4,7,5,1,0,60,21,39,61,33,28,14,14,11,10,10,4,5,6,3,3,5,1,9,8,8,7,5,3,11,15,21,8,2,3,6,7,14,3,1,2,5,8,7,5,1,1,50,36,14,48,25,23,9,6,12,13,6,4,9,7,5,9,4,2,0,-1,7,4,2,2,6,13,16,10,3,0,4,6,7,6,2,0,2,7,9,4,1,0,23,12,11,57,32,25,7,1,-4,11,4,3,2,0,-1,7,1,2,5,1,-3,4,3,1,12,12,19,11,2,0,7,7,11,6,0,0,5,5,8,5,2,0,81,48,33,78,45,33,11,21,16,26,10,-4,4,17,10,14,4,-2,7,4,6,12,6,-2,12,21,25,15,4,0,4,14,17,8,1,0,8,7,8,7,3,0,7,1,6,14,4,10,12,-2,1,3,-7,1,2,3,-3,0,-3,1,10,-5,4,3,-4,0,3,1,6,4,0,0,1,0,1,2,0,0,2,1,5,2,0,0,19,4,15,15,7,8,4,9,-1,7,1,-1,2,2,-1,0,3,-2,2,7,0,7,-2,1,0,6,0,3,4,2,0,2,2,0,2,1,0,4,-2,3,2,1,3,5,-2,23,16,7,-2,-2,6,-3,6,-2,-2,-3,8,0,1,1,0,1,-2,-3,5,-3,3,12,2,4,2,0,2,7,4,2,1,0,1,5,-2,2,1,0,-9,-12,3,-5,-8,3,0,13,-23,-5,2,5,-2,4,-13,-6,3,2,2,9,-10,1,-1,3,0,3,-6,-3,0,1,-2,-2,-4,-2,2,0,2,5,-2,-1,-2,1,-42,-28,-14,-37,-25,-12,10,-9,-16,-16,-12,0,10,-1,-15,-12,-9,-3,0,-8,-1,-4,-3,3,0,-5,-17,-11,-5,2,0,-1,-13,-7,-3,0,0,-4,-4,-4,-2,2,17,11,6,8,6,2,10,-3,-6,11,1,4,3,2,-1,5,2,-1,7,-5,-5,6,-1,5,3,4,0,0,1,0,3,3,0,-1,1,0,0,1,0,1,0,0,-27,-9,-18,0,-2,2,-5,-2,-18,-5,3,0,-3,1,-9,-3,2,3,-2,-3,-9,-2,1,-3,0,-1,-3,1,2,1,0,-1,-3,2,0,0,0,0,0,-1,2,1,-67,-44,-23,-20,-16,-4,-12,-12,-21,-23,-2,5,-4,-8,-15,-12,-3,-1,-8,-4,-6,-11,1,6,-4,-3,-6,-10,3,0,-2,-2,-4,-8,0,0,-2,-1,-2,-2,3,0,7,0,7,20,7,13,7,-5,4,6,-2,-4,2,-4,2,7,-3,-4,5,-1,2,-1,1,0,6,2,4,4,2,1,2,1,1,2,1,0,4,1,3,2,1,1,5,-1,6,13,8,5,4,-2,-12,-3,4,13,5,0,-9,-3,1,5,-1,-2,-3,0,3,8,3,0,1,2,6,1,1,0,0,2,4,1,2,0,1,0,2,0
46,46171,Moncada,18479,195,125,70,139,91,48,34,24,61,37,8,31,30,19,36,27,10,3,4,5,25,10,-2,28,9,30,62,31,5,1,3,18,42,22,5,0,6,12,20,9,0,1,349,203,146,185,114,71,43,82,80,43,16,77,31,55,59,27,7,19,12,27,21,16,9,58,21,53,76,24,6,4,12,32,48,16,2,3,9,21,28,8,4,1,467,208,259,229,123,106,93,79,144,90,11,46,51,44,68,40,5,0,42,35,76,50,6,46,49,49,68,53,8,1,30,26,41,23,3,0,19,23,27,30,5,1,549,287,262,190,96,94,79,115,202,84,15,48,48,65,101,41,12,17,31,50,101,43,3,31,21,68,64,20,8,6,11,32,37,8,3,3,10,36,27,12,5,3,399,205,194,219,119,100,62,96,92,64,34,40,42,45,47,37,19,6,20,51,45,27,15,34,33,69,72,33,8,2,19,33,38,20,5,2,14,36,34,13,3,0,443,241,202,235,124,111,100,67,143,91,24,16,55,37,82,47,8,9,45,30,61,44,16,7,41,66,74,36,14,1,26,35,38,17,7,1,15,31,36,19,7,0,349,164,185,203,100,103,89,64,96,77,-22,34,50,26,62,23,-14,12,39,38,34,54,-8,22,33,64,54,40,7,2,17,31,30,18,2,1,16,33,24,22,5,1,427,253,174,275,149,126,36,104,121,73,23,56,30,54,90,48,22,7,6,50,31,25,1,49,29,95,84,46,13,4,14,48,49,27,10,0,15,47,35,19,3,4,284,139,145,155,86,69,58,27,53,80,29,34,28,11,19,47,20,13,30,16,34,33,9,21,23,41,48,28,7,5,19,17,32,9,5,1,4,24,16,19,2,4,20,4,16,87,49,38,-2,-6,-41,19,3,41,-4,9,-18,4,4,2,2,-15,-23,15,-1,39,15,21,22,14,10,3,10,14,10,5,7,1,5,7,12,9,3,2,8,-29,37,49,25,24,16,-15,-24,2,-9,33,10,-11,-29,6,-9,4,6,-4,5,-4,0,29,12,21,6,3,2,2,8,10,2,2,2,0,4,11,4,1,0,2,77,9,68,79,27,52,-4,53,-19,-11,8,47,8,30,-25,-19,2,13,-12,23,6,8,6,34,9,28,25,12,2,0,4,11,8,2,-1,1,5,17,17,10,3,-1,105,34,71,54,14,40,14,28,-5,0,22,50,-3,10,4,1,14,13,17,18,-9,-1,8,37,2,38,11,-1,1,2,-2,11,6,-2,0,1,4,27,5,1,1,1,-163,-97,-66,-59,-49,-10,-15,37,-105,-40,-40,-3,-3,9,-56,-35,-18,6,-12,28,-49,-5,-22,-9,-13,54,-47,-30,-22,-1,-7,14,-25,-20,-11,0,-6,40,-22,-10,-11,-1,27,-41,68,131,45,86,-16,85,-45,-1,-2,9,-11,22,-21,-12,-10,-7,-5,63,-24,11,8,16,-4,112,10,10,4,-3,-1,37,6,7,-2,-2,-3,75,4,3,6,-1,-85,-110,25,48,-25,73,-16,109,-83,-73,-33,13,-20,20,-46,-55,-14,7,4,89,-37,-18,-19,6,8,143,-10,-55,-29,-9,3,36,-6,-41,-13,-4,5,107,-4,-14,-16,-5,42,-22,64,212,75,137,-21,135,-34,-28,-15,3,3,35,-39,-12,-5,-4,-24,100,5,-16,-10,7,8,151,25,18,0,7,10,48,7,7,-1,3,-2,103,18,11,1,4,137,20,117,227,85,142,3,170,-34,4,-23,15,5,57,-25,-10,-6,0,-2,113,-9,14,-17,15,12,172,15,16,5,5,8,64,7,0,5,1,4,108,8,16,0,4
46,46172,Montserrat,3090,83,53,30,42,24,18,19,13,36,23,-5,-2,10,14,16,13,1,0,9,-1,20,10,-6,-2,6,11,17,5,1,0,2,8,8,3,1,0,4,3,9,2,0,0,108,72,36,63,38,25,24,28,31,23,5,-3,17,19,20,17,2,-3,7,9,11,6,3,0,10,11,22,17,2,1,5,8,13,11,1,0,5,3,9,6,1,1,-111,-56,-55,-2,1,-3,-16,-17,-43,-19,-10,-5,-10,-8,-20,-12,-4,-2,-6,-9,-23,-7,-6,-3,-1,1,-1,0,-1,0,-1,1,1,0,0,0,0,0,-2,0,-1,0,242,148,94,86,53,33,33,41,91,39,18,15,27,20,50,26,12,8,6,21,41,13,6,7,17,25,27,8,6,2,13,13,16,5,4,1,4,12,11,3,2,1,388,213,175,119,63,56,51,58,127,85,53,12,33,22,65,59,29,5,18,36,62,26,24,7,13,20,42,18,21,4,7,9,20,13,10,3,6,11,22,5,11,1,439,251,188,129,81,48,76,63,152,84,42,17,38,40,88,52,22,9,38,23,64,32,20,8,19,33,35,20,15,6,11,24,22,13,8,2,8,9,13,7,7,4,503,261,242,109,57,52,72,92,136,100,66,30,39,47,75,54,30,13,33,45,61,46,36,17,15,28,25,24,11,6,8,15,15,13,4,2,7,13,10,11,7,4,588,372,216,175,106,69,90,90,205,127,47,13,50,59,130,87,30,4,40,31,75,40,17,9,39,48,43,30,10,2,17,34,24,21,6,1,22,14,19,9,4,1,332,195,137,77,40,37,48,66,119,59,21,10,28,32,67,40,14,9,20,34,52,19,7,1,16,34,14,7,5,0,6,16,12,2,3,0,10,18,2,5,2,0,246,104,142,47,21,26,39,38,82,61,10,10,11,21,42,22,3,0,28,17,40,39,7,10,9,11,14,7,2,3,3,8,6,2,0,2,6,3,8,5,2,1,369,198,171,85,52,33,44,90,116,73,26,18,19,49,60,45,17,8,25,41,56,28,9,10,10,26,18,13,11,7,6,19,13,5,5,4,4,7,5,8,6,3,-89,-13,-76,-136,-73,-63,-23,2,-39,-6,-24,-5,13,13,-15,-10,-15,0,-36,-11,-24,4,-9,-5,-32,0,-37,-36,-20,-11,-8,6,-28,-27,-11,-5,-24,-6,-9,-9,-9,-6,152,60,92,17,4,13,35,28,20,32,27,13,12,10,10,7,14,11,23,18,10,25,13,2,4,3,2,0,6,2,2,0,0,-2,2,2,2,3,2,2,4,0,-116,-91,-25,-114,-80,-34,11,-7,-35,-37,-19,-27,7,-8,-31,-30,-16,-11,4,1,-4,-7,-3,-16,-4,-4,-43,-36,-14,-14,-3,-5,-29,-25,-10,-8,-1,1,-14,-11,-4,-6,-27,-31,4,9,-4,13,-15,7,15,-27,2,-11,-4,1,-3,-23,4,-6,-11,6,18,-4,-2,-5,-1,15,-5,-5,4,1,-2,7,-7,-5,3,0,1,8,2,0,1,1,3,0,3,-17,-9,-8,1,-5,-5,18,-3,2,5,-7,-9,11,2,-2,-4,2,4,7,-5,4,0,6,-8,-7,-2,-7,1,1,-4,-6,2,-4,-1,5,-4,-1,-4,-3,115,58,57,12,-5,17,52,14,25,-1,9,16,14,6,16,8,10,5,38,8,9,-9,-1,11,14,-3,-3,-5,1,9,4,-3,-1,-4,-1,1,10,0,-2,-1,2,8,179,99,80,6,-1,7,16,11,67,64,13,4,11,12,25,44,2,7,5,-1,42,20,11,-3,2,0,2,-4,6,0,2,-3,-3,-2,3,2,0,3,5,-2,3,-2
46,46177,Museros,4166,23,6,17,23,14,9,7,1,14,1,1,2,5,0,2,-1,0,2,2,1,12,2,1,0,5,6,9,2,1,0,2,6,4,2,0,0,3,0,5,0,1,0,93,54,39,32,17,15,9,24,24,24,9,2,3,10,17,15,8,1,6,14,7,9,1,1,3,11,11,7,0,0,2,6,5,4,0,0,1,5,6,3,0,0,92,38,54,30,13,17,17,24,34,11,5,-3,12,6,17,2,1,-1,5,18,17,9,4,-2,5,8,10,6,0,1,2,2,7,2,0,0,3,6,3,4,0,1,243,122,121,54,27,27,39,44,86,37,19,15,19,26,43,15,10,7,20,18,43,22,9,8,9,13,17,13,1,0,7,6,6,8,0,0,2,7,11,5,1,0,53,24,29,45,17,28,5,14,6,10,7,9,4,6,4,5,4,2,1,8,2,5,3,7,3,12,14,11,5,0,2,7,2,5,1,0,1,5,12,6,4,0,136,78,58,18,7,11,16,31,41,15,18,13,13,9,31,8,7,7,3,22,10,7,11,6,1,8,5,1,2,1,1,3,2,0,0,1,0,5,3,1,2,0,118,68,50,33,14,19,18,20,52,23,3,3,10,10,37,6,5,0,8,10,15,17,-2,3,6,7,12,5,2,0,2,3,4,3,2,0,4,4,8,2,0,0,131,76,55,40,19,21,22,33,57,19,-1,6,9,15,34,17,1,2,13,18,23,2,-2,4,7,12,12,3,6,2,4,4,7,3,1,1,3,8,5,0,5,1,183,85,98,37,12,25,24,30,69,25,2,19,10,9,38,14,0,10,14,21,31,11,2,9,12,11,4,7,0,1,6,4,2,1,-2,1,6,7,2,6,2,0,56,23,33,13,3,10,2,4,32,8,8,-7,-3,-5,22,5,3,-4,5,9,10,3,5,-3,4,4,6,0,-3,2,0,1,3,0,-2,1,4,3,3,0,-1,1,3,-1,4,-54,-32,-22,-10,20,20,-18,0,-9,-8,12,9,-11,1,-6,-2,8,11,-7,-1,-3,-8,-2,-16,-21,-3,-4,0,-2,-10,-17,-1,-2,-8,0,-6,-4,-2,-2,221,116,105,56,35,21,20,31,97,44,16,6,7,14,53,27,8,3,13,17,44,17,8,3,9,13,13,14,6,0,4,6,11,8,5,0,5,7,2,6,1,0,22,12,10,15,12,3,-10,15,4,8,1,7,-10,10,5,8,-1,0,0,5,-1,0,2,7,5,4,4,1,2,-1,2,4,4,1,2,-1,3,0,0,0,0,0,25,16,9,-15,-14,-1,-1,16,6,10,-7,-2,5,0,10,6,-6,-1,-6,16,-4,4,-1,-1,-3,4,-11,-3,-3,1,-1,1,-6,-4,-4,0,-2,3,-5,1,1,1,-52,-37,-15,0,-4,4,-23,-2,-10,-15,1,-5,-18,-3,-9,-9,1,0,-5,1,-1,-6,0,-5,-1,-1,0,-1,1,1,-4,-3,-2,2,1,1,3,2,2,-3,0,0,48,16,32,15,-5,20,14,23,-2,-9,17,5,14,7,-3,-14,7,5,0,16,1,5,10,0,5,4,2,0,1,1,1,-2,-2,-1,-1,0,4,6,4,1,2,1,-32,-19,-13,28,16,12,5,-8,0,-12,-1,-10,0,-5,1,-4,-4,-2,5,-3,-1,-8,3,-8,5,4,6,6,5,1,4,3,3,3,2,1,1,1,3,3,3,0,55,48,7,31,20,11,23,17,6,24,-15,1,17,10,3,20,-3,0,6,7,3,4,-12,1,5,6,8,5,3,3,5,3,6,2,1,2,0,3,2,3,2,1
46,46178,Náquera,2574,161,97,64,22,14,8,21,6,60,44,22,2,15,7,28,29,11,3,6,-1,32,15,11,-1,5,1,11,3,2,0,3,0,8,2,1,0,2,1,3,1,1,0,171,86,85,43,24,19,32,-3,84,46,9,1,9,-1,47,24,6,-1,23,-2,37,22,3,2,4,5,18,9,5,2,2,2,11,5,3,1,2,3,7,4,2,1,331,180,151,34,17,17,54,37,104,76,39,12,36,18,54,39,22,7,18,19,50,37,17,5,6,8,8,6,5,1,4,3,5,2,2,1,2,5,3,4,3,0,306,156,150,40,17,23,54,34,115,68,36,-5,30,13,54,39,18,0,24,21,61,29,18,-5,12,10,10,2,5,1,4,4,5,1,2,1,8,6,5,1,3,0,285,151,134,29,15,14,48,19,144,76,3,-8,23,3,81,43,3,-3,25,16,63,33,0,-5,5,2,5,7,8,1,3,1,4,2,4,1,2,1,1,5,4,0,294,160,134,24,12,12,52,22,123,74,15,-1,24,12,66,41,12,0,28,10,57,33,3,-1,6,4,2,12,1,-1,1,4,4,5,0,-1,5,0,-2,7,1,0,317,170,147,23,12,11,45,35,128,57,28,17,29,13,72,29,15,10,16,22,56,28,13,7,3,1,2,3,4,7,2,0,1,2,2,3,1,1,1,1,2,4,387,200,187,37,22,15,63,51,156,86,19,7,26,20,91,48,9,1,37,31,65,38,10,6,6,5,15,7,1,1,4,2,12,3,0,0,2,3,3,4,1,1,389,198,191,24,17,7,63,34,170,68,19,19,33,10,93,38,7,10,30,24,77,30,12,9,0,4,9,8,3,0,0,3,4,8,2,0,0,1,5,0,1,0,0,28,-28,0,0,0,-30,-6,28,-9,1,19,-14,-11,36,1,5,12,-16,5,-8,-10,-4,7,1,0,3,0,-4,0,1,0,0,0,-1,0,0,0,3,0,-3,0,-89,-37,-52,-4,-4,0,-36,-10,-12,-9,-17,1,-10,-8,0,-4,-12,-2,-26,-2,-12,-5,-5,3,0,-1,0,-4,2,-1,1,-1,-1,-2,0,-1,-1,0,1,-2,2,0,13,-4,17,20,10,10,-17,4,27,3,-12,9,-17,4,20,-2,-11,4,0,0,7,5,-1,5,2,-1,7,7,1,3,1,-1,5,2,1,2,1,0,2,5,0,1,-52,-18,-34,11,4,7,-31,-7,6,-31,0,11,-16,-1,9,-11,-2,2,-15,-6,-3,-20,2,9,4,4,1,2,3,-3,2,3,-1,0,2,-2,2,1,2,2,1,-1,47,30,17,2,-4,6,6,6,24,3,-9,20,16,0,14,8,-6,3,-10,6,10,-5,-3,17,-2,-3,-1,3,1,3,-4,-2,-5,4,2,1,2,-1,4,-1,-1,2,73,35,38,34,16,18,27,3,7,-4,13,30,27,-2,-5,-4,10,10,0,5,12,0,3,20,13,4,14,3,1,-1,9,1,6,0,0,0,4,3,8,3,1,-1,-23,-9,-14,16,11,5,-20,-15,4,20,-15,4,-14,-3,7,8,-6,-1,-6,-12,-3,12,-9,5,4,1,-2,9,3,1,3,1,-1,6,1,1,1,0,-1,3,2,0,8,8,0,14,5,9,-19,4,26,9,-21,10,-9,4,13,8,-13,4,-10,0,13,1,-8,6,1,3,4,2,1,2,1,1,1,-1,0,3,0,2,3,3,1,-1,75,25,50,28,9,19,1,17,24,16,13,-4,3,8,13,-7,5,2,-2,9,11,23,8,-6,3,6,9,-1,3,5,0,2,3,1,-1,3,3,4,6,-2,4,2
46,46181,Oliva,20656,179,86,93,37,18,19,23,7,51,36,32,32,6,0,30,17,17,15,17,7,21,19,15,17,7,4,6,6,10,4,3,3,3,2,5,2,4,1,3,4,5,2,-194,-94,-100,11,5,6,-20,-31,-86,-30,-5,-18,-8,-7,-43,-22,-5,-9,-12,-24,-43,-8,0,-9,2,1,3,3,2,0,1,0,3,1,0,0,1,1,0,2,2,0,-13,21,-34,0,1,-1,-2,3,-26,17,-5,3,6,5,0,16,-2,-5,-8,-2,-26,1,-3,8,4,-2,1,-1,-4,2,3,-2,2,0,-4,2,1,0,-1,-1,0,0,266,124,142,146,83,63,27,40,45,71,48,25,12,27,28,28,19,3,15,13,17,43,29,22,12,34,29,43,25,1,4,22,16,26,13,0,8,12,13,17,12,1,1186,652,534,1076,583,493,176,240,318,199,177,62,82,131,186,113,104,31,94,109,132,86,73,31,164,219,284,188,174,38,79,112,169,100,98,21,85,107,115,88,76,17,1174,657,517,995,547,448,209,216,310,207,163,60,127,125,177,118,76,30,82,91,133,89,87,30,162,193,259,181,151,40,90,100,142,108,80,23,72,93,117,73,71,17,1066,591,475,1152,624,528,152,250,300,200,110,37,76,135,185,101,58,24,76,115,115,99,52,13,187,250,312,240,126,27,99,132,180,127,63,19,88,118,132,113,63,8,878,506,372,1000,565,435,125,224,240,158,97,25,70,114,138,120,51,12,55,110,102,38,46,13,124,245,287,194,117,26,64,128,165,127,64,15,60,117,122,67,53,11,205,114,91,349,175,174,-6,44,44,43,64,22,-8,12,37,27,39,10,2,32,7,16,25,12,50,88,85,42,61,19,27,44,40,22,31,8,23,44,45,20,30,11,55,29,26,149,95,54,-15,26,-45,14,40,28,-9,24,-33,16,20,8,-6,2,-12,-2,20,20,-2,60,25,30,27,3,2,39,21,17,11,2,-4,21,4,13,16,1,-333,-181,-152,-149,-85,-64,-47,8,-139,-131,-26,2,-17,-9,-67,-74,-18,2,-30,17,-72,-57,-8,0,0,2,-61,-77,-6,-7,5,-9,-35,-47,0,1,-5,11,-26,-30,-6,-8,-102,-114,12,-106,-77,-29,-23,1,-36,-38,-15,-1,-10,-8,-42,-43,-1,-16,-13,9,6,5,-14,15,-27,21,-25,-41,-20,-16,-1,-6,-17,-35,-9,-12,-26,27,-8,-6,-11,-4,-322,-233,-89,-443,-294,-149,-40,-42,-112,-146,-15,22,-14,-24,-89,-94,-11,-4,-26,-18,-23,-52,-4,26,-48,-32,-162,-127,-31,-47,-20,-23,-116,-90,-20,-25,-28,-9,-46,-37,-11,-22,-856,-506,-350,-829,-495,-334,-74,-53,-163,-230,-192,-149,-28,-28,-103,-162,-101,-91,-46,-25,-60,-68,-91,-58,-68,-35,-119,-237,-198,-177,-29,-25,-83,-158,-110,-95,-39,-10,-36,-79,-88,-82,-346,-225,-121,-316,-198,-118,27,-26,-88,-134,-87,-36,2,-20,-45,-82,-47,-30,25,-6,-43,-52,-40,-6,-5,-12,-81,-92,-70,-59,2,-13,-52,-56,-40,-40,-7,1,-29,-36,-30,-19,-471,-284,-187,-427,-259,-168,-25,-43,-155,-200,-25,-27,-11,-30,-85,-129,-17,-15,-14,-13,-70,-71,-8,-12,-23,-29,-129,-157,-49,-45,-16,-24,-65,-106,-29,-22,-7,-5,-64,-51,-20,-23,-123,-83,-40,-54,-25,-29,-20,-4,-82,-16,-16,11,2,-1,-73,-19,5,0,-22,-3,-9,3,-21,11,6,26,-38,-13,-24,-17,16,11,-27,-20,-2,-8,-10,15,-11,7,-22,-9,-41,-56,15,43,16,27,29,-24,-86,-25,58,11,4,-9,-45,-27,18,7,25,-15,-41,2,40,4,20,11,-27,4,38,-5,20,10,-22,-8,14,1,0,1,-5,12,24,-6
46,46183,"Olleria, l'",7071,97,52,45,65,44,21,15,31,39,9,0,3,9,18,20,3,0,1,6,13,19,6,0,2,1,17,27,18,2,0,0,12,18,13,1,0,1,5,9,5,1,0,158,99,59,154,96,58,8,36,62,40,7,2,-2,25,44,25,5,2,10,11,18,15,2,0,12,31,62,35,11,0,5,21,41,21,8,0,7,10,21,14,3,0,131,76,55,187,106,81,31,48,32,27,-3,-2,19,20,25,13,1,-2,12,28,7,14,-4,0,37,46,67,34,3,0,23,21,39,21,2,0,14,25,28,13,1,0,157,74,83,174,87,87,41,58,10,32,13,0,19,17,9,18,11,0,22,41,1,14,2,0,42,51,35,33,11,1,22,21,20,16,7,1,20,30,15,17,4,0,196,94,102,173,95,78,47,31,62,42,19,-8,15,14,33,22,11,-3,32,17,29,20,8,-5,35,27,50,40,20,0,15,16,27,24,12,0,20,11,23,16,8,0,88,48,40,126,69,57,23,16,14,13,19,3,8,7,6,18,7,1,15,9,8,-5,12,2,33,20,31,19,19,4,15,11,19,14,9,1,18,9,12,5,10,3,267,158,109,219,121,98,82,55,60,41,21,7,50,31,44,16,11,5,32,24,16,25,10,2,57,60,51,34,12,4,32,35,28,17,7,2,25,25,23,17,5,2,374,180,194,278,138,140,72,83,92,86,25,8,39,28,47,50,10,4,33,55,45,36,15,4,49,70,72,65,14,4,26,27,37,40,6,2,23,43,35,25,8,2,110,41,69,120,60,60,10,27,31,27,10,3,5,7,14,9,5,-1,5,20,17,18,5,4,19,34,26,25,12,3,13,8,18,13,7,1,6,26,8,12,5,2,-1,-3,2,35,10,25,-11,16,-18,7,7,-4,-8,11,-4,0,4,-5,-3,5,-14,7,3,1,4,13,1,11,4,0,-2,9,-2,4,1,0,6,4,3,7,3,0,27,13,14,36,23,13,5,0,-1,18,-7,13,-1,4,-9,12,-2,7,6,-4,8,6,-5,6,8,11,6,5,-1,3,6,8,3,0,2,1,2,3,3,5,-3,2,-38,-46,8,-33,-32,-1,-6,4,-30,-20,4,7,-11,-3,-20,-19,4,2,5,7,-10,-1,0,5,2,2,-13,-16,-10,1,0,-5,-8,-14,-5,0,2,7,-5,-2,-5,1,-55,-30,-25,-63,-28,-35,-17,-17,-24,-17,18,3,-4,-13,-15,-10,10,2,-13,-4,-9,-7,8,1,-14,-19,-9,-21,4,-4,-3,-9,-5,-13,3,-1,-11,-10,-4,-8,1,-3,-30,-24,-6,-14,-19,5,-12,-8,-7,-17,4,8,-9,-5,-4,-15,5,2,-3,-3,-3,-2,-1,6,0,-5,-3,-10,2,1,-3,-7,-3,-7,0,0,3,2,0,-3,2,1,-49,-16,-33,-6,3,-9,-15,-3,-27,-26,7,15,-11,6,-8,-11,2,7,-4,-9,-19,-15,5,8,-2,2,-2,-9,4,0,0,4,5,-5,-1,0,-2,-2,-7,-4,5,0,43,13,30,-3,-14,11,31,6,1,-6,-12,19,17,-1,-6,-1,-6,7,14,7,7,-5,-6,12,12,7,-6,-7,-14,1,5,0,-8,-4,-8,-1,7,7,2,-3,-6,2,33,17,16,46,29,17,1,13,-4,1,1,21,6,3,-5,5,-1,8,-5,10,1,-4,2,13,5,18,3,20,1,-2,10,6,1,12,1,-2,-5,12,2,8,0,0,49,13,36,25,9,16,3,-2,5,23,-10,29,0,-4,8,6,-6,9,3,2,-3,17,-4,20,11,2,1,16,-5,0,6,0,1,5,-3,0,5,2,0,11,-2,0
46,46182,Olocau,816,56,43,13,14,9,5,7,16,14,8,8,1,7,12,10,5,5,1,0,4,4,3,3,0,1,1,9,0,3,0,1,0,6,0,2,0,0,1,3,0,1,0,39,18,21,4,1,3,4,2,9,21,3,0,1,0,4,10,3,0,3,2,5,11,0,0,1,0,2,1,0,0,0,0,0,1,0,0,1,0,2,0,0,0,94,47,47,6,3,3,4,0,26,25,20,18,7,-5,11,15,10,9,-3,5,15,10,10,9,3,0,2,1,1,-1,2,0,0,1,1,-1,1,0,2,0,0,0,89,43,46,26,10,16,6,6,19,39,17,4,3,3,9,22,7,0,3,3,10,17,10,4,5,1,2,9,8,1,2,0,0,6,3,-1,3,1,2,3,5,2,63,26,37,44,18,26,12,5,19,9,19,-3,-1,1,12,6,7,1,13,4,7,3,12,-4,15,1,5,8,11,3,5,0,2,5,4,2,10,1,3,3,7,1,80,52,28,32,17,15,23,-1,19,27,8,-1,15,1,9,16,7,1,8,-2,10,11,1,-2,10,1,4,9,6,2,7,0,1,4,4,1,3,1,3,5,2,1,93,52,41,13,7,6,14,4,25,30,25,-2,4,3,14,16,15,1,10,1,11,14,10,-3,1,-1,-3,6,8,1,2,0,-2,2,4,1,-1,-1,-1,4,4,0,64,39,25,-1,3,-4,8,11,38,15,-1,-7,6,4,24,13,-1,-6,2,7,14,2,0,-1,-2,2,0,-1,1,-1,0,1,1,-1,2,0,-2,1,-1,0,-1,-1,47,31,16,-3,-3,0,13,4,11,10,5,7,12,2,6,6,5,3,1,2,5,4,0,4,3,0,-1,-5,0,0,1,0,-1,-3,0,0,2,0,0,-2,0,0,-6,-1,-5,-19,-10,-9,-15,7,1,4,-2,2,-5,3,0,6,-5,1,-10,4,1,-2,3,1,-3,0,2,-4,-7,-6,-1,1,0,-3,-5,-2,-2,-1,2,-1,-2,-4,31,15,16,-2,-1,-1,-4,8,15,0,18,-3,-1,2,7,1,10,-2,-3,6,8,-1,8,-1,-4,0,0,0,3,-1,-1,-2,0,1,2,-1,-3,2,0,-1,1,0,130,74,56,23,10,13,28,5,32,29,20,16,18,3,11,24,11,7,10,2,21,5,9,9,4,0,2,4,8,5,1,0,1,2,3,3,3,0,1,2,5,2,5,16,-11,-14,2,-16,2,-12,2,16,-1,-4,2,-3,7,10,3,-4,0,-9,-5,6,-4,0,-3,-1,-1,-2,-6,-2,0,2,1,0,0,-2,-3,-3,-2,-2,-6,0,6,0,6,-5,-5,0,-1,2,-2,-2,4,5,1,1,0,-6,2,1,-2,1,-2,4,2,4,1,1,-2,-4,-2,1,-1,0,0,-3,-2,1,2,1,-2,-1,0,0,35,24,11,-21,-5,-16,10,4,8,21,-3,-4,7,1,5,12,2,-3,3,3,3,9,-5,-1,0,-5,-5,-3,-5,-3,2,-3,-3,1,-1,-1,-2,-2,-2,-4,-4,-2,22,7,15,-4,-6,2,2,0,1,12,3,3,0,-1,-3,7,2,3,2,1,4,5,1,0,-2,0,-4,1,0,0,-1,0,-3,0,-1,-1,-1,0,-1,1,1,1,76,41,35,18,8,10,15,8,7,27,10,8,4,7,2,17,4,6,11,1,5,10,6,2,2,1,0,2,9,4,0,1,-1,1,4,3,2,0,1,1,5,1,22,10,12,10,2,8,8,13,3,-1,6,-9,4,0,0,-1,11,-5,4,13,3,0,-5,-4,4,4,3,-3,2,-1,2,2,0,-3,2,-1,2,2,3,0,0,0
46,46184,Ontinyent,31530,155,75,80,30,19,11,44,28,58,18,-3,6,26,9,28,12,-3,1,18,19,30,6,0,5,6,8,9,1,4,2,5,5,5,0,3,1,1,3,4,1,1,1,761,425,336,702,401,301,157,250,208,117,14,12,94,140,122,67,1,1,63,110,86,50,13,11,143,223,191,110,28,4,77,135,111,65,10,3,66,88,80,45,18,1,690,412,278,653,392,261,154,193,172,105,38,28,97,113,106,65,20,9,57,80,66,40,18,19,146,187,177,105,26,7,90,119,104,59,13,4,56,68,73,46,13,3,311,186,125,460,256,204,58,126,73,28,22,7,46,75,34,19,14,1,12,51,39,9,8,6,90,138,126,69,28,7,56,78,61,44,11,5,34,60,65,25,17,2,478,298,180,556,341,215,79,108,81,116,70,21,53,56,73,61,40,13,26,52,8,55,30,8,79,153,159,115,43,4,48,90,110,66,24,2,31,63,49,49,19,2,653,347,306,631,353,278,122,149,181,94,68,27,64,93,82,59,30,13,58,56,99,35,38,14,107,159,189,107,52,11,55,88,111,61,28,7,52,71,78,46,24,4,1006,549,457,950,523,427,212,232,286,193,60,16,110,134,166,95,34,7,102,98,120,98,26,9,173,239,285,180,61,6,97,131,164,94,32,2,76,108,121,86,29,4,773,429,344,950,556,394,140,233,164,191,37,2,54,132,105,117,19,-2,86,101,59,74,18,4,151,263,255,201,60,10,70,147,169,128,33,3,81,116,86,73,27,7,57,51,6,215,106,109,40,35,-14,-15,20,-7,45,8,-5,-8,12,-5,-5,27,-9,-7,8,-2,42,77,45,26,15,3,24,44,16,9,7,1,18,33,29,17,8,2,67,73,-6,244,165,79,-9,58,-54,37,-2,31,4,36,-22,35,8,9,-13,22,-32,2,-10,22,21,94,51,61,9,0,16,57,35,45,12,-4,5,37,16,16,-3,4,-477,-299,-178,-218,-145,-73,-54,-50,-188,-151,-36,-9,-53,-24,-102,-100,-23,1,-1,-26,-86,-51,-13,-10,-1,20,-100,-97,-28,-17,-12,9,-58,-63,-14,-8,11,11,-42,-34,-14,-9,-489,-308,-181,-358,-234,-124,-94,-41,-156,-128,-55,-20,-50,-17,-103,-82,-44,-13,-44,-24,-53,-46,-11,-7,-78,-5,-99,-110,-48,-21,-37,-9,-66,-74,-34,-14,-41,4,-33,-36,-14,-7,-35,-18,-17,1,-10,11,6,5,-58,-14,-8,23,-2,3,-41,-4,11,11,8,2,-17,-10,-19,12,-5,11,-4,-16,5,1,-5,0,-4,-13,4,4,0,11,0,-3,1,-3,-856,-509,-347,-664,-412,-252,-129,-127,-249,-244,-92,-15,-69,-79,-136,-158,-61,-5,-60,-48,-113,-86,-31,-10,-85,-93,-197,-186,-80,-26,-45,-64,-124,-121,-49,-10,-40,-29,-73,-65,-31,-16,-529,-270,-259,-460,-246,-214,-58,-79,-184,-160,-55,5,-28,-51,-82,-87,-26,4,-30,-28,-102,-73,-29,1,-78,-60,-131,-126,-43,-23,-39,-30,-68,-74,-26,-10,-39,-30,-63,-52,-17,-13,-47,-19,-28,-32,-20,-12,-41,-21,-40,18,7,23,-13,-10,-12,10,-6,10,-28,-11,-28,8,13,13,-19,14,-28,-6,0,4,-8,11,-12,-11,-5,3,-11,3,-16,5,5,1,-116,-81,-35,-74,-53,-21,-31,6,-81,-24,3,3,-25,4,-48,-27,9,-1,-6,2,-33,3,-6,4,-19,13,-39,-33,6,-6,-13,5,-26,-21,5,-5,-6,8,-13,-12,1,-1,127,66,61,85,37,48,50,31,-22,28,18,27,21,23,2,13,2,11,29,8,-24,15,16,16,23,39,4,14,-2,5,12,20,3,11,-9,0,11,19,1,3,7,5
46,46186,Paiporta,17782,214,99,115,8,5,3,43,51,61,32,10,19,22,21,34,6,8,8,21,30,27,26,2,11,0,6,1,1,0,0,0,3,1,1,0,0,0,3,0,0,0,0,611,354,257,93,53,40,56,189,256,73,16,21,34,103,160,41,9,8,22,86,96,32,7,13,13,24,35,15,3,1,7,15,18,10,2,0,6,9,17,5,1,1,419,217,202,8,2,6,61,128,180,47,10,-6,32,63,99,24,3,-2,29,65,81,23,7,-4,4,1,1,1,1,0,0,0,0,1,1,0,4,1,1,0,0,0,258,161,97,19,11,8,9,84,146,8,5,3,10,39,100,12,-3,2,-1,45,46,-4,8,1,2,3,7,6,1,0,2,2,2,5,0,0,0,1,5,1,1,0,611,341,270,155,78,77,27,163,374,44,3,0,29,75,216,18,2,2,-2,88,158,26,1,-2,15,39,65,28,3,4,8,18,35,12,3,1,7,21,30,16,0,3,498,279,219,141,85,56,63,124,246,42,10,10,52,72,135,18,0,2,11,52,111,24,10,8,25,35,59,15,7,0,11,22,38,8,6,0,14,13,21,7,1,0,509,245,264,165,79,86,24,132,285,41,35,-7,-13,63,158,28,13,-7,37,69,127,13,22,0,37,40,51,25,9,2,12,26,26,11,2,1,25,14,25,14,7,1,518,289,229,187,85,102,71,104,234,63,34,3,44,52,122,44,16,6,27,52,112,19,18,-3,35,50,56,35,10,0,12,25,26,19,4,-1,23,25,30,16,6,1,230,95,135,174,73,101,-14,126,94,17,5,7,-3,51,60,5,-11,-1,-11,75,34,12,16,8,37,55,41,24,15,-1,15,22,20,10,3,1,22,33,21,14,12,-2,342,120,222,107,44,63,5,91,167,19,32,31,-2,34,70,-6,8,17,7,57,97,25,24,14,24,21,42,11,7,1,9,6,22,7,1,-1,15,15,20,4,6,2,172,46,126,-7,-4,-3,-11,54,136,-49,36,14,-17,12,72,-33,12,7,6,42,64,-16,24,7,-6,5,-4,-8,8,-2,-3,-1,-1,-3,5,-1,-3,6,-3,-5,3,-1,116,29,87,37,11,26,-3,2,69,-13,24,26,-2,-6,15,-9,14,9,-1,8,54,-4,10,17,8,18,-1,5,3,3,3,7,-3,2,0,1,5,11,2,3,3,2,103,23,80,-3,-12,9,-27,57,59,-6,0,27,-14,14,34,-4,-6,6,-13,43,25,-2,6,21,0,4,0,-9,-2,2,-2,-3,4,-10,-2,1,2,7,-4,1,0,1,4,-30,34,-115,-75,-40,19,-1,7,-21,-27,27,2,-1,5,-30,-16,8,17,0,2,9,-11,19,-4,-1,-56,-41,-15,1,0,-6,-33,-29,-7,0,-4,5,-23,-12,-8,1,-158,-76,-82,-29,-23,-6,-57,-1,6,-66,-38,-8,-30,7,14,-47,-23,-1,-27,-8,-8,-19,-15,-7,-5,4,-8,-18,3,-7,-4,3,-4,-17,0,-1,-1,1,-4,-1,3,-6,39,35,4,-15,-5,-10,-19,23,50,-10,12,-5,10,11,17,1,3,-2,-29,12,33,-11,9,-3,-3,1,-6,-9,2,-1,-1,3,-4,-5,2,0,-2,-2,-2,-4,0,-1,54,-32,86,61,14,47,26,1,28,-21,7,16,11,-3,-3,-30,-6,2,15,4,31,9,13,14,13,12,29,4,-3,3,3,3,13,-4,-4,2,10,9,16,8,1,1,-18,-56,38,43,3,40,-71,12,30,-27,8,36,-48,11,14,-43,0,16,-23,1,16,16,8,20,1,10,-2,17,5,12,-6,2,-3,3,3,4,7,8,1,14,2,8
46,46187,Palma de Gandía,1523,35,23,12,20,11,9,-1,11,1,8,14,3,5,5,0,2,9,3,-6,6,1,6,5,0,2,1,0,4,11,2,1,0,0,3,6,1,1,1,0,1,5,1,33,13,20,11,5,6,2,11,4,13,7,-4,-1,4,3,6,4,-3,3,7,1,7,3,-1,0,0,0,6,5,0,0,0,0,2,3,0,0,0,0,4,2,0,11,6,5,19,9,10,-3,-1,0,2,15,-3,-3,1,1,1,8,-2,0,-2,-1,1,7,-1,0,2,3,3,11,0,0,1,2,1,5,0,0,1,1,2,6,0,98,57,41,55,30,25,23,10,23,23,13,5,9,8,13,12,10,4,14,2,10,11,3,1,12,6,12,9,11,5,4,5,6,5,7,3,8,1,6,4,4,2,53,29,24,43,25,18,7,14,11,9,11,-1,1,6,10,5,5,1,6,8,1,4,6,-2,6,9,8,5,11,4,4,6,4,3,6,2,2,3,4,2,5,2,54,23,31,34,17,17,20,7,18,3,5,1,8,3,7,1,5,-1,12,4,11,2,0,2,6,3,6,9,10,0,2,3,4,3,5,0,4,0,2,6,5,0,119,61,58,35,18,17,32,14,30,27,6,5,11,5,12,18,6,6,21,9,18,9,0,-1,9,3,3,9,7,4,3,3,3,3,3,3,6,0,0,6,4,1,10,16,-6,19,11,8,-3,5,8,8,-1,-6,3,8,6,4,-1,-3,-6,-3,2,4,0,-3,4,5,3,4,3,0,3,3,2,2,1,0,1,2,1,2,2,0,56,31,25,18,11,7,11,7,9,15,11,0,3,2,3,14,8,0,8,5,6,1,3,0,2,3,6,4,3,0,1,0,5,4,1,0,1,3,1,0,2,0,-33,-21,-12,7,1,6,-7,-3,-4,-12,-2,-5,-6,-1,-3,-6,-3,-2,-1,-2,-1,-6,1,-3,3,2,3,3,-1,-3,0,0,2,1,-1,-1,3,2,1,2,0,-2,15,4,11,19,9,10,10,-1,1,-1,6,4,7,0,-3,-1,2,2,3,-1,4,0,4,2,2,4,6,0,5,2,1,2,4,0,2,0,1,2,2,0,3,2,-23,-5,-18,11,8,3,-15,-3,-7,3,3,-3,-4,2,-5,-1,5,-2,-11,-5,-2,4,-2,-1,0,3,2,2,3,1,0,3,2,1,2,0,0,0,0,1,1,1,21,10,11,5,4,1,4,5,4,6,1,0,1,3,1,4,2,-1,3,2,3,2,-1,1,0,1,1,2,2,-1,0,0,0,2,2,0,0,1,1,0,0,-1,-97,-43,-54,-108,-55,-53,-9,-11,-10,-31,-16,-21,-3,0,-6,-18,-8,-8,-6,-11,-4,-13,-8,-13,-12,-12,-14,-29,-25,-17,-3,-2,-8,-18,-14,-10,-9,-10,-6,-11,-11,-7,-13,-8,-5,3,3,0,-13,-1,-2,-1,10,-5,-11,-1,0,-4,10,-2,-2,0,-2,3,0,-3,-1,-1,-1,0,6,0,-1,0,0,0,4,0,0,-1,-1,0,2,0,-9,-8,-1,8,5,3,-9,-9,-1,0,3,7,-7,0,-3,2,-2,2,-2,-9,2,-2,5,5,0,2,0,3,2,1,0,2,0,2,1,0,0,0,0,1,1,1,7,1,6,17,7,10,2,2,-1,-9,12,0,-2,0,1,-7,9,0,4,2,-2,-2,3,0,1,1,4,3,8,0,0,0,1,0,6,0,1,1,3,3,2,0,32,31,1,23,12,11,3,4,6,7,8,4,5,1,7,7,7,4,-2,3,-1,0,1,0,4,2,1,5,8,3,2,1,0,3,3,3,2,1,1,2,5,0
46,46190,Paterna,47190,-593,-280,-313,61,24,37,-135,-83,-125,-153,-52,-43,-66,-43,-35,-85,-25,-25,-69,-40,-90,-68,-27,-18,19,10,19,7,4,1,4,4,10,4,0,1,15,6,9,3,4,0,396,246,150,255,145,110,38,71,172,77,-2,34,23,65,108,41,-13,19,15,6,64,36,11,15,42,55,85,49,18,5,25,34,51,26,7,2,17,21,34,23,11,3,463,182,281,342,172,170,105,47,162,90,-23,66,52,10,70,44,-22,16,53,37,92,46,-1,50,95,70,81,65,19,5,53,30,39,39,10,0,42,40,42,26,9,5,1233,676,557,420,203,217,147,151,625,194,4,80,78,72,350,135,1,25,69,79,275,59,3,55,78,95,128,73,27,10,29,42,76,39,10,2,49,53,52,34,17,8,2504,1299,1205,587,302,285,411,383,1071,410,111,76,201,185,570,239,57,30,210,198,501,171,54,46,88,144,208,87,39,17,39,77,106,53,18,8,49,67,102,34,21,9,1965,1071,894,539,282,257,323,297,968,254,34,58,171,151,563,141,7,21,152,146,405,113,27,37,91,155,147,82,40,20,50,87,76,42,17,7,41,68,71,40,23,13,2114,1075,1039,857,400,457,301,352,883,360,129,58,162,151,458,211,66,10,139,201,425,149,63,48,188,175,248,166,52,20,102,68,113,89,14,8,86,107,135,77,38,12,2106,1092,1014,642,311,331,279,367,1006,275,97,69,128,174,573,141,49,22,151,193,433,134,48,47,148,192,160,96,24,12,58,97,84,48,12,6,90,95,76,48,12,6,1579,811,768,436,213,223,203,264,727,220,73,43,105,141,381,110,37,4,98,123,346,110,36,39,76,151,107,66,20,2,36,80,49,28,11,0,40,71,58,38,9,2,1232,525,707,129,32,97,160,182,579,193,18,98,85,70,255,68,-7,49,75,112,324,125,25,49,51,51,17,3,-7,9,32,11,-10,-12,0,7,19,40,27,15,-7,2,586,225,361,133,43,90,86,86,360,9,-2,42,53,39,167,-22,-15,2,33,47,193,31,13,40,9,53,42,7,4,11,8,24,18,-4,-6,2,1,29,24,11,10,9,-177,-165,-12,-390,-240,-150,-1,-47,-35,-60,-64,19,-42,-27,-28,-30,-33,-10,41,-20,-7,-30,-31,29,-72,-17,-118,-122,-42,-20,-50,-11,-72,-71,-27,-8,-22,-6,-46,-51,-15,-12,-557,-298,-259,-287,-181,-106,-76,-119,-157,-103,-99,12,-7,-57,-93,-64,-68,0,-69,-62,-64,-39,-31,12,-28,-22,-109,-76,-42,-12,-13,-20,-79,-49,-19,-5,-15,-2,-30,-27,-23,-7,-418,-224,-194,-225,-129,-96,-11,-1,-108,-220,-65,-9,9,-6,-78,-115,-28,-8,-20,5,-30,-105,-37,-1,-8,0,-97,-79,-25,-18,4,3,-59,-58,-9,-12,-12,-3,-38,-21,-16,-6,-220,-170,-50,-148,-102,-46,37,-53,-59,-74,-42,-22,15,-30,-58,-61,-25,-14,22,-23,-1,-13,-17,-8,36,-15,-62,-72,-26,-15,21,-12,-43,-51,-15,-9,15,-3,-19,-21,-11,-6,148,-27,175,142,44,98,44,-30,147,-58,-4,50,36,-50,35,-28,-28,13,8,20,112,-30,24,37,78,6,31,-3,16,9,30,-2,12,5,-4,0,48,8,19,-8,20,9,304,139,165,72,9,63,49,56,118,12,49,8,10,34,54,-3,30,7,39,22,64,15,19,1,24,30,-20,-6,20,12,19,17,-13,-33,8,4,5,13,-7,27,12,8,384,200,184,194,114,80,61,57,143,81,43,1,44,13,60,41,40,-6,17,44,83,40,3,7,49,55,38,11,33,7,38,28,22,-1,22,4,11,27,16,12,11,3
46,46191,Pedralba,2068,95,69,26,45,34,11,3,15,40,28,10,-1,-1,13,30,20,8,-1,4,2,10,8,2,0,0,9,22,13,1,0,0,5,16,12,1,0,0,4,6,1,0,0,105,74,31,88,65,23,8,32,32,22,10,1,4,20,30,14,7,-1,4,12,2,8,3,2,6,26,36,18,2,0,4,16,30,13,2,0,2,10,6,5,0,0,103,75,28,94,58,36,17,25,32,29,4,-5,11,16,31,15,4,-2,6,9,1,14,0,-3,12,25,31,24,1,0,6,15,22,13,2,0,6,10,9,11,-1,0,123,74,49,103,66,37,12,11,46,24,20,4,3,2,34,17,12,4,9,9,12,7,8,0,10,17,38,20,13,4,6,8,26,15,9,2,4,9,12,5,4,2,60,28,32,76,42,34,17,-5,18,11,13,5,11,-2,9,1,8,1,6,-3,9,10,5,4,17,7,20,12,19,1,8,7,11,5,10,1,9,0,9,7,9,0,13,9,4,6,2,4,28,6,-25,0,2,0,25,-1,-18,-1,1,3,3,7,-7,1,1,-3,16,5,-15,-2,1,0,14,2,-13,-2,1,0,2,3,-2,0,0,0,137,87,50,75,49,26,30,20,33,28,25,1,23,12,22,17,11,2,7,8,11,11,14,-1,8,19,23,13,10,2,10,11,14,8,4,2,-2,8,9,5,6,0,123,76,47,88,58,30,11,28,29,24,21,9,5,17,14,18,16,5,6,11,15,6,5,4,7,29,19,23,8,2,7,17,13,16,4,1,0,12,6,7,4,1,22,24,-2,16,13,3,-6,0,20,-1,9,0,-3,1,12,6,7,1,-3,-1,8,-7,2,-1,-1,4,5,7,-1,2,0,2,2,7,0,2,-1,2,3,0,-1,0,45,26,19,34,18,16,-5,13,8,19,10,0,-3,5,6,13,3,1,-2,8,2,6,7,-1,4,10,9,9,2,0,2,5,6,4,1,0,2,5,3,5,1,0,29,27,2,39,17,22,1,9,7,-4,12,5,5,7,4,2,9,0,-4,2,3,-6,3,5,11,5,11,8,3,1,6,2,4,4,1,0,5,3,7,4,2,1,-75,-63,-12,-110,-92,-18,-7,2,-20,-32,-20,0,-7,2,-13,-28,-14,-3,0,0,-7,-4,-6,3,1,-11,-32,-37,-21,-10,-4,-7,-26,-33,-13,-9,5,-4,-6,-4,-8,-1,-27,-17,-10,-32,-20,-12,8,-12,-18,-14,10,-1,5,-6,-16,-8,4,3,3,-6,-2,-6,6,-4,1,2,-15,-13,-2,-5,0,2,-9,-10,-2,-1,1,0,-6,-3,0,-4,-28,-28,0,-31,-24,-7,-7,-3,3,-12,-1,-7,-10,-1,-3,-9,-1,-4,3,-2,6,-3,0,-3,1,-4,-4,-15,-5,-4,-1,-3,-5,-10,-4,-1,2,-1,1,-5,-1,-3,-62,-34,-28,-46,-24,-22,-19,-6,-19,-6,-14,3,-9,1,-13,-8,-9,4,-10,-7,-6,2,-5,-1,-9,-2,-11,-9,-7,-8,-4,2,-10,-6,-4,-2,-5,-4,-1,-3,-3,-6,-22,-9,-13,35,21,14,-14,9,-7,-3,-2,-5,-9,8,-1,-3,1,-5,-5,1,-6,0,-3,0,1,5,3,9,7,10,-2,3,4,5,4,7,3,2,-1,4,3,3,-11,-7,-4,-7,-6,-1,5,0,3,-18,11,-10,4,1,-2,-10,5,-4,1,-1,5,-8,6,-6,-3,0,-4,-8,4,5,-1,1,-4,-5,1,3,-2,-1,0,-3,3,2,14,6,8,7,3,4,0,4,3,3,14,-9,4,5,-1,5,1,-7,-4,-1,4,-2,13,-2,13,0,-5,-3,9,-7,10,1,-2,-4,4,-6,3,-1,-3,1,5,-1
46,46193,Picanya,8791,83,33,50,40,22,18,26,1,6,24,14,12,8,1,4,8,8,3,18,0,2,16,6,9,6,10,11,5,7,0,4,3,10,1,3,0,2,7,1,4,4,0,183,106,77,104,63,41,45,26,40,43,7,18,20,8,32,33,2,8,25,18,8,10,5,10,16,31,32,14,4,5,7,17,23,10,2,2,9,14,9,4,2,3,256,133,123,132,82,50,64,23,55,54,19,37,27,14,45,24,12,9,37,9,10,30,7,28,25,31,39,25,9,2,11,20,30,15,5,1,14,11,9,10,4,1,113,67,46,94,44,50,49,-2,13,54,-8,4,29,-6,15,32,-6,-2,20,4,-2,22,-2,6,21,16,33,16,3,3,12,7,15,8,1,0,9,9,18,8,2,3,326,138,188,129,65,64,68,38,59,56,13,87,34,17,27,25,2,30,34,21,32,31,11,57,28,31,22,29,12,4,12,17,12,16,5,1,16,14,10,13,7,3,250,111,139,111,57,54,60,37,79,44,-5,27,26,9,31,26,-2,15,34,28,48,18,-3,12,21,34,33,15,6,0,12,13,21,7,3,0,9,21,12,8,3,0,330,145,185,96,45,51,64,20,110,66,5,61,30,15,57,29,-1,15,34,5,53,37,6,46,15,20,32,17,7,3,6,11,18,7,3,0,9,9,14,10,4,3,336,141,195,106,56,50,65,48,80,78,10,48,23,17,40,41,1,13,42,31,40,37,9,35,19,26,39,21,2,-2,5,10,27,13,1,0,14,16,12,8,1,-2,197,77,120,53,31,22,34,29,74,15,-6,46,17,18,28,3,-4,11,17,11,46,12,-2,35,5,12,21,8,5,2,3,8,12,5,2,1,2,4,9,3,3,1,33,2,31,-65,-46,-19,51,-11,-32,-5,10,16,26,-8,-20,-10,7,4,25,-3,-12,5,3,12,-4,-1,-19,-29,-7,-6,-4,2,-19,-19,-3,-3,0,-3,0,-10,-4,-3,90,16,74,0,-3,3,6,-2,25,-3,10,52,1,-4,8,-6,0,18,5,2,17,3,10,34,-2,15,-14,-9,8,0,-1,6,-8,-5,3,1,-1,9,-6,-4,5,-1,139,55,84,34,10,24,38,-13,29,33,13,37,20,0,9,17,-3,14,18,-13,20,16,16,23,7,5,7,8,5,2,1,0,0,6,3,0,6,5,7,2,2,2,90,46,44,9,-1,10,19,2,13,1,1,48,5,6,6,1,4,21,14,-4,7,0,-3,27,-1,8,1,-2,0,3,-5,6,1,-4,-1,2,4,2,0,2,1,1,21,-6,27,18,6,12,0,5,-46,-3,14,50,1,5,-24,-12,2,21,-1,0,-22,9,12,29,-1,7,6,0,3,3,-2,3,4,-1,1,1,1,4,2,1,2,2,147,76,71,21,13,8,36,11,31,35,21,14,19,17,7,15,17,0,17,-6,24,20,4,14,10,3,2,1,4,0,2,4,2,1,3,0,8,-1,0,0,1,0,-18,-19,1,-75,-42,-33,0,-11,-21,6,-23,26,4,-7,-11,3,-16,7,-4,-4,-10,3,-7,19,-11,-4,-31,-13,-15,-2,-2,-1,-15,-12,-9,-3,-9,-3,-16,-1,-6,1,45,35,10,25,16,9,16,13,16,-3,-15,21,14,5,15,3,-13,9,2,8,1,-6,-2,12,7,6,5,5,2,0,4,3,3,5,1,0,3,3,2,0,1,0,102,61,41,21,6,15,31,12,32,33,-10,-2,12,9,11,24,-4,5,19,3,21,9,-6,-7,9,3,0,7,-1,1,4,0,0,2,-1,1,5,3,0,5,0,0
46,46195,Piles,1963,105,63,42,48,30,18,15,23,39,24,2,2,9,12,22,19,0,1,6,11,17,5,2,1,2,15,16,10,2,3,0,8,13,7,1,1,2,7,3,3,1,2,155,83,72,110,59,51,21,35,49,23,18,7,10,16,26,14,11,4,11,19,23,9,7,3,24,23,34,16,10,2,13,10,17,11,6,1,11,13,17,5,4,1,55,25,30,44,22,22,8,5,17,15,6,3,1,4,14,6,0,0,7,1,3,9,6,3,12,9,8,13,2,0,5,5,7,5,0,0,7,4,1,8,2,0,110,79,31,82,47,35,7,29,36,21,13,1,11,18,22,16,7,2,-4,11,14,5,6,-1,18,16,20,19,6,1,10,8,13,11,2,1,8,8,7,8,4,0,110,56,54,105,55,50,1,27,34,25,20,1,1,15,19,11,10,-1,0,12,15,14,10,2,8,27,23,27,16,3,4,15,15,11,8,1,4,12,8,16,8,2,-15,-6,-9,24,13,11,-7,9,0,-4,-8,-3,-3,8,-2,-2,-4,-1,-4,1,2,-2,-4,-2,0,9,7,5,4,0,0,6,1,4,3,0,0,3,6,1,1,0,132,76,56,64,40,24,21,33,25,26,13,10,7,23,14,16,10,4,14,10,11,10,3,6,12,18,16,13,1,3,5,11,11,8,2,2,7,7,5,5,-1,1,81,51,30,49,28,21,9,20,30,19,6,-5,8,7,19,16,4,-3,1,13,11,3,2,-2,2,14,11,17,4,1,1,5,6,14,3,-1,1,9,5,3,1,2,90,43,47,33,13,20,19,5,28,30,12,-2,9,-2,22,15,4,-2,10,7,6,15,8,0,11,4,3,9,5,0,4,1,1,5,1,1,7,3,2,4,4,-1,-19,-24,5,-29,-17,-12,9,7,-10,-10,-9,-3,6,-3,-5,-5,-10,-4,3,10,-5,-5,1,1,0,0,-1,-20,-8,0,1,-1,1,-11,-6,-1,-1,1,-2,-9,-2,1,12,10,2,6,3,3,12,2,15,-4,-8,-5,8,-1,9,-1,-5,0,4,3,6,-3,-3,-5,2,3,5,-5,0,0,3,1,2,-4,1,-1,-1,2,3,-1,-1,1,37,26,11,7,2,5,6,4,5,1,16,2,7,6,5,-2,8,2,-1,-2,0,3,8,0,0,1,-1,-2,8,1,0,1,0,-2,3,0,0,0,-1,0,5,1,-24,-9,-15,-39,-22,-17,-11,2,1,-5,-14,-1,-9,-1,10,-1,-8,-1,-2,3,-9,-4,-6,0,-3,-1,-11,-15,-8,-2,-3,0,-5,-10,-4,0,0,-1,-6,-5,-4,-2,-20,-11,-9,4,1,3,-1,-3,2,1,-14,-2,-6,2,2,4,-10,-2,5,-5,0,-3,-4,0,2,0,4,1,-1,-2,2,0,2,0,-2,-1,0,0,2,1,1,-1,-35,-32,-3,-17,-11,-6,-1,-5,-6,-10,-8,-7,-3,-6,-11,-6,-4,-2,2,1,5,-4,-4,-5,-3,-2,-4,-5,-4,1,-1,0,-6,-3,-1,0,-2,-2,2,-2,-3,1,-75,-52,-23,-106,-68,-38,0,-8,-21,-20,-22,-6,2,-2,-15,-19,-13,-5,-2,-6,-6,-1,-9,-1,-10,-13,-23,-30,-23,-7,-2,-6,-16,-23,-16,-5,-8,-7,-7,-7,-7,-2,-27,-10,-17,-9,-5,-4,-16,8,-10,-1,0,-7,-4,-1,0,-1,1,-5,-12,9,-10,0,-1,-2,-1,2,-4,-1,-4,-1,1,0,-1,-2,-2,-1,-2,2,-3,1,-2,0,-17,11,-28,4,3,1,-7,-7,8,-13,6,-4,4,3,8,-11,6,0,-11,-10,0,-2,0,-4,3,3,0,-7,5,0,4,3,0,-8,4,0,-1,0,0,1,1,0
46,46202,"Pobla de Vallbona, la",11112,531,283,248,82,50,32,89,81,182,91,12,70,54,51,102,52,10,12,35,30,80,39,2,58,12,23,29,12,4,2,6,17,16,7,3,1,6,6,13,5,1,1,629,305,324,103,52,51,133,77,251,99,34,31,68,24,125,63,18,5,65,53,126,36,16,26,21,21,38,18,4,0,11,10,17,12,2,0,10,11,21,6,2,0,1167,572,595,188,105,83,192,173,421,193,81,100,85,83,208,110,45,35,107,90,213,83,36,65,40,49,47,39,9,3,18,31,28,21,4,2,22,18,19,18,5,1,813,393,420,141,69,72,77,98,346,153,49,81,42,39,182,73,26,29,35,59,164,80,23,52,26,29,42,27,11,3,10,16,19,18,5,1,16,13,23,9,6,2,1123,537,586,161,75,86,204,157,384,183,85,100,97,59,210,92,45,31,107,98,174,91,40,69,37,44,45,27,4,2,21,11,29,9,3,1,16,33,16,18,1,1,851,449,402,156,86,70,125,106,335,168,44,68,73,53,193,85,24,22,52,53,142,83,20,46,30,43,44,26,10,2,18,19,28,16,5,0,12,24,16,10,5,2,712,331,381,134,57,77,88,96,306,119,40,48,40,34,179,51,12,7,48,62,127,68,28,41,26,40,32,30,5,1,12,16,15,14,0,0,14,24,17,16,5,1,615,336,279,298,179,119,99,127,187,118,33,52,63,68,114,69,13,9,36,59,73,49,20,43,48,101,80,53,15,0,23,59,54,34,8,0,25,42,26,19,7,0,826,388,438,149,73,76,169,115,315,119,42,46,72,53,149,79,17,8,97,62,166,40,25,38,49,44,20,26,7,2,24,22,6,19,0,2,25,22,14,7,7,0,500,254,246,61,22,39,46,71,168,97,21,83,32,32,88,60,9,24,14,39,80,37,12,59,9,32,-1,22,-5,0,4,14,-8,14,-5,0,5,18,7,8,0,0,370,155,215,-27,-22,-5,52,47,131,67,22,47,37,13,58,20,8,19,15,34,73,47,14,28,-3,10,-21,-18,3,2,2,-3,-15,-10,3,2,-5,13,-6,-8,0,0,356,163,193,60,24,36,94,18,171,75,-5,12,57,-2,98,19,-13,7,37,20,73,56,8,5,20,16,-1,15,9,2,13,5,1,2,2,2,7,11,-2,13,7,0,236,141,95,-20,-26,6,3,77,123,15,-5,28,17,40,65,1,3,19,-14,37,58,14,-8,9,7,4,-14,-17,-5,2,5,-4,-13,-13,-3,1,2,8,-1,-4,-2,1,146,56,90,-19,-24,5,-27,15,84,6,36,34,-17,-8,43,7,24,7,-10,23,41,-1,12,27,19,-6,-1,-20,-12,0,15,-10,-9,-14,-6,0,4,4,8,-6,-6,0,169,71,98,-60,-40,-20,3,20,110,-9,-3,43,-2,5,61,-11,-3,13,5,15,49,2,0,30,-16,1,-16,-27,-7,3,-9,1,-4,-25,-4,1,-7,0,-12,-2,-3,2,447,202,245,109,55,54,92,24,141,80,21,86,42,24,74,26,7,27,50,0,67,54,14,59,45,14,4,22,13,5,28,10,0,7,6,0,17,4,4,15,7,5,288,156,132,57,23,34,32,11,88,52,23,77,8,4,43,49,18,29,24,7,45,3,5,48,8,7,25,8,-2,9,0,3,15,2,0,2,8,4,10,6,-2,7,354,129,225,56,22,34,56,47,98,40,32,67,35,16,41,-3,10,25,21,31,57,43,22,42,2,21,13,2,9,7,1,10,11,-5,-2,4,1,11,2,7,11,3
46,46200,"Pobla del Duc, la",2430,26,10,16,17,9,8,5,2,14,6,-1,1,2,2,4,2,0,0,3,0,10,4,-1,1,0,4,8,5,0,0,0,2,5,2,0,0,0,2,3,3,0,0,89,55,34,99,55,44,13,22,38,17,1,-2,7,15,24,9,1,0,6,7,14,8,0,-2,13,28,34,23,1,0,8,15,20,11,1,0,5,13,14,12,0,0,46,29,17,54,31,23,15,13,9,12,-2,-2,7,6,12,7,-2,-2,8,7,-3,5,0,0,14,11,15,13,-1,1,7,6,12,6,-1,0,7,5,3,7,0,1,19,10,9,38,16,22,11,7,-11,9,3,1,5,6,-7,5,1,0,6,1,-4,4,2,1,9,8,6,12,2,1,6,5,1,4,0,0,3,3,5,8,2,1,50,28,22,78,37,41,3,15,14,10,4,-3,2,10,12,-2,1,1,1,5,2,12,3,-4,7,18,26,13,7,0,2,11,15,2,3,0,5,7,11,11,4,0,-5,6,-11,19,19,0,-1,4,-2,-13,-3,3,1,7,0,-8,-1,3,-2,-3,-2,-5,-2,0,6,8,2,-2,0,0,4,9,5,-1,0,0,2,-1,-3,-1,0,0,-13,-7,-6,18,5,13,-1,-8,-1,-4,-1,2,2,-3,-4,-3,0,1,-3,-5,3,-1,-1,1,6,3,5,1,3,0,2,1,1,0,1,0,4,2,4,1,2,0,39,14,25,60,22,38,7,16,5,4,4,-2,1,6,4,2,0,0,6,10,1,2,4,-2,10,10,20,12,3,1,5,4,8,4,1,0,5,6,12,8,2,1,-6,-5,-1,10,6,4,0,1,-4,-4,-2,2,2,-3,-5,-1,1,1,-2,4,1,-3,-3,1,2,2,2,4,0,0,4,0,-1,2,1,0,-2,2,3,2,-1,0,-8,-3,-5,-9,-6,-3,1,-13,8,-2,0,-2,0,-6,6,-2,0,1,1,-7,2,0,0,-3,0,-2,-4,-4,2,0,0,-1,-2,-3,1,0,0,-1,-2,-1,1,0,17,7,10,14,8,6,6,12,-10,3,1,3,3,5,-5,0,1,2,3,7,-5,3,0,1,3,7,5,-2,-1,0,2,3,4,-1,-1,0,1,4,1,-1,0,0,13,6,7,17,1,16,0,9,0,11,1,-9,-3,4,4,8,-1,-6,3,5,-4,3,2,-3,1,8,1,6,0,0,-1,2,1,0,-1,0,2,6,0,6,1,0,17,1,16,8,2,6,7,-6,7,12,-2,-1,4,-9,3,5,-2,0,3,3,4,7,0,-1,0,-1,7,2,1,-1,0,-2,3,1,0,0,0,1,4,1,1,-1,15,7,8,1,-2,3,2,13,-8,9,4,-1,1,3,-6,6,3,1,1,10,-2,3,1,-2,-2,5,-3,3,-2,0,-2,2,-4,3,-1,0,0,3,1,0,-1,0,3,-11,14,-7,-3,-4,3,3,8,-9,1,-1,0,3,-5,-8,3,-2,3,0,13,-1,-2,1,1,-5,-1,-2,0,1,1,-1,-2,-1,0,1,0,-4,1,-1,0,0,-5,-1,-4,-4,-1,-3,-2,6,-8,2,-4,1,-1,4,-4,-1,-1,2,-1,2,-4,3,-3,-1,-1,7,-7,3,-7,1,0,3,-1,0,-3,0,-1,4,-6,3,-4,1,-12,-10,-2,16,4,12,-6,3,-3,-5,1,-2,-2,4,-5,-5,-1,-1,-4,-1,2,0,2,-1,-2,12,5,2,4,-5,-2,5,2,-1,2,-2,0,7,3,3,2,-3,-37,-15,-22,9,2,7,-8,-3,-20,-4,3,-6,-5,2,-7,-4,1,-3,-3,-5,-13,0,2,-3,2,2,-5,3,5,1,1,2,-4,0,2,1,1,0,-1,3,3,0
46,46203,"Pobla Llarga, la",4380,-13,0,-13,18,9,9,-4,-5,3,-5,-1,-3,-1,1,0,-3,1,0,-3,-6,3,-2,-2,-3,5,5,5,2,1,0,0,3,4,1,1,0,5,2,1,1,0,0,20,15,5,39,20,19,16,9,-10,4,1,0,12,6,-5,3,0,0,4,3,-5,1,1,0,8,14,8,8,0,0,4,8,4,4,0,0,4,6,4,4,0,0,69,39,30,57,37,20,14,13,15,10,7,8,3,13,5,11,2,3,11,0,10,-1,5,5,12,16,15,9,3,2,3,12,11,8,2,1,9,4,4,1,1,1,51,29,22,45,19,26,19,8,5,13,8,-1,11,6,4,6,4,-1,8,2,1,7,4,0,19,7,4,12,3,0,7,3,2,7,0,0,12,4,2,5,3,0,4,-11,15,38,20,18,-7,9,5,-3,-3,3,-4,3,1,-9,-1,1,-3,6,4,6,-2,2,6,11,9,11,0,1,4,6,5,5,0,0,2,5,4,6,0,1,-21,-14,-7,3,1,2,-6,-5,-12,8,-4,0,-3,-6,-2,-2,-2,2,-3,1,-10,10,-2,-2,4,0,2,-2,0,-1,3,0,0,-2,0,0,1,0,2,0,0,-1,32,4,28,9,1,8,12,17,-1,-2,1,2,1,13,-8,-4,1,0,11,4,7,2,0,2,2,5,1,-1,1,1,0,1,-2,1,1,0,2,4,3,-2,0,1,95,64,31,32,17,15,14,21,37,11,14,-4,10,8,30,7,6,1,4,13,7,4,8,-5,8,11,7,-3,5,3,4,7,3,1,0,1,4,4,4,-4,5,2,19,23,-4,-10,-7,-3,-2,10,13,-1,5,-8,0,7,10,4,6,-5,-2,3,3,-5,-1,-3,6,-3,-3,-3,-8,0,2,-2,-3,-2,-2,-1,4,-1,0,-1,-6,1,12,-4,16,6,1,5,7,16,11,-11,-5,-6,7,5,5,-8,-8,-3,0,11,6,-3,3,-3,5,5,1,-1,-2,-2,1,2,1,-1,-1,-1,4,3,0,0,-1,-1,12,4,8,10,6,4,8,-2,0,4,3,-1,2,-2,-3,0,5,1,6,0,3,4,-2,-2,6,1,6,-1,-1,-1,3,2,1,0,0,0,3,-1,5,-1,-1,-1,-25,-10,-15,11,2,9,-3,-7,-10,2,0,-4,2,0,-8,-2,-1,-1,-5,-7,-2,4,1,-3,7,1,0,4,1,-2,3,1,-1,-1,1,-1,4,0,1,5,0,-1,-21,-22,1,-22,-16,-6,7,-8,-11,0,-3,-7,0,-8,-11,-2,-3,0,7,0,0,2,0,-7,5,-5,-11,-7,-6,0,2,-2,-10,-5,-2,1,3,-3,-1,-2,-4,-1,-50,-18,-32,-5,-2,-3,-17,-8,-6,-7,-8,-5,-10,-3,-3,1,0,-3,-7,-5,-3,-8,-8,-2,-6,-1,2,0,-1,0,-5,-1,3,1,0,0,-1,0,-1,-1,-1,0,-6,-11,5,-11,-14,3,9,-2,-6,-6,7,-7,0,1,-6,-6,5,-5,9,-3,0,0,2,-2,-2,3,-8,-2,-3,1,-2,4,-9,-5,-2,0,0,-1,1,3,-1,1,17,0,17,-3,-3,0,4,2,-7,5,12,-3,2,1,-9,3,6,-4,2,1,2,2,6,1,2,-4,-3,2,0,0,1,-3,-2,1,0,0,1,-1,-1,1,0,0,-35,-5,-30,-3,0,-3,-12,3,-8,-10,-3,-9,-4,4,2,-7,-1,-3,-8,-1,-10,-3,-2,-6,-3,4,-3,0,1,-2,0,1,1,-1,0,-1,-3,3,-4,1,1,-1,27,17,10,7,4,3,9,3,10,7,-2,0,1,6,6,2,-1,2,8,-3,4,5,-1,-2,3,1,1,2,-2,0,1,3,0,-1,-1,0,2,-2,1,3,-1,0
46,46205,Puçol,14211,254,141,113,33,17,16,54,28,83,37,10,42,39,19,47,17,8,11,15,9,36,20,2,31,9,9,8,5,0,2,6,2,4,4,0,1,3,7,4,1,0,1,280,139,141,121,61,60,42,35,95,56,32,19,20,7,58,34,12,7,22,28,37,22,20,12,26,18,40,24,11,1,15,7,19,13,5,1,11,11,21,11,6,0,409,214,195,147,73,74,100,55,110,101,16,25,59,20,60,56,6,11,41,35,50,45,10,14,56,14,43,28,5,1,33,7,16,15,2,0,23,7,27,13,3,1,409,240,169,98,55,43,76,70,101,71,58,27,40,37,81,43,27,12,36,33,20,28,31,15,29,17,25,17,5,3,12,7,20,8,4,3,17,10,5,9,1,0,408,221,187,104,63,41,62,47,156,99,16,21,32,24,94,46,12,9,30,23,62,53,4,12,21,27,28,17,6,4,18,16,17,7,3,0,3,11,11,10,3,4,674,344,330,159,71,88,151,72,213,154,58,15,68,45,110,80,35,4,83,27,103,74,23,11,45,26,35,37,7,8,21,10,18,13,5,4,24,16,17,24,2,4,649,352,297,211,114,97,159,105,228,161,-5,0,86,46,127,96,-1,-4,73,59,101,65,-4,4,56,33,57,47,7,8,35,15,32,20,7,4,21,18,25,27,0,4,478,251,227,141,59,82,117,58,175,100,24,-4,49,31,93,54,13,2,68,27,82,46,11,-6,40,33,44,22,2,-2,16,12,17,13,1,-1,24,21,27,9,1,-1,362,181,181,194,92,102,57,67,113,77,44,12,27,29,72,36,14,9,30,38,41,41,30,3,47,37,44,38,25,0,27,14,17,22,11,0,20,23,27,16,14,0,161,92,69,40,4,36,18,11,58,45,22,-1,7,3,37,24,16,2,11,8,21,21,6,-3,10,24,5,-4,6,-1,-2,7,2,-9,5,1,12,17,3,5,1,-2,-64,-87,23,-95,-62,-33,-17,-1,0,-38,-16,5,-2,-11,-20,-43,-15,0,-15,10,20,5,-1,5,-19,-15,-4,-43,-16,-2,-8,-10,-5,-29,-11,-2,-11,-5,1,-14,-5,0,92,20,72,80,34,46,30,14,11,30,5,1,20,6,4,5,-14,-1,10,8,7,25,19,2,18,9,12,28,10,3,10,1,1,20,0,2,8,8,11,8,10,1,-151,-90,-61,-103,-64,-39,1,-32,-18,-71,-27,-3,6,-5,-27,-46,-14,-6,-5,-27,9,-25,-13,3,1,-10,-20,-49,-20,-6,6,-1,-19,-35,-12,-4,-5,-9,-1,-14,-8,-2,-15,1,-16,-34,-29,-5,35,-18,-27,-5,-6,9,25,-12,-6,-3,-3,1,10,-6,-21,-2,-3,8,6,-7,-5,-21,-6,-1,0,-10,-1,-12,-5,-1,6,3,-4,-9,-1,0,-49,-29,-20,33,21,12,24,-12,-15,-23,-24,-3,18,-9,-15,-15,-3,-6,6,-3,0,-8,-21,3,29,2,-9,7,1,1,14,5,-5,2,4,0,15,-3,-4,5,-3,1,144,60,84,154,78,76,65,27,31,27,-15,8,33,20,-5,6,0,7,32,7,36,21,-15,1,64,18,27,36,5,2,42,7,7,13,7,1,22,11,20,23,-2,1,44,11,33,31,11,20,24,-6,1,13,-13,19,0,-8,1,15,-4,4,24,2,0,-2,-9,15,34,6,12,-18,-4,1,13,3,7,-12,2,-2,21,3,5,-6,-6,3,-64,-75,11,36,-16,52,2,-20,31,-31,-39,-12,-8,-27,14,-28,-24,-6,10,7,17,-3,-15,-6,17,13,22,-4,-14,-1,1,-3,6,-7,-13,-1,16,16,16,3,-1,0
46,46204,Puig,7043,76,56,20,71,44,27,11,3,35,21,7,1,3,6,25,21,6,-3,8,-3,10,0,1,4,7,14,27,17,3,3,4,8,19,9,2,2,3,6,8,8,1,1,252,148,104,91,47,44,32,48,87,54,21,5,24,22,48,39,11,1,8,26,39,15,10,4,15,32,23,16,5,0,10,19,10,7,1,0,5,13,13,9,4,0,232,126,106,100,52,48,69,35,42,44,26,5,42,16,22,23,15,1,27,19,20,21,11,4,24,25,25,15,9,2,13,14,10,8,5,2,11,11,15,7,4,0,53,12,41,49,25,24,0,20,8,14,5,-2,4,10,-16,12,2,-6,-4,10,24,2,3,4,8,19,6,11,4,1,4,9,2,7,3,0,4,10,4,4,1,1,22,11,11,59,33,26,14,-20,29,9,-16,8,8,-9,25,-2,-12,1,6,-11,4,11,-4,7,12,9,15,15,7,0,5,5,9,8,5,0,7,4,6,7,2,0,137,61,76,63,38,25,29,15,64,31,-5,3,14,1,34,12,-3,0,15,14,30,19,-2,3,7,20,19,13,3,0,3,14,9,8,3,0,4,6,10,5,0,0,216,115,101,96,42,54,44,32,72,31,23,13,27,21,37,18,11,2,17,11,35,13,12,11,22,21,32,7,7,6,9,10,16,3,1,3,13,11,16,4,6,3,252,123,129,101,58,43,46,53,97,48,4,-2,25,35,43,21,0,-5,21,18,54,27,4,3,16,34,28,20,2,-2,10,24,13,11,0,0,6,10,15,9,2,-2,136,84,52,71,41,30,16,13,27,53,9,22,1,14,11,39,11,11,15,-1,16,14,-2,11,16,23,4,19,6,0,8,14,5,9,4,0,8,9,-1,10,2,0,217,74,143,42,23,19,21,8,7,53,28,98,1,7,3,22,13,29,20,1,4,31,15,69,11,7,3,11,6,3,5,4,2,7,4,1,6,3,1,4,2,2,187,93,94,6,0,6,33,18,44,43,19,28,18,8,20,27,15,3,15,10,24,16,4,25,10,4,-6,-4,-3,3,7,1,-5,-5,0,0,3,3,-1,1,-3,3,-78,-42,-36,-81,-45,-36,-25,-3,-49,-18,-16,30,-13,5,-37,-8,-4,11,-12,-8,-12,-10,-12,19,-19,1,-35,-18,-10,-2,-11,2,-21,-8,-8,0,-8,-1,-14,-10,-2,-2,-97,-79,-18,-55,-42,-13,-13,-17,-35,-38,-26,26,-14,-10,-22,-23,-19,6,1,-7,-13,-15,-7,20,-7,-10,-10,-13,-14,-2,-5,-7,-10,-9,-11,0,-2,-3,0,-4,-3,-2,-5,-33,28,-52,-40,-12,9,-15,-14,-24,-19,56,4,-12,-16,-19,-2,11,5,-3,2,-5,-17,45,-2,-2,-17,-23,-7,-1,-4,-4,-9,-20,-2,-1,2,2,-8,-3,-5,0,-3,-18,15,7,7,0,15,11,7,-17,-26,6,15,10,-5,-13,-17,-9,0,1,12,-4,-9,15,17,4,-10,2,-4,-4,12,1,-5,2,-1,-2,5,3,-5,0,-3,-2,-97,-32,-65,1,7,-6,0,-5,-45,-18,-24,-3,-2,-1,-11,-4,-10,-4,2,-4,-34,-14,-14,1,4,5,-4,0,-5,1,0,4,4,1,-4,1,4,1,-8,-1,-1,0,-23,-12,-11,11,0,11,-6,-4,2,-26,-21,31,-12,3,2,-6,-11,8,6,-7,0,-20,-10,23,4,6,4,-10,6,2,-1,1,1,-5,3,1,5,5,3,-5,3,1,-12,-5,-7,33,20,13,-15,-8,-42,-21,3,71,-7,-2,-16,-14,7,28,-8,-6,-26,-7,-4,43,4,6,3,10,8,2,5,3,3,4,4,1,-1,3,0,6,4,1
46,46102,Quart de Poblet,26409,-306,-149,-157,58,34,24,-69,-60,-111,-58,-33,23,-28,-38,-54,-20,-14,3,-41,-22,-57,-38,-19,20,7,22,19,9,1,0,2,13,13,6,0,0,5,9,6,3,1,0,12,20,-8,177,99,78,24,-21,-18,24,-16,16,22,-10,-1,8,-7,5,2,-11,-17,16,-9,11,34,46,59,27,5,4,17,27,35,11,5,2,17,19,24,16,0,2,27,17,10,141,66,75,71,-3,-37,-6,-22,12,45,-1,-25,0,-6,5,26,-2,-12,-6,-16,7,39,32,35,21,8,5,22,12,17,10,1,3,17,20,18,11,7,2,-163,-89,-74,142,70,72,27,-54,-89,-20,-27,-12,22,-24,-53,-27,-2,-12,5,-30,-36,7,-25,0,27,38,53,19,3,0,13,19,30,5,2,0,14,19,23,14,1,0,-105,-62,-43,139,66,73,9,-48,-62,-2,-16,1,-3,-23,-30,-2,-5,-6,12,-25,-32,0,-11,7,29,36,53,16,3,2,13,13,29,8,2,1,16,23,24,8,1,1,-43,2,-45,177,88,89,7,18,-76,-5,-15,14,22,15,-32,-8,-10,12,-15,3,-44,3,-5,2,39,44,49,33,11,1,17,19,28,18,5,1,22,25,21,15,6,0,-25,-45,20,149,33,116,54,-9,-27,-13,-14,-14,10,-4,-25,-13,-8,-6,44,-5,-2,0,-6,-8,55,37,38,8,10,1,15,8,9,-2,2,1,40,29,29,10,8,0,112,57,55,282,159,123,-17,41,36,38,27,-10,-23,24,28,20,9,-1,6,17,8,18,18,-9,31,72,87,59,26,4,18,40,52,31,14,4,13,32,35,28,12,0,123,90,33,316,196,120,43,21,5,52,6,-14,35,10,15,27,2,-4,8,11,-10,25,4,-10,55,62,90,82,24,0,32,28,60,56,18,-1,23,34,30,26,6,1,15,-5,20,71,12,59,36,-20,60,-7,-31,-24,13,-6,14,-1,-15,-12,23,-14,46,-6,-16,-12,17,29,31,-5,-2,0,7,13,2,-7,-3,-1,10,16,29,2,1,1,50,37,13,29,9,20,9,40,50,-19,-18,-19,9,23,25,-13,-10,-1,0,17,25,-6,-8,-18,17,18,6,-4,-5,-2,11,8,0,-2,-7,0,6,10,6,-2,2,-2,-270,-187,-83,-211,-157,-54,-20,-2,-140,-68,-43,3,-8,-2,-116,-37,-32,7,-12,0,-24,-31,-11,-4,-18,-5,-82,-73,-31,-4,-8,-11,-64,-52,-20,-4,-10,6,-18,-21,-11,0,-69,-32,-37,-34,-18,-16,0,-11,-15,-20,-21,-4,6,-10,2,-18,-14,0,-6,-1,-17,-2,-7,-4,-1,-2,-18,-9,-8,3,-2,0,-8,-5,-5,1,1,-2,-10,-4,-3,2,-136,-72,-64,-70,-46,-24,-23,-38,-44,-36,12,-9,-25,-4,-32,-11,1,-2,2,-34,-12,-25,11,-7,-6,-15,-21,-24,-1,-3,-4,-7,-12,-19,-2,-2,-2,-8,-9,-5,1,-1,-36,23,-59,-21,-5,-16,-11,-2,-4,1,-14,-3,1,2,3,14,4,-1,-12,-4,-7,-13,-18,-2,0,10,-8,-16,-4,-3,0,5,0,-9,-1,0,0,5,-8,-7,-3,-3,-50,-32,-18,9,10,-1,-5,-1,-8,-13,-30,2,2,-9,-4,-10,-15,3,-7,8,-4,-3,-15,-1,-9,9,4,2,1,2,4,6,0,1,-2,1,-13,3,4,1,3,1,-81,-73,-8,-137,-90,-47,13,11,-47,-37,-22,-3,-3,4,-33,-36,-8,3,16,7,-14,-1,-14,-6,-9,-4,-36,-64,-20,-5,-4,0,-20,-51,-14,-1,-5,-4,-16,-13,-6,-4,120,51,69,73,31,42,45,34,27,8,-6,11,25,23,19,-16,-5,5,20,11,8,24,-1,6,20,11,21,8,8,5,12,6,12,-1,2,0,8,5,9,9,6,5
46,46104,Quatretonda,2528,-6,0,-6,11,5,6,-4,3,-4,-6,2,3,-2,4,-1,-3,1,1,-2,-1,-3,-3,1,2,2,3,1,3,2,0,2,1,0,2,0,0,0,2,1,1,2,0,7,-4,11,15,7,8,6,0,-4,3,5,-3,2,-1,-3,-1,2,-3,4,1,-1,4,3,0,4,3,3,3,2,0,2,2,2,0,1,0,2,1,1,3,1,0,-35,-17,-18,11,6,5,-10,-3,-17,-6,2,1,-5,1,-9,-4,2,0,-5,-4,-8,-2,0,1,2,1,4,0,4,0,1,0,2,0,3,0,1,1,2,0,1,0,6,2,4,14,9,5,-4,15,-1,-7,3,0,-4,7,0,-3,2,0,0,8,-1,-4,1,0,0,7,6,0,1,0,0,4,4,0,1,0,0,3,2,0,0,0,23,13,10,40,24,16,10,10,0,2,0,1,5,9,-4,3,-1,1,5,1,4,-1,1,0,10,17,5,4,4,0,5,11,3,3,2,0,5,6,2,1,2,0,6,6,0,26,17,9,2,12,-12,1,0,2,0,9,-5,0,-1,2,2,3,-7,1,1,0,2,12,5,5,0,1,1,7,5,4,-1,0,1,5,0,1,1,1,8,-1,9,16,8,8,2,4,-7,2,8,-2,-3,2,-4,0,5,-1,5,2,-3,2,3,-1,1,10,1,3,2,-2,0,6,1,1,1,-1,1,4,0,2,1,-1,14,28,-14,29,25,4,5,0,-8,6,6,4,8,5,-4,8,7,3,-3,-5,-4,-2,-1,1,9,7,6,3,4,0,7,7,5,2,4,0,2,0,1,1,0,0,-10,7,-17,-1,-1,0,2,-7,-5,-3,0,3,7,-3,0,0,-1,4,-5,-4,-5,-3,1,-1,-1,-1,0,0,0,1,0,-1,-1,0,0,1,-1,0,1,0,0,0,-24,-7,-17,3,2,1,-4,-13,-17,9,-3,3,-3,-6,-9,8,2,0,-1,-7,-8,1,-5,3,0,0,0,2,1,0,0,0,0,1,1,0,0,0,0,1,0,0,7,-1,8,-4,-6,2,3,1,0,5,1,-3,1,-3,-2,4,0,-1,2,4,2,1,1,-2,0,-3,-3,4,-1,-1,-2,-2,-4,3,-1,0,2,-1,1,1,0,-1,-4,-8,4,-25,-19,-6,-2,4,-10,3,0,0,0,4,-11,3,-2,-2,-2,0,1,0,2,2,-4,0,-13,-5,-3,-1,-3,0,-8,-4,-3,-1,-1,0,-5,-1,0,0,-25,-7,-18,-20,-9,-11,-6,-3,-2,-12,-3,1,-1,-2,6,-8,-3,1,-5,-1,-8,-4,0,0,-3,-3,-6,-5,-4,1,0,-1,-1,-5,-3,1,-3,-2,-5,0,-1,0,-1,-4,3,2,1,1,5,1,-7,-2,-2,3,0,1,-3,-3,-2,2,5,0,-4,1,0,1,1,3,-3,-2,0,2,-1,4,-3,-1,0,1,2,-1,0,-1,0,1,-7,-10,3,-5,-6,1,1,8,-16,1,1,-2,1,4,-12,-2,-1,0,0,4,-4,3,2,-2,0,2,-6,-3,2,0,0,1,-5,-3,1,0,0,1,-1,0,1,0,-30,-19,-11,-15,-5,-10,-6,-4,-14,-1,-3,-3,2,-5,-13,-1,-1,-1,-8,1,-1,0,-2,-2,-6,1,-8,1,-3,0,2,-1,-5,1,-2,0,-8,2,-3,0,-1,0,-44,-16,-28,-7,-4,-3,-11,0,-19,-8,-6,0,-5,3,-7,-3,-2,-1,-6,-3,-12,-5,-4,1,-1,1,-4,-3,0,0,0,1,-3,-2,0,0,-1,0,-1,-1,0,0,-5,-9,4,5,1,4,0,-6,-12,-3,8,6,-1,-4,-9,-3,3,4,1,-2,-3,0,5,2,1,0,3,-2,1,1,1,-1,0,0,0,0,0,1,3,-2,1,1
46,46207,Rafelbuñol/Rafelbunyol,5407,135,71,64,14,8,6,26,38,32,20,13,6,14,17,18,11,9,2,12,21,14,9,4,4,3,3,3,2,3,0,2,2,2,0,2,0,1,1,1,2,1,0,101,52,49,15,10,5,17,31,37,15,-2,4,12,15,22,4,-2,1,5,16,15,11,0,3,5,5,5,0,0,0,3,3,4,0,0,0,2,2,1,0,0,0,187,110,77,34,18,16,30,34,65,36,12,8,12,18,48,23,2,4,18,16,17,13,10,4,10,10,11,3,0,0,3,6,7,2,0,0,7,4,4,1,0,0,255,151,104,50,30,20,54,57,70,45,12,15,34,40,39,23,7,7,20,17,31,22,5,8,11,21,9,8,0,0,8,13,4,4,0,0,3,8,5,4,0,0,239,102,137,30,7,23,38,40,78,49,22,10,22,14,31,25,9,2,16,26,47,24,13,8,4,7,9,7,0,1,1,0,2,4,0,0,3,7,7,3,0,1,239,119,120,75,36,39,29,48,60,58,29,11,22,23,28,30,14,2,7,25,32,28,15,9,7,26,17,18,7,0,3,10,8,11,4,0,4,16,9,7,3,0,219,122,97,59,27,32,25,27,97,39,17,12,15,12,57,23,10,3,10,15,40,16,7,9,8,22,11,9,8,1,3,11,5,2,5,1,5,11,6,7,3,0,524,267,257,67,41,26,60,68,236,80,38,34,40,31,118,42,17,16,20,37,118,38,21,18,11,23,19,10,4,0,10,13,14,4,0,0,1,10,5,6,4,0,346,162,184,-18,-22,4,52,49,160,28,21,27,33,15,86,13,4,9,19,34,74,15,17,18,9,5,-13,-13,-5,-4,7,1,-14,-8,-6,-2,2,4,1,-5,1,-2,208,85,123,34,17,17,21,40,88,33,13,16,2,8,60,10,5,3,19,32,28,23,8,13,4,10,10,8,0,2,0,2,8,6,0,1,4,8,2,2,0,1,160,99,61,34,23,11,0,27,70,30,7,28,7,25,39,14,5,10,-7,2,31,16,2,18,5,3,11,8,4,2,4,3,8,5,2,1,1,0,3,3,2,1,41,-11,52,-29,-23,-6,-8,-14,43,10,-2,13,-7,-5,4,-3,-5,5,-1,-9,39,13,3,8,3,-8,-14,-2,-7,-3,1,-2,-15,-3,-5,-1,2,-6,1,1,-2,-2,142,58,84,-4,-7,3,24,27,40,33,-1,19,16,8,9,23,0,4,8,19,31,10,-1,15,3,2,-5,-3,1,-2,1,-2,-3,-2,0,-1,2,4,-2,-1,1,-1,-42,2,-44,-53,-33,-20,-11,-13,-21,-8,0,8,-5,-3,1,-3,3,3,-6,-10,-22,-5,-3,5,-8,1,-24,-21,-4,2,-1,1,-18,-15,-2,1,-7,0,-6,-6,-2,1,6,2,4,1,2,-1,-1,-8,12,-5,-2,12,0,2,7,-3,-4,0,-1,-10,5,-2,2,12,-5,-2,9,-7,6,0,-1,2,3,-3,1,0,-4,-4,6,-4,5,0,11,6,5,-10,-9,-1,-21,10,5,-13,1,24,-10,-5,6,-7,4,15,-11,15,-1,-6,-3,9,0,4,-2,-7,-6,0,-2,-1,-1,-4,-1,0,2,5,-1,-3,-5,0,-34,-56,22,3,-3,6,-21,15,-15,-26,-6,21,-23,-1,-9,-19,-12,10,2,16,-6,-7,6,11,0,5,0,-6,2,2,0,3,-3,-5,0,2,0,2,3,-1,2,0,47,17,30,22,12,10,-4,13,6,1,-2,30,2,-2,6,5,-1,4,-6,15,0,-4,-1,26,3,3,8,5,0,1,1,1,5,2,0,1,2,2,3,3,0,0
46,46208,Rafelcofer,1416,-5,3,-8,4,3,1,-4,4,-6,-1,2,0,-1,3,1,-1,1,0,-3,1,-7,0,1,0,0,2,2,0,0,0,0,1,2,0,0,0,0,1,0,0,0,0,16,13,3,6,4,2,-1,-4,13,2,3,3,-4,0,12,1,2,2,3,-4,1,1,1,1,1,0,2,0,1,2,0,0,2,0,1,1,1,0,0,0,0,1,-3,-1,-2,16,9,7,-5,1,-7,8,1,-1,-1,2,-5,4,-1,0,-4,-1,-2,4,2,-1,1,4,5,4,2,0,1,2,3,2,1,0,0,2,2,2,1,0,21,10,11,9,3,6,15,-2,1,6,0,1,9,-2,-2,4,-1,2,6,0,3,2,1,-1,2,1,2,0,3,1,0,1,0,0,1,1,2,0,2,0,2,0,20,7,13,25,11,14,0,3,5,6,4,0,-1,1,2,1,2,0,1,2,3,5,2,0,2,6,6,5,4,1,0,3,3,2,1,1,2,3,3,3,3,0,48,23,25,12,8,4,14,13,5,14,4,0,5,7,-1,10,4,-1,9,6,6,4,0,1,0,4,3,1,4,0,0,4,2,0,2,0,0,0,1,1,2,0,69,40,29,23,13,10,9,19,17,14,10,-1,3,10,11,9,5,1,6,9,6,5,5,-2,3,6,8,4,4,-2,1,5,3,3,2,-1,2,1,5,1,2,-1,12,0,12,21,9,12,0,2,14,-4,2,-1,-4,-5,9,-1,1,0,4,7,5,-3,1,-1,1,8,10,0,2,0,0,1,7,0,1,0,1,7,3,0,1,0,-6,-7,1,-4,-5,1,-3,4,-7,-10,5,6,-1,3,-6,-8,3,2,-2,1,-1,-2,2,4,-1,-1,-3,-1,2,0,-1,-2,-2,-1,1,0,0,1,-1,0,1,0,-5,-2,-3,13,5,8,0,3,4,-10,3,-2,-1,4,1,-6,1,-1,1,-1,3,-4,2,-1,6,0,3,3,1,0,3,0,-1,2,1,0,3,0,4,1,0,0,-37,-19,-18,-10,-7,-3,-6,-3,-21,1,-5,-3,-5,1,-8,-4,-3,-1,-1,-4,-13,5,-2,-2,0,-1,-4,-3,0,-2,-1,-1,-1,-2,-1,-1,1,0,-3,-1,1,-1,7,-9,16,9,3,6,2,1,4,-4,2,3,3,-1,-1,-10,1,0,-1,2,5,6,1,3,1,2,2,0,1,3,0,1,1,0,0,1,1,1,1,0,1,2,-18,-12,-6,-1,-2,1,-3,-3,-13,2,1,-2,-2,-1,-7,0,-1,0,-1,-2,-6,2,2,-2,0,1,-3,-2,3,0,0,0,-2,-1,1,0,0,1,-1,-1,2,0,-26,-14,-12,-12,-6,-6,-8,-2,-7,-6,-5,1,-5,0,0,-6,-2,-1,-3,-2,-7,0,-3,2,0,-3,-2,-3,-3,-1,0,-1,0,-3,-1,-1,0,-2,-2,0,-2,0,10,10,0,1,0,1,2,2,-5,8,8,-3,1,3,-2,7,5,-3,1,-1,-3,1,3,0,-1,1,-1,1,1,0,-1,0,-1,1,1,0,0,1,0,0,0,0,-19,-5,-14,-6,-3,-3,-6,-1,2,-13,2,-3,1,-1,1,-7,2,-1,-7,0,1,-6,0,-2,-2,0,0,-5,1,0,-1,0,0,-3,0,1,-1,0,0,-2,1,-1,-7,0,-7,-16,-8,-8,-2,8,-14,6,-6,2,2,3,-5,3,-4,1,-4,5,-9,3,-2,1,-1,1,-7,-4,-5,0,0,2,-4,-3,-3,0,-1,-1,-3,-1,-2,0,-11,1,-12,7,4,3,-3,0,-3,-7,-3,3,0,2,-3,-1,0,2,-3,-2,0,-6,-3,1,0,2,1,1,0,3,0,1,0,0,1,2,0,1,1,1,-1,1
46,46209,Rafelguaraf,2440,-11,-1,-10,4,3,1,-1,0,-8,1,-2,-3,0,2,-4,1,1,-2,-1,-2,-4,0,-3,-1,0,3,0,1,0,0,0,3,0,0,0,0,0,0,0,1,0,0,5,11,-6,11,7,4,-4,-4,5,2,4,2,-1,2,4,2,2,2,-3,-6,1,0,2,0,1,0,5,1,3,1,0,0,3,1,2,1,1,0,2,0,1,0,23,7,16,4,2,2,11,6,2,5,3,-4,5,2,2,0,0,-2,6,4,0,5,3,-2,1,0,2,0,1,0,0,0,2,0,0,0,1,0,0,0,1,0,-7,-5,-2,8,5,3,0,4,-15,1,-3,4,1,3,-11,3,-3,1,-1,1,-4,-2,0,3,2,1,3,1,1,0,2,0,2,0,1,0,0,1,1,1,0,0,17,12,5,16,8,8,1,3,-2,3,4,8,2,6,-2,1,1,4,-1,-3,0,2,3,4,4,4,3,3,1,1,3,2,1,1,0,1,1,2,2,2,1,0,-12,-5,-7,2,0,2,-5,-2,-6,1,2,-3,-1,1,-6,4,-1,-2,-4,-3,0,-3,3,-1,-2,3,-2,1,2,0,-1,2,-2,1,0,0,-1,1,0,0,2,0,56,35,21,23,11,12,19,-3,24,8,6,0,11,0,14,4,4,1,8,-3,10,4,2,-1,7,4,5,5,2,0,4,2,2,2,1,0,3,2,3,3,1,0,43,31,12,25,14,11,14,8,20,4,0,-2,9,6,14,2,1,-2,5,2,6,2,-1,0,10,4,9,1,1,0,8,1,5,0,0,0,2,3,4,1,1,0,7,4,3,6,3,3,5,5,-2,1,3,-4,2,-1,3,0,2,-2,3,6,-5,1,1,-2,-1,1,1,1,4,0,-1,1,1,1,1,0,0,0,0,0,3,0,-14,-6,-8,-7,-3,-4,-9,2,-7,3,2,-4,-5,2,-4,2,1,-1,-4,0,-3,1,1,-3,-4,1,-2,-2,0,0,-2,1,-1,-1,0,0,-2,0,-1,-1,0,0,22,6,16,12,7,5,2,10,10,5,0,-5,2,2,4,1,-1,-2,0,8,6,4,1,-3,3,0,4,3,1,1,2,0,3,2,0,0,1,0,1,1,1,1,7,13,-6,12,7,5,1,5,4,-2,2,-4,0,4,6,2,2,-2,1,1,-2,-4,0,-2,2,2,4,2,1,0,1,2,0,2,1,0,1,0,4,0,0,0,-43,-19,-24,0,-2,2,-3,-7,-26,-5,-2,-1,-1,0,-13,-4,0,-1,-2,-7,-13,-1,-2,0,2,1,-1,-1,0,-1,1,0,-1,-1,0,-1,1,1,0,0,0,0,-32,-16,-16,-1,-3,2,-5,-8,-12,2,-6,-2,-5,-1,-5,1,-4,-1,0,-7,-7,1,-2,-1,1,1,-4,2,0,-1,0,0,-3,1,0,-1,1,1,-1,1,0,0,-7,-6,-1,3,3,0,-5,-6,-1,4,4,0,-1,-5,-1,-2,3,2,-4,-1,0,6,1,-2,0,1,0,1,0,1,0,1,-1,1,1,1,0,0,1,0,-1,0,-5,-1,-4,2,3,-1,0,-1,-6,2,-1,0,1,0,-2,4,-3,-1,-1,-1,-4,-2,2,1,0,-1,0,1,0,2,0,0,1,0,0,2,0,-1,-1,1,0,0,10,5,5,9,8,1,9,2,-4,2,4,-3,3,4,-2,2,1,-2,6,-2,-2,0,3,-1,1,2,-1,6,0,1,2,2,-1,4,0,1,-1,0,0,2,0,0,-14,5,-19,4,3,1,-7,-7,4,2,-4,-2,-3,0,8,3,-3,0,-4,-7,-4,-1,-1,-2,-1,3,3,-1,0,0,-2,3,3,-1,0,0,1,0,0,0,0,0
46,46211,Real de Gandía,1804,22,25,-3,10,4,6,15,2,-1,7,-1,-2,8,3,3,9,1,0,7,-1,-4,-2,-2,-2,3,1,3,2,1,0,1,0,1,2,0,0,2,1,2,0,1,0,48,26,22,10,4,6,3,12,12,10,5,3,1,5,9,5,3,1,2,7,3,5,2,2,0,3,2,1,4,0,0,1,1,0,2,0,0,2,1,1,2,0,15,10,5,5,2,3,0,1,-1,12,3,-1,1,3,1,3,3,-1,-1,-2,-2,9,0,0,0,1,-1,3,1,1,0,1,-1,1,1,0,0,0,0,2,0,1,80,37,43,11,5,6,20,17,21,17,2,0,9,6,8,11,2,0,11,11,13,6,0,0,1,6,4,0,0,0,1,1,3,0,0,0,0,5,1,0,0,0,78,36,42,7,4,3,28,4,12,25,7,-1,15,-3,7,12,1,1,13,7,5,13,6,-2,2,1,2,2,0,0,1,0,1,2,0,0,1,1,1,0,0,0,31,13,18,3,3,0,4,5,-1,14,4,5,2,4,-2,4,2,3,2,1,1,10,2,2,0,1,1,0,0,1,0,1,0,1,0,1,0,0,1,-1,0,0,82,39,43,20,8,12,30,8,28,7,7,-1,18,4,14,4,0,-2,12,4,14,3,7,1,4,6,5,0,3,1,2,3,2,0,0,1,2,3,3,0,3,0,-9,-2,-7,8,4,4,-3,0,8,-9,-1,-5,-2,1,3,-3,0,-2,-1,-1,5,-6,-1,-3,2,4,1,0,1,0,2,1,1,0,0,0,0,3,0,0,1,0,28,19,9,12,9,3,3,0,10,4,4,3,0,-4,10,4,4,2,3,4,0,0,0,1,0,2,4,-1,3,4,0,0,4,1,2,2,0,2,0,-2,1,2,43,18,25,7,3,4,20,1,12,14,-3,1,7,3,6,4,-1,0,13,-2,6,10,-2,1,3,2,1,2,-1,0,2,1,0,1,-1,0,1,1,1,1,0,0,26,4,22,1,0,1,-6,16,15,-2,6,-3,-10,-2,12,2,2,-1,4,18,3,-4,4,-2,0,1,1,1,0,-2,0,0,0,1,0,-1,0,1,1,0,0,-1,11,4,7,4,1,3,-6,6,7,-6,7,1,-3,6,4,-6,2,0,-3,0,3,0,5,1,0,1,2,0,0,1,0,0,1,0,0,0,0,1,1,0,0,1,7,-5,12,5,2,3,0,1,2,6,0,-3,-4,2,-3,4,-4,1,4,-1,5,2,4,-4,2,0,1,0,1,1,1,0,1,-1,0,1,1,0,0,1,1,0,14,4,10,-32,-19,-13,12,-1,7,-7,2,-2,7,-1,-3,0,0,0,5,0,10,-7,2,-2,-4,0,-11,-8,-7,-2,-2,1,-8,-6,-4,0,-2,-1,-3,-2,-3,-2,16,5,11,-12,-5,-7,6,10,4,0,-6,-1,-1,8,0,-2,-3,0,7,2,4,2,-3,-1,-1,0,-6,-2,-1,-2,0,0,-3,-1,0,-1,-1,0,-3,-1,-1,-1,10,1,9,1,-2,3,-2,1,7,7,4,-3,-3,-3,5,4,2,0,1,4,2,3,2,-3,-2,0,1,0,3,-1,-1,-1,1,-1,1,-1,-1,1,0,1,2,0,53,26,27,21,-3,24,-2,20,24,11,0,2,1,7,18,4,-2,-1,-3,13,6,7,2,3,-2,8,13,2,2,-2,-1,0,1,-2,0,-1,-1,8,12,4,2,-1,41,24,17,23,11,12,-3,15,-2,12,10,7,0,9,-7,10,8,3,-3,6,5,2,2,4,5,1,5,3,4,4,2,1,2,2,2,2,3,0,3,1,2,2
46,46213,Requena,18957,245,152,93,242,137,105,56,66,96,37,-3,-9,37,28,65,29,-1,-5,19,38,31,8,-2,-4,31,70,88,43,6,4,16,32,59,26,2,2,15,38,29,17,4,2,274,141,133,314,153,161,54,78,73,61,9,-5,24,43,38,22,7,5,30,35,35,39,2,-10,53,86,99,62,8,2,24,46,48,29,4,1,29,40,51,33,4,1,128,86,42,369,187,182,52,46,15,23,-4,-9,28,22,19,15,9,-9,24,24,-4,8,-13,0,82,106,105,59,11,2,38,49,60,30,7,2,44,57,45,29,4,0,170,84,86,286,151,135,64,36,35,11,3,12,24,20,13,19,5,-1,40,16,22,-8,-2,13,61,87,81,35,11,7,34,46,37,22,5,4,27,41,44,13,6,3,175,90,85,290,156,134,29,47,52,37,4,12,-1,26,46,20,2,4,30,21,6,17,2,8,37,93,109,42,9,2,18,49,63,22,6,0,19,44,46,20,3,2,314,188,126,255,148,107,64,69,72,54,36,19,45,43,47,23,18,10,19,26,25,31,18,9,45,81,78,34,10,6,22,52,48,19,4,2,23,29,30,15,6,4,235,140,95,265,139,126,85,58,25,60,14,-11,45,27,25,38,10,-6,40,31,0,22,4,-5,57,71,69,43,17,4,30,34,42,24,8,0,27,37,27,19,9,4,492,287,205,361,207,154,94,119,132,71,51,24,52,80,85,49,21,2,42,39,47,22,30,22,64,106,108,65,13,4,37,61,64,37,4,4,27,45,44,28,9,0,306,147,159,209,98,111,75,42,79,76,38,-10,35,27,34,36,15,-4,40,15,45,40,23,-6,38,54,67,32,11,3,21,25,31,15,2,1,17,29,36,17,9,2,229,145,84,117,58,59,44,52,46,54,15,18,22,34,28,36,10,15,22,18,18,18,5,3,23,46,17,23,9,-1,11,24,8,13,2,1,12,22,9,10,7,-2,115,43,72,176,75,101,1,41,-6,25,20,31,-3,23,-2,7,11,7,4,18,-4,18,9,24,25,56,44,29,14,5,13,19,24,10,6,3,12,37,20,19,8,2,121,59,62,147,69,78,13,18,36,3,26,25,7,7,17,5,14,8,6,11,19,-2,12,17,29,42,42,18,12,2,16,22,20,5,5,0,13,20,22,13,7,2,66,-8,74,54,26,28,8,28,-8,20,1,17,-5,7,-14,5,-6,6,13,21,6,15,7,11,8,17,6,19,3,1,4,8,2,10,2,0,4,9,4,9,1,1,1,1,0,-1,-15,14,-2,1,-13,-13,2,27,-6,9,-6,-9,-1,12,4,-8,-7,-4,3,15,1,11,-4,-12,-1,2,-3,1,-7,-12,2,2,4,10,3,0,-3,0,-163,-84,-79,-73,-41,-32,-8,-15,-83,-54,-8,7,4,-3,-52,-28,-6,2,-12,-12,-31,-26,-2,5,-4,3,-35,-33,-2,-2,-1,0,-19,-16,-3,-2,-3,3,-16,-17,1,0,-106,-73,-33,1,-14,15,1,-23,-56,-33,-18,20,-9,-11,-31,-21,-8,5,10,-12,-25,-12,-10,15,13,14,-14,-9,-5,1,3,3,-11,-6,-4,1,10,11,-3,-3,-1,0,-358,-212,-146,-277,-173,-104,-26,-45,-112,-151,-50,21,-2,-27,-67,-95,-36,10,-24,-18,-45,-56,-14,11,-11,-10,-83,-132,-40,-4,-2,-5,-50,-88,-27,-3,-9,-5,-33,-44,-13,-1,62,27,35,21,4,17,21,-3,-11,13,41,1,10,-8,-14,11,30,-2,11,5,3,2,11,3,12,4,-1,-3,13,-4,11,0,-9,-3,6,-1,1,4,8,0,7,-3
46,46214,Riba-roja de Túria,12250,545,265,280,30,14,16,104,73,128,144,65,28,50,31,62,73,39,10,54,42,66,71,26,18,7,7,8,7,1,0,3,4,3,3,1,0,4,3,5,4,0,0,590,321,269,132,77,55,107,102,184,128,43,15,58,56,90,76,26,8,49,46,94,52,17,7,29,29,43,19,5,3,19,17,27,9,2,1,10,12,16,10,3,2,720,389,331,145,82,63,143,109,245,126,60,24,78,59,132,68,36,8,65,50,113,58,24,16,37,36,39,23,8,1,18,21,22,14,5,1,19,15,17,9,3,0,913,489,424,143,84,59,145,141,292,208,55,58,84,67,163,119,29,21,61,74,129,89,26,37,20,34,47,24,14,3,13,22,25,13,7,3,7,12,22,11,7,0,863,417,446,155,75,80,169,88,328,162,53,50,83,40,161,89,25,18,86,48,167,73,28,32,34,31,53,22,10,3,20,13,27,11,4,0,14,18,26,11,6,3,949,522,427,224,128,96,198,115,342,207,65,17,105,74,186,112,36,7,93,41,156,95,29,10,40,48,70,42,20,4,26,27,37,26,10,2,14,21,33,16,10,2,729,372,357,182,78,104,125,128,239,156,44,30,71,54,122,89,21,15,54,74,117,67,23,15,48,48,48,24,11,2,21,19,21,9,5,2,27,29,27,15,6,0,716,377,339,180,95,85,72,158,258,119,47,48,23,87,151,72,26,15,49,71,107,47,21,33,30,57,48,28,14,0,15,35,23,17,6,-1,15,22,25,11,8,1,385,230,155,117,66,51,42,70,143,78,21,24,26,39,81,51,10,11,16,31,62,27,11,13,14,49,26,24,0,1,8,30,18,12,-4,0,6,19,8,12,4,1,228,110,118,72,34,38,67,54,46,51,10,4,31,26,21,35,4,-3,36,28,25,16,6,7,14,20,16,11,9,2,6,12,7,5,4,1,8,8,9,6,5,1,192,104,88,87,41,46,58,9,75,11,-6,32,31,13,47,12,-18,15,27,-4,28,-1,12,17,22,24,21,15,0,0,8,12,12,10,-3,-1,14,12,9,5,3,1,153,47,106,28,15,13,36,-11,50,41,11,29,5,-17,32,20,-4,12,31,6,18,21,15,17,8,0,8,10,-3,3,9,-5,3,6,-2,2,-1,5,5,4,-1,1,142,54,88,62,30,32,66,-6,13,5,18,39,27,-5,4,-9,12,21,39,-1,9,14,6,18,24,8,14,8,9,-2,10,1,12,2,5,-1,14,7,2,6,4,-1,29,23,6,-1,4,-5,3,1,-21,41,-14,20,9,2,-11,31,-8,4,-6,-1,-10,10,-6,16,4,9,-15,4,-3,0,4,4,-7,2,2,0,0,5,-8,2,-5,0,116,63,53,65,40,25,14,7,-8,57,5,46,5,3,3,24,7,19,9,4,-11,33,-2,27,17,10,3,24,8,2,6,7,3,17,5,1,11,3,0,7,3,1,174,95,79,46,17,29,42,3,42,55,-14,40,30,6,17,34,-10,15,12,-3,25,21,-4,25,14,19,6,0,3,3,7,9,2,-5,2,2,7,10,4,5,1,1,232,115,117,101,50,51,40,17,61,61,4,44,17,1,42,25,12,11,23,16,19,36,-8,33,14,26,26,18,13,3,3,12,15,10,8,2,11,14,11,8,5,1,341,167,174,132,66,66,63,33,101,99,-1,44,24,14,67,66,-8,2,39,19,34,33,7,42,23,14,46,32,10,4,8,6,27,18,5,0,15,8,19,14,5,4
46,46215,Riola,1584,2,4,-2,3,1,2,-7,0,2,2,7,-1,-4,0,4,1,4,-1,-3,0,-2,1,3,0,0,0,1,0,2,0,0,0,0,0,1,0,0,0,1,0,1,0,38,20,18,11,6,5,9,3,16,9,3,-2,4,3,7,4,3,-1,5,0,9,5,0,-1,0,3,3,4,1,0,0,3,1,1,1,0,0,0,2,3,0,0,34,11,23,9,6,3,2,4,14,9,4,0,0,3,1,4,3,0,2,1,13,5,1,0,1,0,2,4,1,0,1,0,1,3,1,0,0,0,1,1,0,0,17,-2,19,-2,-1,-1,6,4,10,5,-6,-2,1,-1,5,-1,-4,-2,5,5,5,6,-2,0,0,0,0,0,-2,0,0,0,0,0,-1,0,0,0,0,0,-1,0,30,16,14,16,9,7,6,5,12,5,0,-1,5,-3,10,4,-1,1,1,8,2,1,1,-2,3,3,6,3,1,0,2,1,3,3,0,0,1,2,3,0,1,0,7,11,-4,15,11,4,-6,1,9,1,4,-2,-4,5,7,4,1,-2,-2,-4,2,-3,3,0,0,4,4,6,1,0,0,3,2,5,1,0,0,1,2,1,0,0,41,26,15,14,9,5,8,11,6,11,5,0,5,7,4,6,4,0,3,4,2,5,1,0,3,1,5,2,1,2,3,1,3,0,1,1,0,0,2,2,0,1,8,10,-2,4,2,2,-4,5,6,-4,3,1,-1,2,4,1,1,2,-3,3,2,-5,2,-1,0,1,4,-1,0,0,0,1,2,-1,0,0,0,0,2,0,0,0,6,3,3,5,2,3,-1,7,-3,-3,5,0,-2,3,-1,0,2,1,1,4,-2,-3,3,-1,2,1,0,2,0,0,1,0,-1,2,0,0,1,1,1,0,0,0,4,-3,7,0,2,-2,7,-5,2,1,0,-1,3,-2,-2,-1,0,-1,4,-3,4,2,0,0,0,0,0,1,0,-1,0,0,1,1,0,0,0,0,-1,0,0,-1,25,12,13,9,6,3,0,9,11,10,-4,-3,-2,4,11,3,-4,-2,2,5,0,7,0,-1,2,6,6,0,-4,-1,1,4,7,-2,-3,-1,1,2,-1,2,-1,0,6,10,-4,10,4,6,3,8,-8,9,-3,-3,0,6,-4,7,2,-1,3,2,-4,2,-5,-2,1,5,-1,5,0,0,0,3,-2,3,0,0,1,2,1,2,0,0,-28,-12,-16,-12,-8,-4,-12,-6,-7,-6,1,2,-6,-3,-4,-2,2,1,-6,-3,-3,-4,-1,1,-1,0,-3,-6,-2,0,0,0,-4,-3,-1,0,-1,0,1,-3,-1,0,-11,-11,0,-12,-6,-6,2,3,-10,-1,0,-4,0,2,-6,-2,-1,-3,2,1,-4,1,1,-1,-1,-3,-5,-3,0,0,-1,-2,-2,-1,0,0,0,-1,-3,-2,0,0,-3,-3,0,3,3,0,-1,4,-5,-1,0,-4,0,2,-3,-2,-2,-1,-1,2,-2,1,2,-3,2,0,0,0,1,0,1,1,0,0,1,0,1,-1,0,0,0,0,1,-6,7,-3,-3,0,2,-2,19,-14,-2,-4,-1,-3,9,-7,-2,-2,3,1,10,-7,0,-2,1,2,-1,-5,0,0,0,1,-1,-3,0,0,1,1,0,-2,0,0,-32,-12,-20,-18,-14,-4,-5,-5,-21,-8,2,4,-3,0,-12,-2,2,2,-2,-5,-9,-6,0,2,0,-1,-11,-3,-3,0,0,0,-10,-2,-2,0,0,-1,-1,-1,-1,0,-17,-13,-4,3,3,0,-2,9,-8,-16,1,-1,1,3,-6,-11,0,0,-3,6,-2,-5,1,-1,0,0,0,2,1,0,0,0,0,2,1,0,0,0,0,0,0,0
46,46216,Rocafort,5008,75,30,45,50,22,28,14,26,23,17,-6,1,2,16,4,10,-1,-1,12,10,19,7,-5,2,11,6,16,12,5,0,5,3,7,5,2,0,6,3,9,7,3,0,112,53,59,51,18,33,43,11,34,16,1,-2,16,-4,20,11,3,1,27,15,14,5,-2,-3,13,8,15,7,6,1,2,1,6,3,4,1,11,7,9,4,2,0,291,142,149,82,42,40,93,15,102,68,10,-5,54,-1,46,32,7,-1,39,16,56,36,3,-4,25,11,26,17,1,1,16,4,13,8,0,0,9,7,13,9,1,1,202,109,93,48,29,19,55,6,74,44,9,3,38,1,36,21,7,2,17,5,38,23,2,1,9,8,14,9,7,1,5,5,9,6,3,1,4,3,5,3,4,0,10,-14,24,43,11,32,8,4,3,12,-18,-1,-7,-3,1,11,-10,-5,15,7,2,1,-8,4,9,14,9,9,2,0,3,3,4,2,0,-1,6,11,5,7,2,1,10,5,5,53,22,31,8,1,19,-10,-8,-5,5,2,11,-10,-6,-3,3,-1,8,0,-2,-2,14,7,15,9,5,3,9,2,5,4,1,1,5,5,10,5,4,2,53,38,15,44,24,20,48,-5,-7,26,-2,-9,28,4,-11,16,3,-5,20,-9,4,10,-5,-4,15,8,8,9,4,0,8,4,6,4,1,1,7,4,2,5,3,-1,302,169,133,71,25,46,79,49,66,94,-5,14,49,21,50,41,-2,6,30,28,16,53,-3,8,14,12,14,23,6,2,6,6,2,7,3,1,8,6,12,16,3,1,2,-9,11,28,8,20,12,-1,12,-20,-5,2,-9,6,0,-8,-2,2,21,-7,12,-12,-3,0,4,0,11,5,3,1,0,0,-1,3,3,0,4,0,12,2,0,1,89,26,63,20,2,18,40,-5,13,23,-2,12,7,-3,3,13,-2,4,33,-2,10,10,0,8,12,5,0,2,-1,1,4,0,-2,0,-1,1,8,5,2,2,0,0,46,24,22,26,11,15,-2,21,-5,27,-6,-1,-4,8,14,9,-7,4,2,13,-19,18,1,-5,4,9,7,6,0,-1,4,2,2,2,0,1,0,7,5,4,0,-2,25,5,20,-7,-12,5,30,-12,1,19,-18,0,17,-7,-7,11,-16,4,13,-5,8,8,-2,-4,2,3,-11,0,-3,1,-1,0,-7,-1,-4,0,3,3,-4,1,1,1,-7,6,-13,-17,-15,-2,15,-9,-24,-4,10,5,14,-1,-25,7,7,3,1,-8,1,-11,3,2,-4,-4,-6,-1,-2,1,-5,-1,-8,-2,0,1,1,-3,2,1,-2,0,-21,2,-23,12,1,11,13,-12,-24,19,-12,-11,6,-3,-8,11,-2,-7,7,-9,-16,8,-10,-4,6,1,-2,2,3,0,1,1,0,-3,2,0,5,0,-2,5,1,0,33,19,14,-1,6,-7,1,-7,1,35,0,-6,2,-1,6,9,5,-5,-1,-6,-5,26,-5,-1,2,0,-10,4,3,0,3,3,-2,0,2,0,-1,-3,-8,4,1,0,61,25,36,27,21,6,30,1,19,20,-18,5,15,-1,6,11,-12,4,15,2,13,9,-6,1,8,17,3,2,-6,3,4,9,3,6,-3,1,4,8,0,-4,-3,2,44,17,27,7,-4,11,25,5,-2,5,-6,9,10,0,7,1,-6,1,15,5,-9,4,0,8,-1,10,2,-11,4,1,-3,3,1,-6,0,0,2,7,1,-5,4,1,125,48,77,86,32,54,44,13,13,63,6,-17,25,5,3,22,0,-7,19,8,10,41,6,-10,22,25,4,15,14,6,9,8,1,6,6,2,13,17,3,9,8,4
46,46220,Sagunto/Sagunt,56836,346,191,155,321,192,129,83,104,65,53,29,13,55,42,52,32,13,5,28,62,13,21,16,8,29,99,99,64,24,4,19,54,66,38,10,4,10,45,33,26,14,0,847,468,379,625,336,289,164,187,236,132,61,67,90,95,146,82,34,21,74,92,90,50,27,46,104,151,194,110,47,16,58,73,111,64,21,7,46,78,83,46,26,9,728,383,345,495,255,240,103,147,239,145,52,36,40,87,142,77,19,17,63,60,97,68,33,19,98,122,132,88,37,12,52,56,79,42,16,7,46,66,53,46,21,5,1365,676,689,612,301,311,282,239,330,262,170,76,102,117,198,147,80,30,180,122,132,115,90,46,114,144,139,122,62,23,56,62,77,73,24,7,58,82,62,49,38,16,1262,698,564,675,377,298,247,230,395,210,114,60,132,120,235,114,62,31,115,110,160,96,52,29,102,160,203,124,61,21,52,95,118,72,28,10,50,65,85,52,33,11,1386,819,567,892,484,408,262,239,464,305,74,34,146,128,292,191,38,20,116,111,172,114,36,14,166,186,268,168,64,36,81,96,165,92,31,17,85,90,103,76,33,19,1235,740,495,984,563,421,244,317,407,252,48,-40,144,185,266,134,25,-15,100,132,141,118,23,-25,160,270,289,160,75,24,94,156,172,86,39,12,66,114,117,74,36,12,1861,1048,813,1240,709,531,295,408,639,344,114,54,140,220,386,227,40,27,155,188,253,117,74,27,194,339,384,228,73,18,105,195,243,127,32,6,89,144,141,101,41,12,671,362,309,822,445,377,70,197,145,112,72,74,41,93,126,32,28,42,29,104,19,80,44,32,137,242,228,134,54,20,76,132,131,66,30,8,61,110,97,68,24,12,221,95,126,353,174,179,35,88,46,20,2,23,-5,51,38,-1,-5,14,40,37,8,21,7,9,61,131,104,14,20,12,20,76,55,6,10,4,41,55,49,8,10,8,-625,-406,-219,-366,-248,-118,-46,-34,-313,-141,-76,-12,-19,-31,-197,-105,-61,9,-27,-3,-116,-36,-15,-21,-33,26,-126,-119,-85,-37,-5,2,-84,-95,-56,-14,-28,24,-42,-24,-29,-23,-247,-183,-64,340,151,189,-57,26,-127,-125,62,-28,-24,-5,-103,-85,33,1,-33,31,-24,-40,29,-29,53,90,90,41,46,12,20,42,39,16,20,8,33,48,51,25,26,4,99,0,99,213,84,129,27,87,-56,-7,33,20,25,40,-38,-43,11,11,2,47,-18,36,22,9,58,83,23,9,20,15,42,41,-3,-12,5,10,16,42,26,21,15,5,-173,-85,-88,164,60,104,-56,17,-143,-11,-13,35,-28,16,-58,-11,-19,18,-28,1,-85,0,6,17,48,36,29,24,0,20,25,12,14,2,-3,6,23,24,15,22,3,14,-854,-504,-350,-655,-391,-264,-130,-102,-289,-253,-77,-6,-76,-37,-179,-165,-45,-4,-54,-65,-110,-88,-32,-2,-80,-48,-233,-194,-66,-43,-38,-28,-150,-125,-46,-11,-42,-20,-83,-69,-20,-32,108,28,80,103,31,72,61,17,0,-2,31,19,53,2,12,-46,5,8,8,15,-12,44,26,11,90,1,-5,-4,2,12,56,-6,-5,-19,-10,8,34,7,0,15,12,4,130,28,102,26,-38,64,61,39,-26,18,-4,26,31,39,-49,-5,-9,13,30,0,23,23,5,13,39,47,-21,-23,-24,-4,6,40,-24,-29,-25,-12,33,7,3,6,1,8,-28,-66,38,-86,-111,25,-1,30,11,-36,-22,-5,13,5,-15,-55,-35,22,-14,25,26,19,13,-27,17,44,-21,-85,-42,-4,10,19,-29,-80,-30,-3,7,25,8,-5,-12,-1
46,46903,San Antonio de Benagéber,2434,244,122,122,20,9,11,39,26,62,66,29,16,10,23,29,33,19,5,29,3,33,33,10,11,7,3,4,6,0,0,4,2,1,2,0,0,3,1,3,4,0,0,219,119,100,11,6,5,41,13,56,45,23,37,25,7,32,29,12,12,16,6,24,16,11,25,5,0,1,5,0,0,1,0,1,4,0,0,4,0,0,1,0,0,396,185,211,24,12,12,74,50,141,74,34,14,34,12,76,40,13,6,40,38,65,34,21,8,3,1,11,6,3,0,0,1,5,4,2,0,3,0,6,2,1,0,751,350,401,3,3,0,185,73,191,160,73,51,95,39,96,75,28,9,90,34,95,85,45,42,1,0,3,-1,0,0,1,0,2,0,0,0,0,0,1,-1,0,0,302,144,158,19,10,9,65,45,77,69,16,22,30,28,31,38,7,7,35,17,46,31,9,15,3,3,7,6,0,0,1,3,4,2,0,0,2,0,3,4,0,0,363,173,190,37,27,10,60,21,118,75,18,61,33,4,59,45,10,17,27,17,59,30,8,44,4,4,8,12,7,2,2,2,5,11,7,0,2,2,3,1,0,2,258,149,109,42,24,18,74,6,82,51,16,18,40,4,43,32,13,11,34,2,39,19,3,7,9,5,15,8,3,2,6,3,6,6,2,1,3,2,9,2,1,1,329,169,160,57,37,20,67,53,88,71,9,29,34,31,39,42,4,13,33,22,49,29,5,16,8,11,12,19,3,2,4,9,5,15,2,1,4,2,7,4,1,1,406,198,208,30,15,15,91,21,139,81,21,40,55,12,68,43,9,5,36,9,71,38,12,35,4,7,7,2,2,5,2,5,3,2,1,1,2,2,4,0,1,4,470,207,263,27,13,14,101,29,159,102,30,34,41,3,76,55,18,6,60,26,83,47,12,28,5,4,5,4,4,2,4,3,2,1,1,1,1,1,3,3,3,1,582,288,294,15,5,10,112,53,244,114,15,32,62,13,118,66,6,16,50,40,126,48,9,16,6,7,5,0,0,-3,4,2,1,0,0,-2,2,5,4,0,0,-1,250,98,152,41,15,26,56,-4,95,62,9,25,14,-10,52,37,1,3,42,6,43,25,8,22,6,6,11,9,3,4,3,-1,5,6,0,1,3,7,6,3,3,3,271,117,154,20,3,17,41,-4,121,51,16,33,18,-1,59,24,5,6,23,-3,62,27,11,27,7,4,0,5,-2,2,3,0,-1,1,-1,0,4,4,1,4,-1,2,307,156,151,36,13,23,67,7,114,65,18,32,39,1,69,22,9,13,28,6,45,43,9,19,11,6,3,11,4,1,4,1,3,2,1,2,7,5,0,9,3,-1,240,137,103,50,27,23,39,9,86,63,4,25,24,7,47,37,3,8,15,2,39,26,1,17,10,3,7,16,9,4,7,2,2,11,2,2,3,1,5,5,7,2,265,122,143,41,22,19,77,14,81,62,1,25,38,13,33,30,3,4,39,1,48,32,-2,21,13,9,5,11,1,2,9,4,1,7,0,2,4,5,4,4,1,0,250,143,107,91,45,46,76,2,63,59,-1,47,47,3,31,44,-1,21,29,-1,32,15,0,26,25,10,10,20,16,6,12,6,3,12,8,3,13,4,7,8,8,3,90,37,53,59,23,36,62,-10,3,19,-7,19,29,-5,-3,15,-6,4,33,-5,6,4,-1,15,19,0,7,13,8,7,9,1,2,3,2,4,10,-1,5,10,6,3
46,46223,Sedaví,8287,119,91,28,39,29,10,11,21,52,24,6,2,7,13,32,23,6,6,4,8,20,1,0,-4,1,14,12,9,3,0,1,9,9,8,2,0,0,5,3,1,1,0,141,64,77,69,39,30,30,16,57,23,-2,15,16,10,31,7,-3,3,14,6,26,16,1,12,15,11,23,16,2,2,10,7,13,7,1,1,5,4,10,9,1,1,176,111,65,71,44,27,37,36,49,30,18,6,16,24,43,19,13,-3,21,12,6,11,5,9,18,11,25,12,4,1,10,7,17,7,3,0,8,4,8,5,1,1,131,73,58,67,38,29,47,3,35,35,1,4,31,-2,18,16,0,7,16,5,17,19,1,-3,13,12,16,15,6,4,10,6,9,8,2,2,3,6,7,7,4,2,191,80,111,91,45,46,26,39,41,45,15,15,16,2,17,21,11,8,10,37,24,24,4,7,17,29,23,14,5,2,11,11,11,11,0,1,6,18,12,3,5,1,260,109,151,74,34,40,64,38,85,45,14,15,23,16,38,22,4,4,41,22,47,23,10,11,18,13,28,7,5,2,9,6,12,4,1,1,9,7,16,3,4,1,265,125,140,79,38,41,58,47,134,14,-3,14,33,28,64,0,-8,7,25,19,70,14,5,7,19,20,25,12,2,1,8,9,14,7,0,0,11,11,11,5,2,1,139,73,66,83,40,43,-1,39,48,41,4,7,10,8,23,22,2,5,-11,31,25,19,2,2,10,30,25,13,3,2,4,16,12,4,3,1,6,14,13,9,0,1,141,68,73,20,5,15,23,11,46,22,15,24,9,16,13,14,7,11,14,-5,33,8,8,13,11,-2,6,-2,5,0,1,-5,3,1,4,0,10,3,3,-3,1,0,61,-3,64,42,21,21,4,16,-13,2,12,29,-8,-8,-10,1,7,7,12,24,-3,1,5,22,6,7,8,9,6,3,4,1,6,2,5,1,2,6,2,7,1,2,103,55,48,40,22,18,15,29,29,25,-4,1,5,16,15,14,2,-2,10,13,14,11,-6,3,11,13,6,8,0,0,7,8,3,4,0,0,4,5,3,4,0,0,17,15,2,-16,-9,-7,22,-16,-7,-4,15,14,8,-1,-2,-1,9,6,14,-15,-5,-3,6,8,-3,-1,-7,-5,0,-2,1,4,-12,-3,1,-1,-4,-5,5,-2,-1,-1,-13,0,-13,-40,-31,-9,2,-19,20,-1,-3,-13,5,-8,3,2,1,-6,-3,-11,17,-3,-4,-7,4,-3,-15,-17,-7,-4,-2,-5,-10,-10,-3,-2,6,2,-5,-7,-4,-2,2,-16,18,-48,-27,-21,10,3,-5,-19,4,9,7,-1,-8,-18,3,3,3,4,3,-1,1,6,-2,-4,-24,-18,-2,1,-1,1,-16,-10,-2,0,-1,-5,-8,-8,0,1,-6,10,-16,-47,-27,-20,8,-2,-8,-1,-14,12,12,0,1,6,-11,3,-4,-2,-9,-7,-3,9,0,-5,-14,-16,-12,-1,2,-3,-7,-10,-9,0,-2,-2,-7,-6,-3,-1,-1,5,-6,-28,-8,-20,-9,2,-10,-9,12,10,-1,1,4,-4,9,-3,-8,1,-14,-5,3,13,-4,-7,-8,-6,-4,0,-1,-3,-4,3,-2,-1,-3,-4,-4,-9,-2,1,77,31,46,30,14,16,7,9,28,20,-3,6,4,2,14,10,-3,0,3,7,14,10,0,6,3,8,16,-2,3,2,0,2,10,-1,2,1,3,6,6,-1,1,1,79,37,42,61,26,35,15,9,33,8,13,-1,5,5,4,15,12,-7,10,4,29,-7,1,6,1,20,18,12,7,0,0,10,5,5,5,0,1,10,13,7,2,0
46,46228,Serra,1835,48,27,21,11,5,6,11,3,16,10,7,1,11,-2,7,9,1,0,0,5,9,1,6,1,2,1,3,5,0,0,2,0,1,2,0,0,0,1,2,3,0,0,27,28,-1,11,7,4,-10,4,12,13,4,4,-8,8,16,3,3,5,-2,-4,-4,10,1,-1,2,4,3,0,0,2,1,2,3,0,0,1,1,2,0,0,0,1,128,79,49,33,20,13,30,12,23,39,14,7,18,6,10,27,10,5,12,6,13,12,4,2,12,10,1,8,2,0,7,7,0,5,1,0,5,3,1,3,1,0,55,20,35,17,9,8,7,16,16,-1,13,3,4,5,12,-6,5,-1,3,11,4,5,8,4,2,3,3,6,2,1,3,1,0,4,1,0,-1,2,3,2,1,1,142,85,57,16,9,7,38,22,21,46,16,-1,22,13,14,24,10,-1,16,9,7,22,6,0,4,3,4,2,1,0,1,3,2,0,1,0,3,0,2,2,0,0,104,68,36,24,12,12,26,11,39,18,7,-1,17,6,17,17,5,2,9,5,22,1,2,-3,12,4,6,2,0,0,7,2,3,0,0,0,5,2,3,2,0,0,175,84,91,19,11,8,16,9,26,63,28,29,-2,-2,19,38,12,16,18,11,7,25,16,13,2,4,6,5,1,1,0,1,5,4,0,1,2,3,1,1,1,0,149,78,71,47,21,26,22,31,48,14,24,2,15,14,26,10,10,-3,7,17,22,4,14,5,11,13,12,7,2,0,5,5,6,2,1,0,6,8,6,5,1,0,91,55,36,40,22,18,23,18,21,40,1,-17,12,10,11,24,0,-5,11,8,10,16,1,-12,5,11,13,8,2,-1,2,6,8,4,2,-1,3,5,5,4,0,0,102,69,33,11,4,7,12,26,26,31,1,-3,7,16,17,20,8,-4,5,10,9,11,-7,1,0,5,1,1,3,1,-1,3,0,0,2,0,1,2,1,1,1,1,131,66,65,30,17,13,31,16,40,29,9,10,11,15,17,8,7,10,20,1,23,21,2,0,4,9,10,3,3,1,2,4,8,1,1,1,2,5,2,2,2,0,-4,17,-21,34,18,16,3,9,-13,2,-1,-2,1,1,9,0,5,2,2,8,-22,2,-6,-4,9,8,7,9,0,1,3,4,5,6,-1,1,6,4,2,3,1,0,-52,-50,-2,-13,-19,6,-9,-9,-21,-7,-7,3,-10,-4,-18,-7,-8,-2,1,-5,-3,0,1,5,0,1,-10,-4,-1,1,-4,1,-10,-5,-2,1,4,0,0,1,1,0,25,20,5,-6,0,-6,7,-1,19,10,-7,-4,8,-2,8,12,-5,-1,-1,1,11,-2,-2,-3,-1,-1,-3,0,0,-1,1,-1,-1,0,1,0,-2,0,-2,0,-1,-1,-56,-20,-36,10,3,7,-17,-12,-12,2,-12,-6,-3,-8,-5,3,-4,-4,-14,-4,-7,-1,-8,-2,4,-1,1,4,2,0,1,-2,1,2,1,0,3,1,0,2,1,0,-64,-32,-32,6,2,4,-10,3,-15,-25,-13,-2,-4,2,-8,-16,-6,1,-6,1,-7,-9,-7,-3,3,3,1,0,-2,1,2,2,0,-1,-2,1,1,1,1,1,0,0,24,-3,27,33,19,14,16,9,-1,-2,5,-3,2,5,-6,-2,0,-1,14,4,5,0,5,-2,11,1,6,2,10,3,6,1,4,3,4,1,5,0,2,-1,6,2,34,24,10,15,7,8,-4,-10,8,13,6,16,-2,-5,8,4,6,9,-2,-5,0,9,0,7,1,3,-2,3,3,6,0,3,-2,1,1,3,1,0,0,2,2,3
46,46230,Silla,15710,86,65,21,73,42,31,19,11,23,9,-1,21,12,12,24,3,3,7,7,-1,-1,6,-4,14,7,12,33,11,5,5,3,7,20,7,2,3,4,5,13,4,3,2,6,8,-2,87,59,28,10,-18,13,3,-9,7,4,1,6,-1,-6,3,6,-19,7,4,-3,4,8,25,36,14,2,2,6,16,26,9,1,1,2,9,10,5,1,1,280,167,113,192,105,87,73,56,90,46,0,4,45,35,53,29,2,0,28,21,37,17,-2,4,24,56,62,31,11,5,11,31,37,20,4,2,13,25,25,11,7,3,400,206,194,252,138,114,91,95,103,80,5,16,40,50,40,60,6,4,51,45,63,20,-1,12,63,47,72,55,12,3,32,27,42,31,6,0,31,20,30,24,6,3,297,154,143,232,130,102,68,36,87,83,6,1,42,16,53,35,2,-1,26,20,34,48,4,2,37,63,72,46,8,1,20,34,45,25,4,0,17,29,27,21,4,1,369,222,147,242,141,101,65,75,163,73,-10,-4,44,41,92,48,-11,2,21,34,71,25,1,-6,43,74,60,55,6,2,23,44,38,31,2,1,20,30,22,24,4,1,415,227,188,265,136,129,92,61,199,13,20,18,37,38,122,9,10,5,55,23,77,4,10,13,53,86,84,20,14,2,20,40,50,16,6,1,33,46,34,4,8,1,461,231,230,262,125,137,36,150,155,75,18,19,33,66,82,26,13,9,3,84,73,49,5,10,40,96,61,50,8,6,22,53,15,27,4,3,18,43,46,23,4,3,-24,-33,9,32,9,23,-20,47,-36,-20,-12,8,-1,17,-19,-25,-9,2,-19,30,-17,5,-3,6,3,38,-9,-18,10,6,10,7,-1,-14,3,3,-7,31,-8,-4,7,3,30,-33,63,81,16,65,46,6,-26,-3,-20,20,14,-11,-28,-5,-11,2,32,17,2,2,-9,18,35,22,11,7,2,0,16,12,-7,-4,-1,-1,19,10,18,11,3,1,-85,-50,-35,-22,-15,-7,-9,-4,-12,-36,-14,-3,4,-7,-7,-31,-3,-1,-13,3,-5,-5,-11,-2,-10,21,-10,-17,-2,-6,-2,13,-10,-14,-1,-1,-8,8,0,-3,-1,-5,-200,-119,-81,-137,-77,-60,-33,2,-83,-45,-33,-14,-19,-1,-49,-22,-23,-9,-14,3,-34,-23,-10,-5,-15,-7,-60,-31,-27,-3,-2,-8,-39,-15,-14,-2,-13,1,-21,-16,-13,-1,-248,-131,-117,-102,-76,-26,-36,-37,-103,-66,-13,9,-5,-34,-40,-45,-13,9,-31,-3,-63,-21,0,0,-3,-5,-55,-33,-6,0,-6,-14,-31,-20,-7,2,3,9,-24,-13,1,-2,-161,-95,-66,-53,-36,-17,-16,1,-58,-53,-42,7,-7,4,-39,-40,-22,6,-9,-3,-19,-13,-20,1,10,-9,-27,-12,-17,0,8,-5,-22,-12,-7,0,2,-4,-5,0,-10,0,-70,-22,-48,-42,-28,-14,9,-19,-31,-26,-14,6,17,-8,-27,-4,-7,2,-8,-11,-4,-22,-7,4,-2,-4,-12,-17,-4,-5,-3,6,-15,-10,-5,-3,1,-10,3,-7,1,-2,-102,-49,-53,-58,-40,-18,-10,-9,-51,-17,-10,-4,-1,-13,-22,-8,-6,0,-9,4,-29,-9,-4,-4,8,-3,-18,-31,-9,-4,1,-4,-8,-20,-7,-2,7,1,-10,-11,-2,-2,-6,-6,0,49,10,39,-5,18,8,-34,-17,25,5,13,5,-21,-7,1,-10,5,3,-13,-10,24,15,14,17,0,3,0,6,7,1,-2,0,-2,9,7,16,2,3,2,66,31,35,84,32,52,13,10,14,13,5,9,8,5,6,9,-4,3,5,5,8,4,9,6,19,12,14,20,16,-2,5,5,2,8,7,1,14,7,12,12,9,-3
46,46235,Sueca,25173,207,97,110,23,11,12,37,18,76,48,14,5,18,15,36,19,7,-1,19,3,40,29,7,6,6,2,8,1,3,3,3,1,3,0,2,2,3,1,5,1,1,1,183,99,84,10,7,3,20,49,29,49,27,9,17,23,19,24,8,7,3,26,10,25,19,2,2,1,0,4,2,1,1,0,0,3,2,1,1,1,0,1,0,0,80,69,11,5,2,3,16,8,39,1,10,3,18,0,39,3,6,1,-2,8,0,-2,4,2,3,3,-2,0,1,0,1,2,-1,0,1,-1,2,1,-1,0,0,1,81,66,15,31,19,12,2,14,-14,33,39,5,1,4,4,21,27,6,1,10,-18,12,12,-1,2,3,13,5,4,4,0,2,10,2,2,3,2,1,3,3,2,1,495,277,218,255,140,115,76,121,128,98,49,22,35,68,73,71,15,10,41,53,55,27,34,12,24,83,85,47,11,5,10,45,49,27,6,3,14,38,36,20,5,2,363,215,148,275,168,107,44,109,147,49,5,5,14,61,105,36,-1,1,30,48,42,13,6,4,35,89,84,48,13,5,19,57,60,27,4,2,16,32,24,21,9,3,600,320,280,414,226,188,103,158,182,109,22,23,60,81,115,60,-3,6,43,77,67,49,25,17,78,125,105,67,25,11,40,74,61,34,11,4,38,51,44,33,14,7,534,334,200,502,294,208,80,139,168,110,31,1,42,97,101,66,30,0,38,42,67,44,1,1,72,144,152,90,29,9,39,87,96,47,18,4,33,57,56,43,11,5,187,110,77,227,112,115,12,92,46,40,2,-5,12,41,38,11,10,0,0,51,8,29,-8,-5,42,79,65,29,8,0,22,39,33,11,3,2,20,40,32,18,5,-2,90,64,26,157,79,78,9,53,5,11,11,-5,-2,39,1,13,14,-4,11,14,4,-2,-3,-1,18,56,34,31,17,1,8,28,15,19,9,-1,10,28,19,12,8,2,-10,-27,17,105,33,72,-21,59,-52,-26,11,15,-10,43,-43,-27,6,3,-11,16,-9,1,5,12,25,63,-4,6,8,1,13,36,-14,-8,2,0,12,27,10,14,6,1,165,117,48,185,130,55,23,71,31,5,4,21,20,38,27,4,5,18,3,33,4,1,-1,3,27,67,43,19,18,11,21,51,30,15,9,4,6,16,13,4,9,7,-62,-56,-6,-105,-70,-35,20,-4,-54,-24,-11,9,15,4,-50,-31,-5,8,5,-8,-4,7,-6,1,-4,-16,-42,-34,-13,5,1,-9,-32,-27,-7,5,-5,-7,-10,-7,-6,0,-255,-205,-50,-198,-157,-41,-33,-50,-89,-71,-19,3,-19,-30,-74,-74,-7,-1,-14,-20,-15,3,-12,4,-32,-18,-76,-53,-17,-4,-18,-16,-62,-51,-6,-5,-14,-2,-14,-2,-11,1,20,4,16,54,12,42,-5,23,-12,22,7,-21,-3,3,-10,10,10,-10,-2,20,-2,12,-3,-11,7,21,22,-2,7,-4,-1,7,8,-1,0,-4,8,14,14,-1,7,0,31,17,14,112,55,57,34,8,-32,5,5,15,16,9,-1,-3,-2,2,18,-1,-31,8,7,13,17,25,24,20,19,6,6,14,13,9,10,2,11,11,11,11,9,4,5,11,-6,113,61,52,12,27,16,-19,-25,-5,12,8,13,-3,-11,-7,0,19,3,-16,-14,2,19,22,34,16,15,3,8,10,18,11,10,0,11,12,16,5,5,3,114,49,65,207,94,113,50,-14,46,24,1,7,25,-16,10,29,-1,3,25,2,36,-5,2,4,58,21,44,49,29,5,29,5,21,27,11,0,29,16,23,22,18,5
46,46237,Tavernes Blanques,8406,70,43,27,31,17,14,3,11,50,22,-2,-14,-1,11,25,6,3,-3,4,0,25,16,-5,-11,1,5,13,9,2,0,0,3,9,5,0,0,1,2,4,4,2,0,167,97,70,58,37,21,29,43,81,22,-4,-5,12,26,54,12,-6,0,17,17,27,10,2,-5,5,19,21,8,3,2,2,12,15,6,2,0,3,7,6,2,1,2,205,99,106,94,42,52,30,36,84,22,4,25,4,11,50,13,10,9,26,25,34,9,-6,16,27,16,29,18,2,1,9,7,13,10,2,0,18,9,16,8,0,1,38,2,36,5,4,1,-5,1,41,-15,-7,24,-9,0,18,-8,-8,10,4,1,23,-7,1,14,0,2,2,0,1,0,0,1,2,0,1,0,0,1,0,0,0,0,42,30,12,51,29,22,-9,15,50,-25,18,-6,0,13,29,-22,10,0,-9,2,21,-3,8,-6,7,12,19,10,4,-1,4,7,11,4,3,0,3,5,8,6,1,-1,-29,-1,-28,11,4,7,12,-31,-1,0,-6,-2,4,-11,2,10,-8,1,8,-20,-3,-10,2,-3,4,10,-3,1,-3,2,2,8,-5,1,-4,2,2,2,2,0,1,0,44,21,23,32,12,20,12,18,26,12,-15,-11,3,11,15,2,-4,-7,9,7,11,10,-11,-4,9,5,16,1,2,-1,2,4,7,-1,1,-1,7,1,9,2,1,0,29,33,-4,52,26,26,-6,10,-8,24,-5,13,-3,3,7,16,-2,9,-3,7,-15,8,-3,4,8,15,19,6,3,0,0,8,12,4,2,0,8,7,7,2,1,0,-44,-34,-10,31,16,15,6,-1,-3,-7,-14,-21,-4,-2,-11,-9,-4,-2,10,1,8,2,-10,-19,10,13,12,-7,3,0,7,7,6,-6,2,0,3,6,6,-1,1,0,31,8,23,15,-2,17,20,22,-17,10,-8,2,5,15,-13,6,-3,2,15,7,-4,4,-5,0,7,7,-10,3,3,1,3,6,-9,-2,-1,0,4,1,-1,5,4,1,-110,-71,-39,-21,-27,6,-16,-8,-71,-11,-15,7,-5,-10,-46,-5,-12,4,-11,2,-25,-6,-3,3,-5,9,-11,-12,-4,-1,-2,-4,-7,-12,-3,-1,-3,13,-4,0,-1,0,0,-9,9,-5,-7,2,14,1,-3,-5,-10,1,4,2,-13,-6,4,-1,10,-1,10,1,-14,2,2,2,-2,-6,-1,0,0,2,-4,-6,1,0,2,0,2,0,-2,0,-30,-24,-6,-21,-13,-8,13,1,-21,-11,-13,1,10,-2,-13,-10,-12,2,3,3,-8,-1,-1,-1,-5,-1,-4,-9,-4,2,-4,0,-3,-3,-4,1,-1,-1,-1,-6,0,1,-19,-1,-18,-20,-6,-14,-3,16,-27,-18,-4,14,3,10,1,-13,-11,7,-6,6,-28,-5,7,7,-3,-5,-5,-8,0,0,0,-1,-2,-3,0,0,-3,-4,-3,-5,0,0,-65,-30,-35,-25,-20,-5,1,-24,7,-17,-16,-18,5,-15,0,1,-9,-11,-4,-9,7,-18,-7,-7,4,-4,-13,-5,-6,-2,1,-5,-11,-1,-2,-2,3,1,-2,-4,-4,0,-59,-9,-50,-4,-3,-1,-10,2,-10,-48,11,-4,-1,4,-3,-17,8,-1,-9,-2,-7,-31,3,-3,-1,-1,1,-4,4,-2,2,-1,-2,-2,2,-1,-3,0,3,-2,2,-1,-65,-38,-27,-5,-4,-1,-6,2,-8,-50,-13,2,-3,0,-9,-29,-4,3,-3,2,1,-21,-9,-1,-4,14,-3,-13,1,0,-2,8,-3,-7,0,0,-2,6,0,-6,1,0,43,38,5,24,6,18,9,8,25,4,6,-7,10,2,23,7,-4,1,-1,6,2,-3,10,-8,3,9,5,1,4,2,3,0,2,-2,1,2,0,9,3,3,3,0
46,46238,Tavernes de la Valldigna,16300,-22,-11,-11,4,3,1,-14,1,-6,1,6,-11,-5,1,-3,3,-3,-5,-9,0,-3,-2,9,-6,0,0,2,0,2,0,0,0,2,0,1,0,0,0,0,0,1,0,35,14,21,6,4,2,5,4,-1,18,7,2,3,-2,2,5,3,3,2,6,-3,13,4,-1,0,0,2,1,2,1,0,0,1,1,1,1,0,0,1,0,1,0,58,58,0,-5,-2,-3,-5,-12,33,16,19,5,-5,3,31,14,12,0,0,-15,2,2,7,5,-1,-3,-3,-3,1,4,0,-2,-2,-1,1,2,-1,-1,-1,-2,0,2,89,43,46,46,25,21,-5,18,43,39,3,-9,-10,10,14,23,2,4,5,8,29,16,1,-13,6,12,16,5,4,3,4,7,8,2,3,1,2,5,8,3,1,2,328,171,157,192,107,85,57,65,96,43,38,22,22,39,62,21,19,4,35,26,34,22,19,18,39,45,54,26,17,9,21,29,31,13,7,5,18,16,23,13,10,4,288,187,101,262,149,113,37,70,82,69,11,19,31,40,56,44,7,11,6,30,26,25,4,8,39,80,71,49,12,10,27,47,41,28,3,3,12,33,30,21,9,7,77,26,51,227,111,116,21,38,14,25,-18,-5,13,27,-3,10,-19,-1,8,11,17,15,1,-4,43,59,56,48,7,12,24,39,25,18,0,4,19,20,31,30,7,8,303,186,117,334,201,133,39,117,70,65,11,1,25,67,60,38,-1,-1,14,50,10,27,12,2,28,126,92,58,26,2,25,79,55,32,11,-1,3,47,37,26,15,3,-149,-103,-46,18,-2,20,-9,-7,-56,-42,-30,-7,2,-7,-43,-30,-18,-5,-11,0,-13,-12,-12,-2,20,5,10,-18,-6,5,14,2,-2,-18,-1,3,6,3,12,0,-5,2,-83,-70,-13,35,6,29,-3,5,-33,-50,6,-4,-14,-10,-18,-27,7,-3,11,15,-15,-23,-1,-1,18,26,-12,-1,6,-1,8,10,-11,-5,6,-1,10,16,-1,4,0,0,88,59,29,216,131,85,-6,64,5,9,-1,11,3,59,1,2,-8,-6,-9,5,4,7,7,17,20,85,50,29,16,7,13,62,30,11,6,2,7,23,20,18,10,5,-54,-28,-26,17,4,13,4,4,-47,-13,-16,12,12,0,-31,-6,-8,6,-8,4,-16,-7,-8,6,12,25,2,-10,-7,-7,12,6,1,-11,0,-4,0,19,1,1,-7,-3,-175,-106,-69,-156,-87,-69,-10,-46,-55,-95,-5,33,-9,-18,-30,-61,-1,12,-1,-28,-25,-34,-4,21,-6,-35,-48,-52,-7,-11,-3,-23,-27,-32,0,-3,-3,-12,-21,-20,-7,-8,-20,-28,8,-107,-70,-37,-10,-20,-34,-11,-1,52,-13,-12,-30,5,-5,24,3,-8,-4,-16,4,28,-17,-18,-46,-26,-6,4,-14,-17,-29,-11,-6,4,-3,-1,-17,-15,0,0,-32,-31,-1,17,7,10,-19,43,-6,-53,-12,14,-17,27,12,-44,-7,2,-2,16,-18,-9,-5,12,-1,35,2,-21,2,-3,-7,28,5,-20,2,-2,6,7,-3,-1,0,-1,-141,-106,-35,-109,-82,-27,7,-34,-54,-39,-41,19,2,-22,-37,-33,-21,8,5,-12,-17,-6,-20,11,9,-16,-44,-26,-30,-5,4,-15,-27,-21,-21,-3,5,-1,-17,-5,-9,-2,-56,-46,-10,-25,-34,9,29,-22,-37,-23,-15,13,15,-23,-33,-14,-4,13,14,1,-4,-9,-11,0,10,-2,-7,-14,-11,-1,6,-4,-13,-16,-6,-1,4,2,6,2,-5,0,-88,-69,-19,-44,-41,-3,3,-16,-56,-15,-31,22,9,-6,-36,-19,-24,5,-6,-10,-20,4,-7,17,6,-4,-19,-10,-19,0,2,-2,-15,-12,-16,1,4,-2,-4,2,-3,-1
46,46244,Torrent,63616,723,371,352,343,191,152,140,121,257,137,19,48,63,61,150,76,6,17,77,60,107,61,13,31,56,81,117,60,22,6,32,41,67,36,12,2,24,40,50,24,10,4,1146,673,473,756,489,267,219,219,382,173,67,81,131,118,261,112,28,21,88,101,121,61,39,60,134,182,276,128,23,9,72,114,193,90,11,7,62,68,83,38,12,2,1505,809,696,643,330,313,305,274,482,215,89,111,187,141,279,106,48,38,118,133,203,109,41,73,148,151,197,93,35,10,73,82,107,42,18,4,75,69,90,51,17,6,1613,834,779,762,398,364,346,354,420,270,104,105,192,150,246,146,62,34,154,204,174,124,42,71,153,178,225,124,53,22,78,88,126,69,26,8,75,90,99,55,27,14,1422,768,654,786,413,373,208,338,423,206,130,93,110,179,247,116,68,29,98,159,176,90,62,64,144,186,239,123,68,21,70,91,140,70,31,8,74,95,99,53,37,13,1534,855,679,923,507,416,208,341,564,243,100,62,109,157,362,135,43,33,99,184,202,108,57,29,161,228,293,150,60,19,77,109,189,91,24,9,84,119,104,59,36,10,1660,915,745,1246,609,637,297,377,527,263,105,71,155,169,318,170,65,20,142,208,209,93,40,51,237,287,397,211,72,28,111,135,207,109,33,9,126,152,190,102,39,19,1290,700,590,1145,618,527,139,384,427,211,52,95,91,217,251,105,17,26,48,167,176,106,35,69,182,321,341,196,78,19,94,170,198,113,37,3,88,151,143,83,41,16,1330,719,611,845,478,367,176,322,567,163,50,35,91,156,330,102,9,11,85,166,237,61,41,24,129,221,287,128,55,7,75,116,173,74,26,3,54,105,114,54,29,4,748,363,385,505,231,274,76,228,169,122,85,56,43,103,102,59,39,14,33,125,67,63,46,42,109,159,110,78,34,9,57,80,53,25,13,3,52,79,57,53,21,6,-409,-293,-116,-568,-350,-218,-66,40,-227,-118,-122,56,-9,24,-157,-101,-59,3,-57,16,-70,-17,-63,53,-61,32,-232,-192,-92,-34,-21,14,-150,-137,-44,-16,-40,18,-82,-55,-48,-18,119,-53,172,-92,-126,34,12,71,-54,-81,40,123,6,10,-33,-80,3,32,6,61,-21,-1,37,91,3,39,-88,-74,18,3,7,13,-70,-77,-2,-1,-4,26,-18,3,20,4,-811,-595,-216,-686,-441,-245,-230,-98,-242,-284,-39,85,-159,-65,-195,-187,-27,31,-71,-33,-47,-97,-12,54,-93,-57,-261,-206,-58,-12,-47,-47,-184,-138,-19,-7,-46,-10,-77,-68,-39,-5,-387,-353,-34,-554,-340,-214,-22,-51,-173,-176,-35,55,-17,-63,-128,-116,-42,4,-5,12,-45,-60,7,51,-58,-47,-218,-174,-51,-14,-22,-33,-135,-110,-35,-6,-36,-14,-83,-64,-16,-8,-408,-297,-111,-405,-274,-131,-4,-50,-246,-179,-19,105,-40,-41,-123,-122,0,37,36,-9,-123,-57,-19,68,-4,-28,-173,-150,-47,-5,-8,-30,-108,-102,-25,-1,4,2,-65,-48,-22,-4,432,191,241,293,162,131,22,87,115,-12,90,118,21,38,35,0,49,42,1,49,80,-12,41,76,33,69,67,52,64,5,28,37,35,25,34,2,5,32,32,27,30,3,232,-9,241,65,-34,99,46,62,-23,-24,43,129,39,27,-66,-42,-3,35,7,35,43,18,46,94,45,66,-18,-43,-6,16,26,33,-41,-52,-10,6,19,33,23,9,4,10,383,101,282,-15,-39,24,125,66,72,-84,29,156,71,34,65,-102,8,19,54,32,7,18,21,137,58,49,30,-124,-24,-21,40,25,28,-98,-27,-14,18,24,2,-26,3,-7
46,46248,Turís,4655,101,63,38,38,27,11,22,19,33,11,11,4,8,14,29,10,3,-1,14,5,4,1,8,5,3,7,17,4,6,1,1,5,15,4,1,1,2,2,2,0,5,0,144,93,51,71,53,18,28,34,32,37,6,6,25,17,20,23,6,3,3,17,12,14,0,3,4,19,26,15,3,2,3,15,21,11,1,1,1,4,5,4,2,1,141,71,70,49,34,15,11,19,32,30,30,20,6,6,18,15,20,6,5,13,14,15,10,14,3,5,18,9,10,4,1,4,14,7,7,1,2,1,4,2,3,3,224,131,93,76,48,28,25,25,20,81,65,9,12,11,26,43,34,6,13,14,-6,38,31,3,5,15,13,24,17,2,4,7,10,14,12,1,1,8,3,10,5,1,235,119,116,112,57,55,53,36,49,55,54,-14,29,16,25,24,30,-4,24,20,24,31,24,-10,15,22,17,18,36,4,9,11,11,8,15,3,6,11,6,10,21,1,229,111,118,82,38,44,45,29,69,55,23,4,19,12,35,27,12,4,26,17,34,28,11,0,10,16,21,15,15,2,4,8,11,7,6,1,6,8,10,8,9,1,272,159,113,85,48,37,44,26,71,65,46,12,26,21,42,37,24,6,18,5,29,28,22,6,6,12,23,18,23,3,2,10,14,7,12,3,4,2,9,11,11,0,227,134,93,71,37,34,42,42,65,67,9,-3,28,27,35,43,3,-5,14,15,30,24,6,2,10,22,19,12,7,-1,6,10,14,4,3,-1,4,12,5,8,4,0,146,70,76,45,22,23,39,15,42,39,11,-8,20,8,21,19,6,-6,19,7,21,20,5,-2,7,5,13,11,8,-1,5,6,6,3,5,-3,2,-1,7,8,3,2,-11,8,-19,-25,-6,-19,-7,8,-11,-3,7,-4,8,2,0,-3,6,-4,-15,6,-11,0,1,0,5,5,-10,-9,-12,-5,5,5,-4,-6,-4,-2,0,0,-6,-3,-8,-3,-19,-9,-10,-68,-44,-24,-10,-1,14,-18,1,-8,-11,-6,9,-8,6,0,1,5,5,-10,-5,-8,-3,-7,-19,-13,-20,-6,-5,-6,-14,-8,-10,-1,2,-1,-5,-5,-10,-5,114,61,53,2,12,-10,13,8,42,13,25,8,18,5,15,7,13,0,-5,3,27,6,12,8,-2,4,3,-6,3,0,3,2,7,-2,2,0,-5,2,-4,-4,1,0,34,11,23,13,5,8,14,11,26,-5,-9,-1,-4,6,13,2,-5,0,18,5,13,-7,-4,-1,4,2,4,0,0,2,0,1,0,3,-2,2,4,1,4,-3,2,0,-95,-60,-35,-38,-26,-12,-13,-10,-32,-19,-14,-4,-12,-2,-15,-20,-5,-3,-1,-8,-17,1,-9,-1,-3,-3,-14,-7,-5,-6,-1,0,-11,-7,-3,-4,-2,-3,-3,0,-2,-2,-66,-28,-38,-33,-25,-8,-14,-11,-12,-26,7,-13,-1,-6,-11,-9,3,-7,-13,-5,-1,-17,4,-6,-4,0,-10,-15,-1,-4,-2,0,-8,-8,-3,-4,-2,0,-2,-7,2,0,40,-3,43,-17,-21,4,10,-7,15,2,9,10,6,-10,3,-7,5,0,4,3,12,9,4,10,3,-2,-10,-15,4,2,2,-1,-7,-17,0,2,1,-1,-3,2,4,0,11,0,11,29,20,9,-14,-9,10,16,-1,10,-5,-6,0,11,-1,2,-9,-3,10,5,0,8,-3,1,8,15,8,0,1,0,5,10,3,1,-4,1,3,5,5,-1,23,23,0,15,12,3,27,3,12,-13,4,-11,16,1,10,-10,4,1,11,2,2,-3,0,-12,12,4,-1,0,1,-2,8,0,-1,0,0,4,4,4,0,0,1,-6
46,46250,Valencia,739412,9455,5147,4308,11957,6559,5398,731,2575,3955,1609,225,342,372,1383,2333,822,-7,228,359,1192,1622,787,232,114,1295,2933,4676,2321,510,152,664,1532,2760,1250,247,69,631,1401,1916,1071,263,83,13202,6919,6283,16393,8643,7750,2204,3838,4882,2095,302,-162,1117,1907,2733,1050,96,11,1087,1931,2149,1045,206,-173,2571,4334,5801,2774,666,145,1318,2202,3292,1418,304,65,1253,2132,2509,1356,362,80,11200,5758,5442,16300,8417,7883,2635,3618,3590,1804,23,-440,1193,1853,2058,890,-76,-139,1442,1765,1532,914,99,-301,3318,4108,5071,2645,812,224,1626,2057,2871,1358,364,75,1692,2051,2200,1287,448,149,7823,4291,3532,14165,7316,6849,1596,3027,2627,1129,-15,-497,815,1601,1593,583,-119,-159,781,1426,1034,546,104,-338,2538,3790,4510,2205,792,221,1266,1889,2564,1131,319,94,1272,1901,1946,1074,473,127,8370,4771,3599,13324,7215,6109,997,3184,3082,1483,184,-477,454,1765,1835,833,40,-128,543,1419,1247,650,144,-349,1763,3596,4743,2240,715,200,904,1896,2786,1192,320,82,859,1700,1957,1048,395,118,8027,5310,2717,14652,8236,6416,551,3435,3121,1155,112,-236,237,2020,2362,773,28,-66,314,1415,759,382,84,-170,2064,3895,5155,2458,752,242,1017,2128,3176,1418,352,103,1047,1767,1979,1040,400,139,4540,1814,2726,14415,7197,7218,999,3327,1239,187,-472,-662,350,1581,594,-107,-302,-258,649,1746,645,294,-170,-404,2390,4163,4814,2138,616,161,1113,2037,2652,1015,258,68,1277,2126,2162,1123,358,93,7422,3559,3863,14909,7675,7234,1158,4713,1742,377,81,-504,574,2498,887,-113,-76,-117,584,2215,855,490,157,-387,2240,5311,4700,1898,565,122,1155,2785,2556,852,243,55,1085,2526,2144,1046,322,67,4078,2289,1789,9312,5184,4128,537,2793,698,107,30,-38,259,1577,488,-23,-44,36,278,1216,210,130,74,-74,1255,3352,3171,1112,238,66,678,1822,1926,585,95,21,577,1530,1245,527,143,45,-5174,-3268,-1906,-52,-726,674,-209,668,-2849,-1523,-655,-559,-71,312,-1873,-1024,-399,-164,-138,356,-976,-499,-256,-395,215,1193,-661,-711,-181,13,104,544,-681,-631,-108,6,111,649,20,-80,-73,7,-9372,-5640,-3732,-4874,-3163,-1711,-609,615,-4381,-2972,-1130,-903,-236,281,-2709,-2085,-638,-279,-373,334,-1672,-887,-492,-624,-227,1154,-2784,-2205,-720,-185,-30,614,-1730,-1585,-412,-68,-197,540,-1054,-620,-308,-117,-930,-789,-141,1432,532,900,141,1386,-1154,-886,-13,-384,126,619,-684,-643,-135,-42,15,767,-470,-243,122,-342,467,1653,-53,-599,-126,-2,305,789,-9,-453,-161,8,162,864,-44,-146,35,-10,-4169,-2783,-1386,-3106,-2204,-902,-138,599,-2256,-1663,-282,-427,-77,140,-1453,-1102,-153,-128,-61,459,-803,-561,-129,-299,-46,585,-1660,-1463,-477,-113,3,173,-1100,-977,-279,-56,-49,412,-560,-486,-198,-57,-4561,-2988,-1573,-4438,-2819,-1619,-204,287,-2645,-1446,-186,-389,-86,-1,-1649,-1013,-146,-102,-118,288,-996,-433,-40,-287,-300,214,-2263,-1598,-520,-47,-140,-4,-1329,-1080,-286,-16,-160,218,-934,-518,-234,-31,1383,676,707,1164,433,731,324,1419,-72,-50,224,-468,150,628,-35,-59,89,-96,174,791,-37,9,135,-372,260,1130,-94,-317,22,79,147,487,-58,-237,25,30,113,643,-36,-80,-3,49,5349,2483,2866,3927,1730,2197,1002,2077,1317,583,591,-322,542,949,667,168,112,-4,460,1128,650,415,479,-318,783,1560,740,294,289,165,432,715,323,52,92,66,351,845,417,242,197,99,1989,165,1824,1401,-43,1444,935,2154,-89,-773,180,-504,478,926,-315,-790,-121,-58,457,1228,226,17,301,-446,793,1754,-158,-994,-178,41,439,753,-273,-827,-239,36,354,1001,115,-167,61,5,8640,4035,4605,9139,4183,4956,1344,3170,2538,1093,774,-329,680,1519,1022,447,304,32,664,1651,1516,646,470,-361,1546,2827,2383,1341,610,305,840,1302,1012,557,266,134,706,1525,1371,784,344,171
46,46251,Vallada,3064,-11,-1,-10,23,16,7,-6,5,3,-12,3,-3,-4,5,6,-6,-2,0,-2,0,-3,-6,5,-3,2,6,10,1,4,0,1,5,8,1,1,0,1,1,2,0,3,0,64,48,16,70,47,23,7,13,25,16,1,2,5,8,21,14,-1,1,2,5,4,2,2,1,9,13,27,17,4,0,5,7,19,14,2,0,4,6,8,3,2,0,84,52,32,76,47,29,8,19,32,22,1,3,6,12,20,17,-3,0,2,7,12,5,4,3,9,20,25,17,5,0,6,12,17,11,1,0,3,8,8,6,4,0,49,40,9,37,22,15,-2,9,8,4,13,15,3,6,5,8,10,6,-5,3,3,-4,3,9,3,8,13,6,7,0,2,3,8,5,4,0,1,5,5,1,3,0,-22,-7,-15,22,10,12,-2,-12,-12,5,5,-6,-1,-2,-4,1,2,-3,-1,-10,-8,4,3,-3,2,3,3,7,7,0,2,2,-1,4,3,0,0,1,4,3,4,0,-25,-16,-9,32,14,18,-7,1,-22,2,4,-3,-5,6,-16,-2,2,-1,-2,-5,-6,4,2,-2,3,7,7,10,5,0,1,4,4,4,1,0,2,3,3,6,4,0,175,88,87,54,28,26,23,25,50,42,32,5,15,9,21,24,17,2,8,16,29,18,15,3,14,8,21,8,3,0,9,4,9,5,1,0,5,4,12,3,2,0,39,24,15,62,35,27,17,12,-2,3,5,3,8,9,0,3,0,2,9,3,-2,0,5,1,11,12,17,10,9,2,7,7,10,5,3,2,4,5,7,5,6,0,-3,6,-9,21,11,10,5,-13,-3,-6,11,1,5,-1,-6,1,6,0,0,-12,3,-7,5,1,4,3,6,1,6,0,2,2,4,1,2,0,2,1,2,0,4,0,-18,-6,-12,3,-1,4,5,-13,5,-6,-9,-3,9,-7,0,-7,-2,-2,-4,-6,5,1,-7,-1,2,-3,2,2,0,0,1,-2,0,0,1,-1,1,-1,2,2,-1,1,-46,-28,-18,-49,-27,-22,-15,-14,-15,3,-5,-2,-12,-7,-8,2,-3,-1,-3,-7,-7,1,-2,-1,-12,-10,-11,-7,-8,-1,-9,-4,-5,-5,-3,-1,-3,-6,-6,-2,-5,0,-49,-27,-22,-13,-13,0,-17,5,-12,-23,-5,3,-11,4,-5,-15,0,0,-6,1,-7,-8,-5,3,-5,2,0,-6,-4,0,-5,0,-1,-5,-2,0,0,2,1,-1,-2,0,-113,-58,-55,-58,-34,-24,-18,-11,-26,-34,-19,-5,-12,-7,-5,-22,-11,-1,-6,-4,-21,-12,-8,-4,-7,-5,-14,-14,-15,-3,-6,-4,-5,-10,-7,-2,-1,-1,-9,-4,-8,-1,-17,-16,-1,-10,-8,-2,4,1,-2,-9,-11,1,4,-3,-4,-5,-7,0,0,4,2,-4,-4,1,3,0,-2,-6,-6,1,1,-1,-1,-4,-4,1,2,1,-1,-2,-2,0,-1,-6,5,-3,-1,-2,-2,-3,-11,-7,-3,25,-1,-2,-7,-5,-1,10,-1,-1,-4,-2,-2,15,-1,-2,-3,0,3,0,-1,-2,0,0,3,-1,0,0,-3,0,0,1,-4,4,-8,4,4,0,2,1,-4,3,-6,0,1,-2,2,5,-2,0,1,3,-6,-2,-4,0,-1,1,1,1,2,0,0,0,1,2,1,0,-1,1,0,-1,1,0,20,9,11,-10,-8,-2,10,3,0,-1,0,9,1,1,5,-3,0,6,9,2,-5,2,0,3,0,0,1,-7,-3,-1,0,-1,1,-5,-2,-1,0,1,0,-2,-1,0,-46,-18,-28,-6,-2,-4,-10,-7,-8,-25,1,3,-3,-1,-1,-16,-1,4,-7,-6,-7,-9,2,-1,0,-1,-1,0,-4,0,-1,1,2,0,-4,0,1,-2,-3,0,0,0
46,46256,Vilamarxant,5862,134,77,57,21,11,10,23,19,46,28,12,1,12,16,27,18,2,-2,11,3,19,10,10,3,2,6,9,1,2,1,1,4,5,0,0,1,1,2,4,1,2,0,121,66,55,30,16,14,26,28,28,38,6,-4,13,14,12,26,5,-4,13,14,16,12,1,0,4,8,9,6,2,1,1,4,4,6,1,0,3,4,5,0,1,1,244,144,100,70,41,29,36,38,69,53,27,20,14,26,46,27,16,13,22,12,23,26,11,7,13,21,24,7,2,3,7,11,16,4,2,1,6,10,8,3,0,2,258,134,124,91,43,48,59,27,57,68,37,4,24,5,35,38,20,7,35,22,22,30,17,-3,21,9,15,24,19,2,8,4,10,9,12,0,13,5,5,15,7,2,291,163,128,142,73,69,58,50,54,66,38,17,28,24,41,35,25,5,30,26,13,31,13,12,19,24,27,33,29,7,8,11,14,19,16,2,11,13,13,14,13,5,256,142,114,102,58,44,43,24,80,58,45,2,27,15,38,30,30,1,16,9,42,28,15,1,20,16,29,21,15,-2,13,10,13,14,9,-1,7,6,16,7,6,-1,241,99,142,90,38,52,42,35,46,38,28,42,10,16,19,16,16,20,32,19,27,22,12,22,18,16,24,19,8,2,7,4,11,9,6,0,11,12,13,10,2,2,291,180,111,128,67,61,38,61,82,53,43,12,25,36,60,28,21,9,13,25,22,25,22,3,23,29,31,26,14,3,11,16,19,12,7,2,12,13,12,14,7,1,377,215,162,96,58,38,42,63,149,60,51,9,23,39,82,36,29,5,19,24,67,24,22,4,11,28,26,18,12,1,7,16,13,14,7,1,4,12,13,4,5,0,309,153,156,56,28,28,35,56,128,46,29,7,16,30,75,15,16,-1,19,26,53,31,13,8,8,22,15,4,1,1,4,10,7,3,1,0,4,12,8,1,0,1,230,126,104,46,35,11,22,64,63,41,28,8,11,30,46,18,20,1,11,34,17,23,8,7,9,15,8,13,3,-3,5,12,10,9,2,-3,4,3,-2,4,1,0,90,39,51,43,16,27,3,47,19,-3,21,3,-1,25,19,-3,5,-5,4,22,0,0,16,8,5,28,8,-3,4,1,0,13,3,1,0,-1,5,15,5,-4,4,2,-106,-48,-58,-17,-22,5,-39,-16,-20,-23,0,-2,-21,-13,-13,0,-2,3,-18,-3,-7,-23,2,-5,2,-10,-11,-2,3,1,1,-12,-11,-3,1,2,1,2,0,1,2,-1,-104,-54,-50,-147,-82,-65,-15,-29,19,-45,-14,-20,-19,-18,20,-19,-5,-16,4,-11,-1,-26,-9,-4,-16,-27,-27,-48,-20,-9,-9,-14,-14,-28,-10,-7,-7,-13,-13,-20,-10,-2,-9,-7,-2,-22,-5,-17,12,3,6,-31,-6,1,12,7,-10,-16,-3,1,0,-4,16,-15,-3,0,0,3,-4,-18,-2,-1,-1,4,0,-8,0,0,1,-1,-4,-10,-2,-1,16,9,7,-22,-17,-5,3,14,-16,1,16,-3,-2,9,2,-5,7,-3,5,5,-18,6,9,0,8,0,-10,-13,-2,-6,5,2,-6,-12,-3,-3,3,-2,-4,-1,1,-3,164,93,71,50,21,29,7,14,72,22,22,26,8,13,30,16,10,14,-1,1,42,6,12,12,4,9,12,8,9,8,2,3,8,-1,4,5,2,6,4,9,5,3,161,86,75,77,30,47,21,11,9,70,24,29,16,6,8,25,21,12,5,5,1,45,3,17,9,9,21,15,17,5,2,3,5,5,10,4,7,6,16,10,7,1
46,46257,Villanueva de Castellón,6930,36,25,11,3,2,1,11,9,1,12,3,-3,6,3,4,7,2,1,5,6,-3,5,1,-4,0,2,0,1,0,0,0,1,0,1,0,0,0,1,0,0,0,0,35,28,7,10,4,6,-3,24,6,2,5,1,0,13,8,3,3,1,-3,11,-2,-1,2,0,0,7,2,1,0,0,0,3,1,0,0,0,0,4,1,1,0,0,-44,-16,-28,5,3,2,-13,-20,-12,7,8,-10,-5,-14,1,3,1,0,-8,-6,-13,4,7,-10,4,2,-2,0,1,0,1,1,1,0,0,0,3,1,-3,0,1,0,-64,-28,-36,20,11,9,-3,-12,-25,-11,-1,-14,-4,-8,-5,-5,0,-6,1,-4,-20,-6,-1,-8,4,8,6,4,-1,-2,2,4,3,3,0,-1,2,4,3,1,-1,-1,72,47,25,61,25,36,16,24,10,8,2,1,9,12,14,6,0,0,7,12,-4,2,2,1,13,22,14,6,1,2,4,9,6,4,0,1,9,13,8,2,1,1,46,36,10,33,20,13,32,-1,-3,11,4,-6,21,-3,2,8,4,-1,11,2,-5,3,0,-5,9,8,7,4,5,0,5,4,6,2,3,0,4,4,1,2,2,0,161,103,58,63,34,29,45,24,53,33,-2,1,31,20,26,20,-1,2,14,4,27,13,-1,-1,13,23,17,8,1,1,9,12,10,2,0,1,4,11,7,6,1,0,221,133,88,133,76,57,46,88,40,26,17,-3,20,57,34,15,8,-3,26,31,6,11,9,0,20,56,27,17,7,2,11,32,17,11,2,1,9,24,10,6,5,1,61,28,33,88,48,40,-8,13,18,29,4,-1,-13,2,15,19,4,0,5,11,3,10,0,-1,7,21,30,19,6,2,3,11,14,14,4,1,4,10,16,5,2,1,-59,-39,-20,32,17,15,-27,-3,-27,-13,5,2,-12,-1,-24,-4,-1,-1,-15,-2,-3,-9,6,3,5,13,11,-2,1,0,1,8,4,0,1,0,4,5,7,-2,0,0,-79,-43,-36,32,9,23,-18,10,-40,-18,-4,-1,-11,1,-17,-9,-1,0,-7,9,-23,-9,-3,-1,10,9,6,4,1,3,2,4,3,-1,0,2,8,5,3,5,1,1,-126,-64,-62,-39,-27,-12,-12,-18,-45,-32,-14,1,-1,-4,-30,-22,-7,4,-11,-14,-15,-10,-7,-3,-7,-3,-17,-9,-4,1,-3,-3,-11,-6,-4,0,-4,0,-6,-3,0,1,-30,-23,-7,18,10,8,0,4,-33,19,-17,-4,6,1,-18,5,-14,-4,-6,3,-15,14,-3,0,5,6,0,2,1,4,7,3,0,-1,-1,2,-2,3,0,3,2,2,-99,-53,-46,-71,-43,-28,-18,-3,-25,-32,-9,-16,-9,-5,-10,-18,-9,-6,-9,2,-15,-14,0,-10,-13,-5,-23,-16,-13,-3,-8,-4,-14,-9,-9,-1,-5,-1,-9,-7,-4,-2,-26,-7,-19,-49,-34,-15,-3,12,-24,-8,-8,-2,-7,13,-20,1,-3,6,4,-1,-4,-9,-5,-8,-10,5,-19,-16,-9,-3,-7,4,-16,-10,-7,1,-3,1,-3,-6,-2,-4,76,53,23,50,30,20,11,20,32,16,2,-7,14,11,21,8,-2,0,-3,9,11,8,4,-7,7,14,17,12,1,-1,3,8,10,9,1,-1,4,6,7,3,0,0,15,3,12,29,12,17,16,2,-2,-5,1,-1,11,1,-2,-5,0,-2,5,1,0,0,1,1,2,10,7,4,4,0,2,4,1,3,1,0,0,6,6,1,3,0,-92,-48,-44,-18,-18,0,-12,0,-23,-28,-7,-23,-3,1,-13,-19,-6,-8,-9,-1,-10,-9,-1,-15,-1,3,-7,-10,-3,0,-3,3,-5,-8,-3,-2,2,0,-2,-2,0,2
46,46258,Villar del Arzobispo,3441,20,18,2,27,19,8,-3,11,19,2,-7,0,0,8,12,2,-2,-2,-3,3,7,0,-5,2,3,6,15,3,0,0,2,5,10,2,0,0,1,1,5,1,0,0,66,54,12,87,63,24,1,40,23,4,5,-7,-2,34,17,4,4,-4,3,6,6,0,1,-3,3,37,37,9,1,0,2,28,25,8,0,0,1,9,12,1,1,0,38,17,21,49,31,18,14,0,2,11,6,5,7,-1,-2,5,4,4,7,1,4,6,2,1,4,16,20,7,2,0,2,10,13,5,1,0,2,6,7,2,1,0,101,49,52,72,43,29,19,16,30,5,18,10,12,8,12,-1,11,6,7,8,18,6,7,4,13,14,32,12,0,0,9,7,19,7,0,0,4,7,13,5,0,0,80,47,33,89,54,35,20,24,3,27,7,0,11,10,6,13,6,0,9,14,-3,14,1,0,19,23,21,20,5,0,11,13,13,13,3,0,8,10,8,7,2,0,118,94,24,127,83,44,15,32,36,24,17,-2,7,31,31,15,11,0,8,1,5,9,6,-2,17,26,50,21,10,2,8,19,35,14,4,2,9,7,15,7,6,0,105,37,68,77,39,38,27,21,5,29,22,1,11,4,0,13,12,-2,16,17,5,16,10,3,12,23,18,15,9,0,5,13,8,10,3,0,7,10,10,5,6,0,47,37,10,66,35,31,12,4,15,5,6,4,11,0,17,7,2,2,1,4,-2,-2,4,2,6,16,21,11,9,1,5,10,12,5,2,1,1,6,9,6,7,0,33,28,5,22,10,12,12,4,-8,13,17,-7,13,0,0,6,10,-3,-1,4,-8,7,7,-4,8,9,2,2,1,0,5,3,0,1,1,0,3,6,2,1,0,0,-10,-19,9,12,8,4,-1,-3,-12,4,2,4,-6,-6,-8,-4,5,1,5,3,-4,8,-3,3,0,7,3,3,-1,0,-1,3,4,1,1,0,1,4,-1,2,-2,0,-73,-40,-33,-40,-32,-8,-9,-3,-21,-25,-13,0,-6,-7,-9,-14,-6,3,-3,4,-12,-11,-7,-3,-5,-1,-8,-22,-3,-1,-4,-4,-5,-16,-3,0,-1,3,-3,-6,0,-1,-13,-16,3,11,7,4,6,-5,-17,-16,5,15,4,-3,-9,-10,-1,5,2,-2,-8,-6,6,10,6,0,3,-1,3,-1,5,0,0,0,3,-1,1,0,3,-1,0,0,-22,-10,-12,3,-1,4,5,-6,-3,-6,-1,-14,3,-1,-3,-4,2,-9,2,-5,0,-2,-3,-5,0,2,1,3,-1,-2,1,-1,0,1,0,-2,-1,3,1,2,-1,0,-39,-39,0,-45,-36,-9,9,-9,-14,-21,9,-12,-1,-10,-11,-18,6,-4,10,1,-3,-3,3,-8,-3,-1,-19,-20,-2,0,-3,-1,-14,-17,-1,0,0,0,-5,-3,-1,0,-54,-23,-31,-9,-5,-4,-1,-5,-33,-10,-4,-2,2,0,-15,-6,-2,-2,-3,-5,-18,-4,-2,0,-2,5,-8,-6,2,-1,-1,5,-5,-4,0,-1,-1,0,-3,-2,2,0,-20,14,-34,-2,0,-2,3,-10,-7,7,-6,-7,4,-4,1,14,2,-3,-1,-6,-8,-7,-8,-4,1,1,2,-2,-2,-2,2,-1,2,-1,-1,-1,-1,2,0,-1,-1,-1,-1,-7,6,1,-4,5,7,-2,-10,2,8,-9,0,-1,-7,-1,5,-3,7,-1,-3,3,3,-6,3,-1,-2,-3,2,1,1,0,-2,-4,0,1,2,-1,0,1,2,0,25,4,21,4,6,-2,23,-7,10,-2,10,-9,13,-6,1,-7,8,-4,10,-1,9,5,2,-5,4,0,1,-7,6,0,6,1,2,-6,2,1,-2,-1,-1,-1,4,-1
46,46260,Vinalesa,2294,61,31,30,6,3,3,12,12,16,9,6,3,3,8,11,4,4,2,9,4,5,5,2,1,0,2,1,0,1,2,0,1,1,0,0,1,0,1,0,0,1,1,77,47,30,10,6,4,2,19,32,7,9,4,4,7,18,6,7,3,-2,12,14,1,2,1,1,3,1,1,2,2,0,2,1,0,2,1,1,1,0,1,0,1,57,29,28,1,2,-1,13,4,19,11,7,1,7,4,7,6,4,1,6,0,12,5,3,0,0,-1,1,1,0,0,0,0,1,1,0,0,0,-1,0,0,0,0,53,28,25,3,0,3,5,15,34,-3,-7,7,0,7,21,-1,-3,2,5,8,13,-2,-4,5,2,1,0,0,-1,1,0,1,0,0,-1,0,2,0,0,0,0,1,17,14,3,8,3,5,-2,5,15,0,-2,-1,3,4,9,-2,-1,0,-5,1,6,2,-1,-1,1,0,7,0,0,0,0,0,3,0,0,0,1,0,4,0,0,0,18,11,7,9,3,6,-3,3,14,3,-1,1,1,1,4,4,-1,0,-4,2,10,-1,0,1,3,2,5,-1,0,0,0,1,2,0,0,0,3,1,3,-1,0,0,128,55,73,17,3,14,13,18,70,14,8,6,7,6,30,6,4,3,6,12,40,8,4,3,2,2,10,2,0,2,0,0,4,0,0,0,2,2,6,2,0,2,134,76,58,5,2,3,14,21,68,20,7,3,12,10,45,9,-2,2,2,11,23,11,9,1,-1,6,0,0,-1,1,0,2,1,0,-1,0,-1,4,-1,0,0,1,108,53,55,1,0,1,5,21,54,20,3,4,2,11,25,17,-2,1,3,10,29,3,5,3,-3,1,1,0,1,1,-1,0,0,0,0,1,-2,1,1,0,1,0,25,16,9,0,0,0,-7,10,27,1,-4,-2,-3,3,20,2,-6,-1,-4,7,7,-1,2,-1,1,2,-2,0,0,-1,2,0,-2,0,0,0,-1,2,0,0,0,-1,9,-1,10,-7,-8,1,-2,-8,29,-10,1,1,-6,-4,13,-5,2,-1,4,-4,16,-5,-1,2,-1,0,-2,-5,0,1,-1,-1,-1,-4,-1,0,0,1,-1,-1,1,1,31,25,6,0,1,-1,10,5,14,-5,5,2,7,3,13,-3,6,-2,3,2,1,-2,-1,4,0,0,-1,0,1,0,0,0,0,1,0,0,0,0,-1,-1,1,0,12,2,10,0,1,-1,7,-5,7,2,1,-1,0,-1,2,-2,2,1,7,-4,5,4,-1,-2,2,0,1,-1,0,-2,1,0,0,0,0,0,1,0,1,-1,0,-2,-27,-19,-8,-5,-3,-2,-9,-3,-13,5,-6,1,-5,-1,-10,1,-3,0,-4,-2,-3,4,-3,1,-2,0,1,-3,-1,0,-2,0,1,-2,0,0,0,0,0,-1,-1,0,15,4,11,3,4,-1,7,6,-7,12,-7,5,4,3,-10,6,1,0,3,3,3,6,-8,5,3,1,-1,1,-2,1,3,0,0,1,0,0,0,1,-1,0,-2,1,13,9,4,5,0,5,11,7,-11,3,-1,6,5,4,-6,6,0,1,6,3,-5,-3,-1,5,2,1,0,0,1,1,1,-1,-1,0,0,1,1,2,1,0,1,0,24,6,18,4,1,3,0,4,15,-8,4,10,1,2,4,-6,2,3,-1,2,11,-2,2,7,0,3,2,-1,0,0,0,0,1,0,0,0,0,3,1,-1,0,0,29,20,9,16,5,11,8,-2,9,9,-2,5,4,-1,12,2,-2,3,4,-1,-3,7,0,2,7,1,2,4,0,1,2,0,0,2,-1,1,5,1,2,2,1,0
46,46145,Xàtiva,25365,-3,-7,4,8,6,2,30,-21,22,-39,-4,11,12,-9,5,-19,-3,6,18,-12,17,-20,-1,5,1,2,1,0,1,3,1,2,0,0,1,2,0,0,1,0,0,1,-6,5,-11,3,2,1,-2,-20,-15,9,25,-1,-2,-14,-3,8,14,2,0,-6,-12,1,11,-3,1,0,0,1,1,0,0,0,0,1,1,0,1,0,0,0,0,0,33,29,4,-11,-5,-6,14,12,18,-37,6,19,19,0,7,-16,3,17,-5,12,11,-21,3,2,0,-3,-5,-6,1,3,0,-1,-4,-3,1,2,0,-2,-1,-3,0,1,86,41,45,-16,-11,-5,12,7,15,12,26,18,-14,14,12,9,8,12,26,-7,3,3,18,6,-4,-7,-4,-6,3,2,-5,-3,-3,-4,2,2,1,-4,-1,-2,1,0,591,309,282,420,211,209,122,136,183,100,38,7,77,72,90,47,11,7,45,64,93,53,27,0,66,124,131,59,31,8,38,66,66,25,12,3,28,58,65,34,19,5,372,232,140,327,187,140,79,80,89,72,31,16,22,84,67,42,14,1,57,-4,22,30,17,15,50,96,76,56,36,9,19,63,48,28,22,4,31,33,28,28,14,5,15,-36,51,92,1,91,-18,33,0,-18,19,1,-8,-4,-9,-16,3,-1,-10,37,9,-2,16,2,17,69,-7,-4,22,-7,11,21,-23,-16,8,0,6,48,16,12,14,-7,677,370,307,557,312,245,124,180,189,121,59,6,71,113,121,53,23,-6,53,67,68,68,36,12,78,161,156,108,40,9,49,97,89,53,19,3,29,64,67,55,21,6,172,109,63,172,68,104,23,33,51,50,3,14,22,23,36,25,-3,2,1,10,15,25,6,12,37,48,43,18,19,3,18,18,12,6,9,2,19,30,31,12,10,1,-33,-30,-3,-7,-3,-4,7,44,-58,-11,-19,10,-8,29,-36,-1,-3,-8,15,15,-22,-10,-16,18,4,30,6,-10,-29,-11,-1,19,-1,-6,-10,-6,5,11,7,-4,-19,-5,118,31,87,179,89,90,43,32,17,20,-18,28,26,19,-11,10,-16,8,17,13,28,10,-2,20,34,45,51,30,8,8,21,21,27,17,0,3,13,24,24,13,8,5,-181,-164,-17,-127,-105,-22,-26,-17,-105,-30,-22,24,-28,-24,-61,-40,-15,7,2,7,-44,10,-7,17,-9,-4,-53,-46,-11,-5,-4,-22,-40,-30,-6,-4,-5,18,-13,-16,-5,-1,-82,-43,-39,-146,-80,-66,30,-3,-68,-48,-9,14,17,-1,-37,-34,2,7,13,-2,-31,-14,-11,7,-7,-18,-49,-60,-12,-2,-7,-5,-22,-39,-7,-3,0,-13,-27,-21,-5,1,12,-25,37,-59,-49,-10,31,16,-23,-33,18,4,21,-3,-43,-7,7,1,10,19,20,-26,11,3,9,10,-37,-33,-6,-3,1,7,-30,-25,0,-2,8,3,-7,-8,-6,-1,-8,-29,21,-18,-29,11,-1,-28,-15,-13,6,34,8,-25,-13,-15,6,8,-9,-3,-2,2,0,26,3,-3,-18,-7,-4,6,3,-7,-17,-11,-1,0,0,4,-1,4,-3,6,54,30,24,2,-12,14,16,-2,15,-7,13,12,10,13,2,-7,8,0,6,-15,13,0,5,12,4,25,-17,-9,-12,10,-1,11,-15,-2,-7,2,5,14,-2,-7,-5,8,165,109,56,83,52,31,41,8,46,45,13,7,10,12,44,33,5,1,31,-4,2,12,8,6,21,16,19,18,3,1,7,9,18,14,0,1,14,7,1,4,3,0,1,-45,46,-80,-61,-19,49,-26,-8,-35,7,13,19,-22,-17,-31,-8,6,30,-4,9,-4,15,7,-4,-9,-17,-49,-10,4,-7,-11,-12,-37,-2,4,3,2,-5,-12,-8,0
46,46143,Xeraco,4888,41,35,6,8,5,3,11,1,15,6,5,2,8,1,12,5,5,4,3,0,3,1,0,-2,1,1,2,1,1,2,0,1,2,0,1,1,1,0,0,1,0,1,4,9,-5,3,2,1,-13,2,5,8,6,-2,-4,7,3,3,2,-1,-9,-5,2,5,4,-1,0,0,1,0,1,1,0,0,1,0,0,1,0,0,0,0,1,0,85,35,50,-4,-3,-1,26,12,0,26,17,2,8,1,-2,19,7,1,18,11,2,7,10,1,0,-1,0,-1,0,-2,0,-1,0,0,0,-2,0,0,0,-1,0,0,45,26,19,2,0,2,10,6,13,14,3,0,4,4,9,8,6,-4,6,2,4,6,-3,4,1,0,0,2,-1,0,0,0,0,0,0,0,1,0,0,2,-1,0,165,91,74,87,40,47,30,24,44,35,21,8,17,13,24,23,9,4,13,11,20,12,12,4,27,13,23,13,8,1,12,6,9,7,5,1,15,7,14,6,3,0,156,111,45,177,108,69,1,48,72,30,8,2,0,29,59,19,7,0,1,19,13,11,1,2,14,47,65,38,10,3,8,25,45,22,6,2,6,22,20,16,4,1,157,83,74,164,90,74,35,44,39,14,19,-1,28,15,16,8,9,0,7,29,23,6,10,-1,24,49,55,21,8,4,17,25,27,14,4,1,7,24,28,7,4,3,237,186,51,222,151,71,18,83,60,51,16,3,6,64,52,45,10,2,12,19,8,6,6,1,15,69,62,50,21,1,4,51,45,35,12,0,11,18,17,15,9,1,-52,-11,-41,20,13,7,-15,-12,-16,-5,8,-11,-6,-8,2,-4,8,-4,-9,-4,-18,-1,0,-7,0,7,2,8,3,0,1,2,1,6,3,0,-1,5,1,2,0,0,-49,-27,-22,18,5,13,-16,-8,6,-11,-12,-9,-13,-4,2,1,-10,-3,-3,-4,4,-12,-2,-6,-2,9,2,6,1,0,-2,4,-1,3,1,0,0,5,3,3,0,0,11,36,-25,115,89,26,-12,40,7,-11,-4,-11,-6,30,15,-2,2,-3,-6,10,-8,-9,-6,-8,3,42,36,27,6,0,2,33,27,20,7,0,1,9,9,7,-1,0,81,37,44,66,36,30,-7,41,17,22,9,3,-2,11,15,16,-1,0,-5,30,2,6,10,3,3,23,13,17,9,1,2,10,11,8,3,2,1,13,2,9,6,-1,-40,-13,-27,-14,-7,-7,-8,6,-14,-12,0,-9,4,3,-7,-9,1,-1,-12,3,-7,-3,-1,-8,-2,2,-4,-9,-2,1,2,1,-4,-5,-2,1,-4,1,0,-4,0,0,-87,-45,-42,-2,-1,-1,-14,11,-16,-44,-13,-11,-11,11,-7,-25,-8,-6,-3,0,-9,-19,-5,-5,-3,18,-4,-9,-3,-2,-3,13,-1,-5,-5,-1,0,5,-3,-4,2,-1,21,12,9,32,18,14,-5,18,17,9,-14,-3,-10,14,13,4,-9,-1,5,4,4,5,-5,-2,1,14,8,6,4,0,1,8,4,3,2,0,0,6,4,3,2,0,11,12,-1,50,21,29,-4,2,24,-10,8,-10,-1,-4,19,-4,4,-3,-3,6,5,-6,4,-7,4,7,23,8,12,-4,1,-2,15,2,7,-2,3,9,8,6,5,-2,-14,-18,4,17,4,13,0,4,-9,-10,2,0,0,-2,-3,-11,-1,-1,0,6,-6,1,3,1,3,6,4,0,2,2,1,2,3,-3,0,1,2,4,1,3,2,1,-57,-29,-28,-80,-54,-26,14,-18,-21,-9,-20,-7,6,-6,-14,-4,-15,1,8,-12,-7,-5,-5,-8,9,-12,-28,-27,-14,-10,6,-6,-21,-17,-13,-5,3,-6,-7,-10,-1,-5
46,46146,Xeresa,1879,5,3,2,3,2,1,-6,7,2,2,0,0,0,2,2,0,-2,1,-6,5,0,2,2,-1,0,1,2,0,0,0,0,1,1,0,0,0,0,0,1,0,0,0,20,8,12,10,7,3,0,10,6,2,0,1,-2,5,5,-1,0,1,2,5,1,3,0,0,0,3,3,2,2,0,0,2,3,1,1,0,0,1,0,1,1,0,47,23,24,21,13,8,10,12,8,10,7,-1,8,4,1,6,3,1,2,8,7,4,4,-2,4,7,2,4,4,0,3,3,1,3,2,1,1,4,1,1,2,-1,24,12,12,21,10,11,-4,8,15,7,1,-3,-4,5,8,6,-1,-2,0,3,7,1,2,-1,1,6,6,3,4,0,0,4,3,2,1,0,1,2,3,1,3,0,32,17,15,15,9,6,6,2,18,2,3,-1,3,2,11,-1,0,1,3,0,7,3,3,-2,1,3,4,0,5,1,1,3,3,0,1,1,0,0,1,0,4,0,36,19,17,12,7,5,0,5,18,7,5,2,-3,2,13,4,2,1,3,3,5,3,3,1,1,0,2,2,5,2,1,0,0,1,3,2,0,0,2,1,2,0,122,73,49,12,7,5,20,26,35,29,6,5,11,13,20,22,5,2,9,13,15,7,1,3,2,-1,5,6,0,0,1,-2,2,4,2,0,1,1,3,2,-2,0,72,30,42,14,6,8,17,12,26,5,8,-2,7,5,9,0,5,0,10,7,17,5,3,-2,1,10,1,0,2,-1,0,6,-1,0,1,-1,1,4,2,0,1,0,5,2,3,-4,-2,-2,3,-3,8,-3,-4,3,1,-1,6,-2,-4,1,2,-2,2,-1,0,2,4,-4,1,-2,-5,1,3,-3,0,1,-4,0,1,-1,1,-3,-1,1,49,27,22,7,1,6,14,7,14,15,-3,-1,10,5,0,13,-1,-2,4,2,14,2,-2,1,4,3,-2,2,1,-1,3,1,-2,0,0,-1,1,2,0,2,1,0,46,29,17,9,4,5,6,9,17,7,12,-2,9,3,4,9,7,-2,-3,6,13,-2,5,0,2,4,-1,-1,1,2,1,1,-1,0,0,1,1,3,0,-1,1,1,-15,-13,-2,-9,-3,-6,-1,1,-4,-15,4,2,-4,1,-2,-9,4,-1,3,0,-2,-6,0,3,-4,-3,-4,-1,1,2,-3,-2,-1,1,1,1,-1,-1,-3,-2,0,1,-26,-2,-24,-6,-3,-3,-18,1,-3,-5,0,0,-10,2,6,-1,0,1,-8,-1,-9,-4,0,-1,-3,2,-4,-1,0,0,-2,0,-2,1,0,0,-1,2,-2,-2,0,0,-24,-10,-14,-14,-9,-5,-5,3,-6,-8,-6,0,0,4,-1,-8,-3,0,-5,-1,-5,0,-3,0,-3,-1,-4,-5,-2,1,0,0,-4,-5,-1,1,-3,-1,0,0,-1,0,0,1,-1,5,2,3,-6,7,-8,2,4,1,-3,4,-4,0,2,2,-3,3,-4,2,2,-1,0,2,2,1,0,0,0,1,0,1,0,0,0,1,2,0,0,0,-32,-17,-15,-15,-11,-4,-3,-4,-12,-4,-8,-1,0,-3,-9,-1,-2,-2,-3,-1,-3,-3,-6,1,0,-4,-9,0,-2,0,0,-2,-8,0,-1,0,0,-2,-1,0,-1,0,-21,-10,-11,12,4,8,-6,-3,-2,-7,-3,-1,-2,0,-3,-3,-2,0,-4,-3,1,-4,-1,-1,4,2,1,5,2,-2,2,1,0,2,0,-1,2,1,1,3,2,-1,-6,-3,-3,3,3,0,3,5,-5,-3,0,-8,2,0,-2,0,-1,-3,1,5,-3,-3,1,-5,4,0,-1,0,-1,0,2,0,-1,1,0,0,2,0,0,-1,-1,0
46,46110,Xirivella,25957,85,10,75,132,57,75,-18,61,69,-12,-10,-2,-27,10,36,-2,-7,1,9,51,33,-10,-3,-3,28,26,45,23,5,5,10,8,22,11,4,2,18,18,23,12,1,3,332,166,166,180,95,85,51,102,106,41,18,10,27,47,54,24,6,7,24,55,52,17,12,3,36,38,60,33,9,3,18,13,38,19,3,3,18,25,22,14,6,0,337,172,165,198,98,100,51,134,154,16,-12,-11,38,52,83,13,-9,-9,13,82,71,3,-3,-2,33,62,68,25,10,-2,18,25,38,14,4,-2,15,37,30,11,6,0,524,262,262,319,166,153,95,138,221,67,11,-11,46,69,135,26,-11,-8,49,69,86,41,22,-3,66,96,82,52,15,3,44,51,41,22,3,2,22,45,41,30,12,1,626,409,217,377,217,160,113,162,232,93,29,-16,76,106,123,73,21,-4,37,56,109,20,8,-12,56,96,136,60,22,3,26,54,83,37,11,2,30,42,53,23,11,1,547,374,173,460,276,184,49,181,283,60,-14,-10,27,110,212,34,-7,-1,22,71,71,26,-7,-9,67,140,153,77,18,1,36,85,103,39,10,-1,31,55,50,38,8,2,639,369,270,701,391,310,63,211,264,101,-5,-3,36,97,186,59,-9,-7,27,114,78,42,4,4,113,187,238,106,40,13,65,94,144,62,20,4,48,93,94,44,20,9,568,332,236,760,437,323,86,232,185,91,-10,-18,45,134,103,56,-6,-2,41,98,82,35,-4,-16,138,217,256,108,32,5,88,118,156,61,10,2,50,99,100,47,22,3,91,78,13,435,260,175,13,105,30,-48,5,-17,12,70,38,-27,-5,-11,1,35,-8,-21,10,-6,57,114,166,70,23,5,28,74,105,45,8,0,29,40,61,25,15,5,-134,-70,-64,133,57,76,-7,61,-87,-98,1,-10,6,32,-56,-49,-4,-4,-13,29,-31,-49,5,-6,39,77,24,-16,8,-3,24,35,6,-13,4,0,15,42,18,-3,4,-3,-472,-287,-185,-131,-108,-23,-60,-2,-225,-162,-38,16,-16,6,-149,-113,-20,3,-44,-8,-76,-49,-18,13,8,17,-93,-47,-11,-6,8,12,-68,-48,-9,-4,0,5,-25,1,-2,-2,-461,-308,-153,-184,-146,-38,-64,-16,-209,-139,-47,17,-45,-9,-127,-109,-19,7,-19,-7,-82,-30,-28,10,-1,12,-106,-63,-24,-3,-2,3,-71,-56,-19,-1,1,9,-35,-7,-5,-2,-561,-338,-223,-308,-198,-110,-109,-61,-276,-132,-22,35,-51,-37,-152,-91,-17,13,-58,-24,-124,-41,-5,22,-38,-40,-134,-74,-22,-2,-16,-22,-95,-55,-11,1,-22,-18,-39,-19,-11,-3,-333,-181,-152,-53,-51,-2,-53,-56,-79,-106,-26,-5,-20,-32,-55,-62,-7,-6,-33,-24,-24,-44,-19,1,23,0,-33,-31,-13,-4,16,-4,-34,-27,-5,-1,7,4,1,-4,-8,-3,-494,-292,-202,-319,-198,-121,-76,-16,-191,-147,-52,-23,-38,-14,-108,-106,-22,-7,-38,-2,-83,-41,-30,-16,-60,-11,-106,-108,-29,-9,-32,-13,-67,-73,-12,-3,-28,2,-39,-35,-17,-6,-272,-159,-113,-200,-127,-73,-6,-30,-105,-135,-3,6,-11,-4,-59,-84,-7,5,5,-26,-46,-51,4,1,-25,1,-48,-93,-26,-15,-21,6,-31,-57,-18,-8,-4,-5,-17,-36,-8,-7,265,158,107,60,24,36,45,69,89,36,-10,18,31,36,48,31,-7,4,14,33,41,5,-3,14,25,39,31,-20,-15,-5,12,16,12,-12,-6,-2,13,23,19,-8,-9,-3,302,171,131,212,101,111,56,70,69,68,27,11,21,45,56,58,-4,-1,35,25,13,10,31,12,24,62,52,41,22,7,14,33,29,19,5,1,10,29,23,22,17,6
47,47010,Arroyo de la Encomienda,3098,440,229,211,11,4,7,76,61,152,105,39,6,39,32,75,56,25,1,37,29,77,49,14,5,2,2,4,1,2,0,0,0,2,1,1,0,2,2,2,0,1,0,380,189,191,9,5,4,66,27,175,73,29,9,38,11,87,31,17,4,28,16,88,42,12,5,4,0,4,0,1,0,3,0,1,0,1,0,1,0,3,0,0,0,343,188,155,24,10,14,59,39,124,91,16,10,39,22,64,46,11,4,20,17,60,45,5,6,7,9,1,6,1,0,4,4,1,1,0,0,3,5,0,5,1,0,537,278,259,28,14,14,70,67,272,86,30,5,40,32,137,46,17,3,30,35,135,40,13,2,6,4,9,3,2,2,5,1,3,2,2,1,1,3,6,1,0,1,661,344,317,22,8,14,94,33,384,95,39,2,52,15,198,50,22,-1,42,18,186,45,17,3,6,3,5,5,0,3,3,2,2,1,0,0,3,1,3,4,0,3,1262,652,610,27,13,14,189,101,658,221,52,16,100,44,345,116,30,7,89,57,313,105,22,9,7,3,8,4,2,1,2,-1,5,4,1,1,5,4,3,0,1,0,1402,718,684,38,21,17,168,128,768,220,68,26,67,57,402,127,33,13,101,71,366,93,35,13,2,15,14,5,2,0,0,7,10,3,1,0,2,8,4,2,1,0,1056,564,492,126,86,40,91,109,595,168,50,12,63,40,302,115,22,8,28,69,293,53,28,4,20,24,44,26,4,4,15,14,27,26,1,2,5,10,17,0,3,2,637,298,339,62,37,25,59,68,354,107,14,20,25,26,182,53,4,6,34,42,172,54,10,14,5,12,28,17,0,0,5,3,18,10,1,0,0,9,10,7,-1,0,843,451,392,61,33,28,73,92,474,128,57,13,48,46,253,62,38,1,25,46,221,66,19,12,10,18,15,9,6,2,8,11,7,4,2,1,2,7,8,5,4,1,1450,756,694,57,29,28,96,195,787,294,50,10,62,77,418,160,28,1,34,118,369,134,22,9,11,12,16,12,3,2,8,6,10,5,0,0,3,6,6,7,3,2,903,458,445,55,30,25,83,133,453,163,39,22,41,52,226,99,22,14,42,81,227,64,17,8,10,15,16,8,4,1,4,9,7,6,3,0,6,6,9,2,1,1,662,325,337,-64,-42,-22,64,95,367,99,11,15,34,24,200,55,-5,8,30,71,167,44,16,7,-11,0,-22,-22,-6,-5,-9,-2,-13,-12,-7,-1,-2,2,-9,-10,1,-4,547,239,308,12,0,12,60,97,244,69,38,17,25,32,99,39,18,10,35,65,145,30,20,7,5,9,-3,0,0,1,-1,3,-1,-3,1,1,6,6,-2,3,-1,0,564,205,359,-61,-62,1,63,97,334,32,14,9,32,33,143,-5,-7,1,31,64,191,37,21,8,7,10,-18,-45,-14,-2,6,5,-17,-39,-15,-2,1,5,-1,-6,1,0,253,137,116,-47,-41,-6,35,25,144,29,4,4,4,13,84,26,5,-1,31,12,60,3,-1,5,3,3,-17,-27,-9,-2,-2,3,-16,-18,-7,-1,5,0,-1,-9,-2,-1,149,37,112,3,-5,8,-31,50,158,-32,7,8,-25,8,82,-19,-7,5,-6,42,76,-13,14,3,-3,12,3,0,-4,-4,-5,7,2,-3,-3,-2,2,5,1,3,-1,-2,-41,-26,-15,-21,-28,7,-25,-5,85,-66,-22,-1,-6,-6,54,-44,-20,-3,-19,1,31,-22,-2,2,7,3,-2,-16,-11,-2,1,2,-4,-16,-11,0,6,1,2,0,0,-2
47,47050,Cigales,2881,0,8,-8,6,2,4,-26,24,10,0,-4,2,-16,12,12,2,-2,3,-10,12,-2,-2,-2,-1,0,0,4,1,0,1,0,0,1,0,0,1,0,0,3,1,0,0,30,18,12,12,4,8,1,19,4,4,0,2,-2,16,4,0,-1,1,3,3,0,4,1,1,5,2,1,2,2,0,3,1,0,0,0,0,2,1,1,2,2,0,-21,0,-21,11,7,4,-3,14,-4,-21,0,-3,-2,10,10,-15,5,-4,-1,4,-14,-6,-5,1,4,2,4,0,-1,1,3,0,4,0,0,0,1,2,0,0,-1,1,130,78,52,20,9,11,17,26,56,19,11,3,9,8,40,14,6,0,8,18,16,5,5,3,8,4,4,3,1,0,4,2,2,1,0,0,4,2,2,2,1,0,100,56,44,20,8,12,-5,37,48,2,15,6,-2,22,25,-1,10,2,-3,15,23,3,5,4,0,6,7,4,0,3,0,1,5,1,0,1,0,5,2,3,0,2,157,91,66,24,15,9,20,42,54,30,12,3,16,23,31,16,6,3,4,19,23,14,6,0,5,6,5,5,1,2,3,4,3,3,0,2,2,2,2,2,1,0,202,124,78,48,27,21,21,50,92,11,18,2,13,21,60,9,12,4,8,29,32,2,6,-2,7,9,18,9,4,0,3,4,9,7,3,0,4,5,9,2,1,0,247,131,116,58,28,30,35,50,109,45,7,3,16,30,48,28,7,2,19,20,61,17,0,1,10,20,15,9,3,1,5,10,5,7,1,0,5,10,10,2,2,1,199,110,89,29,15,14,23,39,113,14,3,6,8,15,72,10,1,2,15,24,41,4,2,4,8,6,10,4,1,0,5,2,5,3,0,0,3,4,5,1,1,0,160,84,76,13,8,5,24,23,77,15,10,9,13,16,37,7,3,5,11,7,40,8,7,4,6,2,5,0,0,0,5,2,1,1,-1,0,1,0,4,-1,1,0,93,25,68,7,0,7,19,11,30,15,1,9,7,8,4,0,2,2,12,3,26,15,-1,7,4,2,2,-3,2,0,2,3,-3,-3,1,0,2,-1,5,0,1,0,38,12,26,6,5,1,14,10,10,-4,7,1,5,3,2,-3,2,1,9,7,8,-1,5,0,1,2,1,0,0,0,1,1,0,1,0,0,0,1,1,-1,0,0,82,43,39,-14,-13,-1,7,14,38,-4,16,11,0,10,20,-8,10,6,7,4,18,4,6,5,-1,-2,-3,-2,-2,-4,-1,-2,-3,-2,-4,-1,0,0,0,0,2,-3,-13,-18,5,7,2,5,-6,-5,0,-17,1,16,-6,-5,-1,-6,-3,2,0,0,1,-11,4,14,2,1,1,2,2,-1,0,0,-1,2,1,0,2,1,2,0,1,-1,54,35,19,2,0,2,2,12,15,-1,8,15,7,6,15,-1,2,4,-5,6,0,0,6,11,1,2,0,2,-2,-1,-1,2,0,1,-1,-1,2,0,0,1,-1,0,-39,-15,-24,6,1,5,-9,7,6,-28,-4,-12,0,5,4,-15,-5,-6,-9,2,2,-13,1,-6,2,-1,5,-1,0,1,1,-1,2,-1,0,0,1,0,3,0,0,1,22,-1,23,18,7,11,-2,1,28,-5,-6,4,-7,-2,18,-6,-5,2,5,3,10,1,-1,2,2,3,4,4,4,1,1,1,2,2,0,1,1,2,2,2,4,0,97,51,46,26,18,8,18,-1,23,39,4,9,5,-1,14,27,1,1,13,0,9,12,3,8,4,3,9,6,3,1,3,1,7,4,3,0,1,2,2,2,0,1
47,47052,Cistérniga,3206,244,129,115,8,3,5,19,46,127,25,27,-3,14,17,72,11,15,-2,5,29,55,14,12,-1,0,1,1,3,3,0,0,0,0,1,2,0,0,1,1,2,1,0,244,144,100,17,7,10,10,32,148,32,9,9,9,25,79,19,4,5,1,7,69,13,5,4,0,2,7,4,1,1,0,2,3,1,0,0,0,0,4,3,1,1,208,101,107,12,6,6,15,39,102,28,18,7,5,18,45,20,9,4,10,21,57,8,9,3,4,4,1,1,2,0,2,3,1,0,0,0,2,1,0,1,2,0,535,272,263,17,4,13,65,74,281,78,31,4,37,27,146,37,19,3,28,47,135,41,12,1,3,8,3,3,0,0,2,0,0,2,0,0,1,8,3,1,0,0,620,292,328,47,22,25,77,88,324,91,24,13,33,32,158,51,11,6,44,56,166,40,13,7,9,21,9,7,1,0,4,11,3,3,1,0,5,10,6,4,0,0,467,253,214,41,17,24,58,69,253,46,21,14,30,33,140,20,19,5,28,36,113,26,2,9,7,17,7,5,3,2,4,8,2,1,2,0,3,9,5,4,1,2,458,234,224,28,9,19,53,80,229,51,33,6,27,36,124,28,17,1,26,44,105,23,16,5,4,2,9,3,3,6,2,-1,3,2,0,3,2,3,6,1,3,3,239,137,102,62,33,29,32,57,128,21,8,-8,20,23,75,15,2,-2,12,34,53,6,6,-6,13,15,27,4,3,-1,4,6,18,3,2,0,9,9,9,1,1,-1,141,75,66,26,20,6,5,40,66,16,14,-1,-2,14,42,9,8,0,7,26,24,7,6,-1,7,6,-1,12,1,-3,6,5,1,6,0,-1,1,1,-2,6,1,-2,63,31,32,9,2,7,3,15,42,16,-11,3,3,0,25,17,-8,-3,0,15,17,-1,-3,6,4,4,3,0,-2,0,3,-1,4,-2,-2,0,1,5,-1,2,0,0,90,26,64,1,-2,3,15,17,58,-3,-3,3,8,6,18,0,-5,1,7,11,40,-3,2,2,4,3,-2,-1,-2,-1,2,1,-1,-2,-1,-1,2,2,-1,1,-1,0,93,45,48,5,0,5,4,17,40,9,8,7,-2,6,25,4,4,3,6,11,15,5,4,4,6,5,-2,-3,-1,0,1,1,0,-1,-1,0,5,4,-2,-2,0,0,28,12,16,-16,-12,-4,-10,-6,54,-7,-6,5,-8,2,26,-4,-2,-1,-2,-8,28,-3,-4,6,-3,-4,-8,-2,0,1,-2,-1,-8,-1,0,0,-1,-3,0,-1,0,1,76,26,50,-16,-11,-5,9,2,42,3,1,10,1,4,13,0,-2,4,8,-2,29,3,3,6,2,-5,-6,-4,-4,1,0,0,-5,-3,-3,0,2,-5,-1,-1,-1,1,-22,-22,0,-11,-7,-4,-13,-7,28,-25,-8,-1,-10,-7,17,-18,-4,-2,-3,0,11,-7,-4,1,0,-4,-4,-6,1,2,2,-2,-5,-4,1,1,-2,-2,1,-2,0,1,40,-1,41,0,-2,2,0,-10,30,-1,17,-2,7,-10,8,-12,7,-1,-7,0,22,11,10,-1,3,-2,1,2,-4,-2,2,-1,-1,1,-3,0,1,-1,2,1,-1,-2,22,12,10,6,-1,7,-12,8,53,-24,-1,-2,-2,6,28,-19,-2,-1,-10,2,25,-5,1,-1,0,5,3,-1,-4,2,0,3,-2,0,-3,0,0,2,5,-1,-1,2,19,0,19,1,3,-2,-12,8,53,-27,-14,8,-7,1,27,-9,-9,0,-5,7,26,-18,-5,8,-1,1,3,-2,0,-1,1,0,2,0,-1,0,-2,1,1,-2,1,-1
47,47075,Íscar,6125,19,13,6,21,11,10,9,-2,2,11,-3,0,7,-6,5,8,-2,0,2,4,-3,3,-1,0,8,2,7,4,0,0,6,0,3,2,0,0,2,2,4,2,0,0,114,66,48,133,71,62,29,15,30,28,5,2,15,6,17,21,5,0,14,9,13,7,0,2,40,23,34,29,3,0,19,12,19,19,1,0,21,11,15,10,2,0,64,41,23,121,73,48,16,1,28,15,-1,4,8,0,17,11,-2,4,8,1,11,4,1,0,19,22,43,32,0,2,9,13,26,21,0,1,10,9,17,11,0,1,57,37,20,80,40,40,12,21,10,5,5,4,8,10,7,7,3,2,4,11,3,-2,2,2,16,23,21,17,2,0,7,13,10,9,0,0,9,10,11,8,2,0,92,39,53,102,53,49,17,13,39,23,-1,1,5,12,15,11,-3,1,12,1,24,12,2,0,19,18,35,25,3,1,10,11,18,12,1,1,9,7,17,13,2,0,65,52,13,85,38,47,19,8,21,9,4,2,11,10,13,10,5,1,8,-2,8,-1,-1,1,17,18,29,13,4,2,6,8,13,8,2,0,11,10,16,5,2,2,124,56,68,117,57,60,41,38,15,17,12,1,14,17,10,7,4,0,27,21,5,10,8,1,33,25,31,15,11,1,18,14,11,9,4,0,15,11,20,6,7,1,120,83,37,139,82,57,16,32,18,40,10,-1,7,20,29,27,5,-3,9,12,-11,13,5,2,21,37,44,25,8,1,9,21,32,17,4,-1,12,16,12,8,4,2,-12,0,-12,45,24,21,-2,2,-9,8,-8,-4,1,5,-2,3,-4,-3,-3,-3,-7,5,-4,-1,9,10,13,11,1,0,6,5,8,5,0,0,3,5,5,6,1,0,-25,-4,-21,28,14,14,-1,-10,11,-24,2,-7,2,-4,3,-10,4,-1,-3,-6,8,-14,-2,-6,8,8,9,1,2,-1,4,3,2,2,2,0,4,5,7,-1,0,-1,-26,-15,-11,33,12,21,-1,-22,2,-5,-5,1,4,-13,0,-2,-6,3,-5,-9,2,-3,1,-2,6,5,5,8,4,0,4,-1,3,4,1,0,2,6,2,4,3,0,2,-17,19,46,28,18,11,5,-13,0,-1,2,2,2,-10,-7,-1,1,9,3,-3,7,0,1,7,11,8,13,6,0,5,6,5,7,4,0,2,5,3,6,2,0,-12,4,-16,11,2,9,-4,4,0,-13,0,1,6,5,1,-5,-1,-2,-10,-1,-1,-8,1,3,2,6,4,-3,0,1,1,3,1,-4,0,0,1,3,3,1,0,1,-52,-29,-23,0,0,0,-6,-8,-10,-15,-7,-6,-3,-3,-6,-8,-4,-3,-3,-5,-4,-7,-3,-3,-1,1,2,-4,1,1,0,1,1,-2,0,0,-1,0,1,-2,1,1,-49,-32,-17,23,5,18,-1,-7,-27,-11,-2,-3,0,-8,-14,-7,-4,0,-1,1,-13,-4,2,-3,3,3,7,7,1,0,2,0,2,0,0,0,1,3,5,7,1,0,-70,-32,-38,-51,-23,-28,-4,-6,-13,-21,-14,-14,4,4,-11,-13,-10,-6,-8,-10,-2,-8,-4,-8,-5,5,-16,-19,-9,-9,-2,5,-11,-9,-6,-1,-3,0,-5,-10,-3,-8,-16,-6,-10,26,11,15,-8,9,-8,-7,-3,-1,-4,7,-7,-7,1,3,-4,2,-1,0,-4,-4,5,12,8,3,-1,-2,3,6,2,-1,0,0,2,6,6,4,-1,-2,-111,-68,-43,-86,-64,-22,5,-13,-29,-40,-29,-4,5,-5,-13,-31,-20,-4,0,-8,-16,-9,-9,0,7,-2,-21,-38,-23,-9,4,-2,-17,-26,-19,-4,3,0,-4,-12,-4,-5
47,47076,Laguna de Duero,15864,726,387,339,26,10,16,98,70,390,72,54,36,50,31,209,45,28,17,48,39,181,27,26,19,4,11,6,1,3,1,2,4,2,0,2,0,2,7,4,1,1,1,985,498,487,76,36,40,94,138,583,92,47,28,47,44,315,54,25,10,47,94,268,38,22,18,23,9,23,14,5,2,8,3,13,9,2,1,15,6,10,5,3,1,506,254,252,40,20,20,58,60,296,36,30,25,26,25,167,14,10,10,32,35,129,22,20,15,12,14,10,1,3,0,9,5,5,1,1,-1,3,9,5,0,2,1,130,61,69,26,10,16,0,27,84,-14,31,13,-6,17,42,-7,17,4,6,10,42,-7,14,9,6,12,-1,5,2,1,2,4,-1,2,1,1,4,8,0,3,1,0,88,51,37,73,40,33,9,9,20,4,22,20,7,1,17,6,5,11,2,8,3,-2,17,9,16,14,19,17,5,2,7,6,12,11,3,1,9,8,7,6,2,1,108,20,88,85,37,48,10,12,50,15,-5,19,-17,-2,18,14,-5,6,27,14,32,1,0,13,23,21,31,9,2,-3,6,7,18,7,-1,-2,17,14,13,2,3,-1,67,17,50,116,63,53,7,3,15,1,6,21,-13,4,13,0,2,11,20,-1,2,1,4,10,25,23,33,23,6,1,14,8,20,15,4,1,11,15,13,8,2,0,79,55,24,196,121,75,13,-13,3,20,12,40,13,1,16,15,-4,15,0,-14,-13,5,16,25,30,56,46,40,16,6,18,30,33,29,9,1,12,26,13,11,7,5,120,62,58,112,60,52,34,38,-24,62,11,6,23,9,-5,36,-2,5,11,29,-19,26,13,1,23,24,35,26,4,-1,11,9,20,18,3,-1,12,15,15,8,1,0,269,116,153,92,47,45,67,26,57,61,8,34,30,13,25,28,4,4,37,13,32,33,4,30,22,14,25,12,11,5,13,8,9,7,4,3,9,6,16,5,7,2,-16,-44,28,-156,-90,-66,10,-35,-23,-17,3,27,-5,-13,-23,-22,-5,15,15,-22,0,5,8,12,-16,-22,-56,-42,-15,-5,-7,-12,-39,-24,-7,-1,-9,-10,-17,-18,-8,-4,18,-33,51,-24,-30,6,32,-9,37,-34,-26,12,3,-3,-13,-10,-12,-1,29,-6,50,-24,-14,13,-4,2,1,-17,-4,-1,-8,-1,-2,-14,-3,-1,4,3,3,-3,-1,0,75,7,68,-104,-61,-43,36,-16,37,-19,-16,28,26,-16,3,-26,-4,12,10,0,34,7,-12,16,-4,-10,-44,-36,-8,-4,0,-6,-26,-24,-4,-2,-4,-4,-18,-12,-4,-2,-88,-53,-35,-110,-70,-40,21,-26,-62,-14,-21,6,12,-13,-39,-13,-9,4,9,-13,-23,-1,-12,2,-12,-15,-35,-29,-18,-1,-8,-9,-27,-20,-6,0,-4,-6,-8,-9,-12,-1,-79,-72,-7,-50,-38,-12,-2,-1,-26,-48,-17,2,2,-10,-13,-47,-15,0,-4,9,-13,-1,-2,2,-10,-2,-17,-20,-2,0,-7,-1,-5,-20,-6,0,-3,-1,-12,0,4,0,50,37,13,-16,-3,-13,26,-18,34,-23,-15,28,15,-8,22,-16,-5,17,11,-10,12,-7,-10,11,6,-3,-10,-6,-5,0,9,-4,-5,-3,-2,1,-3,1,-5,-3,-3,-1,-57,-56,-1,4,3,1,5,-15,-40,-3,-18,17,-22,-11,-22,7,-13,5,27,-4,-18,-10,-5,12,-3,4,-2,3,2,1,-7,5,0,4,2,-1,4,-1,-2,-1,0,2,-55,-51,-4,13,7,6,-13,-41,-9,-10,-16,20,-15,-18,-5,-5,-19,-1,2,-23,-4,-5,3,21,5,4,1,2,-4,5,7,3,1,-2,-3,1,-2,1,0,4,-1,4
47,47084,Mayorga,1720,24,23,1,47,28,19,3,5,3,17,-3,-1,0,7,3,12,0,1,3,-2,0,5,-3,-2,5,11,15,15,1,0,2,8,8,9,1,0,3,3,7,6,0,0,32,7,25,45,24,21,-6,7,11,1,3,16,-6,1,6,0,1,5,0,6,5,1,2,11,4,11,21,8,1,0,0,6,13,4,1,0,4,5,8,4,0,0,138,94,44,138,84,54,23,28,41,30,13,3,15,19,34,18,6,2,8,9,7,12,7,1,21,29,41,39,8,0,12,17,28,23,4,0,9,12,13,16,4,0,-31,-15,-16,34,25,9,-10,-10,-7,-3,-2,2,-4,-7,2,-4,-2,1,-6,-3,-9,1,0,1,4,6,8,14,1,1,3,3,6,11,1,1,1,3,2,3,0,0,-20,-17,-3,62,35,27,7,-5,1,-22,3,-2,2,-7,3,-11,-1,-1,5,2,-2,-11,4,-1,11,11,21,14,6,0,4,5,14,9,4,0,7,6,7,5,2,0,-29,-21,-8,59,24,35,-10,3,0,-32,9,2,-6,1,-4,-15,4,1,-4,2,4,-17,5,1,12,13,22,4,7,1,6,4,11,1,2,0,6,9,11,3,5,1,90,35,55,69,26,43,12,25,19,5,16,14,5,15,4,-2,9,5,7,10,15,7,7,9,14,21,19,8,6,1,4,10,6,2,3,1,10,11,13,6,3,0,55,29,26,104,50,54,13,8,7,16,7,4,8,6,0,9,7,-1,5,2,7,7,0,5,24,25,36,16,3,0,10,12,17,9,2,0,14,13,19,7,1,0,-8,-9,1,10,4,6,6,-13,0,2,-2,-1,3,-6,2,-4,-3,-1,3,-7,-2,6,1,0,2,0,4,3,1,0,0,1,1,1,1,0,2,-1,3,2,0,0,36,21,15,29,18,11,5,6,14,11,7,-4,3,2,6,11,2,-1,2,4,8,0,5,-3,4,10,9,4,2,0,4,5,5,3,1,0,0,5,4,1,1,0,-12,-12,0,22,9,13,-6,-2,-12,2,5,-1,-5,2,-5,-4,1,-1,-1,-4,-7,6,4,0,1,1,11,5,4,0,1,0,5,1,2,0,0,1,6,4,2,0,-5,-2,-3,24,9,15,0,11,-6,1,-9,-2,3,5,-5,3,-6,-2,-3,6,-1,-2,-3,0,6,11,3,3,0,1,4,3,1,1,0,0,2,8,2,2,0,1,27,10,17,14,4,10,8,12,-4,3,3,4,2,4,-1,4,0,1,6,8,-3,-1,3,3,3,6,3,1,1,0,1,2,0,1,0,0,2,4,3,0,1,0,-36,-5,-31,7,5,2,-10,-12,-13,-7,3,1,-1,-1,-2,-5,1,2,-9,-11,-11,-2,2,-1,2,4,0,0,0,-1,2,2,1,0,0,-1,0,2,-1,0,0,0,31,11,20,12,8,4,3,7,-2,5,9,11,1,2,2,3,4,1,2,5,-4,2,5,10,1,1,2,7,1,0,0,0,2,5,1,0,1,1,0,2,0,0,19,14,5,14,8,6,12,9,2,3,-3,-5,5,5,2,3,0,-2,7,4,0,0,-3,-3,8,6,0,0,0,0,5,2,0,1,0,0,3,4,0,-1,0,0,-18,2,-20,-8,-4,-4,4,-6,-4,-8,2,-5,0,-5,3,0,4,-1,4,-1,-7,-8,-2,-4,-1,-1,1,-8,1,0,-2,-1,1,-2,0,0,1,0,0,-6,1,0,-4,-1,-3,10,3,7,2,-5,-6,-1,8,-2,0,1,-3,-1,4,-1,2,-6,-3,0,4,-1,3,3,1,4,-1,0,3,1,1,0,-2,0,0,2,0,4,1,0
47,47086,Medina de Rioseco,5001,22,6,16,9,4,5,1,5,1,10,6,1,0,3,1,4,3,-2,1,2,0,6,3,3,0,2,2,2,3,0,0,0,1,1,2,0,0,2,1,1,1,0,-52,-25,-27,5,3,2,-2,-8,-27,-4,-5,-4,0,-4,-12,-5,-1,-2,-2,-4,-15,1,-4,-2,2,1,2,0,0,0,2,0,1,0,0,0,0,1,1,0,0,0,-2,7,-9,34,20,14,-10,12,-8,-6,1,10,0,7,-1,-8,3,7,-10,5,-7,2,-2,3,8,8,5,6,4,3,7,4,3,2,2,2,1,4,2,4,2,1,30,23,7,12,3,9,3,4,4,11,2,3,4,-1,4,10,3,2,-1,5,0,1,-1,1,1,3,3,5,0,0,0,0,1,2,0,0,1,3,2,3,0,0,22,22,0,29,18,11,15,-5,12,1,-2,-3,5,-3,12,7,-2,-1,10,-2,0,-6,0,-2,5,8,11,3,0,0,3,4,8,2,0,0,2,4,3,1,0,0,36,9,27,59,29,30,6,3,-12,21,15,4,-2,4,-13,6,10,4,8,-1,1,15,5,0,15,10,9,15,7,2,6,7,4,7,5,0,9,3,5,8,2,2,-11,9,-20,24,14,10,-19,3,6,-7,3,3,-11,3,12,0,3,1,-8,0,-6,-7,0,2,4,7,6,6,1,0,2,4,2,5,1,0,2,3,4,1,0,0,7,1,6,41,16,25,6,11,-1,-14,6,-2,1,2,7,-11,3,-2,5,9,-8,-3,3,0,8,12,11,4,5,1,0,5,8,2,1,0,8,7,3,2,4,1,-16,-10,-6,2,0,2,1,-10,-10,0,-3,8,0,0,-8,0,-2,2,1,-10,-2,0,-1,6,0,0,1,2,0,-1,0,0,0,1,-1,0,0,0,1,1,1,-1,44,27,17,18,5,13,-8,8,-3,16,10,20,-3,0,0,10,6,14,-5,8,-3,6,4,6,0,9,5,2,1,1,0,1,1,1,1,1,0,8,4,1,0,0,-32,0,-32,7,4,3,-11,7,-12,-7,-2,-5,-5,5,-2,-1,4,0,-6,2,-10,-6,-6,-5,0,4,1,2,0,0,0,2,1,1,0,0,0,2,0,1,0,0,13,2,11,9,4,5,0,3,5,-3,8,4,0,-1,0,-4,1,5,0,4,5,1,7,-1,0,3,2,1,0,3,0,1,1,1,0,1,0,2,1,0,0,2,2,0,2,3,-1,4,9,-15,-7,5,3,6,4,-5,-4,-2,4,2,5,-10,-3,7,-1,4,0,0,1,2,0,0,0,0,-1,0,0,0,0,0,2,2,0,0,-8,1,-9,8,2,6,-3,-2,-5,-3,4,5,0,1,-4,0,3,3,-3,-3,-1,-3,1,2,2,1,1,1,2,1,1,0,0,0,1,0,1,1,1,1,1,1,-44,-11,-33,3,2,1,-4,-9,-16,-11,1,-5,-2,-3,-4,-6,4,-1,-2,-6,-12,-5,-3,-4,0,1,1,1,1,-1,0,0,1,0,1,0,0,1,0,1,0,-1,-12,-5,-7,-9,-5,-4,-9,-3,6,-7,-4,2,-1,-6,2,-5,1,3,-8,3,4,-2,-5,-1,4,1,-3,-7,-2,-2,2,0,-2,-2,-1,-2,2,1,-1,-5,-1,0,3,-11,14,5,5,0,9,2,-2,0,-7,3,1,3,-3,-5,-6,0,8,-1,1,5,-1,3,1,1,4,-2,-1,1,1,0,3,1,-1,1,0,1,1,-3,0,0,-15,-10,-5,5,3,2,-3,-2,-5,-10,-4,7,-1,1,-5,-8,0,2,-2,-3,0,-2,-4,5,1,2,2,0,0,0,1,1,1,0,0,0,0,1,1,0,0,0
47,47085,Medina del Campo,20023,52,12,40,64,18,46,-2,13,36,-7,8,3,4,1,7,-3,4,1,-6,12,29,-4,4,2,4,20,27,12,1,0,3,6,4,4,1,0,1,14,23,8,0,0,25,-3,28,100,43,57,-15,33,15,2,-7,-5,-6,11,2,-6,-3,-3,-9,22,13,8,-4,-2,15,32,31,18,4,0,8,12,15,7,1,0,7,20,16,11,3,0,-28,-7,-21,77,44,33,2,4,-16,-26,7,4,9,0,-6,-17,1,8,-7,4,-10,-9,6,-4,15,28,18,11,4,1,8,12,15,5,2,2,7,16,3,6,2,-1,173,98,75,100,57,43,23,6,46,24,15,57,15,5,31,23,4,19,8,1,15,1,11,38,19,20,35,18,6,2,9,10,21,11,4,2,10,10,14,7,2,0,182,86,96,130,64,66,37,49,84,-1,-7,11,27,15,44,-8,-2,5,10,34,40,7,-5,6,26,37,47,11,4,3,17,12,22,7,3,2,9,25,25,4,1,1,125,32,93,135,70,65,40,30,31,5,7,2,5,18,9,-5,5,-3,35,12,22,10,2,5,32,38,47,11,3,1,12,23,24,6,3,1,20,15,23,5,0,0,124,50,74,129,63,66,31,39,13,17,2,13,6,21,9,11,-4,6,25,18,4,6,6,7,29,33,40,12,7,3,16,16,23,5,0,1,13,17,17,7,7,2,392,205,187,293,164,129,37,101,98,82,35,31,17,44,74,43,21,6,20,57,24,39,14,25,38,91,86,49,20,5,20,45,58,28,11,2,18,46,28,21,9,3,214,118,96,108,61,47,50,58,47,17,19,13,16,31,41,3,10,11,34,27,6,14,9,2,27,30,23,17,2,3,7,15,17,12,4,2,20,15,6,5,-2,1,97,28,69,88,40,48,16,39,27,-4,1,11,-3,16,10,-10,-2,8,19,23,17,6,3,3,16,27,19,17,5,-1,8,12,10,5,1,-1,8,15,9,12,4,0,-16,-28,12,63,25,38,12,-11,-44,-7,18,15,11,-12,-18,-8,-3,1,1,1,-26,1,21,14,9,23,15,11,3,-1,7,5,7,4,-1,1,2,18,8,7,4,-2,35,27,8,40,20,20,20,13,-19,11,-14,17,13,7,-10,10,-4,9,7,6,-9,1,-10,8,8,20,6,-1,3,2,6,10,3,2,-2,0,2,10,3,-3,5,2,-31,-52,21,56,17,39,-10,-19,-9,-12,3,23,-15,-16,-15,-12,0,10,5,-3,6,0,3,13,10,19,16,5,4,2,1,5,6,3,1,1,9,14,10,2,3,1,-223,-131,-92,-81,-59,-22,-10,-25,-90,-80,-11,-3,-4,-12,-53,-50,-8,-1,-6,-13,-37,-30,-3,-2,-8,4,-15,-46,-14,-2,-8,3,-9,-34,-9,-2,0,1,-6,-12,-5,0,-98,-29,-69,29,17,12,-11,-25,-44,-30,-3,13,8,-4,-21,-18,-5,7,-19,-21,-23,-12,2,6,8,10,10,4,-2,-2,4,8,7,1,-3,-1,4,2,3,3,1,-1,-115,-64,-51,-5,-8,3,-5,3,-40,-52,-8,-9,1,0,-19,-34,-3,-1,-6,3,-21,-18,-5,-8,2,16,-2,-16,-9,3,1,6,-1,-9,-6,1,1,10,-1,-7,-3,2,-63,-3,-60,13,-4,17,-7,-2,-47,-14,-8,18,-3,-7,-8,7,-6,15,-4,5,-39,-21,-2,3,17,9,-10,1,-5,1,7,0,-7,-3,-2,1,10,9,-3,4,-3,0,-76,-62,-14,-19,-24,5,-16,5,-44,-30,-8,11,-6,7,-33,-34,-8,11,-10,-2,-11,4,0,0,0,19,-3,-21,-12,-3,-1,11,-8,-16,-11,1,1,8,5,-5,-1,-4
47,47114,Peñafiel,5132,10,-4,14,9,5,4,-7,2,9,-11,10,5,-7,-2,1,-3,5,2,0,4,8,-8,5,3,3,2,3,0,0,1,3,1,1,0,0,0,0,1,2,0,0,1,56,23,33,66,29,37,3,8,33,-1,5,5,0,6,16,-4,2,1,3,2,17,3,3,4,7,14,27,12,4,0,2,3,15,5,3,0,5,11,12,7,1,0,157,80,77,153,77,76,16,26,65,27,3,21,2,14,38,20,-2,9,14,12,27,7,5,12,21,36,61,30,5,0,8,17,33,19,0,0,13,19,28,11,5,0,21,28,-7,97,61,36,-1,8,2,6,4,4,3,9,5,2,6,5,-4,-1,-3,4,-2,-1,12,29,33,18,4,1,4,18,23,12,3,1,8,11,10,6,1,0,2,5,-3,90,49,41,3,10,-2,-13,8,-7,0,3,-3,-4,9,-1,3,7,1,-9,-1,-6,25,24,22,11,8,0,11,13,14,8,3,0,14,11,8,3,5,0,65,55,10,87,56,31,-9,39,29,2,3,0,-3,23,25,2,3,4,-6,16,4,0,0,-4,10,30,28,15,3,1,5,17,21,9,3,1,5,13,7,6,0,0,-13,-18,5,37,10,27,0,-5,-21,15,6,-6,1,-4,-20,2,5,-1,-1,-1,-1,13,1,-5,4,11,7,10,3,2,1,2,2,4,1,0,3,9,5,6,2,2,88,38,50,95,50,45,50,11,18,11,-3,-2,22,12,6,8,-9,-2,28,-1,12,3,6,0,26,21,29,13,4,1,13,16,15,5,0,0,13,5,14,8,4,1,33,19,14,52,28,24,-4,4,11,11,1,6,-5,6,2,11,1,1,1,-2,9,0,0,5,14,6,15,10,5,0,7,6,7,6,1,0,7,0,8,4,4,0,5,8,-3,37,16,21,2,3,-12,-3,6,5,2,2,-5,-1,4,4,0,1,-7,-2,2,1,10,10,4,10,1,0,5,4,0,5,1,0,5,6,4,5,0,0,0,1,-1,29,13,16,-2,5,-4,2,-5,3,-3,2,6,2,-6,0,1,3,-10,0,1,3,7,6,6,4,6,0,2,2,6,1,2,0,5,4,0,3,4,0,23,9,14,26,11,15,15,5,1,6,0,-5,5,3,-8,9,0,-1,10,2,9,-3,0,-4,14,3,10,0,-1,0,7,1,4,0,-1,0,7,2,6,0,0,0,-50,-32,-18,-14,-8,-6,-11,-1,-9,-22,-6,-2,-7,0,-2,-17,-3,-3,-4,-1,-7,-5,-3,1,-1,0,-4,-6,-3,0,0,-1,-1,-4,-1,-1,-1,1,-3,-2,-2,1,-19,-15,-4,16,6,10,2,-15,19,-35,12,-2,4,-9,2,-18,5,3,-2,-6,17,-17,7,-5,4,2,5,-1,5,1,3,1,1,-2,2,1,1,1,4,1,3,0,25,3,22,16,5,11,2,11,-5,3,5,8,1,6,-9,1,1,2,1,5,4,2,4,6,6,3,3,5,-1,0,2,2,3,1,-2,-1,4,1,0,4,1,1,-2,3,-5,12,5,7,0,4,0,-5,0,-1,-2,-1,1,1,2,1,2,5,-1,-6,-2,-2,3,5,0,4,-1,0,0,2,0,2,0,0,3,3,0,2,-1,0,-15,-12,-3,20,4,16,-8,-12,-9,7,2,1,-11,-3,-5,4,0,2,3,-9,-4,3,2,-1,4,4,3,6,0,0,-1,2,1,1,0,0,5,2,2,5,0,0,-24,-15,-9,18,11,7,-2,-6,-11,-13,11,-3,1,-5,-8,-10,7,-1,-3,-1,-3,-3,4,-2,2,3,7,5,1,0,2,2,4,2,1,0,0,1,3,3,0,0
47,47122,Portillo,2532,-28,-12,-16,8,5,3,-4,-9,-5,-8,3,-3,-2,-4,-4,-2,2,-1,-2,-5,-1,-6,1,-2,1,0,4,0,3,0,1,0,3,0,1,0,0,0,1,0,2,0,29,20,9,73,41,32,4,13,5,11,-2,-2,5,6,5,7,0,-3,-1,7,0,4,-2,1,5,20,25,21,2,0,3,10,15,13,0,0,2,10,10,8,2,0,38,21,17,55,32,23,21,7,1,8,2,-2,13,9,-3,1,1,-1,8,-2,4,7,1,-1,21,10,12,10,2,0,11,9,5,6,1,0,10,1,7,4,1,0,50,32,18,33,16,17,16,15,0,7,4,8,9,8,6,4,2,3,7,7,-6,3,2,5,4,14,6,5,3,0,3,6,5,1,1,0,1,8,1,4,2,0,7,3,4,18,8,10,1,-3,7,-1,-1,3,4,-4,-2,2,-1,3,-3,1,9,-3,0,0,2,3,8,3,2,0,1,2,2,2,1,0,1,1,6,1,1,0,-1,0,-1,22,14,8,11,0,-10,3,-4,-4,8,-1,-7,2,1,-3,3,1,-3,1,-5,-1,8,7,0,3,0,0,6,3,1,2,0,0,2,4,-1,1,0,0,7,2,5,16,5,11,2,7,-2,-2,1,1,4,0,-4,0,0,2,-2,7,2,-2,1,-1,4,4,5,3,0,0,2,1,1,1,0,0,2,3,4,2,0,0,28,11,17,24,9,15,-1,15,6,2,1,4,-3,7,6,1,-2,2,2,8,0,1,3,2,1,11,2,6,3,1,0,3,1,3,1,1,1,8,1,3,2,0,-16,-5,-11,15,12,3,-5,0,6,-13,1,-5,-2,-2,7,-4,1,-3,-3,2,-1,-9,0,-2,2,3,6,2,1,1,1,2,6,2,1,0,1,1,0,0,0,1,16,2,14,6,2,4,5,1,-2,8,-1,1,1,1,-7,1,1,0,4,0,5,7,-2,1,2,1,2,0,0,0,0,1,0,0,0,0,2,0,2,0,0,0,-19,-6,-13,3,3,0,-2,0,-10,-6,1,0,0,0,-2,-5,0,1,-2,0,-8,-1,1,-1,0,2,1,0,0,0,0,1,2,0,0,0,0,1,-1,0,0,0,-19,-9,-10,3,0,3,-5,-2,-10,-1,1,-3,-3,0,-6,1,0,-1,-2,-2,-4,-2,1,-2,1,0,0,-1,3,0,0,0,0,-1,1,0,1,0,0,0,2,0,0,5,-5,-1,0,-1,4,0,2,-1,-6,1,3,0,-1,5,-2,-1,1,0,3,-6,-4,2,0,0,0,1,-2,0,0,0,0,1,-1,0,0,0,0,0,-1,0,-12,3,-15,0,3,-3,-3,-5,1,-2,1,-4,0,-5,2,3,1,1,-3,0,-1,-5,0,-5,0,0,-1,1,0,0,1,0,0,2,0,0,-1,0,-1,-1,0,0,-11,-3,-8,-6,-3,-3,1,-3,0,-12,3,-2,1,1,-2,-6,3,-2,0,-4,2,-6,0,0,-3,-1,1,-5,0,2,-2,0,0,-2,0,1,-1,-1,1,-3,0,1,-21,-18,-3,-51,-36,-15,8,-2,-16,-6,-9,4,3,-2,-13,-5,-5,3,5,0,-3,-1,-4,1,-6,0,-15,-14,-13,-3,-4,-2,-9,-11,-9,-1,-2,2,-6,-3,-4,-2,5,7,-2,7,3,4,7,5,1,-11,3,-1,4,1,5,-5,2,0,3,4,-4,-6,1,-1,1,3,3,0,0,0,1,0,2,0,0,0,0,3,1,0,0,0,32,13,19,11,6,5,7,1,17,3,4,0,5,0,4,0,2,1,2,1,13,3,2,-1,1,3,3,1,1,2,1,0,2,1,0,2,0,3,1,0,1,0
47,47155,Santovenia de Pisuerga,2109,128,60,68,3,1,2,12,37,49,20,10,2,4,16,26,12,4,0,8,21,23,8,6,2,0,0,3,0,0,0,0,0,1,0,0,0,0,0,2,0,0,0,112,52,60,25,17,8,-10,33,34,13,13,30,-1,22,12,7,8,5,-9,11,22,6,5,25,0,15,9,0,1,0,0,11,5,0,1,0,0,4,4,0,0,0,162,81,81,8,3,5,45,28,48,31,0,4,21,15,20,15,3,3,24,13,28,16,-3,1,4,0,2,1,0,1,1,0,1,1,0,0,3,0,1,0,0,1,-41,-10,-31,4,1,3,-26,-9,16,-22,-5,8,-14,-5,20,-11,-2,2,-12,-4,-4,-11,-3,6,2,0,2,0,0,0,1,0,0,0,0,0,1,0,2,0,0,0,145,69,76,12,5,7,18,37,63,16,1,4,11,12,33,8,1,1,7,25,30,8,0,3,2,3,3,3,0,0,0,0,2,2,0,0,2,3,1,1,0,0,80,40,40,9,2,7,1,24,46,1,0,10,-4,10,29,2,2,2,5,14,17,-1,-2,8,3,1,4,1,0,0,0,0,2,0,0,0,3,1,2,1,0,0,157,80,77,26,14,12,-1,38,105,12,10,-4,-7,16,61,3,8,0,6,22,44,9,2,-4,6,7,7,4,2,0,1,4,4,3,2,0,5,3,3,1,0,0,106,60,46,49,25,24,-3,33,40,21,-3,17,1,14,22,14,-2,8,-4,19,18,7,-1,9,3,13,12,17,4,0,0,6,8,11,0,0,3,7,4,6,4,0,295,157,138,55,35,20,46,34,139,47,17,12,22,15,78,27,9,2,24,19,61,20,8,10,13,12,17,13,0,0,9,5,10,11,0,0,4,7,7,2,0,0,93,43,50,13,4,9,13,26,58,-11,9,-3,7,9,34,-10,6,-4,6,17,24,-1,3,1,2,3,3,3,2,0,1,1,2,0,0,0,1,2,1,3,2,0,89,57,32,3,0,3,8,26,35,6,8,6,9,11,25,6,4,1,-1,15,10,0,4,5,1,1,1,0,0,0,0,0,0,0,0,0,1,1,1,0,0,0,-8,6,-14,-3,-3,0,-23,2,10,5,4,-3,-13,8,5,2,4,-1,-10,-6,5,3,0,-2,1,1,-2,-4,1,0,1,0,-1,-4,1,0,0,1,-1,0,0,0,-24,-16,-8,-6,-1,-5,-23,6,5,-17,2,5,-18,0,5,-5,0,3,-5,6,0,-12,2,2,-1,-2,0,-3,-1,0,0,-2,1,-1,0,0,-1,0,-1,-2,-1,0,128,74,54,1,-4,5,32,10,43,35,9,0,24,3,21,17,7,1,8,7,22,18,2,-1,0,5,-2,-1,-1,0,0,1,-2,-2,-1,0,0,4,0,1,0,0,23,6,17,-1,1,-2,5,12,19,-12,-7,4,-9,4,18,-3,-4,0,14,8,1,-9,-3,4,-1,1,1,-1,-1,0,-1,0,1,1,0,0,0,1,0,-2,-1,0,7,10,-3,4,1,3,-1,-3,-5,6,4,6,5,1,-12,5,5,4,-6,-4,7,1,-1,2,1,1,0,2,0,0,1,1,-1,0,0,0,0,0,1,2,0,0,46,32,14,-4,-6,2,20,-9,44,-4,-6,0,10,3,18,-4,4,-1,10,-12,26,0,-10,1,-3,0,2,-1,-2,0,-3,-1,0,-1,-1,0,0,1,2,0,-1,0,25,-2,27,20,10,10,-1,10,21,-15,-1,13,-8,4,7,-2,-4,0,7,6,14,-13,3,13,4,2,7,5,1,1,2,1,3,4,0,0,2,1,4,1,1,1
47,47161,Simancas,3105,140,74,66,11,6,5,24,15,46,42,9,3,13,13,25,22,3,-1,11,2,21,20,6,4,2,1,5,1,1,0,2,0,3,1,0,0,0,1,2,0,1,0,282,136,146,21,7,14,71,16,93,84,13,1,27,14,39,45,9,1,44,2,54,39,4,0,6,3,5,6,1,0,2,0,1,4,0,0,4,3,4,2,1,0,187,108,79,20,12,8,51,6,55,67,-4,2,25,11,22,39,0,3,26,-5,33,28,-4,-1,6,1,6,5,2,0,3,2,3,3,1,0,3,-1,3,2,1,0,177,96,81,31,17,14,46,8,55,60,2,5,35,3,28,29,0,1,11,5,27,31,2,4,7,6,13,3,2,0,4,3,8,1,1,0,3,3,5,2,1,0,140,85,55,56,32,24,13,25,62,51,-6,-3,9,8,37,36,-2,-3,4,17,25,15,-4,0,10,16,18,11,0,0,6,8,8,8,1,0,4,8,10,3,-1,0,139,67,72,22,8,14,54,-4,25,61,1,-1,31,2,12,27,-7,-1,23,-6,13,34,8,0,1,4,8,5,3,1,0,1,5,1,1,0,1,3,3,4,2,1,42,16,26,29,14,15,30,-8,13,6,0,2,23,-6,7,-4,-2,0,7,-2,6,10,2,2,9,6,6,4,2,0,6,3,3,2,0,0,3,3,3,2,2,0,134,77,57,63,32,31,69,5,28,38,-11,6,42,4,14,23,-7,2,27,1,14,15,-4,4,15,17,14,11,3,2,8,10,7,5,1,1,7,7,7,6,2,1,72,46,26,3,3,0,27,-12,18,25,9,4,15,-6,12,19,4,0,12,-6,6,6,5,4,5,-2,0,-1,-1,2,4,0,0,0,-1,0,1,-2,0,-1,0,2,90,34,56,8,8,0,44,6,27,12,-7,1,33,5,-5,0,-5,1,11,1,32,12,-2,0,-1,1,3,2,2,0,1,1,0,3,2,0,-2,0,3,-1,0,0,11,17,-6,18,10,8,30,-11,-9,7,-5,-4,23,-4,-4,7,0,-5,7,-7,-5,0,-5,1,9,5,3,5,-1,-4,7,2,0,3,0,-2,2,3,3,2,-1,-2,-20,-22,2,5,3,2,16,-5,-24,0,-9,3,6,-2,-20,0,-4,1,10,-3,-4,0,-5,2,0,5,-1,0,2,-1,0,2,0,1,1,-1,0,3,-1,-1,1,0,7,8,-1,3,1,2,16,-9,-1,7,-8,-1,11,-3,2,3,-5,-1,5,-6,-3,4,-3,0,2,-1,0,2,0,0,1,-1,0,1,0,0,1,0,0,1,0,0,-107,-47,-60,-66,-34,-32,-18,-24,-15,-28,-24,0,-3,-13,-6,-17,-8,-1,-15,-11,-9,-11,-16,1,-9,-13,-2,-28,-12,-2,-4,-7,1,-16,-7,-1,-5,-6,-3,-12,-5,-1,-61,-36,-25,-8,-6,-2,-9,-19,-14,-11,-5,-7,-14,-6,-7,-5,-1,-4,5,-13,-7,-6,-4,-3,-6,0,-3,-1,3,-1,-5,-1,0,-1,2,-1,-1,1,-3,0,1,0,-24,-4,-20,-4,1,-5,16,-11,-32,10,-13,3,14,-8,-10,4,-8,3,2,-3,-22,6,-5,0,-2,3,-9,0,0,2,0,1,-4,1,1,1,-2,2,-5,-1,-1,1,-49,-17,-32,-26,-9,-17,5,-18,-16,5,-17,-11,4,-5,-5,6,-11,-6,1,-13,-11,-1,-6,-5,1,-3,-12,-6,-4,-2,3,-1,-5,-3,-3,0,-2,-2,-7,-3,-1,-2,33,18,15,15,5,10,45,-11,-10,19,-16,0,18,-2,-3,-3,-1,3,27,-9,-7,22,-15,-3,8,1,4,1,1,0,1,0,3,-1,2,0,7,1,1,2,-1,0
47,47165,Tordesillas,8002,-90,-47,-43,6,2,4,-11,-17,-37,-17,-3,-3,-6,-12,-18,-8,-2,1,-5,-5,-19,-9,-1,-4,0,2,4,0,0,0,0,0,2,0,0,0,0,2,2,0,0,0,-39,-8,-31,16,8,8,-6,3,-26,0,1,-9,-10,7,-8,3,1,-2,4,-4,-18,-3,0,-7,1,6,7,2,0,0,0,4,3,1,0,0,1,2,4,1,0,0,49,21,28,32,17,15,-2,18,-2,16,12,3,0,6,0,7,7,1,-2,12,-2,9,5,2,5,11,6,5,4,0,3,4,5,3,2,0,2,7,1,2,2,0,-62,-24,-38,42,24,18,-4,3,-36,-18,-6,-3,-4,5,-12,-8,-4,-3,0,-2,-24,-10,-2,0,7,23,6,6,0,0,2,13,6,3,0,0,5,10,0,3,0,0,214,107,107,153,75,78,35,37,67,52,15,4,13,20,29,34,9,2,22,17,38,18,6,2,28,37,43,37,5,2,12,20,15,23,3,1,16,17,28,14,2,1,43,41,2,75,43,32,8,5,24,-8,11,2,5,6,14,7,7,1,3,-1,10,-15,4,1,11,22,23,14,4,0,6,11,13,10,2,0,5,11,10,4,2,0,32,20,12,74,37,37,7,16,8,-6,12,-6,-1,16,4,-6,10,-4,8,0,4,0,2,-2,13,28,22,7,2,-1,7,18,7,2,2,0,6,10,15,5,0,-1,-148,-78,-70,33,15,18,-24,-24,-46,-42,-8,-1,-12,-8,-29,-25,-4,3,-12,-16,-17,-17,-4,-4,5,6,12,6,3,1,3,2,5,3,1,1,2,4,7,3,2,0,104,76,28,119,72,47,23,21,25,19,12,5,18,15,19,13,9,2,5,6,6,6,3,3,27,35,27,20,7,2,18,19,18,11,5,1,9,16,9,9,2,1,128,68,60,74,30,44,38,26,30,27,8,-8,22,10,22,14,2,-2,16,16,8,13,6,-6,22,20,19,12,0,-2,9,6,10,6,0,-1,13,14,9,6,0,-1,-34,-17,-17,53,26,27,7,-10,-26,8,2,-14,6,-5,-14,-1,3,-4,1,-5,-12,9,-1,-10,15,14,8,7,4,3,10,5,4,4,3,-1,5,9,4,3,1,4,66,25,41,56,25,31,5,19,11,32,-3,-3,-3,9,2,14,3,0,8,10,9,18,-6,-3,13,19,12,13,-1,0,6,9,2,8,0,0,7,10,10,5,-1,0,-67,-33,-34,24,7,17,-13,-5,-12,-24,-9,-6,-3,3,-14,-12,-7,-1,-10,-8,2,-12,-2,-5,7,5,5,3,1,1,3,2,0,1,0,0,4,3,5,2,1,1,-68,-36,-32,-2,0,-2,-12,-8,-27,-20,-1,2,-4,-5,-10,-14,0,0,-8,-3,-17,-6,-1,2,3,4,-5,-3,0,-1,1,3,-2,-2,0,0,2,1,-3,-1,0,-1,16,-5,21,18,10,8,21,-8,13,1,-8,2,4,-3,3,-1,-7,0,17,-5,10,2,-1,2,3,3,2,5,6,-1,3,2,2,1,2,0,0,1,0,4,4,-1,-10,-23,13,24,9,15,29,-11,-5,-6,-16,-3,13,-8,-2,-8,-12,-5,16,-3,-3,2,-4,2,7,4,8,1,3,0,4,2,4,-2,1,0,3,2,4,3,2,0,-23,9,-32,45,23,22,-17,2,-5,-5,0,4,-4,11,-1,1,2,-1,-13,-9,-4,-6,-2,5,9,11,19,4,-2,4,5,7,10,0,0,1,4,4,9,4,-2,3,-3,1,-4,40,18,22,15,2,-18,-2,1,-4,13,5,-12,-6,0,0,2,-3,-6,4,1,-4,9,7,8,11,4,1,6,3,1,4,3,1,3,4,7,7,1,0
47,47173,Traspinedo,821,-21,-6,-15,2,1,1,-5,0,-8,-3,-4,-1,-2,0,-2,-1,-1,0,-3,0,-6,-2,-3,-1,0,2,0,0,0,0,0,1,0,0,0,0,0,1,0,0,0,0,25,20,5,12,6,6,3,5,0,8,9,0,2,2,4,4,7,1,1,3,-4,4,2,-1,4,2,2,3,1,0,3,0,1,1,1,0,1,2,1,2,0,0,6,1,5,3,1,2,0,0,4,1,1,0,-1,2,0,-1,0,1,1,-2,4,2,1,-1,2,-1,2,0,0,0,0,0,1,0,0,0,2,-1,1,0,0,0,69,32,37,19,9,10,3,13,29,6,8,8,1,7,11,4,3,6,2,6,18,2,5,2,2,8,6,2,1,0,0,3,4,1,1,0,2,5,2,1,0,0,46,33,13,32,21,11,5,14,15,7,8,-3,4,9,14,2,6,-2,1,5,1,5,2,-1,6,10,7,6,3,0,4,6,6,4,1,0,2,4,1,2,2,0,52,30,22,28,16,12,9,8,10,10,14,0,2,4,7,6,9,1,7,4,3,4,5,-1,3,8,6,5,6,0,0,5,4,3,4,0,3,3,2,2,2,0,-12,-4,-8,12,7,5,-4,0,-7,3,4,-8,-5,-1,-1,7,0,-4,1,1,-6,-4,4,-4,10,0,5,-2,-1,0,5,0,3,0,-1,0,5,0,2,-2,0,0,36,18,18,18,11,7,0,7,15,9,6,1,0,1,13,0,4,0,0,6,2,9,2,1,1,2,8,7,0,0,0,0,6,5,0,0,1,2,2,2,0,0,22,21,1,13,9,4,1,10,10,-3,8,-2,2,7,9,0,5,-2,-1,3,1,-3,3,0,1,7,3,2,0,0,1,5,1,2,0,0,0,2,2,0,0,0,25,19,6,19,10,9,5,1,14,10,-3,-1,4,0,6,9,0,0,1,1,8,1,-3,-1,4,3,7,5,0,0,1,1,3,5,0,0,3,2,4,0,0,0,10,0,10,10,3,7,-7,3,1,4,5,5,-2,0,-3,2,3,1,-5,3,4,2,2,4,1,5,3,1,0,0,1,1,1,0,0,0,0,4,2,1,0,0,35,23,12,3,3,0,8,4,4,6,4,6,6,1,7,1,3,3,2,3,-3,5,1,3,1,-1,1,1,0,0,1,0,1,0,0,0,0,-1,0,1,0,0,20,11,9,-4,-5,1,2,0,6,10,0,3,0,-1,2,8,0,4,2,1,4,2,0,-1,-1,1,-1,-2,-1,0,-2,0,0,-2,-1,0,1,1,-1,0,0,0,2,-1,3,5,1,4,5,0,0,-1,0,-2,3,1,-3,1,-2,-1,2,-1,3,-2,2,-1,1,1,2,0,0,1,1,0,0,0,0,0,0,1,2,0,0,1,-13,-6,-7,-6,-4,-2,-4,5,-11,2,0,-3,-1,3,-7,0,1,-2,-3,2,-4,2,-1,-1,-1,-3,-2,-1,1,0,-1,-2,-2,0,1,0,0,-1,0,-1,0,0,-1,0,-1,-7,-2,-5,2,-1,9,-3,-6,-4,-4,2,3,0,-1,-1,6,-3,6,-3,-5,-3,-1,-2,-1,-1,-2,0,-1,0,0,0,-1,0,0,-2,-1,-1,-1,0,11,11,0,18,10,8,-2,2,5,6,4,-4,-1,3,3,7,1,-2,-1,-1,2,-1,3,-2,4,3,3,5,3,0,1,3,1,5,0,0,3,0,2,0,3,0,5,3,2,8,5,3,-1,6,2,-8,6,-2,2,0,4,-7,3,-1,-3,6,-2,-1,3,-1,3,1,4,0,0,0,3,-1,3,0,0,0,0,2,1,0,0,0
47,47186,Valladolid,319998,-1318,-794,-524,1024,494,530,83,-332,-769,-59,-243,-20,51,-151,-461,-72,-149,-20,32,-181,-308,13,-94,0,144,189,375,222,65,14,75,88,175,114,31,8,69,101,200,108,34,6,213,65,148,2623,1431,1192,192,208,-392,359,-239,57,73,129,-227,197,-142,22,119,79,-165,162,-97,35,309,622,968,571,101,27,153,335,554,318,48,9,156,287,414,253,53,18,245,73,172,2433,1326,1107,537,80,-413,242,-215,0,244,70,-227,103,-137,10,293,10,-186,139,-78,-10,482,562,701,492,128,47,246,296,413,280,66,16,236,266,288,212,62,31,-616,-485,-131,2340,1158,1182,501,-20,-924,75,-210,-64,248,-8,-557,-16,-131,-31,253,-12,-367,91,-79,-33,481,561,679,414,141,40,239,269,347,207,69,16,242,292,332,207,72,24,-370,-365,-5,2467,1251,1216,253,246,-954,168,-143,56,108,113,-514,9,-91,17,145,133,-440,159,-52,39,460,621,761,420,141,46,242,287,429,207,57,25,218,334,332,213,84,21,-810,-696,-114,2421,1154,1267,280,215,-1235,74,-169,49,70,72,-701,-5,-128,22,210,143,-534,79,-41,27,484,626,718,405,121,41,226,285,375,201,45,13,258,341,343,204,76,28,-366,-333,-33,3094,1524,1570,471,292,-1137,174,-290,101,244,188,-658,38,-176,24,227,104,-479,136,-114,77,624,783,909,576,149,31,299,345,489,298,66,13,325,438,420,278,83,18,1905,1031,874,4275,2313,1962,648,728,-106,508,10,93,343,389,44,282,-39,16,305,339,-150,226,49,77,686,1179,1282,802,259,24,355,605,741,471,112,9,331,574,541,331,147,15,-388,-355,-33,1551,792,759,383,118,-832,57,-215,45,239,52,-509,-29,-133,-2,144,66,-323,86,-82,47,379,464,378,245,57,-3,198,215,221,112,32,-1,181,249,157,133,25,-2,-1880,-1309,-571,4,-129,133,230,-292,-1387,-349,-210,80,150,-189,-938,-241,-148,36,80,-103,-449,-108,-62,44,278,110,-219,-175,-15,9,168,32,-194,-132,-20,9,110,78,-25,-43,5,0,-2122,-1342,-780,240,43,197,-18,-140,-1342,-360,-280,22,-43,-83,-836,-230,-164,13,25,-57,-506,-130,-116,9,82,129,3,-26,33,11,47,45,-39,-32,10,9,35,84,42,6,23,2,-534,-562,28,270,-4,274,201,13,-749,-143,-108,206,112,12,-462,-198,-101,62,89,1,-287,55,-7,144,116,163,45,-77,-6,16,60,45,-4,-78,-39,7,56,118,49,1,33,9,-1301,-809,-492,53,-28,81,-18,-172,-796,-261,-95,25,-18,-95,-432,-213,-55,-4,0,-77,-364,-48,-40,29,21,98,-31,-60,6,1,8,35,-31,-55,6,-1,13,63,0,-5,0,2,-1424,-799,-625,-102,-12,-90,-36,-165,-851,-139,-199,-36,-29,-60,-446,-125,-116,-20,-7,-105,-405,-14,-83,-16,22,31,-158,-24,16,-4,13,37,-71,-3,10,-7,9,-6,-87,-21,6,3,-1404,-944,-460,-549,-365,-184,43,-101,-840,-288,-187,-38,23,-89,-518,-236,-104,-20,20,-12,-322,-52,-83,-18,-10,19,-253,-246,-58,-11,-12,-5,-136,-180,-38,1,2,24,-117,-66,-20,-12,-997,-611,-386,-743,-418,-325,100,-100,-740,-203,-125,55,42,-41,-430,-141,-53,12,58,-59,-310,-62,-72,43,-20,-13,-282,-296,-112,-37,-11,0,-158,-173,-62,-20,-9,-13,-124,-123,-50,-17,-674,-461,-213,-489,-336,-153,92,-56,-438,-198,-129,41,46,9,-296,-166,-79,17,46,-65,-142,-32,-50,24,39,21,-190,-226,-114,-35,4,19,-114,-168,-73,-12,35,2,-76,-58,-41,-23,-837,-674,-163,-863,-602,-261,256,141,-530,-398,-212,-74,134,38,-332,-338,-185,12,122,103,-198,-60,-27,-86,76,91,-222,-449,-259,-110,30,26,-132,-321,-168,-43,46,65,-90,-128,-91,-67
47,47217,Villanubla,921,72,37,35,2,1,1,4,12,41,8,6,0,-1,4,21,7,4,1,5,8,20,1,2,-1,0,0,2,0,0,0,0,0,1,0,0,0,0,0,1,0,0,0,105,56,49,2,1,1,13,16,43,21,7,5,3,7,27,13,3,3,10,9,16,8,4,2,0,1,1,0,0,0,0,0,1,0,0,0,0,1,0,0,0,0,92,43,49,13,7,6,12,23,28,19,9,1,9,11,11,10,4,-2,3,12,17,9,5,3,3,5,5,1,-1,0,1,3,4,0,-1,0,2,2,1,1,0,0,53,32,21,14,4,10,1,8,31,10,3,-1,1,4,20,6,3,-1,0,4,11,4,0,0,3,4,2,4,1,0,0,2,1,1,0,0,3,2,1,3,1,0,116,68,48,12,8,4,7,23,63,15,5,2,8,11,36,8,2,2,-1,12,27,7,3,0,5,3,4,0,0,0,4,0,3,1,0,0,1,3,1,-1,0,0,27,12,15,9,4,5,-4,5,33,-4,-3,0,-2,2,16,-3,-1,1,-2,3,17,-1,-2,-1,2,4,3,0,0,0,1,2,1,0,0,0,1,2,2,0,0,0,235,126,109,5,2,3,33,46,106,26,20,2,17,22,61,12,12,2,16,24,45,14,8,0,2,1,2,0,0,0,1,0,1,0,0,0,1,1,1,0,0,0,155,69,86,24,11,13,18,23,60,45,10,-1,2,11,28,24,6,-1,16,12,32,21,4,0,4,7,9,1,2,0,2,4,5,0,0,0,2,3,4,1,2,0,118,56,62,2,2,0,11,21,59,20,6,-2,5,10,33,5,3,-1,6,11,26,15,3,-1,1,1,1,1,-2,0,1,1,1,0,-1,0,0,0,0,1,-1,0,88,59,29,13,9,4,16,3,50,3,5,7,17,-2,29,9,0,4,-1,5,21,-6,5,3,6,-3,4,3,2,1,5,-2,3,1,1,1,1,-1,1,2,1,0,56,18,38,1,-1,2,-6,15,32,8,3,0,-3,8,12,1,0,-1,-3,7,20,7,3,1,0,0,2,0,0,-1,0,0,0,0,0,-1,0,0,2,0,0,0,57,24,33,3,-2,5,1,2,41,1,6,3,2,-4,19,1,5,1,-1,6,22,0,1,2,0,1,3,-2,1,0,-1,-1,1,-2,1,0,1,2,2,0,0,0,42,23,19,2,1,1,6,2,17,5,1,8,-1,2,9,6,2,4,7,0,8,-1,-1,4,1,1,0,-1,-1,2,1,1,0,-2,0,1,0,0,0,1,-1,1,24,18,6,-1,0,-1,-10,4,16,6,4,1,-5,1,10,7,2,1,-5,3,6,-1,2,0,-2,0,1,-1,1,0,-1,0,1,-1,1,0,-1,0,0,0,0,0,61,26,35,7,5,2,3,5,31,9,5,6,1,7,13,1,2,1,2,-2,18,8,3,5,2,1,3,1,0,0,2,1,2,0,0,0,0,0,1,1,0,0,22,11,11,0,2,-2,-5,2,13,4,1,5,2,1,9,0,-2,1,-7,1,4,4,3,4,-1,-1,1,0,0,1,0,0,2,0,0,0,-1,-1,-1,0,0,1,16,0,16,-14,-12,-2,5,14,6,-12,-3,2,-1,8,0,-7,-2,-1,6,6,6,-5,-1,3,1,1,-3,-11,-2,0,0,-1,-3,-5,-3,0,1,2,0,-6,1,0,18,9,9,-3,-4,1,6,7,11,-1,-4,0,6,3,3,-2,-1,0,0,4,8,1,-3,0,3,0,-2,-4,0,0,2,-1,-2,-3,0,0,1,1,0,-1,0,0
48,48001,Abadiño,6858,-12,-10,-2,10,1,9,4,-10,10,-7,-13,3,2,-6,1,0,-9,2,2,-4,9,-7,-4,1,1,2,4,2,0,0,1,0,0,0,0,0,0,2,4,2,0,0,74,40,34,6,3,3,20,1,31,13,10,1,9,-5,20,11,7,0,11,6,11,2,3,1,5,1,0,0,0,0,3,0,0,0,0,0,2,1,0,0,0,0,34,26,8,14,7,7,9,13,25,6,-15,0,1,9,15,9,-7,-1,8,4,10,-3,-8,1,0,2,4,7,1,0,0,0,2,4,1,0,0,2,2,3,0,0,67,40,27,19,10,9,9,13,31,3,0,7,7,6,21,5,1,-1,2,7,10,-2,-1,8,4,3,4,5,2,1,4,1,1,2,1,1,0,2,3,3,1,0,54,57,-3,38,27,11,-1,15,52,-4,-4,-10,6,9,41,0,0,-5,-7,6,11,-4,-4,-5,9,9,12,7,0,0,6,6,8,7,0,0,3,3,4,0,0,0,32,24,8,39,22,17,-14,6,37,1,-3,4,-8,1,26,7,-2,2,-6,5,11,-6,-1,2,5,8,15,8,2,0,3,4,7,7,1,0,2,4,8,1,1,0,-21,-21,0,46,8,38,13,1,18,-26,-19,-8,-4,0,5,-10,-8,-5,17,1,13,-16,-11,-3,15,16,10,2,1,0,1,4,0,0,1,0,14,12,10,2,0,0,39,17,22,42,23,19,12,17,17,3,-8,-5,-2,14,7,4,-5,-4,14,3,10,-1,-3,-1,3,13,12,12,0,0,2,6,5,8,0,0,1,7,7,4,0,0,25,3,22,17,-6,23,13,24,-21,-6,-5,15,6,18,-7,-20,-3,6,7,6,-14,14,-2,9,13,11,-5,-1,-2,-1,5,3,-5,-7,-1,-1,8,8,0,6,-1,0,4,-16,20,2,-3,5,1,-9,21,3,0,-15,-1,-4,4,-3,-3,-9,2,-5,17,6,3,-6,-3,4,-3,4,-1,0,-1,2,-4,1,-1,0,-2,2,1,3,0,0,-21,-34,13,-2,-4,2,-6,9,-8,1,-11,-10,-2,-3,-20,7,-5,-10,-4,12,12,-6,-6,0,1,-2,-5,4,0,0,-1,-2,-6,5,0,0,2,0,1,-1,0,0,18,6,12,9,2,7,14,1,9,-8,-1,-1,9,5,-8,-2,-4,4,5,-4,17,-6,3,-5,5,2,3,-2,0,0,1,0,1,-1,0,0,4,2,2,-1,0,0,22,4,18,15,7,8,-2,2,19,15,-9,0,-1,2,6,5,-5,-3,-1,0,13,10,-4,3,0,7,1,4,2,1,1,5,0,1,0,0,-1,2,1,3,2,1,11,19,-8,-12,-4,-8,-16,-13,41,-5,2,-3,-5,-6,30,2,-1,-1,-11,-7,11,-7,3,-2,-3,-4,-4,-3,-1,1,-1,-2,1,-3,0,1,-2,-2,-5,0,-1,0,-11,6,-17,-2,-1,-1,3,-2,-19,1,4,-1,9,6,-11,-3,8,-4,-6,-8,-8,4,-4,3,6,2,-4,-4,0,-2,5,1,-2,-6,3,-2,1,1,-2,2,-3,0,2,5,-3,-3,-3,0,-3,16,3,-9,-1,-4,-1,4,8,-1,-6,1,-2,12,-5,-8,5,-5,1,0,-2,-2,0,-1,1,0,-1,-1,-3,0,0,0,-1,-1,3,-1,-44,-32,-12,-9,-5,-4,-13,-1,-9,-8,-13,7,-9,-2,-4,-10,-8,2,-4,1,-5,2,-5,5,-5,5,-3,-4,-4,1,-2,3,-2,-2,-4,1,-3,2,-1,-2,0,0,0,14,-14,7,3,4,-7,9,-1,11,-3,-12,-7,6,8,13,-1,-5,0,3,-9,-2,-2,-7,4,3,6,-6,0,-1,2,2,3,-4,0,0,2,1,3,-2,0,-1
48,48002,Abanto y Ciérvana-Abanto Zierbena,8920,26,15,11,9,4,5,-4,4,4,17,0,6,2,-1,4,11,-2,0,-6,5,0,6,2,6,0,1,4,3,0,1,0,1,2,1,0,0,0,0,2,2,0,1,44,24,20,14,4,10,0,12,11,20,4,-8,0,11,0,10,1,0,0,1,11,10,3,-8,3,4,3,2,1,1,0,2,0,1,0,1,3,2,3,1,1,0,135,75,60,11,8,3,12,22,53,11,10,29,12,4,37,2,12,10,0,18,16,9,-2,19,3,4,2,2,0,0,1,4,1,2,0,0,2,0,1,0,0,0,131,66,65,7,3,4,14,32,44,19,7,14,10,14,23,12,1,6,4,18,21,7,6,8,2,0,3,1,1,0,2,-1,1,1,0,0,0,1,2,0,1,0,182,88,94,25,9,16,36,45,56,37,6,0,15,22,31,18,4,0,21,23,25,19,2,0,6,3,11,4,1,0,2,1,5,1,0,0,4,2,6,3,1,0,140,65,75,27,14,13,22,33,36,22,12,10,16,6,23,9,5,2,6,27,13,13,7,8,7,7,7,4,1,1,5,3,5,1,0,0,2,4,2,3,1,1,-2,-13,11,26,4,22,-8,0,-12,3,-2,15,-5,2,-8,-2,-4,3,-3,-2,-4,5,2,12,5,8,7,4,2,0,1,2,1,0,0,0,4,6,6,4,2,0,1,-9,10,24,8,16,8,11,-3,0,-13,-2,-3,13,-8,1,-11,-1,11,-2,5,-1,-2,-1,3,7,10,2,2,0,2,4,2,0,0,0,1,3,8,2,2,0,38,37,1,29,18,11,23,11,-16,10,11,1,18,8,-8,15,8,-2,5,3,-8,-5,3,3,12,7,9,1,0,0,7,6,5,0,0,0,5,1,4,1,0,0,72,44,28,11,4,7,18,13,9,26,0,8,15,6,-2,13,6,5,3,7,11,13,-6,3,4,0,2,3,-1,3,1,-1,2,3,-2,1,3,1,0,0,1,2,18,25,-7,11,3,8,3,13,-15,22,2,-6,3,16,6,10,-2,-6,0,-3,-21,12,4,0,1,4,0,6,1,-1,1,3,-2,1,1,-1,0,1,2,5,0,0,37,14,23,10,5,5,-9,13,17,10,-4,4,-7,-1,9,11,-2,0,-2,14,8,-1,-2,4,0,4,5,1,1,-1,-1,2,4,0,0,0,1,2,1,1,1,-1,12,-16,28,6,-1,7,20,-5,-2,11,2,-10,4,-3,-10,3,-1,-8,16,-2,8,8,3,-2,1,4,-2,2,1,0,0,2,-3,0,0,0,1,2,1,2,1,0,-52,-23,-29,-21,-14,-7,-14,4,-10,-32,7,-3,-11,1,1,-19,6,1,-3,3,-11,-13,1,-4,3,0,-13,-8,-1,-2,-1,0,-10,-3,0,0,4,0,-3,-5,-1,-2,-9,-7,-2,-10,-11,1,6,2,-31,-18,7,20,5,0,-20,-14,12,6,1,2,-11,-4,-5,14,1,2,-8,-5,-2,2,1,-2,-6,-3,-1,0,0,4,-2,-2,-1,2,9,13,-4,4,-1,5,-3,-8,6,6,-7,12,0,-3,11,9,-5,1,-3,-5,-5,-3,-2,11,-2,5,2,-2,1,0,0,1,1,-2,-1,0,-2,4,1,0,2,0,-4,-16,12,16,7,9,-3,10,-2,-4,-2,-3,1,5,-10,-5,-4,-3,-4,5,8,1,2,0,3,3,7,3,1,-2,3,1,1,1,0,0,0,2,6,2,1,-2,30,14,16,18,1,17,14,3,-2,10,-12,16,-2,2,2,7,-2,6,16,1,-4,3,-10,10,4,5,5,2,2,0,0,1,2,-3,1,0,4,4,3,5,1,0
48,48003,Amorebieta-Etxano,16243,76,15,61,38,18,20,36,-20,24,26,-8,14,17,-9,-6,9,-3,4,19,-11,30,17,-5,10,11,3,6,9,6,3,5,1,2,4,3,3,6,2,4,5,3,0,55,30,25,57,30,27,6,4,42,1,-23,22,4,-2,30,7,-14,4,2,6,12,-6,-9,18,13,7,25,9,1,1,7,3,15,5,0,0,6,4,10,4,1,1,61,21,40,59,39,20,14,-12,11,7,4,28,6,-3,-8,7,6,10,8,-9,19,0,-2,18,12,8,23,13,0,2,7,4,13,13,0,1,5,4,10,0,0,1,180,81,99,99,45,54,31,41,68,29,-6,17,19,16,41,9,-6,4,12,25,27,20,0,13,20,25,35,14,1,3,8,12,18,7,-1,1,12,13,17,7,2,2,158,63,95,102,43,59,22,42,50,30,10,2,12,18,13,15,2,1,10,24,37,15,8,1,16,33,25,24,3,0,8,15,7,12,1,0,8,18,18,12,2,0,279,103,176,109,59,50,50,49,126,59,-19,8,18,23,60,16,-16,2,32,26,66,43,-3,6,22,29,41,16,0,0,12,18,24,5,0,0,10,11,17,11,0,0,227,120,107,186,102,84,56,69,102,7,-7,-4,25,37,57,5,1,-7,31,32,45,2,-8,3,55,56,42,29,1,2,36,35,17,13,0,1,19,21,25,16,1,1,195,98,97,192,115,77,46,25,90,27,-13,16,31,9,53,11,-13,9,15,16,37,16,0,7,57,47,42,35,6,3,46,31,21,17,0,0,11,16,21,18,6,3,176,78,98,110,57,53,25,42,57,43,11,2,14,22,28,17,-2,4,11,20,29,26,13,-2,18,40,25,17,7,4,11,23,12,9,2,1,7,17,13,8,5,3,120,73,47,103,65,38,42,22,40,21,1,-11,44,7,22,12,-6,-6,-2,15,18,9,7,-5,39,31,12,14,10,-3,35,20,4,6,2,-1,4,11,8,8,8,-2,142,87,55,134,95,39,66,15,33,28,-14,7,54,-3,21,10,2,-1,12,18,12,18,-16,8,78,37,5,4,7,3,72,21,-1,-4,5,1,6,16,6,8,2,2,330,234,96,227,195,32,92,59,81,28,5,62,97,34,51,18,1,26,-5,25,30,10,4,36,110,90,10,12,0,2,106,74,6,4,-1,4,4,16,4,8,1,-2,114,22,92,46,27,19,59,-37,39,39,-1,13,42,-55,16,17,-5,5,17,18,23,22,4,8,58,1,-17,5,-1,-1,52,-8,-9,-3,-3,-3,6,9,-8,8,2,2,-51,-62,11,-57,-41,-16,-11,-30,-24,2,7,2,-2,-48,-10,-2,-3,2,-9,18,-14,4,10,0,11,-17,-21,-15,-15,-1,20,-24,-16,-11,-11,0,-9,7,-5,-4,-4,-1,161,71,90,20,9,11,50,14,45,5,12,32,34,-2,25,-10,6,19,16,16,20,15,6,13,16,13,2,-9,-2,0,13,8,1,-12,1,-1,3,5,1,3,-3,1,141,107,34,102,73,29,32,28,32,30,-7,21,17,11,33,40,-2,4,15,17,-1,-10,-5,17,20,37,24,16,-1,3,18,27,14,10,1,1,2,10,10,6,-2,2,170,64,106,148,114,34,93,6,-20,19,43,31,68,-12,-15,-3,16,13,25,18,-5,22,27,18,91,44,-6,5,11,3,81,29,-1,-1,3,3,10,15,-5,6,8,0,182,57,125,172,115,57,51,-23,74,46,8,23,29,-34,44,13,4,3,22,11,30,33,4,20,80,21,52,12,2,2,69,12,29,5,-1,0,11,9,23,7,3,2
48,48011,Arrigorriaga,10531,60,43,17,21,6,15,2,3,86,-18,-11,-7,1,3,52,-13,-4,1,1,0,34,-5,-7,-8,5,5,7,2,0,0,3,1,2,0,0,0,2,4,5,2,0,0,415,221,194,27,15,12,47,55,238,61,10,0,24,25,122,38,5,4,23,30,116,23,5,-4,4,7,9,4,2,1,3,4,5,3,0,0,1,3,4,1,2,1,314,169,145,23,15,8,32,45,168,48,10,12,14,19,95,32,6,5,18,26,73,16,4,7,6,8,4,3,2,0,6,4,2,2,1,0,0,4,2,1,1,0,356,170,186,62,31,31,36,64,146,77,22,4,21,33,64,39,10,3,15,31,82,38,12,1,14,14,15,10,4,4,8,8,6,7,1,1,6,6,9,3,3,3,191,100,91,52,21,31,22,5,122,41,9,-13,21,-1,53,26,7,-9,1,6,69,15,2,-4,8,9,19,11,2,1,3,2,9,4,1,0,5,7,10,7,1,1,33,-11,44,34,16,18,-12,11,34,4,-6,-3,-10,-1,11,-4,-2,-6,-2,12,23,8,-4,3,9,19,2,-1,2,1,7,9,1,-1,0,0,2,10,1,0,2,1,50,18,32,69,29,40,17,58,-20,1,1,-8,11,33,-11,-6,-6,-2,6,25,-9,7,7,-6,13,26,16,9,2,1,9,8,6,4,1,0,4,18,10,5,1,1,-9,18,-27,83,50,33,-6,1,-1,-12,4,3,2,8,5,-6,3,2,-8,-7,-6,-6,1,1,15,13,34,14,6,-1,8,11,19,6,4,1,7,2,15,8,2,-2,6,-2,8,58,31,27,27,3,1,-27,3,-2,11,7,-2,-19,-1,-1,16,-4,3,-8,4,-1,8,16,20,6,6,1,6,9,12,3,0,1,2,7,8,3,6,0,-107,-50,-57,-5,-10,5,-18,-17,-45,-15,-6,-3,-8,-2,-20,-13,-4,-1,-10,-15,-25,-2,-2,-2,8,3,-19,5,-3,0,1,4,-12,-1,-3,0,7,-1,-7,6,0,0,100,36,64,33,9,24,23,15,26,-4,-3,44,9,11,19,1,-6,3,14,4,7,-5,3,41,6,11,6,8,4,-2,4,5,1,1,0,-2,2,6,5,7,4,0,-17,-44,27,-13,-21,8,7,19,-31,-14,-17,19,7,-10,-17,-18,-12,6,0,29,-14,4,-5,13,-5,11,-1,-12,-7,0,0,1,-6,-11,-5,0,-5,10,5,-1,-2,0,-118,-84,-34,-3,-9,6,-10,-19,-44,-36,-9,1,0,-13,-40,-15,-9,-5,-10,-6,-4,-21,0,6,2,1,-11,-2,6,1,2,-2,-10,1,0,0,0,3,-1,-3,6,1,-12,-13,1,-27,-16,-11,-9,-15,-23,-22,-6,63,-5,-10,-3,-17,1,20,-4,-5,-20,-5,-7,43,-5,-5,-1,-7,-7,-2,-1,-1,-3,-7,-4,0,-4,-4,2,0,-3,-2,3,3,0,6,3,3,-21,23,3,-20,-3,20,-10,7,17,3,-8,-6,-11,16,-14,-23,5,26,-5,7,3,-3,4,0,-4,4,3,-1,1,0,-1,3,0,-2,3,0,-44,-31,-13,18,9,9,-4,-29,2,-2,11,-9,-2,-18,-7,2,3,-3,-2,-11,9,-4,8,-6,3,2,3,6,2,1,3,0,3,2,1,0,0,2,0,4,1,1,29,-1,30,27,8,19,21,3,39,-5,-21,-14,3,7,24,-8,-16,-13,18,-4,15,3,-5,-1,5,5,13,2,1,-1,2,2,6,-1,-1,-1,3,3,7,3,2,0,22,3,19,28,17,11,-2,-1,20,-11,-3,13,-9,3,11,-3,-3,5,7,-4,9,-8,0,8,0,10,14,2,2,-2,3,4,9,1,0,0,-3,6,5,1,2,-2
48,48012,Bakio,1587,58,20,38,5,3,2,8,13,22,7,3,7,1,2,12,5,1,1,7,11,10,2,2,6,1,0,3,1,0,0,0,0,2,1,0,0,1,0,1,0,0,0,78,33,45,14,5,9,3,18,22,22,4,10,1,6,10,10,1,5,2,12,12,12,3,5,2,4,3,4,0,1,0,1,1,2,0,1,2,3,2,2,0,0,89,50,39,11,7,4,19,12,20,26,3,7,11,7,8,18,0,5,8,5,12,8,3,2,4,3,3,2,-1,0,3,2,1,1,0,0,1,1,2,1,-1,0,94,37,57,6,1,5,9,20,24,33,0,9,0,9,9,14,2,4,9,11,15,19,-2,5,0,2,2,2,0,0,0,1,0,0,0,0,0,1,2,2,0,0,86,59,27,15,7,8,9,19,-3,34,18,5,11,13,3,20,6,3,-2,6,-6,14,12,2,2,8,2,2,1,0,1,5,0,1,0,0,1,3,2,1,1,0,81,40,41,23,10,13,11,14,23,25,8,0,5,7,17,10,2,-1,6,7,6,15,6,1,3,9,6,2,2,0,1,4,3,0,1,0,2,5,3,2,1,0,71,38,33,17,5,12,14,12,22,5,12,5,9,8,8,-1,11,2,5,4,14,6,1,3,-1,8,6,1,3,0,-1,2,2,1,1,0,0,6,4,0,2,0,63,36,27,6,10,-4,12,9,-3,18,11,18,4,7,9,7,4,7,8,2,-12,11,7,11,-3,11,-1,0,0,0,-2,10,1,2,0,0,-1,1,-2,-2,0,0,30,21,9,11,8,3,-8,21,14,3,-1,2,-10,17,6,5,0,2,2,4,8,-2,-1,0,-1,7,1,2,1,1,0,6,2,0,0,0,-1,1,-1,2,1,1,144,63,81,11,4,7,34,11,43,33,25,-1,15,4,17,13,12,2,19,7,26,20,13,-3,4,4,0,2,1,0,2,2,-1,0,1,0,2,2,1,2,0,0,55,29,26,0,-1,1,5,3,21,26,2,0,1,-4,15,17,0,0,4,7,6,9,2,0,0,0,-1,0,1,0,0,-2,-1,1,1,0,0,2,0,-1,0,0,43,20,23,9,1,8,7,17,12,14,-1,-5,2,9,7,8,-2,-4,5,8,5,6,1,-1,2,8,2,-3,0,0,1,3,2,-4,-1,0,1,5,0,1,1,0,9,9,0,-1,1,-2,-3,-9,15,5,4,2,-2,-2,7,4,4,2,-1,-7,8,1,0,0,0,0,1,-3,-1,2,1,2,-1,-2,0,1,-1,-2,2,-1,-1,1,-31,-24,-7,-18,-12,-6,-9,-7,5,-7,-8,-5,-6,-5,2,-11,-1,-3,-3,-2,3,4,-7,-2,1,-4,-5,-3,-4,-3,0,-5,-2,-2,-1,-2,1,1,-3,-1,-3,-1,-29,-17,-12,-14,-12,-2,7,-2,-12,5,-17,-8,2,0,-8,6,-10,-5,5,-2,-4,-1,-7,-3,-1,-2,-4,-2,-5,0,-2,-2,-4,-2,-2,0,1,0,0,0,-3,0,6,0,6,1,-1,2,-12,4,4,-4,9,4,-6,-1,2,-4,5,3,-6,5,2,0,4,1,0,2,-1,-1,1,0,-1,0,0,0,0,0,1,2,-1,-1,1,0,23,15,8,4,0,4,11,12,8,8,-13,1,5,9,2,3,-6,4,6,3,6,5,-7,-3,-1,1,1,1,2,0,-1,0,0,1,0,0,0,1,1,0,2,0,1,-2,3,4,-2,6,-4,4,6,-1,-3,-1,-7,0,9,0,-2,-2,3,4,-3,-1,-1,1,-1,6,1,-2,-2,2,-2,2,2,-3,-1,0,1,4,-1,1,-1,2
48,48090,Balmaseda,7106,32,35,-3,7,2,5,-2,8,1,8,6,10,0,9,10,4,6,5,-2,-1,-9,4,0,5,1,0,2,1,0,3,1,0,0,0,0,1,0,0,2,1,0,2,64,27,37,27,14,13,13,21,24,7,-2,1,4,9,13,1,0,0,9,12,11,6,-2,1,8,5,10,4,0,0,2,4,6,2,0,0,6,1,4,2,0,0,2,-2,4,26,13,13,15,6,-2,-6,-11,0,7,-4,7,-4,-9,1,8,10,-9,-2,-2,-1,10,6,4,6,-1,1,6,4,2,2,-1,0,4,2,2,4,0,1,60,37,23,39,25,14,20,27,6,6,3,-3,17,16,-1,5,-1,0,3,11,7,1,4,-3,12,14,4,5,3,-1,10,6,2,4,2,0,2,8,2,1,1,-1,-9,-6,-3,15,9,6,-6,3,-17,3,0,9,-7,7,-8,0,0,3,1,-4,-9,3,0,6,5,4,2,3,0,1,3,4,-1,1,1,1,2,0,3,2,-1,0,-6,5,-11,45,26,19,13,5,-8,-17,-2,4,10,6,-7,-8,1,3,3,-1,-1,-9,-3,1,8,16,12,6,3,0,5,6,9,4,2,0,3,10,3,2,1,0,71,51,20,41,17,24,30,20,6,21,1,-8,15,8,9,11,3,1,15,12,-3,10,-2,-9,13,13,9,3,1,0,5,6,4,0,0,0,8,7,5,3,1,0,90,47,43,65,34,31,31,25,12,9,7,2,21,8,10,4,1,1,10,17,2,5,6,1,13,16,14,8,8,2,6,9,6,5,5,1,7,7,8,3,3,1,96,43,53,10,3,7,6,14,49,18,8,-1,6,13,13,9,0,0,0,1,36,9,8,-1,3,5,4,1,-3,-1,3,2,0,-1,-2,0,0,3,4,2,-1,-1,142,61,81,28,3,25,25,43,49,1,13,4,5,16,25,0,9,2,20,27,24,1,4,2,15,11,7,-4,-1,-1,5,3,0,-4,-1,0,10,8,7,0,0,-1,248,131,117,16,8,8,42,10,104,49,35,-2,34,0,48,30,18,-2,8,10,56,19,17,0,8,-2,3,5,2,0,6,-1,0,2,1,0,2,-1,3,3,1,0,143,85,58,52,26,26,46,18,30,33,5,1,26,14,17,25,-4,3,20,4,13,8,9,-2,17,13,7,10,2,1,8,5,0,10,1,0,9,8,7,0,1,1,103,54,49,4,0,4,48,25,-8,12,10,12,37,7,-3,-1,11,0,11,18,-5,13,-1,12,5,7,-9,-2,-3,4,2,3,-3,-5,-2,3,3,4,-6,3,-1,1,4,-3,7,-9,-3,-6,-10,-17,-7,17,11,9,-4,-5,-11,12,1,1,-6,-12,4,5,10,8,-1,-1,1,-4,-3,-1,1,-1,0,-2,-1,0,-2,0,1,-2,-2,-1,3,5,-2,-13,-14,1,14,22,-11,-12,-9,2,9,12,-1,-9,-5,0,5,10,-10,-3,-4,2,-10,11,-15,0,0,1,-6,3,-9,-1,0,-1,-4,8,-6,1,0,2,-105,-44,-61,-9,-10,1,-31,-8,-38,-23,1,-2,-20,-1,-15,-11,4,3,-11,-7,-23,-12,-3,-5,-4,3,-3,-4,-1,0,-2,-2,-1,-5,-1,1,-2,5,-2,1,0,-1,67,7,60,27,5,22,11,-5,7,10,19,30,-3,-10,7,3,8,6,14,5,0,7,11,24,2,6,11,2,2,3,0,-1,3,1,0,2,2,7,8,1,2,1,16,-9,25,24,7,17,-15,10,-8,7,9,10,-13,2,-6,1,4,0,-2,8,-2,6,5,10,-1,13,4,7,1,0,-2,5,0,4,1,-1,1,8,4,3,0,1
48,48013,Barakaldo,98212,-572,-276,-296,183,77,106,-49,-26,-201,-134,-114,-51,-31,16,-101,-74,-63,-23,-18,-42,-100,-60,-51,-28,29,47,56,31,11,7,10,24,17,19,4,2,19,23,39,12,7,5,-658,-297,-361,218,88,130,-44,-39,-298,-87,-95,-96,-17,9,-156,-43,-50,-35,-27,-48,-142,-44,-45,-61,37,57,79,31,7,2,16,19,31,16,4,1,21,38,48,15,3,1,-297,-123,-174,197,91,106,-42,76,-78,-116,-43,-104,-37,39,-5,-70,-7,-48,-5,37,-73,-46,-36,-56,45,54,52,29,12,2,21,25,23,14,6,1,24,29,29,15,6,1,602,283,319,285,126,159,94,187,260,92,-22,-19,39,120,113,37,-27,-7,55,67,147,55,5,-12,52,59,96,40,25,5,25,31,45,9,8,3,27,28,51,31,17,2,647,288,359,349,161,188,112,205,237,76,11,-9,42,110,96,31,4,0,70,95,141,45,7,-9,72,80,105,64,18,3,31,37,55,27,6,1,41,43,50,37,12,2,658,324,334,461,215,246,87,239,255,84,3,6,52,98,164,38,-15,2,35,141,91,46,18,4,109,133,123,79,11,0,56,56,63,32,5,2,53,77,60,47,6,-2,1163,530,633,509,192,317,245,293,541,137,12,-53,124,143,269,55,-11,-33,121,150,272,82,23,-20,147,171,117,44,22,3,76,66,34,8,6,0,71,105,83,36,16,3,1061,533,528,562,301,261,145,346,340,207,51,-19,78,166,160,115,17,-7,67,180,180,92,34,-12,109,191,147,79,20,13,66,82,96,42,9,3,43,109,51,37,11,10,1251,678,573,581,304,277,133,309,483,217,52,52,89,181,263,113,20,11,44,128,220,104,32,41,103,183,181,65,31,6,62,96,87,40,11,3,41,87,94,25,20,3,929,446,483,261,108,153,135,297,448,103,14,-51,70,133,232,45,-15,-14,65,164,216,58,29,-37,83,106,67,6,2,-5,39,48,18,4,-2,-1,44,58,49,2,4,-4,742,461,281,196,71,125,153,197,344,99,54,-101,70,130,227,46,25,-29,83,67,117,53,29,-72,78,74,60,-17,4,-9,34,47,13,-26,4,-5,44,27,47,9,0,-4,550,289,261,104,6,98,69,193,149,136,32,-3,60,88,63,63,15,6,9,105,86,73,17,-9,23,75,16,-14,1,1,15,16,-1,-24,-3,2,8,59,17,10,4,-1,305,118,187,-147,-169,22,59,93,67,79,-1,12,8,54,27,20,-8,11,51,39,40,59,7,1,46,-29,-99,-54,-19,-1,18,-40,-79,-59,-12,2,28,11,-20,5,-7,-3,-214,-180,-34,-299,-197,-102,4,-7,-23,-60,-36,-50,9,-18,-28,-74,-16,-31,-5,11,5,14,-20,-19,-20,-25,-119,-111,-26,-3,-15,-33,-63,-73,-12,-2,-5,8,-56,-38,-14,-1,524,193,331,114,-4,118,122,145,208,85,12,-25,69,58,60,23,-2,-5,53,87,148,62,14,-20,44,50,4,11,7,-3,23,5,-20,-5,-5,-3,21,45,24,16,12,0,62,-3,65,8,-28,36,14,120,-32,31,-19,-16,0,62,-39,16,-6,-11,14,58,7,15,-13,-5,38,16,-15,-36,-1,4,18,2,-17,-29,-4,1,20,14,2,-7,3,3,693,405,288,347,140,207,71,201,261,108,85,-3,50,80,219,28,41,-5,21,121,42,80,44,2,100,103,70,29,36,5,62,33,44,-12,11,-1,38,70,26,41,25,6,664,288,376,450,179,271,85,289,213,54,67,-5,36,148,75,16,23,7,49,141,138,38,44,-12,110,194,106,24,2,8,49,100,30,0,-2,0,61,94,76,24,4,8
48,48015,Basauri,47575,-429,-184,-245,79,40,39,-55,-47,-148,-112,-62,4,-22,-13,-54,-57,-34,-3,-33,-34,-94,-55,-28,7,13,15,25,11,9,3,5,6,12,8,6,1,8,9,13,3,3,2,-1042,-555,-487,7,3,4,-95,-143,-452,-177,-98,-73,-61,-69,-229,-105,-52,-38,-34,-74,-223,-72,-46,-35,5,0,1,0,1,0,2,0,0,0,1,0,3,0,1,0,0,0,-549,-259,-290,65,30,35,-37,-55,-271,-101,-56,-39,-24,-11,-126,-54,-29,-20,-13,-44,-145,-47,-27,-19,22,18,13,7,2,1,13,6,8,2,0,0,9,12,5,5,2,1,-501,-263,-238,127,59,68,-9,-16,-299,-73,-54,-38,4,-11,-158,-48,-26,-15,-13,-5,-141,-25,-28,-23,28,31,33,19,10,4,14,12,19,7,3,3,14,19,14,12,7,1,-589,-294,-295,138,75,63,-59,-33,-274,-94,-81,-31,-26,-5,-141,-44,-43,-25,-33,-28,-133,-50,-38,-6,36,32,37,24,5,0,21,18,19,13,2,0,15,14,18,11,3,0,-408,-213,-195,112,44,68,-14,-19,-191,-83,-38,-51,1,-7,-111,-41,-25,-22,-15,-12,-80,-42,-13,-29,23,29,29,18,8,1,9,17,8,6,3,0,14,12,21,12,5,1,-405,-214,-191,247,125,122,-21,10,-190,-85,-73,-43,-13,-16,-81,-54,-36,-15,-8,26,-109,-31,-37,-28,57,63,79,37,7,3,35,25,40,20,2,3,22,38,39,17,5,0,-231,-161,-70,169,90,79,-40,60,-127,-41,-22,-44,-23,21,-61,-54,-17,-23,-17,39,-66,13,-5,-21,25,57,48,19,15,3,17,29,28,8,4,1,8,28,20,11,11,2,-215,-117,-98,152,78,74,-18,24,-124,-24,-59,-21,-13,10,-52,-36,-22,-10,-5,14,-72,12,-37,-11,23,42,47,31,5,3,14,15,31,12,4,2,9,27,16,19,1,1,-136,-57,-79,72,15,57,9,59,-95,-67,-29,-18,7,52,-31,-46,-17,-20,2,7,-64,-21,-12,2,21,41,7,-3,2,1,13,12,-2,-11,1,-1,8,29,9,8,1,2,-204,-129,-75,85,30,55,8,66,-137,-55,-32,-44,4,32,-67,-51,-21,-22,4,34,-70,-4,-11,-22,21,53,10,-1,1,-1,4,26,8,-4,-4,-1,17,27,2,3,5,0,-92,-60,-32,117,55,62,31,19,-37,-64,-22,-27,16,14,-33,-35,-18,-11,15,5,-4,-29,-4,-16,39,22,43,10,2,-3,19,8,18,6,2,-1,20,14,25,4,0,-2,-44,-40,-4,41,19,22,17,13,-43,-10,0,-13,13,8,-44,6,-1,-16,4,5,1,-16,1,3,0,18,24,0,1,-2,4,13,9,-4,-3,0,-4,5,15,4,4,-2,-63,-34,-29,-48,-27,-21,35,27,-60,-3,-39,-33,24,7,-30,-9,-28,-6,11,20,-30,6,-11,-27,-8,1,-14,-18,-10,-2,-6,7,-13,-11,-6,-1,-2,-6,-1,-7,-4,-1,-173,-120,-53,3,-18,21,-7,31,-94,-46,-23,-30,-13,3,-48,-34,-8,-17,6,28,-46,-12,-15,-13,1,20,-4,-11,-6,1,-4,1,-5,-8,0,-2,5,19,1,-3,-6,3,-65,-16,-49,52,25,27,6,38,-56,-34,2,-19,18,22,-24,-23,2,-12,-12,16,-32,-11,0,-7,16,36,-16,13,-1,1,8,15,-10,7,2,0,8,21,-6,6,-3,1,78,10,68,96,33,63,12,48,7,-1,18,-7,-7,24,-6,-8,5,2,19,24,13,7,13,-9,19,26,17,21,7,4,9,12,-1,9,1,3,10,14,18,12,6,1,78,73,5,165,82,83,50,52,15,-12,22,-32,33,38,29,-25,16,-5,17,14,-14,13,6,-27,29,54,45,29,6,0,17,29,27,10,-1,0,12,25,18,19,7,0
48,48016,Berango,4823,119,61,58,12,3,9,10,12,62,31,5,-7,9,0,32,15,3,0,1,12,30,16,2,-7,1,3,2,5,0,0,0,1,0,2,0,0,1,2,2,3,0,0,241,123,118,31,13,18,61,21,82,46,13,17,34,11,38,29,5,6,27,10,44,17,8,11,6,7,8,6,4,0,4,2,2,4,1,0,2,5,6,2,3,0,303,157,146,48,25,23,44,35,116,69,27,11,17,26,60,31,18,2,27,9,56,38,9,9,15,8,7,12,5,1,10,3,3,6,3,0,5,5,4,6,2,1,206,107,99,44,23,21,45,14,90,24,14,17,27,10,44,15,4,7,18,4,46,9,10,10,17,11,11,1,3,1,11,4,6,-1,2,1,6,7,5,2,1,0,10,-10,20,35,5,30,13,2,15,-6,-3,-10,-4,8,-3,-8,2,-5,17,-6,18,2,-5,-5,4,10,13,4,4,0,-1,2,2,1,1,0,5,8,11,3,3,0,44,5,39,22,7,15,17,7,13,3,-2,3,15,-8,2,-3,-2,3,2,15,11,6,0,0,4,7,5,6,0,0,3,1,0,3,0,0,1,6,5,3,0,0,238,94,144,75,21,54,41,35,90,56,19,-3,17,13,30,30,6,0,24,22,60,26,13,-3,7,22,35,7,3,1,4,5,10,1,1,0,3,17,25,6,2,1,105,35,70,67,20,47,8,21,47,14,-2,6,0,3,17,9,-2,4,8,18,30,5,0,2,10,25,19,6,6,1,4,3,9,1,2,1,6,22,10,5,4,0,123,51,72,38,12,26,28,18,43,27,1,0,8,6,19,19,-1,-1,20,12,24,8,2,1,8,8,13,5,3,0,0,3,5,3,1,0,8,5,8,2,2,0,69,24,45,31,12,19,6,15,27,14,3,-1,9,3,5,6,2,-1,-3,12,22,8,1,0,-3,13,12,7,1,0,1,3,6,1,1,0,-4,10,6,6,0,0,25,18,7,6,-3,9,1,11,-4,4,4,6,-8,8,4,1,4,7,9,3,-8,3,0,-1,0,6,-2,-2,2,1,-1,4,-4,-2,0,0,1,2,2,0,2,1,39,14,25,26,10,16,8,5,-10,20,2,7,1,3,-7,5,4,3,7,2,-3,15,-2,4,3,14,9,2,-1,-1,1,7,2,1,-1,0,2,7,7,1,0,-1,41,31,10,29,11,18,27,-4,13,7,-3,-2,17,-6,13,6,-1,0,10,2,0,1,-2,-2,9,4,8,2,3,1,4,2,2,0,2,0,5,2,6,2,1,1,-41,-12,-29,-23,-8,-15,-16,-9,-16,-13,7,8,3,-6,-2,-8,8,-2,-19,-3,-14,-5,-1,10,2,-4,-11,-3,-5,-3,2,-2,-6,-1,0,-2,0,-2,-5,-2,-5,-1,17,-18,35,-5,-6,1,5,1,-8,7,2,6,-3,-3,-6,-7,-2,2,8,4,-2,14,4,4,-5,3,1,0,-3,-1,-4,1,1,-2,-1,-1,-1,2,0,2,-2,0,-15,-9,-6,-10,-3,-7,19,-1,-31,1,-11,5,13,-1,-9,-6,-9,3,6,0,-22,7,-2,2,-5,0,0,-4,-1,0,-3,-1,3,-1,-1,0,-2,1,-3,-3,0,0,83,40,43,23,11,12,27,6,36,19,-9,-3,13,-2,15,19,-5,-3,14,8,21,0,-4,0,6,3,8,5,1,0,3,1,5,1,1,0,3,2,3,4,0,0,60,28,32,17,6,11,28,13,17,9,5,-14,18,5,3,2,4,-5,10,8,14,7,1,-9,1,8,7,-2,1,0,1,4,1,-3,1,1,0,4,6,1,0,-1
48,48017,Bermeo,17011,-50,-26,-24,26,10,16,7,-13,-23,-8,-7,-6,2,-15,-9,-3,-3,2,5,2,-14,-5,-4,-8,6,2,5,6,2,5,2,0,1,1,1,5,4,2,4,5,1,0,71,49,22,68,39,29,3,7,12,30,7,9,3,0,15,15,9,5,0,7,-3,15,-2,4,11,9,18,21,5,1,6,3,13,13,2,1,5,6,5,8,3,0,48,29,19,95,35,60,15,25,19,-10,8,-7,8,11,18,-11,2,3,7,14,1,1,6,-10,13,27,32,21,2,0,4,13,16,5,-2,-1,9,14,16,16,4,1,62,38,24,108,54,54,8,11,38,10,1,-3,-1,7,27,4,1,2,9,4,11,6,0,-5,18,19,39,24,5,3,8,6,23,12,3,2,10,13,16,12,2,1,38,32,6,128,65,63,21,15,5,3,-12,13,9,8,12,5,-8,10,12,7,-7,-2,-4,3,27,25,46,25,2,1,14,9,22,17,1,2,13,16,24,8,1,-1,43,32,11,162,85,77,30,26,-6,2,0,-10,8,23,-12,10,5,-1,22,3,6,-8,-5,-9,33,47,41,25,11,2,14,29,17,14,8,2,19,18,24,11,3,0,67,24,43,179,81,98,42,40,20,-16,8,-26,11,21,10,-8,3,-14,31,19,10,-8,5,-12,56,50,41,24,7,0,21,23,21,14,1,0,35,27,20,10,6,0,96,64,32,169,83,86,20,45,19,22,-3,-5,19,16,12,14,2,1,1,29,7,8,-5,-6,36,46,55,24,5,2,23,15,31,9,4,0,13,31,24,15,1,2,22,14,8,22,21,1,15,8,1,-3,8,-6,14,8,1,-6,2,-4,1,0,0,3,6,-2,12,11,4,-1,-1,-2,9,7,5,0,1,-1,3,4,-1,-1,-2,-1,106,47,59,48,23,25,23,26,43,6,6,-3,18,7,26,-7,-6,2,5,19,17,13,12,-5,17,15,8,2,8,-2,13,2,4,1,4,-1,4,13,4,1,4,-1,152,86,66,31,14,17,29,21,39,31,24,4,18,9,19,19,10,7,11,12,20,12,14,-3,10,12,0,5,3,1,6,4,-1,0,2,2,4,8,1,5,1,-1,133,118,15,47,23,24,8,40,54,32,11,-17,15,21,49,34,-1,-2,-7,19,5,-2,12,-15,1,30,11,-6,7,2,2,15,4,-2,2,2,-1,15,7,-4,5,0,53,35,18,-13,-24,11,20,2,22,21,-17,9,10,-2,13,23,-9,3,10,4,9,-2,-8,6,23,-4,-14,-6,-12,-1,9,-8,-12,-5,-7,-1,14,4,-2,-1,-5,0,-77,-41,-36,-49,-37,-12,-39,-6,-4,-31,-2,8,-26,-8,15,-16,-9,5,-13,2,-19,-15,7,3,-15,-2,-15,-8,-6,-2,-9,-1,-13,-4,-8,-1,-6,-1,-2,-4,2,-1,-78,-31,-47,-10,-1,-9,-36,4,-15,-19,-14,5,-19,12,-6,-14,0,1,-17,-8,-9,-5,-14,4,0,7,-9,-3,-4,-2,1,7,-4,-1,-2,-2,-1,0,-5,-2,-2,0,1,-6,7,14,4,10,14,17,5,-15,-11,-4,10,11,-1,-16,-8,-2,4,6,6,1,-3,-2,1,12,13,-7,-11,4,1,5,7,-7,-5,1,0,7,6,0,-6,3,30,8,22,55,21,34,8,10,17,-7,-2,9,-6,7,12,-14,2,8,14,3,5,7,-4,1,12,16,18,9,-3,5,7,12,6,-2,-3,3,5,4,12,11,0,2,77,71,6,92,54,38,16,34,-3,25,-3,7,18,22,5,18,-1,8,-2,12,-8,7,-2,-1,15,41,24,13,-6,3,10,25,16,2,-2,1,5,16,8,11,-4,2
48,48019,Berriz,4123,83,47,36,12,4,8,-2,22,44,12,3,2,1,9,30,7,1,-2,-3,13,14,5,2,4,1,5,2,0,1,3,1,1,2,0,0,0,0,4,0,0,1,3,93,51,42,4,1,3,8,17,61,8,-5,1,0,13,37,4,-3,-1,8,4,24,4,-2,2,0,1,2,0,0,1,0,0,1,0,0,0,0,1,1,0,0,1,132,64,68,25,9,16,11,25,75,12,1,6,7,11,42,8,-2,-2,4,14,33,4,3,8,7,3,6,3,5,1,5,0,3,0,1,0,2,3,3,3,4,1,33,18,15,10,5,5,-11,17,33,-4,5,-5,-8,11,16,-3,3,-1,-3,6,17,-1,2,-4,0,4,1,2,0,2,0,3,0,0,0,1,0,1,1,2,0,1,43,26,17,27,13,14,-1,17,22,0,-2,10,4,10,12,2,-3,2,-5,7,10,-2,1,8,3,4,11,6,1,2,2,2,4,4,0,1,1,2,7,2,1,1,127,62,65,59,20,39,19,49,57,-5,3,4,6,27,35,-3,1,-2,13,22,22,-2,2,6,16,21,10,6,3,0,6,7,3,2,2,-1,10,14,7,4,1,1,59,11,48,37,16,21,8,11,24,20,-6,-2,0,3,4,10,-6,-3,8,8,20,10,0,1,5,9,13,5,1,4,4,4,4,3,1,0,1,5,9,2,0,4,47,17,30,26,10,16,22,12,5,-1,5,3,9,7,5,-4,1,0,13,5,0,3,4,3,4,5,9,5,-1,2,3,3,3,1,-1,1,1,2,6,4,0,1,50,30,20,36,23,13,13,5,7,9,3,14,11,4,6,10,-2,4,2,1,1,-1,5,10,10,7,9,7,2,1,8,3,5,6,0,1,2,4,4,1,2,0,-40,-24,-16,10,7,3,-8,2,-23,-13,-5,5,-6,5,-8,-12,-2,-3,-2,-3,-15,-1,-3,8,1,3,2,-4,2,4,1,0,5,-1,1,0,0,3,-3,-3,1,4,-16,-13,-3,-1,-2,1,-8,18,-4,-8,-12,0,-7,9,2,-6,-8,-3,-1,9,-6,-2,-4,3,-4,5,1,-4,0,0,-4,1,2,0,-1,0,0,4,-1,-4,1,0,-1,-1,0,20,6,14,14,-11,0,-4,-1,3,6,-5,1,-1,0,1,8,-6,-1,-3,-1,2,10,0,4,3,2,-1,3,-2,4,0,1,0,7,2,0,3,1,-1,-46,-31,-15,-10,-13,3,-19,-15,-1,-9,-10,8,-14,-13,-2,-3,-4,5,-5,-2,1,-6,-6,3,-7,-1,-1,-1,-1,-1,-5,-2,-4,-2,-1,0,-2,1,3,1,0,-1,-30,-19,-11,4,0,4,-8,9,-19,-7,-5,3,-3,6,-6,-7,-3,-4,-5,3,-13,0,-2,7,0,8,-3,-1,-3,2,0,2,0,-2,0,0,0,6,-3,1,-3,2,-2,-11,9,2,0,2,5,8,-11,-2,-3,0,1,4,-11,-6,1,2,4,4,0,4,-4,-2,-2,4,0,0,-1,1,-1,4,-2,-1,0,0,-1,0,2,1,-1,1,-78,-35,-43,-36,-14,-22,-15,-5,-14,-34,-6,-1,-7,-2,-2,-13,-4,-4,-8,-3,-12,-21,-2,3,-10,-3,-14,-8,0,-1,-3,1,-8,-3,0,-1,-7,-4,-6,-5,0,0,-21,-13,-8,13,7,6,-1,6,-17,3,-9,-2,2,3,-12,3,-5,-3,-3,3,-5,0,-4,1,2,6,4,4,-2,-1,4,4,0,2,-2,-1,-2,2,4,2,0,0,10,12,-2,22,10,12,-3,11,5,-3,-1,1,2,6,2,5,-1,-1,-5,5,3,-8,0,2,6,5,10,0,0,0,4,2,4,1,-1,0,2,3,6,-1,1,0
48,48020,Bilbao,357589,180,-50,230,2502,1165,1337,31,343,75,76,-181,-121,17,150,-13,14,-130,-62,14,193,88,62,-51,-59,334,588,961,428,122,50,174,257,456,206,44,20,160,331,505,222,78,30,1475,665,810,3026,1416,1610,331,661,361,294,-141,-36,179,327,201,81,-88,-41,152,334,160,213,-53,5,552,757,1002,530,111,49,284,316,492,247,42,23,268,441,510,283,69,26,481,310,171,2328,1139,1189,372,611,1,-4,-224,-235,183,350,81,-51,-123,-112,189,261,-80,47,-101,-123,474,599,698,382,110,42,229,292,377,170,43,17,245,307,321,212,67,25,1051,499,552,2724,1276,1448,269,870,253,47,-140,-236,139,404,97,30,-86,-81,130,466,156,17,-54,-155,503,751,876,395,122,49,253,333,420,178,59,20,250,418,456,217,63,29,921,399,522,2829,1351,1478,302,686,361,0,-187,-229,130,354,175,-13,-129,-105,172,332,186,13,-58,-124,520,756,948,403,113,55,251,378,460,200,31,14,269,378,488,203,82,41,1356,602,754,3110,1421,1689,393,808,333,141,-72,-215,169,435,154,-5,-58,-82,224,373,179,146,-14,-133,662,846,934,498,115,27,294,402,452,222,32,8,368,444,482,276,83,19,1021,180,841,3687,1684,2003,400,946,46,54,-224,-172,182,391,-59,-89,-144,-84,218,555,105,143,-80,-88,729,1083,1074,583,138,47,365,479,513,243,47,20,364,604,561,340,91,27,605,312,293,3184,1601,1583,321,784,-55,-121,-157,-134,141,453,68,-133,-134,-55,180,331,-123,12,-23,-79,645,1026,946,383,106,36,332,518,523,151,39,15,313,508,423,232,67,21,2272,1393,879,3243,1792,1451,241,1163,824,199,46,-168,135,668,562,116,-23,-53,106,495,262,83,69,-115,435,1027,1180,462,102,25,220,554,706,242,47,13,215,473,474,220,55,12,272,155,117,944,301,643,195,724,-67,-107,-156,-292,98,408,-42,-99,-100,-92,97,316,-25,-8,-56,-200,275,569,163,-58,-32,-4,140,287,15,-117,-38,-3,135,282,148,59,6,-1,188,165,23,1264,581,683,136,604,2,-8,-199,-287,68,291,17,25,-114,-97,68,313,-15,-33,-85,-190,235,554,337,77,5,28,138,243,157,27,-10,9,97,311,180,50,15,19,562,170,392,442,54,388,192,491,177,-49,-106,-119,101,228,37,-63,-84,-31,91,263,140,14,-22,-88,199,378,18,-137,-32,-14,103,161,-65,-145,-26,2,96,217,83,8,-6,-16,-445,-403,-42,-174,-267,93,-43,334,-325,-335,0,-105,13,120,-216,-261,-47,-37,-56,214,-109,-74,47,-68,106,187,-206,-210,-58,-21,63,45,-135,-189,-55,-13,43,142,-71,-21,-3,-8,-804,-468,-336,-863,-572,-291,-234,260,-228,-489,-99,-76,-125,95,-101,-290,-44,-30,-109,165,-127,-199,-55,-46,-101,22,-349,-352,-110,-2,-61,-33,-199,-245,-53,-1,-40,55,-150,-107,-57,-1,837,270,567,462,119,343,54,542,215,57,22,-153,2,215,99,-49,-12,-44,52,327,116,106,34,-109,148,287,80,-86,-4,10,82,112,-18,-89,4,11,66,175,98,3,-8,-1,1423,790,633,260,87,173,84,671,555,158,-2,-177,60,334,349,80,-45,-52,24,337,206,78,43,-125,157,367,-34,-168,-61,-44,97,164,-36,-88,-49,-19,60,203,2,-80,-12,-25,1929,788,1141,1393,532,861,282,844,398,186,89,12,179,375,89,53,9,33,103,469,309,133,80,-21,319,556,353,7,67,41,176,243,116,-64,16,19,143,313,237,71,51,22,3108,1448,1660,2374,1018,1356,435,1073,867,380,211,3,237,522,455,66,81,16,198,551,412,314,130,-13,453,777,647,293,149,10,243,352,288,57,59,-1,210,425,359,236,90,11
48,48901,Derio,4609,68,39,29,11,8,3,4,13,26,11,5,3,1,11,7,9,3,5,3,2,19,2,2,-2,0,6,3,1,0,1,0,5,2,1,0,0,0,1,1,0,0,1,71,23,48,20,6,14,9,7,27,8,9,8,5,3,2,8,1,2,4,4,25,0,8,6,5,5,6,3,0,0,3,1,1,1,0,0,2,4,5,2,0,0,68,36,32,30,19,11,10,5,24,14,10,5,6,1,18,7,5,0,4,4,6,7,5,5,3,5,11,7,3,0,2,4,8,4,1,0,1,1,3,3,2,0,-36,-20,-16,18,10,8,-2,5,-15,-21,-9,6,-4,5,-8,-11,-1,-1,2,0,-7,-10,-8,7,4,3,10,1,0,0,1,0,8,1,0,0,3,3,2,0,0,0,102,51,51,37,28,9,23,17,18,27,3,8,13,8,6,16,5,0,10,9,12,11,-2,8,6,2,10,13,5,0,3,1,6,12,5,0,3,1,4,1,0,0,74,41,33,15,3,12,11,5,36,22,-9,8,13,5,20,8,-8,2,-2,0,16,14,-1,6,6,11,5,-2,-6,0,5,5,3,-5,-6,0,1,6,2,3,0,0,69,38,31,36,26,10,25,16,13,4,-4,13,8,9,19,4,-5,2,17,7,-6,0,1,11,8,12,12,4,0,0,5,9,10,2,0,0,3,3,2,2,0,0,61,27,34,11,7,4,9,6,30,4,8,3,6,4,14,0,3,0,3,2,16,4,5,3,3,2,-1,6,1,0,2,4,-2,3,0,0,1,-2,1,3,1,0,25,5,20,19,6,13,10,2,8,6,-12,10,8,-9,-1,6,-4,5,2,11,9,0,-8,5,3,-1,11,6,0,0,4,-5,4,3,0,0,-1,4,7,3,0,0,44,1,43,22,11,11,15,15,6,4,-6,12,2,2,-11,9,-4,2,13,13,17,-5,-2,10,10,4,5,3,0,0,5,2,2,2,0,0,5,2,3,1,0,0,79,35,44,13,2,11,24,21,31,17,-1,-10,11,10,15,6,-2,-3,13,11,16,11,1,-7,3,9,4,-4,1,0,2,3,0,-4,1,0,1,6,4,0,0,0,146,81,65,4,3,1,26,3,81,20,13,-2,19,-2,41,13,7,0,7,5,40,7,6,-2,4,0,2,-2,0,0,4,-2,3,-2,0,0,0,2,-1,0,0,0,171,64,107,-22,-18,-4,12,7,129,9,6,3,1,-1,55,7,1,0,11,8,74,2,5,3,2,-2,-5,-14,-2,0,0,-2,-5,-8,-2,0,2,0,0,-6,0,0,77,31,46,-27,-20,-7,0,12,40,25,-4,2,-4,6,32,4,-5,-3,4,6,8,21,1,5,-7,-4,-7,-2,-6,0,-6,-2,-4,-3,-3,-1,-1,-2,-3,1,-3,1,74,38,36,-25,-12,-13,0,22,18,17,19,3,0,9,8,13,10,-1,0,13,10,4,9,4,-6,-2,-12,-5,0,1,-6,-1,-2,-1,-2,0,0,-1,-10,-4,2,1,73,31,42,8,-1,9,14,3,26,29,-3,6,-4,4,21,7,2,2,18,-1,5,22,-5,4,4,2,2,-4,3,1,2,1,0,-4,0,0,2,1,2,0,3,1,223,130,93,19,7,12,42,15,85,57,21,-4,27,3,49,40,11,0,15,12,36,17,10,-4,5,5,7,-2,0,3,2,1,5,-1,-1,1,3,4,2,-1,1,2,115,60,55,35,22,13,15,13,31,36,24,-1,6,4,23,18,11,-1,9,9,8,18,13,0,6,3,6,11,8,1,3,2,1,9,6,1,3,1,5,2,2,0
48,48027,Durango,24515,280,123,157,42,16,26,30,50,141,18,14,18,17,13,70,12,-1,6,13,37,71,6,15,12,8,8,11,6,3,4,4,3,3,2,1,1,4,5,8,4,2,3,179,72,107,91,44,47,40,24,93,-2,-6,26,21,9,48,-9,-7,8,19,15,45,7,1,18,21,15,31,9,9,2,8,7,16,5,5,1,13,8,15,4,4,1,290,149,141,116,56,60,53,71,95,59,-5,13,24,48,48,22,-4,4,29,23,47,37,-1,9,28,32,35,11,1,4,11,19,17,3,0,1,17,13,18,8,1,3,226,145,81,80,40,40,44,30,95,46,1,6,28,14,66,28,-7,10,16,16,29,18,8,-4,19,21,13,20,5,2,10,10,11,9,0,0,9,11,2,11,5,2,318,162,156,154,69,85,56,42,142,57,12,8,23,20,70,45,3,6,33,22,72,12,9,2,34,31,41,34,9,4,18,13,10,20,5,2,16,18,31,14,4,2,446,180,266,189,69,120,74,79,189,81,1,15,30,27,94,33,-11,2,44,52,95,48,12,13,49,57,64,17,4,-5,18,19,32,3,-3,-2,31,38,32,14,7,-3,402,198,204,263,115,148,47,98,157,64,4,31,33,39,86,28,4,8,14,59,71,36,0,23,46,84,82,35,11,0,22,33,38,13,8,-1,24,51,44,22,3,1,268,195,73,211,95,116,40,106,72,40,-25,27,22,65,66,30,-8,13,18,41,6,10,-17,14,43,95,57,17,-1,-3,21,43,27,5,-1,0,22,52,30,12,0,-3,217,123,94,179,101,78,42,39,66,38,-4,31,12,16,55,24,5,14,30,23,11,14,-9,17,31,39,60,29,10,4,19,21,35,17,6,1,12,18,25,12,4,3,-16,-34,18,-12,-29,17,-1,32,-70,-19,14,31,-2,20,-66,-9,12,14,1,12,-4,-10,2,17,22,22,-47,-14,4,-2,8,18,-48,-11,1,0,14,4,1,-3,3,-2,1,29,-28,-36,-10,-26,18,-12,21,-3,-30,4,19,7,14,8,-19,-3,-1,-19,7,-11,-11,7,9,1,-31,-21,3,1,12,4,-11,-16,-1,0,-3,-3,-20,-5,4,1,250,144,106,107,49,58,41,42,85,60,15,-2,20,30,43,44,6,-7,21,12,42,16,9,5,21,38,24,17,1,1,13,16,15,4,-4,0,8,22,9,13,5,1,96,49,47,-34,-26,-8,23,19,23,3,2,19,16,14,-1,-1,2,17,7,5,24,4,0,2,-3,14,-21,-11,-15,-2,-4,5,-17,-6,-7,0,1,9,-4,-5,-8,-2,48,-41,89,-84,-80,-4,29,11,16,-11,-28,28,15,7,-17,-42,-23,15,14,4,33,31,-5,13,-2,4,-45,-32,-14,4,1,-2,-43,-30,-12,5,-3,6,-2,-2,-2,-1,115,69,46,55,49,6,33,36,58,9,-19,2,14,16,42,9,-7,-8,19,20,16,0,-12,10,28,30,-2,-1,-1,0,17,20,12,1,1,-2,11,10,-14,-2,-2,2,103,38,65,39,29,10,-8,17,30,42,17,-3,-6,3,14,31,1,-7,-2,14,16,11,16,4,-5,31,21,-7,3,-4,-3,12,18,1,1,0,-2,19,3,-8,2,-4,368,161,207,94,20,74,48,65,106,64,28,48,6,38,43,38,15,17,42,27,63,26,13,31,24,40,12,8,8,2,1,20,-9,2,5,1,23,20,21,6,3,1,346,144,202,202,101,101,84,65,60,78,19,47,33,34,20,45,4,15,51,31,40,33,15,32,53,45,51,46,9,-3,20,25,23,32,2,-1,33,20,28,14,7,-2
48,48032,Elorrio,7233,20,-4,24,13,5,8,3,8,12,-4,1,1,-1,6,1,-5,-1,-4,4,2,11,1,2,5,4,4,4,1,0,0,0,3,1,1,0,0,4,1,3,0,0,0,24,22,2,15,7,8,10,-3,13,10,-5,-1,7,-1,9,12,-4,-1,3,-2,4,-2,-1,0,3,1,6,4,1,0,2,0,2,3,0,0,1,1,4,1,1,0,-4,2,-6,14,9,5,9,-6,-13,4,-6,7,5,-3,0,1,-5,4,4,-3,-13,3,-1,3,3,4,4,3,-1,1,2,3,2,1,0,1,1,1,2,2,-1,0,-39,-3,-36,13,10,3,-3,-2,-29,-7,-8,10,1,4,-5,-1,-3,1,-4,-6,-24,-6,-5,9,4,3,6,0,0,0,2,4,4,0,0,0,2,-1,2,0,0,0,-5,-14,9,34,15,19,11,-10,-18,2,-1,9,9,-10,-13,0,-1,0,2,0,-5,2,0,9,7,12,13,1,1,0,5,2,7,1,0,0,2,10,6,0,1,0,46,20,26,31,16,15,30,-4,8,14,-11,6,17,-6,5,7,-7,2,13,2,3,7,-4,4,10,7,13,1,0,-1,7,3,6,1,0,-1,3,4,7,0,0,0,-1,-6,5,34,13,21,3,-3,-4,7,-5,0,-1,-1,-11,7,-1,2,4,-2,7,0,-4,-2,7,9,11,4,2,1,2,4,4,2,1,0,5,5,7,2,1,1,85,44,41,39,21,18,30,15,29,16,3,-12,10,8,15,10,1,-3,20,7,14,6,2,-9,8,9,13,6,1,1,3,6,6,4,1,1,5,3,7,2,0,0,60,26,34,11,3,8,16,10,12,9,2,7,8,0,9,6,0,-1,8,10,3,3,2,8,5,3,-3,6,-1,1,1,2,-1,2,-1,0,4,1,-2,4,0,1,41,16,25,7,5,2,9,9,18,10,-3,-3,5,1,9,9,-4,-4,4,8,9,1,1,1,3,4,0,-4,3,1,-1,2,3,0,1,0,4,2,-3,-4,2,1,37,20,17,13,1,12,-4,16,6,0,4,12,-2,8,9,-2,2,3,-2,8,-3,2,2,9,1,3,3,3,1,2,1,-1,-2,1,1,1,0,4,5,2,0,1,34,27,7,20,17,3,11,16,7,-1,-4,2,3,8,14,-4,-2,5,8,8,-7,3,-2,-3,9,5,2,4,0,-2,4,3,4,5,0,-1,5,2,-2,-1,0,-1,33,6,27,-2,-6,4,0,16,-3,2,7,13,2,5,-4,-1,3,2,-2,11,1,3,4,11,0,6,-1,-4,-2,-1,0,1,0,-5,-2,0,0,5,-1,1,0,-1,-18,7,-25,1,3,-2,-9,-10,11,-9,-7,8,-3,-4,10,5,-5,4,-6,-6,1,-14,-2,4,6,-1,1,-1,-3,0,3,2,1,-1,-2,0,3,-3,0,0,-1,0,57,45,12,18,5,13,28,12,17,18,-9,-7,17,7,13,9,-6,5,11,5,4,9,-3,-12,8,2,4,5,-1,0,6,-3,1,1,0,0,2,5,3,4,-1,0,66,38,28,20,10,10,28,2,9,12,6,6,15,1,4,11,3,4,13,1,5,1,3,2,11,3,1,3,1,0,7,-1,0,3,0,0,4,4,1,0,1,0,29,11,18,31,16,15,0,16,9,4,-2,0,1,4,9,-1,0,-4,-1,12,0,5,-2,4,3,8,12,5,2,-1,1,3,8,2,1,-1,2,5,4,3,1,0,47,14,33,31,8,23,7,10,25,-2,4,3,0,8,4,-2,2,1,7,2,21,0,2,2,6,13,8,1,2,1,4,5,-1,-2,2,0,2,8,9,3,0,1
48,48902,Erandio,23207,-110,-30,-80,74,37,37,-21,-27,-26,-10,-25,1,-3,0,-11,-2,-17,3,-18,-27,-15,-8,-8,-2,13,13,38,7,1,1,6,7,22,1,0,1,7,6,16,6,1,0,15,21,-6,85,50,35,6,11,37,-16,-17,-6,9,5,17,-2,-9,2,-3,6,20,-14,-8,-8,17,17,32,12,4,2,11,7,20,8,2,2,6,10,12,4,2,0,158,70,88,132,71,61,12,46,97,27,-26,6,4,24,43,21,-17,-2,8,22,54,6,-9,8,34,30,36,25,4,2,18,19,17,14,2,0,16,11,19,11,2,2,238,78,160,122,55,67,-23,49,126,-15,3,98,-16,12,74,-7,-3,18,-7,37,52,-8,6,80,22,40,39,16,5,-1,11,18,18,6,3,-1,11,22,21,10,2,0,295,134,161,143,63,80,20,48,116,36,3,74,0,17,65,21,-2,31,20,31,51,15,5,43,35,34,43,21,8,1,14,14,17,11,5,1,21,20,26,10,3,0,323,171,152,199,104,95,56,74,107,55,-2,30,38,51,39,42,-2,5,18,23,68,13,0,25,51,50,64,16,14,1,29,25,33,12,4,1,22,25,31,4,10,0,323,140,183,217,95,122,104,92,71,40,0,19,53,34,28,31,-5,4,51,58,43,9,5,15,60,85,43,23,3,-1,28,37,19,7,1,1,32,48,24,16,2,-2,17,-23,40,204,98,106,17,51,-28,1,-7,-18,13,17,-34,-15,-4,0,4,34,6,16,-3,-18,46,55,51,37,9,3,23,23,26,20,3,2,23,32,25,17,6,1,208,95,113,146,73,73,61,31,43,42,-4,27,27,24,29,19,-5,-4,34,7,14,23,1,31,18,52,50,16,10,-2,9,25,22,10,5,0,9,27,28,6,5,-2,-13,10,-23,-5,3,-8,-10,23,-6,-10,-36,23,-7,18,9,-3,-9,-1,-3,5,-15,-7,-27,24,7,20,-17,-16,0,0,9,10,-11,-7,2,0,-2,10,-6,-9,-2,0,-53,-47,-6,1,-6,7,-32,36,-34,-18,-16,7,-22,24,-12,-15,-17,-7,-10,12,-22,-3,1,14,7,15,-15,-10,3,-1,6,7,-10,-7,-1,-2,1,8,-5,-3,4,1,44,-3,47,18,9,9,-13,13,31,-4,17,0,-8,2,3,-16,10,3,-5,11,28,12,7,-3,-1,10,9,-2,2,0,1,4,1,-2,1,1,-2,6,8,0,1,-1,105,80,25,-11,-11,0,11,11,24,58,22,-17,13,16,17,27,14,-7,-2,-5,7,31,8,-10,8,3,-3,-7,-11,-2,5,-5,0,-9,-1,-1,3,8,-3,2,-10,-1,-119,-68,-51,-76,-53,-23,-23,19,-42,-39,-8,-19,-4,6,-8,-34,-7,-16,-19,13,-34,-5,-1,-3,-10,-6,-28,-24,-10,0,-5,-9,-23,-12,-4,-1,-5,3,-5,-12,-6,1,6,9,-3,4,-15,19,7,11,25,23,-18,-25,6,-1,7,28,-17,-6,1,12,18,-5,-1,-19,20,5,-14,1,-7,-1,8,1,-15,-1,-7,-1,12,4,1,2,0,0,54,20,34,44,16,28,29,17,20,0,-22,17,12,5,10,3,-11,3,17,12,10,-3,-11,14,10,14,7,4,5,2,2,6,8,-4,2,1,8,8,-1,8,3,1,-122,-98,-24,61,22,39,-49,24,-27,-67,-18,12,-19,-8,-26,-37,-17,9,-30,32,-1,-30,-1,3,9,26,12,11,-5,5,6,16,1,3,-6,2,3,10,11,8,1,3,217,71,146,157,65,92,28,79,42,39,42,-15,-4,30,5,38,8,-9,32,49,37,1,34,-6,24,50,49,21,9,2,9,20,26,8,0,1,15,30,23,13,9,1
48,48034,Ermua,17260,-182,-83,-99,80,57,23,-26,-20,-85,-19,-30,-3,-14,2,-41,-9,-17,-5,-12,-22,-44,-10,-13,2,15,18,30,13,2,0,10,15,19,10,1,0,5,3,11,3,1,0,-171,-87,-84,65,40,25,-10,-17,-71,-30,-37,-10,-7,4,-42,-15,-22,-7,-3,-21,-29,-15,-15,-3,12,19,23,7,4,0,6,16,14,3,1,0,6,3,9,4,3,0,-200,-107,-93,35,19,16,-6,-19,-89,-16,-55,-14,-6,-5,-49,-9,-32,-5,0,-14,-40,-7,-23,-9,6,10,8,7,3,0,3,6,5,3,0,1,3,4,3,4,3,-1,-140,-73,-67,51,27,24,-12,13,-75,-13,-32,-18,-4,-1,-38,-4,-13,-10,-8,14,-37,-9,-19,-8,8,15,16,12,0,-1,5,8,10,5,0,-1,3,7,6,7,0,0,-205,-103,-102,37,22,15,-10,-26,-97,-28,-35,-10,-6,-13,-43,-20,-14,-8,-4,-13,-54,-8,-21,-2,1,15,13,5,2,1,1,6,12,1,1,1,0,9,1,4,1,0,-113,-63,-50,41,24,17,-5,1,-64,-11,-13,-21,-4,16,-43,-18,-4,-10,-1,-15,-21,7,-9,-11,8,19,10,3,3,-1,5,9,9,0,3,-1,3,10,1,3,0,0,-88,-46,-42,91,45,46,10,-7,-48,-12,-26,-13,7,5,-28,-11,-18,-6,3,-12,-20,-1,-8,-7,15,24,30,15,2,1,10,16,12,5,0,0,5,8,18,10,2,1,-11,18,-29,101,53,48,26,-4,-22,16,-26,2,16,-6,6,19,-19,3,10,2,-28,-3,-7,-1,22,28,25,21,3,1,10,12,15,16,-1,1,12,16,10,5,4,0,-21,-30,9,72,38,34,16,6,8,-21,-15,-15,10,-3,-5,-10,-13,-12,6,9,13,-11,-2,-3,9,25,23,11,5,-2,3,13,16,5,1,-1,6,12,7,6,4,-1,-71,-44,-27,26,8,18,5,-22,-27,-11,-22,3,0,-9,-3,-15,-8,-11,5,-13,-24,4,-14,14,8,13,4,1,-1,-1,4,5,3,-3,0,-1,4,8,1,4,-1,0,65,26,39,49,21,28,17,10,13,15,-15,21,5,-3,1,14,-9,17,12,13,12,1,-6,4,18,9,15,8,-3,0,6,2,5,8,0,0,12,7,10,0,-3,0,12,6,6,17,4,13,22,2,-11,12,-23,5,11,1,-4,6,-11,-1,11,1,-7,6,-12,6,6,8,4,-4,1,-1,5,7,-3,-7,-1,0,1,1,7,3,2,-1,6,7,-1,36,15,21,25,-1,-10,5,-4,-11,21,8,-7,-2,-1,-13,4,-9,-3,7,-3,2,11,7,9,4,1,1,5,4,5,-2,1,0,6,3,4,6,0,1,-148,-77,-71,-35,-30,-5,-17,3,-43,-69,-14,-10,-5,4,-28,-43,-5,-2,-12,-1,-15,-26,-9,-8,-3,11,-18,-22,-2,-2,0,6,-16,-17,-4,0,-3,5,-2,-5,2,-2,-57,-2,-55,8,-1,9,7,-7,-27,-4,-25,4,15,4,-5,-4,-15,4,-8,-11,-22,0,-10,0,11,0,1,-7,1,2,8,0,-1,-9,-2,3,3,0,2,2,3,-1,-32,-39,7,9,-1,10,3,-12,-13,-1,-12,6,-14,-6,-10,-2,-10,4,17,-6,-3,1,-2,2,2,5,5,-2,-2,1,-2,4,0,-2,-1,0,4,1,5,0,-1,1,-87,-48,-39,26,9,17,4,-8,-47,5,-25,-19,1,-4,-20,0,-15,-12,3,-4,-27,5,-10,-7,6,7,7,5,2,-1,2,4,3,0,1,-1,4,3,4,5,1,0,5,-8,13,51,14,37,19,-3,0,-10,-12,5,7,-2,-9,-6,-4,2,12,-1,9,-4,-8,3,21,12,18,-1,-1,2,8,6,2,-1,-2,1,13,6,16,0,1,1
48,48029,Etxebarri,6597,207,122,85,11,6,5,24,37,81,29,20,9,20,20,47,14,10,7,4,17,34,15,10,2,1,5,5,0,0,0,1,3,2,0,0,0,0,2,3,0,0,0,224,120,104,14,6,8,25,15,144,36,6,-3,7,11,75,21,4,0,18,4,69,15,2,-3,2,4,6,1,1,0,1,1,3,1,0,0,1,3,3,0,1,0,233,119,114,24,11,13,26,32,103,53,12,1,13,18,48,33,4,1,13,14,55,20,8,0,6,5,7,3,1,1,4,2,4,1,0,0,2,3,3,2,1,1,100,62,38,15,14,1,14,5,70,3,-3,4,5,4,36,11,0,1,9,1,34,-8,-3,3,1,2,9,3,0,0,1,3,7,3,0,0,0,-1,2,0,0,0,146,91,55,33,14,19,7,20,97,27,-5,-7,1,18,59,14,1,-5,6,2,38,13,-6,-2,8,8,13,1,0,1,7,3,4,0,0,0,1,5,9,1,0,1,117,46,71,6,-4,10,10,18,61,23,5,-1,5,13,9,15,3,0,5,5,52,8,2,-1,7,1,-3,-1,1,0,3,0,-4,-3,0,0,4,1,1,2,1,0,203,89,114,16,3,13,37,26,89,21,10,12,20,13,27,16,1,7,17,13,62,5,9,5,6,9,0,3,-1,-1,2,2,-1,1,-1,0,4,7,1,2,0,-1,329,170,159,17,6,11,43,45,144,73,16,0,23,21,69,46,8,0,20,24,75,27,8,0,5,5,5,3,-1,0,2,2,2,0,0,0,3,3,3,3,-1,0,557,275,282,37,19,18,78,74,263,76,44,12,36,32,144,38,18,4,42,42,119,38,26,8,9,13,10,2,2,1,7,4,7,1,0,0,2,9,3,1,2,1,400,214,186,0,-5,5,36,38,207,76,26,11,15,18,114,51,11,2,21,20,93,25,15,9,-3,2,2,-5,4,0,-4,0,2,-4,1,0,1,2,0,-1,3,0,349,160,189,8,6,2,42,33,188,52,16,8,22,15,81,21,10,4,20,18,107,31,6,4,5,6,-2,-1,-1,0,3,4,1,-2,0,0,2,2,-3,1,-1,0,86,37,49,6,7,-1,11,10,40,20,9,-4,3,7,12,11,4,3,8,3,28,9,5,-7,2,1,9,-8,1,1,4,1,2,-1,0,1,-2,0,7,-7,1,0,144,71,73,-9,-6,-3,32,21,69,26,-2,-6,18,7,38,7,1,-1,14,14,31,19,-3,-5,-4,-1,-3,0,0,-2,-3,1,-3,-1,0,-1,-1,-2,0,1,0,-1,113,55,58,-4,-2,-2,24,10,35,42,-1,4,7,7,28,17,-4,1,17,3,7,25,3,3,-2,5,-2,-4,1,-3,-1,2,-2,-2,2,-2,-1,3,0,-2,-1,-1,55,34,21,-3,-5,2,-1,5,41,5,1,4,2,2,27,4,1,-1,-3,3,14,1,0,5,-4,-3,0,2,0,2,-1,-5,-1,2,0,0,-3,2,1,0,0,2,18,0,18,-3,-5,2,4,-8,24,12,-9,4,-3,0,13,3,-8,0,7,-8,11,9,-1,4,-4,-3,4,-3,-1,4,-3,-2,1,-1,-1,1,-1,-1,3,-2,0,3,68,24,44,28,10,18,22,-5,35,14,4,9,5,1,12,1,3,4,17,-6,23,13,1,5,7,8,6,4,2,1,1,6,2,2,-1,0,6,2,4,2,3,1,65,45,20,26,9,17,15,-5,29,31,-5,-3,11,-6,27,16,-1,-6,4,1,2,15,-4,3,4,2,8,9,1,2,1,1,2,4,0,1,3,1,6,5,1,1
48,48036,Galdakao,29417,56,7,49,51,21,30,-11,0,75,-7,-12,6,-9,-6,39,-8,-5,-3,-2,6,36,1,-7,9,10,13,15,6,2,4,5,6,4,3,1,2,5,7,11,3,1,2,-13,4,-17,68,36,32,-11,10,35,-33,-16,-2,-6,15,15,-21,-11,11,-5,-5,20,-12,-5,-13,10,20,23,8,4,1,5,10,14,6,0,1,5,10,9,2,4,0,89,40,49,95,47,48,19,17,53,15,-24,5,8,11,23,13,-18,-1,11,6,30,2,-6,6,33,9,30,17,3,3,16,3,14,11,1,2,17,6,16,6,2,1,-193,-99,-94,66,30,36,4,-3,-95,-50,-40,-7,8,5,-53,-28,-25,-4,-4,-8,-42,-22,-15,-3,18,14,25,8,0,1,9,6,11,4,0,0,9,8,14,4,0,1,-97,-77,-20,73,19,54,-17,10,-47,-19,-30,0,-24,3,-24,-15,-20,-2,7,7,-23,-4,-10,2,11,17,25,15,2,2,2,2,10,3,1,0,9,15,15,12,1,2,-221,-109,-112,72,29,43,-17,-43,-81,-43,-20,-13,-7,-8,-40,-33,-10,-11,-10,-35,-41,-10,-10,-2,21,14,21,9,5,1,12,7,8,-1,3,0,9,7,13,10,2,1,-185,-97,-88,102,49,53,12,17,-122,-29,-62,8,9,11,-57,-16,-38,-2,3,6,-65,-13,-24,10,29,26,29,9,5,3,16,17,14,2,-1,1,13,9,15,7,6,2,9,51,-42,147,97,50,28,33,-23,-19,-14,-7,26,37,-17,-4,2,-1,2,-4,-6,-15,-16,-6,27,66,23,16,4,5,18,58,6,7,2,3,9,8,17,9,2,2,-10,-38,28,91,55,36,-7,-26,48,-11,-32,13,0,-34,11,-2,-15,2,-7,8,37,-9,-17,11,5,54,15,12,3,1,3,42,5,4,1,0,2,12,10,8,2,1,11,-8,19,53,37,16,10,22,-16,-26,-13,24,7,9,-17,-17,-5,5,3,13,1,-9,-8,19,15,42,-3,0,-4,2,14,32,-8,-2,0,0,1,10,5,2,-4,2,-175,-100,-75,48,34,14,-15,-45,-54,-25,-29,-14,-4,-29,-32,-10,-22,-7,-11,-16,-22,-15,-7,-7,5,35,-2,5,0,0,2,27,0,2,-1,0,3,8,-2,3,1,0,45,22,23,61,37,24,19,16,23,-33,-5,19,19,25,12,-36,-2,1,0,-9,11,3,-3,18,6,33,15,9,-4,0,5,29,11,-8,-1,0,1,4,4,17,-3,0,55,43,12,1,3,-2,15,5,28,5,0,3,4,-5,38,3,2,4,11,10,-10,2,-2,-1,-5,24,-11,-4,2,-3,-5,20,-7,-4,1,0,0,4,-4,0,1,-3,135,61,74,3,13,-10,45,-5,92,11,-19,9,22,7,28,23,-22,0,23,-12,64,-12,3,9,2,25,-12,-10,0,-2,4,28,-14,-3,-2,-1,-2,-3,2,-7,2,-1,-10,-14,4,-21,-11,-10,26,-19,-7,15,-15,-8,22,-20,-13,13,-9,-7,4,1,6,2,-6,-1,-4,5,-22,-5,3,-1,0,0,-11,-6,3,0,-4,5,-11,1,0,-1,9,13,-4,-17,-17,0,30,17,-42,25,-14,-2,7,7,-19,16,1,1,23,10,-23,9,-15,-3,-14,8,-1,-3,-6,0,-10,0,-1,0,-7,1,-4,8,0,-3,1,-1,10,3,7,58,28,30,8,-17,45,5,-20,-10,14,-12,20,-7,-11,-4,-6,-5,25,12,-9,-6,16,5,24,-3,10,4,14,-2,17,-6,2,1,2,7,7,3,8,3,-24,-25,1,58,23,35,6,12,-31,-6,-6,10,2,8,-27,5,-6,-4,4,4,-4,-11,0,14,16,14,11,16,-3,3,6,6,4,6,0,0,10,8,7,10,-3,3
48,48046,Gernika-Lumo,15491,-4,-14,10,56,32,24,4,1,-12,-12,-1,21,-6,4,-2,-4,-2,-1,10,-3,-10,-8,1,22,11,14,16,10,4,1,6,9,8,8,1,0,5,5,8,2,3,1,-34,-19,-15,49,32,17,2,-5,-13,-6,-3,-8,3,-6,-9,5,-3,-10,-1,1,-4,-11,0,2,6,10,21,9,1,1,4,6,14,6,0,1,2,4,7,3,1,0,39,9,30,91,49,42,-1,-1,26,0,4,15,6,-3,5,-5,1,6,-7,2,21,5,3,9,22,20,28,17,3,1,14,8,15,9,3,0,8,12,13,8,0,1,150,79,71,160,85,75,35,47,47,23,-4,1,19,26,24,10,-4,3,16,21,23,13,0,-2,41,43,41,27,5,2,18,23,25,16,1,2,23,20,16,11,4,0,288,151,137,206,100,106,53,76,77,68,23,-12,25,39,47,34,6,-2,28,37,30,34,17,-10,36,62,55,45,5,2,14,37,24,23,0,1,22,25,31,22,5,1,140,78,62,176,95,81,33,42,9,26,15,20,29,16,7,16,9,4,4,26,2,10,6,16,44,55,32,32,8,3,29,26,17,16,6,1,15,29,15,16,2,2,228,103,125,235,100,135,57,65,38,38,14,11,25,34,11,17,11,4,32,31,27,21,3,7,46,73,53,33,22,4,18,37,21,6,15,2,28,36,32,27,7,2,103,44,59,217,118,99,25,35,52,-26,-11,29,18,27,24,-25,-4,7,7,8,28,-1,-7,22,56,63,72,15,9,0,35,38,39,2,2,1,21,25,33,13,7,-1,17,0,17,102,45,57,8,26,-27,1,6,7,5,9,-20,2,-2,4,3,17,-7,-1,8,3,29,42,24,11,-5,0,13,17,12,4,-2,0,16,25,12,7,-3,0,35,-2,37,15,-7,22,22,6,-14,8,-5,15,20,-9,-9,0,-7,2,2,15,-5,8,2,13,14,6,-7,-10,4,5,6,-1,-8,-9,1,2,8,7,1,-1,3,3,140,57,83,85,33,52,26,23,88,5,-8,0,0,11,54,0,-9,-1,26,12,34,5,1,1,22,27,39,7,-9,-3,6,7,17,9,-7,-1,16,20,22,-2,-2,-2,361,142,219,104,44,60,82,56,111,81,16,7,38,27,34,35,4,-2,44,29,77,46,12,9,30,36,22,20,-4,-1,11,19,11,10,-6,-2,19,17,11,10,2,1,72,28,44,-24,-35,11,15,19,21,8,-7,9,14,3,5,12,-9,4,1,16,16,-4,2,5,3,6,-6,-26,-3,-1,5,-6,-11,-20,-4,-1,-2,12,5,-6,1,0,-25,-27,2,-87,-68,-19,-11,15,-18,-28,2,12,-17,11,-6,-14,-5,4,6,4,-12,-14,7,8,-3,-5,-39,-39,-3,-1,-5,-2,-34,-26,-1,-2,2,-3,-5,-13,-2,1,4,15,-11,25,12,13,14,-2,7,-26,8,2,9,7,24,-25,5,-4,5,-9,-17,-1,3,6,7,13,7,-1,-1,-1,2,7,6,-6,2,0,5,6,1,5,-3,-1,153,66,87,69,39,30,53,9,15,44,14,12,31,-1,4,14,11,3,22,10,11,30,3,9,13,19,8,19,0,2,13,9,1,8,1,3,0,10,7,11,-1,-1,56,-5,61,-19,-26,7,8,15,10,9,-22,32,-2,-4,0,9,-15,7,10,19,10,0,-7,25,-12,15,-9,-12,-4,2,-13,6,-2,-12,-6,1,1,9,-7,0,2,1,99,66,33,80,52,28,3,27,36,13,4,16,15,32,13,-3,3,8,-12,-5,23,16,1,8,3,23,31,15,1,7,4,23,19,6,-3,3,-1,0,12,9,4,4
48,48044,Getxo,83459,128,-37,165,501,213,288,89,-6,-15,-7,-19,80,44,-14,-70,-15,-24,30,45,8,55,8,5,50,83,113,173,81,31,11,47,44,71,27,14,6,36,69,102,54,17,5,16,-108,124,638,248,390,90,14,-94,-10,-24,38,37,3,-85,-31,-33,0,53,11,-9,21,9,38,138,139,192,126,26,5,71,46,78,37,11,1,67,93,114,89,15,4,-150,-124,-26,477,192,285,68,22,-240,-31,-23,57,55,-9,-130,-29,-24,13,13,31,-110,-2,1,44,111,112,130,78,29,10,60,33,53,30,8,6,51,79,77,48,21,4,-208,-187,-21,679,240,439,104,19,-320,21,-61,16,47,1,-179,-22,-39,-3,57,18,-141,43,-22,19,153,137,203,128,34,16,75,37,60,46,15,3,78,100,143,82,19,13,-354,-194,-160,637,241,396,51,78,-384,-27,-101,14,42,18,-192,-17,-56,5,9,60,-192,-10,-45,9,114,178,199,99,30,8,58,56,69,35,12,7,56,122,130,64,18,1,-274,-254,-20,719,266,453,62,112,-381,-7,-73,11,20,35,-237,-29,-51,8,42,77,-144,22,-22,3,133,192,247,123,15,-2,59,70,101,30,3,-1,74,122,146,93,12,-1,-261,-220,-41,799,258,541,52,126,-328,-54,-82,23,40,49,-196,-65,-50,-1,12,77,-132,11,-32,24,152,242,248,123,23,3,73,69,79,36,-1,-2,79,173,169,87,24,5,-268,-202,-66,776,315,461,37,128,-296,-30,-64,-41,8,58,-183,-36,-36,-19,29,70,-113,6,-28,-22,128,219,247,125,38,13,63,88,85,55,14,7,65,131,162,70,24,6,-93,-134,41,411,140,271,18,127,-217,42,-93,15,3,29,-112,-14,-31,-8,15,98,-105,56,-62,23,38,160,120,80,6,-5,16,52,50,16,4,-1,22,108,70,64,2,-4,-197,-111,-86,227,69,158,19,16,-209,-31,-9,7,11,-8,-81,-39,-2,0,8,24,-128,8,-7,7,34,71,89,13,7,10,16,5,40,-1,2,5,18,66,49,14,5,5,-193,-120,-73,95,-16,111,66,22,-212,-12,-54,-14,48,-6,-119,-10,-26,-5,18,28,-93,-2,-28,-9,16,70,4,-3,1,-2,3,12,-24,-14,3,1,13,58,28,11,-2,-3,6,-24,30,176,34,142,71,109,-134,-11,-36,-16,38,51,-93,-20,-12,-1,33,58,-41,9,-24,-15,65,80,28,1,-12,4,32,17,-11,-16,6,-1,33,63,39,17,-18,5,-193,-163,-30,-86,-70,-16,-36,48,-118,-61,-63,26,-3,-5,-76,-44,-31,1,-33,53,-42,-17,-32,25,-7,37,-52,-47,-25,4,8,-2,-33,-37,-11,5,-15,39,-19,-10,-14,-1,-370,-189,-181,-101,-56,-45,23,-8,-135,-67,-114,-71,17,-6,-88,-19,-62,-37,6,-2,-47,-48,-52,-34,5,27,-16,-66,-39,-18,7,8,-12,-34,-19,-10,-2,19,-4,-32,-20,-8,-328,-225,-103,-25,-30,5,50,-21,-267,5,-62,-40,12,-29,-174,23,-35,-23,38,8,-93,-18,-27,-17,18,47,-54,-22,-17,1,11,2,-30,-4,-9,-1,7,45,-24,-18,-8,2,-220,-119,-101,119,22,97,111,23,-229,-28,-55,-37,52,11,-119,-21,-30,-12,59,12,-110,-7,-25,-25,35,74,-1,4,2,-1,7,29,-8,-1,-8,2,28,45,7,5,10,-3,-32,-85,53,253,93,160,104,98,-186,2,-4,-26,52,25,-113,-16,0,-24,52,73,-73,18,-4,-2,65,104,57,8,7,6,39,29,15,-5,6,4,26,75,42,13,1,2,-114,-113,-1,207,35,172,47,59,-64,-49,-72,-21,23,2,-40,-27,-37,-24,24,57,-24,-22,-35,3,65,111,74,-36,-9,-7,26,26,12,-28,-9,2,39,85,62,-8,0,-9
48,48043,Gorliz,3970,201,95,106,20,7,13,34,16,67,38,24,18,16,10,30,17,11,6,18,6,37,21,13,12,3,2,8,4,0,3,2,1,2,1,0,1,1,1,6,3,0,2,142,81,61,19,8,11,19,14,67,29,13,-4,11,4,45,16,3,-1,8,10,22,13,10,-3,7,2,6,3,0,0,4,0,2,1,0,0,3,2,4,2,0,0,91,57,34,19,7,12,-4,8,55,3,22,8,-2,5,27,9,10,7,-2,3,28,-6,12,1,4,5,7,0,3,0,3,2,1,0,1,0,1,3,6,0,2,0,99,45,54,21,12,9,21,8,46,-7,17,10,9,2,17,-1,12,5,12,6,29,-6,5,5,3,6,5,7,0,0,1,3,4,4,0,0,2,3,1,3,0,0,109,56,53,26,9,17,3,10,53,30,5,7,8,9,20,17,-2,3,-5,1,33,13,7,4,5,3,11,4,1,0,1,0,4,3,0,0,4,3,7,1,1,0,165,75,90,29,14,15,33,28,57,36,8,0,23,14,15,14,7,-1,10,14,42,22,1,1,6,11,11,1,-1,0,4,5,6,-1,0,0,2,6,5,2,-1,0,105,50,55,52,24,28,13,-1,46,35,23,-9,2,0,25,22,8,-8,11,-1,21,13,15,-1,12,10,14,10,5,1,3,6,7,7,1,0,9,4,7,3,4,1,128,63,65,59,35,24,21,16,65,30,0,-1,14,3,33,18,3,-6,7,13,32,12,-3,5,4,16,18,13,6,2,2,10,10,9,4,0,2,6,8,4,2,2,76,40,36,16,7,9,27,2,37,4,3,-3,10,-7,27,0,4,2,17,9,10,4,-1,-5,8,1,4,1,0,1,6,-2,2,-1,0,1,2,3,2,2,0,0,80,34,46,10,3,7,23,-2,40,12,4,0,18,-5,22,0,0,-2,5,3,18,12,4,2,3,3,5,-1,0,0,0,1,2,0,-1,1,3,2,3,-1,1,-1,16,2,14,29,3,26,4,-5,13,-11,19,-6,-2,-6,8,-4,13,-7,6,1,5,-7,6,1,9,9,7,5,-2,1,3,3,-1,-1,-2,1,6,6,8,6,0,0,38,16,22,23,6,17,12,8,-2,15,6,-3,10,1,-10,11,3,2,2,7,8,4,3,-5,12,3,5,4,-1,0,7,-2,-1,1,1,0,5,5,6,3,-2,0,72,36,36,9,3,6,27,-4,11,38,2,-5,10,3,4,21,-2,-2,17,-7,7,17,4,-3,3,5,4,-2,0,-1,1,3,2,-2,-1,0,2,2,2,0,1,-1,62,38,24,4,-2,6,22,-4,26,-3,8,6,10,1,12,1,5,2,12,-5,14,-4,3,4,3,1,-2,0,-2,2,2,0,-3,-2,-2,1,1,1,1,2,0,1,-1,-1,0,-13,-12,-1,4,-5,0,-5,1,0,2,-4,-11,4,7,-2,2,-1,11,-9,-6,2,-5,-1,2,-1,-6,-2,-4,-2,0,-3,-2,-1,-1,1,2,2,-4,-1,-17,-32,15,-13,-5,-8,1,-4,1,-6,-7,-4,-6,-4,-7,-1,-8,-7,7,0,8,-5,1,3,0,-2,-5,-5,0,-1,0,-2,0,-1,-1,-1,0,0,-5,-4,1,0,19,13,6,16,5,11,7,-3,0,13,0,-1,-1,2,1,4,2,4,8,-5,-1,9,-2,-5,5,4,3,0,3,1,3,1,0,-1,1,1,2,3,3,1,2,0,19,15,4,21,7,14,-7,-4,5,22,5,1,-5,-2,10,11,1,3,-2,-2,-5,11,4,-2,7,5,7,0,2,0,1,2,4,-2,2,0,6,3,3,2,0,0
48,48045,Güeñes,5859,12,2,10,12,7,5,13,6,7,3,-13,-3,7,2,0,-1,-7,1,6,4,7,4,-6,-4,1,1,6,3,0,0,1,0,3,2,0,0,0,1,3,1,0,0,20,5,15,22,8,14,-10,16,43,-15,-8,-7,-8,5,24,-7,-4,-4,-2,11,19,-8,-4,-3,7,10,4,1,0,0,3,3,2,0,0,0,4,7,2,1,0,0,168,85,83,20,10,10,30,10,77,34,6,11,13,10,32,23,2,5,17,0,45,11,4,6,5,3,9,0,3,0,1,4,3,1,1,0,4,-1,6,-1,2,0,77,60,17,32,20,12,5,3,66,6,-6,3,3,9,47,2,-1,0,2,-6,19,4,-5,3,5,10,9,6,2,0,3,7,6,3,1,0,2,3,3,3,1,0,67,48,19,36,18,18,20,11,33,4,3,-3,13,4,21,6,4,1,7,7,12,-2,-1,-4,7,7,11,7,3,0,3,3,7,4,1,0,4,4,4,3,2,0,78,39,39,53,30,23,12,18,57,-11,1,-2,13,4,20,-4,6,-1,-1,14,37,-7,-5,-1,16,13,14,9,-1,1,11,6,5,8,0,0,5,7,9,1,-1,1,40,20,20,26,6,20,6,17,17,-7,13,-4,2,8,15,-8,5,-1,4,9,2,1,8,-3,11,4,8,2,1,0,5,0,1,0,0,0,6,4,7,2,1,0,78,51,27,38,18,20,8,15,29,17,10,-7,11,8,19,5,5,-3,-3,7,10,12,5,-4,6,7,10,7,6,1,2,1,6,4,3,1,4,6,4,3,3,0,45,10,35,26,3,23,11,7,8,9,13,-3,0,4,-5,4,9,-1,11,3,13,5,4,-2,9,3,8,3,1,1,4,0,0,-1,0,0,5,3,8,4,1,1,115,51,64,15,-1,16,23,22,58,5,0,0,2,10,30,5,0,-1,21,12,28,0,0,1,1,6,4,-2,3,2,-1,2,-3,-2,1,1,2,4,7,0,2,1,-67,-24,-43,-16,-13,-3,-22,-1,-8,-26,-15,1,-7,0,-1,-17,-5,1,-15,-1,-7,-9,-10,0,-7,3,-6,-7,-3,3,-3,0,-5,-4,-3,2,-4,3,-1,-3,0,1,60,20,40,16,8,8,-4,20,54,-7,-8,4,-4,10,31,-8,-6,0,0,10,23,1,-2,4,7,9,6,-1,-3,-2,4,6,2,-1,-2,-1,3,3,4,0,-1,-1,64,13,51,-7,-8,1,25,5,3,15,9,4,15,-5,-12,5,5,4,10,10,15,10,4,0,0,0,-6,-2,2,-1,1,0,-7,-3,1,0,-1,0,1,1,1,-1,14,20,-6,-13,-4,-9,-4,10,0,4,2,4,8,7,4,1,-2,2,-12,3,-4,3,4,2,1,-1,-5,-9,0,1,3,-1,-1,-5,0,0,-2,0,-4,-4,0,1,57,17,40,-7,-3,-4,10,19,20,-4,17,-5,8,8,5,-10,6,-1,2,11,15,6,11,-4,-2,5,-1,-8,-1,0,-3,4,1,-4,-1,0,1,1,-2,-4,0,0,109,34,75,7,1,6,12,27,38,21,4,6,-8,-1,21,6,6,6,20,28,17,15,-2,0,0,3,5,-2,-1,0,0,1,1,-2,0,0,0,2,4,0,-1,0,47,25,22,13,2,11,9,9,4,12,9,0,1,12,3,-2,8,1,8,-3,1,14,1,-1,7,3,3,1,1,-2,0,1,1,2,-1,-1,7,2,2,-1,2,-1,13,-3,16,13,4,9,-8,9,13,1,3,-5,-5,0,6,1,-3,-2,-3,9,7,0,6,-3,5,4,2,0,0,2,2,1,-1,0,1,1,3,3,3,0,-1,1
48,48094,Igorre,3938,0,10,-10,10,9,1,-1,10,-3,2,1,-5,-1,12,-1,2,-1,-1,0,-2,-2,0,2,-4,0,2,7,1,0,0,0,2,6,1,0,0,0,0,1,0,0,0,27,15,12,9,6,3,-1,7,5,14,-1,2,-3,5,7,7,-1,0,2,2,-2,7,0,2,0,4,3,1,0,0,0,4,1,1,0,0,0,0,2,0,0,0,56,34,22,19,14,5,12,13,19,8,-4,2,12,5,14,5,-3,-1,0,8,5,3,-1,3,4,7,8,0,0,0,3,6,5,0,0,0,1,1,3,0,0,0,36,21,15,35,21,14,8,-2,26,5,-3,3,5,2,15,1,-2,1,3,-4,11,4,-1,2,10,13,6,5,0,0,5,10,5,1,0,0,5,3,1,4,0,0,49,23,26,26,14,12,8,21,0,12,5,3,4,12,-5,8,3,2,4,9,5,4,2,1,4,11,5,5,1,0,4,5,2,3,0,0,0,6,3,2,1,0,7,-3,10,29,5,24,15,10,-28,12,-1,0,3,2,-17,8,0,1,12,8,-11,4,-1,-1,7,12,0,7,2,1,3,2,-5,5,0,0,4,10,5,2,2,1,-8,-14,6,40,16,24,-2,10,-5,0,-7,-3,1,0,-7,-1,-5,-1,-3,10,2,1,-2,-2,13,9,8,8,2,0,5,3,4,4,0,0,8,6,4,4,2,0,84,44,40,54,27,27,15,23,19,8,13,6,7,9,10,9,6,4,8,14,9,-1,7,2,14,13,17,7,3,0,5,6,13,2,1,0,9,7,4,5,2,0,63,45,18,13,9,4,3,4,35,11,6,10,-3,3,23,17,5,3,6,1,12,-6,1,7,2,5,1,2,3,0,0,4,1,2,2,0,2,1,0,0,1,0,-10,-13,3,-11,-13,2,6,1,-1,-2,-7,-6,2,-1,1,-10,0,-3,4,2,-2,8,-7,-3,2,1,-4,-9,0,-1,1,-1,-7,-7,1,0,1,2,3,-2,-1,-1,25,14,11,20,8,12,13,14,-9,6,-5,3,10,8,-9,2,-2,1,3,6,0,4,-3,2,4,4,0,9,2,1,2,1,-2,5,2,0,2,3,2,4,0,1,-20,-18,-2,1,-1,2,0,2,-18,1,0,-7,-8,1,-1,-8,0,-3,8,1,-17,9,0,-4,3,6,-4,-1,-2,-1,1,3,1,-4,-2,0,2,3,-5,3,0,-1,-8,-4,-4,1,-4,5,7,0,-1,3,-7,-7,2,4,-2,0,-4,-3,5,-4,1,3,-3,-4,1,0,1,-2,1,0,0,-1,1,-4,0,0,1,1,0,2,1,0,-5,1,-6,-15,-7,-8,16,-2,-8,-7,-3,-2,12,-3,0,-6,-2,0,4,1,-8,-1,-1,-2,0,-3,-4,-7,-1,0,2,0,-4,-3,-2,0,-2,-3,0,-4,1,0,-12,-12,0,4,-3,7,-6,8,-1,-10,-1,-4,-7,3,-6,-4,-2,2,1,5,5,-6,1,-6,-5,7,1,0,-1,1,-5,1,-1,1,0,1,0,6,2,-1,-1,0,-39,-18,-21,0,3,-3,-3,-11,-13,-6,-8,1,1,-6,0,-6,-6,-2,-4,-5,-13,0,-2,3,-3,0,4,0,-1,0,-2,0,4,2,0,-1,-1,0,0,-2,-1,1,53,46,7,21,16,5,18,-1,19,10,4,0,16,2,15,6,3,3,2,-3,4,4,1,-3,7,3,10,0,1,-1,6,2,8,-1,1,0,1,1,2,1,0,-1,3,-3,6,18,6,12,15,6,-25,13,-9,2,10,5,-13,1,-7,0,5,1,-12,12,-2,2,9,5,2,0,1,0,5,2,0,-2,0,0,4,3,2,2,1,0
48,48910,Iurreta,4329,-54,-31,-23,8,1,7,-10,-8,-26,-4,-14,8,-7,-4,-8,-4,-8,1,-3,-4,-18,0,-6,7,1,1,2,1,2,1,1,0,0,0,0,0,0,1,2,1,2,1,-76,-31,-45,5,2,3,-4,4,-31,-14,-22,-11,2,6,-20,-8,-11,-2,-6,-2,-11,-6,-11,-9,0,0,4,1,0,0,0,0,1,1,0,0,0,0,3,0,0,0,-32,-25,-7,9,6,3,-5,-16,12,-3,-10,-11,-4,-9,1,-3,-4,-7,-1,-7,11,0,-6,-4,3,2,-1,2,2,0,2,0,-1,2,2,0,1,2,0,0,0,0,-66,-29,-37,29,21,8,-27,3,-25,-16,4,-4,-11,-1,-8,-13,6,-1,-16,4,-17,-3,-2,-3,4,9,7,7,1,1,4,6,6,3,1,1,0,3,1,4,0,0,-38,-19,-19,29,12,17,-3,7,-21,-4,-16,0,-4,0,-8,3,-8,0,1,7,-13,-7,-8,0,5,13,7,3,1,0,1,3,5,3,0,0,4,10,2,0,1,0,-89,-31,-58,13,7,6,-25,-10,-24,-18,-11,-1,-16,-1,-4,-3,-8,0,-9,-9,-20,-15,-3,-1,3,3,3,4,0,0,0,4,0,4,-1,0,3,-1,3,0,1,0,-51,-34,-17,31,10,21,-4,7,-24,-23,-1,-7,-7,6,-14,-18,2,-4,3,1,-10,-5,-3,-3,11,9,6,3,2,0,4,1,2,1,2,0,7,8,4,2,0,0,18,15,3,38,15,23,-4,27,0,-2,-2,-3,0,12,9,3,-2,-6,-4,15,-9,-5,0,3,4,22,2,7,3,0,0,10,0,4,1,0,4,12,2,3,2,0,-19,4,-23,27,17,10,-2,7,14,-8,-17,-14,4,0,10,6,-9,-6,-6,7,4,-14,-8,-8,7,9,6,5,-1,1,5,4,3,5,0,0,2,5,3,0,-1,1,-21,4,-25,-1,-10,9,10,-4,-4,-1,-20,-4,6,0,6,-2,-10,1,4,-4,-10,1,-10,-5,5,2,3,-9,-2,0,1,0,0,-10,-1,0,4,2,3,1,-1,0,63,28,35,22,17,5,21,15,14,17,3,-8,10,2,-1,17,1,-1,11,13,15,0,2,-7,3,6,17,-2,-1,-1,3,2,11,2,-1,0,0,4,6,-4,0,-1,31,-2,33,10,-2,12,11,2,7,15,-3,-3,1,4,-3,1,-4,-2,10,-2,10,14,1,-1,2,3,-5,6,2,1,0,1,-5,1,-1,1,2,2,0,5,3,0,-25,-17,-8,-25,-15,-10,-3,3,-45,12,6,-3,-7,-2,-19,7,4,-2,4,5,-26,5,2,-1,-2,-2,-14,-6,0,-1,-1,-1,-8,-4,0,-1,-1,-1,-6,-2,0,0,-64,-40,-24,-15,-11,-4,9,3,-43,-20,-7,-8,5,3,-27,-13,-5,-4,4,0,-16,-7,-2,-4,4,4,-4,-15,-4,0,5,2,-4,-13,-1,0,-1,2,0,-2,-3,0,-20,-3,-17,-14,-8,-6,-15,0,-5,2,-4,-3,-2,-5,0,3,-2,1,-13,5,-5,-1,-2,-4,-1,0,-12,-1,-3,1,2,0,-10,0,-2,1,-3,0,-2,-1,-1,0,-4,8,-12,13,7,6,9,5,-22,9,9,-12,7,6,-11,4,7,-5,2,-1,-11,5,2,-7,7,0,3,1,2,-1,5,-1,1,1,0,0,2,1,2,0,2,-1,-35,-21,-14,3,-4,7,3,7,-6,-21,-8,-11,2,8,-6,-16,-3,-4,1,-1,0,-5,-5,-7,3,3,4,-8,1,0,2,1,1,-9,1,0,1,2,3,1,0,0,12,18,-6,23,10,13,16,3,12,-3,-4,-15,4,2,21,-4,-1,-6,12,1,-9,1,-3,-9,4,6,9,3,2,-1,1,2,5,0,2,0,3,4,4,3,0,-1
48,48022,Karrantza Harana/Valle de Carranza,3037,9,5,4,5,4,1,-3,3,-4,13,8,-7,-1,4,-11,9,4,0,-2,-1,7,4,4,-7,1,1,1,1,1,0,1,1,1,0,1,0,0,0,0,1,0,0,11,0,11,7,4,3,0,6,-2,3,-2,7,1,4,-6,-1,1,2,-1,2,4,4,-3,5,1,2,2,1,0,1,1,0,2,0,0,1,0,2,0,1,0,0,14,7,7,-3,-3,0,10,-1,-3,8,1,1,5,1,-4,4,-2,5,5,-2,1,4,3,-4,0,-1,-3,0,1,0,0,-2,-2,0,0,1,0,1,-1,0,1,-1,28,4,24,10,5,5,-7,7,20,1,-1,8,-6,5,11,-2,-4,0,-1,2,9,3,3,8,4,0,2,3,1,0,1,0,1,2,1,0,3,0,1,1,0,0,-8,4,-12,6,4,2,3,-2,-18,2,5,2,2,-2,-5,5,4,0,1,0,-13,-3,1,2,0,0,3,2,1,0,0,0,1,2,1,0,0,0,2,0,0,0,16,13,3,12,6,6,-3,2,-19,18,10,11,2,2,-7,10,4,4,-5,0,-12,8,6,7,1,4,3,2,0,3,1,1,3,1,0,1,0,3,0,1,0,2,21,9,12,23,11,12,-3,0,6,4,5,12,-2,0,3,1,1,7,-1,0,3,3,4,5,2,6,7,6,1,1,0,4,3,3,1,0,2,2,4,3,0,1,28,14,14,5,4,1,6,3,-3,8,12,6,4,-1,6,-1,6,1,2,4,-9,9,6,5,1,2,0,1,0,1,1,2,2,0,-1,0,0,0,-2,1,1,1,15,15,0,14,7,7,5,3,15,0,0,-9,2,2,7,4,1,0,3,1,8,-4,-1,-9,0,5,2,4,4,-1,0,1,0,3,3,0,0,4,2,1,1,-1,7,6,1,10,4,6,1,0,-2,4,2,3,3,0,-2,4,2,0,-2,0,0,0,0,3,2,2,2,3,1,0,1,1,0,1,0,1,1,1,2,2,1,-1,33,15,18,12,6,6,-3,9,9,7,2,12,-4,6,7,1,2,3,1,3,2,6,0,9,1,4,2,2,1,2,1,1,2,1,0,1,0,3,0,1,1,1,30,9,21,1,-2,3,0,4,5,-5,17,9,0,1,-5,0,9,4,0,3,10,-5,8,5,0,3,2,-3,0,0,0,0,-1,-1,1,-1,0,3,3,-2,-1,1,-3,-2,-1,0,-2,2,-2,-5,7,5,-3,-2,-2,-2,6,0,-1,-1,0,-3,1,5,-2,-1,0,2,0,-1,0,-1,0,0,2,-2,-1,-1,0,2,-2,1,1,0,36,12,24,-20,-13,-7,8,2,-7,15,4,14,5,-3,-5,11,0,4,3,5,-2,4,4,10,-2,-3,-9,-3,-2,-1,-1,-3,-6,0,-2,-1,-1,0,-3,-3,0,0,-24,-11,-13,7,3,4,-2,-9,-7,-8,3,0,2,-7,-5,-2,1,0,-4,-2,-2,-6,2,0,5,0,-1,-1,2,2,4,0,-2,0,-1,2,1,0,1,-1,3,0,18,12,6,6,1,5,1,15,-4,1,4,1,4,6,-4,6,-1,2,-3,9,0,-5,5,-1,1,5,0,1,-1,0,1,2,-1,1,-1,-1,0,3,1,0,0,1,1,0,1,8,4,4,5,6,-3,-3,-1,-4,2,5,1,-1,-1,-6,3,1,-4,-2,0,2,0,3,4,3,1,-3,0,2,1,1,1,-1,0,1,3,2,0,-2,8,-7,15,12,3,9,-2,9,-3,-4,9,1,-1,-3,0,-2,1,-2,-1,12,-3,-2,8,3,1,4,7,0,0,0,1,1,2,-1,-1,1,0,3,5,1,1,-1
48,48054,Leioa,27645,48,-33,81,111,39,72,-39,1,63,-11,2,30,-39,-2,29,-20,-2,5,0,3,34,9,4,25,21,36,29,21,2,2,8,9,12,8,1,1,13,27,17,13,1,1,202,96,106,198,93,105,16,37,107,13,14,19,3,27,52,2,9,7,13,10,55,11,5,12,54,41,53,32,9,5,28,18,20,19,4,3,26,23,33,13,5,2,190,116,74,159,81,78,56,19,80,-3,-22,63,48,15,56,0,-17,17,8,4,24,-3,-5,46,33,45,50,19,10,0,16,22,27,11,5,0,17,23,23,8,5,0,-8,-56,48,174,82,92,47,22,-33,-27,-28,13,11,23,-50,-23,-13,-2,36,-1,17,-4,-15,15,50,47,43,19,10,5,31,23,16,5,5,2,19,24,27,14,5,3,-51,-55,4,151,54,97,16,29,-55,-23,-41,33,-1,11,-44,-5,-21,8,17,18,-11,-18,-20,25,45,26,50,19,8,3,21,7,17,7,2,0,24,19,33,12,6,3,117,20,97,173,64,109,55,39,13,-24,-22,47,22,18,-4,-14,-19,13,33,21,17,-10,-3,34,51,39,39,31,6,2,27,14,7,12,0,1,24,25,32,19,6,1,106,1,105,270,118,152,39,63,64,-43,-26,-10,21,20,16,-36,-25,-5,18,43,48,-7,-1,-5,85,64,75,27,10,4,47,21,36,8,1,4,38,43,39,19,9,0,430,240,190,212,90,122,77,70,193,53,10,14,52,42,102,31,9,2,25,28,91,22,1,12,46,68,56,26,13,1,26,26,23,11,3,1,20,42,33,15,10,0,248,87,161,181,74,107,16,90,80,16,6,38,1,44,24,11,-3,9,15,46,56,5,9,29,22,66,52,34,7,-1,7,32,23,14,0,-2,15,34,29,20,7,1,132,38,94,45,8,37,22,25,52,15,-42,57,4,10,30,6,-13,0,18,15,22,9,-29,57,14,10,18,2,0,-1,0,6,3,-4,4,-2,14,4,15,6,-4,1,63,21,42,11,-13,24,6,35,33,-35,-24,35,15,17,13,-36,-7,13,-9,18,20,1,-17,22,11,21,-16,-3,-4,-1,2,2,-7,-10,-1,1,9,19,-9,7,-3,-2,34,23,11,-8,6,-14,6,2,-17,17,-23,36,7,1,-15,13,3,12,-1,1,-2,4,-26,24,-4,17,-8,-14,-3,2,2,14,-6,-6,0,0,-6,3,-2,-8,-3,2,-11,4,-15,-29,-11,-18,-26,8,7,-13,-26,35,-5,10,10,-13,-12,11,-21,-2,-3,0,-14,24,-7,2,-14,-14,1,0,-3,-4,-1,-4,-2,0,-4,6,-13,-10,3,0,14,-29,43,-44,-28,-16,1,8,0,-9,-42,48,-8,8,-16,-3,-29,16,9,0,16,-6,-13,32,-5,-8,-6,-23,-3,1,-4,-4,-5,-13,-3,1,-1,-4,-1,-10,0,0,6,-5,11,-56,-34,-22,-1,-23,-21,-10,3,61,6,-24,6,-7,4,17,-7,1,-27,-3,-1,44,-4,-6,-21,-23,-6,2,-2,-10,-10,-11,-2,1,-2,4,-11,-12,-4,1,158,41,117,-9,-26,17,2,37,60,-12,37,26,1,5,17,-16,17,10,1,32,43,4,20,16,1,3,-1,-22,6,3,-4,-5,0,-15,-3,0,5,8,-1,-7,9,3,393,194,199,122,64,58,64,54,179,40,14,23,43,41,73,2,13,13,21,13,106,38,1,10,29,37,28,19,5,2,15,19,18,9,1,1,14,18,10,10,4,1,273,124,149,98,41,57,34,30,116,62,-3,27,9,15,53,40,-3,8,25,15,63,22,0,19,21,19,23,22,2,2,11,7,10,12,-2,0,10,12,13,10,4,2
48,48057,Lekeitio,7443,-15,5,-20,13,4,9,-8,-13,-16,15,0,10,-4,-3,-3,12,1,4,-4,-10,-13,3,-1,6,1,1,3,3,1,4,0,0,1,1,1,1,1,1,2,2,0,3,-15,-13,-2,7,4,3,-5,7,-15,-4,4,-2,-5,2,-7,-3,4,-3,0,5,-8,-1,0,1,1,0,2,1,1,1,1,0,1,1,1,0,0,0,1,0,0,1,-6,-7,1,20,9,11,1,0,-8,-5,-5,11,1,-1,-6,-4,-2,5,0,1,-2,-1,-3,6,5,3,6,3,1,2,2,2,2,1,1,1,3,1,4,2,0,1,-24,-23,-1,23,13,10,6,5,-23,-15,3,0,-5,1,-7,-13,2,-1,11,4,-16,-2,1,1,8,6,3,2,2,1,4,3,2,2,2,0,4,3,1,0,0,1,-20,-17,-3,29,11,18,-3,7,-20,-1,-9,6,-1,10,-11,-9,-7,2,-2,-3,-9,8,-2,4,1,5,10,9,3,1,0,2,5,4,0,0,1,3,5,5,3,1,13,8,5,39,21,18,14,2,-4,-24,13,13,14,1,-9,-7,3,7,0,1,5,-17,10,6,16,6,8,2,6,1,11,4,2,1,2,1,5,2,6,1,4,0,107,49,58,55,27,28,34,13,12,24,18,7,22,3,8,8,7,4,12,10,4,16,11,3,11,12,14,8,8,1,8,6,5,5,3,0,3,6,9,3,5,1,112,37,75,74,31,43,13,18,22,15,15,26,4,7,8,3,5,8,9,11,14,12,10,18,12,18,21,9,4,8,5,6,10,4,2,3,7,12,11,5,2,5,6,5,1,44,25,19,-1,17,-12,9,1,-5,3,12,-13,3,0,0,-4,5,1,6,1,-5,8,15,16,2,1,2,5,5,10,2,2,1,3,10,6,0,-1,1,-1,-16,15,26,9,17,11,0,-17,-11,2,14,8,0,-15,-14,-1,6,3,0,-2,3,3,8,7,6,7,3,3,0,4,2,-1,1,3,0,3,4,8,2,0,0,0,17,-17,37,12,25,-3,4,3,6,3,-11,4,-1,9,4,1,0,-7,5,-6,2,2,-11,8,12,14,3,1,-1,5,-1,6,1,1,0,3,13,8,2,0,-1,44,17,27,39,17,22,3,21,-7,17,12,-3,1,2,-4,12,4,1,2,19,-3,5,8,-4,4,18,11,4,-1,2,2,5,9,1,-2,1,2,13,2,3,1,1,-18,-9,-9,0,5,-5,11,-2,-10,5,-22,-1,7,2,-6,-1,-11,0,4,-4,-4,6,-11,-1,6,9,-9,-3,-2,-1,6,5,-4,-2,0,0,0,4,-5,-1,-2,-1,-12,11,-23,17,9,8,-3,-2,-7,-4,9,-3,2,-3,8,2,7,-4,-5,1,-15,-6,2,1,4,4,3,4,1,0,2,1,2,3,0,1,2,3,1,1,1,-1,-67,-35,-32,-39,-12,-27,6,-4,-35,-6,-15,-12,-1,4,-11,-9,-10,-7,7,-8,-24,3,-5,-5,-4,3,-25,-5,-8,0,0,4,-8,-6,-2,0,-4,-1,-17,1,-6,0,-13,-2,-11,40,21,19,-9,7,-5,-4,1,-1,-5,5,3,-3,0,1,-4,2,-8,-1,1,-2,4,10,18,5,2,1,0,5,12,3,1,0,4,5,6,2,1,1,95,46,49,61,29,32,17,22,29,8,5,10,9,8,12,10,1,4,8,14,17,-2,4,6,7,19,24,7,3,0,5,6,11,5,1,0,2,13,13,2,2,0,80,29,51,61,20,41,11,24,4,15,24,-3,3,8,3,-6,17,0,8,16,1,21,7,-3,9,25,14,6,4,1,1,11,8,-4,2,0,8,14,6,10,2,1
48,48903,Loiu,1898,123,77,46,37,31,6,51,20,10,38,4,-1,35,13,7,18,2,2,16,7,3,20,2,-3,18,14,3,1,1,0,18,12,0,0,1,0,0,2,3,1,0,0,281,245,36,238,230,8,70,177,11,11,8,4,62,173,7,2,5,-4,8,4,4,9,3,8,62,171,4,1,0,0,60,169,1,0,0,0,2,2,3,1,0,0,44,35,9,108,104,4,59,-10,-13,-4,-1,11,56,-10,-5,-7,0,-1,3,0,-8,3,-1,12,65,39,2,2,-1,1,65,39,0,0,0,0,0,0,2,2,-1,1,60,50,10,94,88,6,44,1,16,15,-5,-13,44,-7,9,7,-2,-1,0,8,7,8,-3,-12,40,47,4,3,0,0,41,43,3,1,0,0,-1,4,1,2,0,0,28,6,22,39,32,7,47,-81,19,26,14,3,42,-80,11,18,9,4,5,-1,8,8,5,-1,39,-10,1,9,0,0,37,-13,1,7,0,0,2,3,0,2,0,0,15,8,7,90,82,8,32,-16,1,-5,8,-5,27,-17,0,-4,4,-2,5,1,1,-1,4,-3,34,54,8,-6,0,0,32,53,4,-6,-1,0,2,1,4,0,1,0,-16,-32,16,65,51,14,49,-59,1,-2,-5,-4,42,-56,-7,-6,-3,-4,7,-3,8,4,-2,0,39,19,5,2,-1,1,36,14,1,1,-1,0,3,5,4,1,0,1,-19,-13,-6,49,39,10,16,-30,-2,-15,-3,15,19,-30,2,-5,-2,3,-3,0,-4,-10,-1,12,26,14,6,2,0,1,23,13,2,1,0,0,3,1,4,1,0,1,138,101,37,98,86,12,39,-4,48,33,10,10,37,-11,35,27,9,4,2,7,13,6,1,6,39,28,13,13,4,0,37,26,12,8,3,0,2,2,1,5,1,0,252,123,129,35,33,2,31,3,59,56,4,95,25,-4,36,25,4,33,6,7,23,31,0,62,11,23,2,-1,-1,0,10,21,2,0,0,0,1,2,0,-1,-1,0,-33,-21,-12,40,38,2,29,-45,-3,-11,-5,1,30,-45,-6,1,1,-3,-1,0,3,-12,-6,4,24,11,4,1,1,-1,23,11,2,2,1,-1,1,0,2,-1,0,0,6,-12,18,34,25,9,25,-32,4,-1,0,7,21,-35,0,0,-1,2,4,3,4,-1,1,5,12,14,4,3,0,1,11,11,3,0,0,0,1,3,1,3,0,1,15,-1,16,22,23,-1,23,-24,11,0,-4,8,15,-29,7,2,-2,4,8,5,4,-2,-2,4,10,17,-2,-2,0,-1,10,16,0,-2,0,-1,0,1,-2,0,0,0,-88,-31,-57,5,6,-1,16,-30,-7,-13,-5,-47,19,-25,-3,-4,-3,-13,-3,-5,-4,-9,-2,-34,10,2,-1,-3,-2,-1,10,2,-1,-3,-1,-1,0,0,0,0,-1,0,22,-13,35,6,2,4,22,0,-3,2,-8,5,13,-6,-6,-6,-7,-1,9,6,3,8,-1,6,13,8,-2,-8,-4,-1,9,6,-3,-7,-3,0,4,2,1,-1,-1,-1,-24,-14,-10,35,31,4,16,-25,-6,-15,-2,9,32,-29,-5,-12,-3,4,-16,4,-1,-3,1,5,26,9,2,0,-2,0,27,9,-1,-2,-2,0,-1,0,3,2,0,0,14,27,-13,32,27,5,22,5,-1,-11,-1,1,27,7,3,-10,-1,-1,-5,-2,-4,-1,0,2,19,17,0,-5,-1,1,16,16,-2,-4,-1,1,3,1,2,-1,0,0,82,46,36,68,53,15,65,-6,0,14,11,-3,52,-20,-1,9,5,1,13,14,1,5,6,-4,19,33,8,2,5,1,17,26,3,3,3,1,2,7,5,-1,2,0
48,48060,Markina-Xemein,4699,44,25,19,17,10,7,3,14,4,13,6,3,3,3,3,10,4,2,0,11,1,3,2,1,1,3,3,5,3,1,1,1,2,3,2,1,0,2,1,2,1,0,44,29,15,29,19,10,7,5,16,9,4,3,5,5,11,5,4,-1,2,0,5,4,0,4,11,4,4,5,4,1,7,4,3,3,2,0,4,0,1,2,2,1,52,48,4,40,29,11,8,5,36,10,-5,-3,5,6,31,8,-1,-1,3,-1,5,2,-4,-2,7,8,20,4,1,0,3,6,15,3,2,0,4,2,5,1,-1,0,47,37,10,40,32,8,2,20,18,0,2,6,0,22,11,-3,4,3,2,-2,7,3,-2,3,2,15,17,2,2,2,2,14,12,2,2,0,0,1,5,0,0,2,83,76,7,48,32,16,15,15,32,25,0,-3,8,8,35,18,4,2,7,7,-3,7,-4,-5,8,8,13,12,5,2,4,4,12,6,4,2,4,4,1,6,1,0,-250,-122,-128,71,35,36,-9,1,-21,-65,-65,-91,-13,3,0,-32,-36,-44,4,-2,-21,-33,-29,-47,19,20,20,8,2,1,9,10,9,6,0,1,10,10,11,2,2,0,110,88,22,120,84,36,16,35,41,23,-16,9,10,29,40,14,-8,3,6,6,1,9,-8,6,16,41,42,18,-2,3,9,28,38,9,-1,1,7,13,4,9,-1,2,111,94,17,95,70,25,3,39,45,14,4,3,4,31,39,9,4,6,-1,8,6,5,0,-3,12,26,36,11,5,2,5,20,30,9,3,2,7,6,6,2,2,0,145,96,49,65,30,35,21,18,50,36,10,8,15,8,32,30,6,3,6,10,18,6,4,5,13,15,22,12,2,0,9,5,6,9,0,0,4,10,16,3,2,0,-15,-27,12,18,5,13,2,5,-13,1,-9,-2,2,2,-18,-5,-9,-1,0,3,5,6,0,-1,6,8,1,1,1,0,3,5,-3,0,-1,0,3,3,4,1,2,0,34,13,21,15,8,7,14,0,10,-4,4,5,8,-2,9,-7,1,1,6,2,1,3,3,4,9,2,3,-3,2,1,5,2,1,-4,2,1,4,0,2,1,0,0,-5,-37,32,19,6,13,15,-2,-25,-4,-3,9,7,-5,-27,-12,-4,3,8,3,2,8,1,6,2,7,2,3,-1,2,-1,3,1,1,-1,1,3,4,1,2,0,1,-1,-1,0,-15,-5,-10,-2,-5,15,-9,2,-3,-2,-4,6,-5,3,0,0,-1,9,-4,-1,-3,-6,-3,1,-1,-3,-2,-1,-2,1,0,-1,-1,-5,-1,0,-1,-2,-1,-5,-8,3,10,2,8,5,-1,-5,-6,-7,9,4,2,-9,0,-7,2,1,-3,4,-6,0,7,-1,5,6,-4,-2,6,-1,5,1,-3,-3,3,0,0,5,-1,1,3,-5,-5,0,24,17,7,-2,3,2,-11,6,-4,-5,10,0,-15,5,-2,3,-7,2,4,1,-2,2,5,10,4,6,-3,-1,5,13,-1,2,-1,3,0,-3,5,4,-2,-15,-24,9,5,-1,6,-4,7,8,-11,-14,-2,-5,-6,-1,-8,-4,0,1,13,9,-3,-10,-2,-4,9,5,1,-4,-2,-2,2,-3,3,-1,0,-2,7,8,-2,-3,-2,29,28,1,53,39,14,6,12,31,-8,-2,-10,7,12,20,0,-5,-6,-1,0,11,-8,3,-4,1,24,28,-2,2,-3,5,12,19,3,0,-1,-4,12,9,-5,2,-2,-71,-55,-16,-17,-24,7,-10,-5,-18,-23,-9,-4,-5,-4,-18,-21,-8,0,-5,-1,0,-2,-1,-4,0,0,-14,-7,2,1,-1,1,-15,-9,-1,0,1,-1,1,2,3,1
48,48069,Mungia,13396,143,69,74,79,32,47,36,13,41,43,-3,11,17,8,17,23,3,2,19,5,24,20,-6,9,15,15,31,15,3,0,5,8,12,6,1,0,10,7,19,9,2,0,126,66,60,89,40,49,4,27,71,11,0,10,9,17,31,4,-4,7,-5,10,40,7,4,3,16,18,35,14,4,1,10,11,14,3,1,0,6,7,21,11,3,1,248,108,140,126,47,79,51,14,92,32,28,27,7,7,47,21,19,7,44,7,45,11,9,20,36,21,29,23,9,8,10,11,8,9,6,3,26,10,21,14,3,5,199,105,94,98,43,55,12,45,113,22,-19,27,7,20,66,16,-13,6,5,25,47,6,-6,21,11,23,39,15,7,3,4,13,16,7,2,1,7,10,23,8,5,2,391,195,196,141,51,90,64,44,233,56,-8,-6,34,15,119,29,-1,-6,30,29,114,27,-7,0,33,32,54,13,9,-1,17,9,16,5,4,0,16,23,38,8,5,-1,188,91,97,103,31,72,24,37,80,26,3,15,22,23,36,-1,2,7,2,14,44,27,1,8,18,26,27,26,5,1,9,10,4,5,2,1,9,16,23,21,3,0,282,116,166,157,61,96,40,32,121,58,7,23,22,14,52,22,1,5,18,18,69,36,6,18,32,31,59,23,8,2,15,10,25,6,4,0,17,21,34,17,4,2,371,181,190,158,67,91,99,52,116,82,11,7,53,19,55,47,4,3,46,33,61,35,7,4,33,43,46,25,5,3,17,16,23,10,-1,2,16,27,23,15,6,1,253,125,128,176,92,84,33,54,116,47,17,-14,7,47,54,21,1,-7,26,7,62,26,16,-7,38,45,58,27,8,0,20,27,31,12,2,0,18,18,27,15,6,0,246,134,112,74,35,39,56,48,56,58,15,10,44,26,28,34,3,0,12,22,28,24,12,10,13,26,23,5,5,0,10,17,7,3,-3,0,3,9,16,2,8,0,147,50,97,33,-7,40,22,39,43,31,2,9,3,-6,23,8,11,7,19,45,20,23,-9,2,26,17,-7,7,-5,-7,13,5,-13,-8,-3,-2,13,12,6,15,-2,-5,133,91,42,32,-3,35,44,34,42,17,-8,8,26,25,35,10,-6,3,18,9,7,7,-2,5,8,8,11,2,0,2,1,0,-3,-1,-2,2,7,8,14,3,2,0,10,-20,30,-60,-57,-3,24,14,0,-5,-31,8,-1,2,-3,4,-26,2,25,12,3,-9,-5,6,6,8,-41,-29,-4,-1,-3,1,-29,-21,-5,0,9,7,-12,-8,1,-1,20,-1,21,-23,-19,-4,14,-13,1,42,-20,-4,9,-11,-7,23,-9,-4,5,-2,8,19,-11,0,0,1,-8,-3,-12,-2,1,0,-9,-5,-6,-1,-1,1,1,2,-6,-1,41,-1,42,-4,-5,1,11,19,24,3,-12,-6,1,11,9,-8,-8,-6,10,8,15,11,-4,0,0,10,-1,-11,-4,2,5,2,1,-11,-4,2,-5,8,-2,0,0,0,65,15,50,4,-5,9,55,-7,-27,30,11,0,31,5,-28,0,4,-1,24,-12,1,30,7,1,12,4,-4,-6,-1,-1,8,0,-8,-5,0,0,4,4,4,-1,-1,-1,84,43,41,-9,-15,6,29,26,-17,32,3,11,21,18,-11,11,1,4,8,8,-6,21,2,7,1,12,-8,-8,-1,-3,0,7,-5,-11,-2,-2,1,5,-3,3,1,-1,135,87,48,128,65,63,41,21,12,44,29,-8,26,8,-6,42,19,-2,15,13,18,2,10,-6,27,34,28,28,7,5,17,9,11,19,7,2,10,25,17,9,0,3
48,48071,Muskiz,6196,54,31,23,8,4,4,16,12,26,5,5,-9,12,5,13,2,7,-6,4,7,13,3,-2,-3,2,2,1,1,2,0,1,1,0,1,1,0,1,1,1,0,1,0,23,11,12,14,8,6,0,12,20,0,-6,-4,4,6,9,-2,-4,-3,-4,6,11,2,-2,-1,2,3,9,0,0,0,1,1,6,0,0,0,1,2,3,0,0,0,29,3,26,7,2,5,1,7,1,0,7,11,-1,4,-4,-4,1,5,2,3,5,4,6,6,6,2,0,0,-1,0,3,0,-1,0,0,0,3,2,1,0,-1,0,53,26,27,32,15,17,13,14,19,3,12,-10,10,8,4,-2,6,-2,3,6,15,5,6,-8,5,5,16,4,2,0,3,3,6,2,1,0,2,2,10,2,1,0,79,60,19,14,6,8,7,19,21,29,4,2,8,9,23,18,4,-1,-1,10,-2,11,0,3,5,4,1,3,1,0,4,0,0,1,1,0,1,4,1,2,0,0,79,33,46,41,12,29,-8,26,50,9,6,2,-8,10,23,2,8,2,0,16,27,7,-2,0,5,17,11,5,3,0,1,3,3,3,2,0,4,14,8,2,1,0,117,78,39,20,-1,21,25,22,36,19,4,8,15,16,13,20,8,4,10,6,23,-1,-4,4,1,2,13,3,-1,1,0,0,-2,1,-1,0,1,2,15,2,0,1,152,76,76,38,12,26,17,27,74,23,10,0,6,10,43,14,2,1,11,17,31,9,8,-1,6,11,13,7,1,-1,1,6,5,1,0,-1,5,5,8,6,1,0,110,62,48,25,10,15,29,0,67,15,-3,0,17,2,43,5,-1,-5,12,-2,24,10,-2,5,10,10,6,-1,-1,0,6,1,4,-1,0,0,4,9,2,0,-1,0,104,67,37,18,21,-3,9,35,26,13,14,9,6,17,14,17,12,2,3,18,12,-4,2,7,12,7,3,-5,0,1,9,5,6,0,0,1,3,2,-3,-5,0,0,51,12,39,-2,-5,3,16,3,8,7,2,16,10,1,2,-1,-3,2,6,2,6,8,5,14,3,-1,-4,-1,2,-1,2,-1,-2,-4,1,-1,1,0,-2,3,1,0,102,44,58,27,14,13,20,17,40,-15,15,25,9,11,18,-18,13,8,11,6,22,3,2,17,4,7,5,4,3,2,2,4,3,1,1,1,2,3,2,3,2,1,66,20,46,-8,-6,-2,7,3,18,4,20,12,1,-1,6,-1,9,4,6,4,12,5,11,8,-2,-2,-7,2,2,-1,-3,-2,-6,3,2,0,1,0,-1,-1,0,-1,-23,-23,0,-16,-11,-5,6,-8,-27,0,6,8,1,-6,-12,-8,6,1,5,-2,-15,8,0,7,1,0,-2,-5,-8,-2,0,0,-1,-4,-5,-1,1,0,-1,-1,-3,-1,26,19,7,8,5,3,8,-2,7,9,-9,12,10,-1,1,5,-1,5,-2,-1,6,4,-8,7,4,2,4,-5,0,1,3,1,3,-3,-1,1,1,1,1,-2,1,0,-13,-4,-9,6,4,2,-9,-5,1,-4,-3,13,-10,0,7,1,-5,7,1,-5,-6,-5,2,6,1,-1,6,0,-1,1,0,0,4,1,-2,1,1,-1,2,-1,1,0,3,-11,14,18,7,11,-5,4,-20,17,-4,12,-3,-1,-18,5,-2,9,-2,5,-2,12,-2,3,4,4,8,1,0,0,2,3,1,0,0,0,2,1,7,1,0,0,-9,-5,-4,16,2,14,-9,16,-16,-20,-5,30,6,8,-14,-7,-2,8,-15,8,-2,-13,-3,22,3,4,6,0,2,0,1,3,-1,-1,0,0,2,1,7,1,2,0
48,48073,Ondarroa,10013,-63,-2,-61,47,38,9,-8,3,-46,3,-7,-8,-8,15,-10,8,-5,-2,0,-12,-36,-5,-2,-6,7,15,12,11,2,0,3,14,9,10,2,0,4,1,3,1,0,0,-24,5,-29,67,49,18,4,-3,-30,17,-12,1,2,0,-10,18,-3,-2,2,-3,-20,-1,-9,3,5,12,22,23,3,2,2,11,17,16,3,0,3,1,5,7,0,2,-11,22,-33,104,88,16,-7,4,-8,3,1,-5,-4,12,2,8,5,-2,-3,-8,-10,-5,-4,-3,6,26,44,19,8,0,2,22,40,17,7,0,4,4,4,2,1,0,-22,29,-51,157,132,25,-1,6,-7,11,-20,-10,-4,10,18,20,-13,-1,3,-4,-25,-9,-7,-9,13,32,72,36,2,1,5,24,67,33,2,1,8,8,5,3,0,0,-178,-114,-64,43,32,11,-22,-16,-90,-33,-17,-1,-13,-3,-63,-22,-14,1,-9,-13,-27,-11,-3,-2,2,12,18,6,2,1,0,10,12,6,2,1,2,2,6,0,0,0,-134,-95,-39,67,42,25,21,-9,-94,-25,-15,-14,14,-3,-67,-18,-11,-10,7,-6,-27,-7,-4,-4,18,13,19,10,4,1,13,10,9,8,2,0,5,3,10,2,2,1,-117,-53,-64,58,39,19,-9,-17,-54,-22,-14,-1,-6,-6,-21,-9,-10,-2,-3,-11,-33,-13,-4,1,11,11,20,11,3,1,4,8,18,8,1,1,7,3,2,3,2,0,-46,-18,-28,81,59,22,-6,14,-20,-7,-17,-9,-6,12,-2,-4,-10,-5,0,2,-18,-3,-7,-4,8,27,27,12,4,1,6,21,19,10,2,0,2,6,8,2,2,1,-22,5,-27,59,34,25,0,-4,2,3,-15,-12,3,2,8,6,-11,-5,-3,-6,-6,-3,-4,-7,14,6,27,6,5,0,8,3,17,3,3,0,6,3,10,3,2,0,-50,-27,-23,-8,-13,5,-3,-4,-11,-18,-2,-8,0,-1,-6,-12,-4,-2,-3,-3,-5,-6,2,-6,4,4,-6,-11,0,1,3,1,-8,-9,0,0,1,3,2,-2,0,1,17,8,9,26,15,11,20,2,-14,11,-4,-4,12,8,-20,12,-4,-1,8,-6,6,-1,0,-3,7,6,4,2,5,1,4,5,1,2,2,1,3,1,3,0,3,0,35,27,8,40,22,18,7,10,-4,10,5,3,9,9,0,10,-1,-1,-2,1,-4,0,6,4,17,7,7,11,-1,-3,12,4,2,8,-2,-2,5,3,5,3,1,-1,-60,-26,-34,29,25,4,4,6,-16,-27,-13,-15,0,8,-9,-14,-6,-7,4,-2,-7,-13,-7,-8,5,6,13,4,1,-1,4,7,11,2,2,-1,1,-1,2,2,-1,0,-32,-35,3,-2,-3,1,1,4,-22,-9,-6,-2,-7,-1,-16,-9,-6,4,8,5,-6,0,0,-6,-1,5,-1,-1,-2,-2,-1,4,-1,0,-4,-1,0,1,0,-1,2,-1,30,41,-11,15,10,5,10,-9,3,27,-2,1,7,1,7,27,-3,2,3,-10,-4,0,1,-1,1,6,8,0,-3,3,0,4,6,0,-2,2,1,2,2,0,-1,1,15,7,8,25,21,4,-2,2,12,6,1,-1,-4,0,11,9,-3,-2,2,2,1,-3,4,1,0,4,17,1,-2,3,0,2,13,3,-1,3,0,2,4,-2,-1,0,16,-5,21,40,27,13,26,20,-9,-1,-11,-10,15,16,-22,-6,-4,-3,11,4,13,5,-7,-7,10,21,13,-5,-1,2,9,12,6,-2,0,2,1,9,7,-3,-1,0,-10,-20,10,16,11,5,24,-4,-11,-8,-2,-10,8,-3,-5,-4,-8,-7,16,-1,-6,-4,6,-3,8,8,3,-7,3,1,5,6,3,-5,2,0,3,2,0,-2,1,1
48,48083,Ortuella,8791,-41,-38,-3,10,2,8,-3,-10,-27,9,-6,0,-12,-9,-16,4,-6,2,9,-1,-11,5,0,-2,2,2,1,1,2,2,0,1,0,0,0,1,2,1,1,1,2,1,-4,13,-17,7,3,4,0,11,4,-14,-4,1,-2,13,5,-3,1,-3,2,-2,-1,-11,-5,4,0,1,4,1,0,0,0,0,1,1,0,0,0,1,3,0,0,0,-28,-21,-7,6,2,4,-7,15,-27,-7,-8,1,-6,4,-21,1,-2,0,-1,11,-6,-8,-6,1,4,3,-2,4,-2,-1,2,2,0,1,-2,-1,2,1,-2,3,0,0,-96,-63,-33,10,4,6,-4,7,-59,-9,-17,-12,-4,6,-36,-8,-11,-9,0,1,-23,-1,-6,-3,2,1,3,4,0,0,1,2,-1,2,0,0,1,-1,4,2,0,0,-79,-32,-47,11,2,9,-3,-11,-22,-22,-14,-6,-3,-11,3,-16,-3,-4,0,0,-25,-6,-11,-2,3,5,1,2,0,0,0,0,0,1,1,0,3,5,1,1,-1,0,59,24,35,20,9,11,16,17,8,21,4,-5,10,6,3,7,1,-1,6,11,5,14,3,-4,2,7,4,3,3,1,2,3,2,1,1,0,0,4,2,2,2,1,-33,-16,-17,11,5,6,-9,4,-4,1,-12,-9,0,1,-5,0,-6,-3,-9,3,1,1,-6,-6,4,4,5,1,-1,-2,2,1,2,0,0,0,2,3,3,1,-1,-2,-65,-38,-27,6,3,3,-8,-19,-29,-32,-6,27,-7,-9,-10,-19,1,5,-1,-10,-19,-13,-7,22,3,-2,5,2,-2,0,2,-2,3,0,0,0,1,0,2,2,-2,0,39,24,15,15,5,10,14,13,-5,-3,11,8,2,0,2,1,4,11,12,13,-7,-4,7,-3,4,1,6,2,1,1,2,0,2,1,0,0,2,1,4,1,1,1,-30,-6,-24,12,4,8,-7,-23,-18,-1,2,21,6,-7,-5,-2,0,5,-13,-16,-13,1,2,16,-1,5,7,-1,2,0,0,0,4,-1,1,0,-1,5,3,0,1,0,6,15,-9,16,11,5,-5,26,-14,-23,3,20,-2,12,-3,-10,6,10,-3,14,-11,-13,-3,10,0,6,5,3,0,1,-1,4,4,2,0,1,1,2,1,1,0,0,32,13,19,6,1,5,13,4,-19,25,-7,14,10,3,-21,16,-3,6,3,1,2,9,-4,8,1,1,2,3,-1,0,1,2,-1,0,-1,0,0,-1,3,3,0,0,17,19,-2,11,4,7,12,9,-18,-7,7,14,13,12,-14,-5,9,4,-1,-3,-4,-2,-2,10,2,1,4,2,1,0,1,0,4,-1,0,0,1,1,0,3,1,0,28,14,14,7,5,2,-1,10,25,-10,1,0,3,2,12,-2,-5,3,-4,8,13,-8,6,-3,3,2,3,-3,2,0,2,1,3,-2,1,0,1,1,0,-1,1,0,37,33,4,5,5,0,1,7,44,-14,3,-10,2,10,28,-9,3,-4,-1,-3,16,-5,0,-6,0,-1,1,2,2,0,3,0,-1,2,1,0,-3,-1,2,0,1,0,27,16,11,4,-1,5,-6,1,26,14,-2,-5,2,-6,17,15,-6,-5,-8,7,9,-1,4,0,-1,3,3,-4,2,1,-1,0,1,-1,0,0,0,3,2,-3,2,1,32,11,21,6,-2,8,17,3,26,-6,-6,-4,9,0,11,-3,-8,1,8,3,15,-3,2,-5,2,8,0,1,-4,-1,-1,3,0,0,-3,-1,3,5,0,1,-1,0,13,-10,23,22,11,11,-17,12,-9,27,-3,3,-8,1,-6,11,-4,-1,-9,11,-3,16,1,4,1,8,4,4,3,2,1,4,1,4,1,0,0,4,3,0,2,2
48,48077,Plentzia,3463,61,44,17,18,9,9,-6,16,45,14,-2,-4,3,6,23,12,3,-1,-9,10,22,2,-5,-3,3,2,8,5,0,0,2,0,5,2,0,0,1,2,3,3,0,0,36,11,25,26,9,17,3,-2,5,21,11,-2,3,0,-8,14,1,1,0,-2,13,7,10,-3,2,4,10,7,2,1,2,1,2,3,0,1,0,3,8,4,2,0,106,47,59,19,10,9,20,16,17,27,22,-2,5,1,12,18,12,-4,15,15,5,9,10,2,3,3,10,1,1,0,3,0,5,1,0,0,0,3,5,0,1,0,145,69,76,37,19,18,32,13,23,57,2,12,14,7,11,26,2,7,18,6,12,31,0,5,8,4,10,11,2,0,5,1,4,7,0,0,3,3,6,4,2,0,43,24,19,33,15,18,7,6,25,7,1,-4,7,11,17,-7,-3,-2,0,-5,8,14,4,-2,5,13,9,3,0,2,2,8,3,1,0,1,3,5,6,2,0,1,85,31,54,34,11,23,30,-7,28,28,0,2,10,-3,10,17,-5,1,20,-4,18,11,5,1,7,7,7,9,3,1,4,2,2,4,-1,0,3,5,5,5,4,1,-1,4,-5,-8,1,-9,26,-15,-11,4,1,-5,15,-10,-11,9,1,1,11,-5,0,-5,0,-6,6,-2,-3,-8,-1,-1,3,1,0,-3,0,0,3,-3,-3,-5,-1,-1,-17,10,-27,-3,0,-3,-21,-10,24,-1,-6,-5,-8,-3,13,15,-4,-5,-13,-7,11,-16,-2,0,2,-2,-3,0,0,0,2,0,-1,0,-1,0,0,-2,-2,0,1,0,-22,-5,-17,16,2,14,-15,-2,12,-4,-10,2,-8,1,9,-2,-4,0,-7,-3,3,-2,-6,2,3,6,2,3,2,0,1,1,2,-2,0,0,2,5,0,5,2,0,28,28,0,9,4,5,16,12,4,6,-1,-11,9,4,16,5,-4,-5,7,8,-12,1,3,-6,1,6,4,-3,1,0,0,2,3,-1,0,0,1,4,1,-2,1,0,5,-11,16,2,1,1,6,-9,19,11,-17,-6,-2,-1,2,-5,-4,-3,8,-8,17,16,-13,-3,-1,3,-4,4,0,0,0,1,-3,3,0,0,-1,2,-1,1,0,0,12,10,2,9,1,8,21,16,4,4,-16,-11,6,8,2,-3,0,-3,15,8,2,7,-16,-8,7,7,0,0,-4,-1,3,2,-2,-1,-1,0,4,5,2,1,-3,-1,-13,-7,-6,6,3,3,9,1,7,2,-13,-16,11,0,8,-9,-8,-7,-2,1,-1,11,-5,-9,5,1,4,-3,0,-1,1,-1,3,0,0,0,4,2,1,-3,0,-1,-5,5,-10,-1,-1,0,-5,-5,21,-12,-1,2,-1,-3,13,-2,1,2,-4,-2,8,-10,-2,0,1,-1,2,2,-5,0,0,0,1,0,-2,0,1,-1,1,2,-3,0,-27,0,-27,8,10,-2,6,3,-10,-11,-11,-3,11,1,1,-3,-8,-3,-5,2,-11,-8,-3,0,4,0,1,2,1,0,4,2,2,2,-1,1,0,-2,-1,0,2,-1,-17,-10,-7,9,5,4,-11,12,-10,1,4,-13,-5,6,-10,5,-1,-4,-6,6,0,-4,5,-9,-2,7,2,-1,3,0,2,0,2,0,1,0,-4,7,0,-1,2,0,56,21,35,24,8,16,12,13,14,23,-5,-1,3,2,14,7,-4,-2,9,11,0,16,-1,1,5,7,7,0,4,0,1,3,2,0,2,-1,4,4,5,0,2,1,-19,0,-19,34,15,19,-7,17,-4,-21,4,-6,-2,11,0,-14,3,1,-5,6,-4,-7,1,-7,4,11,6,9,4,0,3,5,3,3,1,0,1,6,3,6,3,0
48,48078,Portugalete,53241,-399,-242,-157,79,38,41,-13,-46,-144,-74,-84,-37,-1,-24,-94,-43,-53,-26,-12,-22,-50,-31,-31,-11,7,23,25,19,2,2,6,9,9,12,0,1,1,14,16,7,2,1,-505,-235,-270,88,41,47,-13,-71,-268,-88,-56,-12,-24,-29,-112,-52,-20,0,11,-42,-156,-36,-36,-12,23,22,28,10,3,1,9,8,17,3,2,1,14,14,11,7,1,0,-524,-282,-242,44,21,23,-45,-55,-201,-113,-67,-40,-22,-33,-94,-60,-49,-19,-23,-22,-107,-53,-18,-21,13,4,1,13,7,5,4,0,6,4,3,3,9,4,-5,9,4,2,-478,-260,-218,77,36,41,1,-34,-252,-74,-72,-44,-15,1,-148,-40,-28,-27,16,-35,-104,-34,-44,-17,17,13,30,9,6,2,7,7,15,4,3,0,10,6,15,5,3,2,-469,-253,-216,126,53,73,25,-17,-255,-90,-95,-49,16,7,-147,-51,-49,-35,9,-24,-108,-39,-46,-14,35,35,27,14,9,1,19,13,12,4,3,0,16,22,15,10,6,1,-537,-326,-211,149,63,86,14,-67,-323,-132,-58,25,22,-33,-188,-95,-35,3,-8,-34,-135,-37,-23,22,34,33,38,24,12,5,17,16,14,9,4,2,17,17,24,15,8,3,-593,-335,-258,107,43,64,-36,-6,-339,-110,-79,-32,-30,-6,-187,-60,-38,-21,-6,0,-152,-50,-41,-11,37,23,28,17,1,1,13,8,11,9,2,0,24,15,17,8,-1,1,-67,-55,-12,198,67,131,70,19,-65,-5,-42,-47,22,-5,-49,1,-7,-15,48,24,-16,-6,-35,-32,48,40,51,41,11,6,13,13,15,17,8,2,35,27,36,24,3,4,-42,-14,-28,187,93,94,52,62,-80,-31,-11,-53,18,34,-50,-4,-5,-27,34,28,-30,-27,-6,-26,35,43,60,31,12,1,17,16,34,16,7,-1,18,27,26,15,5,2,-61,-49,-12,166,84,82,10,65,-42,-29,-52,-27,0,31,-21,-38,-19,-9,10,34,-21,9,-33,-18,41,41,55,33,-6,2,25,17,28,14,-1,2,16,24,27,19,-5,0,-8,2,-10,131,59,72,55,42,-23,11,-32,-62,31,22,6,-1,-24,-29,24,20,-29,12,-8,-33,29,30,37,21,11,1,14,15,15,10,2,1,15,15,22,11,9,0,139,74,65,169,85,84,45,20,44,34,7,-28,18,-10,53,14,-2,-5,27,30,-9,20,9,-23,37,43,48,23,15,3,22,21,24,11,6,1,15,22,24,12,9,2,-121,-78,-43,60,22,38,-50,-6,-3,-54,-16,3,-39,-2,-1,-33,-11,4,-11,-4,-2,-21,-5,-1,10,23,28,-3,-3,3,6,10,17,-11,-2,0,4,13,11,8,-1,3,36,34,2,-26,-8,-18,52,0,-52,26,14,-17,33,16,-49,17,10,-5,19,-16,-3,9,4,-12,7,-2,-16,-16,-4,3,7,3,-9,-9,-1,0,0,-5,-7,-7,-3,3,-112,-89,-23,3,6,-3,21,17,-72,-34,-9,-42,29,2,-67,-15,-14,-25,-8,15,-5,-19,5,-17,7,11,-7,-8,-1,1,12,2,-9,0,1,1,-5,9,2,-8,-2,0,-76,-10,-66,61,18,43,-49,-2,-57,35,28,-40,-14,1,-55,34,25,-11,-35,-3,-2,1,3,-29,-10,12,31,19,5,1,-10,1,13,10,1,1,0,11,18,9,4,0,112,26,86,148,62,86,41,39,7,35,9,-20,18,4,12,7,-7,-7,23,35,-5,28,16,-13,19,37,39,35,8,6,8,17,18,12,1,2,11,20,21,23,7,4,9,15,-6,187,88,99,44,15,-33,-2,21,-28,30,4,-16,-7,15,-7,14,11,-17,5,6,-21,42,35,59,32,16,1,20,14,28,18,6,0,22,21,31,14,10,1
48,48082,Santurtzi,48515,-244,-140,-104,81,38,43,-5,-21,-99,-55,-57,-8,-13,-7,-44,-40,-30,-6,8,-14,-55,-15,-27,-2,15,14,33,12,5,1,8,3,18,6,3,0,7,11,15,6,2,1,-166,-143,-23,71,32,39,-7,11,-54,-30,-52,-27,-9,-18,-32,-33,-31,-19,2,29,-22,3,-21,-8,16,11,27,7,3,7,8,6,12,3,0,3,8,5,15,4,3,4,-300,-147,-153,73,42,31,-26,-54,-100,-60,-30,-21,-14,-17,-43,-28,-26,-13,-12,-37,-57,-32,-4,-8,6,14,31,13,5,3,3,10,18,10,1,0,3,4,13,3,4,3,-62,-3,-59,148,69,79,19,16,-47,-15,0,-20,11,-1,-10,6,4,-4,8,17,-37,-21,-4,-16,29,39,39,15,15,8,14,12,25,7,6,3,15,27,14,8,9,5,101,34,67,168,74,94,57,55,-6,30,1,-32,15,19,3,6,8,-14,42,36,-9,24,-7,-18,27,43,56,25,11,3,10,18,23,14,7,1,17,25,33,11,4,2,218,116,102,214,99,115,72,41,94,69,-20,-39,26,14,72,36,-5,-22,46,27,22,33,-15,-17,41,52,61,40,14,0,17,19,33,22,7,0,24,33,28,18,7,0,-72,-57,-15,236,107,129,66,4,-35,-26,-9,-71,27,-1,-27,-22,-6,-27,39,5,-8,-4,-3,-44,60,61,61,31,18,2,31,27,29,16,4,0,29,34,32,15,14,2,-67,-80,13,217,101,116,52,28,-111,11,-10,-31,11,16,-69,-8,-8,-19,41,12,-42,19,-2,-12,49,67,67,34,-3,1,17,33,37,16,-3,-1,32,34,30,18,0,2,32,87,-55,240,145,95,10,43,1,17,-15,-22,3,41,40,16,-6,-5,7,2,-39,1,-9,-17,40,77,67,32,21,3,19,46,50,17,11,2,21,31,17,15,10,1,225,130,95,135,77,58,66,57,95,23,10,-34,22,27,70,21,-1,-14,44,30,25,2,11,-20,16,30,56,25,6,-5,10,11,37,16,2,-2,6,19,19,9,4,-3,-23,-41,18,81,40,41,10,33,27,-36,-29,-30,-2,33,-4,-36,-12,-20,12,0,31,0,-17,-10,13,40,28,-1,0,0,7,23,18,-9,0,-1,6,17,10,8,0,1,174,76,98,140,61,79,29,80,20,24,25,1,19,46,3,16,-3,-1,10,34,17,8,28,2,26,38,35,23,9,8,16,21,15,5,0,3,10,17,20,18,9,5,-90,-25,-65,-6,-1,-5,-15,41,-49,-42,5,-26,-7,22,-14,-18,0,-3,-8,19,-35,-24,5,-23,2,18,9,-15,-14,-4,-1,3,13,-3,-9,-2,3,15,-4,-12,-5,-2,-288,-162,-126,-104,-55,-49,-44,-15,-107,-69,-14,-25,-3,-16,-69,-56,-7,-7,-41,1,-38,-13,-7,-18,-19,-4,-37,-25,-14,-8,-4,-3,-16,-23,-7,-4,-15,-1,-21,-2,-7,-4,-174,-102,-72,-35,-46,11,-7,-1,-104,15,-49,-17,-2,4,-64,-1,-24,-11,-5,-5,-40,16,-25,-6,-7,28,-34,-15,-6,0,-7,6,-29,-17,-1,1,0,22,-5,2,-5,-1,-77,-58,-19,96,40,56,46,-17,-26,-52,11,-27,19,-6,-21,-34,3,-15,27,-11,-5,-18,8,-12,30,31,25,-1,11,-2,15,14,12,-4,3,-2,15,17,13,3,8,0,-89,-69,-20,61,22,39,-13,37,-46,14,-28,-50,-4,19,-49,0,-17,-18,-9,18,3,14,-11,-32,13,26,15,6,0,-1,6,9,7,0,0,1,7,17,8,6,0,-2,201,63,138,135,51,84,85,51,82,25,-28,-27,35,19,37,1,-24,-11,50,32,45,24,-4,-16,35,41,45,2,6,0,18,13,20,-3,1,0,17,28,25,5,5,0
48,48084,Sestao,33288,-285,-133,-152,69,37,32,13,-24,-122,-73,-39,-39,15,-6,-64,-42,-16,-17,-2,-18,-58,-31,-23,-22,19,14,22,8,5,1,12,7,10,5,3,0,7,7,12,3,2,1,-283,-141,-142,76,33,43,-37,15,-126,-65,-39,-27,-24,4,-54,-35,-20,-9,-13,11,-72,-30,-19,-18,17,20,24,8,3,3,5,10,10,5,1,1,12,10,14,3,2,2,-490,-247,-243,62,24,38,-81,-21,-199,-34,-62,-79,-34,-12,-94,-18,-38,-41,-47,-9,-105,-16,-24,-38,7,18,20,16,-1,1,1,10,8,6,-1,0,6,8,12,10,0,1,-543,-267,-276,58,24,34,-107,-14,-198,-105,-51,-63,-54,-26,-83,-65,-13,-23,-53,12,-115,-40,-38,-40,10,17,9,14,3,3,4,4,5,6,1,2,6,13,4,8,2,1,-407,-227,-180,82,32,50,-27,-36,-173,-67,-50,-55,-29,-34,-73,-31,-34,-22,2,-2,-100,-36,-16,-33,29,19,26,2,2,2,13,6,10,1,0,2,16,13,16,1,2,0,-181,-86,-95,105,50,55,-1,31,-59,-71,-12,-64,-2,19,-41,-37,-9,-23,1,12,-18,-34,-3,-41,19,38,30,7,8,1,15,16,13,3,2,0,4,22,17,4,6,1,-241,-104,-137,124,50,74,-36,43,-102,-37,-65,-37,-19,16,-35,-25,-28,-13,-17,27,-67,-12,-37,-24,36,32,36,16,3,1,19,11,13,6,0,0,17,21,23,10,3,1,28,-10,38,177,93,84,35,47,-10,-18,-35,0,17,25,-2,-20,-13,-19,18,22,-8,2,-22,19,34,63,42,26,9,-1,15,33,28,9,6,0,19,30,14,17,3,-1,-72,-12,-60,178,99,79,-14,39,-9,-37,-11,-35,-8,16,28,-28,-8,-7,-6,23,-37,-9,-3,-28,42,51,59,19,6,-1,21,29,37,8,3,0,21,22,22,11,3,-1,-120,-33,-87,95,48,47,-15,25,-77,-18,-6,-35,-16,35,-29,-9,-4,-11,1,-10,-48,-9,-2,-24,30,44,3,10,8,-3,16,23,2,5,3,-2,14,21,1,5,5,-1,-42,4,-46,80,48,32,-26,72,3,-38,-32,-25,-10,35,12,-15,-9,-15,-16,37,-9,-23,-23,-10,24,29,19,10,-4,-1,14,12,12,10,-1,0,10,17,7,0,-3,-1,-41,-22,-19,48,25,23,-20,37,-22,3,-5,-40,-11,24,-11,6,-9,-22,-9,13,-11,-3,4,-18,9,18,8,2,8,0,5,4,7,5,4,-1,4,14,1,-3,4,1,-95,-64,-31,36,9,27,-14,-2,-20,-21,-16,-21,-8,4,-31,-18,-14,-1,-6,-6,11,-3,-2,-20,-3,16,20,-1,-2,1,1,5,9,-6,-4,2,-4,11,11,5,2,-1,-267,-138,-129,-59,-40,-19,-40,-24,-111,-59,-9,-23,-19,-14,-49,-32,-3,-16,-21,-10,-62,-27,-6,-7,-8,2,-23,-20,-7,-4,-4,0,-19,-9,-5,-3,-4,2,-4,-11,-2,-1,-67,-56,-11,20,7,13,2,18,-15,-43,-19,-26,2,12,-21,-34,-8,-17,0,6,6,-9,-11,-9,6,13,5,-4,-7,1,5,8,-2,-2,-5,-1,1,5,7,-2,-2,2,-68,12,-80,41,41,0,3,4,-38,-16,-1,-18,9,11,-10,3,5,-5,-6,-7,-28,-19,-6,-13,14,22,-3,2,7,-2,13,13,3,7,5,-1,1,9,-6,-5,2,-1,45,-5,50,111,50,61,29,80,-44,-3,-1,-17,18,39,-32,-18,-4,-11,11,41,-12,15,3,-6,20,50,14,14,6,3,9,29,4,6,0,0,11,21,10,8,6,3,-116,-25,-91,115,67,48,-37,48,-59,-44,2,-29,-15,27,-8,-27,-1,-2,-22,21,-51,-17,3,-27,13,38,42,8,5,4,8,17,35,-3,5,1,5,21,7,11,0,3
48,48904,Sondika,3854,66,39,27,13,7,6,14,9,21,14,6,0,5,7,13,8,4,1,9,2,8,6,2,-1,2,4,4,1,2,0,1,1,4,0,1,0,1,3,0,1,1,0,19,-3,22,17,10,7,0,0,3,8,5,4,-2,2,-3,0,3,-2,2,-2,6,8,2,6,2,3,6,3,2,1,2,3,2,2,1,0,0,0,4,1,1,1,138,78,60,15,10,5,25,15,48,40,0,4,16,5,29,23,-1,3,9,10,19,17,1,1,6,1,3,6,-1,0,5,1,1,4,-1,0,1,0,2,2,0,0,94,50,44,16,8,8,27,5,32,25,4,-4,12,1,14,15,4,1,15,4,18,10,0,-5,1,4,7,2,2,0,0,3,2,1,2,0,1,1,5,1,0,0,48,18,30,25,17,8,4,9,3,14,-1,23,2,3,1,10,-1,5,2,6,2,4,0,18,2,7,7,9,0,0,1,3,5,8,0,0,1,4,2,1,0,0,100,33,67,13,-1,14,22,27,15,23,5,4,15,11,-5,9,3,-2,7,16,20,14,2,6,2,7,5,-3,1,1,2,2,0,-5,0,0,0,5,5,2,1,1,56,31,25,30,9,21,5,7,21,0,7,11,4,4,15,1,2,2,1,3,6,-1,5,9,7,9,7,3,1,1,2,3,1,2,0,0,5,6,6,1,1,1,40,7,33,24,13,11,14,8,15,2,-4,2,7,1,5,-3,-3,0,7,7,10,5,-1,2,9,3,7,4,-1,1,3,3,4,3,0,0,6,0,3,1,-1,1,33,8,25,20,11,9,15,15,13,-6,-7,4,4,2,8,-5,-4,4,11,13,5,-1,-3,0,0,12,9,-3,0,3,2,5,5,-1,0,1,-2,7,4,-2,0,2,-8,0,-8,5,2,3,13,-3,-23,-2,-4,7,13,-1,-13,-4,-2,4,0,-2,-10,2,-2,3,6,0,-3,3,-1,-1,3,2,-1,-1,-1,0,3,-2,-2,4,0,-1,30,8,22,4,8,-4,6,10,4,7,-6,6,3,9,1,-1,-3,-2,3,1,3,8,-3,8,1,6,0,1,-4,0,3,4,0,1,0,0,-2,2,0,0,-4,0,12,-8,20,4,1,3,7,3,15,-10,-9,2,1,5,8,-12,-9,-4,6,-2,7,2,0,6,-2,6,2,1,1,-4,-1,2,0,0,1,-1,-1,4,2,1,0,-3,11,15,-4,1,-1,2,5,12,-3,-7,-4,6,9,7,3,-7,3,-1,-4,5,-6,0,-7,7,3,-3,1,-1,1,0,1,-4,1,0,1,0,2,1,0,-1,0,0,61,15,46,-8,-9,1,4,-1,16,15,12,8,-3,-3,4,4,4,5,7,2,12,11,8,3,1,-1,-8,0,-1,1,1,-2,-6,-1,-1,0,0,1,-2,1,0,1,-38,-18,-20,-4,-3,-1,-7,-2,-11,-13,-2,-4,-8,-2,1,-7,0,-3,1,0,-12,-6,-2,-1,-2,0,1,-3,0,0,-1,-1,1,-1,-1,0,-1,1,0,-2,1,0,10,-4,14,4,-4,8,-3,3,11,3,0,-5,3,-2,4,-4,-2,-3,-6,5,7,7,2,-2,2,5,-5,2,1,-1,1,1,-5,0,0,-1,1,4,0,2,1,0,-4,1,-5,14,8,6,1,4,4,-9,-1,-2,-2,7,2,4,-5,-2,3,-3,2,-13,4,0,4,3,6,1,0,0,2,3,1,2,0,0,2,0,5,-1,0,0,42,22,20,33,20,13,13,5,12,7,0,6,1,1,11,0,7,2,12,4,1,7,-7,4,13,4,5,9,2,0,8,0,5,4,3,0,5,4,0,5,-1,0
48,48085,Sopelana,9917,167,88,79,28,12,16,-9,13,125,20,14,3,5,2,66,17,6,-8,-14,11,59,3,8,11,6,9,6,4,3,0,6,3,1,1,1,0,0,6,5,3,2,0,322,143,179,65,29,36,47,59,155,38,6,12,19,26,81,11,3,0,28,33,74,27,3,12,16,10,19,13,1,2,7,5,10,5,0,1,9,5,9,8,1,1,59,21,38,55,24,31,-19,11,85,-7,-15,1,-10,7,46,-8,-12,-1,-9,4,39,1,-3,2,13,14,14,8,4,-1,6,7,8,3,1,-1,7,7,6,5,3,0,303,171,132,58,25,33,25,34,196,32,10,8,19,26,105,18,4,-1,6,8,91,14,6,9,17,14,13,11,2,0,10,5,5,4,0,0,7,9,8,7,2,0,206,114,92,56,26,30,35,20,109,12,13,14,17,15,65,8,7,1,18,5,44,4,6,13,15,8,19,3,6,4,3,2,13,2,4,2,12,6,6,1,2,2,274,122,152,66,27,39,7,31,164,28,28,12,8,7,77,6,15,6,-1,24,87,22,13,6,8,23,17,4,10,1,5,10,6,1,4,0,3,13,11,3,6,1,253,134,119,103,48,55,17,27,162,18,7,19,19,18,84,8,0,3,-2,9,78,10,7,16,27,29,27,10,6,2,17,13,12,2,3,1,10,16,15,8,3,1,31,3,28,76,24,52,-14,25,43,-38,8,1,-2,4,19,-18,-2,-1,-12,21,24,-20,10,2,15,29,24,4,1,0,8,8,6,2,0,-1,7,21,18,2,1,1,36,10,26,54,20,34,-14,11,46,6,-15,5,-8,-1,18,14,-8,-6,-6,12,28,-8,-7,11,8,15,24,8,-1,1,3,3,11,3,-1,1,5,12,13,5,0,0,95,49,46,-10,6,-16,1,25,87,4,-22,-2,4,7,32,8,-4,-2,-3,18,55,-4,-18,0,-3,-2,7,-3,-8,-2,2,-2,6,2,-1,-2,-5,0,1,-5,-7,0,18,12,6,5,2,3,-3,8,50,-23,-30,9,4,2,33,-17,-15,2,-7,6,17,-6,-15,7,1,4,3,-4,1,0,0,3,4,-5,0,0,1,1,-1,1,1,0,123,64,59,38,16,22,7,38,60,2,7,12,5,24,36,-3,2,1,2,14,24,5,5,11,9,9,9,9,-1,3,5,4,4,1,1,1,4,5,5,8,-2,2,65,-1,66,26,22,4,11,-11,37,12,6,13,-11,4,5,-2,3,1,22,-15,32,14,3,12,11,3,12,-1,4,-4,6,4,5,3,5,-2,5,-1,7,-4,-1,-2,-2,-1,-1,-25,-24,-1,32,-6,-27,14,-18,6,21,-4,-7,-11,-5,2,11,-2,-20,25,-13,4,-1,-4,-9,-11,-1,-1,-1,-6,-6,-11,-2,0,0,2,-3,0,1,-1,84,36,48,-24,-12,-12,6,5,61,27,-13,-4,0,-5,30,20,-11,2,6,10,31,7,-2,-6,0,-1,-4,-11,-2,-5,0,-2,0,-6,-1,-2,0,1,-4,-5,-1,-3,139,78,61,-2,2,-4,43,18,29,30,1,12,11,20,19,20,1,4,32,-2,10,10,0,8,3,3,-4,-11,3,4,4,3,-4,-5,3,1,-1,0,0,-6,0,3,71,37,34,63,31,32,7,12,31,24,-22,15,3,7,14,19,-10,-1,4,5,17,5,-12,16,10,17,16,16,0,3,3,8,8,10,1,1,7,9,8,6,-1,2,98,25,73,47,22,25,20,32,32,9,-5,5,22,10,6,-6,-5,-2,-2,22,26,15,0,7,9,19,9,-1,5,5,5,12,5,0,-2,2,4,7,4,-1,7,3
48,48086,Sopuerta,2229,-12,-2,-10,2,1,1,-5,-3,-10,-1,6,1,-1,-3,-2,-1,5,0,-4,0,-8,0,1,1,0,0,1,1,0,0,0,0,1,0,0,0,0,0,0,1,0,0,-3,-2,-1,3,2,1,4,-3,-4,0,2,0,3,-2,-1,1,-1,-1,1,-1,-3,-1,3,1,2,0,1,0,0,0,1,0,1,0,0,0,1,0,0,0,0,0,5,-1,6,4,1,3,3,-2,-2,2,2,0,3,-2,-7,1,1,1,0,0,5,1,1,-1,1,0,1,0,2,0,1,0,-1,0,1,0,0,0,2,0,1,0,58,36,22,7,4,3,7,4,25,12,3,7,1,2,21,8,3,1,6,2,4,4,0,6,2,1,4,0,0,0,1,0,3,0,0,0,1,1,1,0,0,0,36,10,26,16,9,7,2,4,20,7,3,0,1,2,4,2,-2,2,1,2,16,5,5,-2,4,5,4,2,1,0,2,4,1,2,0,0,2,1,3,0,1,0,74,43,31,26,18,8,8,21,26,15,3,-2,1,11,13,14,2,1,7,10,13,1,1,-3,0,12,5,7,0,0,0,7,4,6,0,0,0,5,1,1,0,0,74,38,36,25,15,10,2,5,46,5,12,4,-4,0,26,7,7,2,6,5,20,-2,5,2,2,13,9,3,-1,-1,2,7,5,3,-2,0,0,6,4,0,1,-1,23,9,14,20,16,4,0,-1,11,-1,2,12,1,0,7,-1,-1,3,-1,-1,4,0,3,9,0,8,8,2,2,0,0,6,7,2,1,0,0,2,1,0,1,0,80,36,44,10,5,5,5,11,47,8,2,5,0,6,21,6,1,0,5,5,26,2,1,5,4,7,4,-2,-2,-1,1,4,3,-1,-1,-1,3,3,1,-1,-1,0,47,25,22,15,8,7,7,6,19,6,2,7,3,4,14,3,0,1,4,2,5,3,2,6,2,2,3,6,2,0,2,1,1,4,0,0,0,1,2,2,2,0,39,18,21,-8,-7,-1,10,0,12,14,4,-1,7,-4,4,9,0,1,3,4,8,5,4,-2,0,-5,-3,-2,2,0,-1,-3,-5,1,1,0,1,-2,2,-3,1,0,36,35,1,1,0,1,2,8,11,12,4,-1,3,9,9,8,5,0,-1,-1,2,4,-1,-1,-1,3,2,-2,0,-1,0,1,1,-2,0,0,-1,2,1,0,0,-1,-28,-13,-15,-14,-11,-3,5,4,-28,0,-6,-2,8,2,-13,-5,-2,-2,-3,2,-15,5,-4,0,1,1,-11,-7,0,2,1,2,-7,-7,-1,1,0,-1,-4,0,1,1,7,0,7,-7,-5,-2,6,-2,-1,1,-5,4,1,1,-2,1,-3,0,5,-3,1,0,-2,4,0,-1,-4,-1,0,-1,0,1,-5,-1,0,0,0,-2,1,0,0,-1,40,12,28,-1,-3,2,3,10,-3,4,11,15,1,5,-5,-3,6,8,2,5,2,7,5,7,-1,4,-4,-1,0,1,-2,1,-2,1,-1,0,1,3,-2,-2,1,1,12,-1,13,-7,-5,-2,-1,1,-5,0,-5,20,4,-1,-8,-1,-3,8,-5,2,3,1,-2,12,1,-1,-3,-4,-1,1,1,-1,-3,-1,-1,0,0,0,0,-3,0,1,23,9,14,1,3,-2,0,-2,10,2,1,14,-6,2,4,4,0,6,6,-4,6,-2,1,8,-2,1,0,2,0,0,-1,3,-2,3,0,0,-1,-2,2,-1,0,0,6,1,5,-6,-9,3,-4,0,17,-4,-4,0,-3,-2,14,-7,0,-3,-1,2,3,3,-4,3,2,-3,-1,-2,-2,0,0,-4,0,-4,-1,0,2,1,-1,2,-1,0
48,48065,Ugao-Miraballes,4158,-18,-8,-10,5,2,3,-7,-3,5,-9,-3,-2,-6,0,6,-6,-2,0,-1,-3,-1,-3,-1,-2,2,0,1,2,0,0,0,0,1,1,0,0,2,0,0,1,0,0,-19,-7,-12,8,6,2,-7,-2,7,-11,-3,-3,-3,-4,7,-5,-1,0,-4,2,0,-6,-2,-3,3,0,3,2,0,0,3,0,2,1,0,0,0,0,1,1,0,0,0,6,-6,9,5,4,-8,-2,19,-7,-9,7,-4,2,15,-4,-7,4,-4,-4,4,-3,-2,3,2,0,6,0,0,1,1,0,4,0,0,0,1,0,2,0,0,1,-20,-14,-6,8,4,4,2,2,-17,0,-7,1,-3,5,-13,1,-3,1,5,-3,-4,-1,-4,0,3,1,4,1,-1,0,2,1,2,0,-1,0,1,0,2,1,0,0,-25,-5,-20,15,10,5,-2,2,-6,-4,-5,-10,-2,1,5,-2,-2,-5,0,1,-11,-2,-3,-5,3,4,5,2,0,1,2,3,4,1,-1,1,1,1,1,1,1,0,-9,0,-9,17,9,8,9,-9,3,-6,-3,-3,10,-8,6,-5,-1,-2,-1,-1,-3,-1,-2,-1,4,7,1,0,4,0,3,2,0,1,2,0,1,5,1,-1,2,0,-10,-1,-9,17,6,11,3,1,1,-15,-3,2,2,2,6,-8,-3,0,1,-1,-5,-7,0,2,6,5,2,3,0,1,4,2,-1,1,0,0,2,3,3,2,0,1,-13,-8,-5,28,10,18,-11,18,17,-33,1,-5,-4,4,9,-17,1,0,-7,14,8,-16,0,-5,4,9,11,2,2,0,3,4,2,0,1,0,1,5,9,2,1,0,13,8,5,2,5,-3,5,3,7,11,-8,-2,2,3,9,1,-3,-2,3,0,-2,10,-5,0,-1,0,-1,7,-3,0,-1,2,3,3,-2,0,0,-2,-4,4,-1,0,29,11,18,11,6,5,6,5,16,5,2,-4,2,5,7,0,-1,-1,4,0,9,5,3,-3,4,0,5,1,-1,2,2,0,2,0,0,2,2,0,3,1,-1,0,2,-7,9,-9,-5,-4,-2,10,-8,1,0,0,1,0,-15,1,1,3,-3,10,7,0,-1,-3,-3,0,-4,-4,1,1,-1,0,-1,-4,0,1,-2,0,-3,0,1,0,17,6,11,9,1,8,-6,5,24,-6,-2,2,0,-1,8,0,-1,-1,-6,6,16,-6,-1,3,1,7,0,0,0,0,1,0,0,0,-1,0,0,7,0,0,1,0,45,26,19,4,-1,5,9,5,11,7,5,6,1,3,11,5,2,4,8,2,0,2,3,2,3,2,-2,0,0,0,1,0,0,-1,-1,0,2,2,-2,1,1,0,-7,-2,-5,1,2,-1,9,-2,-11,4,-7,1,5,-3,-5,9,-3,-2,4,1,-6,-5,-4,3,3,0,0,-2,0,0,1,0,1,0,0,0,2,0,-1,-2,0,0,35,18,17,0,-2,2,12,6,19,3,2,-5,6,1,7,0,2,1,6,5,12,3,0,-6,-2,0,-1,1,1,1,1,-1,-4,1,0,1,-3,1,3,0,1,0,-21,-9,-12,-3,-5,2,3,-5,10,-27,-2,0,11,-6,1,-13,-2,0,-8,1,9,-14,0,0,1,-2,0,0,-2,0,1,-3,0,-1,-2,0,0,1,0,1,0,0,35,24,11,9,5,4,-2,4,-1,16,7,11,-5,5,6,12,2,5,3,-1,-7,4,5,6,4,2,2,-1,0,2,3,1,-1,1,0,1,1,1,3,-2,0,1,5,-10,15,-2,-2,0,-1,4,-1,-2,4,-2,-7,1,-2,-4,0,-1,6,3,1,2,4,-1,-1,6,-4,-2,-1,0,-1,5,-4,-2,0,0,0,1,0,0,-1,0
48,48089,Urduliz,2923,84,35,49,15,7,8,13,7,33,17,8,4,3,1,15,10,4,2,10,6,18,7,4,2,3,5,6,0,0,0,2,1,4,0,0,0,1,4,2,0,0,0,28,15,13,14,8,6,0,16,10,-1,-8,8,-1,9,12,-4,-3,0,1,7,-2,3,-5,8,1,5,4,2,0,0,1,2,2,1,0,0,0,3,2,1,0,0,27,14,13,13,8,5,-5,0,12,15,-2,7,-3,2,0,12,-2,4,-2,-2,12,3,0,3,4,1,4,3,0,0,3,0,3,2,0,0,1,1,1,1,0,0,-11,-1,-10,10,4,6,0,7,13,-14,-6,-10,1,2,17,-12,-5,-3,-1,5,-4,-2,-1,-7,4,1,5,0,0,0,3,1,1,-1,0,0,1,0,4,1,0,0,41,13,28,28,13,15,6,7,8,15,0,4,-1,0,4,8,0,1,7,7,4,7,0,3,8,3,8,8,0,1,3,1,4,5,0,0,5,2,4,3,0,1,-92,-37,-55,-3,-4,1,-30,0,-38,-21,-1,2,-13,1,-13,-10,-1,1,-17,-1,-25,-11,0,1,-3,2,2,-4,0,0,-1,0,0,-3,0,0,-2,2,2,-1,0,0,120,56,64,11,3,8,16,13,44,34,6,5,6,7,28,15,1,1,10,6,16,19,5,4,0,4,3,3,1,0,-1,1,1,2,0,0,1,3,2,1,1,0,21,24,-3,10,5,5,0,7,26,-19,8,-2,6,6,18,-8,5,-2,-6,1,8,-11,3,0,-1,7,3,0,1,0,0,3,2,0,0,0,-1,4,1,0,1,0,25,10,15,8,2,6,11,2,5,12,-3,0,6,5,6,-2,-3,-1,5,-3,-1,14,0,1,-1,6,0,3,1,-1,-1,3,0,1,-1,0,0,3,0,2,2,-1,87,43,44,3,2,1,11,12,44,11,5,1,3,6,23,4,3,3,8,6,21,7,2,-2,3,-1,6,-3,-2,0,3,-1,4,-2,-2,0,0,0,2,-1,0,0,132,65,67,10,5,5,7,18,66,24,14,4,0,8,30,15,8,5,7,10,36,9,6,-1,2,3,5,-1,0,1,2,0,3,0,0,0,0,3,2,-1,0,1,41,18,23,9,5,4,6,-1,27,8,4,-4,0,4,14,2,0,-2,6,-5,13,6,4,-2,1,4,0,3,-1,1,1,3,2,0,-1,0,0,1,-2,3,0,1,134,75,59,3,3,0,9,10,77,32,-2,9,16,5,39,18,-6,2,-7,5,38,14,4,7,-1,1,2,0,1,0,0,1,1,0,1,0,-1,0,1,0,0,0,116,51,65,11,7,4,13,9,66,12,13,-2,0,3,29,7,9,1,13,6,37,5,4,-3,2,1,5,-1,4,-1,2,1,1,-1,3,0,0,0,4,0,1,-1,108,71,37,6,1,5,13,4,32,40,9,9,9,6,21,19,6,7,4,-2,11,21,3,2,1,0,1,4,-1,1,-1,0,0,2,-1,1,2,0,1,2,0,0,51,42,9,12,8,4,9,5,28,3,2,4,10,4,16,9,2,1,-1,1,12,-6,0,3,5,6,3,-2,-2,0,5,2,3,-2,-1,0,0,4,0,0,-1,0,78,21,57,4,-3,7,11,24,22,6,3,10,0,10,5,0,3,3,11,14,17,6,0,7,0,7,-1,-5,0,3,0,2,-3,-5,1,2,0,5,2,0,-1,1,49,18,31,24,10,14,6,13,14,0,13,3,4,3,10,-8,6,4,2,10,4,8,7,-1,3,8,8,4,1,0,1,2,6,-1,2,0,2,6,2,5,-1,0
48,48074,Urduña/Orduña,3876,4,-4,8,7,4,3,1,1,10,-3,-3,-3,-3,-4,6,0,-2,-2,4,5,4,-3,-1,-1,1,2,3,1,0,0,1,1,1,1,0,0,0,1,2,0,0,0,37,20,17,29,10,19,7,5,9,8,-3,12,2,7,3,5,0,4,5,-2,6,3,-3,8,12,6,8,1,1,0,4,3,2,1,0,0,8,3,6,0,1,0,44,45,-1,38,24,14,24,35,-6,-10,5,-3,27,23,-1,-3,4,-4,-3,12,-5,-7,1,1,14,16,6,2,0,0,11,10,2,1,0,0,3,6,4,1,0,0,52,32,20,43,22,21,8,24,26,1,5,-13,5,11,15,-1,5,-3,3,13,11,2,0,-10,11,19,8,3,1,0,5,10,3,2,1,0,6,9,5,1,0,0,38,19,19,17,6,11,1,-3,16,18,3,1,-1,-13,18,11,0,3,2,10,-2,7,3,-2,7,4,3,2,0,1,5,-2,4,0,-1,0,2,6,-1,2,1,1,57,24,33,19,9,10,5,21,24,12,-1,-2,1,4,12,6,0,1,4,17,12,6,-1,-3,1,7,9,2,0,0,0,4,5,0,0,0,1,3,4,2,0,0,66,44,22,8,4,4,7,9,40,10,1,-2,4,9,21,7,2,-1,3,0,19,3,-1,-1,2,3,2,1,0,0,2,0,2,0,0,0,0,3,0,1,0,0,58,25,33,20,11,9,14,-4,26,18,-2,8,6,-2,16,7,-3,1,8,-2,10,11,1,7,4,3,7,5,1,0,1,3,2,4,1,0,3,0,5,1,0,0,27,28,-1,14,6,8,10,7,21,-2,3,-9,5,1,19,-3,5,2,5,6,2,1,-2,-11,2,3,7,2,0,0,2,0,3,1,0,0,0,3,4,1,0,0,49,30,19,8,2,6,4,5,24,6,6,0,0,6,11,7,3,-1,4,-1,13,-1,3,1,7,1,1,-1,0,0,3,0,1,-2,0,0,4,1,0,1,0,0,2,-7,9,-10,-8,-2,6,-3,-11,0,1,9,2,-2,-10,-3,2,4,4,-1,-1,3,-1,5,2,-3,-5,-3,-1,0,1,-3,-4,-2,0,0,1,0,-1,-1,-1,0,-25,-17,-8,3,3,0,-14,7,-16,-6,-4,8,-6,4,-11,-5,-2,3,-8,3,-5,-1,-2,5,0,2,0,0,1,0,1,2,-1,-1,1,1,-1,0,1,1,0,-1,29,13,16,7,1,6,15,-1,-5,7,1,13,10,1,-4,-1,-1,10,5,-2,-1,8,2,3,6,4,-3,1,0,-1,2,1,-3,1,0,0,4,3,0,0,0,-1,-23,-16,-7,-12,-2,-10,-21,6,-10,-8,7,6,-14,5,-4,1,1,-3,-7,1,-6,-9,6,9,-9,-2,2,-4,0,1,-6,1,3,-1,0,1,-3,-3,-1,-3,0,0,-16,-9,-7,-6,-2,-4,-14,-1,-5,-14,-1,19,-10,2,2,-9,0,7,-4,-3,-7,-5,-1,12,-4,0,2,-3,-1,0,-2,0,3,-2,-1,0,-2,0,-1,-1,0,0,-3,1,-4,3,2,1,8,1,-12,-1,-1,4,5,-3,-5,0,4,0,3,4,-7,-1,-5,4,3,3,-3,-1,-1,2,2,3,-2,-1,-1,1,1,0,-1,0,0,1,-18,-8,-10,0,0,0,0,-1,-8,-8,3,-4,-1,0,-8,-5,4,2,1,-1,0,-3,-1,-6,1,2,0,-5,2,0,1,-1,2,-3,2,-1,0,3,-2,-2,0,1,50,48,2,62,65,-3,38,38,-6,-11,-13,4,40,29,-8,-9,-6,2,-2,9,2,-2,-7,2,41,30,-7,-2,0,-1,43,29,-6,-2,0,0,-2,1,-1,0,0,-1
48,48080,Valle de Trápaga-Trapagaran,12609,121,66,55,14,5,9,13,11,104,-11,1,-3,4,8,54,-5,0,0,9,3,50,-6,1,-3,5,4,1,2,2,0,1,1,1,1,1,0,4,3,0,1,1,0,105,61,44,37,20,17,23,16,51,9,-14,21,14,5,25,11,-4,10,9,11,26,-2,-10,11,8,7,8,12,2,0,5,2,4,8,1,0,3,5,4,4,1,0,-31,-17,-14,18,7,11,7,2,-5,4,-24,-15,-2,4,-4,6,-16,-6,9,-2,-1,-2,-8,-9,6,6,4,4,-1,-1,4,1,2,1,0,-1,2,5,2,3,-1,0,-70,-49,-21,19,4,15,0,-11,-24,-28,2,-4,-2,-11,-21,-12,1,-1,2,0,-3,-16,1,-3,3,6,3,7,-1,1,1,1,-1,4,-1,0,2,5,4,3,0,1,-32,-14,-18,18,5,13,12,-6,-12,-13,-13,0,6,-5,1,-9,-6,1,6,-1,-13,-4,-7,-1,5,3,8,0,1,1,4,-1,3,-1,0,0,1,4,5,1,1,1,-68,-27,-41,30,8,22,-10,14,-31,-14,-10,-21,-6,9,-5,-4,-9,-15,-4,5,-26,-10,-1,-6,8,6,6,6,4,0,2,-1,5,1,1,0,6,7,1,5,3,0,-57,-36,-21,31,12,19,9,-4,-58,0,-1,-1,0,-4,-31,0,1,2,9,0,-27,0,-2,-3,8,10,2,8,2,1,5,7,-1,-1,1,1,3,3,3,9,1,0,-43,-13,-30,14,4,10,5,-3,-14,2,-20,-16,3,-3,-8,3,-8,-3,2,0,-6,-1,-12,-13,3,3,3,4,1,0,2,0,0,2,0,0,1,3,3,2,1,0,-18,-14,-4,35,8,27,18,17,-18,-13,-13,-12,7,8,-10,-7,-10,-2,11,9,-8,-6,-3,-10,6,6,10,7,4,1,1,4,0,0,1,1,5,2,10,7,3,0,-11,19,-30,14,10,4,19,13,-23,8,-14,-11,21,12,-15,1,3,-2,-2,1,-8,7,-17,-9,5,5,4,4,-3,-1,2,5,1,3,0,-1,3,0,3,1,-3,0,-61,-46,-15,12,3,9,4,-11,-36,-2,-10,-10,1,-9,-15,-12,-6,-8,3,-2,-21,10,-4,-2,0,5,6,2,-1,0,1,1,4,-2,-1,0,-1,4,2,4,0,0,-33,-7,-26,8,6,2,14,15,-37,-12,-6,-2,-4,19,-11,-6,-2,-1,18,-4,-26,-6,-4,-1,2,5,2,-2,-1,2,-1,3,4,-1,0,1,3,2,-2,-1,-1,1,-60,-41,-19,-15,-8,-7,-17,7,-10,-28,4,-16,-6,1,-15,-17,9,-11,-11,6,5,-11,-5,-5,2,0,-4,-10,-2,-1,0,-2,-2,-2,-1,-1,2,2,-2,-8,-1,0,51,2,49,-15,-10,-5,34,-5,-11,25,1,4,11,-8,-4,5,-7,5,23,3,-7,20,8,-1,-6,-2,-6,0,0,-1,-5,-3,-2,0,0,0,-1,1,-4,0,0,-1,8,23,-15,16,1,15,10,-1,13,-2,1,-11,16,-3,14,0,2,-8,-6,2,-1,-2,-1,-3,4,3,10,2,0,-3,1,-1,2,2,-1,-2,3,4,8,0,1,-1,-15,-32,17,-5,0,-5,6,4,-13,-3,-12,1,-4,-1,-16,-9,-5,3,10,5,3,6,-7,-2,2,-1,-5,0,-1,0,1,0,-4,2,1,0,1,-1,-1,-2,-2,0,-13,-19,6,1,-5,6,11,-5,9,-11,10,-25,-9,-2,10,-12,8,-10,20,-3,-1,1,2,-15,2,2,3,-7,0,1,-1,-1,1,-4,0,0,3,3,2,-3,0,1,9,15,-6,7,1,6,0,29,-8,-7,-1,-3,10,9,6,-7,-3,1,-10,20,-14,0,2,-4,3,1,3,-2,1,1,3,2,-2,-1,-1,0,0,-1,5,-1,2,1
48,48096,Zalla,7640,31,5,26,15,10,5,6,7,7,-3,3,11,-1,3,4,-3,0,2,7,4,3,0,3,9,0,3,6,6,0,0,0,2,4,4,0,0,0,1,2,2,0,0,55,31,24,49,32,17,13,12,4,20,4,0,10,-1,12,10,1,-2,3,13,-8,10,3,2,12,10,13,12,2,0,8,5,8,10,1,0,4,5,5,2,1,0,68,37,31,56,29,27,17,4,20,8,2,16,12,0,15,5,3,2,5,4,5,3,-1,14,8,13,25,9,1,0,5,6,15,2,1,0,3,7,10,7,0,0,60,17,43,35,22,13,11,6,27,14,4,-2,3,3,7,4,2,-1,8,3,20,10,2,-1,4,8,14,4,3,1,2,4,11,2,1,1,2,4,3,2,2,0,42,12,30,55,22,33,3,31,-13,12,-7,13,-3,13,-2,3,-5,5,6,18,-11,9,-2,8,13,14,12,12,2,1,6,5,4,6,0,0,7,9,8,6,2,1,45,41,4,59,36,23,3,24,17,-4,7,-1,1,15,21,1,2,-1,2,9,-4,-5,5,0,11,18,20,6,5,-1,5,10,15,5,2,-1,6,8,5,1,3,0,55,7,48,70,29,41,15,29,1,4,3,1,5,12,-11,-1,1,0,10,17,12,5,2,1,21,29,13,5,2,0,10,15,1,2,1,0,11,14,12,3,1,0,108,76,32,123,70,53,20,34,32,25,-3,-1,7,18,26,19,3,0,13,16,6,6,-6,-1,15,39,43,17,5,2,7,19,28,9,4,1,8,20,15,8,1,1,11,9,2,53,30,23,4,5,-8,5,1,10,4,6,-2,3,-1,4,0,-1,-6,2,2,6,4,18,14,12,2,3,3,10,10,6,0,1,1,8,4,6,2,2,-16,-13,-3,-34,-32,-2,10,4,-38,1,-1,5,1,5,-25,-8,2,7,9,-1,-13,9,-3,-2,2,3,-18,-15,-2,-4,0,1,-16,-13,-3,-1,2,2,-2,-2,1,-3,100,60,40,47,27,20,26,9,36,28,3,-4,19,8,18,16,-1,1,7,1,18,12,4,-5,7,15,14,8,2,0,4,11,8,4,0,0,3,4,6,4,2,0,191,91,100,12,-9,21,55,33,60,18,12,12,35,16,19,9,3,7,20,17,41,9,9,5,11,10,-4,-12,5,0,5,0,-9,-10,2,1,6,10,5,-2,3,-1,71,32,39,-24,-19,-5,7,9,30,15,-1,10,4,2,14,10,1,4,3,7,16,5,-2,6,1,-4,1,-16,-6,-1,1,-3,0,-14,-3,0,0,-1,1,-2,-3,-1,-19,-1,-18,-41,-27,-14,-7,4,-1,-16,1,-1,-8,8,1,-10,5,3,1,-4,-2,-6,-4,-4,-13,-1,-10,-12,-5,0,-9,0,-3,-12,-3,0,-4,-1,-7,0,-2,0,-15,-10,-5,-5,-11,6,24,10,-33,11,-22,-3,9,7,-15,3,-11,-3,15,3,-18,8,-11,0,0,5,-3,-1,-7,1,0,0,-3,-5,-3,0,0,5,0,4,-4,1,-3,2,-5,4,5,-1,-8,9,-8,-2,12,-8,-2,8,-6,3,7,-7,-6,1,-2,-5,5,-1,-1,7,2,-2,-1,-1,-1,6,2,-2,1,0,0,1,0,0,-2,-1,-15,0,-15,-8,-1,-7,9,-2,-9,-10,4,-12,7,0,-11,0,6,-4,2,-2,2,-10,-2,-8,3,-1,2,-7,-6,1,2,1,-3,1,-3,1,1,-2,5,-8,-3,0,28,12,16,54,26,28,24,17,-10,8,-11,-1,15,10,-17,6,-7,4,9,7,7,2,-4,-5,13,18,7,9,6,0,11,10,-1,2,3,0,2,8,8,7,3,0
49,49021,Benavente,16452,169,69,100,9,4,5,17,8,58,21,27,35,2,-2,24,16,12,15,15,10,34,5,15,20,1,1,2,1,4,0,0,0,0,1,3,0,1,1,2,0,1,0,140,65,75,38,13,25,17,13,49,9,6,46,6,-5,35,2,5,23,11,18,14,7,1,23,10,11,5,7,4,1,6,1,1,1,3,1,4,10,4,6,1,0,183,140,43,51,12,39,9,9,62,29,40,31,2,8,33,25,40,28,7,1,29,4,0,3,12,11,18,7,0,3,4,1,3,2,-1,3,8,10,15,5,1,0,252,115,137,73,34,39,82,9,79,58,13,13,48,-8,39,31,2,6,34,17,40,27,11,7,22,14,18,5,8,6,16,3,8,2,3,2,6,11,10,3,5,4,401,218,183,116,53,63,46,47,168,74,26,26,21,29,79,65,9,10,25,18,89,9,17,16,33,24,30,18,8,2,16,10,15,9,3,0,17,14,15,9,5,2,401,247,154,107,44,63,67,67,128,64,42,32,29,42,98,37,28,12,38,25,30,27,14,20,19,34,24,14,12,3,10,15,5,6,7,1,9,19,19,8,5,2,147,76,71,113,47,66,11,45,72,3,4,5,7,24,47,-15,3,6,4,21,25,18,1,-1,23,26,39,16,5,4,12,16,13,2,1,3,11,10,26,14,4,1,367,221,146,223,116,107,92,80,80,89,7,13,58,46,42,54,7,8,34,34,38,35,0,5,50,68,58,36,8,1,32,29,32,22,1,0,18,39,26,14,7,1,71,-29,100,45,-9,54,39,1,0,-6,9,15,15,-4,-37,-18,5,4,24,5,37,12,4,11,20,19,-5,2,7,0,10,2,-14,-9,2,-1,10,17,9,11,5,1,14,-30,44,43,-1,44,23,-31,-9,-19,25,24,1,-20,-8,-31,8,19,22,-11,-1,12,17,5,19,14,7,4,1,-2,8,-3,2,-5,-2,-1,11,17,5,9,3,-1,102,61,41,80,44,36,17,40,-4,7,11,30,8,24,1,2,2,21,9,16,-5,5,9,9,23,19,12,11,12,0,18,12,2,7,5,-1,5,7,10,4,7,1,92,-2,94,82,37,45,30,-9,8,-2,-3,44,7,-9,-10,-8,-3,8,23,0,18,6,0,36,19,19,21,11,9,0,11,10,11,2,2,0,8,9,10,9,7,0,-51,-26,-25,-45,-35,-10,-9,-26,-15,-21,-8,21,-6,-14,-2,-9,-7,10,-3,-12,-13,-12,-1,11,-3,-8,-16,-16,-6,1,-4,-11,-9,-11,-5,2,1,3,-7,-5,-1,-1,-200,-110,-90,-43,-25,-18,-21,-57,-46,-41,-22,-9,-12,-36,-29,-21,-16,5,-9,-21,-17,-20,-6,-14,-4,-4,-14,-18,-3,0,-2,-5,-7,-11,-1,0,-2,1,-7,-7,-2,0,-231,-134,-97,-43,-22,-21,-32,-48,-77,-85,1,7,-14,-42,-38,-53,0,9,-18,-6,-39,-32,1,-2,-7,-11,-18,-9,6,-4,-4,-4,-8,-6,1,-1,-3,-7,-10,-3,5,-3,-142,-64,-78,-48,-29,-19,-3,-28,-68,-30,-28,2,-1,-21,-17,-21,-14,0,-2,-7,-51,-9,-14,2,-2,3,-22,-15,-14,-1,-2,-5,-11,-9,-4,-1,0,8,-11,-6,-10,0,-9,4,-13,-10,-4,-6,-10,-14,-20,7,-7,25,-3,2,-15,13,-3,6,-7,-16,-5,-6,-4,19,-5,5,-6,-4,-2,-1,-4,6,-2,-4,1,-2,-1,-1,-4,0,-3,1,-62,-42,-20,-20,-14,-6,13,-14,-25,-31,-6,-2,8,-15,-13,-18,-2,-2,5,1,-12,-13,-4,0,8,2,-12,-13,-6,-1,0,-1,-3,-5,-5,-1,8,3,-9,-8,-1,0
49,49065,Fermoselle,1646,3,9,-6,12,7,5,-3,-5,-7,3,11,4,-1,-1,-1,2,7,3,-2,-4,-6,1,4,1,3,2,0,2,4,1,2,1,0,1,2,1,1,1,0,1,2,0,-5,-5,0,8,4,4,2,-3,-6,0,4,-2,-2,1,-4,-1,2,-1,4,-4,-2,1,2,-1,4,2,0,1,0,1,1,1,0,1,0,1,3,1,0,0,0,0,-1,8,-9,10,9,1,-1,-5,-9,4,4,5,1,-2,-2,2,3,5,-2,-3,-7,2,1,0,3,-1,3,3,1,0,3,0,2,2,1,0,0,-1,1,1,0,0,38,26,12,21,14,7,1,0,-2,8,16,16,1,2,-1,7,8,10,0,-2,-1,1,8,6,3,2,4,6,5,1,1,2,2,6,3,0,2,0,2,0,2,1,-7,-11,4,11,7,4,-3,-5,-4,-3,7,1,-3,-4,-3,-6,3,2,0,-1,-1,3,4,-1,2,0,2,4,-1,4,2,0,1,1,0,3,0,0,1,3,-1,1,-7,5,-12,17,13,4,-6,4,-7,5,1,-3,-1,6,-2,4,0,-1,-5,-2,-5,1,1,-2,0,5,4,5,2,1,0,5,2,4,1,1,0,0,2,1,1,0,14,13,1,34,23,11,7,3,1,4,0,0,7,3,-1,6,-1,0,0,0,2,-2,1,0,9,6,9,5,4,1,6,6,7,2,1,1,3,0,2,3,3,0,27,15,12,25,14,11,-1,7,2,11,14,-5,-1,5,1,7,7,-3,0,2,1,4,7,-2,0,6,6,6,7,0,0,3,3,4,4,0,0,3,3,2,3,0,30,20,10,3,0,3,8,11,-1,-2,6,8,6,4,0,1,5,5,2,7,-1,-3,1,3,3,4,-4,2,-1,-1,1,2,-4,2,0,-1,2,2,0,0,-1,0,-4,0,-4,4,0,4,1,-5,-1,-2,-1,3,0,-3,-1,0,0,4,1,-2,0,-2,-1,-1,1,0,0,-1,2,2,0,0,0,-1,1,0,1,0,0,0,1,2,29,12,17,9,5,4,-1,1,-9,-1,13,27,0,0,-9,-1,6,16,-1,1,0,0,7,11,3,1,0,1,4,0,2,0,0,1,2,0,1,1,0,0,2,0,15,15,0,8,1,7,2,2,-4,6,7,2,1,-2,5,3,4,4,1,4,-9,3,3,-2,1,1,2,1,3,0,1,-1,2,-1,0,0,0,2,0,2,3,0,-37,-29,-8,-33,-27,-6,-3,-7,-12,-10,-3,-3,-1,-6,-8,-9,-4,-1,-2,-1,-4,-1,1,-2,-2,-4,-3,-13,-4,-7,-1,-3,-3,-11,-5,-4,-1,-1,0,-2,1,-3,19,6,13,4,1,3,7,-3,0,1,3,11,3,-1,0,-1,0,5,4,-2,0,2,3,6,0,0,1,0,2,1,0,0,0,1,0,0,0,0,1,-1,2,1,27,21,6,1,0,1,0,-3,4,1,6,19,-1,0,4,3,3,12,1,-3,0,-2,3,7,-1,0,2,0,-1,1,-1,0,1,0,0,0,0,0,1,0,-1,1,-5,-7,2,7,2,5,-1,0,-5,-2,4,-2,-1,0,-2,-3,1,-2,0,0,-3,1,3,0,1,0,2,1,1,2,0,0,0,1,0,1,1,0,2,0,1,1,4,2,2,1,-1,2,-3,-1,1,-1,-4,12,-2,0,0,0,-1,5,-1,-1,1,-1,-3,7,0,-1,2,-1,1,0,0,0,2,-1,-1,-1,0,-1,0,0,2,1,-20,-15,-5,-21,-15,-6,-4,1,-7,-10,1,-1,-2,2,-6,-7,0,-2,-2,-1,-1,-3,1,1,-2,0,-5,-3,-7,-4,-1,0,-5,-2,-6,-1,-1,0,0,-1,-1,-3
49,49081,Fuentesaúco,1875,14,19,-5,18,12,6,-1,10,8,1,2,-6,0,10,9,1,1,-2,-1,0,-1,0,1,-4,3,7,6,1,1,0,2,4,5,0,1,0,1,3,1,1,0,0,4,4,0,16,9,7,9,3,-1,-1,-1,-4,6,2,-4,2,-1,0,3,1,3,-3,0,-4,8,5,1,0,1,1,6,2,0,0,0,1,2,3,1,0,1,0,0,3,-3,14,11,3,3,-4,2,-1,2,-2,2,-2,4,-1,1,-1,1,-2,-2,0,1,-1,3,3,6,1,1,0,2,1,6,1,1,0,1,2,0,0,0,0,33,19,14,32,16,16,11,4,5,12,0,0,5,7,-1,8,0,-1,6,-3,6,4,0,1,12,4,8,7,1,0,4,3,5,4,0,0,8,1,3,3,1,0,40,32,8,45,28,17,4,16,8,9,3,1,5,8,9,5,1,4,-1,8,-1,4,2,-3,6,16,13,9,0,1,5,8,9,6,0,0,1,8,4,3,0,1,32,16,16,31,18,13,0,2,7,0,14,6,4,-4,5,-4,8,4,-4,6,2,4,6,2,8,9,6,2,4,0,6,3,4,1,2,0,2,6,2,1,2,0,49,31,18,36,24,12,9,25,17,-11,4,4,7,19,7,-4,1,1,2,6,10,-7,3,3,11,12,12,-2,3,0,8,9,7,-2,2,0,3,3,5,0,1,0,49,22,27,39,14,25,13,13,3,11,11,-3,5,6,-2,9,4,0,8,7,5,2,7,-3,12,8,12,6,1,0,4,1,6,3,0,0,8,7,6,3,1,0,-17,-5,-12,29,12,17,-6,0,0,-7,2,-5,-4,-6,6,-2,2,-1,-2,6,-6,-5,0,-4,8,7,7,3,4,0,2,2,5,2,1,0,6,5,2,1,3,0,0,7,-7,22,9,13,3,6,-5,4,-2,-6,1,6,3,1,-2,-2,2,0,-8,3,0,-4,9,6,3,3,1,0,4,3,3,-1,0,0,5,3,0,4,1,0,18,6,12,18,10,8,13,-3,5,-1,4,0,2,0,0,2,1,1,11,-3,5,-3,3,-1,4,4,7,0,2,1,1,2,4,1,1,1,3,2,3,-1,1,0,14,21,-7,10,6,4,9,5,-14,6,1,4,6,6,-5,6,4,3,3,-1,-9,0,-3,1,5,3,0,1,0,0,3,0,1,1,1,0,2,3,-1,0,-1,0,12,12,0,19,15,4,-3,9,-1,7,1,2,0,11,1,1,0,1,-3,-2,-2,6,1,1,5,6,4,2,0,2,4,6,2,1,1,1,1,0,2,1,-1,1,-51,-25,-26,-1,-2,1,-6,-8,-20,-11,-3,-1,0,-4,-7,-6,-4,-2,-6,-4,-13,-5,1,1,1,0,-1,0,-1,0,1,0,-1,-1,-1,0,0,0,0,1,0,0,-54,-33,-21,1,0,1,-10,-9,-12,-10,-4,-8,-6,-3,-9,-8,-3,-3,-4,-6,-3,-2,-1,-5,1,-1,1,0,1,-1,0,-1,1,0,0,0,1,0,0,0,1,-1,-24,-5,-19,-7,-3,-4,-4,-8,-10,-3,-2,5,-2,-5,-1,0,0,4,-2,-3,-9,-3,-2,1,-1,-1,-4,-1,1,-1,0,-1,-2,-1,1,0,-1,0,-2,0,0,-1,-40,-12,-28,-1,0,-1,-16,-10,-8,-6,3,-4,-5,-6,-2,0,1,0,-11,-4,-6,-6,2,-4,0,0,-1,1,0,-1,0,0,0,0,0,0,0,0,-1,1,0,-1,-20,-6,-14,3,5,-2,-2,-11,-3,-6,2,0,-1,-3,0,-5,2,1,-1,-8,-3,-1,0,-1,-1,2,3,-1,-1,1,0,2,3,0,-1,1,-1,0,0,-1,0,0
49,49127,Morales del Vino,1576,67,30,37,3,1,2,12,15,17,9,10,3,6,5,8,5,5,1,6,10,9,4,5,2,0,1,0,0,2,0,0,0,0,0,1,0,0,1,0,0,1,0,108,64,44,5,1,4,16,10,34,25,18,6,10,8,21,13,10,2,6,2,13,12,8,4,2,0,2,0,1,0,0,0,0,0,1,0,2,0,2,0,0,0,52,24,28,4,3,1,9,0,17,9,18,-2,5,1,7,3,6,2,4,-1,10,6,12,-4,0,0,0,2,2,0,0,1,-1,1,2,0,0,-1,1,1,0,0,143,80,63,19,6,13,21,24,49,30,13,5,13,9,24,22,10,2,8,15,25,8,3,3,4,4,3,3,3,2,2,0,1,1,2,0,2,4,2,2,1,2,96,48,48,10,4,6,8,14,45,11,18,-2,0,4,27,6,11,0,8,10,18,5,7,-2,2,3,2,1,1,0,0,2,2,0,0,0,2,1,0,1,1,0,79,60,19,9,7,2,5,16,21,20,14,2,11,8,17,8,11,2,-6,8,4,12,3,0,3,1,4,0,1,0,3,0,3,0,1,0,0,1,1,0,0,0,133,47,86,2,0,2,19,12,28,32,6,32,8,6,10,14,1,5,11,6,18,18,5,27,0,0,1,0,-1,2,0,0,0,0,-1,1,0,0,1,0,0,1,154,87,67,22,17,5,29,11,56,31,20,8,13,7,31,21,11,4,16,4,25,10,9,4,6,1,8,6,1,0,3,1,7,6,0,0,3,0,1,0,1,0,104,58,46,3,2,1,19,18,40,13,14,0,9,7,31,6,7,-2,10,11,9,7,7,2,0,2,1,0,0,0,0,2,0,0,0,0,0,0,1,0,0,0,73,44,29,13,5,8,28,4,16,14,4,7,20,1,8,8,5,2,8,3,8,6,-1,5,8,1,1,1,0,2,4,0,0,0,0,1,4,1,1,1,0,1,61,33,28,2,2,0,8,20,15,14,12,-7,8,7,7,9,3,-1,0,13,8,5,9,-6,1,2,0,0,0,-1,0,1,1,0,0,-1,1,1,-1,0,0,0,65,16,49,8,3,5,20,6,19,16,1,3,2,5,5,4,1,-1,18,1,14,12,0,4,6,-2,4,0,0,0,2,-1,2,0,0,0,4,-1,2,0,0,0,45,20,25,4,1,3,14,-4,8,16,9,-1,10,-4,6,4,5,-3,4,0,2,12,4,2,2,-1,2,1,-2,1,1,-1,1,0,-1,0,1,0,1,1,-1,1,30,19,11,-4,-1,-3,-2,11,14,0,4,1,-4,6,9,1,4,1,2,5,5,-1,0,0,-4,1,1,-3,1,0,-2,1,1,-1,0,0,-2,0,0,-2,1,0,80,45,35,0,0,0,26,0,28,23,-4,3,16,1,12,16,-3,1,10,-1,16,7,-1,2,0,0,1,0,1,-2,0,0,0,0,0,0,0,0,1,0,1,-2,0,9,-9,-3,-1,-2,-8,5,-8,2,9,0,-9,3,1,2,8,3,1,2,-9,0,1,-3,-1,0,-1,-1,0,0,-1,0,0,0,0,0,0,0,-1,-1,0,0,-12,-6,-6,-5,-3,-2,7,-9,-11,5,0,-1,7,-4,-12,3,0,1,0,-5,1,2,0,-2,1,-2,-4,-1,1,0,0,-2,-2,0,0,1,1,0,-2,-1,1,-1,-12,-6,-6,0,-1,1,-3,2,7,-7,-10,-1,2,0,2,-6,-1,-4,-5,2,5,-1,-9,3,0,0,0,0,-1,1,0,0,0,0,-1,0,0,0,0,0,0,1
49,49219,Toro,9396,-56,-17,-39,13,5,8,-13,-19,-17,-19,10,2,-3,-8,-8,-7,6,3,-10,-11,-9,-12,4,-1,4,0,5,1,2,1,2,0,1,1,0,1,2,0,4,0,2,0,-16,-5,-11,11,6,5,14,-12,-15,0,4,-7,4,-2,-7,-3,4,-1,10,-10,-8,3,0,-6,4,1,2,3,0,1,1,1,2,2,0,0,3,0,0,1,0,1,48,27,21,9,6,3,8,4,0,10,4,23,1,3,-3,14,1,13,7,1,3,-4,3,10,1,1,4,3,0,0,0,0,3,3,0,0,1,1,1,0,0,0,176,71,105,65,37,28,19,20,50,23,26,37,3,9,21,8,18,11,16,11,29,15,8,26,13,17,15,12,6,2,8,8,11,6,3,1,5,9,4,6,3,1,116,80,36,82,56,26,13,30,17,40,7,7,8,19,27,17,2,6,5,11,-10,23,5,1,6,30,15,21,8,2,4,20,14,15,3,0,2,10,1,6,5,2,169,80,89,127,71,56,30,34,24,36,18,21,11,14,9,22,8,10,19,20,15,14,10,11,23,35,32,23,8,4,10,19,18,14,6,2,13,16,14,9,2,2,81,31,50,101,53,48,35,23,-11,4,27,3,19,11,-13,0,14,0,16,12,2,4,13,3,33,24,24,12,5,3,16,16,12,6,1,2,17,8,12,6,4,1,187,108,79,197,115,82,19,68,35,37,17,9,8,41,30,16,10,1,11,27,5,21,7,8,34,64,47,37,12,2,15,37,32,22,7,1,19,27,15,15,5,1,40,27,13,70,37,33,10,13,1,-3,9,3,3,2,5,6,7,0,7,11,-4,-9,2,3,20,25,13,8,-1,1,13,12,3,7,0,0,7,13,10,1,-1,1,13,18,-5,7,-5,12,16,-13,-6,8,4,5,13,-8,5,2,6,1,3,-5,-11,6,-2,4,17,-2,-5,1,-1,-3,8,-4,-6,0,-1,-2,9,2,1,1,0,-1,-15,-18,3,6,-6,12,15,-9,0,-14,4,-9,6,-11,3,-11,0,-4,9,2,-3,-3,4,-5,13,4,-9,-8,5,0,7,-5,-7,-4,3,0,6,9,-2,-4,2,0,4,3,1,-8,-7,-1,3,-4,3,-16,8,10,2,3,4,-13,4,3,1,-7,-1,-3,4,7,-1,-2,-7,-1,0,1,0,1,-7,-4,0,1,-1,-3,0,3,0,0,-117,-85,-32,-92,-62,-30,-22,-17,-38,-30,-16,8,-12,-7,-27,-29,-14,6,-10,-10,-11,-1,-2,2,-17,-2,-27,-30,-13,-3,-9,-1,-18,-25,-9,0,-8,-1,-9,-5,-4,-3,-75,-50,-25,-40,-28,-12,-12,-4,-47,-13,-1,3,-7,-1,-32,-9,-2,0,-5,-3,-15,-4,1,3,-7,3,-20,-7,-10,0,-5,-1,-11,-5,-7,1,-2,4,-9,-2,-3,-1,-25,-5,-20,-15,-6,-9,6,-14,-23,5,14,-10,5,-6,-4,-2,3,1,1,-8,-19,7,11,-11,-2,-2,-8,-4,0,1,0,0,-2,-4,0,0,-2,-2,-6,0,0,1,-27,-20,-7,-3,-9,6,-4,-5,-19,-6,2,0,-7,1,-6,-4,-6,-2,3,-6,-13,-2,8,2,1,3,-3,-4,1,-2,3,0,-6,-3,-2,-2,-2,3,3,-1,3,0,-49,-7,-42,-9,-2,-7,19,-14,-30,-12,-7,-7,13,-4,-11,0,-3,-3,6,-10,-19,-12,-4,-4,-2,4,-1,-5,-8,2,-1,5,0,-2,-5,1,-1,-1,-1,-3,-3,1,-74,-26,-48,11,11,0,-14,-3,-21,-5,-22,-10,-6,-3,-4,1,-11,-3,-8,0,-17,-6,-11,-7,-3,10,0,1,2,0,-1,8,0,3,1,0,-2,2,0,-2,1,0
49,49223,Trabazos,959,3,5,-2,3,1,2,-2,-1,3,1,3,-1,-2,2,0,0,4,1,0,-3,3,1,-1,-2,0,0,1,0,1,1,0,0,0,0,0,1,0,0,1,0,1,0,1,1,0,6,4,2,-1,-1,-3,1,8,-3,-1,-2,-1,2,4,-1,0,1,-2,-1,4,-2,1,0,3,2,0,0,0,0,2,2,0,0,1,0,1,0,0,0,1,4,-3,14,8,6,4,-5,-5,0,8,-1,3,-2,-2,0,3,2,1,-3,-3,0,5,-3,4,3,0,3,2,2,2,2,-1,2,1,2,2,1,1,1,1,0,14,8,6,12,5,7,-2,7,-2,9,5,-3,-2,5,0,4,2,-1,0,2,-2,5,3,-2,2,3,1,5,1,0,0,1,0,3,1,0,2,2,1,2,0,0,37,16,21,15,9,6,8,6,3,3,9,7,4,1,0,1,7,3,4,5,3,2,2,4,4,5,2,4,0,0,1,3,2,3,0,0,3,2,0,1,0,0,24,16,8,12,7,5,7,1,10,7,1,-1,3,2,4,5,1,1,4,-1,6,2,0,-2,1,0,1,5,3,2,0,0,0,3,3,1,1,0,1,2,0,1,61,42,19,40,26,14,-1,11,11,21,17,1,2,4,6,15,13,2,-3,7,5,6,4,-1,3,8,7,17,5,0,3,4,4,10,5,0,0,4,3,7,0,0,15,19,-4,23,20,3,-1,5,5,0,8,-2,1,4,8,0,6,0,-2,1,-3,0,2,-2,0,7,7,5,4,0,1,5,7,4,3,0,-1,2,0,1,1,0,-13,-9,-4,3,4,-1,-4,-1,-13,-1,4,3,-4,0,-7,1,2,-1,0,-1,-6,-2,2,4,0,-2,4,0,-1,2,0,0,3,1,-1,1,0,-2,1,-1,0,1,18,7,11,6,3,3,-2,2,6,1,6,5,-1,2,0,1,3,2,-1,0,6,0,3,3,-2,1,2,0,3,2,0,1,0,0,1,1,-2,0,2,0,2,1,20,9,11,7,5,2,4,2,3,4,5,2,3,2,1,3,0,0,1,0,2,1,5,2,0,1,3,3,-1,1,0,1,2,3,-1,0,0,0,1,0,0,1,9,3,6,0,-1,1,1,2,1,2,4,-3,2,1,-1,0,2,-2,-1,1,2,2,2,-1,0,1,-1,0,0,0,0,1,-1,0,-1,0,0,0,0,0,1,0,19,12,7,7,3,4,1,2,1,7,5,2,1,-1,2,3,3,3,0,3,-1,4,2,-1,0,2,1,3,1,0,0,0,1,2,0,0,0,2,0,1,1,0,16,12,4,-1,0,-1,3,4,6,6,2,-5,3,2,4,4,2,-3,0,2,2,2,0,-2,-1,1,1,0,-1,-1,0,0,1,0,-1,0,-1,1,0,0,0,-1,24,20,4,7,6,1,2,1,1,8,10,2,1,0,1,7,6,5,1,1,0,1,4,-3,0,-1,4,3,1,0,0,-1,4,3,0,0,0,0,0,0,1,0,-23,-17,-6,-12,-9,-3,-2,-1,-2,-10,-7,-1,-2,1,-2,-5,-7,-2,0,-2,0,-5,0,1,0,1,-5,-3,-5,0,1,1,-4,-1,-5,-1,-1,0,-1,-2,0,1,-18,-5,-13,-4,1,-5,-5,-2,-15,2,1,2,-3,-1,-3,1,0,2,-2,-1,-12,1,1,0,-1,1,-4,-1,0,1,0,1,0,0,-1,1,-1,0,-4,-1,1,0,-2,0,-2,6,4,2,1,0,-1,-3,4,-3,0,0,0,3,0,-3,1,0,-1,-6,4,0,1,1,2,1,1,0,0,1,2,1,0,0,1,0,0,0,1,0
49,49250,Villalpando,1749,-22,-11,-11,4,3,1,-6,0,-9,-6,1,0,-3,1,-5,-4,2,0,-3,-1,-4,-2,-1,0,0,0,0,1,2,1,0,0,0,1,1,1,0,0,0,0,1,0,1,4,-3,4,2,2,2,-1,-2,-5,1,6,1,-1,1,-1,1,3,1,0,-3,-4,0,3,0,2,1,1,0,0,0,1,0,1,0,0,0,1,1,0,0,0,-29,-13,-16,0,1,-1,0,-7,-15,-9,3,-1,1,-6,-5,-5,1,1,-1,-1,-10,-4,2,-2,0,0,1,0,0,-1,0,0,1,0,0,0,0,0,0,0,0,-1,18,4,14,5,4,1,-2,2,3,-2,0,16,-2,-2,0,2,-3,8,0,4,3,-4,3,8,0,0,4,1,0,0,0,0,3,1,0,0,0,0,1,0,0,0,13,16,-3,23,13,10,4,3,1,0,1,4,3,4,1,1,4,4,1,-1,0,-1,-3,0,5,6,11,0,0,0,4,3,6,0,0,0,1,3,5,0,0,0,-2,-5,3,11,4,7,6,-2,-6,2,0,-4,3,-3,-3,-2,1,-2,3,1,-3,4,-1,-2,2,2,1,5,0,1,1,0,1,2,0,0,1,2,0,3,0,1,49,19,30,14,9,5,9,-3,12,13,6,14,0,0,5,8,3,5,9,-3,7,5,3,9,0,1,9,2,1,1,0,2,5,1,0,1,0,-1,4,1,1,0,14,13,1,42,27,15,2,12,4,-7,7,-5,7,6,6,-4,3,-6,-5,6,-2,-3,4,1,7,12,15,5,3,0,5,7,11,3,1,0,2,5,4,2,2,0,15,-1,16,20,10,10,5,-1,-5,2,0,13,-1,-2,-1,-2,-2,5,6,1,-4,4,2,8,8,3,4,2,3,0,3,2,2,1,2,0,5,1,2,1,1,0,-10,-4,-6,-10,-5,-5,-7,-1,-9,-1,2,6,-3,0,-5,0,2,2,-4,-1,-4,-1,0,4,-3,-3,-2,0,-2,0,-2,-1,-1,0,-1,0,-1,-2,-1,0,-1,0,26,21,5,21,10,11,3,9,4,1,3,6,7,4,7,0,0,4,-4,5,-3,1,3,2,6,6,5,3,1,0,3,1,4,2,0,0,3,5,1,1,1,0,-4,-5,1,8,4,4,6,5,-10,-2,-3,-2,4,3,-10,2,-3,-2,2,2,0,-4,0,0,1,3,1,4,0,-2,1,2,-1,3,0,-1,0,1,2,1,0,-1,1,-2,3,2,0,2,1,-1,-5,-4,-1,11,0,-1,-2,-4,0,6,1,0,-3,0,-1,5,0,1,1,0,0,0,0,0,0,0,0,0,0,1,1,0,0,0,-19,-15,-4,-12,-10,-2,2,-7,-16,-2,0,5,-2,-3,-11,0,1,1,4,-4,-5,-2,-1,4,-2,-1,-6,-3,0,0,-2,0,-5,-3,0,0,0,-1,-1,0,0,0,-13,-9,-4,-24,-13,-11,-9,4,-13,-3,-5,13,-5,1,-6,-1,-2,5,-4,3,-7,-2,-3,8,-11,0,-7,-5,-2,0,-6,-1,-4,-1,-1,0,-5,1,-3,-4,-1,0,26,12,14,2,2,0,0,2,0,7,5,11,2,0,-2,5,4,3,-2,2,2,2,1,8,2,0,-1,2,-1,0,1,0,-1,2,0,0,1,0,0,0,-1,0,-3,-5,2,2,0,2,1,0,0,0,-4,0,3,-1,3,-4,-4,-1,-2,1,-3,4,0,1,2,1,0,0,-1,0,3,0,0,-2,-1,0,-1,1,0,2,0,0,47,27,20,18,9,9,18,2,2,15,3,6,14,0,0,8,1,3,4,2,2,7,2,3,7,2,3,3,3,0,5,0,0,2,2,0,2,2,3,1,1,0
49,49275,Zamora,64906,133,42,91,118,57,61,89,-21,-5,50,34,-17,42,-23,-20,39,10,-5,47,2,15,11,24,-12,23,26,24,19,19,7,12,7,15,8,11,4,11,19,9,11,8,3,30,-36,66,175,63,112,29,-18,19,-17,-13,22,17,-27,-5,-17,-21,17,12,9,24,0,8,5,38,29,61,31,11,5,15,10,20,11,6,1,23,19,41,20,5,4,-40,-26,-14,191,108,83,94,-67,-66,60,-29,-33,51,-29,-57,24,-20,4,43,-38,-9,36,-9,-37,39,43,57,32,16,2,24,27,30,13,11,1,15,16,27,19,5,1,109,-6,115,289,124,165,111,-23,-2,20,-16,13,54,-23,-30,-14,-5,8,57,0,28,34,-11,5,82,52,81,36,28,9,42,23,28,18,8,4,40,29,53,18,20,5,413,174,239,355,166,189,129,4,33,124,4,115,66,-6,0,47,10,57,63,10,33,77,-6,58,66,78,98,62,34,17,37,32,49,24,16,8,29,46,49,38,18,9,70,43,27,380,196,184,39,40,-28,-5,22,-3,2,27,-10,2,8,11,37,13,-18,-7,14,-14,72,91,120,62,26,8,34,45,67,32,16,2,38,46,53,30,10,6,108,51,57,552,284,268,76,34,-14,82,-50,-15,25,18,-16,61,-35,2,51,16,2,21,-15,-17,77,142,168,117,33,10,36,69,86,73,14,4,41,73,82,44,19,6,786,502,284,888,544,344,179,149,156,224,54,33,107,90,141,137,14,21,72,59,15,87,40,12,117,234,252,204,71,7,67,138,160,136,36,4,50,96,92,68,35,3,-50,-32,-18,306,131,175,88,-19,-147,45,-33,29,45,-14,-101,31,-13,33,43,-5,-46,14,-20,-4,79,63,65,63,21,13,43,21,18,33,9,7,36,42,47,30,12,6,-32,-36,4,182,82,100,66,-41,-95,-24,19,41,25,-32,-67,-8,17,27,41,-9,-28,-16,2,14,39,46,50,21,18,6,12,17,20,20,9,2,27,29,30,1,9,4,-451,-307,-144,100,1,99,22,-90,-161,-104,-86,-39,23,-68,-98,-79,-61,-28,-1,-22,-63,-25,-25,-11,49,43,2,-13,9,8,32,7,-13,-22,-5,2,17,36,15,9,14,6,-73,-75,2,90,23,67,74,-63,-116,6,13,16,45,-38,-81,6,-17,7,29,-25,-35,0,30,9,37,44,-18,13,2,7,18,21,-15,2,-9,3,19,23,-3,11,11,4,-120,-118,-2,107,37,70,-2,-31,-66,-17,-11,15,-9,-35,-61,-15,-11,8,7,4,-5,-2,0,7,19,41,14,14,9,7,4,16,7,0,3,4,15,25,7,14,6,3,-230,-160,-70,38,8,30,41,-31,-92,-41,-34,-58,37,-6,-77,-60,-27,-22,4,-25,-15,19,-7,-36,16,20,-6,3,-5,10,7,14,-5,-6,-7,4,9,6,-1,9,2,6,-564,-298,-266,-226,-143,-83,-67,-39,-274,-106,-43,-19,-27,-37,-125,-70,-15,-11,-40,-2,-149,-36,-28,-8,-18,1,-110,-70,-22,-9,-11,-12,-54,-50,-9,-6,-7,13,-56,-20,-13,-3,-402,-280,-122,-112,-85,-27,-21,-52,-205,-75,-51,25,-3,-51,-121,-51,-52,11,-18,-1,-84,-24,1,14,0,6,-66,-39,-19,4,-6,-6,-36,-24,-16,2,6,12,-30,-15,-3,2,-333,-227,-106,-36,-52,16,-13,-69,-186,-58,-8,4,-22,-45,-90,-53,-20,3,9,-24,-96,-5,12,1,23,20,-27,-42,-12,-3,9,0,-17,-35,-11,-2,14,20,-10,-7,-1,-1,-172,-128,-44,83,21,62,61,-98,-152,-2,10,12,28,-65,-82,-16,4,2,33,-33,-70,14,6,10,44,14,17,-5,4,8,28,1,1,-19,4,4,16,13,16,14,0,4
50,50053,Boquiñeni,1005,5,5,0,7,5,2,0,5,-3,4,2,-2,0,3,-1,4,1,-1,0,2,-2,0,1,-1,0,3,2,2,0,0,0,1,2,2,0,0,0,2,0,0,0,0,8,5,3,8,3,5,2,3,2,3,-2,0,2,-1,3,2,-1,0,0,4,-1,1,-1,0,0,3,3,2,0,0,0,0,2,1,0,0,0,3,1,1,0,0,25,16,9,39,25,14,12,9,4,0,0,-1,6,6,4,1,0,-1,6,3,0,-1,0,0,9,11,13,5,1,0,5,6,10,3,1,0,4,5,3,2,0,0,26,14,12,39,19,20,3,6,13,1,5,-1,3,3,7,0,2,0,0,3,6,1,3,-1,6,8,19,4,2,0,4,2,9,3,1,0,2,6,10,1,1,0,30,27,3,36,28,8,10,13,16,-7,-3,0,6,13,14,-5,-2,1,4,0,2,-2,-1,-1,1,15,18,1,1,0,1,13,13,1,0,0,0,2,5,0,1,0,15,11,4,24,17,7,5,-1,2,7,2,1,3,-1,3,4,3,0,2,0,-1,3,-1,1,4,4,5,9,2,0,3,3,4,5,2,0,1,1,1,4,0,0,-3,-10,7,4,-5,9,8,-5,-15,5,1,1,3,-4,-14,2,1,0,5,-1,-1,3,0,1,11,-1,-7,0,0,0,4,-3,-7,0,0,0,7,2,0,0,0,0,-6,-8,2,32,14,18,5,0,-8,0,-2,-1,2,-2,-6,0,-1,-1,3,2,-2,0,-1,0,8,9,5,8,2,0,3,3,3,4,1,0,5,6,2,4,1,0,24,4,20,11,4,7,4,6,11,2,1,0,-3,2,1,2,0,1,7,4,10,0,1,-1,4,4,0,3,0,0,1,1,0,2,0,0,3,3,0,1,0,0,-6,1,-7,2,-3,5,-1,2,-6,-2,2,-1,6,-1,-2,-2,0,0,-7,3,-4,0,2,-1,3,0,-2,0,1,0,3,-2,-2,-1,-1,0,0,2,0,1,2,0,-2,5,-7,4,3,1,1,0,1,-3,0,-1,0,0,4,-2,0,3,1,0,-3,-1,0,-4,2,1,1,0,0,0,2,0,1,0,0,0,0,1,0,0,0,0,-17,-9,-8,-4,-1,-3,0,-2,-15,2,-3,1,2,0,-9,-1,-2,1,-2,-2,-6,3,-1,0,-2,0,-3,2,-1,0,-1,1,-2,1,0,0,-1,-1,-1,1,-1,0,-18,-10,-8,-4,-2,-2,-5,0,-8,-5,0,0,-3,1,-5,-3,0,0,-2,-1,-3,-2,0,0,-2,0,-1,-1,0,0,-1,0,-1,0,0,0,-1,0,0,-1,0,0,-28,-14,-14,-7,-4,-3,-4,-1,-14,-2,-3,-3,-2,-1,-4,-3,-2,-1,-2,0,-10,1,-1,-2,0,-2,-2,-2,0,-1,0,-1,-1,-2,0,0,0,-1,-1,0,0,-1,-17,-10,-7,-5,-3,-2,-1,-7,-6,-3,1,-1,-1,-4,-2,-3,0,0,0,-3,-4,0,1,-1,2,-3,-2,-2,0,0,1,-2,-1,-1,0,0,1,-1,-1,-1,0,0,-3,-3,0,2,0,2,-2,4,-1,-1,-1,-2,-2,2,0,-1,-1,-1,0,2,-1,0,0,-1,0,1,0,1,0,0,0,0,0,0,0,0,0,1,0,1,0,0,-1,-3,2,0,-1,1,-2,-3,5,1,1,-3,-2,0,1,-1,-1,0,0,-3,4,2,2,-3,0,0,1,2,-3,0,0,0,1,0,-2,0,0,0,0,2,-1,0,-26,-10,-16,-1,0,-1,-2,-5,-8,-6,-5,0,0,-2,-5,-2,-1,0,-2,-3,-3,-4,-4,0,0,1,0,0,-2,0,0,1,0,0,-1,0,0,0,0,0,-1,0
50,50055,Borja,4235,33,23,10,16,8,8,-1,16,9,7,4,-1,0,8,10,4,3,-2,-1,8,-1,3,1,1,0,6,2,6,1,0,0,3,2,1,1,0,0,3,0,5,0,0,40,25,15,18,9,9,11,6,6,8,7,1,8,2,2,6,5,1,3,4,4,2,2,0,6,6,2,4,0,0,3,2,2,2,0,0,3,4,0,2,0,0,37,12,25,25,10,15,10,-2,18,7,3,3,1,-3,7,5,4,0,9,1,11,2,-1,3,11,4,7,1,0,2,4,0,4,1,0,1,7,4,3,0,0,1,48,29,19,23,15,8,8,11,12,7,6,0,6,9,10,-1,2,3,2,2,2,8,4,-3,8,7,5,3,1,-1,5,5,4,1,1,-1,3,2,1,2,0,0,94,37,57,35,13,22,23,9,31,13,13,4,8,8,8,10,5,-1,15,1,23,3,8,5,9,6,13,8,0,-2,3,2,6,4,0,-2,6,4,7,4,0,0,102,59,43,40,27,13,13,16,37,31,8,-4,4,11,27,14,5,-2,9,5,10,17,3,-2,5,7,15,13,1,-1,4,6,9,9,0,-1,1,1,6,4,1,0,172,99,73,83,45,38,54,27,41,29,11,4,29,17,23,21,3,4,25,10,18,8,8,0,25,21,20,12,2,-2,14,13,8,8,0,-1,11,8,12,4,2,-1,196,132,64,128,85,43,31,51,52,34,21,1,26,21,43,24,12,1,5,30,9,10,9,0,23,38,37,25,4,-1,19,20,24,18,2,0,4,18,13,7,2,-1,171,95,76,83,53,30,36,32,55,26,10,5,24,14,31,16,5,2,12,18,24,10,5,3,13,22,37,7,2,2,9,10,23,7,2,2,4,12,14,0,0,0,23,20,3,47,30,17,0,6,2,13,8,-4,0,4,0,15,4,-2,0,2,2,-2,4,-2,7,9,16,9,5,2,7,6,10,5,2,1,0,3,6,4,3,1,-19,-25,6,6,-4,10,3,-5,-14,-8,8,-3,1,-5,-16,-11,4,1,2,0,2,3,4,-4,0,6,2,-5,3,0,1,0,-3,-4,2,0,-1,6,5,-1,1,0,54,15,39,-6,-5,-1,8,4,-5,-9,1,55,12,7,-7,-10,-5,19,-4,-3,2,1,6,36,4,3,-4,-6,-1,-1,1,3,-1,-5,-1,-1,3,0,-3,-1,0,0,-103,-82,-21,-115,-75,-40,-25,-11,-38,-40,-6,15,-28,-3,-29,-18,-6,0,3,-8,-9,-22,0,15,-10,-17,-42,-28,-17,-2,-12,-8,-27,-17,-11,-1,2,-9,-15,-11,-6,-1,37,9,28,-23,-12,-11,18,-8,-3,2,7,21,9,-6,-4,-2,6,6,9,-2,1,4,1,15,2,-1,-18,-3,-3,0,2,-1,-10,-2,-1,0,0,0,-8,-1,-2,0,8,-4,12,-27,-18,-9,10,-15,-21,2,6,25,6,-5,-17,-1,3,9,4,-10,-4,3,3,16,-3,-7,-11,-7,1,0,-1,-4,-8,-6,1,0,-2,-3,-3,-1,0,0,34,18,16,-1,3,-4,4,-3,8,5,5,14,3,-3,10,-1,1,8,1,0,-2,6,4,6,-3,-1,0,2,-1,1,-1,1,2,1,-1,1,-2,-2,-2,1,0,0,36,37,-1,12,0,12,1,2,13,2,-8,20,5,8,11,8,-5,8,-4,-6,2,-6,-3,12,5,3,5,-2,-2,2,1,1,1,-3,-2,2,4,2,4,1,0,0,20,12,8,0,-3,3,2,0,16,-6,5,3,5,-2,8,-7,6,0,-3,2,8,1,-1,3,-1,0,6,-4,-1,0,-2,0,3,-3,-1,0,1,0,3,-1,0,0
50,50067,Calatayud,17352,734,488,246,764,510,254,11,266,297,129,17,14,11,171,204,86,12,3,0,95,93,43,5,11,27,279,310,128,17,2,14,181,216,85,12,1,13,98,94,43,5,1,604,367,237,695,418,277,111,197,191,85,19,4,55,125,129,50,8,2,56,72,62,35,11,2,78,225,250,110,25,6,34,144,156,70,12,2,44,81,94,40,13,4,840,442,398,889,520,369,116,219,243,127,64,74,75,107,135,60,29,34,41,112,108,67,35,40,108,294,306,147,29,2,70,154,193,89,10,2,38,140,113,58,19,0,574,320,254,758,430,328,119,148,137,105,26,27,45,103,79,51,16,20,74,45,58,54,10,7,101,221,260,114,52,5,49,127,155,68,25,2,52,94,105,46,27,3,654,374,280,824,484,340,82,200,169,106,72,26,41,116,109,58,36,18,41,84,60,48,36,8,77,267,286,129,57,6,34,154,186,77,29,3,43,113,100,52,28,3,640,352,288,701,386,315,172,166,126,104,42,29,105,80,77,49,18,22,67,86,49,55,24,7,121,216,208,101,45,5,70,111,125,56,20,3,51,105,83,45,25,2,515,223,292,669,350,319,75,195,95,81,49,19,25,99,35,34,18,11,50,96,60,47,31,8,81,236,153,124,61,12,39,127,83,68,26,7,42,109,70,56,35,5,995,527,468,1132,621,511,165,280,237,170,91,31,71,164,134,77,52,17,94,116,103,93,39,14,168,344,315,204,85,3,77,197,186,109,45,1,91,147,129,95,40,2,78,49,29,196,99,97,23,19,-7,8,7,14,9,25,-14,11,-3,14,14,-6,7,-3,10,0,34,45,55,39,16,0,19,27,28,16,6,-1,15,18,27,23,10,1,17,-5,22,148,73,75,4,-2,-16,-6,27,6,6,-11,-17,-2,14,2,-2,9,1,-4,13,4,33,32,40,28,8,2,16,15,23,11,3,1,17,17,17,17,5,1,161,74,87,246,132,114,27,57,51,-8,23,2,14,37,26,-10,10,-8,13,20,25,2,13,10,30,81,62,28,33,8,20,46,35,12,14,2,10,35,27,16,19,6,372,260,112,224,110,114,32,137,118,14,35,29,22,88,115,4,13,14,10,49,3,10,22,15,24,72,45,45,28,8,12,33,28,22,11,3,12,39,17,23,17,5,-61,-31,-30,18,1,17,0,8,-25,-24,-35,9,2,9,-21,-13,-28,15,-2,-1,-4,-11,-7,-6,9,7,9,2,-9,0,2,3,-1,0,-5,2,7,4,10,2,-4,-2,-25,-12,-13,-27,-25,-2,-5,26,-33,3,-22,0,-1,9,-30,10,-10,7,-4,17,-3,-7,-12,-7,-2,6,-21,-8,1,-4,-3,3,-17,-3,-4,-2,1,3,-4,-5,5,-2,22,45,-23,-2,-1,-1,-12,47,0,-22,-14,24,4,37,24,-21,-18,19,-16,10,-24,-1,4,5,-11,30,-6,-12,-4,1,-3,21,2,-22,-2,3,-8,9,-8,10,-2,-2,-176,-84,-92,-170,-95,-75,-40,9,-67,-67,-27,20,-7,5,-46,-32,-12,16,-33,4,-21,-35,-15,4,-14,-5,-55,-51,-35,-12,-1,-7,-37,-32,-14,-4,-13,2,-18,-19,-21,-8,76,33,43,182,86,96,4,45,-7,-15,26,20,3,16,-2,-13,18,11,1,29,-5,-2,8,9,49,39,43,31,8,11,28,14,19,17,4,3,21,25,24,14,4,8,171,80,91,187,83,104,49,41,-2,48,22,7,17,10,-4,39,3,6,32,31,2,9,19,1,31,48,35,47,22,4,15,22,10,26,8,2,16,26,25,21,14,2
50,50068,Calatorao,2722,87,64,23,70,49,21,10,25,27,11,14,0,6,18,25,6,10,0,4,7,2,5,4,0,1,24,34,9,1,0,0,12,29,7,1,0,1,12,5,2,0,0,123,92,31,97,71,26,16,35,50,23,3,-6,12,24,39,17,3,-4,4,11,11,6,0,-2,7,24,47,17,2,0,4,19,32,14,2,0,3,5,15,3,0,0,53,60,-7,71,54,17,6,31,3,15,5,-7,3,27,14,12,7,-3,3,4,-11,3,-2,-4,7,23,30,11,2,-2,3,16,27,7,2,-1,4,7,3,4,0,-1,39,19,20,56,36,20,6,12,19,0,4,-4,2,11,3,2,3,-3,4,1,16,-2,1,-1,5,12,22,14,3,0,1,9,15,9,2,0,4,3,7,5,1,0,9,17,-8,52,34,18,5,15,-16,-2,2,3,5,13,-7,1,2,1,0,2,-9,-3,0,2,5,22,15,6,3,1,4,15,9,4,1,1,1,7,6,2,2,0,26,3,23,45,20,25,6,8,-2,4,8,-2,2,-3,0,-4,5,-1,4,11,-2,8,3,-1,11,11,12,6,2,1,7,3,7,2,1,0,4,8,5,4,1,1,18,11,7,43,16,27,-1,8,-3,11,6,-3,-5,7,-1,9,4,-2,4,1,-2,2,2,-1,7,12,9,11,2,1,1,5,7,3,0,0,6,7,2,8,2,1,43,32,11,70,35,35,6,16,20,0,5,-3,6,10,9,3,4,-1,0,6,11,-3,1,-2,5,13,38,10,4,0,3,7,17,5,3,0,2,6,21,5,1,0,49,21,28,74,32,42,12,14,19,7,8,-8,8,7,16,-6,3,-5,4,7,3,13,5,-3,17,13,22,13,7,2,11,5,12,3,1,0,6,8,10,10,6,2,28,4,24,20,-3,23,18,10,3,3,2,-8,10,7,-2,-1,-3,-4,8,3,5,4,5,-4,16,12,-6,-1,-2,0,10,5,-10,-5,-3,0,6,7,4,4,1,0,-22,-6,-16,10,7,3,-9,8,2,-12,-6,0,-6,7,2,-5,-4,1,-3,1,0,-7,-2,-1,1,10,0,0,-1,0,1,6,1,0,-1,0,0,4,-1,0,0,0,-38,-13,-25,12,7,5,-2,6,-16,-7,-8,-12,1,2,-7,-5,-4,-1,-3,4,-9,-2,-4,-11,7,5,-2,3,0,-1,7,4,-3,-1,0,0,0,1,1,4,0,-1,-30,-23,-7,-30,-23,-7,-3,5,-2,-18,-5,-10,-2,4,-5,-15,-2,-5,-1,1,3,-3,-3,-5,-4,5,-3,-25,-2,-1,-2,3,-4,-18,-1,-1,-2,2,1,-7,-1,0,-57,-33,-24,-17,-12,-5,-11,-4,-17,-18,0,-6,-8,-1,-6,-11,-3,-3,-3,-3,-11,-7,3,-3,-2,-2,-9,-5,1,0,-2,-2,-5,-2,-1,0,0,0,-4,-3,2,0,-15,-10,-5,-3,0,-3,-3,8,-13,5,-5,-6,-4,9,-19,8,-4,1,1,-1,6,-3,-1,-7,2,5,-7,0,-1,-2,2,5,-5,-1,-1,0,0,0,-2,1,0,-2,-46,-21,-25,-18,-11,-7,-11,-2,-8,-7,-2,-14,-1,-3,-3,-7,-2,-4,-10,1,-5,0,0,-10,-1,0,-4,-8,-2,-4,2,0,-5,-6,-1,-1,-3,0,1,-2,-1,-3,51,33,18,37,23,14,12,8,13,11,6,-1,10,4,2,13,4,-1,2,4,11,-2,2,0,5,10,11,7,6,-2,4,6,4,7,3,-1,1,4,7,0,3,-1,21,10,11,5,1,4,8,6,8,5,-3,-5,2,-1,1,7,2,-4,6,7,7,-2,-5,-1,3,3,1,1,-3,-1,2,-1,-1,1,0,-1,1,4,2,0,-3,0
50,50182,"Muela, La",1205,231,115,116,6,1,5,32,24,67,41,37,29,15,15,34,22,20,9,17,9,33,19,17,20,2,3,1,0,0,0,0,1,0,0,0,0,2,2,1,0,0,0,276,148,128,10,5,5,41,27,61,67,51,29,20,18,29,39,33,9,21,9,32,28,18,20,2,3,2,3,0,0,1,1,1,2,0,0,1,2,1,1,0,0,486,243,243,11,6,5,93,84,91,107,69,41,50,32,46,54,37,22,43,52,45,53,32,19,7,0,2,2,0,0,3,0,2,1,0,0,4,0,0,1,0,0,504,260,244,6,3,3,70,77,118,106,92,35,43,40,59,58,39,17,27,37,59,48,53,18,0,1,4,1,0,0,0,0,2,1,0,0,0,1,2,0,0,0,359,178,181,10,3,7,66,47,106,62,52,17,29,17,65,31,28,4,37,30,41,31,24,13,2,2,0,4,2,0,0,1,-1,2,1,0,2,1,1,2,1,0,245,117,128,13,8,5,37,34,133,14,10,9,18,17,69,5,4,1,19,17,64,9,6,8,2,2,6,3,0,0,1,2,3,2,0,0,1,0,3,1,0,0,379,205,174,28,13,15,54,51,170,72,20,1,33,25,91,47,5,-1,21,26,79,25,15,2,-2,11,10,5,3,1,0,2,7,3,1,0,-2,9,3,2,2,1,426,218,208,71,40,31,82,59,161,90,21,6,45,19,83,54,7,6,37,40,78,36,14,0,14,15,22,17,1,1,9,6,13,10,0,1,5,9,9,7,1,0,445,224,221,55,23,32,41,75,222,56,20,16,17,31,128,26,6,6,24,44,94,30,14,10,10,13,15,12,2,1,2,7,4,7,1,0,8,6,11,5,1,1,205,121,84,5,1,4,19,44,108,28,4,-8,21,26,56,11,6,-7,-2,18,52,17,-2,-1,1,5,1,-1,-3,1,1,2,1,-3,-1,0,0,3,0,2,-2,1,-32,12,-44,-36,-24,-12,-13,15,16,-10,-31,-15,-3,9,27,-2,-15,-8,-10,6,-11,-8,-16,-7,-4,-8,-1,-13,-8,-3,-3,-4,-1,-8,-7,-1,-1,-4,0,-5,-1,-2,-216,-97,-119,2,0,2,-26,-16,-39,-49,-50,-34,-13,-11,-20,-17,-20,-16,-13,-5,-19,-32,-30,-18,3,3,-7,0,2,0,2,1,-4,-1,1,0,1,2,-3,1,1,0,-119,-67,-52,-16,-18,2,-21,-1,-9,-40,-27,-27,-18,-4,1,-21,-13,-15,-3,3,-10,-19,-14,-12,-2,-2,-7,-6,0,-1,-3,-2,-6,-7,-1,0,1,0,-1,1,1,-1,-139,-52,-87,-29,-15,-14,-41,11,-24,-39,-24,-15,-22,4,12,-27,-11,-8,-19,7,-36,-12,-13,-7,-13,-1,-6,-7,-1,0,-6,-1,-2,-4,-1,0,-7,0,-4,-3,0,0,-53,-33,-20,-6,2,-8,-25,3,15,-27,-12,-4,-11,0,2,-18,-3,-1,-14,3,13,-9,-9,-3,-5,-1,2,-2,0,0,-1,1,2,0,0,0,-4,-2,0,-2,0,0,38,38,0,-20,-6,-14,-6,30,42,-11,-7,-15,-1,8,38,-2,1,-9,-5,22,4,-9,-8,-6,0,-1,-9,-7,-2,-1,0,0,-3,-3,1,-1,0,-1,-6,-4,-3,0,108,65,43,-8,-7,-1,33,5,48,33,-8,-6,17,2,25,22,2,-3,16,3,23,11,-10,-3,1,-1,-7,-1,0,0,1,-1,-5,-2,0,0,0,0,-2,1,0,0,182,100,82,-10,-2,-8,29,26,59,37,16,4,18,17,34,13,12,4,11,9,25,24,4,0,-3,1,-10,0,2,1,-1,1,-4,-1,3,1,-2,0,-6,1,-1,0
50,50204,Pedrola,2588,60,30,30,15,10,5,23,2,16,10,4,5,10,5,3,6,2,4,13,-3,13,4,2,1,7,1,3,2,1,1,5,1,1,2,0,1,2,0,2,0,1,0,69,43,26,3,2,1,5,19,14,14,11,6,3,10,14,7,6,4,2,9,0,7,5,2,0,2,0,1,0,0,0,1,0,1,0,0,0,1,0,0,0,0,36,28,8,20,13,7,13,4,23,-7,0,4,11,6,17,-4,-1,1,2,-2,6,-3,1,3,5,1,10,4,0,0,2,2,6,3,0,0,3,-1,4,1,0,0,35,16,19,10,6,4,9,1,7,10,2,3,-1,2,1,9,1,1,10,-1,6,1,1,2,1,1,2,4,2,0,1,0,1,3,1,0,0,1,1,1,1,0,135,76,59,70,41,29,26,33,42,26,5,1,15,15,27,15,5,-1,11,18,15,11,0,2,19,11,18,17,3,0,11,7,9,12,2,0,8,4,9,5,1,0,60,47,13,43,24,19,5,16,28,6,3,1,8,8,26,0,1,5,-3,8,2,6,2,-4,2,13,14,7,6,1,1,6,10,3,3,1,1,7,4,4,3,0,133,101,32,121,93,28,17,17,39,41,7,13,11,11,28,39,7,5,6,6,11,2,0,8,13,18,36,41,9,3,7,11,31,36,7,1,6,7,5,5,2,2,59,31,28,90,52,38,1,9,29,20,-4,-1,0,-1,19,19,-7,0,1,10,10,1,3,-1,17,14,29,27,1,0,7,7,18,19,0,0,10,7,11,8,1,0,149,84,65,107,63,44,35,9,36,47,19,1,19,5,22,28,10,0,16,4,14,19,9,1,25,13,26,30,10,1,15,5,19,19,5,0,10,8,7,11,5,1,19,16,3,42,24,18,-7,5,16,-4,2,2,-2,6,14,-2,1,0,-5,-1,2,-2,1,2,8,8,14,8,0,1,5,4,12,5,-2,0,3,4,2,3,2,1,55,37,18,50,29,21,10,5,16,17,2,0,6,4,10,12,5,-3,4,1,6,5,-3,3,8,7,16,16,2,0,4,3,8,11,2,0,4,4,8,5,0,0,36,7,29,74,40,34,-3,11,6,18,9,-6,-8,2,3,7,6,-3,5,9,3,11,3,-3,14,15,12,24,9,0,4,8,6,15,7,0,10,7,6,9,2,0,-168,-109,-59,-186,-125,-61,-15,-18,-51,-54,-28,-3,-8,-10,-38,-36,-21,3,-7,-8,-13,-18,-7,-6,-22,-9,-54,-64,-33,-5,-9,-7,-35,-49,-25,0,-13,-2,-19,-15,-8,-5,-47,-32,-15,-25,-18,-7,-11,-3,-21,-20,0,6,-4,-1,-13,-16,0,0,-7,-2,-8,-4,0,6,-4,0,-10,-12,-1,1,-5,-1,-3,-8,-2,0,1,1,-7,-4,1,1,-30,-5,-25,20,15,5,-9,-6,-1,-13,3,-3,-1,-3,6,-9,1,1,-8,-3,-7,-4,2,-4,2,0,7,2,9,0,2,0,6,2,5,0,0,0,1,0,4,0,-47,-25,-22,3,6,-3,-15,0,3,-22,-2,-10,-5,-8,5,-9,-1,-7,-10,8,-2,-13,-1,-3,-3,4,3,0,0,-1,1,0,4,2,0,-1,-4,4,-1,-2,0,0,10,5,5,18,5,13,10,3,-3,1,0,-2,4,0,3,-1,-1,-2,6,3,-6,2,1,0,1,6,6,5,-3,0,0,1,3,0,-2,1,1,5,3,5,-1,-1,78,35,43,48,33,15,27,14,35,6,-4,-4,12,3,15,8,-1,-5,15,11,20,-2,-3,1,8,7,14,14,6,-2,6,1,9,11,6,-1,2,6,5,3,0,-1
50,50208,Pina de Ebro,2221,28,21,7,16,9,7,1,10,12,4,2,-2,3,8,10,-1,2,-1,-2,2,2,5,0,-1,2,5,6,3,0,0,1,4,3,1,0,0,1,1,3,2,0,0,11,9,2,8,5,3,2,9,5,-1,3,-6,-2,6,6,-2,3,-2,4,3,-1,1,0,-4,0,5,2,0,1,0,0,3,2,0,0,0,0,2,0,0,1,0,38,25,13,7,4,3,5,5,23,1,0,2,2,3,19,-1,0,2,3,2,4,2,0,0,1,1,1,3,0,1,0,0,1,2,0,1,1,1,0,1,0,0,16,7,9,12,6,6,-3,-3,13,1,7,0,1,-4,8,-3,4,0,-4,1,5,4,3,0,0,3,4,2,1,2,0,1,2,2,0,1,0,2,2,0,1,1,25,22,3,23,14,9,4,12,10,1,-3,2,2,7,12,1,-1,1,2,5,-2,0,-2,1,4,10,4,3,1,0,2,5,2,3,1,0,2,5,2,0,0,0,37,26,11,30,20,10,-6,15,8,10,7,1,2,10,0,7,5,1,-8,5,8,3,2,0,5,12,5,6,1,0,4,8,2,4,1,0,1,4,3,2,0,0,65,34,31,35,13,22,26,2,29,4,3,1,18,-3,15,3,2,0,8,5,14,1,1,1,11,4,11,7,1,1,8,-2,4,2,1,0,3,6,7,5,0,1,68,45,23,38,21,17,24,1,16,24,0,2,10,1,16,18,-1,0,14,0,0,6,1,2,4,12,6,13,1,2,2,3,7,9,0,0,2,9,-1,4,1,2,40,28,12,38,21,17,7,13,21,4,-4,-1,11,13,14,-7,-2,-1,-4,0,7,11,-2,0,3,13,16,6,0,0,2,9,11,-2,1,0,1,4,5,8,-1,0,58,19,39,30,10,20,19,13,19,1,3,3,5,8,10,-4,0,1,14,5,9,5,3,2,11,5,5,6,1,1,4,2,2,0,0,1,7,3,3,6,1,0,-14,-6,-8,7,5,2,-5,2,-7,-5,-4,3,-2,0,-6,2,-3,3,-3,2,-1,-7,-1,0,3,5,-2,-2,1,2,3,1,-2,1,1,1,0,4,0,-3,0,1,8,1,7,9,3,6,6,0,-11,6,4,-1,7,-2,-9,2,1,1,-1,2,-2,4,3,-2,0,4,2,4,1,-2,-1,2,1,1,0,0,1,2,1,3,1,-2,-16,-9,-7,4,-1,5,-6,-3,0,-4,2,-4,-1,0,-5,1,-1,-3,-5,-3,5,-5,3,-1,-1,0,4,0,0,1,0,0,1,0,-2,0,-1,0,3,0,2,1,-29,-18,-11,6,2,4,-1,-3,-5,-9,-8,-5,1,-3,-3,-7,-2,-4,-2,0,-2,-2,-6,-1,5,1,1,0,-1,0,3,0,-1,0,0,0,2,1,2,0,-1,0,-22,-17,-5,-3,-4,1,0,-5,2,-11,-3,-2,-4,-6,4,-7,-1,-1,4,1,-2,-4,-2,-1,-1,1,1,-1,-2,-1,0,0,2,-3,-2,-1,-1,1,-1,2,0,0,-71,-30,-41,-4,-6,2,-20,-3,-14,-15,-9,-6,-9,-1,-2,-8,-8,0,-11,-2,-12,-7,-1,-6,-4,1,1,1,-2,-1,-2,-1,1,0,-3,-1,-2,2,0,1,1,0,-7,-10,3,10,7,3,0,1,-7,-11,5,4,-2,1,-7,-4,0,2,2,0,0,-7,5,2,3,3,-1,-1,3,3,2,2,-1,1,1,2,1,1,0,-2,2,1,-37,-14,-23,15,5,10,-7,-7,-13,-2,-3,-6,-5,-3,-6,0,1,-3,-2,-4,-7,-2,-4,-3,3,7,2,3,0,0,0,3,1,1,0,0,3,4,1,2,0,0
50,50209,Pinseque,1500,145,72,73,3,1,2,14,28,32,28,21,21,10,9,22,13,12,5,4,19,10,15,9,16,0,3,0,0,0,0,0,1,0,0,0,0,0,2,0,0,0,0,100,49,51,9,6,3,11,4,28,32,13,12,1,-2,18,19,8,5,10,6,10,13,5,7,2,3,1,2,1,0,1,2,0,2,1,0,1,1,1,0,0,0,141,70,71,3,2,1,40,5,60,29,2,3,21,1,28,16,1,2,19,4,32,13,1,1,1,0,0,2,0,0,1,0,0,1,0,0,0,0,0,1,0,0,187,100,87,-1,0,-1,28,24,52,36,10,29,15,11,32,18,6,12,13,13,20,18,4,17,0,-1,-1,2,-1,0,0,0,-1,2,-1,0,0,-1,0,0,0,0,249,134,115,22,12,10,45,29,100,35,9,26,30,14,53,22,5,7,15,15,47,13,4,19,2,7,8,2,2,1,2,4,6,0,0,0,0,3,2,2,2,1,203,97,106,19,7,12,31,37,83,34,13,2,11,14,47,15,9,0,20,23,36,19,4,2,5,5,6,2,1,0,1,1,4,1,0,0,4,4,2,1,1,0,178,90,88,23,14,9,23,34,85,18,4,10,1,16,48,13,-1,11,22,18,37,5,5,-1,3,6,8,6,-1,1,1,5,2,6,0,0,2,1,6,0,-1,1,277,152,125,89,57,32,35,54,97,50,20,22,13,31,58,27,15,9,22,23,39,23,5,13,12,23,28,18,7,1,6,15,20,13,3,0,6,8,8,5,4,1,152,83,69,38,25,13,31,18,47,23,18,14,20,7,26,16,8,4,11,11,21,7,10,10,13,4,8,7,6,-1,8,3,5,5,4,-1,5,1,3,2,2,0,47,22,25,16,7,9,6,6,27,1,1,2,7,3,11,3,-1,-4,-1,3,16,-2,2,6,7,2,4,0,2,0,6,1,0,-1,0,0,1,1,4,1,2,0,93,57,36,18,10,8,0,10,37,1,17,24,3,6,22,4,9,13,-3,4,15,-3,8,11,-1,3,6,4,3,0,-1,2,5,3,1,0,0,1,1,1,2,0,85,46,39,14,9,5,11,4,33,7,8,15,1,4,15,13,3,7,10,0,18,-6,5,8,2,2,6,0,2,1,4,0,2,2,0,0,-2,2,4,-2,2,1,-21,-20,-1,-63,-45,-18,-8,-10,19,-24,-14,11,-3,-8,7,-13,-6,2,-5,-2,12,-11,-8,9,-14,-15,-14,-15,-5,-1,-10,-8,-13,-11,-3,0,-4,-7,-1,-4,-2,-1,-56,-44,-12,-29,-19,-10,-17,-3,6,-16,-24,-4,-13,-2,2,-15,-11,-4,-4,-1,4,-1,-13,0,0,-3,-9,-8,-5,-4,0,-3,-4,-8,-2,-2,0,0,-5,0,-3,-2,-28,5,-33,-15,-7,-8,-11,-13,-1,0,-13,7,-7,-5,11,4,-6,4,-4,-8,-12,-4,-7,3,10,-1,-9,-9,-6,0,8,0,-3,-9,-3,0,2,-1,-6,0,-3,0,97,46,51,-7,-4,-3,15,17,26,24,0,10,7,9,6,12,-1,10,8,8,20,12,1,0,-1,2,-8,3,-2,-1,0,0,-5,1,0,0,-1,2,-3,2,-2,-1,111,41,70,14,1,13,17,14,42,12,9,12,1,3,22,0,3,9,16,11,20,12,6,3,3,2,6,-1,3,1,-2,0,2,-1,1,1,5,2,4,0,2,0,51,18,33,-1,-2,1,1,2,36,6,-4,11,-5,1,24,1,-5,2,6,1,12,5,1,9,0,-2,2,-3,1,1,0,-1,1,-3,0,1,0,-1,1,0,1,0
50,50225,Ricla,1858,280,203,77,309,236,73,17,70,123,61,10,-2,9,46,90,52,6,-1,8,24,33,9,4,-1,21,72,139,73,4,0,13,52,105,63,3,0,8,20,34,10,1,0,196,142,54,253,188,65,7,66,86,34,5,-4,3,47,68,25,-1,0,4,19,18,9,6,-4,8,73,117,50,5,0,4,52,90,40,2,0,4,21,27,10,3,0,240,149,91,341,220,121,38,68,87,39,0,4,22,40,64,15,4,2,16,28,23,24,-4,2,34,88,145,67,5,0,16,55,103,41,4,0,18,33,42,26,1,0,-13,-22,9,124,62,62,8,1,-15,-9,0,4,4,-2,-16,-6,-1,1,4,3,1,-3,1,3,12,37,45,23,7,0,4,19,23,13,3,0,8,18,22,10,4,0,1,-19,20,100,63,37,2,12,-9,-3,-1,2,-8,9,-11,-5,-5,3,10,3,2,2,4,-1,12,30,38,17,2,1,2,22,26,11,1,1,10,8,12,6,1,0,160,102,58,193,112,81,26,50,55,15,12,1,16,31,30,17,6,1,10,19,25,-2,6,0,25,61,65,33,8,1,13,34,35,25,5,0,12,27,30,8,3,1,76,41,35,131,76,55,23,18,20,1,9,1,13,12,11,1,4,-1,10,6,9,0,5,2,31,33,35,21,8,0,20,19,21,12,3,0,11,14,14,9,5,0,488,286,202,494,284,210,61,129,164,104,27,0,33,83,92,60,17,-2,28,46,72,44,10,2,52,139,176,102,20,5,26,83,103,58,13,1,26,56,73,44,7,4,69,40,29,103,57,46,4,15,21,18,8,0,2,8,6,17,2,2,2,7,15,1,6,-2,7,31,36,21,7,0,3,19,18,13,4,0,4,12,18,8,3,0,98,54,44,110,61,49,10,38,20,34,-8,3,3,19,20,13,-5,3,7,19,0,21,-3,0,14,44,25,21,5,0,10,23,17,8,2,0,4,21,8,13,3,0,-505,-335,-170,-417,-288,-129,-33,-66,-177,-170,-51,-6,-22,-37,-112,-122,-37,-2,-11,-29,-65,-48,-14,-4,-18,-51,-158,-145,-43,-2,-12,-32,-104,-108,-32,0,-6,-19,-54,-37,-11,-2,110,52,58,116,52,64,26,26,49,9,1,-1,14,16,18,2,1,0,12,10,31,7,0,-1,17,33,36,22,9,-1,13,17,9,9,5,-1,4,16,27,13,4,0,47,11,36,72,28,44,-8,11,23,31,-4,-6,-3,9,5,10,-3,-5,-5,2,18,21,-1,-1,3,16,21,32,0,0,1,12,4,10,1,0,2,4,17,22,-1,0,27,12,15,41,14,27,1,5,4,6,7,0,4,5,1,-3,5,-2,-3,0,3,9,2,2,8,4,13,12,3,0,2,3,4,4,1,0,6,1,9,8,2,0,-33,-23,-10,-8,-11,3,1,-5,-13,-9,-4,-1,-1,1,-8,-11,-2,-1,2,-6,-5,2,-2,0,0,7,-6,-7,-1,-1,-1,4,-8,-7,1,0,1,3,2,0,-2,-1,-50,-50,0,-34,-38,4,-1,14,-23,-19,-14,-7,5,5,-23,-19,-12,-5,-6,9,0,0,-2,-2,-5,10,-5,-16,-16,-2,1,3,-8,-18,-14,-2,-6,7,3,2,-2,0,-48,-17,-31,-24,-8,-16,-3,5,-18,-17,-6,-9,0,6,-7,-10,-3,-3,-3,-1,-11,-7,-3,-6,-1,6,-10,-16,-1,-2,0,3,-4,-6,-1,0,-1,3,-6,-10,0,-2,24,19,5,29,9,20,-10,21,13,-8,9,-2,-3,9,6,1,6,1,-7,12,7,-9,3,-3,2,17,15,-8,1,1,2,7,4,-5,0,1,0,10,11,-3,1,0
50,50235,San Mateo de Gállego,2069,57,32,25,4,3,1,9,11,24,14,2,-4,6,6,13,8,1,-2,3,5,11,6,1,-2,0,1,2,1,0,0,0,1,1,1,0,0,0,0,1,0,0,0,26,12,14,12,5,7,3,0,16,3,5,-1,0,-1,11,0,2,0,3,1,5,3,3,-1,2,2,4,3,1,0,1,1,3,0,0,0,1,1,1,3,1,0,54,38,16,11,8,3,13,5,9,15,12,1,7,4,5,10,10,2,6,1,4,5,2,-1,5,2,4,0,0,0,4,1,3,0,0,0,1,1,1,0,0,0,78,41,37,5,1,4,7,7,28,16,18,-1,2,3,12,12,12,-1,5,4,16,4,6,0,0,2,3,0,0,0,0,0,1,0,0,0,0,2,2,0,0,0,59,35,24,22,9,13,10,11,26,16,-2,-2,4,3,21,6,0,0,6,8,5,10,-2,-2,2,5,8,4,3,0,0,2,5,1,1,0,2,3,3,3,2,0,144,78,66,24,7,17,25,13,62,26,9,4,14,4,36,12,7,2,11,9,26,14,2,2,3,7,7,6,0,0,1,1,3,2,0,0,2,6,4,4,0,0,114,70,44,26,12,14,18,14,36,34,7,2,11,10,15,21,9,2,7,4,21,13,-2,0,3,7,4,8,1,1,1,4,-1,5,1,1,2,3,5,3,0,0,155,68,87,61,29,32,24,23,69,5,9,18,10,13,37,2,1,4,14,10,32,3,8,14,13,19,20,3,3,1,6,14,9,0,0,0,7,5,11,3,3,1,126,59,67,25,13,12,16,12,54,24,16,2,1,3,25,17,10,1,15,9,29,7,6,1,4,4,17,4,-2,-2,0,-1,13,2,0,-1,4,5,4,2,-2,-1,67,38,29,11,5,6,7,13,17,5,18,7,2,12,12,-1,10,5,5,1,5,6,8,2,7,0,5,1,-1,-1,5,-1,0,1,0,0,2,1,5,0,-1,-1,65,29,36,7,-5,12,7,17,22,6,4,6,9,5,13,2,0,0,-2,12,9,4,4,6,3,4,1,1,-2,0,2,-1,-2,-2,-2,0,1,5,3,3,0,0,22,11,11,16,7,9,17,7,2,2,-7,-1,11,5,-6,0,-2,1,6,2,8,2,-5,-2,10,3,0,3,0,0,4,2,1,-1,1,0,6,1,-1,4,-1,0,27,19,8,5,-1,6,4,7,8,1,0,6,8,4,1,2,1,3,-4,3,7,-1,-1,3,2,1,2,-1,0,0,0,0,0,-2,0,0,2,1,2,1,0,0,-65,-44,-21,-17,-14,-3,-21,-6,-34,-14,12,-2,-12,-4,-20,-9,5,-1,-9,-2,-14,-5,7,-1,1,-3,-6,-9,0,0,1,-3,-5,-6,-1,0,0,0,-1,-3,1,0,-43,-27,-16,-2,2,-4,-13,-5,4,-18,-4,-7,-10,-1,-1,-8,-1,-6,-3,-4,5,-10,-3,-1,2,-1,3,-4,-1,-1,0,0,2,0,0,0,2,-1,1,-4,-1,-1,16,15,1,0,-4,4,-1,5,17,-4,-2,1,7,2,12,-1,-3,-1,-8,3,5,-3,1,2,-3,3,-1,1,-1,1,-2,0,-1,0,-1,0,-1,3,0,1,0,1,29,9,20,7,6,1,3,1,21,-4,-5,12,3,-2,5,3,-1,1,0,3,16,-7,-4,11,2,-2,9,0,-4,2,1,1,4,2,-2,0,1,-3,5,-2,-2,2,56,24,32,25,9,16,11,4,16,19,1,3,4,-1,9,15,-2,0,7,5,7,4,3,3,5,5,7,5,2,1,0,3,3,1,1,1,5,2,4,4,1,0
50,50272,Utebo,9758,644,346,298,88,41,47,110,118,275,76,42,16,57,62,150,43,26,3,53,56,125,33,16,13,23,19,30,15,1,0,10,7,16,7,1,0,13,12,14,8,0,0,611,325,286,89,53,36,64,126,276,89,38,5,37,63,138,57,23,3,27,63,138,32,15,2,18,23,26,17,4,1,11,14,14,12,1,1,7,9,12,5,3,0,378,165,213,-5,-3,-2,52,58,207,49,4,2,16,23,112,11,5,-4,36,35,95,38,-1,6,1,-2,-2,-2,1,-1,0,-1,-2,-1,1,0,1,-1,0,-1,0,-1,289,164,125,-7,-4,-3,31,70,143,25,17,5,18,25,93,21,4,2,13,45,50,4,13,3,-2,3,-8,2,-2,0,-1,0,-4,2,-1,0,-1,3,-4,0,-1,0,641,364,277,184,109,75,80,103,310,83,26,26,40,43,185,68,12,10,40,60,125,15,14,16,30,44,55,47,6,1,15,19,38,35,2,0,15,25,17,12,4,1,730,352,378,206,113,93,146,131,312,80,57,-1,71,62,149,42,28,-3,75,69,163,38,29,2,49,46,63,32,11,3,25,24,35,19,8,0,24,22,28,13,3,3,883,449,434,278,163,115,157,115,379,151,57,8,50,52,216,90,29,5,107,63,163,61,28,3,45,65,90,66,11,0,19,34,59,49,2,0,26,31,31,17,9,0,868,441,427,383,231,152,139,154,359,141,36,30,62,87,182,79,15,14,77,67,177,62,21,16,63,99,128,78,14,-2,35,59,75,54,6,1,28,40,53,24,8,-3,508,257,251,192,103,89,73,94,199,90,20,20,50,40,92,48,7,10,23,54,107,42,13,10,43,45,50,39,11,3,29,24,25,21,2,1,14,21,25,18,9,2,156,45,111,-68,-66,-2,53,14,27,18,27,16,32,-3,-1,-6,18,6,21,17,28,24,9,10,3,-8,-23,-40,-3,3,1,-18,-19,-30,-3,2,2,10,-4,-10,0,1,53,-21,74,-134,-90,-44,20,27,-6,-26,3,27,11,9,-21,-39,5,7,9,18,15,13,-2,20,-13,-7,-67,-48,-2,-1,-3,-5,-39,-42,-5,0,-10,-2,-28,-6,3,-1,-53,-34,-19,-38,-31,-7,-12,-9,-8,-36,-11,15,3,2,-2,-25,-14,1,-15,-11,-6,-11,3,14,3,3,-4,-29,-9,-5,2,5,-12,-17,-9,-1,1,-2,8,-12,0,-4,-84,-51,-33,-95,-52,-43,3,-9,-34,-34,-12,1,14,4,-31,-27,-14,0,-11,-13,-3,-7,2,1,-11,-2,-40,-24,-13,-5,-3,-2,-23,-17,-6,-1,-8,0,-17,-7,-7,-4,-38,-48,10,-93,-58,-35,3,11,18,-56,-34,11,6,8,1,-46,-24,7,-3,3,17,-10,-10,4,-2,-16,-25,-34,-12,-3,3,-12,-18,-22,-8,0,-5,-4,-7,-12,-4,-3,-69,-68,-1,-65,-46,-19,-39,8,-78,-58,15,76,-30,11,-36,-53,1,34,-9,-3,-42,-5,14,42,-3,1,-33,-25,-4,-3,-4,0,-18,-19,-8,1,1,1,-15,-6,4,-4,-44,-33,-11,-43,-21,-22,20,-23,22,-44,-2,-13,11,-16,12,-29,-2,-7,9,-7,10,-15,0,-6,-3,1,-11,-19,-7,-5,-3,4,-3,-15,-4,-1,0,-3,-8,-4,-3,-4,97,22,75,-32,-29,-3,51,-21,43,-6,3,23,31,-18,10,-8,-7,13,20,-3,33,2,10,10,-5,4,-19,-4,-7,-1,0,-2,-11,-11,-4,-1,-5,6,-8,7,-3,0,-17,2,-19,-10,-5,-5,17,-6,-8,-54,-32,64,11,-9,8,-15,-29,33,6,3,-16,-39,-3,31,-2,3,9,-13,-7,0,-1,3,4,-4,-7,0,-1,0,5,-9,0,0
50,50297,Zaragoza,603367,-930,-542,-388,251,121,130,-96,-138,-378,-70,-198,-10,-88,-32,-172,-112,-130,18,-8,-106,-206,42,-68,-28,36,44,69,55,30,15,18,25,33,22,15,7,18,19,36,33,15,8,-1380,-830,-550,241,110,131,-117,-121,-474,-164,-427,-31,-108,-45,-301,-131,-218,-18,-9,-76,-173,-33,-209,-13,63,34,59,44,22,18,21,17,31,21,9,11,42,17,28,23,13,7,-3668,-1948,-1720,-142,-62,-80,-296,-416,-1344,-568,-735,-226,-142,-174,-777,-332,-375,-115,-154,-242,-567,-236,-360,-111,50,-41,-164,-3,9,6,13,-1,-86,-2,3,10,37,-40,-78,-1,6,-4,-1964,-1017,-947,1068,610,458,-91,51,-820,-269,-555,-207,-58,116,-433,-215,-331,-60,-33,-65,-387,-54,-224,-147,177,317,310,180,48,22,82,178,209,106,20,8,95,139,101,74,28,14,7804,4189,3615,8915,4864,4051,1178,2750,2650,1140,74,16,555,1506,1626,548,-50,15,623,1244,1024,592,124,1,1275,2543,3102,1391,399,139,631,1355,1879,752,159,60,644,1188,1223,639,240,79,9594,4870,4724,11026,5636,5390,1631,2955,2919,1820,63,193,867,1412,1603,977,-45,70,764,1543,1316,843,108,123,1885,2932,3584,1930,480,136,988,1426,1998,959,184,42,897,1506,1586,971,296,94,5826,2999,2827,11529,5881,5648,1142,2669,1833,1035,-458,-389,600,1320,1072,456,-294,-152,542,1349,761,579,-164,-237,1997,3085,3564,2098,549,141,1026,1499,1926,1081,242,56,971,1586,1638,1017,307,85,15330,8779,6551,16437,9128,7309,2346,4981,4594,2728,449,188,1129,2812,3003,1560,153,93,1217,2169,1591,1168,296,95,2508,4935,5388,2739,671,101,1272,2655,3254,1568,278,44,1236,2280,2134,1171,393,57,9330,5052,4278,10787,5814,4973,1794,3041,2525,1430,219,231,1007,1682,1468,711,31,103,787,1359,1057,719,188,128,1914,3308,3362,1606,405,71,1005,1764,1962,859,135,31,909,1544,1400,747,270,40,2490,716,1774,4789,2057,2732,1032,1114,33,173,-122,229,538,517,-260,-87,-129,120,494,597,293,260,7,109,1025,1656,1181,557,220,70,549,770,460,174,50,15,476,886,721,383,170,55,881,-619,1500,2970,787,2183,726,746,-231,-269,-197,60,319,218,-520,-478,-206,30,407,528,289,209,9,30,788,1195,559,144,190,8,393,423,25,-135,34,8,395,772,534,279,156,0,4466,1458,3008,3248,1176,2072,943,1106,796,568,503,497,505,384,124,31,167,212,438,722,672,537,336,285,846,1121,688,292,186,46,469,424,191,-14,48,26,377,697,497,306,138,20,1142,245,897,545,-91,636,467,490,-34,-32,11,221,287,218,-125,-209,-50,97,180,272,91,177,61,124,392,464,-94,-213,-65,0,246,169,-200,-280,-59,-4,146,295,106,67,-6,4,296,-243,539,-217,-397,180,377,127,-105,-249,-14,139,203,12,-190,-253,-74,44,174,115,85,4,60,95,192,279,-276,-319,-86,-50,109,53,-250,-247,-53,-35,83,226,-26,-72,-33,-15,1995,1132,863,1331,464,867,574,598,421,122,154,55,349,264,353,31,33,52,225,334,68,91,121,3,402,581,203,5,60,19,210,223,58,-89,19,7,192,358,145,94,41,12,1413,121,1292,1279,354,925,583,477,-150,-102,169,391,356,155,-309,-258,-20,167,227,322,159,156,189,224,429,549,151,-8,53,51,236,213,-38,-82,-25,23,193,336,189,74,78,28,1971,254,1717,1293,107,1186,478,966,309,-278,68,363,238,429,-47,-429,-87,110,240,537,356,151,155,253,357,883,282,-355,-7,47,184,381,-22,-389,-90,-4,173,502,304,34,83,51,1973,592,1381,792,53,739,534,1017,120,-14,-13,220,291,466,-61,-220,-69,131,243,551,181,206,56,89,273,970,6,-406,-129,-32,190,412,-102,-414,-96,1,83,558,108,8,-33,-33
51,51001,Ceuta,73704,-420,-116,-304,110,60,50,-136,60,-239,-25,-16,-60,-73,92,-124,3,6,-23,-63,-32,-115,-28,-22,-37,43,21,13,14,12,3,24,12,7,10,5,0,19,9,6,4,7,3,-263,-41,-222,56,32,24,-104,-6,-85,-23,2,-48,-28,-19,-33,37,28,-24,-76,13,-52,-60,-26,-24,32,6,3,4,8,2,17,4,2,3,4,2,15,2,1,1,4,0,-840,-437,-403,-26,-14,-12,-204,-61,-300,-173,-41,-65,-124,-45,-176,-56,-5,-30,-80,-16,-124,-117,-36,-35,15,-12,-13,-20,1,-2,9,-10,-5,-9,1,-2,6,-2,-8,-11,0,0,-771,-464,-307,25,-3,28,-173,-106,-260,-112,-78,-40,-97,-88,-163,-57,-24,-29,-76,-18,-97,-55,-54,-11,12,7,0,-4,0,-1,3,0,0,-5,-3,0,9,7,0,1,3,-1,-747,-504,-243,277,142,135,-75,-108,-347,-103,-25,-58,-34,-80,-271,-72,-5,-22,-41,-28,-76,-31,-20,-36,54,56,83,52,22,7,31,21,45,28,11,4,23,35,38,24,11,3,-211,-154,-57,366,183,183,-64,39,-155,-3,21,-48,-41,4,-140,13,20,-13,-23,35,-15,-16,1,-35,27,80,149,75,21,6,13,24,75,45,14,5,14,56,74,30,7,1,306,126,180,527,231,296,-1,248,-64,129,17,-6,-7,134,-110,91,29,-5,6,114,46,38,-12,-1,48,82,185,136,36,33,21,23,76,66,24,15,27,59,109,70,12,18,-31,23,-54,348,175,173,-64,177,-148,16,59,-49,-24,110,-86,14,37,-14,-40,67,-62,2,22,-35,27,62,122,86,27,20,29,24,57,44,11,6,-2,38,65,42,16,14,529,396,133,358,210,148,82,179,153,126,58,-61,72,98,103,109,45,-29,10,81,50,17,13,-32,14,73,148,60,46,15,28,29,83,33,30,7,-14,44,65,27,16,8,1344,868,476,470,226,244,148,536,411,239,70,-82,56,310,262,195,83,-43,92,226,149,44,-13,-39,42,91,152,121,37,15,16,42,69,64,17,11,26,49,83,57,20,4,1008,523,485,665,257,408,135,386,275,230,38,-69,76,217,116,124,38,-59,59,169,159,106,0,-10,61,144,248,120,55,26,33,41,94,41,33,7,28,103,154,79,22,19,954,434,520,729,368,361,171,293,230,260,55,-73,59,139,134,145,10,-52,112,154,96,115,45,-21,53,198,234,159,52,25,26,114,115,81,19,8,27,84,119,78,33,17,-30,9,-39,128,96,32,32,35,63,21,-79,-97,-2,9,54,63,-53,-57,34,26,9,-42,-26,-40,-27,78,67,1,2,-1,-24,55,49,12,-3,1,-3,23,18,-11,5,-2,241,-23,264,-255,-246,-9,263,92,-3,74,-89,-118,121,-40,-26,34,-56,-71,142,132,23,40,-33,-47,38,-46,-78,-81,-61,-39,11,-65,-78,-68,-31,-19,27,19,0,-13,-30,-20,-872,-585,-287,-274,-194,-80,-60,-5,-265,-195,-198,-138,-33,-40,-174,-116,-132,-90,-27,35,-91,-79,-66,-48,-45,-8,-90,-79,-35,-22,-19,-14,-64,-68,-24,-9,-26,6,-26,-11,-11,-13,-553,-324,-229,130,28,102,-32,-30,-189,-72,-114,-115,6,-36,-110,-41,-83,-62,-38,6,-79,-31,-31,-53,52,23,49,25,0,-30,31,-2,15,-5,-2,-16,21,25,34,30,2,-14,-101,-68,-33,209,86,123,25,150,-63,-47,-100,-75,17,71,-48,-22,-55,-43,8,79,-15,-25,-45,-32,37,26,89,41,-1,3,10,4,40,30,-10,3,27,22,49,11,9,0,-133,-10,-123,213,108,105,-86,86,17,-10,-45,-84,-53,43,35,17,-15,-35,-33,43,-18,-27,-30,-49,35,33,91,57,7,-18,27,17,48,22,2,-10,8,16,43,35,5,-8
52,52001,Melilla,56929,-835,-469,-366,27,13,14,-231,-181,-188,-137,-27,-59,-116,-136,-100,-66,-19,-28,-115,-45,-88,-71,-8,-31,1,3,7,3,7,4,1,1,3,3,3,2,0,2,4,0,4,2,-607,-345,-262,16,8,8,-147,-149,-190,-61,-38,-21,-69,-98,-124,-22,-29,-4,-78,-51,-66,-39,-9,-17,6,1,1,3,5,0,2,0,1,3,2,0,4,1,0,0,3,0,-1182,-627,-555,-227,-87,-140,-233,-257,-369,-174,-89,-50,-131,-169,-192,-69,-44,-22,-102,-88,-177,-105,-45,-28,-36,-44,-68,-50,-22,-9,-13,-19,-25,-19,-7,-4,-23,-25,-43,-31,-15,-5,-867,-505,-362,-152,-68,-84,-120,-165,-368,-134,-45,-50,-71,-108,-242,-59,-14,-20,-49,-57,-126,-75,-31,-30,-17,-14,-49,-50,-15,-14,-12,-6,-20,-26,-6,-3,-5,-8,-29,-24,-9,-11,-1275,-656,-619,-560,-300,-260,-260,-157,-362,-322,-80,-84,-149,-112,-194,-150,-24,-24,-111,-45,-168,-172,-56,-60,-116,-69,-131,-167,-45,-39,-70,-41,-71,-93,-16,-14,-46,-28,-60,-74,-29,-25,895,412,483,1266,617,649,256,153,23,251,144,57,139,68,-1,121,69,16,117,85,24,130,75,41,306,192,190,298,172,76,178,123,67,124,87,25,128,69,123,174,85,51,1754,797,957,1947,855,1092,355,260,391,436,180,79,183,101,100,234,104,39,172,159,291,202,76,40,363,248,561,446,169,97,178,90,207,204,92,44,185,158,354,242,77,53,1115,637,478,900,431,469,254,207,255,236,101,17,141,112,135,166,63,11,113,95,120,70,38,6,139,134,269,173,97,37,77,49,109,94,59,22,62,85,160,79,38,15,1161,667,494,803,379,424,261,239,238,265,59,30,166,85,139,189,48,9,95,154,99,76,11,21,143,105,249,133,81,38,75,33,110,68,49,15,68,72,139,65,32,23,1822,1165,657,555,258,297,313,483,518,343,156,-22,159,263,366,262,113,-7,154,220,152,81,43,-15,89,115,181,98,46,16,36,38,84,59,25,11,53,77,97,39,21,5,1500,1008,492,455,194,261,245,478,403,314,43,-22,93,294,317,216,54,6,152,184,86,98,-11,-28,103,130,172,61,-16,0,44,46,100,17,-18,3,59,84,72,44,2,-3,1813,1078,735,793,352,441,393,262,487,448,213,-11,238,98,251,323,176,-12,155,164,236,125,37,1,190,136,239,146,64,3,94,55,95,58,44,3,96,81,144,88,20,0,2415,1322,1093,758,353,405,574,446,718,443,200,0,284,191,399,314,119,2,290,255,319,129,81,-2,183,148,246,110,35,21,107,51,104,59,15,8,76,97,142,51,20,13,248,-157,405,-383,-449,66,235,159,-7,-53,-48,-66,78,20,-68,-93,-41,-57,157,139,61,40,-7,-9,46,39,-169,-207,-72,-43,14,-12,-163,-194,-66,-36,32,51,-6,-13,-6,-7,219,97,122,18,-67,85,40,251,23,-49,-10,-26,38,131,2,-51,-5,-14,2,120,21,2,-5,-12,36,60,4,-46,-20,-20,38,27,-21,-79,-16,-20,-2,33,25,33,-4,0,-239,-165,-74,318,94,224,-24,75,-63,-56,-90,-86,-15,13,-32,-29,-60,-54,-9,62,-31,-27,-30,-32,108,80,139,12,-18,-19,67,13,51,-2,-26,-18,41,67,88,14,8,-1,-466,-337,-129,-27,-134,107,-154,151,-137,-142,-116,-51,-96,76,-88,-108,-89,-31,-58,75,-49,-34,-27,-20,65,28,18,-94,-50,-1,26,15,-26,-107,-40,-5,39,13,44,13,-10,4,-532,-322,-210,335,145,190,-170,89,-111,-141,-93,-93,-59,36,-84,-79,-68,-57,-111,53,-27,-62,-25,-36,138,63,97,30,11,-13,83,29,28,11,0,-11,55,34,69,19,11,-2
